unix_secs,sysuptime,dpkts,doctets,doctets/dpkts,Real First Packet,Real End Packet,first,last,Duration
1360072290,493675032,1,127,127,1360072262874,1360072262874,493647906,493647906,0
1360072596,493980836,1,48,48,1360072568408,1360072568408,493953244,493953244,0
1360072958,494342820,11,1040,94.54545455,1360072954403,1360072954659,494339223,494339479,256
1360072958,494342824,13,1288,99.07692308,1360072954722,1360072955042,494339546,494339866,320
1360072958,494342824,12,1334,111.1666667,1360072955169,1360072955489,494339993,494340313,320
1360072958,494342864,15,6998,466.5333333,1360072953847,1360072954615,494338711,494339479,768
1360072968,494352740,15,3688,245.8666667,1360072943732,1360072955060,494328472,494339800,11328
1360072972,494356740,1,76,76,1360072946354,1360072946354,494331094,494331094,0
1360073020,494404868,4,1236,309,1360072995380,1360072995380,494380248,494380248,0
1360073028,494412936,50,65302,1306.04,1360073003502,1360073004334,494388438,494389270,832
1360073060,494444884,1,52,52,1360073034340,1360073034340,494419224,494419224,0
1360073060,494444924,1,52,52,1360073034299,1360073034299,494419223,494419223,0
1360073136,494520960,1,76,76,1360073108117,1360073108117,494493077,494493077,0
1360073217,494601348,3,152,50.66666667,1360073192825,1360073201849,494577173,494586197,9024
1360073308,494692144,1,48,48,1360073280069,1360073280069,494664213,494664213,0
1360073471,494855228,5,309,61.8,1360073466733,1360073466733,494850961,494850961,0
1360073476,3428139872,9,1599,177.6666667,1360073469117,1360073469245,3428132989,3428133117,128
1360073476,3428139872,13,9103,700.2307692,1360073469244,1360073469372,3428133116,3428133244,128
1360073476,3428139880,11,4687,426.0909091,1360073469046,1360073469110,3428132926,3428132990,64
1360073501,494885812,15,7436,495.7333333,1360073473445,1360073478053,494858257,494862865,4608
1360073505,494889836,29,37382,1289.034483,1360073480203,1360073480907,494865039,494865743,704
1360073505,494889836,45,61951,1376.688889,1360073480267,1360073480843,494865103,494865679,576
1360073505,494889880,64,85654,1338.34375,1360073479778,1360073491426,494864658,494876306,11648
1360073509,494893748,3,362,120.6666667,1360073480869,1360073480933,494865617,494865681,64
1360073511,494895220,12,12511,1042.583333,1360073492979,1360073509619,494877199,494893839,16640
1360073511,494895256,14,15322,1094.428571,1360073492434,1360073509586,494876690,494893842,17152
1360073511,494895256,38,50578,1331,1360073492178,1360073510610,494876434,494894866,18432
1360073527,494911272,132,188542,1428.348485,1360073480832,1360073524096,494865104,494908368,43264
1360073533,494917888,1,52,52,1360073507927,1360073507927,494892815,494892815,0
1360073549,494933896,1,52,52,1360073523469,1360073523469,494908365,494908365,0
1360073549,494933896,1,52,52,1360073523469,1360073523469,494908365,494908365,0
1360073549,494933900,1,52,52,1360073523469,1360073523469,494908369,494908369,0
1360073549,494933900,1,52,52,1360073523469,1360073523469,494908369,494908369,0
1360073549,494933944,1,52,52,1360073523422,1360073523422,494908366,494908366,0
1360073549,494933944,1,52,52,1360073523422,1360073523422,494908366,494908366,0
1360073549,494933948,1,52,52,1360073523417,1360073523417,494908365,494908365,0
1360073646,495030128,1,76,76,1360073619983,1360073619983,495004111,495004111,0
1360073684,3428347240,3,586,195.3333333,1360073658105,1360073658105,3428321345,3428321345,0
1360073686,495070084,32,43276,1352.375,1360073658169,1360073658297,495042253,495042381,128
1360073686,495070124,40,55521,1388.025,1360073658063,1360073658191,495042187,495042315,128
1360073714,495098132,1,52,52,1360073688073,1360073688073,495072205,495072205,0
1360073714,495098176,1,52,52,1360073688027,1360073688027,495072203,495072203,0
1360073716,3428379208,1,52,52,1360073688089,1360073688089,3428351297,3428351297,0
1360074155,495539392,1,76,76,1360074130685,1360074130685,495515077,495515077,0
1360074672,496056076,1,76,76,1360074644018,1360074644018,496028094,496028094,0
1360074728,496112128,4,1030,257.5,1360074701375,1360074701439,496085503,496085567,64
1360074732,496116104,18,20921,1162.277778,1360074705812,1360074706580,496089916,496090684,768
1360074764,496148100,1,52,52,1360074736537,1360074736537,496120637,496120637,0
1360074764,496148144,1,52,52,1360074736491,1360074736491,496120635,496120635,0
1360075180,496564844,1,76,76,1360075155244,1360075155244,496540088,496540088,0
1360075485,496869772,37,51440,1390.27027,1360075458925,1360075459053,496843697,496843825,128
1360075485,496869772,31,40863,1318.16129,1360075458989,1360075459053,496843761,496843825,64
1360075486,3430149736,3,586,195.3333333,1360075459091,1360075459155,3430122827,3430122891,64
1360075513,496897848,1,52,52,1360075488864,1360075488864,496873712,496873712,0
1360075513,496897896,1,52,52,1360075488818,1360075488818,496873714,496873714,0
1360075514,3430177712,1,52,52,1360075489133,1360075489133,3430152845,3430152845,0
1360075569,496953348,9,3757,417.4444444,1360075563157,1360075563349,496947505,496947697,192
1360075569,496953352,9,3952,439.1111111,1360075563665,1360075563857,496948017,496948209,192
1360075569,496953384,9,3646,405.1111111,1360075565744,1360075566448,496950128,496950832,704
1360075569,496953420,9,3755,417.2222222,1360075564746,1360075564938,496949166,496949358,192
1360075694,497078188,1,76,76,1360075666931,1360075666931,497051119,497051119,0
1360076203,497587348,1,76,76,1360076178762,1360076178762,497563110,497563110,0
1360076237,497621660,1,46,46,1360076208721,1360076208721,497593381,497593381,0
1360076555,497939952,4,1125,281.25,1360076529834,1360076529834,497914786,497914786,0
1360076560,497944068,28,34990,1249.642857,1360076535069,1360076536861,497919137,497920929,1792
1360076592,497976264,1,52,52,1360076566616,1360076566616,497950880,497950880,0
1360076592,497976264,1,52,52,1360076566616,1360076566616,497950880,497950880,0
1360076716,498100440,9,684,76,1360076689702,1360076705702,498074142,498090142,16000
1360847509,1268891384,1,46,46,1360847481745,1360847481745,1268864129,1268864129,0
1360849074,1270456312,1,48,48,1360849046016,1360849046016,1270428328,1270428328,0
1360850625,4205287724,16,11970,748.125,1360850626560,1360850626752,4205289284,4205289476,192
1360850633,4205294944,8,1467,183.375,1360850627786,1360850627850,4205289730,4205289794,64
1360850633,4205294944,14,9619,687.0714286,1360850628617,1360850628681,4205290561,4205290625,64
1360850633,4205294968,8,1611,201.375,1360850628467,1360850628531,4205290435,4205290499,64
1360850633,4205294968,8,876,109.5,1360850628531,1360850628531,4205290499,4205290499,0
1360850633,4205294968,8,1105,138.125,1360850628851,1360850628915,4205290819,4205290883,64
1360850637,1272019188,15,5402,360.1333333,1360850631844,1360850632292,1272014032,1272014480,448
1360850637,1272019188,16,5671,354.4375,1360850631908,1360850632740,1272014096,1272014928,832
1360850637,1272019232,4,366,91.5,1360850631864,1360850632120,1272014096,1272014352,256
1360850637,1272019236,19,5949,313.1052632,1360850632691,1360850633267,1272014927,1272015503,576
1360850637,1272019236,19,5940,312.6315789,1360850632691,1360850633267,1272014927,1272015503,576
1360850637,1272019240,97,113834,1173.546392,1360850633265,1360850633713,1272015505,1272015953,448
1360850641,4205302952,15,12028,801.8666667,1360850639041,1360850639297,4205300993,4205301249,256
1360850641,4205302956,11,2727,247.9090909,1360850639616,1360850639872,4205301572,4205301828,256
1360850641,4205302956,9,2575,286.1111111,1360850639616,1360850639936,4205301572,4205301892,320
1360850641,4205302956,8,1691,211.375,1360850639616,1360850640448,4205301572,4205302404,832
1360850641,4205302956,8,1649,206.125,1360850639551,1360850639615,4205301507,4205301571,64
1360850641,4205302956,8,1569,196.125,1360850639743,1360850639807,4205301699,4205301763,64
1360850641,4205302956,8,1569,196.125,1360850639807,1360850639807,4205301763,4205301763,0
1360850641,4205302956,8,1569,196.125,1360850639871,1360850639871,4205301827,4205301827,0
1360850641,4205302960,10,1635,163.5,1360850638268,1360850638908,4205300228,4205300868,640
1360850641,4205302964,10,7091,709.1,1360850638903,1360850638967,4205300867,4205300931,64
1360850641,4205302964,12,7931,660.9166667,1360850639030,1360850639350,4205300994,4205301314,320
1360850641,4205302964,8,1649,206.125,1360850639542,1360850639606,4205301506,4205301570,64
1360850641,4205302964,9,2357,261.8888889,1360850639541,1360850639605,4205301505,4205301569,64
1360850641,4205302964,8,1483,185.375,1360850639605,1360850639733,4205301569,4205301697,128
1360850641,4205302964,8,1707,213.375,1360850639605,1360850639797,4205301569,4205301761,192
1360850641,4205302964,8,1569,196.125,1360850639797,1360850639797,4205301761,4205301761,0
1360850649,4205310940,9,1343,149.2222222,1360850643085,1360850643085,4205305025,4205305025,0
1360850649,4205310944,10,7027,702.7,1360850643276,1360850643468,4205305220,4205305412,192
1360850649,4205310944,10,1839,183.9,1360850643084,1360850645900,4205305028,4205307844,2816
1360850649,4205310944,11,7879,716.2727273,1360850643531,1360850643787,4205305475,4205305731,256
1360850649,4205310944,9,2277,253,1360850643851,1360850643915,4205305795,4205305859,64
1360850649,4205310948,13,8095,622.6923077,1360850645256,1360850645512,4205307204,4205307460,256
1360850649,4205310948,9,1487,165.2222222,1360850645256,1360850645384,4205307204,4205307332,128
1360850649,4205310948,8,1569,196.125,1360850645320,1360850645320,4205307268,4205307268,0
1360850649,4205310948,8,1339,167.375,1360850645191,1360850645255,4205307139,4205307203,64
1360850649,4205310948,8,1499,187.375,1360850645255,1360850645511,4205307203,4205307459,256
1360850649,4205310948,8,1569,196.125,1360850645319,1360850645383,4205307267,4205307331,64
1360850649,4205310948,9,1343,149.2222222,1360850645510,1360850645574,4205307458,4205307522,64
1360850649,4205310952,10,1651,165.1,1360850643650,1360850644354,4205305602,4205306306,704
1360850649,4205310956,8,1627,203.375,1360850643521,1360850643649,4205305477,4205305605,128
1360850649,4205310956,16,11312,707,1360850639680,1360850643008,4205301636,4205304964,3328
1360850649,4205310968,8,1547,193.375,1360850644340,1360850644404,4205306308,4205306372,64
1360850649,4205310968,9,1343,149.2222222,1360850647476,1360850647476,4205309444,4205309444,0
1360850649,4205310968,15,14396,959.7333333,1360850644403,1360850645043,4205306371,4205307011,640
1360850649,4205310968,9,1503,167,1360850645234,1360850645426,4205307202,4205307394,192
1360850649,4205310968,8,1291,161.375,1360850645234,1360850645298,4205307202,4205307266,64
1360850649,4205310968,8,1569,196.125,1360850645298,1360850645298,4205307266,4205307266,0
1360850649,4205310968,8,1233,154.125,1360850645170,1360850645170,4205307138,4205307138,0
1360850649,4205310968,8,1569,196.125,1360850645234,1360850645298,4205307202,4205307266,64
1360850649,4205310968,9,1775,197.2222222,1360850645489,1360850645617,4205307457,4205307585,128
1360850655,1272037488,4,304,76,1360850630777,1360850636729,1272013265,1272019217,5952
1360850657,4205318944,10,1395,139.5,1360850649802,1360850649866,4205311746,4205311810,64
1360850657,4205318948,12,7931,660.9166667,1360850649223,1360850649415,4205311171,4205311363,192
1360850657,4205318952,8,1233,154.125,1360850649731,1360850649731,4205311683,4205311683,0
1360850657,4205318956,9,1343,149.2222222,1360850656768,1360850656832,4205318724,4205318788,64
1360850657,4205318956,8,1233,154.125,1360850656703,1360850656767,4205318659,4205318723,64
1360850657,4205318956,12,7195,599.5833333,1360850649022,1360850649086,4205310978,4205311042,64
1360850657,4205318956,8,1371,171.375,1360850648958,1360850649022,4205310914,4205310978,64
1360850657,4205318956,14,10360,740,1360850654014,1360850654334,4205315970,4205316290,320
1360850657,4205318960,9,1343,149.2222222,1360850654588,1360850654652,4205316548,4205316612,64
1360850657,4205318960,8,1233,154.125,1360850654524,1360850654588,4205316484,4205316548,64
1360850657,4205318960,8,1659,207.375,1360850649211,1360850649275,4205311171,4205311235,64
1360850657,4205318960,8,1563,195.375,1360850649275,1360850649339,4205311235,4205311299,64
1360850657,4205318960,12,10448,870.6666667,1360850649340,1360850649596,4205311300,4205311556,256
1360850657,4205318972,9,2277,253,1360850649455,1360850649455,4205311427,4205311427,0
1360850657,4205318976,14,10408,743.4285714,1360850655851,1360850656491,4205317827,4205318467,640
1360850661,1272043272,41,49238,1200.926829,1360850639311,1360850654415,1272021583,1272036687,15104
1360850663,1272045456,1,46,46,1360850636825,1360850636825,1272019281,1272019281,0
1360850665,4205327040,12,10528,877.3333333,1360850657772,1360850658028,4205319812,4205320068,256
1360850665,4205327040,12,7147,595.5833333,1360850657836,1360850657964,4205319876,4205320004,128
1360850665,4205327040,14,10632,759.4285714,1360850658091,1360850658667,4205320131,4205320707,576
1360850665,4205327044,9,2277,253,1360850658535,1360850658599,4205320579,4205320643,64
1360850665,4205327044,8,1132,141.5,1360850658919,1360850658983,4205320963,4205321027,64
1360850665,4205327044,8,1291,161.375,1360850658918,1360850658918,4205320962,4205320962,0
1360850665,4205327052,10,7827,782.7,1360850657758,1360850658014,4205319810,4205320066,256
1360850665,4205327064,12,7931,660.9166667,1360850658004,1360850658452,4205320068,4205320516,448
1360850665,4205327064,8,1643,205.375,1360850657489,1360850657489,4205319553,4205319553,0
1360850665,4205327064,11,7095,645,1360850657489,1360850657681,4205319553,4205319745,192
1360850665,4205327064,9,6159,684.3333333,1360850658709,1360850658773,4205320773,4205320837,64
1360850665,4205327068,8,1233,154.125,1360850658704,1360850658768,4205320772,4205320836,64
1360850665,4205327068,1692,2526876,1493.425532,1360850658959,1360850661071,4205321027,4205323139,2112
1360850673,4205335032,8,1643,205.375,1360850670837,1360850670837,4205332869,4205332869,0
1360850673,4205335036,13,10608,816,1360850671023,1360850671215,4205333059,4205333251,192
1360850673,4205335036,11,7891,717.3636364,1360850671023,1360850671279,4205333059,4205333315,256
1360850673,4205335036,12,7147,595.5833333,1360850671087,1360850671151,4205333123,4205333187,64
1360850673,4205335036,12,10528,877.3333333,1360850671278,1360850671470,4205333314,4205333506,192
1360850673,4205335036,10,7827,782.7,1360850668334,1360850668526,4205330370,4205330562,192
1360850673,4205335036,9,2277,253,1360850668589,1360850668589,4205330625,4205330625,0
1360850673,4205335036,8,1233,154.125,1360850669101,1360850669165,4205331137,4205331201,64
1360850673,4205335040,9,2277,253,1360850671532,1360850671596,4205333572,4205333636,64
1360850673,4205335040,9,6159,684.3333333,1360850671660,1360850671660,4205333700,4205333700,0
1360850673,4205335040,8,1052,131.5,1360850671787,1360850671851,4205333827,4205333891,64
1360850673,4205335044,12,7147,595.5833333,1360850670821,1360850670949,4205332865,4205332993,128
1360850673,4205335056,11,7143,649.3636364,1360850668059,1360850668187,4205330115,4205330243,128
1360850673,4205335056,14,10408,743.4285714,1360850668314,1360850669018,4205330370,4205331074,704
1360850673,4205335056,10,7827,782.7,1360850671257,1360850671449,4205333313,4205333505,192
1360850673,4205335056,8,1291,161.375,1360850669213,1360850669213,4205331269,4205331269,0
1360850673,4205335060,8,1233,154.125,1360850671640,1360850671640,4205333700,4205333700,0
1360850673,4205335060,10,1395,139.5,1360850671768,1360850671832,4205333828,4205333892,64
1360850681,4205343032,6004,8995610,1498.269487,1360850671861,1360850675765,4205333893,4205337797,3904
1360850695,1272077448,6,2541,423.5,1360850667040,1360850673568,1272049488,1272056016,6528
1360850700,1272081584,47,63577,1352.702128,1360850674433,1360850677185,1272056017,1272058769,2752
1360850704,1272085668,1,76,76,1360850679596,1360850679596,1272061264,1272061264,0
1360850715,1272097508,31,42566,1373.096774,1360850689826,1360850689954,1272072334,1272072462,128
1360850716,1272097560,38,52649,1385.5,1360850690776,1360850690840,1272072336,1272072400,64
1360850718,4205379784,3,586,195.3333333,1360850690731,1360850690731,4205352515,4205352515,0
1360850728,1272109584,1,52,52,1360850702144,1360850702144,1272083728,1272083728,0
1360850732,1272113556,1,52,52,1360850707164,1360850707164,1272088720,1272088720,0
1360850732,1272113556,1,52,52,1360850707164,1360850707164,1272088720,1272088720,0
1360850746,4205407892,1,52,52,1360850720639,1360850720639,4205382531,4205382531,0
1360850747,1272129524,1,52,52,1360850719761,1360850719761,1272102285,1272102285,0
1360850748,1272129572,1,52,52,1360850720714,1360850720714,1272102286,1272102286,0
1360850904,1272286056,1,61,61,1360850878756,1360850878756,1272260812,1272260812,0
1360851216,1272598352,1,76,76,1360851190905,1360851190905,1272573257,1272573257,0
1360851729,1273111040,1,76,76,1360851702182,1360851702182,1273084222,1273084222,0
1360852242,1273624120,1,76,76,1360852214097,1360852214097,1273596217,1273596217,0
1360852516,4207178268,3,586,195.3333333,1360852491796,1360852491796,4207154064,4207154064,0
1360852519,1273900952,31,42566,1373.096774,1360852491958,1360852492022,1273873910,1273873974,64
1360852519,1273901024,41,56557,1379.439024,1360852491884,1360852491948,1273873908,1273873972,64
1360852531,1273913028,13,12070,928.4615385,1360852505191,1360852508071,1273887219,1273890099,2880
1360852531,1273913028,4,1093,273.25,1360852505127,1360852505191,1273887155,1273887219,64
1360852547,1273928984,1,52,52,1360852521812,1360852521812,1273903796,1273903796,0
1360852547,1273929036,1,52,52,1360852521761,1360852521761,1273903797,1273903797,0
1360852548,4207210208,1,52,52,1360852521807,1360852521807,4207184015,4207184015,0
1360852563,1273944988,1,52,52,1360852538127,1360852538127,1273920115,1273920115,0
1360852563,1273944992,1,52,52,1360852538123,1360852538123,1273920115,1273920115,0
1360852751,1274133308,1,76,76,1360852725963,1360852725963,1274108271,1274108271,0
1360852799,1274181504,1,46,46,1360852771657,1360852771657,1274154161,1274154161,0
1360853265,1274646892,1,76,76,1360853238373,1360853238373,1274620265,1274620265,0
1360853664,1275045604,9,3952,439.1111111,1360853658560,1360853658688,1275040164,1275040292,128
1360853664,1275045608,9,3755,417.2222222,1360853659642,1360853659898,1275041250,1275041506,256
1360853664,1275045632,9,3646,405.1111111,1360853660517,1360853661029,1275042149,1275042661,512
1360853664,1275045652,9,3757,417.4444444,1360853657104,1360853658128,1275038756,1275039780,1024
1360853774,1275155664,1,76,76,1360853749570,1360853749570,1275131234,1275131234,0
1360941895,1363276988,1,52,52,1360941865591,1360941865591,1363247579,1363247579,0
1360941895,1363277228,1,46,46,1360941866117,1360941866117,1363248345,1363248345,0
1360941941,1363322516,12,4475,372.9166667,1360941915660,1360941939596,1363297176,1363321112,23936
1360941973,1363354900,1,1073,1073,1360941946702,1360941946702,1363328602,1363328602,0
1360942049,1363431264,1,46,46,1360942024477,1360942024477,1363406741,1363406741,0
1360942337,1363719184,1,52,52,1360942309164,1360942309164,1363691348,1363691348,0
1360942754,1364136220,2,96,48,1360942729346,1360942733890,1364111566,1364116110,4544
1360944314,1365696012,1,46,46,1360944289337,1360944289337,1365671349,1365671349,0
1360945002,1366383552,12,1086,90.5,1360944995771,1360944996475,1366377323,1366378027,704
1360945002,1366383592,13,1388,106.7692308,1360944998480,1360944998864,1366380072,1366380456,384
1360945002,1366383632,12,1250,104.1666667,1360944996393,1360944998313,1366378025,1366379945,1920
1360945002,1366383640,15,6998,466.5333333,1360944995169,1360944996385,1366376809,1366378025,1216
1360945020,1366401532,17,4122,242.4705882,1360944994446,1360944998350,1366375978,1366379882,3904
1360945024,1366405452,8,608,76,1360944997597,1360945011421,1366379049,1366392873,13824
1360945160,4854424,3,586,195.3333333,1360945134547,1360945134547,4828971,4828971,0
1360945160,1366541736,42,57802,1376.238095,1360945134208,1360945134464,1366515944,1366516200,256
1360945160,1366541736,31,42010,1355.16129,1360945134207,1360945134463,1366515943,1366516199,256
1360945180,1366561972,16,21066,1316.625,1360945151571,1360945151635,1366533543,1366533607,64
1360945192,4886400,1,52,52,1360945164588,1360945164588,4858988,4858988,0
1360945192,1366573880,1,52,52,1360945164080,1360945164080,1366545960,1366545960,0
1360945192,1366573880,1,52,52,1360945164079,1360945164079,1366545959,1366545959,0
1360945208,1366589888,1,52,52,1360945181672,1360945181672,1366563560,1366563560,0
1360945297,1366678996,1,46,46,1360945268152,1360945268152,1366650148,1366650148,0
1360945356,1366738108,1,76,76,1360945328776,1360945328776,1366710884,1366710884,0
1360945436,1366818192,2,120,60,1360945411507,1360945414451,1366793699,1366796643,2944
1360945870,1367251288,1,76,76,1360945842547,1360945842547,1367223835,1367223835,0
1360945926,1367307268,2,141,70.5,1360945898632,1360945898632,1367279900,1367279900,0
1360946382,1367764168,1,76,76,1360946355707,1360946355707,1367737875,1367737875,0
1360946415,1367796380,1,71,71,1360946388305,1360946388305,1367769685,1367769685,0
1360946627,1368008764,4,1064,266,1360946600782,1360946600782,1367982546,1367982546,0
1360946627,1368008848,19,21841,1149.526316,1360946600762,1360946603002,1367982610,1367984850,2240
1360946660,1368041320,1,52,52,1360946633542,1360946633542,1368014862,1368014862,0
1360946660,1368041396,1,52,52,1360946633470,1360946633470,1368014866,1368014866,0
1360946824,1368205548,1,89,89,1360946798306,1360946798306,1368179854,1368179854,0
1360946892,1368273652,1,76,76,1360946867194,1360946867194,1368248846,1368248846,0
1360946960,1368341672,28,38112,1361.142857,1360946935781,1360946935845,1368317453,1368317517,64
1360946960,1368341728,39,54162,1388.769231,1360946935725,1360946935853,1368317453,1368317581,128
1360946962,6656972,3,586,195.3333333,1360946935484,1360946935548,6630456,6630520,64
1360946990,6684944,1,52,52,1360946965528,1360946965528,6660472,6660472,0
1360946992,1368373776,1,52,52,1360946965626,1360946965626,1368347402,1368347402,0
1360946992,1368373856,1,52,52,1360946965549,1360946965549,1368347405,1368347405,0
1360947208,1368590072,1,60,60,1360947180751,1360947180751,1368562823,1368562823,0
1361038724,1460104996,1,46,46,1361038696138,1361038696138,1460077134,1460077134,0
1361039473,1460854280,1,46,46,1361039447394,1361039447394,1460828674,1460828674,0
1361040050,1461431076,1,60,60,1361040023717,1361040023717,1461404793,1461404793,0
1361040090,1461471508,2,120,60,1361040065590,1361040068598,1461447098,1461450106,3008
1361040178,1461559552,1,46,46,1361040153034,1361040153034,1461534586,1461534586,0
1361040407,1461788128,2,96,48,1361040381742,1361040384686,1461762870,1461765814,2944
1361040696,1462077432,1,46,46,1361040670650,1361040670650,1462052082,1462052082,0
1361041917,1463298368,31,25892,835.2258065,1361041892070,1361041909670,1463273438,1463291038,17600
1361041917,1463298368,9,3277,364.1111111,1361041892453,1361041916069,1463273821,1463297437,23616
1361041917,1463298368,7,1704,243.4285714,1361041892453,1361041916069,1463273821,1463297437,23616
1361041917,1463298368,6,1588,264.6666667,1361041892453,1361041916069,1463273821,1463297437,23616
1361041917,1463298432,11,7500,681.8181818,1361041892390,1361041916006,1463273822,1463297438,23616
1361041917,1463298432,7,2318,331.1428571,1361041892390,1361041916006,1463273822,1463297438,23616
1361041917,1463298432,8,3805,475.625,1361041892390,1361041916006,1463273822,1463297438,23616
1361041918,1463299872,20,19633,981.65,1361041892076,1361041892588,1463273948,1463274460,512
1361041925,1463306376,502,679455,1353.496016,1361041911964,1361041919324,1463293340,1463300700,7360
1361041926,1463307880,4,968,242,1361041898982,1361041899110,1463280862,1463280990,128
1361041926,1463307884,3,540,180,1361041899108,1361041899172,1463280992,1463281056,64
1361041926,1463307928,22,12540,570,1361041901302,1361041912630,1463283230,1463294558,11328
1361041926,1463307928,3,540,180,1361041899061,1361041899125,1463280989,1463281053,64
1361041926,1463307932,3,540,180,1361041899059,1361041899123,1463280991,1463281055,64
1361041935,1463315956,11,4654,423.0909091,1361041910081,1361041910337,1463291037,1463291293,256
1361041938,1463319908,7,3234,462,1361041912585,1361041912905,1463294493,1463294813,320
1361041938,1463319908,8,3878,484.75,1361041912200,1361041915592,1463294108,1463297500,3392
1361041938,1463319912,39,20154,516.7692308,1361041912775,1361041924167,1463294687,1463306079,11392
1361041939,1463319984,80,95919,1198.9875,1361041913703,1361041918311,1463294687,1463299295,4608
1361041941,1463322384,25,11395,455.8,1361041914324,1361041916500,1463295708,1463297884,2176
1361041942,1463323888,5,860,172,1361041916572,1361041916636,1463298460,1463298524,64
1361041942,1463323936,10,6117,611.7,1361041915501,1361041916525,1463297437,1463298461,1024
1361041942,1463323936,9,4678,519.7777778,1361041915564,1361041916524,1463297500,1463298460,960
1361041943,1463323968,5,905,181,1361041917493,1361041917557,1463298461,1463298525,64
1361041943,1463324016,13,11183,860.2307692,1361041916551,1361041916743,1463297567,1463297759,192
1361041943,1463324016,10,3524,352.4,1361041916742,1361041917254,1463297758,1463298270,512
1361041954,1463335884,5,634,126.8,1361041927394,1361041927458,1463309278,1463309342,64
1361041965,1463346508,302,354388,1173.470199,1361041909847,1361041961879,1463291355,1463343387,52032
1361041965,1463346516,112,133046,1187.910714,1361041913043,1361041961875,1463294559,1463343391,48832
1361041965,1463346536,196,251242,1281.846939,1361041912957,1361041961789,1463294493,1463343325,48832
1361041965,1463346592,2,104,52,1361041961732,1361041961988,1463343324,1463343580,256
1361041965,1463346592,4,220,55,1361041961732,1361041961796,1463343324,1463343388,64
1361041965,1463346592,3,168,56,1361041961732,1361041961796,1463343324,1463343388,64
1361041979,1463360200,2,535,267.5,1361041953293,1361041976141,1463334493,1463357341,22848
1361041987,1463368216,2,104,52,1361041962109,1361041962109,1463343325,1463343325,0
1361041987,1463368216,1,52,52,1361041962109,1361041962109,1463343325,1463343325,0
1361041987,1463368216,1,52,52,1361041962109,1361041962109,1463343325,1463343325,0
1361041987,1463368216,1,52,52,1361041962109,1361041962109,1463343325,1463343325,0
1361041987,1463368216,1,52,52,1361041962108,1361041962108,1463343324,1463343324,0
1361041987,1463368216,2,104,52,1361041962108,1361041962108,1463343324,1463343324,0
1361041987,1463368216,1,52,52,1361041962108,1361041962108,1463343324,1463343324,0
1361041987,1463368216,1,46,46,1361041962172,1361041962172,1463343388,1463343388,0
1361041987,1463368216,1,52,52,1361041962172,1361041962172,1463343388,1463343388,0
1361041987,1463368288,1,52,52,1361041962036,1361041962036,1463343324,1463343324,0
1361041987,1463368288,1,52,52,1361041962036,1361041962036,1463343324,1463343324,0
1361041987,1463368288,1,52,52,1361041962035,1361041962035,1463343323,1463343323,0
1361041987,1463368288,2,104,52,1361041962035,1361041962035,1463343323,1463343323,0
1361041987,1463368292,1,52,52,1361041962031,1361041962031,1463343323,1463343323,0
1361041987,1463368292,3,138,46,1361041962031,1361041962095,1463343323,1463343387,64
1361041991,1463372248,10,2549,254.9,1361041963998,1361041968414,1463345246,1463349662,4416
1361041991,1463372304,26,7566,291,1361041963687,1361041977895,1463344991,1463359199,14208
1361041991,1463372308,14,14063,1004.5,1361041963935,1361041963999,1463345243,1463345307,64
1361041995,1463376216,7,957,136.7142857,1361041968125,1361041969981,1463349341,1463351197,1856
1361041995,1463376216,6,1194,199,1361041968125,1361041968189,1463349341,1463349405,64
1361041995,1463376252,12,3127,260.5833333,1361041970263,1361041970519,1463351515,1463351771,256
1361041995,1463376284,8,1235,154.375,1361041968055,1361041968247,1463349339,1463349531,192
1361041995,1463376324,23,7830,340.4347826,1361041969618,1361041970706,1463350942,1463352030,1088
1361041995,1463376328,12,3127,260.5833333,1361041970127,1361041970447,1463351455,1463351775,320
1361041995,1463376328,10,2020,202,1361041970124,1361041970380,1463351452,1463351708,256
1361041995,1463376328,9,2645,293.8888889,1361041970188,1361041970636,1463351516,1463351964,448
1361042011,1463392392,14,12990,927.8571429,1361041983438,1361042010318,1463364830,1463391710,26880
1361042013,1463394516,3,168,56,1361042007503,1361042007503,1463389019,1463389019,0
1361042013,1463394520,3,168,56,1361042007502,1361042007502,1463389022,1463389022,0
1361042013,1463394520,3,168,56,1361042007501,1361042007501,1463389021,1463389021,0
1361042013,1463394520,3,168,56,1361042007501,1361042007501,1463389021,1463389021,0
1361042013,1463394568,3,168,56,1361042007454,1361042007454,1463389022,1463389022,0
1361042013,1463394568,3,150,50,1361042007454,1361042007454,1463389022,1463389022,0
1361042013,1463394568,3,168,56,1361042007454,1361042007454,1463389022,1463389022,0
1361042035,1463416328,2,104,52,1361042007692,1361042007692,1463389020,1463389020,0
1361042035,1463416328,1,52,52,1361042007691,1361042007691,1463389019,1463389019,0
1361042035,1463416380,1,52,52,1361042007639,1361042007639,1463389019,1463389019,0
1361042035,1463416380,1,52,52,1361042007639,1361042007639,1463389019,1463389019,0
1361042037,1463418536,15,1985,132.3333333,1361042017019,1361042034683,1463398555,1463416219,17664
1361042053,1463434616,178,219550,1233.426966,1361042017258,1361042045546,1463398874,1463427162,28288
1361042059,1463440400,18,3178,176.5555556,1361042034820,1361042047812,1463416220,1463429212,12992
1361042067,1463448400,2,208,104,1361042039171,1361042064259,1463420571,1463445659,25088
1361042069,1463450548,4,220,55,1361042068208,1361042068272,1463449756,1463449820,64
1361042095,1463476452,11,1174,106.7272727,1361042068302,1361042094798,1463449754,1463476250,26496
1361042095,1463476456,1,46,46,1361042068493,1361042068493,1463449949,1463449949,0
1361042115,1463496472,1,104,104,1361042089402,1361042089402,1463470874,1463470874,0
1361042123,1463504404,8,1006,125.75,1361042094847,1361042095167,1463476251,1463476571,320
1361042125,1463506568,348,439728,1263.586207,1361042045594,1361042124698,1463427162,1463506266,79104
1361042125,1463506644,3,168,56,1361042124622,1361042124622,1463506266,1463506266,0
1361042143,1463524700,5,462,92.4,1361042118741,1361042119061,1463500441,1463500761,320
1361042149,1463530568,4,277,69.25,1361042144345,1361042144409,1463525913,1463525977,64
1361042157,101851692,15,16881,1125.4,1361042149760,1361042149824,101844452,101844516,64
1361042157,101851692,7,3210,458.5714286,1361042150080,1361042150080,101844772,101844772,0
1361042157,101851696,15,16881,1125.4,1361042151678,1361042151742,101846374,101846438,64
1361042157,1463538576,16,7038,439.875,1361042155985,1361042156497,1463537561,1463538073,512
1361042157,1463538580,11,1040,94.54545455,1361042156431,1361042156687,1463538011,1463538267,256
1361042157,1463538580,20,10892,544.6,1361042149966,1361042150350,1463531546,1463531930,384
1361042157,1463538584,11,1282,116.5454545,1361042150348,1361042150540,1463531932,1463532124,192
1361042157,1463538584,18,9441,524.5,1361042150348,1361042151052,1463531932,1463532636,704
1361042157,1463538612,14,2361,168.6428571,1361042151149,1361042151533,1463532761,1463533145,384
1361042157,1463538620,14,2374,169.5714286,1361042151720,1361042155624,1463533340,1463537244,3904
1361042157,1463538620,16,7165,447.8125,1361042149925,1361042150309,1463531545,1463531929,384
1361042157,1463538628,8,2684,335.5,1361042150560,1361042150752,1463532188,1463532380,192
1361042157,1463538632,13,2547,195.9230769,1361042154201,1361042155673,1463535833,1463537305,1472
1361042165,1463546576,16,2691,168.1875,1361042155920,1361042158224,1463537496,1463539800,2304
1361042165,1463546580,13,1302,100.1538462,1361042156686,1361042158094,1463538266,1463539674,1408
1361042165,1463546580,13,1388,106.7692308,1361042158222,1361042158542,1463539802,1463540122,320
1361042165,1463546608,19,4611,242.6842105,1361042159284,1361042160564,1463540892,1463542172,1280
1361042171,1463552740,6,822,137,1361042144174,1361042144430,1463525914,1463526170,256
1361042179,1463560744,15,3688,245.8666667,1361042151017,1361042157801,1463532761,1463539545,6784
1361042179,1463560788,9,1073,119.2222222,1361042154494,1361042154750,1463536282,1463536538,256
1361042179,1463560876,4,1339,334.75,1361042153832,1361042153832,1463535708,1463535708,0
1361042189,1463570668,4,220,55,1361042184567,1361042184631,1463566235,1463566299,64
1361042197,1463578708,103,138958,1349.106796,1361042161871,1361042193999,1463543579,1463575707,32128
1361042199,1463580832,1,104,104,1361042173841,1361042173841,1463555673,1463555673,0
1361042219,1463600880,1,52,52,1361042193825,1361042193825,1463575705,1463575705,0
1361042221,1463602660,13,1293,99.46153846,1361042198462,1361042214590,1463580122,1463596250,16128
1361042227,1463608904,1,104,104,1361042201481,1361042201481,1463583385,1463583385,0
1361042229,1463610684,12,1328,110.6666667,1361042223396,1361042223588,1463605080,1463605272,192
1361042240,1463620984,20,2612,130.6,1361042215266,1361042238114,1463596250,1463619098,22848
1361042245,1463626652,5,309,61.8,1361042237060,1361042237124,1463618712,1463618776,64
1361042255,1463636916,3,653,217.6666667,1361042229949,1361042241725,1463611865,1463623641,11776
1361042269,1463650652,4,220,55,1361042267205,1361042267269,1463648857,1463648921,64
1361042296,1463677140,1,104,104,1361042269125,1361042269125,1463650265,1463650265,0
1361042300,1463681104,8,996,124.5,1361042275112,1361042275432,1463656216,1463656536,320
1361042309,1463690672,4,220,55,1361042304560,1361042304560,1463686232,1463686232,0
1361042324,1463705124,1,104,104,1361042298387,1361042298387,1463679511,1463679511,0
1361042352,1463733160,1,104,104,1361042326831,1361042326831,1463707991,1463707991,0
1361042357,1463738756,12,1216,101.3333333,1361042334493,1361042355037,1463716249,1463736793,20544
1361042357,1463738764,6,674,112.3333333,1361042354964,1361042354964,1463736728,1463736728,0
1361042380,1463761228,11,1656,150.5454545,1361042355498,1361042360362,1463736726,1463741590,4864
1361042392,1463773236,1,76,76,1361042367268,1361042367268,1463748504,1463748504,0
1361042416,1463797276,2,208,104,1361042388028,1361042412604,1463769304,1463793880,24576
1361042420,1463801252,10,2943,294.3,1361042394963,1361042395411,1463776215,1463776663,448
1361042429,1463810760,4,220,55,1361042424469,1361042424469,1463806229,1463806229,0
1361042464,1463845620,3,659,219.6666667,1361042436961,1361042441633,1463818581,1463823253,4672
1361042468,1463849648,14,1814,129.5714286,1361042441991,1361042455047,1463823639,1463836695,13056
1361042485,1463866772,4,220,55,1361042484490,1361042484490,1463866262,1463866262,0
1361042496,1463877692,2,208,104,1361042470168,1361042494296,1463851860,1463875988,24128
1361042540,1463921680,10,1160,116,1361042514531,1361042515107,1463896211,1463896787,576
1361042548,1463929732,2,181,90.5,1361042522608,1361042522608,1463904340,1463904340,0
1361042549,1463930784,4,220,55,1361042544446,1361042544446,1463926230,1463926230,0
1361042576,1463957752,1,104,104,1361042549725,1361042549725,1463931477,1463931477,0
1361042601,1463982068,12,2398,199.8333333,1361042575175,1361042578247,1463956243,1463959315,3072
1361042605,1463986060,1,104,104,1361042577362,1361042577362,1463958422,1463958422,0
1361042605,1463986812,6,406,67.66666667,1361042604385,1361042604449,1463986197,1463986261,64
1361042605,1463986852,4,220,55,1361042604343,1361042604407,1463986195,1463986259,64
1361042633,1464014148,9,1433,159.2222222,1361042605046,1361042611062,1463986194,1463992210,6016
1361042661,1464042192,19,2519,132.5789474,1361042635018,1361042650954,1464016210,1464032146,15936
1361042661,1464042196,1,104,104,1361042635398,1361042635398,1464016594,1464016594,0
1361042685,1464066856,3,156,52,1361042677169,1361042677169,1464059025,1464059025,0
1361042689,1464070120,1,104,104,1361042661460,1361042661460,1464042580,1464042580,0
1361042717,1464098108,3,659,219.6666667,1361042689054,1361042693214,1464070162,1464074322,4160
1361042721,1464102252,8,1006,125.75,1361042694991,1361042695247,1464076243,1464076499,256
1361042725,1464106860,4,220,55,1361042724399,1361042724399,1464106259,1464106259,0
1361042749,1464130272,1,104,104,1361042722491,1361042722491,1464103763,1464103763,0
1361042777,1464158556,1,104,104,1361042751134,1361042751134,1464132690,1464132690,0
1361042781,1464162620,8,1006,125.75,1361042754587,1361042755163,1464136207,1464136783,576
1361042789,1464170900,4,220,55,1361042784325,1361042784325,1464166225,1464166225,0
1361042805,1464186560,3,285,95,1361042778327,1361042803863,1464159887,1464185423,25536
1361042837,1464218916,7,483,69,1361042830005,1361042830069,1464211921,1464211985,64
1361042838,1464218964,13,1303,100.2307692,1361042815278,1361042831022,1464196242,1464211986,15744
1361042857,1464238552,7,884,126.2857143,1361042830431,1361042831007,1464211983,1464212559,576
1361042885,1464266620,3,285,95,1361042857305,1361042881433,1464238925,1464263053,24128
1361042901,1464282676,8,1006,125.75,1361042874532,1361042874852,1464256208,1464256528,320
1361042905,1464286644,1,48,48,1361042879684,1361042879684,1464261328,1464261328,0
1361042905,1464286732,1,76,76,1361042879787,1361042879787,1464261519,1464261519,0
1361042910,1464291064,1,48,48,1361042883337,1361042883337,1464264401,1464264401,0
1361042910,1464291228,4,220,55,1361042904995,1361042904995,1464286223,1464286223,0
1361042918,1464299208,9,3757,417.4444444,1361042915576,1361042915896,1464296784,1464297104,320
1361042918,1464299272,9,3952,439.1111111,1361042916855,1361042917047,1464298127,1464298319,192
1361042926,1464306948,31,39523,1274.935484,1361042899708,1361042899836,1464280656,1464280784,128
1361042926,1464307104,37,49596,1340.432432,1361042899550,1361042899678,1464280654,1464280782,128
1361042926,1464307180,9,3755,417.2222222,1361042918033,1361042918289,1464299213,1464299469,256
1361042926,1464307228,9,3646,405.1111111,1361042918948,1361042919396,1464300176,1464300624,448
1361042926,102621052,3,586,195.3333333,1361042898780,1361042898780,102593832,102593832,0
1361042934,1464315104,1,104,104,1361042909086,1361042909086,1464290190,1464290190,0
1361042942,1464322968,15,2100,140,1361042916582,1361042935270,1464297550,1464316238,18688
1361042942,1464323144,8,3572,446.5,1361042917432,1361042918328,1464298576,1464299472,896
1361042942,1464323188,11,1535,139.5454545,1361042918281,1361042935049,1464299469,1464316237,16768
1361042942,1464323188,11,1506,136.9090909,1361042918348,1361042935052,1464299536,1464316240,16704
1361042954,1464334952,1,52,52,1361042929720,1361042929720,1464310672,1464310672,0
1361042954,1464335048,1,52,52,1361042929622,1361042929622,1464310670,1464310670,0
1361042955,102649376,1,52,52,1361042929473,1361042929473,102623849,102623849,0
1361042962,1464343056,13,4953,381,1361042935181,1361042947853,1464316237,1464328909,12672
1361042962,1464343092,2,181,90.5,1361042937001,1361042937001,1464318093,1464318093,0
1361042974,1464354948,2,104,52,1361042948025,1361042948025,1464328973,1464328973,0
1361042974,1464354948,5,904,180.8,1361042948025,1361042948089,1464328973,1464329037,64
1361042990,1464371072,2,181,90.5,1361042964096,1361042964096,1464345168,1464345168,0
1361042998,1464379168,4,220,55,1361042995165,1361042995165,1464376333,1464376333,0
1361043002,1464383040,13,4631,356.2307692,1361042974878,1361042975134,1464355918,1464356174,256
1361043018,1464399116,1,104,104,1361042993106,1361042993106,1464374222,1464374222,0
1361043022,1464403112,8,996,124.5,1361042995220,1361042995540,1464376332,1464376652,320
1361043031,1464412084,3,168,56,1361043025201,1361043025265,1464406285,1464406349,64
1361043031,1464412084,3,168,56,1361043025201,1361043025265,1464406285,1464406349,64
1361043046,1464427052,1,105,105,1361043021201,1361043021201,1464402253,1464402253,0
1361043050,1464431056,2,104,52,1361043025229,1361043025229,1464406285,1464406285,0
1361043062,1464443036,15,4203,280.2,1361043036515,1361043055203,1464417551,1464436239,18688
1361043074,1464455112,6,435,72.5,1361043048403,1361043073043,1464429515,1464454155,24640
1361043082,1464463120,18,3456,192,1361043055116,1361043073228,1464436236,1464454348,18112
1361043086,1464467072,6,1550,258.3333333,1361043061310,1361043069054,1464442382,1464450126,7744
1361043102,1464483212,21,10484,499.2380952,1361043076015,1361043085295,1464457227,1464466507,9280
1361043110,1464491184,11,1483,134.8181818,1361043085068,1361043109132,1464466252,1464490316,24064
1361043110,1464491412,4,220,55,1361043108905,1361043108905,1464490317,1464490317,0
1361043118,1464498992,6,1042,173.6666667,1361043090060,1361043113996,1464471052,1464494988,23936
1361043118,1464498992,7,960,137.1428571,1361043090059,1361043113995,1464471051,1464494987,23936
1361043118,1464499072,2,104,52,1361043089980,1361043089980,1464471052,1464471052,0
1361043126,1464507108,3,283,94.33333333,1361043099030,1361043099286,1464480138,1464480394,256
1361043142,1464523128,8,1463,182.875,1361043113857,1361043140737,1464494985,1464521865,26880
1361043142,1464523396,11,1486,135.0909091,1361043117944,1361043140536,1464499340,1464521932,22592
1361043154,1464535052,2,210,105,1361043126671,1361043151695,1464507723,1464532747,25024
1361043166,1464547200,5,1558,311.6,1361043140669,1361043140733,1464521869,1464521933,64
1361043166,1464547200,11,3359,305.3636364,1361043140669,1361043141437,1464521869,1464522637,768
1361043170,1464551176,12,4181,348.4166667,1361043142995,1361043143315,1464524171,1464524491,320
1361043174,1464555412,3,168,56,1361043172327,1361043172391,1464553739,1464553803,64
1361043174,1464555460,301,321520,1068.172757,1361043108854,1361043172342,1464490314,1464553802,63488
1361043198,1464579204,22,3130,142.2727273,1361043172533,1361043186613,1464553737,1464567817,14080
1361043206,1464587116,5,812,162.4,1361043180495,1361043192399,1464561611,1464573515,11904
1361043222,1464603404,3,168,56,1361043216176,1361043216240,1464597580,1464597644,64
1361043222,1464603448,3,168,56,1361043216132,1361043216196,1464597580,1464597644,64
1361043242,1464623208,2,104,52,1361043216369,1361043216369,1464597577,1464597577,0
1361043246,1464627204,2,182,91,1361043220599,1361043220599,1464601803,1464601803,0
1361043262,1464643268,14,1746,124.7142857,1361043234997,1361043261365,1464616265,1464642633,26368
1361043278,1464659244,6,895,149.1666667,1361043250383,1361043250383,1464631627,1464631627,0
1361043286,1464667424,18,3995,221.9444444,1361043261081,1361043279001,1464642505,1464660425,17920
1361043286,1464667532,5,330,66,1361043278831,1361043278895,1464660363,1464660427,64
1361043306,1464687296,7,885,126.4285714,1361043279127,1361043279383,1464660423,1464660679,256
1361043322,1464703312,9,5199,577.6666667,1361043296074,1361043306826,1464677386,1464688138,10752
1361043322,1464703312,6,1484,247.3333333,1361043296137,1361043306825,1464677449,1464688137,10688
1361043322,1464703392,12,3122,260.1666667,1361043296057,1361043306489,1464677449,1464687881,10432
1361043326,1464707568,3,168,56,1361043321928,1361043322056,1464703496,1464703624,128
1361043326,1464707608,171,187335,1095.526316,1361043293346,1361043322146,1464674954,1464703754,28800
1361043334,1464715316,5,913,182.6,1361043306821,1361043306885,1464688137,1464688201,64
1361043334,1464715408,5,964,192.8,1361043306727,1361043306791,1464688135,1464688199,64
1361043334,1464715432,5,915,183,1361043306706,1361043306770,1464688138,1464688202,64
1361043334,1464715432,5,1001,200.2,1361043306770,1361043306770,1464688202,1464688202,0
1361043334,1464715432,3,367,122.3333333,1361043306833,1361043323473,1464688265,1464704905,16640
1361043350,1464731388,37,12128,327.7837838,1361043322110,1361043347774,1464703498,1464729162,25664
1361043350,1464731388,12,1564,130.3333333,1361043322618,1361043347578,1464704006,1464728966,24960
1361043366,1464747660,12,1266,105.5,1361043347309,1361043365229,1464728969,1464746889,17920
1361043374,1464755380,1,52,52,1361043347910,1361043347910,1464729290,1464729290,0
1361043374,1464755380,1,52,52,1361043347909,1361043347909,1464729289,1464729289,0
1361043374,1464755380,6,1439,239.8333333,1361043347909,1361043357317,1464729289,1464738697,9408
1361043374,1464755392,1,105,105,1361043349558,1361043349558,1464730950,1464730950,0
1361043374,1464755460,2,104,52,1361043347828,1361043347828,1464729288,1464729288,0
1361043374,1464755460,1,52,52,1361043347828,1361043347828,1464729288,1464729288,0
1361043374,1464755460,1,52,52,1361043347828,1361043347828,1464729288,1464729288,0
1361043374,1464755460,1,52,52,1361043347828,1361043347828,1464729288,1464729288,0
1361043382,1464763548,5,894,178.8,1361043357146,1361043357210,1464738694,1464738758,64
1361043382,1464763588,44,12510,284.3181818,1361043354803,1361043375667,1464736391,1464757255,20864
1361043390,1464771400,10,1922,192.2,1361043365488,1361043371632,1464746888,1464753032,6144
1361043402,1464783552,2,210,105,1361043374102,1361043398422,1464755654,1464779974,24320
1361043414,1464795824,4,761,190.25,1361043386055,1361043387207,1464767879,1464769031,1152
1361043418,1464799724,1,76,76,1361043391786,1361043391786,1464773510,1464773510,0
1361043422,1464803872,4,220,55,1361043414358,1361043414422,1464796230,1464796294,64
1361043422,1464803920,3,168,56,1361043414313,1361043414377,1464796233,1464796297,64
1361043430,1464811864,9,1847,205.2222222,1361043405022,1361043405278,1464786886,1464787142,256
1361043442,1464823816,8,1008,126,1361043414416,1361043414736,1464796232,1464796552,320
1361043447,1464828048,3,168,56,1361043445197,1361043445197,1464826245,1464826245,0
1361043447,1464828052,3,168,56,1361043445197,1361043445261,1464826249,1464826313,64
1361043450,1464831768,3,540,180,1361043423487,1361043426559,1464805255,1464808327,3072
1361043470,1464851776,2,104,52,1361043444470,1361043444470,1464826246,1464826246,0
1361043470,1464851780,1,52,52,1361043444465,1361043444465,1464826245,1464826245,0
1361043478,1464859920,2,182,91,1361043453286,1361043453286,1464835206,1464835206,0
1361043487,1464868028,6,407,67.83333333,1361043481248,1361043481248,1464862276,1464862276,0
1361043506,1464887820,42,38259,910.9285714,1361043480713,1361043484553,1464862533,1464866373,3840
1361043506,1464887904,7,885,126.4285714,1361043480374,1361043480694,1464862278,1464862598,320
1361043522,1464903856,12,4066,338.8333333,1361043496935,1361043497255,1464878791,1464879111,320
1361043527,1464908020,4,220,55,1361043522985,1361043522985,1464904005,1464904005,0
1361043527,1464908068,142,141192,994.3098592,1361043479931,1361043522939,1464860999,1464904007,43008
1361043527,1464908104,4,220,55,1361043526612,1361043526612,1464907716,1464907716,0
1361043534,1464915832,1,105,105,1361043506558,1361043506558,1464888390,1464888390,0
1361043542,1464923904,1,46,46,1361043516853,1361043516853,1464898757,1464898757,0
1361043543,1464924024,31,27080,873.5483871,1361043524199,1361043541351,1464905223,1464922375,17152
1361043550,1464931792,80,65416,817.7,1361043522213,1361043546597,1464904005,1464928389,24384
1361043554,1464935836,19,4041,212.6842105,1361043525882,1361043529530,1464907718,1464911366,3648
1361043562,1464943836,2,210,105,1361043533946,1361043559610,1464915782,1464941446,25664
1361043567,1464948232,10,1620,162,1361043541332,1361043564052,1464922564,1464945284,22720
1361043567,1464948316,11,1449,131.7272727,1361043541058,1361043563970,1464922374,1464945286,22912
1361043567,1464948316,11,1523,138.4545455,1361043541057,1361043563969,1464922373,1464945285,22912
1361043567,1464948436,4,220,55,1361043563847,1361043563847,1464945283,1464945283,0
1361043583,1464964264,4,220,55,1361043581110,1361043581110,1464962374,1464962374,0
1361043591,1464972364,19,6218,327.2631579,1361043563923,1361043584147,1464945287,1464965511,20224
1361043591,1464972444,18,4916,273.1111111,1361043563840,1361043584064,1464945284,1464965508,20224
1361043603,1464984360,10,2259,225.9,1361043575061,1361043584213,1464956421,1464965573,9152
1361043603,1464984436,10,2254,225.4,1361043574983,1361043583879,1464956419,1464965315,8896
1361043607,1464988372,9,1359,151,1361043581000,1361043581192,1464962372,1464962564,192
1361043611,1464992376,1,105,105,1361043585859,1361043585859,1464967235,1464967235,0
1361043615,1464996200,4,220,55,1361043606963,1361043606963,1464988163,1464988163,0
1361043615,1464996200,3,168,56,1361043606963,1361043606963,1464988163,1464988163,0
1361043619,1465000476,10,2942,294.2,1361043594016,1361043606880,1464975492,1464988356,12864
1361043619,1465000476,3,1019,339.6666667,1361043594015,1361043594271,1464975491,1464975747,256
1361043639,1465020180,4,220,55,1361043637000,1361043637000,1465018180,1465018180,0
1361043639,1465020180,3,168,56,1361043637000,1361043637000,1465018180,1465018180,0
1361043639,1465020248,4,220,55,1361043636933,1361043636933,1465018181,1465018181,0
1361043643,1465024456,4,364,91,1361043615540,1361043639796,1464996996,1465021252,24256
1361043663,1465044460,1,56,56,1361043634928,1361043634928,1465016388,1465016388,0
1361043671,1465052164,13,4151,319.3076923,1361043644057,1361043667097,1465025221,1465048261,23040
1361043691,1465072488,8,1008,126,1361043666771,1361043667027,1465048259,1465048515,256
1361043695,1465076432,1,105,105,1361043669132,1361043669132,1465050564,1465050564,0
1361043703,1465084244,3,168,56,1361043697031,1361043697031,1465078275,1465078275,0
1361043723,1465104616,7,537,76.71428571,1361043697940,1361043722260,1465079556,1465103876,24320
1361043747,1465128644,7,885,126.4285714,1361043722296,1361043722552,1465103940,1465104196,256
1361043751,1465132632,8,1008,126,1361043726529,1361043726849,1465108161,1465108481,320
1361043759,1465140212,4,220,55,1361043756966,1361043756966,1465138178,1465138178,0
1361043775,1465156696,3,287,95.66666667,1361043747778,1361043774786,1465129474,1465156482,27008
1361043803,1465184608,21,4438,211.3333333,1361043776345,1361043786777,1465157953,1465168385,10432
1361043815,1465196296,4,220,55,1361043813778,1361043813842,1465195074,1465195138,64
1361043831,1465212648,1,105,105,1361043803890,1361043803890,1465185538,1465185538,0
1361043839,1465220684,16,6865,429.0625,1361043813451,1361043836619,1465195135,1465218303,23168
1361043839,1465220760,16,4917,307.3125,1361043813377,1361043836545,1465195137,1465218305,23168
1361043847,1465228256,12,1668,139,1361043823993,1361043843641,1465205249,1465224897,19648
1361043851,1465232760,11,2426,220.5454545,1361043823489,1361043836417,1465205249,1465218177,12928
1361043855,1465236252,4,208,52,1361043854780,1361043854844,1465236032,1465236096,64
1361043855,1465236680,4,220,55,1361043854351,1361043854415,1465236031,1465236095,64
1361043855,1465236772,1,105,105,1361043830772,1361043830772,1465212544,1465212544,0
1361043880,1465261096,1,46,46,1361043854745,1361043854745,1465235841,1465235841,0
1361043883,1465264672,27,22426,830.5925926,1361043854937,1361043869593,1465236609,1465251265,14656
1361043883,1465264716,3,287,95.66666667,1361043856877,1361043881389,1465238593,1465263105,24512
1361043887,1465268228,4,220,55,1361043885781,1361043885845,1465267009,1465267073,64
1361043911,1465292872,16,10001,625.0625,1361043885454,1361043892110,1465267326,1465273982,6656
1361043919,1465300456,4,220,55,1361043914993,1361043915057,1465296449,1465296513,64
1361043931,1465312860,1,76,76,1361043903643,1361043903643,1465285503,1465285503,0
1361043931,1465312904,1,105,105,1361043906224,1361043906224,1465288128,1465288128,0
1361043935,1465316432,11,1580,143.6363636,1361043916104,1361043933256,1465297536,1465314688,17152
1361043939,1465320884,4,1061,265.25,1361043914307,1361043914371,1465296191,1465296255,64
1361043947,1465328780,14,14146,1010.428571,1361043919914,1361043920874,1465301694,1465302654,960
1361043959,1465340452,20,13379,668.95,1361043934194,1361043954290,1465315646,1465335742,20096
1361043959,1465340828,2,210,105,1361043931772,1361043956220,1465313600,1465338048,24448
1361043975,1465356820,1,52,52,1361043950852,1361043950852,1465332672,1465332672,0
1361043975,1465356892,1,52,52,1361043950778,1361043950778,1465332670,1465332670,0
1361043979,1465360908,7,3033,433.2857143,1361043954347,1361043954539,1465336255,1465336447,192
1361043980,1465360984,44,28754,653.5,1361043955271,1361043979015,1465336255,1465359999,23744
1361043983,1465364460,5,302,60.4,1361043976938,1361043976938,1465358398,1465358398,0
1361043983,1465364464,4,294,73.5,1361043980521,1361043980521,1465361985,1465361985,0
1361043984,1465364964,10,1904,190.4,1361043958748,1361043958940,1465339712,1465339904,192
1361044003,1465384916,9,3028,336.4444444,1361043977571,1361043977827,1465359487,1465359743,256
1361044003,1465384924,13,2622,201.6923077,1361043978332,1361043979420,1465360256,1465361344,1088
1361044004,1465384968,50,32281,645.62,1361043978198,1361044001814,1465359166,1465382782,23616
1361044032,1465412944,52,46152,887.5384615,1361044007792,1361044030320,1465388736,1465411264,22528
1361044036,1465416936,3,285,95,1361044009911,1361044034487,1465390847,1465415423,24576
1361044055,1465436500,13,1303,100.2307692,1361044038848,1361044054272,1465420348,1465435772,15424
1361044088,1465468996,1,104,104,1361044062458,1361044062458,1465443454,1465443454,0
1361044116,1465496948,3,285,95,1361044089257,1361044115241,1465470205,1465496189,25984
1361044127,1465508520,270,224953,833.1592593,1361044031534,1361044123310,1465413054,1465504830,91776
1361044159,1465540480,12,3544,295.3333333,1361044131732,1361044152788,1465513212,1465534268,21056
1361044159,1465540524,13,1303,100.2307692,1361044131561,1361044152745,1465513085,1465534269,21184
1361044172,1465553056,2,208,104,1361044144252,1361044170108,1465525308,1465551164,25856
1361044196,1465577144,46,15249,331.5,1361044167908,1361044193764,1465549052,1465574908,25856
1361044220,1465601124,1,52,52,1361044195384,1361044195384,1465576508,1465576508,0
1361044220,1465601200,5,718,143.6,1361044194859,1361044195115,1465576059,1465576315,256
1361044224,1465605324,33,10794,327.0909091,1361044195821,1361044223469,1465577145,1465604793,27648
1361044224,1465605368,1,52,52,1361044198533,1361044198533,1465579901,1465579901,0
1361044244,1465625464,1,52,52,1361044218338,1361044218338,1465599802,1465599802,0
1361044248,1465629504,1,104,104,1361044220538,1361044220538,1465602042,1465602042,0
1361044252,1465633504,46,31366,681.8695652,1361044225722,1361044243450,1465607226,1465624954,17728
1361044276,1465657468,1,104,104,1361044250397,1361044250397,1465631865,1465631865,0
1361044284,1465665432,32,10674,333.5625,1361044256514,1361044281346,1465637946,1465662778,24832
1361044304,1465685496,4,730,182.5,1361044276801,1361044302785,1465658297,1465684281,25984
1361044316,1465697564,40,38227,955.675,1361044291710,1361044315838,1465673274,1465697402,24128
1361044344,1465725448,72,80743,1121.430556,1361044315952,1361044343856,1465697400,1465725304,27904
1361044352,1465733444,4,752,188,1361044327412,1361044332276,1465708856,1465713720,4864
1361044384,1465765756,2,181,90.5,1361044359102,1361044359102,1465740858,1465740858,0
1361044412,1465793756,2,208,104,1361044384571,1361044409403,1465766327,1465791159,24832
1361044423,1465804672,7,902,128.8571429,1361044416590,1361044416782,1465798262,1465798454,192
1361044423,1465804684,2,92,46,1361044418178,1361044418178,1465799862,1465799862,0
1361044423,1465804708,243,248642,1023.218107,1361044343788,1361044420780,1465725496,1465802488,76992
1361044439,1465820684,14,1344,96,1361044419139,1361044435715,1465800823,1465817399,16576
1361044444,1465825792,1,76,76,1361044417686,1361044417686,1465799478,1465799478,0
1361044444,1465825824,22,5667,257.5909091,1361044418488,1361044420216,1465800312,1465802040,1728
1361044444,1465825876,7,952,136,1361044418052,1361044418180,1465799928,1465800056,128
1361044444,1465825908,36,31649,879.1388889,1361044418726,1361044432102,1465800634,1465814010,13376
1361044463,1465844696,4,220,55,1361044458358,1361044458358,1465840054,1465840054,0
1361044473,1465853932,1,104,104,1361044447603,1361044447603,1465828535,1465828535,0
1361044479,1465860708,6,431,71.83333333,1361044474411,1361044477931,1465856119,1465859639,3520
1361044505,1465885940,31,27737,894.7419355,1361044479788,1361044480236,1465860728,1465861176,448
1361044505,1465885968,7,2891,413,1361044480336,1361044480528,1465861304,1465861496,192
1361044505,1465886004,10,2447,244.7,1361044478506,1361044480682,1465859510,1465861686,2176
1361044511,1465892700,7852,8226289,1047.667983,1361043843121,1361044507569,1465224821,1465889269,664448
1361044511,1465892708,2,92,46,1361044509802,1361044509802,1465891510,1465891510,0
1361044511,1465892708,3,168,56,1361044509802,1361044509866,1465891510,1465891574,64
1361044511,1465892772,2,92,46,1361044509737,1361044509737,1465891509,1465891509,0
1361044537,1465918212,1,52,52,1361044510300,1361044510300,1465891512,1465891512,0
1361044537,1465918212,1,46,46,1361044510364,1361044510364,1465891576,1465891576,0
1361044537,1465918284,1,52,52,1361044510225,1361044510225,1465891509,1465891509,0
1361044670,104364152,15,16884,1125.6,1361044666604,1361044666732,104360756,104360884,128
1361044670,104364156,7,3210,458.5714286,1361044664234,1361044664234,104358390,104358390,0
1361044670,104364160,15,16881,1125.4,1361044663974,1361044664102,104358134,104358262,128
1361044671,1466052892,15,2438,162.5333333,1361044664303,1361044665647,1466046195,1466047539,1344
1361044671,1466052900,18,9438,524.3333333,1361044663528,1361044664104,1466045428,1466046004,576
1361044671,1466052904,11,1282,116.5454545,1361044664035,1361044664163,1466045939,1466046067,128
1361044672,1466052932,12,1086,90.5,1361044667761,1361044668017,1466048693,1466048949,256
1361044672,1466052936,13,1288,99.07692308,1361044668078,1361044668462,1466049014,1466049398,384
1361044672,1466052936,12,1334,111.1666667,1361044668523,1361044668907,1466049459,1466049843,384
1361044672,1466052936,14,2587,184.7857143,1361044668651,1361044668971,1466049587,1466049907,320
1361044672,1466052944,16,7165,447.8125,1361044664292,1361044664996,1466045236,1466045940,704
1361044672,1466052972,14,2373,169.5,1361044666824,1361044667272,1466047796,1466048244,448
1361044672,1466052976,16,7038,439.875,1361044667333,1361044667781,1466048309,1466048757,448
1361044672,1466052980,13,2547,195.9230769,1361044668160,1361044668352,1466049140,1466049332,192
1361044679,1466060908,14,2423,173.0714286,1361044672222,1361044672478,1466054130,1466054386,256
1361044693,1466074120,15,3688,245.8666667,1361044665077,1361044668149,1466046197,1466049269,3072
1361044729,1466110284,37,48685,1315.810811,1361044701390,1361044701454,1466082674,1466082738,64
1361044729,1466110284,30,38888,1296.266667,1361044701390,1361044701454,1466082674,1466082738,64
1361044729,104423556,3,586,195.3333333,1361044701271,1361044701271,104395827,104395827,0
1361044757,1466138252,1,52,52,1361044731373,1361044731373,1466112625,1466112625,0
1361044757,1466138304,1,52,52,1361044731322,1361044731322,1466112626,1466112626,0
1361044757,104451832,1,52,52,1361044730951,1361044730951,104425783,104425783,0
1361044957,1466338736,1,76,76,1361044931785,1361044931785,1466313521,1466313521,0
1361045024,1466405224,16,17968,1123,1361044999559,1361045016199,1466380783,1466397423,16640
1361045042,1466423056,15,17916,1194.4,1361045016367,1361045016495,1466397423,1466397551,128
1361045074,1466455128,1,52,52,1361045046310,1361045046310,1466427438,1466427438,0
1361045146,1466527192,1,48,48,1361045119910,1361045119910,1466501102,1466501102,0
1361045166,1466547252,1,46,46,1361045138664,1361045138664,1466519916,1466519916,0
1361045312,1466693436,4,917,229.25,1361045300144,1361045310320,1466681580,1466691756,10176
1361045326,105020576,57,70182,1231.263158,1361045299339,1361045300811,104993915,104995387,1472
1361045326,105020576,61,77910,1277.213115,1361045299339,1361045300875,104993915,104995451,1536
1361045326,105020576,86,114273,1328.755814,1361045299338,1361045300874,104993914,104995450,1536
1361045326,105020580,29,38516,1328.137931,1361045300612,1361045300676,104995192,104995256,64
1361045326,105020580,3,1107,369,1361045300612,1361045300612,104995192,104995192,0
1361045326,105020608,44,56421,1282.295455,1361045299305,1361045301161,104993913,104995769,1856
1361045326,105020624,39,51740,1326.666667,1361045300123,1361045300699,104994747,104995323,576
1361045326,105020624,29,38516,1328.137931,1361045300569,1361045300633,104995193,104995257,64
1361045326,1466707540,40,52593,1314.825,1361045299208,1361045300104,1466680748,1466681644,896
1361045326,1466707540,37,48611,1313.810811,1361045299527,1361045300103,1466681067,1466681643,576
1361045326,1466707540,8,6438,804.75,1361045299525,1361045299973,1466681065,1466681513,448
1361045326,1466707568,8,5242,655.25,1361045299945,1361045300265,1466681513,1466681833,320
1361045326,1466707612,30,37539,1251.3,1361045299132,1361045299964,1466680744,1466681576,832
1361045326,1466707616,66,87628,1327.69697,1361045299132,1361045299964,1466680748,1466681580,832
1361045326,1466707624,9,5292,588,1361045299892,1361045300212,1466681516,1466681836,320
1361045330,1466711612,32,15658,489.3125,1361045304062,1361045314622,1466685674,1466696234,10560
1361045334,105028508,126,166710,1323.095238,1361045299405,1361045331277,104993913,105025785,31872
1361045334,105028516,147,195782,1331.85034,1361045299398,1361045331270,104993914,105025786,31872
1361045336,1466717368,309,429933,1391.368932,1361045299251,1361045331315,1466680619,1466712683,32064
1361045336,1466717368,3,150,50,1361045331314,1361045331378,1466712682,1466712746,64
1361045336,1466717412,2,104,52,1361045331270,1361045331270,1466712682,1466712682,0
1361045352,1466733392,8,2684,335.5,1361045347802,1361045347994,1466729194,1466729386,192
1361045352,1466733396,8,2576,322,1361045347992,1361045348184,1466729388,1466729580,192
1361045352,1466733428,8,2684,335.5,1361045346358,1361045346550,1466727786,1466727978,192
1361045352,1466733436,8,2684,335.5,1361045344687,1361045344879,1466726123,1466726315,192
1361045358,105052792,1,52,52,1361045330995,1361045330995,105025787,105025787,0
1361045358,105052792,1,52,52,1361045330995,1361045330995,105025787,105025787,0
1361045358,105052792,1,52,52,1361045330995,1361045330995,105025787,105025787,0
1361045358,105052792,1,52,52,1361045330995,1361045330995,105025787,105025787,0
1361045358,105052820,1,52,52,1361045330964,1361045330964,105025784,105025784,0
1361045358,105052820,1,52,52,1361045330964,1361045330964,105025784,105025784,0
1361045358,105052820,1,52,52,1361045330964,1361045330964,105025784,105025784,0
1361045358,105052820,1,52,52,1361045330964,1361045330964,105025784,105025784,0
1361045358,1466739888,1,52,52,1361045330793,1361045330793,1466712681,1466712681,0
1361045358,1466739888,1,52,52,1361045330793,1361045330793,1466712681,1466712681,0
1361045359,1466739972,1,52,52,1361045331708,1361045331708,1466712680,1466712680,0
1361045359,1466739972,1,52,52,1361045331708,1361045331708,1466712680,1466712680,0
1361045359,1466739972,1,52,52,1361045331708,1361045331708,1466712680,1466712680,0
1361045362,1466743904,4,891,222.75,1361045335385,1361045360729,1466717289,1466742633,25344
1361045362,1466743920,97,125465,1293.453608,1361045334408,1361045360712,1466716328,1466742632,26304
1361045363,1466743996,26,32939,1266.884615,1361045335716,1361045336420,1466716712,1466717416,704
1361045363,1466744032,4,382,95.5,1361045336258,1361045361602,1466717290,1466742634,25344
1361045368,1466749376,6,3677,612.8333333,1361045362858,1361045363178,1466744234,1466744554,320
1361045368,1466749376,13,10882,837.0769231,1361045362922,1361045363242,1466744298,1466744618,320
1361045368,1466749376,12,10492,874.3333333,1361045362922,1361045363242,1466744298,1466744618,320
1361045368,1466749376,27,31210,1155.925926,1361045362922,1361045367082,1466744298,1466748458,4160
1361045368,1466749388,158,218713,1384.259494,1361045335455,1361045361247,1466716843,1466742635,25792
1361045368,1466749408,19,19307,1016.157895,1361045361995,1361045363211,1466743403,1466744619,1216
1361045368,1466749416,16,15889,993.0625,1361045362881,1361045363201,1466744297,1466744617,320
1361045368,1466749416,10,8042,804.2,1361045362881,1361045363201,1466744297,1466744617,320
1361045368,1466749420,6,524,87.33333333,1361045363071,1361045363135,1466744491,1466744555,64
1361045368,1466749424,9,8922,991.3333333,1361045367289,1361045367609,1466748713,1466749033,320
1361045368,1466749460,27,32184,1192,1361045361940,1361045363156,1466743400,1466744616,1216
1361045370,1466751876,14,12088,863.4285714,1361045345782,1361045346870,1466727658,1466728746,1088
1361045370,1466751884,34,34645,1018.970588,1361045343981,1361045347181,1466725865,1466729065,3200
1361045370,1466751912,1,52,52,1361045344272,1361045344272,1466726184,1466726184,0
1361045370,1466751924,89,118893,1335.876404,1361045344709,1361045344965,1466726633,1466726889,256
1361045370,1466751924,27,23701,877.8148148,1361045344708,1361045346372,1466726632,1466728296,1664
1361045371,1466751948,20,21740,1087,1361045346710,1361045347798,1466727658,1466728746,1088
1361045371,1466751948,23,24193,1051.869565,1361045346710,1361045347798,1466727658,1466728746,1088
1361045371,1466751996,71,94395,1329.507042,1361045345639,1361045345895,1466726635,1466726891,256
1361045371,1466751996,44,47119,1070.886364,1361045345638,1361045347238,1466726634,1466728234,1600
1361045374,105068800,12,13816,1151.333333,1361045346536,1361045346536,105041336,105041336,0
1361045374,105068800,6,4024,670.6666667,1361045346536,1361045347112,105041336,105041912,576
1361045374,105068804,32,42709,1334.65625,1361045346470,1361045346598,105041274,105041402,128
1361045374,105068804,77,106153,1378.61039,1361045346661,1361045346789,105041465,105041593,128
1361045374,105068804,76,92269,1214.065789,1361045346660,1361045347236,105041464,105042040,576
1361045374,105068848,6,5766,961,1361045346427,1361045346491,105041275,105041339,64
1361045374,105068848,6,4910,818.3333333,1361045346490,1361045346618,105041338,105041466,128
1361045374,105068848,56,69822,1246.821429,1361045346553,1361045346809,105041401,105041657,256
1361045374,105068852,4,2299,574.75,1361045347062,1361045347062,105041914,105041914,0
1361045374,1466755892,8,2211,276.375,1361045346279,1361045346343,1466728171,1466728235,64
1361045374,1466755892,9,4023,447,1361045346279,1361045346343,1466728171,1466728235,64
1361045374,1466755896,5,1227,245.4,1361045346913,1361045346913,1466728809,1466728809,0
1361045374,1466755896,7,3923,560.4285714,1361045346913,1361045346977,1466728809,1466728873,64
1361045374,1466755900,9,5771,641.2222222,1361045347103,1361045347935,1466729003,1466729835,832
1361045375,1466755968,6,1023,170.5,1361045347200,1361045347264,1466728168,1466728232,64
1361045375,1466755968,25,26081,1043.24,1361045347200,1361045347328,1466728168,1466728296,128
1361045375,1466755976,5,843,168.6,1361045347834,1361045347898,1466728810,1466728874,64
1361045376,1466757356,20,17555,877.75,1361045367997,1361045372221,1466749353,1466753577,4224
1361045376,1466757356,22,19396,881.6363636,1361045367997,1361045372221,1466749353,1466753577,4224
1361045376,1466757356,38,42832,1127.157895,1361045367997,1361045372221,1466749353,1466753577,4224
1361045376,1466757368,10,7845,784.5,1361045367666,1361045371826,1466749034,1466753194,4160
1361045376,1466757368,17,17978,1057.529412,1361045367666,1361045371826,1466749034,1466753194,4160
1361045376,1466757368,13,10649,819.1538462,1361045367666,1361045371826,1466749034,1466753194,4160
1361045376,1466757368,5,1388,277.6,1361045367856,1361045368816,1466749224,1466750184,960
1361045376,1466757412,37,39874,1077.675676,1361045367942,1361045372294,1466749354,1466753706,4352
1361045376,1466757412,51,58069,1138.607843,1361045367942,1361045374470,1466749354,1466755882,6528
1361045376,1466757412,34,37653,1107.441176,1361045367941,1361045372165,1466749353,1466753577,4224
1361045376,1466757424,8,3148,393.5,1361045367611,1361045371835,1466749035,1466753259,4224
1361045376,1466757424,17,14046,826.2352941,1361045367610,1361045374202,1466749034,1466755626,6592
1361045376,1466757448,9,6785,753.8888889,1361045367778,1361045371810,1466749226,1466753258,4032
1361045387,1466767944,17,20157,1185.705882,1361045361880,1361045362392,1466742824,1466743336,512
1361045387,1466767948,17,20449,1202.882353,1361045362325,1361045363157,1466743273,1466744105,832
1361045387,1466767948,23,28835,1253.695652,1361045362453,1361045362581,1466743401,1466743529,128
1361045387,1466767948,30,38060,1268.666667,1361045362516,1361045363348,1466743464,1466744296,832
1361045387,1466767948,5,3106,621.2,1361045362516,1361045363284,1466743464,1466744232,768
1361045387,1466767952,9,8094,899.3333333,1361045362512,1361045363344,1466743464,1466744296,832
1361045387,1466768024,4,1344,336,1361045361609,1361045367625,1466742633,1466748649,6016
1361045387,1466768032,6,4389,731.5,1361045362434,1361045363266,1466743466,1466744298,832
1361045387,1466768032,9,6657,739.6666667,1361045362433,1361045363201,1466743465,1466744233,768
1361045387,1466768032,13,13029,1002.230769,1361045362433,1361045363329,1466743465,1466744361,896
1361045390,1466771900,15,18544,1236.266667,1361045362462,1361045362590,1466744362,1466744490,128
1361045390,1466771900,15,18420,1228,1361045362462,1361045362590,1466744362,1466744490,128
1361045390,1466771900,11,11805,1073.181818,1361045362461,1361045362525,1466744361,1466744425,64
1361045390,1466771900,16,18739,1171.1875,1361045362461,1361045362589,1466744361,1466744489,128
1361045391,1466771972,14,16901,1207.214286,1361045363388,1361045363516,1466744360,1466744488,128
1361045392,1466773408,4,539,134.75,1361045388232,1361045388360,1466769640,1466769768,128
1361045392,1466773412,6,3280,546.6666667,1361045388741,1361045388805,1466770153,1466770217,64
1361045392,1466773412,28,33450,1194.642857,1361045388740,1361045388996,1466770152,1466770408,256
1361045392,1466773412,19,20600,1084.210526,1361045388740,1361045388932,1466770152,1466770344,192
1361045392,1466773416,32,39493,1234.15625,1361045389059,1361045389315,1466770475,1466770731,256
1361045392,1466773452,6,5212,868.6666667,1361045388316,1361045388444,1466769768,1466769896,128
1361045392,1466773472,57,72670,1274.912281,1361045388679,1361045388999,1466770151,1466770471,320
1361045392,1466773472,56,71354,1274.178571,1361045388682,1361045389002,1466770154,1466770474,320
1361045392,1466773472,48,60550,1261.458333,1361045388746,1361045389002,1466770218,1466770474,256
1361045392,1466773472,56,71890,1283.75,1361045388938,1361045389258,1466770410,1466770730,320
1361045392,1466773472,19,19929,1048.894737,1361045388809,1361045389001,1466770281,1466770473,192
1361045392,1466773472,54,66874,1238.407407,1361045389001,1361045389321,1466770473,1466770793,320
1361045392,1466773472,43,52690,1225.348837,1361045389065,1361045389321,1466770537,1466770793,256
1361045392,1466773472,32,38434,1201.0625,1361045388936,1361045389192,1466770408,1466770664,256
1361045392,1466773472,94,124912,1328.851064,1361045389000,1361045389384,1466770472,1466770856,384
1361045392,1466773476,16,16581,1036.3125,1361045370115,1361045388803,1466751591,1466770279,18688
1361045394,1466775876,4,2792,698,1361045367477,1361045367669,1466749353,1466749545,192
1361045394,1466775876,4,2728,682,1361045367540,1361045367668,1466749416,1466749544,128
1361045394,1466775916,27,34990,1295.925926,1361045366925,1361045367053,1466748841,1466748969,128
1361045394,1466775916,50,65012,1300.24,1361045367052,1361045368844,1466748968,1466750760,1792
1361045394,1466775924,3,986,328.6666667,1361045368838,1361045368902,1466750762,1466750826,64
1361045394,1466775928,10,6536,653.6,1361045369283,1361045369795,1466751211,1466751723,512
1361045394,1466775928,25,27655,1106.2,1361045369537,1361045371201,1466751465,1466753129,1664
1361045394,1466775928,61,82775,1356.967213,1361045369409,1361045369985,1466751337,1466751913,576
1361045395,1466775992,4,1624,406,1361045369767,1361045369831,1466750759,1466750823,64
1361045395,1466775992,7,5263,751.8571429,1361045368234,1361045368490,1466749226,1466749482,256
1361045395,1466775992,12,5874,489.5,1361045368234,1361045370602,1466749226,1466751594,2368
1361045395,1466775992,25,31699,1267.96,1361045369769,1361045369833,1466750761,1466750825,64
1361045395,1466775996,5,3482,696.4,1361045370151,1361045370663,1466751147,1466751659,512
1361045395,1466775996,5,2021,404.2,1361045370086,1361045370534,1466751082,1466751530,448
1361045399,1466780004,3,1082,360.6666667,1361045372126,1361045372126,1466753130,1466753130,0
1361045400,1466781420,11,9734,884.9090909,1361045388667,1361045392827,1466770087,1466774247,4160
1361045400,1466781444,5,2032,406.4,1361045388835,1361045392867,1466770279,1466774311,4032
1361045400,1466781456,4,542,135.5,1361045394715,1361045394843,1466776171,1466776299,128
1361045400,1466781456,6,5210,868.3333333,1361045394842,1361045395034,1466776298,1466776490,192
1361045400,1466781480,7,3951,564.4285714,1361045388607,1361045392703,1466770087,1466774183,4096
1361045408,1466789440,6,5361,893.5,1361045405224,1361045405416,1466786664,1466786856,192
1361045408,1466789444,29,34290,1182.413793,1361045405475,1361045405731,1466786919,1466787175,256
1361045408,1466789444,33,39498,1196.909091,1361045405735,1361045405991,1466787179,1466787435,256
1361045408,1466789444,63,81463,1293.063492,1361045405478,1361045405798,1466786922,1466787242,320
1361045408,1466789444,25,28138,1125.52,1361045405798,1361045405990,1466787242,1466787434,192
1361045408,1466789444,29,33209,1145.137931,1361045405798,1361045405990,1466787242,1466787434,192
1361045408,1466789492,70,88358,1262.257143,1361045405427,1361045405683,1466786919,1466787175,256
1361045408,1466789492,37,45453,1228.459459,1361045405427,1361045405683,1466786919,1466787175,256
1361045408,1466789492,36,43334,1203.722222,1361045405687,1361045405879,1466787179,1466787371,192
1361045408,1466789492,62,78357,1263.822581,1361045405686,1361045406006,1466787178,1466787498,320
1361045408,1466789492,35,42955,1227.285714,1361045405750,1361045405942,1466787242,1466787434,192
1361045408,1466789492,34,42255,1242.794118,1361045405430,1361045405686,1466786922,1466787178,256
1361045408,1466789492,53,67125,1266.509434,1361045405430,1361045405750,1466786922,1466787242,320
1361045415,1466795952,1,46,46,1361045389135,1361045389135,1466770087,1466770087,0
1361045415,1466795952,1,46,46,1361045389135,1361045389135,1466770087,1466770087,0
1361045415,1466795952,1,46,46,1361045389135,1361045389135,1466770087,1466770087,0
1361045415,1466795956,1,46,46,1361045389131,1361045389131,1466770087,1466770087,0
1361045415,1466795956,1,46,46,1361045389131,1361045389131,1466770087,1466770087,0
1361045415,1466795956,1,46,46,1361045389131,1361045389131,1466770087,1466770087,0
1361045415,1466795956,5,1396,279.2,1361045389326,1361045405966,1466770282,1466786922,16640
1361045415,1466796008,1,46,46,1361045389082,1361045389082,1466770090,1466770090,0
1361045415,1466796008,1,46,46,1361045389081,1361045389081,1466770089,1466770089,0
1361045415,1466796008,1,46,46,1361045389081,1361045389081,1466770089,1466770089,0
1361045415,1466796008,1,46,46,1361045389081,1361045389081,1466770089,1466770089,0
1361045415,1466796008,1,46,46,1361045389081,1361045389081,1466770089,1466770089,0
1361045415,1466796008,1,46,46,1361045389081,1361045389081,1466770089,1466770089,0
1361045415,1466796024,26,15745,605.5769231,1361045389127,1361045405959,1466770151,1466786983,16832
1361045416,1466797408,27,29865,1106.111111,1361045414920,1361045415176,1466796328,1466796584,256
1361045416,1466797408,34,40295,1185.147059,1361045414920,1361045415240,1466796328,1466796648,320
1361045416,1466797408,2,480,240,1361045414920,1361045414920,1466796328,1466796328,0
1361045416,1466797408,5,2012,402.4,1361045414920,1361045414984,1466796328,1466796392,64
1361045416,1466797408,5,1988,397.6,1361045414920,1361045414984,1466796328,1466796392,64
1361045416,1466797408,55,69339,1260.709091,1361045414919,1361045415175,1466796327,1466796583,256
1361045416,1466797448,4,545,136.25,1361045414433,1361045414497,1466795881,1466795945,64
1361045416,1466797448,6,5748,958,1361045414560,1361045414752,1466796008,1466796200,192
1361045416,1466797452,5,1904,380.8,1361045414875,1361045414939,1466796327,1466796391,64
1361045416,1466797452,5,2075,415,1361045414875,1361045414939,1466796327,1466796391,64
1361045416,1466797452,5,2043,408.6,1361045414875,1361045414939,1466796327,1466796391,64
1361045416,1466797452,32,37472,1171,1361045414875,1361045415131,1466796327,1466796583,256
1361045416,1466797452,33,39448,1195.393939,1361045414875,1361045415131,1466796327,1466796583,256
1361045416,1466797452,29,35355,1219.137931,1361045414875,1361045415131,1466796327,1466796583,256
1361045416,1466797452,11,5365,487.7272727,1361045414875,1361045415131,1466796327,1466796583,256
1361045416,1466797456,29,35548,1225.793103,1361045415129,1361045415385,1466796585,1466796841,256
1361045416,1466797456,38,46062,1212.157895,1361045415129,1361045415449,1466796585,1466796905,320
1361045416,1466797456,27,29704,1100.148148,1361045415129,1361045415385,1466796585,1466796841,256
1361045416,1466797456,33,39625,1200.757576,1361045415129,1361045415449,1466796585,1466796905,320
1361045416,1466797456,29,35860,1236.551724,1361045415193,1361045415449,1466796649,1466796905,256
1361045416,1466797480,34,41020,1206.470588,1361045415169,1361045415425,1466796649,1466796905,256
1361045424,1466805452,8,4085,510.625,1361045414877,1361045418973,1466796329,1466800425,4096
1361045431,1466811980,6,2366,394.3333333,1361045406068,1361045406644,1466787048,1466787624,576
1361045431,1466811980,1,52,52,1361045405939,1361045405939,1466786919,1466786919,0
1361045431,1466811980,17,21146,1243.882353,1361045405939,1361045406003,1466786919,1466786983,64
1361045431,1466811980,1,52,52,1361045406067,1361045406067,1466787047,1466787047,0
1361045431,1466812060,11,12632,1148.363636,1361045405796,1361045405796,1466786856,1466786856,0
1361045431,1466812064,1,52,52,1361045405984,1361045405984,1466787048,1466787048,0
1361045431,1466812068,1,46,46,1361045406558,1361045406558,1466787626,1466787626,0
1361045431,1466812068,3,1755,585,1361045406620,1361045406684,1466787688,1466787752,64
1361045431,1466812068,1,52,52,1361045406683,1361045406683,1466787751,1466787751,0
1361045431,1466812072,6,3313,552.1666667,1361045406683,1361045406747,1466787755,1466787819,64
1361045434,1466815920,1,52,52,1361045405962,1361045405962,1466787882,1466787882,0
1361045434,1466815920,14,13699,978.5,1361045405962,1361045432522,1466787882,1466814442,26560
1361045435,1466815928,1,52,52,1361045407530,1361045407530,1466788458,1466788458,0
1361045435,1466815928,32,41253,1289.15625,1361045407528,1361045434088,1466788456,1466815016,26560
1361045435,1466815976,1,52,52,1361045406904,1361045406904,1466787880,1466787880,0
1361045440,1466821428,6,5355,892.5,1361045432052,1361045432244,1466813480,1466813672,192
1361045440,1466821432,74,94600,1278.378378,1361045432305,1361045432689,1466813737,1466814121,384
1361045440,1466821432,26,29704,1142.461538,1361045432368,1361045432688,1466813800,1466814120,320
1361045440,1466821432,23,27104,1178.434783,1361045432368,1361045432688,1466813800,1466814120,320
1361045440,1466821436,25,27778,1111.12,1361045432685,1361045432877,1466814121,1466814313,192
1361045440,1466821436,24,26239,1093.291667,1361045432685,1361045432877,1466814121,1466814313,192
1361045440,1466821436,29,34831,1201.068966,1361045432685,1361045432941,1466814121,1466814377,256
1361045440,1466821436,39,50003,1282.128205,1361045432685,1361045432941,1466814121,1466814377,256
1361045440,1466821476,51,64125,1257.352941,1361045432323,1361045432643,1466813799,1466814119,320
1361045440,1466821480,61,78447,1286.016393,1361045432319,1361045432639,1466813799,1466814119,320
1361045440,1466821480,42,48835,1162.738095,1361045432319,1361045432639,1466813799,1466814119,320
1361045440,1466821480,39,46298,1187.128205,1361045432640,1361045432896,1466814120,1466814376,256
1361045440,1466821484,34,41312,1215.058824,1361045432638,1361045432894,1466814122,1466814378,256
1361045443,1466823976,1,46,46,1361045415354,1361045415354,1466796330,1466796330,0
1361045447,1466827972,1,52,52,1361045422334,1361045422334,1466803306,1466803306,0
1361045451,1466831960,1,52,52,1361045423369,1361045423369,1466804329,1466804329,0
1361045451,1466831960,1,52,52,1361045423369,1361045423369,1466804329,1466804329,0
1361045451,1466831960,1,52,52,1361045423496,1361045423496,1466804456,1466804456,0
1361045451,1466831960,1,52,52,1361045423496,1361045423496,1466804456,1466804456,0
1361045451,1466831960,1,52,52,1361045423496,1361045423496,1466804456,1466804456,0
1361045451,1466832036,1,52,52,1361045423291,1361045423291,1466804327,1466804327,0
1361045451,1466832036,1,52,52,1361045423291,1361045423291,1466804327,1466804327,0
1361045451,1466832040,1,52,52,1361045423286,1361045423286,1466804326,1466804326,0
1361045451,1466832040,1,52,52,1361045423418,1361045423418,1466804458,1466804458,0
1361045451,1466832040,1,52,52,1361045423416,1361045423416,1466804456,1466804456,0
1361045451,1466832040,1,52,52,1361045423416,1361045423416,1466804456,1466804456,0
1361045455,1466835928,1,52,52,1361045426986,1361045426986,1466807914,1466807914,0
1361045456,1466837416,7,5466,780.8571429,1361045454464,1361045455360,1466835880,1466836776,896
1361045456,1466837424,10,5328,532.8,1361045432314,1361045455354,1466813738,1466836778,23040
1361045456,1466837424,7,2423,346.1428571,1361045432378,1361045455418,1466813802,1466836842,23040
1361045456,1466837424,4,592,148,1361045432377,1361045455417,1466813801,1466836841,23040
1361045459,1466839944,1,52,52,1361045432858,1361045432858,1466813802,1466813802,0
1361045459,1466839952,7,3372,481.7142857,1361045433362,1361045456594,1466814314,1466837546,23232
1361045459,1466839952,1,52,52,1361045433362,1361045433362,1466814314,1466814314,0
1361045459,1466839972,14,13700,978.5714286,1361045433467,1361045456699,1466814439,1466837671,23232
1361045459,1466840024,1,46,46,1361045433226,1361045433226,1466814250,1466814250,0
1361045459,1466840024,4,1805,451.25,1361045433223,1361045456391,1466814247,1466837415,23168
1361045459,1466840060,30,39919,1330.633333,1361045433958,1361045434022,1466815018,1466815082,64
1361045464,1466845420,39,46028,1180.205128,1361045456509,1361045456829,1466837929,1466838249,320
1361045464,1466845420,29,33778,1164.758621,1361045456571,1361045456827,1466837991,1466838247,256
1361045464,1466845424,30,35071,1169.033333,1361045455353,1361045456505,1466836777,1466837929,1152
1361045464,1466845424,28,31800,1135.714286,1361045455353,1361045456505,1466836777,1466837929,1152
1361045464,1466845424,24,25385,1057.708333,1361045455353,1361045456505,1466836777,1466837929,1152
1361045464,1466845468,67,86563,1291.985075,1361045456397,1361045456717,1466837865,1466838185,320
1361045464,1466845468,36,43236,1201,1361045456460,1361045456716,1466837928,1466838184,256
1361045464,1466845468,27,31562,1168.962963,1361045456460,1361045456716,1466837928,1466838184,256
1361045464,1466845468,34,39968,1175.529412,1361045456460,1361045456716,1466837928,1466838184,256
1361045464,1466845468,33,36746,1113.515152,1361045455306,1361045456458,1466836774,1466837926,1152
1361045464,1466845468,58,73069,1259.810345,1361045455306,1361045456522,1466836774,1466837990,1216
1361045464,1466845472,37,43271,1169.486486,1361045455302,1361045456454,1466836774,1466837926,1152
1361045471,1466852036,9,684,76,1361045444475,1361045460475,1466825511,1466841511,16000
1361045472,1466853420,55,68276,1241.381818,1361045465530,1361045465850,1466846950,1466847270,320
1361045472,1466853424,44,55299,1256.795455,1361045465849,1361045466169,1466847273,1466847593,320
1361045472,1466853424,42,52194,1242.714286,1361045465529,1361045465785,1466846953,1466847209,256
1361045472,1466853424,55,70393,1279.872727,1361045465529,1361045465849,1466846953,1466847273,320
1361045472,1466853452,40,48568,1214.2,1361045465756,1361045466012,1466847208,1466847464,256
1361045472,1466853452,41,50687,1236.268293,1361045465820,1361045466076,1466847272,1466847528,256
1361045472,1466853492,7,5434,776.2857143,1361045465075,1361045465331,1466846567,1466846823,256
1361045472,1466853496,63,79530,1262.380952,1361045465457,1361045465777,1466846953,1466847273,320
1361045472,1466853496,68,88653,1303.720588,1361045465457,1361045465841,1466846953,1466847337,384
1361045472,1466853496,32,38305,1197.03125,1361045465521,1361045465777,1466847017,1466847273,256
1361045472,1466853496,36,43068,1196.333333,1361045465776,1361045466032,1466847272,1466847528,256
1361045472,1466853496,26,28205,1084.807692,1361045465775,1361045466031,1466847271,1466847527,256
1361045472,1466853496,22,24676,1121.636364,1361045465838,1361045466030,1466847334,1466847526,192
1361045480,1466861416,6,5340,890,1361045478528,1361045478720,1466859944,1466860136,192
1361045480,1466861420,40,46405,1160.125,1361045478908,1361045479292,1466860328,1466860712,384
1361045480,1466861420,32,35196,1099.875,1361045478907,1361045479163,1466860327,1466860583,256
1361045480,1466861420,31,34780,1121.935484,1361045478907,1361045479227,1466860327,1466860647,320
1361045480,1466861424,27,28981,1073.37037,1361045479161,1361045479417,1466860585,1466860841,256
1361045480,1466861424,29,34780,1199.310345,1361045479224,1361045479480,1466860648,1466860904,256
1361045480,1466861428,6,5360,893.3333333,1361045472694,1361045472822,1466854122,1466854250,128
1361045480,1466861428,39,48151,1234.641026,1361045472947,1361045473267,1466854375,1466854695,320
1361045480,1466861432,53,64138,1210.150943,1361045473070,1361045473518,1466854502,1466854950,448
1361045480,1466861432,48,57672,1201.5,1361045473070,1361045473454,1466854502,1466854886,384
1361045480,1466861432,53,66418,1253.169811,1361045473329,1361045473713,1466854761,1466855145,384
1361045480,1466861432,23,25150,1093.478261,1361045473329,1361045473585,1466854761,1466855017,256
1361045480,1466861432,33,38421,1164.272727,1361045473456,1361045473776,1466854888,1466855208,320
1361045480,1466861432,61,74562,1222.327869,1361045473328,1361045473840,1466854760,1466855272,512
1361045480,1466861468,39,47445,1216.538462,1361045478860,1361045479180,1466860328,1466860648,320
1361045480,1466861468,37,43451,1174.351351,1361045478860,1361045479116,1466860328,1466860584,256
1361045480,1466861468,64,77904,1217.25,1361045478860,1361045479372,1466860328,1466860840,512
1361045480,1466861472,35,39733,1135.228571,1361045479113,1361045479433,1466860585,1466860905,320
1361045480,1466861472,26,30680,1180,1361045479113,1361045479433,1466860585,1466860905,320
1361045480,1466861472,58,70374,1213.344828,1361045479176,1361045479624,1466860648,1466861096,448
1361045480,1466861472,28,33389,1192.464286,1361045479303,1361045479623,1466860775,1466861095,320
1361045480,1466861492,33,37743,1143.727273,1361045473014,1361045473270,1466854506,1466854762,256
1361045480,1466861492,28,32279,1152.821429,1361045473013,1361045473269,1466854505,1466854761,256
1361045480,1466861492,44,51895,1179.431818,1361045473010,1361045473394,1466854502,1466854886,384
1361045480,1466861496,36,41435,1150.972222,1361045473391,1361045473775,1466854887,1466855271,384
1361045480,1466861496,28,30934,1104.785714,1361045473455,1361045473711,1466854951,1466855207,256
1361045483,1466864056,6,1824,304,1361045455784,1361045479208,1466836840,1466860264,23424
1361045483,1466864100,7,5189,741.2857143,1361045456318,1361045473982,1466837418,1466855082,17664
1361045483,1466864100,16,9833,614.5625,1361045456443,1361045474107,1466837543,1466855207,17664
1361045483,1466864104,35,40717,1163.342857,1361045456568,1361045474936,1466837672,1466856040,18368
1361045483,1466864116,35,21028,600.8,1361045455662,1361045479278,1466836778,1466860394,23616
1361045483,1466864116,21,11424,544,1361045455725,1361045479533,1466836841,1466860649,23808
1361045488,1466869448,29,31570,1088.62069,1361045484193,1361045485985,1466865641,1466867433,1792
1361045488,1466869448,20,20463,1023.15,1361045484193,1361045486049,1466865641,1466867497,1856
1361045488,1466869448,52,61273,1178.326923,1361045484191,1361045486239,1466865639,1466867687,2048
1361045488,1466869448,32,36731,1147.84375,1361045484191,1361045486111,1466865639,1466867559,1920
1361045488,1466869480,35,40698,1162.8,1361045486016,1361045486336,1466867496,1466867816,320
1361045488,1466869480,29,34908,1203.724138,1361045486080,1361045486400,1466867560,1466867880,320
1361045488,1466869480,69,87785,1272.246377,1361045486080,1361045486592,1466867560,1466868072,512
1361045488,1466869480,53,66315,1251.226415,1361045486208,1361045486656,1466867688,1466868136,448
1361045488,1466869484,7,5465,780.7142857,1361045482812,1361045484092,1466864296,1466865576,1280
1361045488,1466869488,35,43113,1231.8,1361045486902,1361045487222,1466868390,1466868710,320
1361045488,1466869492,28,29257,1044.892857,1361045484147,1361045486003,1466865639,1466867495,1856
1361045488,1466869492,40,46341,1158.525,1361045484147,1361045486131,1466865639,1466867623,1984
1361045488,1466869524,30,34645,1154.833333,1361045485971,1361045486227,1466867495,1466867751,256
1361045499,1466880084,1,52,52,1361045474186,1361045474186,1466855270,1466855270,0
1361045499,1466880160,31,40573,1308.806452,1361045474111,1361045474175,1466855271,1466855335,64
1361045504,1466885444,7,5459,779.8571429,1361045496677,1361045496997,1466878121,1466878441,320
1361045504,1466885448,42,52523,1250.547619,1361045497118,1361045497502,1466878566,1466878950,384
1361045504,1466885452,46,58258,1266.478261,1361045497050,1361045497370,1466878502,1466878822,320
1361045504,1466885452,28,32532,1161.857143,1361045497117,1361045497437,1466878569,1466878889,320
1361045504,1466885452,38,43804,1152.736842,1361045497499,1361045497883,1466878951,1466879335,384
1361045504,1466885452,53,64115,1209.716981,1361045497563,1361045497947,1466879015,1466879399,384
1361045504,1466885520,59,73054,1238.20339,1361045497046,1361045497494,1466878566,1466879014,448
1361045504,1466885520,39,48115,1233.717949,1361045497046,1361045497430,1466878566,1466878950,384
1361045504,1466885524,40,48755,1218.875,1361045497044,1361045497428,1466878568,1466878952,384
1361045504,1466885524,43,53337,1240.395349,1361045497298,1361045497682,1466878822,1466879206,384
1361045504,1466885528,24,26538,1105.75,1361045497361,1361045497553,1466878889,1466879081,192
1361045504,1466885528,35,40953,1170.085714,1361045497425,1361045497745,1466878953,1466879273,320
1361045504,1466885528,24,26586,1107.75,1361045497425,1361045497681,1466878953,1466879209,256
1361045507,1466888012,1,52,52,1361045479636,1361045479636,1466860648,1466860648,0
1361045507,1466888012,1,52,52,1361045479635,1361045479635,1466860647,1466860647,0
1361045507,1466888012,5,3159,631.8,1361045479635,1361045479699,1466860647,1466860711,64
1361045507,1466888012,3,1376,458.6666667,1361045479635,1361045479699,1466860647,1466860711,64
1361045507,1466888396,1,52,52,1361045479250,1361045479250,1466860646,1466860646,0
1361045507,1466888396,1,52,52,1361045479250,1361045479250,1466860646,1466860646,0
1361045507,1466888400,18,22161,1231.166667,1361045479249,1361045484561,1466860649,1466865961,5312
1361045511,1466892048,14,8596,614,1361045484529,1361045506801,1466865577,1466887849,22272
1361045511,1466892048,21,15493,737.7619048,1361045484592,1361045506352,1466865640,1466887400,21760
1361045511,1466892152,3,1284,428,1361045484487,1361045506119,1466865639,1466887271,21632
1361045512,1466893464,31,36802,1187.16129,1361045505871,1361045506127,1466887335,1466887591,256
1361045512,1466893464,38,48409,1273.921053,1361045505871,1361045506319,1466887335,1466887783,448
1361045512,1466893488,32,38024,1188.25,1361045506295,1361045506615,1466887783,1466888103,320
1361045512,1466893528,6,5368,894.6666667,1361045505425,1361045505617,1466886953,1466887145,192
1361045512,1466893528,45,55243,1227.622222,1361045505808,1361045506128,1466887336,1466887656,320
1361045512,1466893528,31,36706,1184.064516,1361045505808,1361045506064,1466887336,1466887592,256
1361045512,1466893528,31,35687,1151.193548,1361045505808,1361045506128,1466887336,1466887656,320
1361045512,1466893528,36,43716,1214.333333,1361045505807,1361045506127,1466887335,1466887655,320
1361045512,1466893528,35,41473,1184.942857,1361045506063,1361045506383,1466887591,1466887911,320
1361045512,1466893528,41,50860,1240.487805,1361045506126,1361045506446,1466887654,1466887974,320
1361045512,1466893528,37,45501,1229.756757,1361045506062,1361045506446,1466887590,1466887974,384
1361045512,1466893528,52,66008,1269.384615,1361045506126,1361045506510,1466887654,1466888038,384
1361045512,1466893528,45,52527,1167.266667,1361045506126,1361045506510,1466887654,1466888038,384
1361045520,1466901476,40,48421,1210.525,1361045516227,1361045516547,1466897703,1466898023,320
1361045520,1466901476,39,45148,1157.641026,1361045516163,1361045516483,1466897639,1466897959,320
1361045520,1466901476,47,56483,1201.765957,1361045516227,1361045516611,1466897703,1466898087,384
1361045520,1466901480,44,52867,1201.522727,1361045516481,1361045516801,1466897961,1466898281,320
1361045520,1466901480,69,85667,1241.550725,1361045516544,1361045516992,1466898024,1466898472,448
1361045520,1466901480,4,1188,297,1361045516671,1361045516799,1466898151,1466898279,128
1361045520,1466901480,5,1925,385,1361045516735,1361045516927,1466898215,1466898407,192
1361045520,1466901516,6,5404,900.6666667,1361045515802,1361045515994,1466897318,1466897510,192
1361045520,1466901520,28,32363,1155.821429,1361045516119,1361045516375,1466897639,1466897895,256
1361045520,1466901520,26,27804,1069.384615,1361045516183,1361045516439,1466897703,1466897959,256
1361045520,1466901520,45,55001,1222.244444,1361045516183,1361045516567,1466897703,1466898087,384
1361045520,1466901540,31,37643,1214.290323,1361045516354,1361045516674,1466897894,1466898214,320
1361045520,1466901540,36,41774,1160.388889,1361045516354,1361045516738,1466897894,1466898278,384
1361045520,1466901540,35,41462,1184.628571,1361045516483,1361045516803,1466898023,1466898343,320
1361045520,1466901540,54,67848,1256.444444,1361045516546,1361045516994,1466898086,1466898534,448
1361045523,1466904072,5,4223,844.6,1361045497879,1361045506903,1466878951,1466887975,9024
1361045523,1466904072,15,15624,1041.6,1361045498197,1361045506965,1466879269,1466888037,8768
1361045523,1466904128,7,4126,589.4285714,1361045497950,1361045506782,1466879078,1466887910,8832
1361045526,105220860,58,78807,1358.741379,1361045498351,1361045506479,105193211,105201339,8128
1361045528,1466909456,33,37697,1142.333333,1361045522584,1361045522904,1466904040,1466904360,320
1361045528,1466909456,36,41598,1155.5,1361045522584,1361045522968,1466904040,1466904424,384
1361045528,1466909456,23,26348,1145.565217,1361045522584,1361045522840,1466904040,1466904296,256
1361045528,1466909456,23,27672,1203.130435,1361045522584,1361045522840,1466904040,1466904296,256
1361045528,1466909456,24,27984,1166,1361045522584,1361045522840,1466904040,1466904296,256
1361045528,1466909460,49,62098,1267.306122,1361045522897,1361045523281,1466904357,1466904741,384
1361045528,1466909460,4,1188,297,1361045522897,1361045522961,1466904357,1466904421,64
1361045528,1466909460,5,1928,385.6,1361045522901,1361045523093,1466904361,1466904553,192
1361045528,1466909468,3,908,302.6666667,1361045516171,1361045522507,1466897639,1466903975,6336
1361045528,1466909468,20,10640,532,1361045516234,1361045522698,1466897702,1466904166,6464
1361045528,1466909472,6,5336,889.3333333,1361045521606,1361045522374,1466903078,1466903846,768
1361045528,1466909492,6,1295,215.8333333,1361045516980,1361045523252,1466898472,1466904744,6272
1361045528,1466909496,52,63779,1226.519231,1361045522542,1361045522990,1466904038,1466904486,448
1361045528,1466909500,32,37092,1159.125,1361045522796,1361045523116,1466904296,1466904616,320
1361045528,1466909500,60,75475,1257.916667,1361045522796,1361045523308,1466904296,1466904808,512
1361045528,1466909500,25,27019,1080.76,1361045522796,1361045523052,1466904296,1466904552,256
1361045528,1466909500,30,34947,1164.9,1361045522859,1361045523179,1466904359,1466904679,320
1361045528,1466909500,49,60592,1236.571429,1361045522923,1361045523307,1466904423,1466904807,384
1361045528,1466909536,9,5700,633.3333333,1361045516232,1361045522824,1466897768,1466904360,6592
1361045536,1466917464,9,6295,699.4444444,1361045522894,1361045529422,1466904358,1466910886,6528
1361045536,1466917472,8,6135,766.875,1361045535496,1361045535816,1466916968,1466917288,320
1361045536,1466917472,4,1540,385,1361045535496,1361045535816,1466916968,1466917288,320
1361045536,1466917472,22,26733,1215.136364,1361045535495,1361045535815,1466916967,1466917287,320
1361045536,1466917472,6,5355,892.5,1361045528647,1361045528903,1466910119,1466910375,256
1361045536,1466917472,49,65027,1327.081633,1361045535495,1361045535815,1466916967,1466917287,320
1361045536,1466917472,9,7332,814.6666667,1361045535559,1361045535815,1466917031,1466917287,256
1361045536,1466917476,11,5380,489.0909091,1361045529028,1361045529220,1466910504,1466910696,192
1361045536,1466917476,37,45116,1219.351351,1361045529091,1361045529411,1466910567,1466910887,320
1361045536,1466917476,31,37067,1195.709677,1361045529091,1361045529411,1466910567,1466910887,320
1361045536,1466917476,4,592,148,1361045529026,1361045529090,1466910502,1466910566,64
1361045536,1466917476,58,72289,1246.362069,1361045529090,1361045529602,1466910566,1466911078,512
1361045536,1466917480,33,39140,1186.060606,1361045529408,1361045529664,1466910888,1466911144,256
1361045536,1466917480,27,30758,1139.185185,1361045529280,1361045529600,1466910760,1466911080,320
1361045536,1466917480,4,740,185,1361045529472,1361045529536,1466910952,1466911016,64
1361045536,1466917480,26,29554,1136.692308,1361045529343,1361045529599,1466910823,1466911079,256
1361045536,1466917480,52,64405,1238.557692,1361045529407,1361045529791,1466910887,1466911271,384
1361045536,1466917480,4,1025,256.25,1361045529471,1361045529471,1466910951,1466910951,0
1361045536,1466917504,51,61690,1209.607843,1361045529574,1361045529894,1466911078,1466911398,320
1361045536,1466917516,10,11112,1111.2,1361045535322,1361045535514,1466916838,1466917030,192
1361045536,1466917520,6,4400,733.3333333,1361045535449,1361045535769,1466916969,1466917289,320
1361045536,1466917520,8,6573,821.625,1361045535449,1361045535769,1466916969,1466917289,320
1361045536,1466917520,8,6080,760,1361045535448,1361045535768,1466916968,1466917288,320
1361045536,1466917520,6,3532,588.6666667,1361045535448,1361045535768,1466916968,1466917288,320
1361045536,1466917588,31,36325,1171.774194,1361045528916,1361045529172,1466910504,1466910760,256
1361045536,1466917588,35,41872,1196.342857,1361045528980,1361045529236,1466910568,1466910824,256
1361045536,1466917588,28,31888,1138.857143,1361045528979,1361045529235,1466910567,1466910823,256
1361045536,1466917588,4,790,197.5,1361045529297,1361045529361,1466910885,1466910949,64
1361045536,1466917588,7,4902,700.2857143,1361045529361,1361045529361,1466910949,1466910949,0
1361045536,1466917588,29,34773,1199.068966,1361045529233,1361045529553,1466910821,1466911141,320
1361045536,1466917592,4,789,197.25,1361045529297,1361045529361,1466910889,1466910953,64
1361045543,1466924100,13,10818,832.1538462,1361045517052,1361045523324,1466898152,1466904424,6272
1361045543,1466924104,33,40356,1222.909091,1361045517173,1361045517685,1466898277,1466898789,512
1361045543,1466924108,20,24212,1210.6,1361045517617,1361045517745,1466898725,1466898853,128
1361045543,1466924180,1,52,52,1361045517097,1361045517097,1466898277,1466898277,0
1361045543,1466924184,21,24952,1188.190476,1361045517544,1361045517672,1466898728,1466898856,128
1361045544,1466925472,4,1494,373.5,1361045535945,1361045537481,1466917417,1466918953,1536
1361045544,1466925472,10,4199,419.9,1361045535944,1361045537480,1466917416,1466918952,1536
1361045544,1466925472,78,105039,1346.653846,1361045535944,1361045537480,1466917416,1466918952,1536
1361045544,1466925480,12,11495,957.9166667,1361045536448,1361045537472,1466917928,1466918952,1024
1361045544,1466925484,18,8359,464.3888889,1361045535802,1361045537466,1466917286,1466918950,1664
1361045544,1466925484,41,51762,1262.487805,1361045537018,1361045537530,1466918502,1466919014,512
1361045544,1466925488,4,592,148,1361045537462,1361045537462,1466918950,1466918950,0
1361045544,1466925488,5,2509,501.8,1361045537462,1361045543414,1466918950,1466924902,5952
1361045544,1466925488,4,634,158.5,1361045537462,1361045537526,1466918950,1466919014,64
1361045544,1466925520,14,10392,742.2857143,1361045535893,1361045537429,1466917413,1466918949,1536
1361045544,1466925524,12,5767,480.5833333,1361045535893,1361045537429,1466917417,1466918953,1536
1361045544,1466925552,8,6789,848.625,1361045535733,1361045536373,1466917285,1466917925,640
1361045544,1466925556,26,18243,701.6538462,1361045535733,1361045537397,1466917289,1466918953,1664
1361045544,1466925560,61,80474,1319.245902,1361045529392,1361045537392,1466910952,1466918952,8000
1361045552,1466933468,20,10643,532.15,1361045544074,1361045547722,1466925542,1466929190,3648
1361045552,1466933476,21,21436,1020.761905,1361045547459,1361045547715,1466928935,1466929191,256
1361045552,1466933476,28,31477,1124.178571,1361045547459,1361045547779,1466928935,1466929255,320
1361045552,1466933476,66,82754,1253.848485,1361045547459,1361045547971,1466928935,1466929447,512
1361045552,1466933476,52,65081,1251.557692,1361045547649,1361045548033,1466929125,1466929509,384
1361045552,1466933480,48,57237,1192.4375,1361045547968,1361045548416,1466929448,1466929896,448
1361045552,1466933480,40,46616,1165.4,1361045547966,1361045548350,1466929446,1466929830,384
1361045552,1466933480,6,5365,894.1666667,1361045543805,1361045543997,1466925285,1466925477,192
1361045552,1466933512,195,263417,1350.85641,1361045516765,1361045544989,1466898277,1466926501,28224
1361045552,1466933524,6,5368,894.6666667,1361045547090,1361045547282,1466928614,1466928806,192
1361045552,1466933528,64,78609,1228.265625,1361045547407,1361045547919,1466928935,1466929447,512
1361045552,1466933528,73,93284,1277.863014,1361045547407,1361045547919,1466928935,1466929447,512
1361045552,1466933528,67,83235,1242.313433,1361045547406,1361045547918,1466928934,1466929446,512
1361045552,1466933552,30,33099,1103.3,1361045547640,1361045547960,1466929192,1466929512,320
1361045552,1466933552,30,33103,1103.433333,1361045547893,1361045548149,1466929445,1466929701,256
1361045552,1466933552,55,67273,1223.145455,1361045547893,1361045548341,1466929445,1466929893,448
1361045555,1466936128,1,52,52,1361045529757,1361045529757,1466910885,1466910885,0
1361045555,1466936208,1,52,52,1361045529679,1361045529679,1466910887,1466910887,0
1361045555,1466936208,1,52,52,1361045529679,1361045529679,1466910887,1466910887,0
1361045555,1466936208,4,1653,413.25,1361045529870,1361045529870,1466911078,1466911078,0
1361045559,1466940140,1,52,52,1361045534737,1361045534737,1466915877,1466915877,0
1361045560,1466941484,17,15374,904.3529412,1361045544121,1361045553977,1466925605,1466935461,9856
1361045560,1466941484,6,4379,729.8333333,1361045558780,1361045559164,1466940264,1466940648,384
1361045560,1466941484,33,38282,1160.060606,1361045558780,1361045559100,1466940264,1466940584,320
1361045560,1466941484,37,44717,1208.567568,1361045558779,1361045559163,1466940263,1466940647,384
1361045560,1466941484,22,23490,1067.727273,1361045558779,1361045559035,1466940263,1466940519,256
1361045560,1466941484,34,38640,1136.470588,1361045559033,1361045559289,1466940517,1466940773,256
1361045560,1466941488,26,29629,1139.576923,1361045559032,1361045559288,1466940520,1466940776,256
1361045560,1466941488,34,41382,1217.117647,1361045559157,1361045559477,1466940645,1466940965,320
1361045560,1466941520,41,51115,1246.707317,1361045553495,1361045553879,1466935015,1466935399,384
1361045560,1466941520,32,36843,1151.34375,1361045553495,1361045553751,1466935015,1466935271,256
1361045560,1466941520,33,37903,1148.575758,1361045553688,1361045554008,1466935208,1466935528,320
1361045560,1466941520,35,40951,1170.028571,1361045553815,1361045554135,1466935335,1466935655,320
1361045560,1466941520,38,44817,1179.394737,1361045553751,1361045554135,1466935271,1466935655,384
1361045560,1466941520,44,51201,1163.659091,1361045553878,1361045555222,1466935398,1466936742,1344
1361045560,1466941528,6,5403,900.5,1361045558285,1361045558477,1466939813,1466940005,192
1361045560,1466941528,28,32990,1178.214286,1361045558671,1361045558991,1466940199,1466940519,320
1361045560,1466941528,6,1448,241.3333333,1361045544079,1361045553423,1466925607,1466934951,9344
1361045560,1466941528,12,5432,452.6666667,1361045558734,1361045558926,1466940262,1466940454,192
1361045560,1466941528,4,592,148,1361045558734,1361045558734,1466940262,1466940262,0
1361045560,1466941528,37,44031,1190.027027,1361045558798,1361045559118,1466940326,1466940646,320
1361045560,1466941528,96,126986,1322.770833,1361045558798,1361045559630,1466940326,1466941158,832
1361045560,1466941532,36,41077,1141.027778,1361045559051,1361045559435,1466940583,1466940967,384
1361045560,1466941532,36,42103,1169.527778,1361045559178,1361045559626,1466940710,1466941158,448
1361045560,1466941532,39,48312,1238.769231,1361045559241,1361045559625,1466940773,1466941157,384
1361045560,1466941564,6,5398,899.6666667,1361045553131,1361045553323,1466934695,1466934887,192
1361045560,1466941568,11,5381,489.1818182,1361045553384,1361045553576,1466934952,1466935144,192
1361045560,1466941568,33,38773,1174.939394,1361045553320,1361045553640,1466934888,1466935208,320
1361045560,1466941568,37,44473,1201.972973,1361045553448,1361045553768,1466935016,1466935336,320
1361045560,1466941568,58,73842,1273.137931,1361045553448,1361045553832,1466935016,1466935400,384
1361045560,1466941568,45,53748,1194.4,1361045553447,1361045553895,1466935015,1466935463,448
1361045560,1466941568,21,23996,1142.666667,1361045553830,1361045554086,1466935398,1466935654,256
1361045560,1466941568,23,25949,1128.217391,1361045553829,1361045554085,1466935397,1466935653,256
1361045563,1466944132,1,46,46,1361045535834,1361045535834,1466916966,1466916966,0
1361045563,1466944132,1,46,46,1361045535834,1361045535834,1466916966,1466916966,0
1361045563,1466944156,3,624,208,1361045537859,1361045537987,1466919015,1466919143,128
1361045563,1466944156,9,4552,505.7777778,1361045537922,1361045538242,1466919078,1466919398,320
1361045563,1466944212,1,46,46,1361045535756,1361045535756,1466916968,1466916968,0
1361045563,1466944236,1,46,46,1361045537204,1361045537204,1466918440,1466918440,0
1361045563,1466944240,3,580,193.3333333,1361045537774,1361045537838,1466919014,1466919078,64
1361045563,1466944248,4,2567,641.75,1361045538535,1361045538599,1466919783,1466919847,64
1361045567,1466948184,3,361,120.3333333,1361045539240,1361045539240,1466920424,1466920424,0
1361045568,1466949488,6,5368,894.6666667,1361045562998,1361045563190,1466944486,1466944678,192
1361045568,1466949492,30,32864,1095.466667,1361045563188,1361045563508,1466944680,1466945000,320
1361045568,1466949492,7,5341,763,1361045563252,1361045563636,1466944744,1466945128,384
1361045568,1466949492,41,47630,1161.707317,1361045563316,1361045563636,1466944808,1466945128,320
1361045568,1466949492,27,32353,1198.259259,1361045563316,1361045563636,1466944808,1466945128,320
1361045568,1466949492,28,29903,1067.964286,1361045563315,1361045563571,1466944807,1466945063,256
1361045568,1466949492,46,54667,1188.413043,1361045563315,1361045563699,1466944807,1466945191,384
1361045568,1466949492,27,31114,1152.37037,1361045563570,1361045563826,1466945062,1466945318,256
1361045568,1466949492,6,5340,890,1361045567281,1361045567473,1466948773,1466948965,192
1361045568,1466949492,4,592,148,1361045567601,1361045567665,1466949093,1466949157,64
1361045568,1466949492,19,20303,1068.578947,1361045567601,1361045567857,1466949093,1466949349,256
1361045568,1466949496,27,30411,1126.333333,1361045563696,1361045564272,1466945192,1466945768,576
1361045568,1466949540,13,5484,421.8461538,1361045563203,1361045563395,1466944743,1466944935,192
1361045568,1466949540,4,592,148,1361045563203,1361045563267,1466944743,1466944807,64
1361045568,1466949540,23,25015,1087.608696,1361045563267,1361045563459,1466944807,1466944999,192
1361045568,1466949544,53,66922,1262.679245,1361045563453,1361045563901,1466944997,1466945445,448
1361045568,1466949544,33,39391,1193.666667,1361045563456,1361045563840,1466945000,1466945384,384
1361045568,1466949556,27,29462,1091.185185,1361045563572,1361045563828,1466945128,1466945384,256
1361045568,1466949560,28,30661,1095.035714,1361045563565,1361045563885,1466945125,1466945445,320
1361045568,1466949560,34,40142,1180.647059,1361045567599,1361045567855,1466949159,1466949415,256
1361045568,1466949560,28,32869,1173.892857,1361045567599,1361045567855,1466949159,1466949415,256
1361045568,1466949560,10,5329,532.9,1361045567598,1361045567854,1466949158,1466949414,256
1361045571,1466952144,61,81553,1336.934426,1361045544335,1361045568335,1466925479,1466949479,24000
1361045571,1466952180,1,52,52,1361045545323,1361045545323,1466926503,1466926503,0
1361045571,1466952180,1,52,52,1361045545323,1361045545323,1466926503,1466926503,0
1361045571,1466952240,33,43000,1303.030303,1361045545264,1361045545328,1466926504,1466926568,64
1361045571,1466952256,1,52,52,1361045545245,1361045545245,1466926501,1466926501,0
1361045576,1466957472,42,49553,1179.833333,1361045567943,1361045568263,1466949415,1466949735,320
1361045576,1466957472,2,131,65.5,1361045567942,1361045567942,1466949414,1466949414,0
1361045576,1466957472,35,40050,1144.285714,1361045567942,1361045568262,1466949414,1466949734,320
1361045576,1466957472,21,23124,1101.142857,1361045567942,1361045568198,1466949414,1466949670,256
1361045576,1466957472,42,51676,1230.380952,1361045568006,1361045568390,1466949478,1466949862,384
1361045576,1466957476,35,38957,1113.057143,1361045568131,1361045568451,1466949607,1466949927,320
1361045576,1466957476,19,19315,1016.578947,1361045574978,1361045575234,1466956454,1466956710,256
1361045576,1466957476,28,30414,1086.214286,1361045574978,1361045575298,1466956454,1466956774,320
1361045576,1466957476,4,592,148,1361045574978,1361045575042,1466956454,1466956518,64
1361045576,1466957476,34,40958,1204.647059,1361045574977,1361045575297,1466956453,1466956773,320
1361045576,1466957476,54,65687,1216.425926,1361045574977,1361045575361,1466956453,1466956837,384
1361045576,1466957476,55,69484,1263.345455,1361045574977,1361045575489,1466956453,1466956965,512
1361045576,1466957480,36,43992,1222,1361045575294,1361045575678,1466956774,1466957158,384
1361045576,1466957484,58,70980,1223.793103,1361045567673,1361045568121,1466949157,1466949605,448
1361045576,1466957520,42,49761,1184.785714,1361045567957,1361045568405,1466949477,1466949925,448
1361045576,1466957524,38,45293,1191.921053,1361045574931,1361045575251,1466956455,1466956775,320
1361045576,1466957524,10,5329,532.9,1361045574994,1361045575186,1466956518,1466956710,192
1361045576,1466957524,32,35799,1118.71875,1361045575122,1361045575506,1466956646,1466957030,384
1361045576,1466957524,36,41641,1156.694444,1361045575249,1361045575633,1466956773,1466957157,384
1361045576,1466957524,34,40689,1196.735294,1361045575185,1361045575633,1466956709,1466957157,448
1361045576,1466957528,44,55485,1261.022727,1361045575376,1361045575696,1466956904,1466957224,320
1361045576,1466957528,63,81103,1287.349206,1361045575439,1361045575887,1466956967,1466957415,448
1361045576,1466957528,38,44985,1183.815789,1361045567630,1361045567950,1466949158,1466949478,320
1361045576,1466957528,33,37941,1149.727273,1361045567629,1361045567949,1466949157,1466949477,320
1361045576,1466957568,7,6842,977.4285714,1361045574373,1361045574821,1466955941,1466956389,448
1361045584,1466965476,45,55881,1241.8,1361045578561,1361045578881,1466960037,1466960357,320
1361045584,1466965476,35,39876,1139.314286,1361045578561,1361045578945,1466960037,1466960421,384
1361045584,1466965476,30,35808,1193.6,1361045578561,1361045578945,1466960037,1466960421,384
1361045584,1466965480,19,21429,1127.842105,1361045582782,1361045582974,1466964262,1466964454,192
1361045584,1466965480,39,45944,1178.051282,1361045578941,1361045579261,1466960421,1466960741,320
1361045584,1466965480,54,66224,1226.37037,1361045578941,1361045579389,1466960421,1466960869,448
1361045584,1466965484,26,29533,1135.884615,1361045579000,1361045579320,1466960484,1466960804,320
1361045584,1466965484,54,66672,1234.666667,1361045583035,1361045583483,1466964519,1466964967,448
1361045584,1466965484,57,72192,1266.526316,1361045579003,1361045579451,1466960487,1466960935,448
1361045584,1466965484,24,25022,1042.583333,1361045582971,1361045583291,1466964455,1466964775,320
1361045584,1466965484,29,33873,1168.034483,1361045583098,1361045583354,1466964582,1466964838,256
1361045584,1466965532,6,5353,892.1666667,1361045582410,1361045582602,1466963942,1466964134,192
1361045584,1466965532,10,5328,532.8,1361045578569,1361045578761,1466960101,1466960293,192
1361045584,1466965536,12,5432,452.6666667,1361045582727,1361045582919,1466964263,1466964455,192
1361045584,1466965536,30,32389,1079.633333,1361045582727,1361045583047,1466964263,1466964583,320
1361045584,1466965536,37,44571,1204.621622,1361045582663,1361045582983,1466964199,1466964519,320
1361045584,1466965536,27,31567,1169.148148,1361045582726,1361045583046,1466964262,1466964582,320
1361045584,1466965536,23,27084,1177.565217,1361045582726,1361045582982,1466964262,1466964518,256
1361045584,1466965536,27,29969,1109.962963,1361045582726,1361045583046,1466964262,1466964582,320
1361045584,1466965536,27,31853,1179.740741,1361045578821,1361045579077,1466960357,1466960613,256
1361045584,1466965536,48,58944,1228,1361045578885,1361045579269,1466960421,1466960805,384
1361045584,1466965540,34,38810,1141.470588,1361045582979,1361045583299,1466964519,1466964839,320
1361045584,1466965540,34,38692,1138,1361045583043,1361045583363,1466964583,1466964903,320
1361045584,1466965540,27,31490,1166.296296,1361045582978,1361045583298,1466964518,1466964838,320
1361045584,1466965564,22,22373,1016.954545,1361045567595,1361045583019,1466949159,1466964583,15424
1361045584,1466965576,6,5426,904.3333333,1361045578016,1361045578208,1466959592,1466959784,192
1361045584,1466965576,4,592,148,1361045578462,1361045578462,1466960038,1466960038,0
1361045584,1466965576,61,75036,1230.098361,1361045578461,1361045578909,1466960037,1466960485,448
1361045584,1466965576,38,46886,1233.842105,1361045578461,1361045578781,1466960037,1466960357,320
1361045584,1466965576,41,49655,1211.097561,1361045578461,1361045578909,1466960037,1466960485,448
1361045591,1466972268,1,52,52,1361045565650,1361045565650,1466946918,1466946918,0
1361045595,1466976160,1,52,52,1361045568317,1361045568317,1466949477,1466949477,0
1361045595,1466976172,2,141,70.5,1361045568112,1361045568112,1466949284,1466949284,0
1361045599,1466980164,1,46,46,1361045572091,1361045572091,1466953255,1466953255,0
1361045599,1466980164,1,46,46,1361045572281,1361045572281,1466953445,1466953445,0
1361045600,1466981500,6,5442,907,1361045599466,1361045599658,1466980966,1466981158,192
1361045600,1466981508,39,47683,1222.641026,1361045593316,1361045593636,1466974824,1466975144,320
1361045600,1466981508,33,37754,1144.060606,1361045593316,1361045593636,1466974824,1466975144,320
1361045600,1466981508,25,27333,1093.32,1361045593315,1361045593635,1466974823,1466975143,320
1361045600,1466981528,47,57607,1225.680851,1361045593614,1361045594062,1466975142,1466975590,448
1361045600,1466981528,29,33961,1171.068966,1361045593678,1361045593998,1466975206,1466975526,320
1361045600,1466981528,58,71499,1232.741379,1361045593614,1361045594062,1466975142,1466975590,448
1361045600,1466981536,5,1020,204,1361045582661,1361045593221,1466964197,1466974757,10560
1361045600,1466981544,4,634,158.5,1361045599549,1361045599677,1466981093,1466981221,128
1361045600,1466981548,4,592,148,1361045599676,1361045599676,1466981224,1466981224,0
1361045600,1466981572,6,5376,896,1361045592932,1361045593124,1466974504,1466974696,192
1361045600,1466981572,28,34658,1237.785714,1361045599587,1361045599843,1466981159,1466981415,256
1361045600,1466981572,27,29599,1096.259259,1361045593122,1361045593442,1466974694,1466975014,320
1361045600,1466981572,6,4389,731.5,1361045593185,1361045593569,1466974757,1466975141,384
1361045600,1466981572,11,5381,489.1818182,1361045593185,1361045593377,1466974757,1466974949,192
1361045600,1466981572,49,61634,1257.836735,1361045593249,1361045593633,1466974821,1466975205,384
1361045600,1466981576,35,39617,1131.914286,1361045593436,1361045593756,1466975012,1466975332,320
1361045600,1466981576,10,8231,823.1,1361045593248,1361045593376,1466974824,1466974952,128
1361045600,1466981576,40,46426,1160.65,1361045593375,1361045593695,1466974951,1466975271,320
1361045600,1466981576,36,41115,1142.083333,1361045593502,1361045593886,1466975078,1466975462,384
1361045603,1466984152,1,52,52,1361045576261,1361045576261,1466957413,1466957413,0
1361045603,1466984232,1,52,52,1361045576180,1361045576180,1466957412,1466957412,0
1361045608,1466989508,29,34704,1196.689655,1361045599971,1361045600227,1466981479,1466981735,256
1361045608,1466989508,36,43434,1206.5,1361045600098,1361045600546,1466981606,1466982054,448
1361045608,1466989508,38,45863,1206.921053,1361045600225,1361045600545,1466981733,1466982053,320
1361045608,1466989512,50,59231,1184.62,1361045600224,1361045600672,1466981736,1466982184,448
1361045608,1466989520,35,41682,1190.914286,1361045599764,1361045600084,1466981284,1466981604,320
1361045608,1466989520,13,5483,421.7692308,1361045599701,1361045599893,1466981221,1466981413,192
1361045608,1466989520,42,52257,1244.214286,1361045599765,1361045600213,1466981285,1466981733,448
1361045608,1466989556,34,38114,1121,1361045600051,1361045600499,1466981607,1466982055,448
1361045608,1466989556,75,95823,1277.64,1361045600177,1361045600689,1466981733,1466982245,512
1361045608,1466989564,7,4545,649.2857143,1361045599656,1361045600104,1466981220,1466981668,448
1361045608,1466989588,29,34918,1204.068966,1361045599700,1361045600020,1466981288,1466981608,320
1361045608,1466989588,53,66908,1262.415094,1361045599700,1361045600148,1466981288,1466981736,448
1361045608,1466989592,66,85214,1291.121212,1361045599692,1361045600204,1466981284,1466981796,512
1361045616,1466997536,10,11139,1113.9,1361045608519,1361045608775,1466990055,1466990311,256
1361045616,1466997540,43,56566,1315.488372,1361045608836,1361045612932,1466990376,1466994472,4096
1361045616,1466997572,2,92,46,1361045610339,1361045610339,1466991911,1466991911,0
1361045616,1466997616,4,876,219,1361045610229,1361045615285,1466991845,1466996901,5056
1361045623,1467004288,2,104,52,1361045597820,1361045609020,1466979108,1466990308,11200
1361045623,1467004296,2,104,52,1361045598644,1361045611892,1466979940,1466993188,13248
1361045624,1467005536,6,5356,892.6666667,1361045623047,1361045623239,1467004583,1467004775,192
1361045624,1467005540,27,29670,1098.888889,1361045623300,1361045623556,1467004840,1467005096,256
1361045624,1467005540,38,45573,1199.289474,1361045623299,1361045623683,1467004839,1467005223,384
1361045624,1467005552,7,5483,783.2857143,1361045618039,1361045618231,1466999591,1466999783,192
1361045624,1467005584,26,28306,1088.692308,1361045623254,1361045623574,1467004838,1467005158,320
1361045624,1467005584,26,27836,1070.615385,1361045623254,1361045623574,1467004838,1467005158,320
1361045624,1467005584,67,85042,1269.283582,1361045623254,1361045623766,1467004838,1467005350,512
1361045624,1467005584,20,22721,1136.05,1361045623509,1361045623765,1467005093,1467005349,256
1361045624,1467005584,28,30801,1100.035714,1361045623508,1361045623828,1467005092,1467005412,320
1361045624,1467005620,6,1448,241.3333333,1361045610032,1361045623216,1466991652,1467004836,13184
1361045624,1467005620,20,10651,532.55,1361045618354,1361045623346,1466999974,1467004966,4992
1361045627,1467008164,1,52,52,1361045600251,1361045600251,1466981415,1466981415,0
1361045627,1467008260,1,52,52,1361045599834,1361045599834,1466981094,1466981094,0
1361045632,1467013572,102,129122,1265.901961,1361045623265,1361045623969,1467004837,1467005541,704
1361045632,1467013576,35,40449,1155.685714,1361045623644,1361045623964,1467005220,1467005540,320
1361045632,1467013580,26,25069,964.1923077,1361045608730,1361045623898,1466990310,1467005478,15168
1361045632,1467013580,35,40915,1169,1361045623770,1361045624154,1467005350,1467005734,384
1361045632,1467013624,59,70148,1188.949153,1361045623469,1361045623981,1467005093,1467005605,512
1361045632,1467013648,44,55134,1253.045455,1361045623701,1361045624085,1467005349,1467005733,384
1361045635,1467016208,1,52,52,1361045608271,1361045608271,1466989479,1466989479,0
1361045635,1467016208,1,52,52,1361045608333,1361045608333,1466989541,1466989541,0
1361045635,1467016208,1,52,52,1361045608333,1361045608333,1466989541,1466989541,0
1361045635,1467016216,1,46,46,1361045607428,1361045607428,1466988644,1466988644,0
1361045635,1467016268,4,632,158,1361045610579,1361045634387,1466991847,1467015655,23808
1361045635,1467016268,4,635,158.75,1361045610514,1361045634194,1466991782,1467015462,23680
1361045635,1467016268,1,52,52,1361045610514,1361045610514,1466991782,1466991782,0
1361045635,1467016268,1,46,46,1361045610578,1361045610578,1466991846,1466991846,0
1361045635,1467016268,10,4722,472.2,1361045610641,1361045634449,1466991909,1467015717,23808
1361045635,1467016300,2,104,52,1361045607601,1361045610481,1466988901,1466991781,2880
1361045635,1467016304,6,3041,506.8333333,1361045609070,1361045634606,1466990374,1467015910,25536
1361045635,1467016304,4,547,136.75,1361045609069,1361045634605,1466990373,1467015909,25536
1361045635,1467016336,61,82660,1355.081967,1361045609614,1361045634126,1466990950,1467015462,24512
1361045635,1467016344,21,24465,1165,1361045610311,1361045634119,1466991655,1467015463,23808
1361045635,1467016344,4,675,168.75,1361045610500,1361045634308,1466991844,1467015652,23808
1361045639,1467020200,4,413,103.25,1361045611988,1361045635284,1466993188,1467016484,23296
1361045640,1467021588,29,36428,1256.137931,1361045632080,1361045636176,1467013668,1467017764,4096
1361045640,1467021672,10,11171,1117.1,1361045631743,1361045631935,1467013415,1467013607,192
1361045648,1467029580,6,5354,892.3333333,1361045639961,1361045640153,1467021541,1467021733,192
1361045648,1467029584,21,20169,960.4285714,1361045632020,1361045641556,1467013604,1467023140,9536
1361045648,1467029592,6,2281,380.1666667,1361045640652,1361045641548,1467022244,1467023140,896
1361045648,1467029620,10,11107,1110.7,1361045641522,1361045641714,1467023142,1467023334,192
1361045648,1467029624,5,1020,204,1361045633839,1361045641519,1467015463,1467023143,7680
1361045648,1467029640,10,5329,532.9,1361045640479,1361045641567,1467022119,1467023207,1088
1361045648,1467029668,2,141,70.5,1361045641218,1361045641218,1467022886,1467022886,0
1361045648,1467029668,2,92,46,1361045641728,1361045641728,1467023396,1467023396,0
1361045648,1467029672,19,21604,1137.052632,1361045641726,1361045645822,1467023398,1467027494,4096
1361045646,105340908,116,143957,1241.008621,1361045346433,1361045347009,105041341,105041917,576
1361045646,105340908,139,180291,1297.057554,1361045346433,1361045346753,105041341,105041661,320
1361045655,1467036196,4,1019,254.75,1361045627547,1361045627611,1467008743,1467008807,64
1361045655,1467036196,15,16477,1098.466667,1361045627610,1361045629210,1467008806,1467010406,1600
1361045656,1467037588,5,734,146.8,1361045650515,1361045651027,1467032103,1467032615,512
1361045656,1467037592,4,592,148,1361045651022,1361045651086,1467032614,1467032678,64
1361045656,1467037596,10,8129,812.9,1361045643211,1361045650251,1467024807,1467031847,7040
1361045656,1467037628,10,7786,778.6,1361045650217,1361045650473,1467031845,1467032101,256
1361045656,1467037628,22,22881,1040.045455,1361045641704,1361045650984,1467023332,1467032612,9280
1361045656,1467037628,2,92,46,1361045650216,1361045650216,1467031844,1467031844,0
1361045656,1467037632,5,1408,281.6,1361045650407,1361045650471,1467032039,1467032103,64
1361045656,1467037632,9,6893,765.8888889,1361045650407,1361045650471,1467032039,1467032103,64
1361045656,1467037640,5,872,174.4,1361045651037,1361045651101,1467032677,1467032741,64
1361045656,1467037640,12,10980,915,1361045651037,1361045651101,1467032677,1467032741,64
1361045656,1467037640,4,655,163.75,1361045651037,1361045651101,1467032677,1467032741,64
1361045656,1467037640,4,714,178.5,1361045651100,1361045651228,1467032740,1467032868,128
1361045656,1467037640,4,893,223.25,1361045651100,1361045651228,1467032740,1467032868,128
1361045656,1467037640,5,804,160.8,1361045651227,1361045653403,1467032867,1467035043,2176
1361045656,1467037676,5,2390,478,1361045650040,1361045650168,1467031716,1467031844,128
1361045656,1467037680,11,9404,854.9090909,1361045650167,1361045650423,1467031847,1467032103,256
1361045656,1467037680,5,1886,377.2,1361045650167,1361045650231,1467031847,1467031911,64
1361045656,1467037680,9,8572,952.4444444,1361045650167,1361045650359,1467031847,1467032039,192
1361045656,1467037680,28,35237,1258.464286,1361045650167,1361045650295,1467031847,1467031975,128
1361045656,1467037680,12,10979,914.9166667,1361045650358,1361045650422,1467032038,1467032102,64
1361045656,1467037680,9,6566,729.5555556,1361045650358,1361045650422,1467032038,1467032102,64
1361045656,1467037680,9,7565,840.5555556,1361045650357,1361045650421,1467032037,1467032101,64
1361045656,1467037680,129,176332,1366.914729,1361045653492,1361045654388,1467035172,1467036068,896
1361045659,1467040308,4,1048,262,1361045634347,1361045643563,1467015655,1467024871,9216
1361045659,1467040308,5,1188,237.6,1361045634411,1361045643627,1467015719,1467024935,9216
1361045659,1467040312,6,5022,837,1361045634599,1361045644391,1467015911,1467025703,9792
1361045659,1467040316,1,46,46,1361045632354,1361045632354,1467013670,1467013670,0
1361045659,1467040360,38,48714,1281.947368,1361045634099,1361045643443,1467015459,1467024803,9344
1361045659,1467040360,4,1054,263.5,1361045634099,1361045643443,1467015459,1467024803,9344
1361045659,1467040392,9,5317,590.7777778,1361045634323,1361045643539,1467015715,1467024931,9216
1361045663,1467044280,4,610,152.5,1361045635206,1361045644998,1467016486,1467026278,9792
1361045664,1467045636,10,11139,1113.9,1361045663328,1361045663520,1467044964,1467045156,192
1361045667,1467048360,5,2229,445.8,1361045642550,1361045642614,1467023910,1467023974,64
1361045671,1467052264,77,106102,1377.948052,1361045643092,1361045665172,1467024356,1467046436,22080
1361045671,1467052308,1,52,52,1361045645544,1361045645544,1467026852,1467026852,0
1361045671,1467052308,1,52,52,1361045645608,1361045645608,1467026916,1467026916,0
1361045672,1467053656,2,131,65.5,1361045664844,1361045664844,1467046500,1467046500,0
1361045675,1467056304,1,46,46,1361045649391,1361045649391,1467030695,1467030695,0
1361045680,1467061608,4,578,144.5,1361045675837,1361045675901,1467057445,1467057509,64
1361045680,1467061644,4,578,144.5,1361045674585,1361045674649,1467056229,1467056293,64
1361045687,1467068188,1,52,52,1361045659232,1361045659232,1467040420,1467040420,0
1361045687,1467068268,1,52,52,1361045659154,1361045659154,1467040422,1467040422,0
1361045688,1467069576,4,655,163.75,1361045687324,1361045687452,1467068900,1467069028,128
1361045688,1467069580,19,17500,921.0526316,1361045663576,1361045686680,1467045156,1467068260,23104
1361045688,1467069584,4,592,148,1361045664854,1361045687318,1467046438,1467068902,22464
1361045688,1467069612,5,2390,478,1361045686521,1361045686649,1467068133,1467068261,128
1361045691,1467072204,5,2229,445.8,1361045664849,1361045664913,1467046053,1467046117,64
1361045691,1467072208,1,52,52,1361045665227,1361045665227,1467046435,1467046435,0
1361045691,1467072240,8,4591,573.875,1361045665259,1361045665579,1467046499,1467046819,320
1361045691,1467072248,1,52,52,1361045666148,1361045666148,1467047396,1467047396,0
1361045691,1467072252,1,52,52,1361045666274,1361045666274,1467047526,1467047526,0
1361045691,1467072296,3,583,194.3333333,1361045665143,1361045665207,1467046439,1467046503,64
1361045691,1467072324,5,2619,523.8,1361045666075,1361045666139,1467047399,1467047463,64
1361045691,1467072324,3,362,120.6666667,1361045666265,1361045666265,1467047589,1467047589,0
1361045696,1467077640,2,131,65.5,1361045695195,1361045695195,1467076835,1467076835,0
1361045707,1467088344,1,52,52,1361045679555,1361045679555,1467060899,1467060899,0
1361045711,1467092204,1,46,46,1361045683215,1361045683215,1467064419,1467064419,0
1361045711,1467092208,1,46,46,1361045683595,1361045683595,1467064803,1467064803,0
1361045715,1467096240,6,4489,748.1666667,1361045687021,1361045687533,1467068261,1467068773,512
1361045715,1467096328,3,540,180,1361045687573,1361045687573,1467068901,1467068901,0
1361045715,1467096328,1,46,46,1361045688724,1361045688724,1467070052,1467070052,0
1361045718,105412752,2,104,52,1361045717277,1361045717533,105412029,105412285,256
1361045718,105412752,3,150,50,1361045717277,1361045717597,105412029,105412349,320
1361045718,105412752,3,150,50,1361045717277,1361045717597,105412029,105412349,320
1361045718,105412752,3,150,50,1361045717277,1361045717597,105412029,105412349,320
1361045718,105412752,2,104,52,1361045717277,1361045717533,105412029,105412285,256
1361045718,105412752,2,104,52,1361045717277,1361045717405,105412029,105412157,128
1361045718,105412756,3,150,50,1361045717272,1361045717592,105412028,105412348,320
1361045718,105412756,3,150,50,1361045717272,1361045717592,105412028,105412348,320
1361045718,105412756,4,202,50.5,1361045717272,1361045717592,105412028,105412348,320
1361045718,105412756,2,104,52,1361045717272,1361045717528,105412028,105412284,256
1361045718,105412756,4,202,50.5,1361045717272,1361045717592,105412028,105412348,320
1361045718,105412756,2,104,52,1361045717272,1361045717400,105412028,105412156,128
1361045720,1467101632,3,144,48,1361045713571,1361045718179,1467095203,1467099811,4608
1361045720,1467101656,2,92,46,1361045717259,1361045718155,1467098915,1467099811,896
1361045720,1467101656,2,104,52,1361045717259,1361045717451,1467098915,1467099107,192
1361045720,1467101660,3,150,50,1361045717255,1361045717511,1467098915,1467099171,256
1361045720,1467101660,3,230,76.66666667,1361045717254,1361045717446,1467098914,1467099106,192
1361045720,1467101660,2,92,46,1361045717254,1361045717254,1467098914,1467098914,0
1361045720,1467101660,3,150,50,1361045717254,1361045717510,1467098914,1467099170,256
1361045720,1467101660,3,230,76.66666667,1361045717254,1361045717510,1467098914,1467099170,256
1361045720,1467101660,3,230,76.66666667,1361045717254,1361045717510,1467098914,1467099170,256
1361045720,1467101660,2,104,52,1361045717254,1361045717382,1467098914,1467099042,128
1361045720,1467101660,3,150,50,1361045717256,1361045717512,1467098916,1467099172,256
1361045720,1467101660,2,104,52,1361045717256,1361045717448,1467098916,1467099108,192
1361045720,1467101660,3,230,76.66666667,1361045717256,1361045717448,1467098916,1467099108,192
1361045720,1467101660,2,92,46,1361045717256,1361045718152,1467098916,1467099812,896
1361045720,1467101660,3,230,76.66666667,1361045717256,1361045717512,1467098916,1467099172,256
1361045720,1467101660,2,92,46,1361045717256,1361045718152,1467098916,1467099812,896
1361045720,1467101660,3,230,76.66666667,1361045717256,1361045717512,1467098916,1467099172,256
1361045720,1467101660,3,193,64.33333333,1361045717320,1361045717320,1467098980,1467098980,0
1361045720,1467101704,3,150,50,1361045717212,1361045717468,1467098916,1467099172,256
1361045720,1467101704,3,150,50,1361045717212,1361045717468,1467098916,1467099172,256
1361045720,1467101704,3,150,50,1361045717212,1361045717468,1467098916,1467099172,256
1361045720,1467101704,2,92,46,1361045717212,1361045718108,1467098916,1467099812,896
1361045720,1467101704,5,346,69.2,1361045717212,1361045717404,1467098916,1467099108,192
1361045720,1467101704,3,230,76.66666667,1361045717212,1361045717468,1467098916,1467099172,256
1361045720,1467101704,3,230,76.66666667,1361045717212,1361045717468,1467098916,1467099172,256
1361045720,1467101704,3,230,76.66666667,1361045717212,1361045717468,1467098916,1467099172,256
1361045720,1467101704,2,104,52,1361045717212,1361045717404,1467098916,1467099108,192
1361045720,1467101704,3,150,50,1361045717276,1361045717532,1467098980,1467099236,256
1361045720,1467101704,2,104,52,1361045717211,1361045717403,1467098915,1467099107,192
1361045720,1467101704,5,346,69.2,1361045717211,1361045717467,1467098915,1467099171,256
1361045720,1467101704,4,282,70.5,1361045717210,1361045717466,1467098914,1467099170,256
1361045720,1467101704,3,230,76.66666667,1361045717210,1361045717466,1467098914,1467099170,256
1361045720,1467101708,2,92,46,1361045717274,1361045717274,1467098982,1467098982,0
1361045739,1467120388,2,104,52,1361045711510,1361045717526,1467092898,1467098914,6016
1361045743,1467124336,1,46,46,1361045717578,1361045717578,1467098914,1467098914,0
1361045743,1467124340,1,46,46,1361045717574,1361045717574,1467098914,1467098914,0
1361045743,1467124340,1,46,46,1361045717578,1361045717578,1467098918,1467098918,0
1361045743,1467124340,1,46,46,1361045717578,1361045717578,1467098918,1467098918,0
1361045743,1467124340,1,46,46,1361045717706,1361045717706,1467099046,1467099046,0
1361045743,1467124340,1,46,46,1361045717575,1361045717575,1467098915,1467098915,0
1361045743,1467124340,1,46,46,1361045717575,1361045717575,1467098915,1467098915,0
1361045743,1467124340,1,52,52,1361045717575,1361045717575,1467098915,1467098915,0
1361045743,1467124340,1,46,46,1361045717575,1361045717575,1467098915,1467098915,0
1361045743,1467124340,1,46,46,1361045717575,1361045717575,1467098915,1467098915,0
1361045743,1467124340,1,46,46,1361045717575,1361045717575,1467098915,1467098915,0
1361045743,1467124340,1,46,46,1361045717574,1361045717574,1467098914,1467098914,0
1361045743,1467124340,1,46,46,1361045717574,1361045717574,1467098914,1467098914,0
1361045743,1467124340,1,46,46,1361045717638,1361045717638,1467098978,1467098978,0
1361045743,1467124412,1,46,46,1361045717505,1361045717505,1467098917,1467098917,0
1361045743,1467124412,1,46,46,1361045717505,1361045717505,1467098917,1467098917,0
1361045743,1467124412,1,46,46,1361045717505,1361045717505,1467098917,1467098917,0
1361045743,1467124412,1,46,46,1361045717505,1361045717505,1467098917,1467098917,0
1361045743,1467124412,1,46,46,1361045717503,1361045717503,1467098915,1467098915,0
1361045743,1467124412,1,46,46,1361045717503,1361045717503,1467098915,1467098915,0
1361045743,1467124412,1,46,46,1361045717503,1361045717503,1467098915,1467098915,0
1361045743,1467124412,1,46,46,1361045717502,1361045717502,1467098914,1467098914,0
1361045979,1467360864,1,76,76,1361045954681,1361045954681,1467336545,1467336545,0
1361046001,1467382100,4,917,229.25,1361045984054,1361045996982,1467365154,1467378082,12928
1361046008,1467389136,41,53476,1304.292683,1361045983183,1361045984079,1467364319,1467365215,896
1361046008,1467389136,70,93297,1332.814286,1361045983183,1361045984015,1467364319,1467365151,832
1361046008,1467389224,50,63251,1265.02,1361045982967,1361045983991,1467364191,1467365215,1024
1361046011,105705332,54,67956,1258.444444,1361045983171,1361045984323,105677503,105678655,1152
1361046011,105705332,49,60517,1235.040816,1361045983171,1361045984323,105677503,105678655,1152
1361046011,105705336,3,1107,369,1361045984062,1361045984062,105678398,105678398,0
1361046011,105705360,78,103044,1321.076923,1361045983143,1361045984295,105677503,105678655,1152
1361046011,105705360,91,117793,1294.428571,1361045983143,1361045984295,105677503,105678655,1152
1361046011,105705360,98,129375,1320.153061,1361045983143,1361045984295,105677503,105678655,1152
1361046011,105705368,25,32446,1297.84,1361045984030,1361045984094,105678398,105678462,64
1361046011,105705368,29,38516,1328.137931,1361045984030,1361045984158,105678398,105678526,128
1361046011,105705368,29,38516,1328.137931,1361045984030,1361045984158,105678398,105678526,128
1361046011,1467392784,8,5239,654.875,1361045983050,1361045983370,1467364834,1467365154,320
1361046011,1467392856,6,4948,824.6666667,1361045982850,1361045982850,1467364706,1467364706,0
1361046011,1467392856,16,18170,1135.625,1361045982849,1361045983297,1467364705,1467365153,448
1361046011,1467392860,9,5297,588.5555556,1361045982974,1361045983294,1467364834,1467365154,320
1361046025,1467406064,11,9740,885.4545455,1361046004823,1361046020055,1467385887,1467401119,15232
1361046025,1467406064,67,87723,1309.298507,1361046004694,1361046020246,1467385758,1467401310,15552
1361046025,1467406068,17,19190,1128.823529,1361046004821,1361046020053,1467385889,1467401121,15232
1361046025,1467406112,14,14089,1006.357143,1361046004775,1361046020007,1467385887,1467401119,15232
1361046025,1467406116,21,23089,1099.47619,1361046004770,1361046020002,1467385886,1467401118,15232
1361046038,105732760,113,150278,1329.893805,1361045982742,1361046034710,105677502,105729470,51968
1361046041,1467422112,284,397396,1399.28169,1361045983208,1361046035240,1467364320,1467416352,52032
1361046041,1467422164,2,104,52,1361046035189,1361046035189,1467416353,1467416353,0
1361046041,1467422180,2,104,52,1361046035172,1361046035172,1467416352,1467416352,0
1361046059,105753644,1,52,52,1361046034826,1361046034826,105729470,105729470,0
1361046059,105753644,1,52,52,1361046034826,1361046034826,105729470,105729470,0
1361046059,105753644,1,52,52,1361046034826,1361046034826,105729470,105729470,0
1361046059,105753644,1,52,52,1361046034826,1361046034826,105729470,105729470,0
1361046059,1467440880,1,52,52,1361046034471,1361046034471,1467416351,1467416351,0
1361046059,1467440880,1,52,52,1361046034471,1361046034471,1467416351,1467416351,0
1361046059,1467440880,1,52,52,1361046034471,1361046034471,1467416351,1467416351,0
1361046059,1467440880,1,52,52,1361046034470,1361046034470,1467416350,1467416350,0
1361046060,1467440964,1,52,52,1361046035388,1361046035388,1467416352,1467416352,0
1361046060,1467440964,1,52,52,1361046035388,1361046035388,1467416352,1467416352,0
1361046060,1467440964,1,52,52,1361046035388,1361046035388,1467416352,1467416352,0
1361046060,1467440964,1,52,52,1361046035388,1361046035388,1467416352,1467416352,0
1361046060,1467440964,1,52,52,1361046035388,1361046035388,1467416352,1467416352,0
1361046060,1467440964,1,52,52,1361046035388,1361046035388,1467416352,1467416352,0
1361046063,105757552,1,52,52,1361046034917,1361046034917,105729469,105729469,0
1361046063,105757552,1,52,52,1361046034917,1361046034917,105729469,105729469,0
1361046063,105757552,1,52,52,1361046034917,1361046034917,105729469,105729469,0
1361046063,105757552,1,52,52,1361046034917,1361046034917,105729469,105729469,0
1361046063,105757552,1,52,52,1361046034917,1361046034917,105729469,105729469,0
1361046065,1467446144,36,42596,1183.222222,1361046055816,1361046059784,1467436960,1467440928,3968
1361046073,1467454096,51,41714,817.9215686,1361046055861,1361046072437,1467436957,1467453533,16576
1361046073,1467454096,123,126772,1030.666667,1361046055861,1361046072437,1467436957,1467453533,16576
1361046073,1467454096,143,144048,1007.328671,1361046055861,1361046071925,1467436957,1467453021,16064
1361046073,1467454100,28,27424,979.4285714,1361046056117,1361046072373,1467437217,1467453473,16256
1361046073,1467454132,5,1186,237.2,1361046053842,1361046068882,1467434974,1467450014,15040
1361046073,1467454144,134,124832,931.5820896,1361046055816,1361046072392,1467436960,1467453536,16576
1361046073,1467454144,99,94590,955.4545455,1361046055816,1361046071944,1467436960,1467453088,16128
1361046073,1467454176,8,1179,147.375,1361046056679,1361046072551,1467437855,1467453727,15872
1361046073,1467454184,4,759,189.75,1361046053983,1361046069023,1467435167,1467450207,15040
1361046073,1467454188,4,565,141.25,1361046054169,1361046069209,1467435357,1467450397,15040
1361046079,1467460864,33,25387,769.3030303,1361046053561,1361046072185,1467435425,1467454049,18624
1361046079,1467460864,7,1656,236.5714286,1361046054070,1361046054134,1467435934,1467435998,64
1361046084,1467464980,49,54750,1117.346939,1361046056874,1361046072938,1467437854,1467453918,16064
1361046089,1467470092,2,141,70.5,1361046087802,1361046087802,1467468894,1467468894,0
1361046089,1467470144,2,141,70.5,1361046087944,1361046087944,1467469088,1467469088,0
1361046100,1467481044,6,1258,209.6666667,1361046072428,1361046073004,1467453472,1467454048,576
1361046100,1467481064,6,2532,422,1361046072469,1361046072917,1467453533,1467453981,448
1361046105,1467486140,2,104,52,1361046102986,1361046102986,1467484126,1467484126,0
1361046105,1467486216,2,92,46,1361046102909,1361046102909,1467484125,1467484125,0
1361046108,1467488960,429,457874,1067.305361,1361046055101,1361046103165,1467436061,1467484125,48064
1361046128,1467509024,1,46,46,1361046103103,1361046103103,1467484127,1467484127,0
1361046128,1467509024,1,52,52,1361046103103,1361046103103,1467484127,1467484127,0
1361046128,1467509024,1,46,46,1361046103102,1361046103102,1467484126,1467484126,0
1361046128,1467509024,1,52,52,1361046103102,1361046103102,1467484126,1467484126,0
1361046128,1467509108,1,46,46,1361046103018,1361046103018,1467484126,1467484126,0
1361046128,1467509108,1,52,52,1361046103018,1361046103018,1467484126,1467484126,0
1361046128,1467509108,1,52,52,1361046103018,1361046103018,1467484126,1467484126,0
1361046260,1467641180,21,7850,373.8095238,1361046235232,1361046249376,1467616412,1467630556,14144
1361046260,1467641180,10,5272,527.2,1361046235232,1361046248864,1467616412,1467630044,13632
1361046260,1467641280,16,5514,344.625,1361046235131,1361046249275,1467616411,1467630555,14144
1361046260,1467641280,10,3070,307,1361046235195,1361046248827,1467616475,1467630107,13632
1361046260,1467641280,6,2532,422,1361046235130,1361046235642,1467616410,1467616922,512
1361046265,1467646188,2,141,70.5,1361046264407,1361046264407,1467645595,1467645595,0
1361046265,1467646188,2,141,70.5,1361046264343,1361046264343,1467645531,1467645531,0
1361046273,1467654284,200,198244,991.22,1361046234103,1361046266551,1467615387,1467647835,32448
1361046273,1467654288,4,208,52,1361046266485,1361046266549,1467647773,1467647837,64
1361046273,1467654288,5,260,52,1361046266485,1361046266549,1467647773,1467647837,64
1361046292,1467673328,1,46,46,1361046267402,1361046267402,1467648730,1467648730,0
1361046292,1467673332,1,46,46,1361046267400,1361046267400,1467648732,1467648732,0
1361046292,1467673332,14,3983,284.5,1361046267464,1361046290504,1467648796,1467671836,23040
1361046292,1467673416,8,3168,396,1361046267250,1361046274866,1467648666,1467656282,7616
1361046292,1467673416,18,5479,304.3888889,1361046267317,1361046290421,1467648733,1467671837,23104
1361046292,1467673416,2,104,52,1361046267380,1361046267380,1467648796,1467648796,0
1361046292,1467673416,6,2532,422,1361046267380,1361046267828,1467648796,1467649244,448
1361046292,1467673416,8,2164,270.5,1361046267380,1361046274932,1467648796,1467656348,7552
1361046297,1467678392,2,104,52,1361046295884,1361046295884,1467677276,1467677276,0
1361046297,1467678404,131,132184,1009.038168,1361046266366,1361046295870,1467647770,1467677274,29504
1361046297,1467678440,3,156,52,1361046295834,1361046295834,1467677274,1467677274,0
1361046305,1467686408,35,44506,1271.6,1361046298236,1361046301500,1467679644,1467682908,3264
1361046305,1467686408,95,124255,1307.947368,1361046298363,1361046303483,1467679771,1467684891,5120
1361046305,1467686408,132,176168,1334.606061,1361046298363,1361046303483,1467679771,1467684891,5120
1361046305,1467686408,143,186077,1301.237762,1361046298363,1361046299771,1467679771,1467681179,1408
1361046305,1467686408,143,194321,1358.888112,1361046298363,1361046303483,1467679771,1467684891,5120
1361046305,1467686476,102,131077,1285.068627,1361046298295,1361046303415,1467679771,1467684891,5120
1361046305,1467686480,269,370486,1377.271375,1361046298293,1361046303413,1467679773,1467684893,5120
1361046321,1467702408,8,1179,147.375,1361046298939,1361046315195,1467680347,1467696603,16256
1361046321,1467702480,4,587,146.75,1361046298802,1361046313842,1467680282,1467695322,15040
1361046321,1467702484,32,26618,831.8125,1361046298801,1361046315377,1467680285,1467696861,16576
1361046321,1467702484,12,2969,247.4166667,1361046298864,1361046314992,1467680348,1467696476,16128
1361046324,1467705316,97,126265,1301.701031,1361046297817,1361046299161,1467679133,1467680477,1344
1361046324,1467705320,37,42984,1161.72973,1361046298323,1361046299283,1467679643,1467680603,960
1361046324,1467705320,58,72152,1244,1361046298321,1361046299281,1467679641,1467680601,960
1361046324,1467705328,1,46,46,1361046298956,1361046298956,1467680284,1467680284,0
1361046324,1467705328,8,7649,956.125,1361046299020,1361046299020,1467680348,1467680348,0
1361046324,1467705328,16,16957,1059.8125,1361046299019,1361046299595,1467680347,1467680923,576
1361046324,1467705360,9,1760,195.5555556,1361046295917,1361046297581,1467677277,1467678941,1664
1361046324,1467705400,10,3870,387,1361046298307,1361046299395,1467679707,1467680795,1088
1361046324,1467705404,1,46,46,1361046298878,1361046298878,1467680282,1467680282,0
1361046337,1467718424,3,156,52,1361046330475,1361046330475,1467711899,1467711899,0
1361046356,1467737480,1,52,52,1361046330419,1361046330419,1467711899,1467711899,0
1361046356,1467737480,1,52,52,1361046330419,1361046330419,1467711899,1467711899,0
1361046356,1467737480,1,52,52,1361046330419,1361046330419,1467711899,1467711899,0
1361046356,1467737480,1,46,46,1361046330419,1361046330419,1467711899,1467711899,0
1361046356,1467737480,1,52,52,1361046330419,1361046330419,1467711899,1467711899,0
1361046356,1467737484,1,52,52,1361046330415,1361046330415,1467711899,1467711899,0
1361046356,1467737484,1,46,46,1361046330415,1361046330415,1467711899,1467711899,0
1361046356,1467737484,1,46,46,1361046330415,1361046330415,1467711899,1467711899,0
1361046356,1467737588,1,46,46,1361046330309,1361046330309,1467711897,1467711897,0
1361046356,1467737588,1,52,52,1361046330309,1361046330309,1467711897,1467711897,0
1361046356,1467737588,2,104,52,1361046330309,1361046330309,1467711897,1467711897,0
1361046356,1467737588,1,52,52,1361046330309,1361046330309,1467711897,1467711897,0
1361046356,1467737592,1,52,52,1361046330305,1361046330305,1467711897,1467711897,0
1361046356,1467737592,1,52,52,1361046330305,1361046330305,1467711897,1467711897,0
1361046356,1467737592,1,46,46,1361046330309,1361046330309,1467711901,1467711901,0
1361046356,1467737592,1,46,46,1361046330309,1361046330309,1467711901,1467711901,0
1361046356,1467737592,1,46,46,1361046330308,1361046330308,1467711900,1467711900,0
1361046745,1468126676,5,408,81.6,1361046742506,1361046744362,1468124182,1468126038,1856
1361046753,1468134684,2,178,89,1361046746528,1361046750752,1468128212,1468132436,4224
1361046777,1468158752,2,178,89,1361046759132,1361046776092,1468140884,1468157844,16960
1361046837,1468218544,1,89,89,1361046810221,1361046810221,1468191765,1468191765,0
1361046977,1468358648,1,48,48,1361046949825,1361046949825,1468331473,1468331473,0
1361047026,1468406988,17,7084,416.7058824,1361047023829,1361047024341,1468404817,1468405329,512
1361047026,1468406992,6,650,108.3333333,1361047020306,1361047025106,1468401298,1468406098,4800
1361047026,1468406992,12,1086,90.5,1361047024273,1361047024529,1468405265,1468405521,256
1361047026,1468407052,13,1288,99.07692308,1361047024468,1361047024852,1468405520,1468405904,384
1361047026,1468407056,13,1380,106.1538462,1361047024977,1361047025297,1468406033,1468406353,320
1361047034,1468415084,6,650,108.3333333,1361047025013,1361047031669,1468406097,1468412753,6656
1361047041,1468422760,15,3688,245.8666667,1361047012880,1361047024080,1468394640,1468405840,11200
1361047042,1468423016,36,40022,1111.722222,1361047031738,1361047035898,1468412754,1468416914,4160
1361047042,1468423016,25,26084,1043.36,1361047031738,1361047035898,1468412754,1468416914,4160
1361047042,1468423016,15,15749,1049.933333,1361047031736,1361047035896,1468412752,1468416912,4160
1361047042,1468423084,23,25864,1124.521739,1361047031668,1361047035828,1468412752,1468416912,4160
1361047042,1468423088,21,22929,1091.857143,1361047031666,1361047035826,1468412754,1468416914,4160
1361047042,1468423088,12,10880,906.6666667,1361047031666,1361047035826,1468412754,1468416914,4160
1361047045,1468426736,8,2680,335,1361047020136,1361047031656,1468401872,1468413392,11520
1361047045,1468426736,14,4670,333.5714286,1361047020072,1361047031912,1468401808,1468413648,11840
1361047045,1468426820,24,8746,364.4166667,1361047019605,1361047031701,1468401425,1468413521,12096
1361047045,1468426828,11,4476,406.9090909,1361047020046,1361047024654,1468401874,1468406482,4608
1361047050,1468431000,2,141,70.5,1361047047496,1361047047496,1468428496,1468428496,0
1361047050,1468431000,2,141,70.5,1361047047688,1361047047688,1468428688,1468428688,0
1361047066,1468447052,256,334665,1307.285156,1361047019733,1361047062485,1468400785,1468443537,42752
1361047082,1468463036,4,558,139.5,1361047072293,1361047075877,1468453329,1468456913,3584
1361047089,1468470748,1,52,52,1361047061786,1361047061786,1468443534,1468443534,0
1361047089,1468470752,1,52,52,1361047061782,1361047061782,1468443534,1468443534,0
1361047089,1468470752,1,52,52,1361047061782,1361047061782,1468443534,1468443534,0
1361047089,1468470752,1,46,46,1361047061785,1361047061785,1468443537,1468443537,0
1361047089,1468470832,1,52,52,1361047061705,1361047061705,1468443537,1468443537,0
1361047089,1468470832,1,52,52,1361047061705,1361047061705,1468443537,1468443537,0
1361047089,1468470832,1,46,46,1361047061705,1361047061705,1468443537,1468443537,0
1361047089,1468470832,1,52,52,1361047061704,1361047061704,1468443536,1468443536,0
1361047089,1468470832,1,52,52,1361047061704,1361047061704,1468443536,1468443536,0
1361047089,1468470832,1,46,46,1361047061704,1361047061704,1468443536,1468443536,0
1361047090,1468471012,2,92,46,1361047082940,1361047082940,1468463952,1468463952,0
1361047090,1468471048,6,650,108.3333333,1361047082904,1361047089880,1468463952,1468470928,6976
1361047097,1468478824,10,3536,353.6,1361047071952,1361047093008,1468453776,1468474832,21056
1361047097,1468478912,26,11158,429.1538462,1361047071352,1361047094008,1468453264,1468475920,22656
1361047097,1468478916,18,4927,273.7222222,1361047071859,1361047094323,1468453775,1468476239,22464
1361047097,1468478916,21,8906,424.0952381,1361047071859,1361047092787,1468453775,1468474703,20928
1361047098,1468479200,4,558,139.5,1361047093054,1361047096766,1468474254,1468477966,3712
1361047098,1468479212,6,650,108.3333333,1361047089716,1361047093044,1468470928,1468474256,3328
1361047117,1468498852,10,2774,277.4,1361047092466,1361047103090,1468474318,1468484942,10624
1361047117,1468498856,10,2311,231.1,1361047092528,1361047114096,1468474384,1468495952,21568
1361047118,106812892,15,16884,1125.6,1361047116247,1361047116311,106811139,106811203,64
1361047122,1468503040,2,141,70.5,1361047118945,1361047118945,1468499985,1468499985,0
1361047122,1468503124,16,7165,447.8125,1361047117195,1361047117515,1468498319,1468498639,320
1361047138,1468519068,210,262786,1251.361905,1361047071107,1361047133955,1468452175,1468515023,62848
1361047161,1468542800,1,52,52,1361047133159,1361047133159,1468514959,1468514959,0
1361047161,1468542800,1,46,46,1361047133223,1361047133223,1468515023,1468515023,0
1361047161,1468542884,1,46,46,1361047133073,1361047133073,1468514957,1468514957,0
1361047161,1468542888,1,52,52,1361047133072,1361047133072,1468514960,1468514960,0
1361047161,1468542888,1,46,46,1361047133072,1361047133072,1468514960,1468514960,0
1361047178,1468559336,6,2387,397.8333333,1361047170552,1361047174584,1468551888,1468555920,4032
1361047178,1468559336,10,6221,622.1,1361047170552,1361047174584,1468551888,1468555920,4032
1361047178,1468559336,9,6057,673,1361047170551,1361047174583,1468551887,1468555919,4032
1361047178,1468559340,10,5988,598.8,1361047167155,1361047174579,1468548495,1468555919,7424
1361047178,1468559376,16,12987,811.6875,1361047170512,1361047174544,1468551888,1468555920,4032
1361047178,1468559376,6,2387,397.8333333,1361047170512,1361047174544,1468551888,1468555920,4032
1361047186,1468567336,10,2311,231.1,1361047167477,1361047183285,1468548813,1468564621,15808
1361047194,1468575140,6,1824,304,1361047167674,1361047172346,1468548814,1468553486,4672
1361047194,1468575140,11,4476,406.9090909,1361047167738,1361047172218,1468548878,1468553358,4480
1361047194,1468575288,22,7151,325.0454545,1361047167335,1361047186855,1468548623,1468568143,19520
1361047210,1468591464,459,507896,1106.527233,1361047201525,1361047206453,1468582989,1468587917,4928
1361047230,1468611064,1,52,52,1361047201924,1361047201924,1468582988,1468582988,0
1361047230,1468611064,1,52,52,1361047201924,1361047201924,1468582988,1468582988,0
1361047230,1468611068,1,52,52,1361047201920,1361047201920,1468582988,1468582988,0
1361047230,1468611148,1,52,52,1361047201840,1361047201840,1468582988,1468582988,0
1361047230,1468611152,1,52,52,1361047201835,1361047201835,1468582987,1468582987,0
1361047230,1468611152,1,52,52,1361047201839,1361047201839,1468582991,1468582991,0
1361047234,1468615392,169,228602,1352.674556,1361047166463,1361047231935,1468547855,1468613327,65472
1361047242,1468623392,16,7165,447.8125,1361047233660,1361047233916,1468615052,1468615308,256
1361047258,1468639176,1,46,46,1361047232150,1361047232150,1468613326,1468613326,0
1361047258,1468639176,1,46,46,1361047232149,1361047232149,1468613325,1468613325,0
1361047258,1468639364,1,52,52,1361047231963,1361047231963,1468613327,1468613327,0
1361047258,1468639364,1,52,52,1361047231961,1361047231961,1468613325,1468613325,0
1361047258,1468639364,1,46,46,1361047231961,1361047231961,1468613325,1468613325,0
1361047314,1468695412,8,4818,602.25,1361047306470,1361047313510,1468687882,1468694922,7040
1361047322,1468703856,454,508027,1119.002203,1361047314733,1361047319021,1468696589,1468700877,4288
1361047322,1468703856,2,92,46,1361047314732,1361047314732,1468696588,1468696588,0
1361047330,1468711700,98,128017,1306.295918,1361047305353,1361047309833,1468687053,1468691533,4480
1361047330,1468711780,18,5479,304.3888889,1361047306232,1361047325880,1468688012,1468707660,19648
1361047330,1468711780,15,4615,307.6666667,1361047306486,1361047325814,1468688266,1468707594,19328
1361047334,1468715612,6,1824,304,1361047306654,1361047310558,1468688266,1468692170,3904
1361047334,1468715616,11,4476,406.9090909,1361047306653,1361047310493,1468688269,1468692109,3840
1361047362,1468743840,7,3479,497,1361047356541,1361047361085,1468738381,1468742925,4544
1361047362,1468743908,8,5859,732.375,1361047356471,1361047359991,1468738379,1468741899,3520
1361047362,1468743916,6,1012,168.6666667,1361047353198,1361047359982,1468735114,1468741898,6784
1361047370,1468751576,1,52,52,1361047345093,1361047345093,1468726669,1468726669,0
1361047370,1468751576,1,46,46,1361047345091,1361047345091,1468726667,1468726667,0
1361047371,1468752020,1,46,46,1361047345647,1361047345647,1468726667,1468726667,0
1361047371,1468752020,1,46,46,1361047345647,1361047345647,1468726667,1468726667,0
1361047371,1468752020,1,46,46,1361047345647,1361047345647,1468726667,1468726667,0
1361047371,1468752024,1,52,52,1361047345643,1361047345643,1468726667,1468726667,0
1361047374,1468755704,1,76,76,1361047348612,1361047348612,1468730316,1468730316,0
1361047378,1468759636,21,6519,310.4285714,1361047353479,1361047374087,1468735115,1468755723,20608
1361047379,1468759988,14,3099,221.3571429,1361047354511,1361047374735,1468735499,1468755723,20224
1361047379,1468759988,6,650,108.3333333,1361047374606,1361047378126,1468755594,1468759114,3520
1361047379,1468760036,12,4522,376.8333333,1361047354463,1361047374047,1468735499,1468755083,19584
1361047379,1468760036,7,1876,268,1361047354462,1361047375070,1468735498,1468756106,20608
1361047379,1468760076,162,218658,1349.740741,1361047352950,1361047374006,1468734026,1468755082,21056
1361047387,1468768032,7,4760,680,1361047378083,1361047381859,1468759115,1468762891,3776
1361047387,1468768032,4,558,139.5,1361047378082,1361047381858,1468759114,1468762890,3776
1361047387,1468768076,8,5664,708,1361047378041,1361047381817,1468759117,1468762893,3776
1361047395,1468776000,24,11490,478.75,1361047374723,1361047393859,1468755723,1468774859,19136
1361047395,1468776056,12,2995,249.5833333,1361047375052,1361047393996,1468756108,1468775052,18944
1361047402,1468783572,1,52,52,1361047374025,1361047374025,1468755597,1468755597,0
1361047402,1468783652,1,52,52,1361047373941,1361047373941,1468755593,1468755593,0
1361047402,1468783652,1,52,52,1361047373941,1361047373941,1468755593,1468755593,0
1361047402,1468783660,6,1824,304,1361047374446,1361047378030,1468756106,1468759690,3584
1361047402,1468783660,11,4476,406.9090909,1361047374510,1361047377966,1468756170,1468759626,3456
1361047411,1468792040,4,558,139.5,1361047404185,1361047407833,1468785225,1468788873,3648
1361047411,1468792068,165,222023,1345.593939,1361047374015,1361047403263,1468755083,1468784331,29248
1361047419,1468800024,2,92,46,1361047412843,1361047412843,1468793867,1468793867,0
1361047427,1468808012,8,4748,593.5,1361047418871,1361047425911,1468799883,1468806923,7040
1361047427,1468808020,12,5395,449.5833333,1361047412847,1361047421935,1468793867,1468802955,9088
1361047430,1468811620,1,46,46,1361047402709,1361047402709,1468784329,1468784329,0
1361047430,1468811652,1,52,52,1361047403575,1361047403575,1468785227,1468785227,0
1361047430,1468811652,1,52,52,1361047403573,1361047403573,1468785225,1468785225,0
1361047430,1468811656,1,46,46,1361047403699,1361047403699,1468785355,1468785355,0
1361047430,1468811656,45,16663,370.2888889,1361047403699,1361047428467,1468785355,1468810123,24768
1361047430,1468811660,1,52,52,1361047404012,1361047404012,1468785672,1468785672,0
1361047430,1468811660,22,7111,323.2272727,1361047404080,1361047428848,1468785740,1468810508,24768
1361047430,1468811660,21,8906,424.0952381,1361047404080,1361047427248,1468785740,1468808908,23168
1361047430,1468811736,1,52,52,1361047403491,1361047403491,1468785227,1468785227,0
1361047430,1468811736,1,46,46,1361047403618,1361047403618,1468785354,1468785354,0
1361047430,1468811740,15,5676,378.4,1361047403934,1361047429726,1468785674,1468811466,25792
1361047435,1468816016,2,92,46,1361047426994,1361047426994,1468808010,1468808010,0
1361047435,1468816016,5,952,190.4,1361047427057,1361047432881,1468808073,1468813897,5824
1361047435,1468816056,8,6163,770.375,1361047429772,1361047432844,1468810828,1468813900,3072
1361047435,1468816056,7,5807,829.5714286,1361047429771,1361047432843,1468810827,1468813899,3072
1361047435,1468816100,8,6304,788,1361047429724,1361047432796,1468810824,1468813896,3072
1361047435,1468816104,8,6266,783.25,1361047429722,1361047432794,1468810826,1468813898,3072
1361047446,1468827672,3,540,180,1361047421412,1361047421412,1468803084,1468803084,0
1361047451,1468832052,10,2311,231.1,1361047429839,1361047445967,1468810891,1468827019,16128
1361047451,1468832052,12,2915,242.9166667,1361047429775,1361047445775,1468810827,1468826827,16000
1361047459,1468840100,425,560664,1319.209412,1361047403231,1361047458207,1468784331,1468839307,54976
1361047467,1468848096,6,650,108.3333333,1361047459619,1361047463779,1468840715,1468844875,4160
1361047475,1468856040,7,5483,783.2857143,1361047463962,1361047467866,1468845002,1468848906,3904
1361047475,1468856104,8,5848,731,1361047463769,1361047467801,1468844873,1468848905,4032
1361047482,1468863672,1,46,46,1361047457635,1361047457635,1468839307,1468839307,0
1361047483,1468864044,2,92,46,1361047477525,1361047477525,1468858569,1468858569,0
1361047483,1468864044,4,558,139.5,1361047477525,1361047480853,1468858569,1468861897,3328
1361047483,1468864108,2,98,49,1361047477460,1361047477460,1468858568,1468858568,0
1361047486,1468867604,1,52,52,1361047459110,1361047459110,1468840714,1468840714,0
1361047486,1468867604,1,52,52,1361047459108,1361047459108,1468840712,1468840712,0
1361047486,1468867604,1,52,52,1361047459108,1361047459108,1468840712,1468840712,0
1361047486,1468867608,33,12430,376.6666667,1361047459426,1361047485730,1468841034,1468867338,26304
1361047486,1468867640,1,52,52,1361047460481,1361047460481,1468842121,1468842121,0
1361047486,1468867640,8,2680,335,1361047460481,1361047477569,1468842121,1468859209,17088
1361047486,1468867640,12,4522,376.8333333,1361047460481,1361047484609,1468842121,1468866249,24128
1361047486,1468867740,1,52,52,1361047458975,1361047458975,1468840715,1468840715,0
1361047486,1468867740,1,52,52,1361047458974,1361047458974,1468840714,1468840714,0
1361047486,1468867744,1,46,46,1361047459290,1361047459290,1468841034,1468841034,0
1361047486,1468867744,1,46,46,1361047459290,1361047459290,1468841034,1468841034,0
1361047486,1468867776,1,52,52,1361047460346,1361047460346,1468842122,1468842122,0
1361047491,1468872060,2,92,46,1361047485828,1361047485828,1468866888,1468866888,0
1361047491,1468872112,10,5427,542.7,1361047486161,1361047489809,1468867273,1468870921,3648
1361047499,1468880036,2,92,46,1361047495455,1361047495455,1468876491,1468876491,0
1361047499,1468880064,12,6733,561.0833333,1361047485826,1361047495426,1468866890,1468876490,9600
1361047499,1468880080,4,558,139.5,1361047495410,1361047498802,1468876490,1468879882,3392
1361047507,1468888040,4,558,139.5,1361047499290,1361047502874,1468880330,1468883914,3584
1361047507,1468888076,7,2307,329.5714286,1361047486519,1361047504247,1468867595,1468885323,17728
1361047507,1468888080,2,92,46,1361047499251,1361047499251,1468880331,1468880331,0
1361047514,1468895612,17,5710,335.8823529,1361047485916,1361047513756,1468867528,1468895368,27840
1361047514,1468895612,23,10668,463.826087,1361047485916,1361047513756,1468867528,1468895368,27840
1361047514,1468895616,8,3424,428,1361047485975,1361047513751,1468867591,1468895367,27776
1361047514,1468895788,4,592,148,1361047488877,1361047513581,1468870665,1468895369,24704
1361047515,1468896084,2,92,46,1361047514094,1361047514094,1468895178,1468895178,0
1361047523,1468904140,5,610,122,1361047514037,1361047518069,1468895177,1468899209,4032
1361047531,1468912060,5,1905,381,1361047514758,1361047530054,1468895818,1468911114,15296
1361047531,1468912104,7,2509,358.4285714,1361047514455,1361047529943,1468895559,1468911047,15488
1361047531,1468912104,55,63735,1158.818182,1361047510554,1361047530330,1468891658,1468911434,19776
1361047531,1468912148,7,2307,329.5714286,1361047514285,1361047530285,1468895433,1468911433,16000
1361047539,1468920080,2,480,240,1361047514800,1361047531952,1468895880,1468913032,17152
1361047539,1468920136,4,558,139.5,1361047531641,1361047534777,1468912777,1468915913,3136
1361047554,1468935752,68,82838,1218.205882,1361047529678,1361047531342,1468911430,1468913094,1664
1361047555,1468936100,11,2943,267.5454545,1361047531933,1361047548893,1468913033,1468929993,16960
1361047555,1468936144,12,2915,242.9166667,1361047531761,1361047548529,1468912905,1468929673,16768
1361047558,1468939724,6,2261,376.8333333,1361047531309,1361047531693,1468913033,1468913417,384
1361047558,1468939808,1,52,52,1361047530970,1361047530970,1468912778,1468912778,0
1361047558,1468939808,1,52,52,1361047531096,1361047531096,1468912904,1468912904,0
1361047558,1468939808,2,104,52,1361047531096,1361047531096,1468912904,1468912904,0
1361047558,1468939808,4,968,242,1361047531223,1361047531671,1468913031,1468913479,448
1361047590,1468971700,1,46,46,1361047562946,1361047562946,1468944646,1468944646,0
1361047590,1468971704,1,46,46,1361047563006,1361047563006,1468944710,1468944710,0
1361047590,1468971804,1,46,46,1361047562844,1361047562844,1468944648,1468944648,0
1361047590,1468971804,1,52,52,1361047562844,1361047562844,1468944648,1468944648,0
1361047590,1468971804,1,52,52,1361047562844,1361047562844,1468944648,1468944648,0
1361047590,1468971804,1,46,46,1361047562908,1361047562908,1468944712,1468944712,0
1361047667,1469048208,8,5414,676.75,1361047656621,1361047660717,1469037829,1469041925,4096
1361047667,1469048208,6,1346,224.3333333,1361047653999,1361047662703,1469035207,1469043911,8704
1361047675,1469056120,2,92,46,1361047667142,1361047667142,1469048262,1469048262,0
1361047675,1469056120,2,92,46,1361047667142,1361047667142,1469048262,1469048262,0
1361047675,1469056120,4,558,139.5,1361047667142,1361047670790,1469048262,1469051910,3648
1361047678,1469059848,24,8890,370.4166667,1361047653424,1361047667440,1469035272,1469049288,14016
1361047678,1469059872,10,3536,353.6,1361047653527,1361047666839,1469035399,1469048711,13312
1361047679,1469059960,20,7394,369.7,1361047654440,1361047668264,1469035400,1469049224,13824
1361047679,1469059960,12,4522,376.8333333,1361047654440,1361047678568,1469035400,1469059528,24128
1361047683,1469064128,2,92,46,1361047679295,1361047679295,1469060423,1469060423,0
1361047691,1469072140,30,27602,920.0666667,1361047679283,1361047687795,1469060423,1469068935,8512
1361047691,1469072180,23,20775,903.2608696,1361047682252,1361047685708,1469063432,1469066888,3456
1361047691,1469072180,22,19764,898.3636364,1361047682316,1361047686732,1469063496,1469067912,4416
1361047691,1469072224,19,15324,806.5263158,1361047682206,1361047685662,1469063430,1469066886,3456
1361047691,1469072224,9,6632,736.8888889,1361047682270,1361047685662,1469063494,1469066886,3392
1361047691,1469072224,17,14051,826.5294118,1361047682270,1361047685662,1469063494,1469066886,3392
1361047699,1469080144,12,3877,323.0833333,1361047679471,1361047698607,1469060615,1469079751,19136
1361047699,1469080184,2,98,49,1361047698375,1361047698375,1469079559,1469079559,0
1361047699,1469080192,15,5033,335.5333333,1361047679357,1361047698557,1469060549,1469079749,19200
1361047699,1469080220,400,508500,1271.25,1361047653028,1361047697636,1469034248,1469078856,44608
1361047706,1469087804,5,1764,352.8,1361047678812,1361047702172,1469060616,1469083976,23360
1361047707,1469088232,4,558,139.5,1361047698327,1361047701655,1469079559,1469082887,3328
1361047722,1469103912,1,52,52,1361047697646,1361047697646,1469079558,1469079558,0
1361047722,1469103912,1,52,52,1361047697646,1361047697646,1469079558,1469079558,0
1361047722,1469103912,1,52,52,1361047697646,1361047697646,1469079558,1469079558,0
1361047723,1469104000,1,52,52,1361047698558,1361047698558,1469079558,1469079558,0
1361047723,1469104000,1,52,52,1361047698558,1361047698558,1469079558,1469079558,0
1361047723,1469104188,6,650,108.3333333,1361047714817,1361047720065,1469096005,1469101253,5248
1361047727,1469107968,31,15873,512.0322581,1361047698845,1361047721181,1469079813,1469102149,22336
1361047730,1469111816,10,3536,353.6,1361047702157,1361047727693,1469083973,1469109509,25536
1361047730,1469111816,16,6691,418.1875,1361047702157,1361047720205,1469083973,1469102021,18048
1361047731,1469112528,6,650,108.3333333,1361047719724,1361047727532,1469101252,1469109060,7808
1361047739,1469120196,5,952,190.4,1361047727867,1361047734715,1469109063,1469115911,6848
1361047742,1469123916,1,52,52,1361047714088,1361047714088,1469096004,1469096004,0
1361047743,1469123920,20,7618,380.9,1361047715470,1361047732238,1469096390,1469113158,16768
1361047747,1469128164,18,5833,324.0555556,1361047727962,1361047746906,1469109126,1469128070,18944
1361047754,1469135848,4,1262,315.5,1361047726573,1361047726637,1469108421,1469108485,64
1361047754,1469135888,18,20323,1129.055556,1361047728070,1361047729734,1469109958,1469111622,1664
1361047755,1469136220,4,558,139.5,1361047746657,1361047750689,1469127877,1469131909,4032
1361047755,1469136224,3,908,302.6666667,1361047731167,1361047747551,1469112391,1469128775,16384
1361047763,1469144236,4,558,139.5,1361047757841,1361047761681,1469139077,1469142917,3840
1361047763,1469144288,2,92,46,1361047757790,1361047757790,1469139078,1469139078,0
1361047771,1469151980,1,46,46,1361047746448,1361047746448,1469127428,1469127428,0
1361047771,1469152280,4,558,139.5,1361047764516,1361047767652,1469145796,1469148932,3136
1361047771,1469152280,2,92,46,1361047764516,1361047764516,1469145796,1469145796,0
1361047774,1469155876,1,52,52,1361047746002,1361047746002,1469127878,1469127878,0
1361047774,1469155884,16,6691,418.1875,1361047746953,1361047764489,1469128837,1469146373,17536
1361047775,1469155960,26,10892,418.9230769,1361047747045,1361047765669,1469128005,1469146629,18624
1361047775,1469155992,8,2680,335,1361047747846,1361047765510,1469128838,1469146502,17664
1361047779,1469160196,2,92,46,1361047776187,1361047776187,1469157383,1469157383,0
1361047786,1469167888,1,52,52,1361047759748,1361047759748,1469141636,1469141636,0
1361047787,1469167976,1,52,52,1361047760662,1361047760662,1469141638,1469141638,0
1361047787,1469168292,4,558,139.5,1361047776090,1361047779610,1469157382,1469160902,3520
1361047791,1469171992,16,5722,357.625,1361047765061,1361047788165,1469146053,1469169157,23104
1361047795,1469176204,2,92,46,1361047786994,1361047786994,1469168198,1469168198,0
1361047795,1469176252,4,558,139.5,1361047786946,1361047790658,1469168198,1469171910,3712
1361047802,1469183908,20,8472,423.6,1361047775600,1361047799728,1469157508,1469181636,24128
1361047802,1469183912,6,2261,376.8333333,1361047775790,1361047797998,1469157702,1469179910,22208
1361047803,1469183996,6,2568,428,1361047776706,1361047800386,1469157702,1469181382,23680
1361047803,1469184228,4,558,139.5,1361047799191,1361047802711,1469180419,1469183939,3520
1361047803,1469184232,2,92,46,1361047799187,1361047799187,1469180419,1469180419,0
1361047811,1469192216,2,92,46,1361047806629,1361047806629,1469187845,1469187845,0
1361047811,1469192268,4,558,139.5,1361047806576,1361047809648,1469187844,1469190916,3072
1361047814,1469195916,559,719173,1286.534884,1361047457384,1361047510632,1468839300,1468892548,53248
1361047827,1469207936,8,2641,330.125,1361047799934,1361047822334,1469180870,1469203270,22400
1361047827,1469208288,8,2561,320.125,1361047806558,1361047821918,1469187846,1469203206,15360
1361047827,1469208292,1304,1741987,1335.879601,1361047679319,1361047825175,1469060611,1469206467,145856
1361047834,1469215916,2,856,428,1361047805991,1361047806439,1469187907,1469188355,448
1361047835,1469216228,7,5039,719.8571429,1361047827545,1361047830681,1469208773,1469211909,3136
1361047835,1469216228,4,693,173.25,1361047827545,1361047830681,1469208773,1469211909,3136
1361047835,1469216272,5,1068,213.6,1361047827502,1361047832622,1469208774,1469213894,5120
1361047835,1469216272,4,624,156,1361047827502,1361047830638,1469208774,1469211910,3136
1361047843,1469224292,16,7165,447.8125,1361047840344,1361047840664,1469221636,1469221956,320
1361047851,1469231940,7,1896,270.8571429,1361047825529,1361047848825,1469206469,1469229765,23296
1361047855,1469235948,2,104,52,1361047827822,1361047828718,1469208770,1469209666,896
1361047859,1469240292,5,952,190.4,1361047849047,1361047855639,1469230339,1469236931,6592
1361047867,1469248344,2,92,46,1361047865637,1361047865637,1469246981,1469246981,0
1361047875,1469256012,1,52,52,1361047849327,1361047849327,1469230339,1469230339,0
1361047875,1469256016,1,46,46,1361047849517,1361047849517,1469230533,1469230533,0
1361047875,1469256016,10,3536,353.6,1361047849771,1361047872619,1469230787,1469253635,22848
1361047875,1469256104,1,52,52,1361047849237,1361047849237,1469230341,1469230341,0
1361047875,1469256104,1,52,52,1361047849236,1361047849236,1469230340,1469230340,0
1361047875,1469256104,1,52,52,1361047849236,1361047849236,1469230340,1469230340,0
1361047875,1469256124,29,10730,370,1361047849470,1361047873022,1469230594,1469254146,23552
1361047875,1469256124,1,46,46,1361047849406,1361047849406,1469230530,1469230530,0
1361047875,1469256128,20,7618,380.9,1361047849661,1361047873341,1469230789,1469254469,23680
1361047875,1469256128,22,8952,406.9090909,1361047849661,1361047872445,1469230789,1469253573,22784
1361047875,1469256128,1,52,52,1361047849659,1361047849659,1469230787,1469230787,0
1361047875,1469256336,6,650,108.3333333,1361047865645,1361047871725,1469246981,1469253061,6080
1361047883,1469264428,4,558,139.5,1361047878478,1361047882510,1469259906,1469263938,4032
1361047883,1469264440,6,650,108.3333333,1361047871620,1361047878468,1469253060,1469259908,6848
1361047887,1469268140,1,76,76,1361047862191,1361047862191,1469243331,1469243331,0
1361047891,1469272280,2,92,46,1361047884899,1361047884899,1469266179,1469266179,0
1361047891,1469272348,448,506389,1130.332589,1361047884832,1361047890592,1469266180,1469271940,5760
1361047899,1469280276,8,2561,320.125,1361047878696,1361047894440,1469259972,1469275716,15744
1361047899,1469280320,6,1957,326.1666667,1361047878587,1361047894523,1469259907,1469275843,15936
1361047899,1469280360,2,98,49,1361047898324,1361047898324,1469279684,1469279684,0
1361047907,1469288056,3,908,302.6666667,1361047878913,1361047906433,1469259969,1469287489,27520
1361047907,1469288056,6,2261,376.8333333,1361047878917,1361047902085,1469259973,1469283141,23168
1361047907,1469288288,332,428765,1291.460843,1361047848475,1361047901851,1469229763,1469283139,53376
1361047907,1469288320,457,507740,1111.028446,1361047898364,1361047906044,1469279684,1469287364,7680
1361047915,1469296324,6,650,108.3333333,1361047906039,1361047913783,1469287363,1469295107,7744
1361047915,1469296372,10,1295,129.5,1361047906056,1361047913608,1469287428,1469294980,7552
1361047923,1469304376,5,610,122,1361047913731,1361047917827,1469295107,1469299203,4096
1361047923,1469304376,12,2427,202.25,1361047906115,1361047918275,1469287491,1469299651,12160
1361047931,1469312048,1,46,46,1361047906377,1361047906377,1469287425,1469287425,0
1361047931,1469312052,6,1824,304,1361047906440,1361047914952,1469287492,1469296004,8512
1361047931,1469312052,11,4476,406.9090909,1361047906504,1361047914824,1469287556,1469295876,8320
1361047931,1469312136,1,46,46,1361047906291,1361047906291,1469287427,1469287427,0
1361047939,1469320144,12,2283,190.25,1361047914090,1361047931818,1469295234,1469312962,17728
1361047939,1469320148,11,2906,264.1818182,1361047914152,1361047938280,1469295300,1469319428,24128
1361047939,1469320340,4,558,139.5,1361047932200,1361047935592,1469313540,1469316932,3392
1361047939,1469320412,109,128908,1182.642202,1361047901725,1361047931165,1469283137,1469312577,29440
1361047951,1469332144,2,141,70.5,1361047924650,1361047924650,1469305794,1469305794,0
1361047955,1469336344,55,63435,1153.363636,1361047931235,1361047947811,1469312579,1469329155,16576
1361047955,1469336352,18,4497,249.8333333,1361047932379,1361047954843,1469313731,1469336195,22464
1361047955,1469336352,5,1020,204,1361047932379,1361047949275,1469313731,1469330627,16896
1361047955,1469336352,6,650,108.3333333,1361047949017,1361047954649,1469330369,1469336001,5632
1361047955,1469336424,11,3613,328.4545455,1361047941584,1361047954384,1469323008,1469335808,12800
1361047959,1469340020,1,46,46,1361047931559,1361047931559,1469312579,1469312579,0
1361047959,1469340056,1,52,52,1361047932674,1361047932674,1469313730,1469313730,0
1361047959,1469340136,1,46,46,1361047931892,1361047931892,1469313028,1469313028,0
1361047959,1469340140,1,52,52,1361047932396,1361047932396,1469313536,1469313536,0
1361047963,1469344344,24,23347,972.7916667,1361047954658,1361047962466,1469336002,1469343810,7808
1361047963,1469344344,11,7699,699.9090909,1361047954849,1361047962465,1469336193,1469343809,7616
1361047963,1469344344,12,8125,677.0833333,1361047954848,1361047962464,1469336192,1469343808,7616
1361047963,1469344392,16,13725,857.8125,1361047954739,1361047962419,1469336131,1469343811,7680
1361047963,1469344392,19,16073,845.9473684,1361047954738,1361047962418,1469336130,1469343810,7680
1361047963,1469344392,11,7289,662.6363636,1361047954738,1361047962418,1469336130,1469343810,7680
1361047971,1469352340,12,2427,202.25,1361047955111,1361047969767,1469336451,1469351107,14656
1361047971,1469352352,7,3099,442.7142857,1361047965464,1361047969560,1469346816,1469350912,4096
1361047971,1469352384,12,2283,190.25,1361047954684,1361047966780,1469336068,1469348164,12096
1361047971,1469352416,6,3127,521.1666667,1361047965402,1361047969498,1469346818,1469350914,4096
1361047971,1469352416,4,558,139.5,1361047965402,1361047968474,1469346818,1469349890,3072
1361047971,1469352416,4782,6799325,1421.858009,1361047829402,1361047968730,1469210818,1469350146,139328
1361047971,1469352424,9,6477,719.6666667,1361047962385,1361047968465,1469343809,1469349889,6080
1361047975,1469356080,1,52,52,1361047949290,1361047949290,1469330370,1469330370,0
1361047975,1469356084,11,4476,406.9090909,1361047949541,1361047955941,1469330625,1469337025,6400
1361047975,1469356196,10,3536,353.6,1361047949430,1361047966134,1469330626,1469347330,16704
1361047979,1469360740,8,1179,147.375,1361047962068,1361047973652,1469343808,1469355392,11584
1361047987,1469368164,10,1295,129.5,1361047962645,1361047981141,1469343809,1469362305,18496
1361047987,1469368424,369,478268,1296.119241,1361047932371,1361047981459,1469313795,1469362883,49088
1361047987,1469368428,10,1295,129.5,1361047965517,1361047985293,1469346945,1469366721,19776
1361047987,1469368432,4,558,139.5,1361047982088,1361047985480,1469363520,1469366912,3392
1361047991,1469372096,12,2283,190.25,1361047965720,1361047988760,1469346816,1469369856,23040
1361048003,1469384424,6,650,108.3333333,1361047995218,1361048001234,1469376642,1469382658,6016
1361048003,1469384464,16,7306,456.625,1361047982249,1361047999849,1469363713,1469381313,17600
1361048003,1469384468,10,1295,129.5,1361047982757,1361047995365,1469364225,1469376833,12608
1361048003,1469384472,2,92,46,1361047995170,1361047995170,1469376642,1469376642,0
1361048003,1469384472,10,1295,129.5,1361047995297,1361048000609,1469376769,1469382081,5312
1361048007,1469388088,1,46,46,1361047981794,1361047981794,1469362882,1469362882,0
1361048007,1469388116,1,52,52,1361047982406,1361047982406,1469363522,1469363522,0
1361048007,1469388116,1,52,52,1361047982406,1361047982406,1469363522,1469363522,0
1361048007,1469388208,1,52,52,1361047982313,1361047982313,1469363521,1469363521,0
1361048007,1469388212,1,52,52,1361047982311,1361047982311,1469363523,1469363523,0
1361048011,1469392116,1,52,52,1361047983174,1361047983174,1469364290,1469364290,0
1361048011,1469392200,17,6737,396.2941176,1361047983089,1361048010801,1469364289,1469392001,27712
1361048011,1469392200,9,3108,345.3333333,1361047983089,1361048010801,1469364289,1469392001,27712
1361048011,1469392468,6,650,108.3333333,1361048001253,1361048009829,1469382721,1469391297,8576
1361048019,1469400464,4,558,139.5,1361048009895,1361048013415,1469391359,1469394879,3520
1361048023,1469404176,8,1154,144.25,1361047996299,1361048001675,1469377475,1469382851,5376
1361048027,1469408188,12,3986,332.1666667,1361048001595,1361048021947,1469382783,1469403135,20352
1361048027,1469408276,13,3510,270,1361048001443,1361048018403,1469382719,1469399679,16960
1361048039,1469420172,1,428,428,1361048011212,1361048011212,1469392384,1469392384,0
1361048039,1469420260,4,2169,542.25,1361048010870,1361048011062,1469392130,1469392322,192
1361048043,1469424560,5,1825,365,1361048027722,1361048042826,1469409282,1469424386,15104
1361048043,1469424564,466,508344,1090.866953,1361048036166,1361048041350,1469417730,1469422914,5184
1361048043,1469424720,2,141,70.5,1361048036392,1361048036392,1469418112,1469418112,0
1361048063,1469444200,1,52,52,1361048036530,1361048036530,1469417730,1469417730,0
1361048067,1469448564,425,582620,1370.870588,1361047981317,1361048066373,1469362881,1469447937,85056
1361048091,1469472276,1,52,52,1361048066661,1361048066661,1469447937,1469447937,0
1361048091,1469472276,1,46,46,1361048066661,1361048066661,1469447937,1469447937,0
1361048091,1469472372,1,52,52,1361048066563,1361048066563,1469447935,1469447935,0
1361048091,1469472372,1,46,46,1361048066563,1361048066563,1469447935,1469447935,0
1361048091,1469472372,1,46,46,1361048066563,1361048066563,1469447935,1469447935,0
1361048107,1469488544,6,650,108.3333333,1361048099479,1361048103575,1469481023,1469485119,4096
1361048107,1469488592,10,1295,129.5,1361048099497,1361048102633,1469481089,1469484225,3136
1361048107,1469488592,12,2427,202.25,1361048099752,1361048102760,1469481344,1469484352,3008
1361048115,1469496552,6,656,109.3333333,1361048103568,1361048108432,1469485120,1469489984,4864
1361048115,1469496628,466,508712,1091.656652,1361048108355,1361048113283,1469489983,1469494911,4928
1361048123,1469504584,2,98,49,1361048119408,1361048119408,1469500992,1469500992,0
1361048127,1469508376,6,1824,304,1361048099966,1361048104702,1469481342,1469486078,4736
1361048127,1469508380,11,4476,406.9090909,1361048099965,1361048104637,1469481345,1469486017,4672
1361048131,1469512268,12,2915,242.9166667,1361048103916,1361048127980,1469485184,1469509248,24064
1361048131,1469512372,10,2311,231.1,1361048104002,1361048128002,1469485374,1469509374,24000
1361048131,1469512564,439,507341,1155.67426,1361048119429,1361048124357,1469500993,1469505921,4928
1361048139,1469520544,2,92,46,1361048134870,1361048134870,1469516414,1469516414,0
1361048139,1469520596,4,558,139.5,1361048134818,1361048138338,1469516414,1469519934,3520
1361048139,1469520600,131,166841,1273.59542,1361048098782,1361048132574,1469480382,1469514174,33792
1361048139,1469520632,3,150,50,1361048136449,1361048137345,1469518081,1469518977,896
1361048139,1469520636,8,840,105,1361048136956,1361048138428,1469518592,1469520064,1472
1361048147,1469528632,17,7211,424.1764706,1361048144446,1361048144702,1469526078,1469526334,256
1361048155,1469536596,14,4047,289.0714286,1361048134947,1361048151459,1469516543,1469533055,16512
1361048155,1469536596,11,2795,254.0909091,1361048135010,1361048151202,1469516606,1469532798,16192
1361048155,1469536596,8,1179,147.375,1361048135010,1361048151010,1469516606,1469532606,16000
1361048159,1469540448,1,46,46,1361048132728,1361048132728,1469514176,1469514176,0
1361048159,1469540448,53,64277,1212.773585,1361048132728,1361048135224,1469514176,1469516672,2496
1361048163,1469544316,1,46,46,1361048135228,1361048135228,1469516544,1469516544,0
1361048163,1469544316,1,46,46,1361048135228,1361048135228,1469516544,1469516544,0
1361048163,1469544484,6,2261,376.8333333,1361048135121,1361048135505,1469516605,1469516989,384
1361048171,1469552912,5799,8195904,1413.330574,1361048137384,1361048167336,1469519296,1469549248,29952
1361048195,1469576552,1,52,52,1361048167632,1361048167632,1469549184,1469549184,0
1361048195,1469576552,1,46,46,1361048167631,1361048167631,1469549183,1469549183,0
1361048195,1469576552,1,46,46,1361048167631,1361048167631,1469549183,1469549183,0
1361048195,1469576552,1,46,46,1361048167695,1361048167695,1469549247,1469549247,0
1361048195,1469576628,1,48,48,1361048167233,1361048167233,1469548861,1469548861,0
1361048195,1469576632,1,46,46,1361048167549,1361048167549,1469549181,1469549181,0
1361048195,1469576636,1,46,46,1361048167612,1361048167612,1469549248,1469549248,0
1361048231,1469612780,1,60,60,1361048205226,1361048205226,1469587006,1469587006,0
1361048252,1469633000,11,1213,110.2727273,1361048249334,1361048249846,1469630334,1469630846,512
1361048260,1469640944,12,1641,136.75,1361048254956,1361048256812,1469635900,1469637756,1856
1361048260,1469640944,7,562,80.28571429,1361048254956,1361048255084,1469635900,1469636028,128
1361048260,1469640980,90,86033,955.9222222,1361048253129,1361048254921,1469634109,1469635901,1792
1361048260,1469640988,6,780,130,1361048254467,1361048254659,1469635455,1469635647,192
1361048260,1469640988,6,654,109,1361048254466,1361048254658,1469635454,1469635646,192
1361048268,1469648960,12,2915,242.9166667,1361048251100,1361048267548,1469632060,1469648508,16448
1361048268,1469649008,10,2311,231.1,1361048251181,1361048267693,1469632189,1469648701,16512
1361048268,1469649008,11,2795,254.0909091,1361048251052,1361048267244,1469632060,1469648252,16192
1361048275,1469656732,7,3042,434.5714286,1361048250202,1361048250842,1469631934,1469632574,640
1361048275,1469656736,8,3344,418,1361048250455,1361048250903,1469632191,1469632639,448
1361048275,1469656784,6,985,164.1666667,1361048249060,1361048249124,1469630844,1469630908,64
1361048275,1469656784,77,92154,1196.805195,1361048249189,1361048250597,1469630973,1469632381,1408
1361048275,1469656928,6,881,146.8333333,1361048271127,1361048271319,1469653055,1469653247,192
1361048275,1469656928,5,709,141.8,1361048271445,1361048271637,1469653373,1469653565,192
1361048275,1469656928,6,1309,218.1666667,1361048271445,1361048271637,1469653373,1469653565,192
1361048276,1469656932,4,468,117,1361048272699,1361048272827,1469653631,1469653759,128
1361048276,1469656936,11,8545,776.8181818,1361048254324,1361048270452,1469635260,1469651388,16128
1361048276,1469656936,4,1168,292,1361048254324,1361048268340,1469635260,1469649276,14016
1361048276,1469656936,11,9816,892.3636364,1361048254260,1361048270452,1469635196,1469651388,16192
1361048276,1469656936,8,5023,627.875,1361048254324,1361048270452,1469635260,1469651388,16128
1361048276,1469656940,6,780,130,1361048270897,1361048271089,1469651837,1469652029,192
1361048276,1469656964,21,21108,1005.142857,1361048271577,1361048272089,1469652541,1469653053,512
1361048276,1469656972,5,709,141.8,1361048271826,1361048272082,1469652798,1469653054,256
1361048276,1469656972,6,1694,282.3333333,1361048271826,1361048272018,1469652798,1469652990,192
1361048276,1469656976,4,468,117,1361048272653,1361048272781,1469653629,1469653757,128
1361048276,1469657000,530,727557,1372.749057,1361048253686,1361048274678,1469634686,1469655678,20992
1361048276,1469657000,10,7944,794.4,1361048254197,1361048270389,1469635197,1469651389,16192
1361048276,1469657004,9,6539,726.5555556,1361048254259,1361048270387,1469635263,1469651391,16128
1361048276,1469657008,6,654,109,1361048270831,1361048271023,1469651839,1469652031,192
1361048276,1469657012,5,713,142.6,1361048271467,1361048271723,1469652479,1469652735,256
1361048276,1469657012,21,21111,1005.285714,1361048271530,1361048272042,1469652542,1469653054,512
1361048276,1469657012,7,2046,292.2857143,1361048274665,1361048274857,1469655677,1469655869,192
1361048276,1469657012,8,2008,251,1361048275240,1361048275368,1469656252,1469656380,128
1361048279,107973180,5,1209,241.8,1361048254377,1361048274473,107948557,107968653,20096
1361048279,1469660696,2,136,68,1361048251389,1361048251389,1469633085,1469633085,0
1361048279,1469660736,46,58465,1270.978261,1361048253462,1361048269718,1469635198,1469651454,16256
1361048279,1469660736,30,35457,1181.9,1361048253526,1361048270102,1469635262,1469651838,16576
1361048279,1469660736,23,26936,1171.130435,1361048253526,1361048270102,1469635262,1469651838,16576
1361048279,1469660824,25,29415,1176.6,1361048253439,1361048270015,1469635263,1469651839,16576
1361048279,1469660824,45,54839,1218.644444,1361048253439,1361048274559,1469635263,1469656383,21120
1361048283,1469664680,11,4204,382.1818182,1361048255375,1361048275663,1469637055,1469657343,20288
1361048283,1469664768,4,1052,263,1361048255285,1361048255349,1469637053,1469637117,64
1361048283,1469664768,14,15146,1081.857143,1361048255348,1361048270196,1469637116,1469651964,14848
1361048284,1469664944,5,709,141.8,1361048275758,1361048276014,1469656702,1469656958,256
1361048284,1469664944,7,1369,195.5714286,1361048275757,1361048276909,1469656701,1469657853,1152
1361048284,1469664944,6,1309,218.1666667,1361048275949,1361048276141,1469656893,1469657085,192
1361048284,1469664948,10,7456,745.6,1361048276139,1361048277291,1469657087,1469658239,1152
1361048284,1469664948,43,54381,1264.674419,1361048276457,1361048277673,1469657405,1469658621,1216
1361048284,1469664952,7,1361,194.4285714,1361048276965,1361048277157,1469657917,1469658109,192
1361048284,1469664956,5,859,171.8,1361048281314,1361048281378,1469662270,1469662334,64
1361048284,1469664956,14,13334,952.4285714,1361048281378,1361048281442,1469662334,1469662398,64
1361048284,1469664960,6,404,67.33333333,1361048282012,1361048282140,1469662972,1469663100,128
1361048284,1469664964,4,645,161.25,1361048270999,1361048276055,1469651963,1469657019,5056
1361048284,1469664984,6,404,67.33333333,1361048282438,1361048282566,1469663422,1469663550,128
1361048284,1469664984,5,427,85.4,1361048282566,1361048282694,1469663550,1469663678,128
1361048284,1469664984,17,18370,1080.588235,1361048274629,1361048280005,1469655613,1469660989,5376
1361048284,1469664988,7,1361,194.4285714,1361048282947,1361048283075,1469663935,1469664063,128
1361048284,1469664988,5,709,141.8,1361048275905,1361048276097,1469656893,1469657085,192
1361048284,1469664988,5,709,141.8,1361048275713,1361048275969,1469656701,1469656957,256
1361048284,1469664992,7,1360,194.2857143,1361048276413,1361048276541,1469657405,1469657533,128
1361048284,1469664996,4,1341,335.25,1361048276986,1361048277114,1469657982,1469658110,128
1361048284,1469664996,6,2098,349.6666667,1361048277114,1361048277498,1469658110,1469658494,384
1361048284,1469664996,7,1361,194.4285714,1361048281273,1361048281465,1469662269,1469662461,192
1361048284,1469665028,7,658,94,1361048282074,1361048282650,1469663102,1469663678,576
1361048284,1469665032,9,3770,418.8888889,1361048282263,1361048282519,1469663295,1469663551,256
1361048284,1469665036,5,709,141.8,1361048283411,1361048283667,1469664447,1469664703,256
1361048284,1469665036,7,1360,194.2857143,1361048283411,1361048283603,1469664447,1469664639,192
1361048292,1469672944,6,3514,585.6666667,1361048272301,1361048290413,1469653245,1469671357,18112
1361048292,1469672956,8,3172,396.5,1361048270881,1361048285985,1469651837,1469666941,15104
1361048292,1469672984,13,13265,1020.384615,1361048271493,1361048285573,1469652477,1469666557,14080
1361048292,1469672984,14,15837,1131.214286,1361048271493,1361048285573,1469652477,1469666557,14080
1361048292,1469672996,18,21284,1182.444444,1361048272377,1361048287481,1469653373,1469668477,15104
1361048292,1469673024,180,250872,1393.733333,1361048281244,1361048286876,1469662268,1469667900,5632
1361048292,1469673028,6,1031,171.8333333,1361048269915,1361048285019,1469650943,1469666047,15104
1361048292,1469673028,35,41357,1181.628571,1361048270554,1361048288794,1469651582,1469669822,18240
1361048292,1469673028,7,5356,765.1428571,1361048270361,1361048288409,1469651389,1469669437,18048
1361048292,1469673028,8,3175,396.875,1361048270808,1361048285912,1469651836,1469666940,15104
1361048292,1469673032,9,5792,643.5555556,1361048270999,1361048286295,1469652031,1469667327,15296
1361048292,1469673032,14,14800,1057.142857,1361048270742,1361048288790,1469651774,1469669822,18048
1361048292,1469673032,47,59302,1261.744681,1361048270933,1361048289685,1469651965,1469670717,18752
1361048292,1469673032,9,5798,644.2222222,1361048270997,1361048286421,1469652029,1469667453,15424
1361048295,1469676772,59,65337,1107.40678,1361048269297,1361048271921,1469651069,1469653693,2624
1361048295,1469676780,9,5870,652.2222222,1361048270056,1361048291688,1469651836,1469673468,21632
1361048295,1469676808,5,1742,348.4,1361048270667,1361048270795,1469652475,1469652603,128
1361048296,1469676972,64,86341,1349.078125,1361048270992,1361048271312,1469651964,1469652284,320
1361048296,1469676976,3,471,157,1361048270926,1361048270990,1469651902,1469651966,64
1361048296,1469676976,3,860,286.6666667,1361048271053,1361048271053,1469652029,1469652029,0
1361048298,1469679128,46,61900,1345.652174,1361048271412,1361048271540,1469652540,1469652668,128
1361048298,107992660,14,17148,1224.857143,1361048271751,1361048271815,107966411,107966475,64
1361048298,107992680,4,788,197,1361048273142,1361048273462,107967822,107968142,320
1361048299,1469680692,8,2935,366.875,1361048271298,1361048275266,1469652990,1469656958,3968
1361048299,1469680736,4,960,240,1361048272983,1361048273047,1469654719,1469654783,64
1361048299,1469680744,9,4420,491.1111111,1361048273932,1361048274188,1469655676,1469655932,256
1361048299,1469680768,7,2094,299.1428571,1361048273909,1361048274229,1469655677,1469655997,320
1361048299,1469680768,14,12457,889.7857143,1361048273973,1361048274101,1469655741,1469655869,128
1361048299,1469680780,26,4407,169.5,1361048271015,1361048297959,1469652795,1469679739,26944
1361048299,1469680852,10,3151,315.1,1361048273827,1361048274275,1469655679,1469656127,448
1361048300,1469680972,5,709,141.8,1361048293202,1361048293458,1469674174,1469674430,256
1361048300,1469680976,268,366840,1368.80597,1361048253775,1361048293391,1469634751,1469674367,39616
1361048300,1469680980,4,4096,1024,1361048281739,1361048299787,1469662719,1469680767,18048
1361048300,1469681004,5,1429,285.8,1361048298355,1361048298675,1469679359,1469679679,320
1361048300,1469681004,7,1360,194.2857143,1361048298672,1361048298864,1469679676,1469679868,192
1361048300,1469681004,6,654,109,1361048298736,1361048298864,1469679740,1469679868,128
1361048300,1469681008,8,978,122.25,1361048275885,1361048298733,1469656893,1469679741,22848
1361048300,1469681040,6,1309,218.1666667,1361048293199,1361048293327,1469674239,1469674367,128
1361048300,1469681040,6,597,99.5,1361048281228,1361048298700,1469662268,1469679740,17472
1361048302,107996652,19,23369,1229.947368,1361048274576,1361048274640,107969228,107969292,64
1361048302,107996684,6,2140,356.6666667,1361048274034,1361048282930,107968718,107977614,8896
1361048302,107996684,18,20596,1144.222222,1361048274097,1361048274673,107968781,107969357,576
1361048302,107996688,4,1891,472.75,1361048274542,1361048274606,107969230,107969294,64
1361048303,1469684804,3,524,174.6666667,1361048275346,1361048275346,1469657150,1469657150,0
1361048303,1469684840,5,1479,295.8,1361048276653,1361048276717,1469658493,1469658557,64
1361048307,1469688740,5,1844,368.8,1361048281040,1361048281168,1469662780,1469662908,128
1361048307,1469688744,1,46,46,1361048281420,1361048281420,1469663164,1469663164,0
1361048307,1469688748,1,46,46,1361048281545,1361048281545,1469663293,1469663293,0
1361048307,1469688748,1,46,46,1361048281545,1361048281545,1469663293,1469663293,0
1361048307,1469688752,1,52,52,1361048281923,1361048281923,1469663675,1469663675,0
1361048307,1469688832,16,5347,334.1875,1361048280951,1361048302903,1469662783,1469684735,21952
1361048307,1469688840,1,52,52,1361048281775,1361048281775,1469663615,1469663615,0
1361048308,1469689020,6,1310,218.3333333,1361048303199,1361048303327,1469684219,1469684347,128
1361048308,1469689020,5,709,141.8,1361048303203,1361048303459,1469684223,1469684479,256
1361048315,1469696700,1,52,52,1361048288122,1361048288122,1469669822,1469669822,0
1361048315,1469696700,1,52,52,1361048288121,1361048288121,1469669821,1469669821,0
1361048315,1469696808,1,52,52,1361048288012,1361048288012,1469669820,1469669820,0
1361048316,1469697008,5,709,141.8,1361048313195,1361048313387,1469694203,1469694395,192
1361048316,1469697040,5,545,109,1361048298700,1361048313740,1469679740,1469694780,15040
1361048316,1469697076,6,1309,218.1666667,1361048313127,1361048313255,1469694203,1469694331,128
1361048319,1469700844,1,52,52,1361048292520,1361048292520,1469674364,1469674364,0
1361048324,1469705452,5,709,141.8,1361048322865,1361048323057,1469704317,1469704509,192
1361048324,1469705456,12,4192,349.3333333,1361048303278,1361048323310,1469684734,1469704766,20032
1361048324,1469705524,6,1309,218.1666667,1361048322794,1361048322922,1469704318,1469704446,128
1361048332,1469713064,8,2402,300.25,1361048328500,1361048328948,1469709564,1469710012,448
1361048332,1469713072,6,780,130,1361048329517,1361048329645,1469710589,1469710717,128
1361048332,1469713072,5,840,168,1361048329517,1361048329645,1469710589,1469710717,128
1361048332,1469713108,6,2303,383.8333333,1361048328074,1361048328394,1469709182,1469709502,320
1361048332,1469713328,1,52,52,1361048305581,1361048305581,1469686909,1469686909,0
1361048340,1469721096,5,709,141.8,1361048333139,1361048333395,1469714235,1469714491,256
1361048340,1469721096,6,1308,218,1361048333139,1361048333331,1469714235,1469714427,192
1361048340,1469721140,41,53723,1310.317073,1361048328423,1361048333671,1469709563,1469714811,5248
1361048340,1469721172,5,840,168,1361048334474,1361048334538,1469715646,1469715710,64
1361048340,1469721216,1,52,52,1361048315677,1361048315677,1469696893,1469696893,0
1361048340,1469721216,1,52,52,1361048315548,1361048315548,1469696764,1469696764,0
1361048340,1469721344,1,46,46,1361048313502,1361048313502,1469694846,1469694846,0
1361048344,1469725164,1,52,52,1361048317777,1361048317777,1469698941,1469698941,0
1361048348,1469729108,5,709,141.8,1361048343112,1361048343368,1469724220,1469724476,256
1361048348,1469729116,5,545,109,1361048328448,1361048343488,1469709564,1469724604,15040
1361048348,1469729164,6,1309,218.1666667,1361048343057,1361048343249,1469724221,1469724413,192
1361048348,1469729188,12,4192,349.3333333,1361048323577,1361048343609,1469704765,1469724797,20032
1361048354,108048696,10,9777,977.7,1361048328612,1361048328676,108023308,108023372,64
1361048356,1469737116,6,1308,218,1361048353217,1361048353409,1469734333,1469734525,192
1361048356,1469737164,5,709,141.8,1361048353169,1361048353425,1469734333,1469734589,256
1361048356,1469737232,1,52,52,1361048328334,1361048328334,1469709566,1469709566,0
1361048356,1469737324,1,52,52,1361048328240,1361048328240,1469709564,1469709564,0
1361048356,1469737364,1,52,52,1361048329800,1361048329800,1469711164,1469711164,0
1361048364,1469745132,5,709,141.8,1361048363119,1361048363375,1469744251,1469744507,256
1361048364,1469745132,6,1308,218,1361048363119,1361048363311,1469744251,1469744443,192
1361048364,1469745136,8,1002,125.25,1361048343661,1361048363693,1469724797,1469744829,20032
1361048372,1469753120,7,1360,194.2857143,1361048364220,1361048364348,1469745340,1469745468,128
1361048372,1469753136,4,468,117,1361048369710,1361048369838,1469750846,1469750974,128
1361048372,1469753164,5,709,141.8,1361048364113,1361048364369,1469745277,1469745533,256
1361048372,1469753200,5,709,141.8,1361048369196,1361048369452,1469750396,1469750652,256
1361048372,1469753204,4,468,117,1361048369639,1361048369767,1469750843,1469750971,128
1361048375,108069184,5,1822,364.4,1361048373861,1361048373861,108068045,108068045,0
1361048375,108069184,37,46200,1248.648649,1361048374500,1361048374628,108068684,108068812,128
1361048375,108069184,6,3780,630,1361048373924,1361048374308,108068108,108068492,384
1361048375,108069184,5,1692,338.4,1361048374116,1361048374180,108068300,108068364,64
1361048375,108069184,4,464,116,1361048374307,1361048374371,108068491,108068555,64
1361048375,108069184,4,464,116,1361048374691,1361048374691,108068875,108068875,0
1361048375,108069184,36,44476,1235.444444,1361048374691,1361048374819,108068875,108069003,128
1361048375,108069188,36,44917,1247.694444,1361048374690,1361048374818,108068878,108069006,128
1361048375,108069192,7,3703,529,1361048373917,1361048374173,108068109,108068365,256
1361048375,108069192,4,938,234.5,1361048374173,1361048374301,108068365,108068493,128
1361048375,108069192,5,1238,247.6,1361048374173,1361048374301,108068365,108068493,128
1361048375,108069192,36,44546,1237.388889,1361048374493,1361048374621,108068685,108068813,128
1361048375,108069192,4,1255,313.75,1361048374557,1361048374621,108068749,108068813,64
1361048380,1469761032,15,16419,1094.6,1361048373716,1361048373780,1469754748,1469754812,64
1361048380,1469761036,67,90229,1346.701493,1361048376144,1361048377040,1469757180,1469758076,896
1361048380,1469761040,9,8191,910.1111111,1361048372877,1361048372941,1469753917,1469753981,64
1361048380,1469761040,20,23992,1199.6,1361048372877,1361048373197,1469753917,1469754237,320
1361048380,1469761040,8,7100,887.5,1361048372877,1361048372877,1469753917,1469753917,0
1361048380,1469761040,20,22332,1116.6,1361048372877,1361048372941,1469753917,1469753981,64
1361048380,1469761040,19,22586,1188.736842,1361048372877,1361048372941,1469753917,1469753981,64
1361048380,1469761040,7,4478,639.7142857,1361048372877,1361048372941,1469753917,1469753981,64
1361048380,1469761040,15,17169,1144.6,1361048372877,1361048372941,1469753917,1469753981,64
1361048380,1469761040,14,14637,1045.5,1361048372877,1361048372941,1469753917,1469753981,64
1361048380,1469761040,36,44010,1222.5,1361048372877,1361048373325,1469753917,1469754365,448
1361048380,1469761040,3,150,50,1361048372877,1361048372941,1469753917,1469753981,64
1361048380,1469761040,527,744284,1412.303605,1361048372877,1361048373965,1469753917,1469755005,1088
1361048380,1469761040,4,2902,725.5,1361048372877,1361048372941,1469753917,1469753981,64
1361048380,1469761040,41,50648,1235.317073,1361048372877,1361048373389,1469753917,1469754429,512
1361048380,1469761040,25,29830,1193.2,1361048372877,1361048373261,1469753917,1469754301,384
1361048380,1469761040,97,132394,1364.886598,1361048372877,1361048373389,1469753917,1469754429,512
1361048380,1469761040,26,32109,1234.961538,1361048373004,1361048373196,1469754044,1469754236,192
1361048380,1469761040,18,20950,1163.888889,1361048373004,1361048373132,1469754044,1469754172,128
1361048380,1469761040,22,25937,1178.954545,1361048373004,1361048373196,1469754044,1469754236,192
1361048380,1469761040,4,592,148,1361048373004,1361048373068,1469754044,1469754108,64
1361048380,1469761040,13,13354,1027.230769,1361048373004,1361048373132,1469754044,1469754172,128
1361048380,1469761040,10,9718,971.8,1361048373004,1361048373132,1469754044,1469754172,128
1361048380,1469761040,21,23492,1118.666667,1361048373004,1361048373068,1469754044,1469754108,64
1361048380,1469761040,26,29817,1146.807692,1361048373004,1361048373452,1469754044,1469754492,448
1361048380,1469761040,12,12071,1005.916667,1361048373196,1361048373196,1469754236,1469754236,0
1361048380,1469761040,9,7688,854.2222222,1361048373196,1361048373196,1469754236,1469754236,0
1361048380,1469761040,20,23473,1173.65,1361048373196,1361048373260,1469754236,1469754300,64
1361048380,1469761040,62,79503,1282.306452,1361048376779,1361048377483,1469757819,1469758523,704
1361048380,1469761040,9,7573,841.4444444,1361048373195,1361048373195,1469754235,1469754235,0
1361048380,1469761040,3,608,202.6666667,1361048373195,1361048373195,1469754235,1469754235,0
1361048380,1469761040,25,28172,1126.88,1361048373323,1361048373387,1469754363,1469754427,64
1361048380,1469761040,16,17233,1077.0625,1361048373323,1361048373387,1469754363,1469754427,64
1361048380,1469761040,21,23851,1135.761905,1361048373195,1361048373259,1469754235,1469754299,64
1361048380,1469761040,18,21198,1177.666667,1361048373323,1361048373387,1469754363,1469754427,64
1361048380,1469761040,43,55702,1295.395349,1361048373195,1361048373323,1469754235,1469754363,128
1361048380,1469761040,23,27391,1190.913043,1361048373323,1361048373451,1469754363,1469754491,128
1361048380,1469761040,23,26322,1144.434783,1361048373387,1361048373451,1469754427,1469754491,64
1361048380,1469761040,4,971,242.75,1361048373387,1361048373515,1469754427,1469754555,128
1361048380,1469761040,14,14543,1038.785714,1361048373194,1361048373322,1469754234,1469754362,128
1361048380,1469761040,10,9117,911.7,1361048373386,1361048373450,1469754426,1469754490,64
1361048380,1469761040,19,22583,1188.578947,1361048373386,1361048373514,1469754426,1469754554,128
1361048380,1469761040,4,682,170.5,1361048376650,1361048377354,1469757690,1469758394,704
1361048380,1469761044,14,15720,1122.857143,1361048373318,1361048373382,1469754362,1469754426,64
1361048380,1469761044,13,13504,1038.769231,1361048373318,1361048373318,1469754362,1469754362,0
1361048380,1469761044,4,1058,264.5,1361048373322,1361048373514,1469754366,1469754558,192
1361048380,1469761044,35,43397,1239.914286,1361048373450,1361048373578,1469754494,1469754622,128
1361048380,1469761044,87,112756,1296.045977,1361048376714,1361048377354,1469757758,1469758398,640
1361048380,1469761044,27,32387,1199.518519,1361048373322,1361048373450,1469754366,1469754494,128
1361048380,1469761044,30,37721,1257.366667,1361048373577,1361048373705,1469754621,1469754749,128
1361048380,1469761044,22,26357,1198.045455,1361048373577,1361048373641,1469754621,1469754685,64
1361048380,1469761044,28,35085,1253.035714,1361048373449,1361048373577,1469754493,1469754621,128
1361048380,1469761044,14,14518,1037,1361048373704,1361048373768,1469754748,1469754812,64
1361048380,1469761044,48,62888,1310.166667,1361048376776,1361048377352,1469757820,1469758396,576
1361048380,1469761044,16,18242,1140.125,1361048373704,1361048373768,1469754748,1469754812,64
1361048380,1469761044,31,39680,1280,1361048373576,1361048373704,1469754620,1469754748,128
1361048380,1469761044,30,38167,1272.233333,1361048373576,1361048373704,1469754620,1469754748,128
1361048380,1469761044,21,24628,1172.761905,1361048373576,1361048373640,1469754620,1469754684,64
1361048380,1469761044,73,94554,1295.260274,1361048373576,1361048373768,1469754620,1469754812,192
1361048380,1469761044,9,7890,876.6666667,1361048373767,1361048373831,1469754811,1469754875,64
1361048380,1469761044,6,4404,734,1361048373767,1361048373831,1469754811,1469754875,64
1361048380,1469761044,24,28144,1172.666667,1361048373767,1361048374215,1469754811,1469755259,448
1361048380,1469761044,32,40013,1250.40625,1361048373767,1361048373895,1469754811,1469754939,128
1361048380,1469761044,37,46683,1261.702703,1361048373767,1361048374279,1469754811,1469755323,512
1361048380,1469761044,15,16311,1087.4,1361048373831,1361048373895,1469754875,1469754939,64
1361048380,1469761044,17,18985,1116.764706,1361048373831,1361048373895,1469754875,1469754939,64
1361048380,1469761044,43,55504,1290.790698,1361048373831,1361048373959,1469754875,1469755003,128
1361048380,1469761044,21,24601,1171.47619,1361048373703,1361048373767,1469754747,1469754811,64
1361048380,1469761044,28,34545,1233.75,1361048373702,1361048373830,1469754746,1469754874,128
1361048380,1469761044,7,5044,720.5714286,1361048373894,1361048374150,1469754938,1469755194,256
1361048380,1469761048,15,16043,1069.533333,1361048373766,1361048373830,1469754814,1469754878,64
1361048380,1469761048,22,26561,1207.318182,1361048373894,1361048374086,1469754942,1469755134,192
1361048380,1469761048,6,2021,336.8333333,1361048373958,1361048374086,1469755006,1469755134,128
1361048380,1469761048,14,15595,1113.928571,1361048373830,1361048373894,1469754878,1469754942,64
1361048380,1469761048,7,5037,719.5714286,1361048373893,1361048374085,1469754941,1469755133,192
1361048380,1469761048,67,86451,1290.313433,1361048374021,1361048374533,1469755069,1469755581,512
1361048380,1469761048,45,56176,1248.355556,1361048373893,1361048374021,1469754941,1469755069,128
1361048380,1469761048,14,15296,1092.571429,1361048373957,1361048374021,1469755005,1469755069,64
1361048380,1469761048,5,2061,412.2,1361048374149,1361048374213,1469755197,1469755261,64
1361048380,1469761048,6,1994,332.3333333,1361048374149,1361048374213,1469755197,1469755261,64
1361048380,1469761048,4,1261,315.25,1361048374149,1361048374213,1469755197,1469755261,64
1361048380,1469761048,6,3832,638.6666667,1361048377220,1361048377348,1469758268,1469758396,128
1361048380,1469761048,5,3604,720.8,1361048374212,1361048374532,1469755260,1469755580,320
1361048380,1469761048,5,1940,388,1361048374148,1361048374212,1469755196,1469755260,64
1361048380,1469761048,76,98659,1298.144737,1361048374148,1361048374724,1469755196,1469755772,576
1361048380,1469761048,5,2053,410.6,1361048374276,1361048374404,1469755324,1469755452,128
1361048380,1469761048,4,661,165.25,1361048374276,1361048374404,1469755324,1469755452,128
1361048380,1469761048,26,30395,1169.038462,1361048374339,1361048374403,1469755387,1469755451,64
1361048380,1469761048,34,41836,1230.470588,1361048374339,1361048374403,1469755387,1469755451,64
1361048380,1469761048,4,1205,301.25,1361048374339,1361048374403,1469755387,1469755451,64
1361048380,1469761048,5,1470,294,1361048374211,1361048374339,1469755259,1469755387,128
1361048380,1469761048,5,1940,388,1361048374211,1361048374403,1469755259,1469755451,192
1361048380,1469761048,7,5123,731.8571429,1361048374339,1361048374403,1469755387,1469755451,64
1361048380,1469761048,58,77383,1334.189655,1361048374275,1361048374403,1469755323,1469755451,128
1361048380,1469761048,64,85746,1339.78125,1361048374339,1361048374531,1469755387,1469755579,192
1361048380,1469761048,14,9746,696.1428571,1361048374339,1361048374531,1469755387,1469755579,192
1361048380,1469761052,4,1205,301.25,1361048374338,1361048374466,1469755390,1469755518,128
1361048380,1469761052,42,54538,1298.52381,1361048374466,1361048374530,1469755518,1469755582,64
1361048380,1469761052,54,70349,1302.759259,1361048374466,1361048374594,1469755518,1469755646,128
1361048380,1469761052,4,1428,357,1361048374466,1361048374530,1469755518,1469755582,64
1361048380,1469761052,8,7278,909.75,1361048374465,1361048374465,1469755517,1469755517,0
1361048380,1469761052,82,111029,1354.012195,1361048374465,1361048374593,1469755517,1469755645,128
1361048380,1469761052,4,817,204.25,1361048374465,1361048374529,1469755517,1469755581,64
1361048380,1469761052,5,3621,724.2,1361048374529,1361048374721,1469755581,1469755773,192
1361048380,1469761052,5,1940,388,1361048374528,1361048374592,1469755580,1469755644,64
1361048380,1469761052,4,817,204.25,1361048374592,1361048374656,1469755644,1469755708,64
1361048380,1469761052,27,32820,1215.555556,1361048374592,1361048374656,1469755644,1469755708,64
1361048380,1469761052,4,1205,301.25,1361048374592,1361048374720,1469755644,1469755772,128
1361048380,1469761052,57,75130,1318.070175,1361048374528,1361048374656,1469755580,1469755708,128
1361048380,1469761052,48,62952,1311.5,1361048374656,1361048375232,1469755708,1469756284,576
1361048380,1469761052,5,455,91,1361048374655,1361048374975,1469755707,1469756027,320
1361048380,1469761052,5,455,91,1361048374655,1361048374975,1469755707,1469756027,320
1361048380,1469761052,4,817,204.25,1361048374655,1361048374719,1469755707,1469755771,64
1361048380,1469761140,33,41519,1258.151515,1361048374567,1361048374695,1469755707,1469755835,128
1361048380,1469761140,54,70858,1312.185185,1361048374567,1361048375143,1469755707,1469756283,576
1361048380,1469761140,246,334438,1359.504065,1361048374695,1361048375655,1469755835,1469756795,960
1361048380,1469761140,4,1205,301.25,1361048374695,1361048374759,1469755835,1469755899,64
1361048380,1469761144,62,77779,1254.5,1361048375141,1361048375973,1469756285,1469757117,832
1361048380,1469761144,48,62766,1307.625,1361048375141,1361048375653,1469756285,1469756797,512
1361048380,1469761144,67,89204,1331.402985,1361048375332,1361048375972,1469756476,1469757116,640
1361048380,1469761144,20,19594,979.7,1361048375650,1361048376162,1469756794,1469757306,512
1361048380,1469761144,62,82118,1324.483871,1361048375650,1361048376546,1469756794,1469757690,896
1361048380,1469761144,51,63907,1253.078431,1361048375650,1361048376418,1469756794,1469757562,768
1361048380,1469761144,5,2038,407.6,1361048375650,1361048376162,1469756794,1469757306,512
1361048380,1469761152,4,574,143.5,1361048372445,1361048372765,1469753597,1469753917,320
1361048380,1469761152,19,22240,1170.526316,1361048372509,1361048372765,1469753661,1469753917,256
1361048380,1469761152,66,88703,1343.984848,1361048376156,1361048376668,1469757308,1469757820,512
1361048380,1469761152,27,30240,1120,1361048372572,1361048372764,1469753724,1469753916,192
1361048380,1469761152,12,11712,976,1361048372763,1361048372827,1469753915,1469753979,64
1361048380,1469761152,29,34524,1190.482759,1361048372763,1361048372955,1469753915,1469754107,192
1361048380,1469761152,49,63394,1293.755102,1361048372763,1361048372891,1469753915,1469754043,128
1361048380,1469761152,59,77339,1310.830508,1361048372763,1361048372891,1469753915,1469754043,128
1361048380,1469761152,59,78168,1324.881356,1361048372763,1361048372891,1469753915,1469754043,128
1361048380,1469761152,406,572581,1410.29803,1361048372763,1361048374107,1469753915,1469755259,1344
1361048380,1469761152,20,22948,1147.4,1361048372763,1361048372827,1469753915,1469753979,64
1361048380,1469761152,19,22352,1176.421053,1361048372763,1361048373147,1469753915,1469754299,384
1361048380,1469761152,138,190147,1377.876812,1361048372763,1361048373659,1469753915,1469754811,896
1361048380,1469761152,7,4379,625.5714286,1361048372763,1361048372827,1469753915,1469753979,64
1361048380,1469761152,5,1351,270.2,1361048372763,1361048372891,1469753915,1469754043,128
1361048380,1469761152,2,104,52,1361048372763,1361048372763,1469753915,1469753915,0
1361048380,1469761152,34,41132,1209.764706,1361048372763,1361048373211,1469753915,1469754363,448
1361048380,1469761152,6,1681,280.1666667,1361048372763,1361048373147,1469753915,1469754299,384
1361048380,1469761152,9,1617,179.6666667,1361048372826,1361048373146,1469753978,1469754298,320
1361048380,1469761156,14,14576,1041.142857,1361048372890,1361048373082,1469754046,1469754238,192
1361048380,1469761156,21,23367,1112.714286,1361048372890,1361048373082,1469754046,1469754238,192
1361048380,1469761156,45,57620,1280.444444,1361048372890,1361048373466,1469754046,1469754622,576
1361048380,1469761156,4,1134,283.5,1361048376537,1361048377305,1469757693,1469758461,768
1361048380,1469761156,22,25189,1144.954545,1361048373081,1361048373145,1469754237,1469754301,64
1361048380,1469761156,23,26263,1141.869565,1361048373081,1361048373145,1469754237,1469754301,64
1361048380,1469761156,87,102353,1176.471264,1361048376409,1361048377241,1469757565,1469758397,832
1361048380,1469761156,18,20385,1132.5,1361048373081,1361048373209,1469754237,1469754365,128
1361048380,1469761156,54,67734,1254.333333,1361048376537,1361048377241,1469757693,1469758397,704
1361048380,1469761156,17,19712,1159.529412,1361048373209,1361048373273,1469754365,1469754429,64
1361048380,1469761156,16,18401,1150.0625,1361048373144,1361048373208,1469754300,1469754364,64
1361048380,1469761156,24,27918,1163.25,1361048373208,1361048373336,1469754364,1469754492,128
1361048380,1469761156,17,20098,1182.235294,1361048373208,1361048373336,1469754364,1469754492,128
1361048380,1469761156,4,1068,267,1361048373272,1361048373400,1469754428,1469754556,128
1361048380,1469761156,22,25169,1144.045455,1361048373208,1361048373272,1469754364,1469754428,64
1361048380,1469761156,4,952,238,1361048373208,1361048373400,1469754364,1469754556,192
1361048380,1469761180,23,28556,1241.565217,1361048373248,1361048373376,1469754428,1469754556,128
1361048380,1469761180,11,11412,1037.454545,1361048373248,1361048373376,1469754428,1469754556,128
1361048380,1469761180,9,7471,830.1111111,1361048373185,1361048373249,1469754365,1469754429,64
1361048380,1469761180,17,18159,1068.176471,1361048373249,1361048373313,1469754429,1469754493,64
1361048380,1469761180,37,46509,1257,1361048373312,1361048373440,1469754492,1469754620,128
1361048380,1469761180,14,14604,1043.142857,1361048373312,1361048373376,1469754492,1469754556,64
1361048380,1469761180,7,3584,512,1361048373440,1361048373568,1469754620,1469754748,128
1361048380,1469761180,16,17923,1120.1875,1361048373440,1361048373504,1469754620,1469754684,64
1361048380,1469761180,22,26006,1182.090909,1361048373439,1361048373567,1469754619,1469754747,128
1361048380,1469761184,52,68686,1320.884615,1361048373435,1361048373499,1469754619,1469754683,64
1361048380,1469761184,64,82806,1293.84375,1361048373435,1361048373563,1469754619,1469754747,128
1361048380,1469761184,28,34558,1234.214286,1361048373435,1361048373819,1469754619,1469755003,384
1361048380,1469761184,54,68030,1259.814815,1361048376894,1361048377214,1469758078,1469758398,320
1361048380,1469761184,9,8058,895.3333333,1361048373629,1361048373693,1469754813,1469754877,64
1361048380,1469761184,62,81783,1319.080645,1361048373629,1361048373821,1469754813,1469755005,192
1361048380,1469761184,13,13147,1011.307692,1361048373565,1361048373629,1469754749,1469754813,64
1361048380,1469761184,23,27404,1191.478261,1361048373693,1361048373757,1469754877,1469754941,64
1361048380,1469761184,10,8856,885.6,1361048373693,1361048373757,1469754877,1469754941,64
1361048380,1469761184,74,99353,1342.608108,1361048373565,1361048373693,1469754749,1469754877,128
1361048380,1469761184,13,14179,1090.692308,1361048373565,1361048373629,1469754749,1469754813,64
1361048380,1469761184,13,13335,1025.769231,1361048373756,1361048373820,1469754940,1469755004,64
1361048380,1469761184,26,30953,1190.5,1361048373756,1361048373948,1469754940,1469755132,192
1361048380,1469761184,42,51048,1215.428571,1361048373820,1361048373948,1469755004,1469755132,128
1361048380,1469761184,4,658,164.5,1361048373691,1361048373819,1469754875,1469755003,128
1361048380,1469761184,51,67085,1315.392157,1361048373755,1361048373883,1469754939,1469755067,128
1361048380,1469761184,45,59097,1313.266667,1361048373755,1361048373883,1469754939,1469755067,128
1361048380,1469761184,29,36185,1247.758621,1361048373755,1361048373883,1469754939,1469755067,128
1361048380,1469761184,22,25840,1174.545455,1361048373883,1361048374011,1469755067,1469755195,128
1361048380,1469761184,25,30717,1228.68,1361048373819,1361048373947,1469755003,1469755131,128
1361048380,1469761184,5,1992,398.4,1361048377083,1361048377211,1469758267,1469758395,128
1361048380,1469761184,44,56388,1281.545455,1361048374010,1361048374074,1469755194,1469755258,64
1361048380,1469761184,5,2061,412.2,1361048374010,1361048374074,1469755194,1469755258,64
1361048380,1469761184,5,1940,388,1361048374010,1361048374074,1469755194,1469755258,64
1361048380,1469761184,170,238186,1401.094118,1361048377210,1361048377722,1469758394,1469758906,512
1361048380,1469761184,23,26174,1138,1361048373882,1361048373946,1469755066,1469755130,64
1361048380,1469761184,4,1261,315.25,1361048374010,1361048374074,1469755194,1469755258,64
1361048380,1469761188,77,99561,1293,1361048369142,1361048372726,1469750330,1469753914,3584
1361048380,1469761188,5,3617,723.4,1361048373946,1361048374202,1469755134,1469755390,256
1361048380,1469761188,5,3619,723.8,1361048374010,1361048374202,1469755198,1469755390,192
1361048380,1469761188,41,48612,1185.658537,1361048374009,1361048374201,1469755197,1469755389,192
1361048380,1469761188,7,4744,677.7142857,1361048374201,1361048374393,1469755389,1469755581,192
1361048380,1469761188,5,2086,417.2,1361048374201,1361048374329,1469755389,1469755517,128
1361048380,1469761188,7,5123,731.8571429,1361048374201,1361048374265,1469755389,1469755453,64
1361048380,1469761188,5,3621,724.2,1361048374200,1361048374392,1469755388,1469755580,192
1361048380,1469761188,5,1940,388,1361048374200,1361048374264,1469755388,1469755452,64
1361048380,1469761188,4,817,204.25,1361048374328,1361048374392,1469755516,1469755580,64
1361048380,1469761188,8,7278,909.75,1361048374328,1361048374328,1469755516,1469755516,0
1361048380,1469761188,15,9798,653.2,1361048374264,1361048374392,1469755452,1469755580,128
1361048380,1469761188,5,2065,413,1361048374392,1361048374456,1469755580,1469755644,64
1361048380,1469761188,37,46424,1254.702703,1361048374518,1361048375222,1469755706,1469756410,704
1361048380,1469761188,4,1205,301.25,1361048374518,1361048374646,1469755706,1469755834,128
1361048380,1469761188,4,1205,301.25,1361048374390,1361048374454,1469755578,1469755642,64
1361048380,1469761192,515,713069,1384.6,1361048374646,1361048376118,1469755838,1469757310,1472
1361048380,1469761192,11,5368,488,1361048374646,1361048375286,1469755838,1469756478,640
1361048380,1469761192,5,455,91,1361048374517,1361048374837,1469755709,1469756029,320
1361048380,1469761192,5,455,91,1361048374517,1361048374837,1469755709,1469756029,320
1361048380,1469761192,61,80734,1323.508197,1361048374517,1361048374965,1469755709,1469756157,448
1361048380,1469761192,5,455,91,1361048374837,1361048375157,1469756029,1469756349,320
1361048380,1469761192,70,90355,1290.785714,1361048374963,1361048375603,1469756155,1469756795,640
1361048380,1469761196,7,3910,558.5714286,1361048375601,1361048376113,1469756797,1469757309,512
1361048380,1469761196,5,2018,403.6,1361048375600,1361048376112,1469756796,1469757308,512
1361048380,1469761196,51,67418,1321.921569,1361048375599,1361048376495,1469756795,1469757691,896
1361048380,1469761196,5,2016,403.2,1361048375599,1361048376111,1469756795,1469757307,512
1361048380,1469761196,71,90865,1279.788732,1361048375663,1361048376623,1469756859,1469757819,960
1361048383,108077188,33,41209,1248.757576,1361048374945,1361048375457,108069133,108069645,512
1361048383,108077188,8,6651,831.375,1361048375329,1361048375393,108069517,108069581,64
1361048383,108077188,8,6148,768.5,1361048375457,1361048375457,108069645,108069645,0
1361048383,108077192,8,6651,831.375,1361048375324,1361048375388,108069516,108069580,64
1361048383,108077192,8,6148,768.5,1361048375452,1361048375452,108069644,108069644,0
1361048383,108077192,8,6148,768.5,1361048375452,1361048375516,108069644,108069708,64
1361048388,1469769232,78,102099,1308.961538,1361048377227,1361048387531,1469758459,1469768763,10304
1361048388,1469769296,1,52,52,1361048360717,1361048360717,1469742013,1469742013,0
1361048388,1469769336,1,52,52,1361048362340,1361048362340,1469743676,1469743676,0
1361048388,1469769456,10,4051,405.1,1361048363370,1361048363626,1469744826,1469745082,256
1361048396,1469777084,2,131,65.5,1361048394976,1361048394976,1469776060,1469776060,0
1361048396,1469777300,26,32939,1266.884615,1361048369672,1361048370312,1469750972,1469751612,640
1361048396,1469777300,39,48805,1251.410256,1361048369736,1361048370248,1469751036,1469751548,512
1361048396,1469777340,6,2338,389.6666667,1361048367903,1361048368607,1469749243,1469749947,704
1361048398,108092980,1,52,52,1361048373322,1361048373322,108068302,108068302,0
1361048400,1469781320,1,76,76,1361048374005,1361048374005,1469755325,1469755325,0
1361048402,108096968,7,6405,915,1361048376918,1361048376918,108071886,108071886,0
1361048404,1469785316,84,116447,1386.27381,1361048377080,1361048377528,1469758396,1469758844,448
1361048404,1469785396,84,116447,1386.27381,1361048377382,1361048377446,1469758778,1469758842,64
1361048404,1469785400,15,16897,1126.466667,1361048377572,1361048377828,1469758972,1469759228,256
1361048404,1469785400,5,3785,757,1361048377572,1361048377636,1469758972,1469759036,64
1361048412,1469793052,4,208,52,1361048408192,1361048408256,1469789244,1469789308,64
1361048412,1469793052,3,138,46,1361048408192,1361048411200,1469789244,1469792252,3008
1361048412,1469793052,3,138,46,1361048408192,1361048411200,1469789244,1469792252,3008
1361048412,1469793052,3,138,46,1361048408192,1361048411200,1469789244,1469792252,3008
1361048412,1469793052,3,138,46,1361048408192,1361048411200,1469789244,1469792252,3008
1361048412,1469793052,2,104,52,1361048408192,1361048408192,1469789244,1469789244,0
1361048412,1469793052,3,138,46,1361048408192,1361048411200,1469789244,1469792252,3008
1361048412,1469793052,3,138,46,1361048408192,1361048411200,1469789244,1469792252,3008
1361048412,1469793052,3,138,46,1361048408191,1361048411199,1469789243,1469792251,3008
1361048412,1469793052,3,138,46,1361048408191,1361048411199,1469789243,1469792251,3008
1361048412,1469793064,132,182556,1383,1361048369970,1361048408178,1469751034,1469789242,38208
1361048412,1469793100,3,193,64.33333333,1361048408144,1361048408144,1469789244,1469789244,0
1361048412,1469793100,2,131,65.5,1361048408144,1361048408144,1469789244,1469789244,0
1361048412,1469793100,2,104,52,1361048408144,1361048408144,1469789244,1469789244,0
1361048412,1469793100,2,92,46,1361048408143,1361048408143,1469789243,1469789243,0
1361048412,1469793100,2,104,52,1361048408143,1361048408143,1469789243,1469789243,0
1361048412,1469793100,3,138,46,1361048408143,1361048411151,1469789243,1469792251,3008
1361048412,1469793100,3,138,46,1361048408143,1361048411151,1469789243,1469792251,3008
1361048412,1469793100,3,138,46,1361048408143,1361048411151,1469789243,1469792251,3008
1361048412,1469793100,3,138,46,1361048408143,1361048411151,1469789243,1469792251,3008
1361048412,1469793100,3,138,46,1361048408143,1361048411151,1469789243,1469792251,3008
1361048412,1469793100,3,138,46,1361048408143,1361048411151,1469789243,1469792251,3008
1361048412,1469793100,3,138,46,1361048408142,1361048411150,1469789242,1469792250,3008
1361048412,1469793136,170,238186,1401.094118,1361048378090,1361048408106,1469759226,1469789242,30016
1361048415,108109200,114,146776,1287.508772,1361048272214,1361048408150,107966414,108102350,135936
1361048415,108109200,112,144938,1294.089286,1361048272342,1361048408150,107966542,108102350,135808
1361048416,1469797420,2,104,52,1361048390607,1361048407823,1469772027,1469789243,17216
1361048424,1469805392,1,52,52,1361048398508,1361048398508,1469779900,1469779900,0
1361048428,1469809156,2,92,46,1361048415064,1361048423064,1469796220,1469804220,8000
1361048428,1469809156,2,92,46,1361048415064,1361048423064,1469796220,1469804220,8000
1361048434,108128896,1,52,52,1361048407452,1361048407452,108102348,108102348,0
1361048434,108128896,1,52,52,1361048407455,1361048407455,108102351,108102351,0
1361048434,108128896,1,52,52,1361048407455,1361048407455,108102351,108102351,0
1361048434,108128896,1,52,52,1361048407455,1361048407455,108102351,108102351,0
1361048434,108128912,1,52,52,1361048407439,1361048407439,108102351,108102351,0
1361048434,108128960,1,52,52,1361048407390,1361048407390,108102350,108102350,0
1361048434,108128960,1,52,52,1361048407389,1361048407389,108102349,108102349,0
1361048436,1469817280,1,52,52,1361048407964,1361048407964,1469789244,1469789244,0
1361048436,1469817280,1,52,52,1361048407964,1361048407964,1469789244,1469789244,0
1361048436,1469817280,1,52,52,1361048407964,1361048407964,1469789244,1469789244,0
1361048436,1469817280,1,46,46,1361048407964,1361048407964,1469789244,1469789244,0
1361048436,1469817280,1,46,46,1361048407964,1361048407964,1469789244,1469789244,0
1361048436,1469817280,1,52,52,1361048407964,1361048407964,1469789244,1469789244,0
1361048436,1469817280,1,52,52,1361048407963,1361048407963,1469789243,1469789243,0
1361048436,1469817280,1,52,52,1361048407963,1361048407963,1469789243,1469789243,0
1361048436,1469817280,1,52,52,1361048407963,1361048407963,1469789243,1469789243,0
1361048436,1469817280,1,46,46,1361048407963,1361048407963,1469789243,1469789243,0
1361048436,1469817280,1,46,46,1361048407963,1361048407963,1469789243,1469789243,0
1361048436,1469817280,1,52,52,1361048407963,1361048407963,1469789243,1469789243,0
1361048436,1469817280,1,52,52,1361048407963,1361048407963,1469789243,1469789243,0
1361048436,1469817280,1,46,46,1361048407963,1361048407963,1469789243,1469789243,0
1361048436,1469817280,1,46,46,1361048407963,1361048407963,1469789243,1469789243,0
1361048436,1469817280,1,46,46,1361048407962,1361048407962,1469789242,1469789242,0
1361048436,1469817280,1,46,46,1361048407962,1361048407962,1469789242,1469789242,0
1361048436,1469817284,1,46,46,1361048407961,1361048407961,1469789245,1469789245,0
1361048436,1469817284,1,46,46,1361048407961,1361048407961,1469789245,1469789245,0
1361048436,1469817284,1,52,52,1361048407961,1361048407961,1469789245,1469789245,0
1361048436,1469817368,1,52,52,1361048407876,1361048407876,1469789244,1469789244,0
1361048436,1469817368,1,46,46,1361048407876,1361048407876,1469789244,1469789244,0
1361048436,1469817368,1,52,52,1361048407876,1361048407876,1469789244,1469789244,0
1361048436,1469817368,1,52,52,1361048407876,1361048407876,1469789244,1469789244,0
1361048436,1469817368,1,46,46,1361048407876,1361048407876,1469789244,1469789244,0
1361048436,1469817368,1,52,52,1361048407876,1361048407876,1469789244,1469789244,0
1361048436,1469817368,1,52,52,1361048407876,1361048407876,1469789244,1469789244,0
1361048436,1469817368,1,46,46,1361048407876,1361048407876,1469789244,1469789244,0
1361048436,1469817368,1,46,46,1361048407876,1361048407876,1469789244,1469789244,0
1361048436,1469817368,1,46,46,1361048407876,1361048407876,1469789244,1469789244,0
1361048436,1469817368,1,46,46,1361048407876,1361048407876,1469789244,1469789244,0
1361048436,1469817368,1,52,52,1361048407876,1361048407876,1469789244,1469789244,0
1361048436,1469817368,1,46,46,1361048407875,1361048407875,1469789243,1469789243,0
1361048436,1469817368,1,46,46,1361048407874,1361048407874,1469789242,1469789242,0
1361048440,1469821340,1,46,46,1361048414877,1361048414877,1469796217,1469796217,0
1361048440,1469821340,1,46,46,1361048414877,1361048414877,1469796217,1469796217,0
1361048440,1469821340,1,46,46,1361048414877,1361048414877,1469796217,1469796217,0
1361048440,1469821344,1,46,46,1361048414877,1361048414877,1469796221,1469796221,0
1361048440,1469821344,1,46,46,1361048414877,1361048414877,1469796221,1469796221,0
1361048440,1469821344,1,46,46,1361048414876,1361048414876,1469796220,1469796220,0
1361048440,1469821344,1,46,46,1361048414876,1361048414876,1469796220,1469796220,0
1361048440,1469821344,1,46,46,1361048414876,1361048414876,1469796220,1469796220,0
1361048440,1469821432,1,46,46,1361048414788,1361048414788,1469796220,1469796220,0
1361048440,1469821432,1,46,46,1361048414787,1361048414787,1469796219,1469796219,0
1361048440,1469821432,1,46,46,1361048414787,1361048414787,1469796219,1469796219,0
1361048440,1469821432,1,46,46,1361048414787,1361048414787,1469796219,1469796219,0
1361048440,1469821432,1,46,46,1361048414787,1361048414787,1469796219,1469796219,0
1361048444,1469825120,5,578,115.6,1361048443068,1361048443260,1469824188,1469824380,192
1361048444,1469825120,3,598,199.3333333,1361048443067,1361048443259,1469824187,1469824379,192
1361048444,1469825120,4,578,144.5,1361048443195,1361048443259,1469824315,1469824379,64
1361048444,1469825120,5,2061,412.2,1361048443259,1361048443451,1469824379,1469824571,192
1361048444,1469825120,4,579,144.75,1361048443387,1361048443451,1469824507,1469824571,64
1361048444,1469825120,5,3589,717.8,1361048443514,1361048443706,1469824634,1469824826,192
1361048444,1469825120,6,3366,561,1361048443514,1361048443770,1469824634,1469824890,256
1361048444,1469825120,3,676,225.3333333,1361048443066,1361048443258,1469824186,1469824378,192
1361048444,1469825120,5,3619,723.8,1361048443258,1361048443514,1469824378,1469824634,256
1361048444,1469825120,5,2061,412.2,1361048443514,1361048443578,1469824634,1469824698,64
1361048444,1469825120,3,1153,384.3333333,1361048443770,1361048443834,1469824890,1469824954,64
1361048444,1469825192,5,1940,388,1361048443187,1361048443379,1469824379,1469824571,192
1361048444,1469825192,6,2021,336.8333333,1361048443442,1361048443570,1469824634,1469824762,128
1361048444,1469825196,3,608,202.6666667,1361048442989,1361048442989,1469824185,1469824185,0
1361048444,1469825292,11,11995,1090.454545,1361048443409,1361048443601,1469824701,1469824893,192
1361048448,1469829340,1,46,46,1361048422877,1361048422877,1469804217,1469804217,0
1361048448,1469829340,1,46,46,1361048422877,1361048422877,1469804217,1469804217,0
1361048448,1469829340,1,46,46,1361048422877,1361048422877,1469804217,1469804217,0
1361048448,1469829340,1,46,46,1361048422877,1361048422877,1469804217,1469804217,0
1361048448,1469829344,1,46,46,1361048422877,1361048422877,1469804221,1469804221,0
1361048448,1469829344,1,46,46,1361048422877,1361048422877,1469804221,1469804221,0
1361048448,1469829344,1,46,46,1361048422877,1361048422877,1469804221,1469804221,0
1361048448,1469829456,1,46,46,1361048422764,1361048422764,1469804220,1469804220,0
1361048448,1469829456,1,46,46,1361048422764,1361048422764,1469804220,1469804220,0
1361048448,1469829456,1,46,46,1361048422764,1361048422764,1469804220,1469804220,0
1361048448,1469829456,1,46,46,1361048422762,1361048422762,1469804218,1469804218,0
1361048448,1469829456,1,46,46,1361048422762,1361048422762,1469804218,1469804218,0
1361048448,1469829456,1,46,46,1361048422762,1361048422762,1469804218,1469804218,0
1361048452,1469833068,5,455,91,1361048444014,1361048444398,1469825082,1469825466,384
1361048452,1469833072,5,480,96,1361048444652,1361048444780,1469825724,1469825852,128
1361048452,1469833120,4,1205,301.25,1361048443836,1361048444988,1469824956,1469826108,1152
1361048452,1469833120,6,501,83.5,1361048443962,1361048445050,1469825082,1469826170,1088
1361048452,1469833120,4,578,144.5,1361048443962,1361048443962,1469825082,1469825082,0
1361048452,1469833128,6,1992,332,1361048444977,1361048445041,1469826105,1469826169,64
1361048452,1469833128,5,3600,720,1361048445172,1361048445300,1469826300,1469826428,128
1361048452,1469833128,5,2065,413,1361048445172,1361048445236,1469826300,1469826364,64
1361048452,1469833128,6,1992,332,1361048445236,1361048445364,1469826364,1469826492,128
1361048452,1469833128,5,1257,251.4,1361048445363,1361048445491,1469826491,1469826619,128
1361048452,1469833128,5,455,91,1361048445427,1361048445811,1469826555,1469826939,384
1361048452,1469833156,8,7215,901.875,1361048441943,1361048446999,1469823099,1469828155,5056
1361048452,1469833156,4,1205,301.25,1361048446998,1361048448150,1469828154,1469829306,1152
1361048452,1469833168,5,1480,296,1361048443785,1361048446921,1469824953,1469828089,3136
1361048460,1469841112,11,5669,515.3636364,1361048442626,1361048453058,1469823738,1469834170,10432
1361048460,1469841116,5,1855,371,1361048443071,1361048453055,1469824187,1469834171,9984
1361048460,1469841116,6,2015,335.8333333,1361048443071,1361048453119,1469824187,1469834235,10048
1361048460,1469841116,4,656,164,1361048443262,1361048453438,1469824378,1469834554,10176
1361048460,1469841164,6,1821,303.5,1361048459087,1361048459215,1469840251,1469840379,128
1361048460,1469841164,29,32242,1111.793103,1361048442573,1361048453005,1469823737,1469834169,10432
1361048460,1469841188,5,1073,214.6,1361048442999,1361048453047,1469824187,1469834235,10048
1361048460,1469841188,5,791,158.2,1361048442999,1361048453047,1469824187,1469834235,10048
1361048464,1469845748,1,46,46,1361048438472,1361048438472,1469820220,1469820220,0
1361048464,1469845748,1,46,46,1361048438536,1361048438536,1469820284,1469820284,0
1361048468,1469849556,1,52,52,1361048443462,1361048443462,1469825018,1469825018,0
1361048468,1469849560,40,51710,1292.75,1361048443586,1361048443906,1469825146,1469825466,320
1361048468,1469849608,37,43205,1167.702703,1361048442132,1361048442580,1469823740,1469824188,448
1361048468,1469849608,6,1468,244.6666667,1361048442577,1361048442833,1469824185,1469824441,256
1361048468,1469849612,38,37186,978.5789474,1361048442511,1361048442959,1469824123,1469824571,448
1361048468,1469849612,6,2724,454,1361048443023,1361048446415,1469824635,1469828027,3392
1361048468,1469849612,23,25352,1102.26087,1361048442702,1361048442958,1469824314,1469824570,256
1361048468,1469849636,1,52,52,1361048443384,1361048443384,1469825020,1469825020,0
1361048468,1469849692,21,25855,1231.190476,1361048442111,1361048442175,1469823803,1469823867,64
1361048468,1469849696,3,540,180,1361048442236,1361048442236,1469823932,1469823932,0
1361048468,1469849720,16,14426,901.625,1361048443106,1361048444770,1469824826,1469826490,1664
1361048468,1469849724,5,3448,689.6,1361048442397,1361048442525,1469824121,1469824249,128
1361048468,1469849724,19,14610,768.9473684,1361048442461,1361048444573,1469824185,1469826297,2112
1361048468,1469849724,9,5354,594.8888889,1361048442461,1361048442717,1469824185,1469824441,256
1361048468,1469849724,18,15462,859,1361048442461,1361048442845,1469824185,1469824569,384
1361048468,1469849724,32,39055,1220.46875,1361048442846,1361048442910,1469824570,1469824634,64
1361048468,1469849724,4,661,165.25,1361048442910,1361048442974,1469824634,1469824698,64
1361048470,108164928,56,74767,1335.125,1361048442814,1361048443070,108137742,108137998,256
1361048470,108164928,19,23793,1252.263158,1361048442813,1361048442877,108137741,108137805,64
1361048470,108164928,49,65406,1334.816327,1361048442813,1361048443069,108137741,108137997,256
1361048470,108164928,29,38516,1328.137931,1361048442813,1361048442877,108137741,108137805,64
1361048470,108164928,10,11047,1104.7,1361048443068,1361048443132,108137996,108138060,64
1361048470,108164928,6,4812,802,1361048443068,1361048443068,108137996,108137996,0
1361048470,108164932,14,16121,1151.5,1361048443067,1361048443131,108137999,108138063,64
1361048470,108164932,12,12887,1073.916667,1361048443067,1361048443131,108137999,108138063,64
1361048470,108164932,10,11098,1109.8,1361048443067,1361048443067,108137999,108137999,0
1361048470,108164932,69,89156,1292.115942,1361048443259,1361048444795,108138191,108139727,1536
1361048470,108164932,33,41899,1269.666667,1361048443322,1361048443386,108138254,108138318,64
1361048470,108164932,3,1437,479,1361048443577,1361048443577,108138509,108138509,0
1361048470,108164972,17,19575,1151.470588,1361048442707,1361048444499,108137679,108139471,1792
1361048470,108164972,34,43734,1286.294118,1361048442707,1361048443539,108137679,108138511,832
1361048470,108164972,10,4994,499.4,1361048442707,1361048444499,108137679,108139471,1792
1361048470,108164972,17,20663,1215.470588,1361048442770,1361048442834,108137742,108137806,64
1361048470,108164972,13,13261,1020.076923,1361048442770,1361048443026,108137742,108137998,256
1361048470,108164972,15,17329,1155.266667,1361048443025,1361048443089,108137997,108138061,64
1361048470,108164976,6,4824,804,1361048443214,1361048443534,108138190,108138510,320
1361048470,108164976,9,9102,1011.333333,1361048443534,1361048443534,108138510,108138510,0
1361048472,1469853564,3,580,193.3333333,1361048444031,1361048444031,1469825595,1469825595,0
1361048472,1469853564,3,645,215,1361048444030,1361048444030,1469825594,1469825594,0
1361048472,1469853568,8,4591,573.875,1361048444092,1361048444412,1469825660,1469825980,320
1361048472,1469853576,14,14880,1062.857143,1361048444660,1361048446196,1469826236,1469827772,1536
1361048472,1469853676,21,21411,1019.571429,1361048444557,1361048446029,1469826233,1469827705,1472
1361048476,1469857080,5,553,110.6,1361048474209,1361048474337,1469855289,1469855417,128
1361048476,1469857080,2,131,65.5,1361048474915,1361048474915,1469855995,1469855995,0
1361048492,1469873092,5,553,110.6,1361048489111,1361048489239,1469870203,1469870331,128
1361048496,1469877636,1,46,46,1361048470647,1361048470647,1469852283,1469852283,0
1361048496,1469877720,1,46,46,1361048470564,1361048470564,1469852284,1469852284,0
1361048508,1469889256,5,553,110.6,1361048503986,1361048504050,1469885242,1469885306,64
1361048516,1469897144,2,141,70.5,1361048505187,1361048510179,1469886331,1469891323,4992
1361048516,1469897180,19536,27852087,1425.680129,1361048443965,1361048511485,1469825145,1469892665,67520
1361048524,1469905204,5,553,110.6,1361048519013,1361048519141,1469900217,1469900345,128
1361048532,1469913660,1,52,52,1361048505694,1361048505694,1469887354,1469887354,0
1361048532,1469913696,1,52,52,1361048507194,1361048507194,1469888890,1469888890,0
1361048532,1469913748,1,52,52,1361048505606,1361048505606,1469887354,1469887354,0
1361048540,1469921168,5,553,110.6,1361048534088,1361048534152,1469915256,1469915320,64
1361048548,1469929208,3,608,202.6666667,1361048547809,1361048547873,1469929017,1469929081,64
1361048548,1469929212,3,150,50,1361048547615,1361048547679,1469928827,1469928891,64
1361048548,1469929280,2,104,52,1361048547544,1361048547544,1469928824,1469928824,0
1361048548,1469929280,2,104,52,1361048547544,1361048547544,1469928824,1469928824,0
1361048556,1469937248,5,1940,388,1361048548410,1361048548474,1469929658,1469929722,64
1361048556,1469937248,5,2061,412.2,1361048548410,1361048548986,1469929658,1469930234,576
1361048556,1469937248,6,2044,340.6666667,1361048548410,1361048548666,1469929658,1469929914,256
1361048556,1469937248,5,1940,388,1361048548410,1361048548538,1469929658,1469929786,128
1361048556,1469937248,4,971,242.75,1361048548026,1361048553210,1469929274,1469934458,5184
1361048556,1469937248,4,1205,301.25,1361048548728,1361048548792,1469929976,1469930040,64
1361048556,1469937252,5,1940,388,1361048548982,1361048549046,1469930234,1469930298,64
1361048556,1469937252,5,455,91,1361048548982,1361048549366,1469930234,1469930618,384
1361048556,1469937252,4,1205,301.25,1361048549045,1361048549109,1469930297,1469930361,64
1361048556,1469937252,5,455,91,1361048549173,1361048549557,1469930425,1469930809,384
1361048556,1469937292,5,1583,316.6,1361048544077,1361048549133,1469925369,1469930425,5056
1361048556,1469937296,6,2021,336.8333333,1361048548235,1361048548427,1469929531,1469929723,192
1361048556,1469937296,5,3627,725.4,1361048548298,1361048548426,1469929594,1469929722,128
1361048556,1469937296,4,1068,267,1361048547978,1361048553162,1469929274,1469934458,5184
1361048556,1469937296,5,3591,718.2,1361048548362,1361048548426,1469929658,1469929722,64
1361048556,1469937296,5,2061,412.2,1361048548362,1361048548490,1469929658,1469929786,128
1361048556,1469937296,4,952,238,1361048547977,1361048553161,1469929273,1469934457,5184
1361048556,1469937296,6,1994,332.3333333,1361048548425,1361048548489,1469929721,1469929785,64
1361048556,1469937296,2,92,46,1361048548425,1361048548489,1469929721,1469929785,64
1361048556,1469937296,5,3663,732.6,1361048548617,1361048548809,1469929913,1469930105,192
1361048556,1469937296,5,3688,737.6,1361048548104,1361048548424,1469929400,1469929720,320
1361048556,1469937296,5,455,91,1361048548872,1361048549256,1469930168,1469930552,384
1361048556,1469937296,5,455,91,1361048548872,1361048549256,1469930168,1469930552,384
1361048556,1469937300,5,3621,724.2,1361048548931,1361048549059,1469930231,1469930359,128
1361048556,1469937300,5,455,91,1361048548871,1361048549255,1469930171,1469930555,384
1361048556,1469937340,21,23187,1104.142857,1361048546908,1361048552988,1469928248,1469934328,6080
1361048560,1469941760,1,46,46,1361048534586,1361048534586,1469916346,1469916346,0
1361048560,1469941760,1,46,46,1361048534586,1361048534586,1469916346,1469916346,0
1361048564,1469945292,21,24628,1172.761905,1361048548109,1361048558157,1469929401,1469939449,10048
1361048564,1469945292,4,657,164.25,1361048548173,1361048558157,1469929465,1469939449,9984
1361048564,1469945336,58,73343,1264.534483,1361048544162,1361048558114,1469925498,1469939450,13952
1361048564,1469945336,40,48008,1200.2,1361048544161,1361048558113,1469925497,1469939449,13952
1361048568,1469949716,1,46,46,1361048543718,1361048543718,1469925434,1469925434,0
1361048568,1469949796,13,14585,1121.923077,1361048543700,1361048543764,1469925496,1469925560,64
1361048572,1469953624,1,46,46,1361048547843,1361048547843,1469929467,1469929467,0
1361048572,1469953624,7,4900,700,1361048547842,1361048547970,1469929466,1469929594,128
1361048572,1469953716,3,540,180,1361048547300,1361048547300,1469929016,1469929016,0
1361048572,1469953720,1,52,52,1361048547296,1361048547296,1469929016,1469929016,0
1361048572,1469953724,1,52,52,1361048547485,1361048547485,1469929209,1469929209,0
1361048572,1469953724,6,3666,611,1361048547485,1361048547613,1469929209,1469929337,128
1361048572,1469953732,10,7597,759.7,1361048547735,1361048548183,1469929467,1469929915,448
1361048572,1469953732,1,52,52,1361048547670,1361048547670,1469929402,1469929402,0
1361048572,1469953804,6,1468,244.6666667,1361048547020,1361048547340,1469928824,1469929144,320
1361048575,108269120,5,2081,416.2,1361048548455,1361048549223,108242575,108243343,768
1361048575,108269124,1,52,52,1361048548964,1361048548964,108243088,108243088,0
1361048575,108269124,1,52,52,1361048548963,1361048548963,108243087,108243087,0
1361048575,108269172,1,52,52,1361048548660,1361048548660,108242832,108242832,0
1361048575,108269172,4,1186,296.5,1361048548660,1361048548660,108242832,108242832,0
1361048575,108269172,6,2577,429.5,1361048548658,1361048549234,108242830,108243406,576
1361048575,108269172,35,44424,1269.257143,1361048548914,1361048548978,108243086,108243150,64
1361048575,108269172,33,41811,1267,1361048548978,1361048549042,108243150,108243214,64
1361048576,1469957620,12,9605,800.4166667,1361048548291,1361048548419,1469929911,1469930039,128
1361048576,1469957652,1,52,52,1361048549606,1361048549606,1469931258,1469931258,0
1361048576,1469957652,13,11730,902.3076923,1361048549670,1361048549862,1469931322,1469931514,192
1361048576,1469957652,4,1986,496.5,1361048549669,1361048549733,1469931321,1469931385,64
1361048576,1469957652,12,11652,971,1361048549668,1361048549860,1469931320,1469931512,192
1361048576,1469957652,4,1965,491.25,1361048549668,1361048549668,1469931320,1469931320,0
1361048576,1469957700,1,52,52,1361048548022,1361048548022,1469929722,1469929722,0
1361048576,1469957700,4,1418,354.5,1361048548148,1361048548532,1469929848,1469930232,384
1361048576,1469957700,12,9605,800.4166667,1361048548212,1361048548340,1469929912,1469930040,128
1361048576,1469957700,5,3780,756,1361048548467,1361048548531,1469930167,1469930231,64
1361048576,1469957704,5,3785,757,1361048548528,1361048548528,1469930232,1469930232,0
1361048576,1469957736,1,52,52,1361048549520,1361048549520,1469931256,1469931256,0
1361048576,1469957740,4,1988,497,1361048549582,1361048549582,1469931322,1469931322,0
1361048583,108277292,102,132283,1296.892157,1361048548793,1361048580409,108243085,108274701,31616
1361048583,108277300,104,137532,1322.423077,1361048443380,1361048580404,108137680,108274704,137024
1361048588,1469969260,3,168,56,1361048580269,1361048580269,1469961529,1469961529,0
1361048588,1469969268,170,238186,1401.094118,1361048549286,1361048580262,1469930554,1469961530,30976
1361048588,1469969308,2,104,52,1361048580219,1361048580219,1469961527,1469961527,0
1361048588,1469969312,2,141,70.5,1361048580215,1361048580215,1469961527,1469961527,0
1361048588,1469969312,3,193,64.33333333,1361048580215,1361048580215,1469961527,1469961527,0
1361048588,1469969316,170,238186,1401.094118,1361048549236,1361048580212,1469930552,1469961528,30976
1361048596,1469977256,5,2061,412.2,1361048592367,1361048592431,1469973623,1469973687,64
1361048596,1469977256,4,409,102.25,1361048592367,1361048592495,1469973623,1469973751,128
1361048596,1469977260,5,1257,251.4,1361048592430,1361048592686,1469973690,1469973946,256
1361048596,1469977260,4,1205,301.25,1361048592558,1361048592814,1469973818,1469974074,256
1361048596,1469977268,6,1608,268,1361048593251,1361048593379,1469974519,1469974647,128
1361048596,1469977272,8,6999,874.875,1361048590751,1361048595807,1469972023,1469977079,5056
1361048596,1469977296,4,569,142.25,1361048594696,1361048594824,1469975992,1469976120,128
1361048596,1469977300,6,1994,332.3333333,1361048595012,1361048595268,1469976312,1469976568,256
1361048596,1469977300,7,2044,292,1361048592131,1361048593091,1469973431,1469974391,960
1361048596,1469977304,6,2021,336.8333333,1361048595713,1361048595841,1469977017,1469977145,128
1361048596,1469977304,5,700,140,1361048595584,1361048595712,1469976888,1469977016,128
1361048596,1469977304,5,3590,718,1361048592256,1361048592512,1469973560,1469973816,256
1361048596,1469977308,6,1992,332,1361048592382,1361048592510,1469973690,1469973818,128
1361048596,1469977308,7,772,110.2857143,1361048592573,1361048594109,1469973881,1469975417,1536
1361048596,1469977308,5,480,96,1361048592509,1361048592637,1469973817,1469973945,128
1361048596,1469977308,4,1428,357,1361048592636,1361048593852,1469973944,1469975160,1216
1361048596,1469977312,6,2207,367.8333333,1361048593016,1361048593208,1469974328,1469974520,192
1361048596,1469977316,4,1888,472,1361048593333,1361048593589,1469974649,1469974905,256
1361048596,1469977344,3,608,202.6666667,1361048594584,1361048594648,1469975928,1469975992,64
1361048596,1469977348,3,608,202.6666667,1361048591507,1361048591571,1469972855,1469972919,64
1361048596,1469977348,9,8799,977.6666667,1361048591507,1361048591635,1469972855,1469972983,128
1361048596,1469977348,7,2105,300.7142857,1361048594711,1361048594903,1469976059,1469976251,192
1361048596,1469977348,5,578,115.6,1361048591510,1361048591638,1469972858,1469972986,128
1361048596,1469977348,5,3589,717.8,1361048591894,1361048592022,1469973242,1469973370,128
1361048596,1469977348,5,2061,412.2,1361048591958,1361048592022,1469973306,1469973370,64
1361048596,1469977348,6,2045,340.8333333,1361048592149,1361048592277,1469973497,1469973625,128
1361048596,1469977664,3,1089,363,1361048595227,1361048595419,1469976891,1469977083,192
1361048596,1469977664,3,539,179.6666667,1361048595482,1361048595546,1469977146,1469977210,64
1361048600,1469981728,2,92,46,1361048573656,1361048579800,1469955384,1469961528,6144
1361048604,1469985264,6,438,73,1361048596137,1361048596265,1469977401,1469977529,128
1361048604,1469985264,4,1205,301.25,1361048592999,1361048596199,1469974263,1469977463,3200
1361048604,1469985300,4,657,164.25,1361048592005,1361048602053,1469973305,1469983353,10048
1361048604,1469985304,5,969,193.8,1361048595967,1361048596095,1469977271,1469977399,128
1361048604,1469985308,5,969,193.8,1361048595966,1361048596094,1469977274,1469977402,128
1361048604,1469985336,6,4326,721,1361048594337,1361048599585,1469975673,1469980921,5248
1361048604,1469985692,5,1498,299.6,1361048595454,1361048595582,1469977146,1469977274,128
1361048604,1469985692,2,104,52,1361048579837,1361048580733,1469961529,1469962425,896
1361048604,1469985692,1,52,52,1361048579837,1361048579837,1469961529,1469961529,0
1361048604,1469985692,1,52,52,1361048579837,1361048579837,1469961529,1469961529,0
1361048604,1469985692,1,52,52,1361048579837,1361048579837,1469961529,1469961529,0
1361048604,1469985692,1,52,52,1361048579837,1361048579837,1469961529,1469961529,0
1361048604,1469985692,1,52,52,1361048579837,1361048579837,1469961529,1469961529,0
1361048604,1469985692,1,52,52,1361048579837,1361048579837,1469961529,1469961529,0
1361048604,1469985692,1,46,46,1361048579837,1361048579837,1469961529,1469961529,0
1361048604,1469985692,1,46,46,1361048579837,1361048579837,1469961529,1469961529,0
1361048604,1469985692,1,46,46,1361048579837,1361048579837,1469961529,1469961529,0
1361048604,1469985692,1,46,46,1361048579837,1361048579837,1469961529,1469961529,0
1361048604,1469985692,1,46,46,1361048579837,1361048579837,1469961529,1469961529,0
1361048604,1469985692,1,52,52,1361048579837,1361048579837,1469961529,1469961529,0
1361048604,1469985692,1,46,46,1361048579837,1361048579837,1469961529,1469961529,0
1361048604,1469985692,1,52,52,1361048579837,1361048579837,1469961529,1469961529,0
1361048604,1469985692,1,52,52,1361048579836,1361048579836,1469961528,1469961528,0
1361048604,1469985692,1,52,52,1361048579836,1361048579836,1469961528,1469961528,0
1361048604,1469985780,1,46,46,1361048579748,1361048579748,1469961528,1469961528,0
1361048604,1469985788,1,52,52,1361048579742,1361048579742,1469961530,1469961530,0
1361048604,1469985788,1,52,52,1361048579742,1361048579742,1469961530,1469961530,0
1361048604,1469985788,1,46,46,1361048579742,1361048579742,1469961530,1469961530,0
1361048604,1469985788,1,52,52,1361048579742,1361048579742,1469961530,1469961530,0
1361048604,1469985788,1,52,52,1361048579742,1361048579742,1469961530,1469961530,0
1361048604,1469985788,1,52,52,1361048579742,1361048579742,1469961530,1469961530,0
1361048604,1469985788,1,52,52,1361048579742,1361048579742,1469961530,1469961530,0
1361048604,1469985788,1,46,46,1361048579742,1361048579742,1469961530,1469961530,0
1361048604,1469985788,1,46,46,1361048579742,1361048579742,1469961530,1469961530,0
1361048604,1469985788,2,104,52,1361048579742,1361048579742,1469961530,1469961530,0
1361048604,1469985788,2,104,52,1361048579741,1361048579741,1469961529,1469961529,0
1361048604,1469985788,1,46,46,1361048579741,1361048579741,1469961529,1469961529,0
1361048604,1469985788,1,52,52,1361048579741,1361048579741,1469961529,1469961529,0
1361048604,1469985788,1,52,52,1361048579741,1361048579741,1469961529,1469961529,0
1361048604,1469985788,1,52,52,1361048579741,1361048579741,1469961529,1469961529,0
1361048604,1469985832,2,104,52,1361048578034,1361048579698,1469959866,1469961530,1664
1361048607,108301112,1,52,52,1361048580591,1361048580591,108274703,108274703,0
1361048607,108301112,1,52,52,1361048580591,1361048580591,108274703,108274703,0
1361048607,108301112,1,52,52,1361048580591,1361048580591,108274703,108274703,0
1361048607,108301112,1,52,52,1361048580591,1361048580591,108274703,108274703,0
1361048607,108301112,1,52,52,1361048580591,1361048580591,108274703,108274703,0
1361048607,108301112,1,52,52,1361048580589,1361048580589,108274701,108274701,0
1361048607,108301112,1,52,52,1361048580589,1361048580589,108274701,108274701,0
1361048607,108301112,1,52,52,1361048580589,1361048580589,108274701,108274701,0
1361048607,108301112,1,52,52,1361048580589,1361048580589,108274701,108274701,0
1361048607,108301112,1,52,52,1361048580589,1361048580589,108274701,108274701,0
1361048607,108301112,1,52,52,1361048580589,1361048580589,108274701,108274701,0
1361048607,108301152,1,52,52,1361048580549,1361048580549,108274701,108274701,0
1361048607,108301152,1,52,52,1361048580549,1361048580549,108274701,108274701,0
1361048607,108301152,1,52,52,1361048580549,1361048580549,108274701,108274701,0
1361048607,108301152,1,52,52,1361048580549,1361048580549,108274701,108274701,0
1361048607,108301152,1,52,52,1361048580549,1361048580549,108274701,108274701,0
1361048607,108301152,1,52,52,1361048580549,1361048580549,108274701,108274701,0
1361048607,108301152,1,52,52,1361048580549,1361048580549,108274701,108274701,0
1361048607,108301152,1,52,52,1361048580548,1361048580548,108274700,108274700,0
1361048607,108301152,1,52,52,1361048580552,1361048580552,108274704,108274704,0
1361048607,108301152,1,52,52,1361048580552,1361048580552,108274704,108274704,0
1361048607,108301152,1,52,52,1361048580552,1361048580552,108274704,108274704,0
1361048608,1469989684,1,46,46,1361048579844,1361048579844,1469961528,1469961528,0
1361048608,1469989684,1,46,46,1361048579907,1361048579907,1469961591,1469961591,0
1361048612,1469993276,6,1990,331.6666667,1361048607134,1361048607262,1469988410,1469988538,128
1361048612,1469993344,6,1394,232.3333333,1361048594646,1361048604886,1469975990,1469986230,10240
1361048616,1469997744,3,540,180,1361048591113,1361048591113,1469972857,1469972857,0
1361048616,1469997744,9,5353,594.7777778,1361048591177,1361048591305,1469972921,1469973049,128
1361048616,1469997744,15,15317,1021.133333,1361048591177,1361048591433,1469972921,1469973177,256
1361048616,1469997744,16,12499,781.1875,1361048591113,1361048592265,1469972857,1469974009,1152
1361048616,1469997768,5,3413,682.6,1361048591345,1361048591409,1469973113,1469973177,64
1361048616,1469997768,3,644,214.6666667,1361048591345,1361048591345,1469973113,1469973113,0
1361048616,1469997768,12,9996,833,1361048591663,1361048592047,1469973431,1469973815,384
1361048616,1469997852,20,24413,1220.65,1361048591006,1361048591070,1469972858,1469972922,64
1361048616,1469997852,6,1469,244.8333333,1361048591069,1361048591197,1469972921,1469973049,128
1361048616,1469997852,21,13894,661.6190476,1361048591004,1361048591388,1469972856,1469973240,384
1361048616,1469997856,3,580,193.3333333,1361048591258,1361048591322,1469973114,1469973178,64
1361048616,1469997856,8,4591,573.875,1361048591321,1361048591705,1469973177,1469973561,384
1361048616,1469997856,6,2712,452,1361048591639,1361048594071,1469973495,1469975927,2432
1361048619,108313324,19,21681,1141.105263,1361048591964,1361048593180,108286288,108287504,1216
1361048619,108313324,10,4734,473.4,1361048592218,1361048594842,108286542,108289166,2624
1361048619,108313328,5,2168,433.6,1361048592919,1361048593559,108287247,108287887,640
1361048619,108313368,20,24262,1213.1,1361048591919,1361048593199,108286287,108287567,1280
1361048619,108313372,6,2940,490,1361048592427,1361048594795,108286799,108289167,2368
1361048619,108313372,68,86609,1273.661765,1361048592554,1361048595882,108286926,108290254,3328
1361048620,1470001692,3,387,129,1361048595517,1361048595517,1469977209,1469977209,0
1361048620,1470001692,4,1501,375.25,1361048595516,1361048595644,1469977208,1469977336,128
1361048620,1470001696,4,1058,264.5,1361048595578,1361048595706,1469977274,1469977402,128
1361048620,1470001708,12,11649,970.75,1361048592750,1361048594478,1469974458,1469976186,1728
1361048620,1470001708,9,7120,791.1111111,1361048593067,1361048594987,1469974775,1469976695,1920
1361048620,1470001740,5,3360,672,1361048594059,1361048594123,1469975799,1469975863,64
1361048620,1470001792,4,1667,416.75,1361048594967,1361048595031,1469976759,1469976823,64
1361048620,1470001800,3,615,205,1361048591887,1361048592015,1469973687,1469973815,128
1361048620,1470001812,13,11708,900.6153846,1361048592646,1361048594374,1469974458,1469976186,1728
1361048620,1470001880,22,27430,1246.818182,1361048595136,1361048595136,1469977016,1469977016,0
1361048624,1470005696,3,1552,517.3333333,1361048595448,1361048595512,1469977144,1469977208,64
1361048624,1470005744,1,46,46,1361048598664,1361048598664,1469980408,1469980408,0
1361048624,1470005828,1,46,46,1361048598581,1361048598581,1469980409,1469980409,0
1361048628,1470009300,5,553,110.6,1361048622214,1361048622342,1470003514,1470003642,128
1361048628,1470009368,2,131,65.5,1361048622208,1361048622208,1470003576,1470003576,0
1361048644,1470025340,6,1946,324.3333333,1361048637082,1361048637210,1470018422,1470018550,128
1361048649,1470030004,1,46,46,1361048623851,1361048623851,1470004855,1470004855,0
1361048660,1470041308,5,553,110.6,1361048652156,1361048652220,1470033464,1470033528,64
1361048660,1470041356,2,141,70.5,1361048651595,1361048656587,1470032951,1470037943,4992
1361048668,1470049368,5,553,110.6,1361048667133,1361048667261,1470048501,1470048629,128
1361048673,1470054056,3780,5086481,1345.629894,1361048282231,1361048369527,1469663287,1469750583,87296
1361048681,1470062096,1,52,52,1361048654800,1361048654800,1470035896,1470035896,0
1361048681,1470062100,1,52,52,1361048655370,1361048655370,1470036470,1470036470,0
1361048681,1470062100,1,52,52,1361048655434,1361048655434,1470036534,1470036534,0
1361048681,1470062104,1,52,52,1361048655494,1361048655494,1470036598,1470036598,0
1361048681,1470062184,1,52,52,1361048654711,1361048654711,1470035895,1470035895,0
1361048684,1470065336,5,553,110.6,1361048682142,1361048682270,1470063478,1470063606,128
1361048689,1470070052,1,52,52,1361048661819,1361048661819,1470042871,1470042871,0
1361048699,108393340,3,586,195.3333333,1361048672972,1361048672972,108367312,108367312,0
1361048700,1470081380,6,1823,303.8333333,1361048697140,1361048697204,1470078520,1470078584,64
1361048701,1470082116,40,52936,1323.4,1361048673020,1361048673084,1470054136,1470054200,64
1361048701,1470082116,30,37974,1265.8,1361048673020,1361048673084,1470054136,1470054200,64
1361048708,1470089344,33304,47485910,1425.832032,1361048592728,1361048702936,1469974072,1470084280,110208
1361048716,1470097336,5,553,110.6,1361048712669,1361048712797,1470094005,1470094133,128
1361048717,1470098176,1,52,52,1361048692734,1361048692734,1470073910,1470073910,0
1361048729,1470110208,1,52,52,1361048702944,1361048702944,1470084152,1470084152,0
1361048729,1470110296,1,52,52,1361048702856,1361048702856,1470084152,1470084152,0
1361048731,108425344,1,52,52,1361048702983,1361048702983,108397327,108397327,0
1361048732,1470113432,5,553,110.6,1361048727616,1361048727680,1470109048,1470109112,64
1361048737,1470118332,1,52,52,1361048711650,1361048711650,1470092982,1470092982,0
1361048737,1470118332,1,52,52,1361048711650,1361048711650,1470092982,1470092982,0
1361048737,1470118332,1,52,52,1361048711650,1361048711650,1470092982,1470092982,0
1361048741,1470122276,1,52,52,1361048715738,1361048715738,1470097014,1470097014,0
1361048741,1470122360,1,52,52,1361048715462,1361048715462,1470096822,1470096822,0
1361048748,1470129360,6,2185,364.1666667,1361048742661,1361048742789,1470124021,1470124149,128
1361048753,1470134188,1,46,46,1361048725168,1361048725168,1470106356,1470106356,0
1361048764,1470145428,5,553,110.6,1361048757633,1361048757697,1470139061,1470139125,64
1361048780,1470161396,5,553,110.6,1361048772643,1361048772771,1470154039,1470154167,128
1361048788,1470169512,5,553,110.6,1361048787566,1361048787630,1470169078,1470169142,64
1361048804,1470185448,10,7626,762.6,1361048802671,1361048803119,1470184119,1470184567,448
1361048820,1470201404,5,553,110.6,1361048817690,1361048817754,1470199094,1470199158,64
1361048836,1470217460,5,553,110.6,1361048832610,1361048832738,1470214070,1470214198,128
1361048849,1470230472,1,89,89,1361048824339,1361048824339,1470205811,1470205811,0
1361048852,1470233472,9,3554,394.8888889,1361048847637,1361048848021,1470229109,1470229493,384
1361048857,1470238460,1,52,52,1361048831394,1361048831394,1470212854,1470212854,0
1361048857,1470238460,1,52,52,1361048831713,1361048831713,1470213173,1470213173,0
1361048857,1470238460,1,52,52,1361048831712,1361048831712,1470213172,1470213172,0
1361048861,1470242544,1,52,52,1361048834379,1361048834379,1470215923,1470215923,0
1361048868,1470249444,5,553,110.6,1361048862640,1361048862768,1470244084,1470244212,128
1361048869,1470250496,1,46,46,1361048840830,1361048840830,1470222326,1470222326,0
1361048873,1470254396,1,46,46,1361048845152,1361048845152,1470226548,1470226548,0
1361048873,1470254524,1,48,48,1361048846754,1361048846754,1470228278,1470228278,0
1361048884,1470265440,5,3614,722.8,1361048881332,1361048881716,1470262772,1470263156,384
1361048884,1470265440,5,1940,388,1361048881396,1361048881460,1470262836,1470262900,64
1361048884,1470265440,5,1940,388,1361048881332,1361048881396,1470262772,1470262836,64
1361048884,1470265440,5,2061,412.2,1361048881332,1361048881396,1470262772,1470262836,64
1361048884,1470265440,7,3697,528.1428571,1361048877684,1361048877748,1470259124,1470259188,64
1361048884,1470265440,4,1205,301.25,1361048881523,1361048881587,1470262963,1470263027,64
1361048884,1470265444,4,1205,301.25,1361048881520,1361048881584,1470262964,1470263028,64
1361048884,1470265444,5,3591,718.2,1361048881646,1361048881710,1470263090,1470263154,64
1361048884,1470265448,2,92,46,1361048881709,1361048881709,1470263157,1470263157,0
1361048884,1470265448,7,3597,513.8571429,1361048881773,1361048882029,1470263221,1470263477,256
1361048884,1470265448,4,409,102.25,1361048881963,1361048882219,1470263411,1470263667,256
1361048884,1470265448,4,409,102.25,1361048881963,1361048882283,1470263411,1470263731,320
1361048884,1470265448,3,608,202.6666667,1361048882027,1361048882091,1470263475,1470263539,64
1361048884,1470265476,4,1428,357,1361048883472,1361048883664,1470264948,1470265140,192
1361048884,1470265476,5,1940,388,1361048883536,1361048883600,1470265012,1470265076,64
1361048884,1470265480,3,608,202.6666667,1361048880717,1361048880781,1470262197,1470262261,64
1361048884,1470265480,4,1205,301.25,1361048883725,1361048883853,1470265205,1470265333,128
1361048884,1470265480,5,2061,412.2,1361048883469,1361048883597,1470264949,1470265077,128
1361048884,1470265484,5,3621,724.2,1361048881288,1361048881672,1470262772,1470263156,384
1361048884,1470265484,6,2083,347.1666667,1361048881351,1361048881607,1470262835,1470263091,256
1361048884,1470265488,5,2061,412.2,1361048881350,1361048881414,1470262838,1470262902,64
1361048884,1470265488,5,3610,722,1361048881413,1361048881669,1470262901,1470263157,256
1361048884,1470265492,3,608,202.6666667,1361048881598,1361048881662,1470263090,1470263154,64
1361048884,1470265512,4,409,102.25,1361048881899,1361048882219,1470263411,1470263731,320
1361048884,1470265512,4,409,102.25,1361048881901,1361048882221,1470263413,1470263733,320
1361048884,1470265512,7,2085,297.8571429,1361048882027,1361048882155,1470263539,1470263667,128
1361048884,1470265516,2,92,46,1361048882791,1361048882791,1470264307,1470264307,0
1361048884,1470265516,9,9964,1107.111111,1361048882791,1361048882919,1470264307,1470264435,128
1361048884,1470265520,3,608,202.6666667,1361048882790,1361048882854,1470264310,1470264374,64
1361048884,1470265520,5,578,115.6,1361048882854,1361048882982,1470264374,1470264502,128
1361048884,1470265520,5,3604,720.8,1361048883045,1361048883237,1470264565,1470264757,192
1361048884,1470265520,5,2061,412.2,1361048883045,1361048883173,1470264565,1470264693,128
1361048884,1470265520,5,1940,388,1361048883044,1361048883172,1470264564,1470264692,128
1361048884,1470265524,5,3621,724.2,1361048883422,1361048883614,1470264946,1470265138,192
1361048884,1470265524,4,1205,301.25,1361048883486,1361048883550,1470265010,1470265074,64
1361048884,1470265524,4,1205,301.25,1361048883680,1361048883808,1470265204,1470265332,128
1361048885,1470266456,2,92,46,1361048857254,1361048881062,1470238710,1470262518,23808
1361048885,1470266536,1,46,46,1361048857235,1361048857235,1470238771,1470238771,0
1361048892,1470273448,4,1067,266.75,1361048880878,1361048886062,1470262326,1470267510,5184
1361048892,1470273448,4,951,237.75,1361048880878,1361048886062,1470262326,1470267510,5184
1361048892,1470273448,5,970,194,1361048885036,1361048885164,1470266484,1470266612,128
1361048892,1470273448,5,969,193.8,1361048885036,1361048885100,1470266484,1470266548,64
1361048892,1470273448,6,501,83.5,1361048885036,1361048888428,1470266484,1470269876,3392
1361048892,1470273448,6,438,73,1361048885100,1361048885228,1470266548,1470266676,128
1361048892,1470273452,6,4326,721,1361048884200,1361048889448,1470265652,1470270900,5248
1361048892,1470273456,4,569,142.25,1361048884452,1361048884580,1470265908,1470266036,128
1361048892,1470273456,8,3683,460.375,1361048884452,1361048884772,1470265908,1470266228,320
1361048892,1470273464,5,3576,715.2,1361048884766,1361048884894,1470266230,1470266358,128
1361048892,1470273464,5,1958,391.6,1361048884764,1361048884892,1470266228,1470266356,128
1361048892,1470273496,10,7943,794.3,1361048880699,1361048887099,1470262195,1470268595,6400
1361048892,1470273500,3,539,179.6666667,1361048884857,1361048884921,1470266357,1470266421,64
1361048892,1470273500,86,116436,1353.906977,1361048881015,1361048891063,1470262515,1470272563,10048
1361048892,1470273500,4,1205,301.25,1361048884919,1361048884983,1470266419,1470266483,64
1361048892,1470273504,5,1567,313.4,1361048884021,1361048884085,1470265525,1470265589,64
1361048892,1470273532,6,2021,336.8333333,1361048884695,1361048884823,1470266227,1470266355,128
1361048892,1470273544,4,970,242.5,1361048880780,1361048885964,1470262324,1470267508,5184
1361048892,1470273544,6,2083,347.1666667,1361048883724,1361048883980,1470265268,1470265524,256
1361048892,1470273544,5,455,91,1361048883724,1361048884044,1470265268,1470265588,320
1361048892,1470273544,5,480,96,1361048883788,1361048883916,1470265332,1470265460,128
1361048892,1470273544,5,455,91,1361048883788,1361048884172,1470265332,1470265716,384
1361048900,1470281452,6,1705,284.1666667,1361048881639,1361048894375,1470263091,1470275827,12736
1361048900,1470281520,5,553,110.6,1361048898274,1361048898402,1470279794,1470279922,128
1361048905,1470286544,11,2876,261.4545455,1361048880524,1361048883020,1470262068,1470264564,2496
1361048905,1470286544,1,46,46,1361048880588,1361048880588,1470262132,1470262132,0
1361048905,1470286544,4,968,242,1361048880716,1361048882764,1470262260,1470264308,2048
1361048905,1470286544,1,46,46,1361048880778,1361048880778,1470262322,1470262322,0
1361048905,1470286548,10,6764,676.4,1361048880774,1361048882950,1470262322,1470264498,2176
1361048905,1470286628,1,46,46,1361048880503,1361048880503,1470262131,1470262131,0
1361048905,1470286632,1,46,46,1361048880502,1361048880502,1470262134,1470262134,0
1361048905,1470286632,1,46,46,1361048880565,1361048880565,1470262197,1470262197,0
1361048907,108601628,1,52,52,1361048881004,1361048881004,108575632,108575632,0
1361048907,108601628,7,3195,456.4285714,1361048881004,1361048884204,108575632,108578832,3200
1361048907,108601628,3,1050,350,1361048881003,1361048881259,108575631,108575887,256
1361048907,108601628,1,52,52,1361048881262,1361048881262,108575890,108575890,0
1361048907,108601628,8,3593,449.125,1361048881326,1361048884398,108575954,108579026,3072
1361048907,108601644,67,86333,1288.552239,1361048881755,1361048883867,108576399,108578511,2112
1361048907,108601644,1,52,52,1361048881758,1361048881758,108576402,108576402,0
1361048907,108601644,33,41811,1267,1361048881758,1361048881886,108576402,108576530,128
1361048907,108601676,3,1426,475.3333333,1361048880956,1361048881340,108575632,108576016,384
1361048907,108601676,1,52,52,1361048881214,1361048881214,108575890,108575890,0
1361048907,108601680,16,7704,481.5,1361048881210,1361048884346,108575890,108579026,3136
1361048908,1470289456,4276,6091798,1424.648737,1361048883875,1361048906723,1470265331,1470288179,22848
1361048909,1470290496,1,46,46,1361048884860,1361048884860,1470266356,1470266356,0
1361048909,1470290496,1,46,46,1361048884860,1361048884860,1470266356,1470266356,0
1361048909,1470290500,16,12648,790.5,1361048881015,1361048883319,1470262515,1470264819,2304
1361048909,1470290504,4,1418,354.5,1361048881394,1361048883634,1470262898,1470265138,2240
1361048909,1470290508,10,6741,674.1,1361048881457,1361048884273,1470262965,1470265781,2816
1361048909,1470290508,1,46,46,1361048881329,1361048881329,1470262837,1470262837,0
1361048909,1470290508,1,46,46,1361048881583,1361048881583,1470263091,1470263091,0
1361048909,1470290540,12,9605,800.4166667,1361048881678,1361048881806,1470263218,1470263346,128
1361048909,1470290552,1,46,46,1361048882754,1361048882754,1470264306,1470264306,0
1361048909,1470290552,9,5354,594.8888889,1361048882754,1361048883074,1470264306,1470264626,320
1361048909,1470290556,3,580,193.3333333,1361048883008,1361048883008,1470264564,1470264564,0
1361048909,1470290556,3,645,215,1361048883008,1361048883072,1470264564,1470264628,64
1361048909,1470290556,20,24413,1220.65,1361048882751,1361048882815,1470264307,1470264371,64
1361048909,1470290556,14,15153,1082.357143,1361048882750,1361048883134,1470264306,1470264690,384
1361048909,1470290580,3,615,205,1361048883241,1361048883305,1470264821,1470264885,64
1361048909,1470290580,1,46,46,1361048882984,1361048882984,1470264564,1470264564,0
1361048909,1470290580,9,4643,515.8888889,1361048883047,1361048883559,1470264627,1470265139,512
1361048909,1470290588,8,5694,711.75,1361048884769,1361048888993,1470266357,1470270581,4224
1361048909,1470290588,1,46,46,1361048884769,1361048884769,1470266357,1470266357,0
1361048909,1470290592,12,9765,813.75,1361048880924,1361048883228,1470262516,1470264820,2304
1361048909,1470290596,6,2724,454,1361048881239,1361048884759,1470262835,1470266355,3520
1361048909,1470290596,1,46,46,1361048884055,1361048884055,1470265651,1470265651,0
1361048909,1470290624,5,3781,756.2,1361048881468,1361048881468,1470263092,1470263092,0
1361048909,1470290624,5,3782,756.4,1361048881468,1361048881532,1470263092,1470263156,64
1361048909,1470290628,25,25494,1019.76,1361048881591,1361048884791,1470263219,1470266419,3200
1361048909,1470290636,1,60,60,1361048881904,1361048881904,1470263540,1470263540,0
1361048909,1470290664,21,13971,665.2857143,1361048882644,1361048883028,1470264308,1470264692,384
1361048909,1470290668,1,52,52,1361048882896,1361048882896,1470264564,1470264564,0
1361048909,1470290672,1,46,46,1361048883149,1361048883149,1470264821,1470264821,0
1361048911,108605672,6,5712,952,1361048883458,1361048883458,108578130,108578130,0
1361048911,108605672,1,52,52,1361048883394,1361048883394,108578066,108578066,0
1361048911,108605672,11,12438,1130.727273,1361048883394,1361048883458,108578066,108578130,64
1361048911,108605708,1,52,52,1361048883354,1361048883354,108578062,108578062,0
1361048911,108605708,12,13049,1087.416667,1361048883422,1361048883422,108578130,108578130,0
1361048913,1470294452,1,46,46,1361048883881,1361048883881,1470265333,1470265333,0
1361048913,1470294452,1,46,46,1361048884903,1361048884903,1470266355,1470266355,0
1361048913,1470294452,25,29092,1163.68,1361048884903,1361048889127,1470266355,1470270579,4224
1361048913,1470294452,4,1501,375.25,1361048884903,1361048884967,1470266355,1470266419,64
1361048913,1470294452,3,1552,517.3333333,1361048884903,1361048884967,1470266355,1470266419,64
1361048913,1470294456,4,1058,264.5,1361048885092,1361048885156,1470266548,1470266612,64
1361048913,1470294468,1,76,76,1361048885849,1361048885849,1470267317,1470267317,0
1361048913,1470294540,3,387,129,1361048884880,1361048884944,1470266420,1470266484,64
1361048913,1470294544,1,46,46,1361048884941,1361048884941,1470266485,1470266485,0
1361048916,1470297464,6,890,148.3333333,1361048913435,1361048913755,1470294899,1470295219,320
1361048916,1470297540,2,131,65.5,1361048913616,1361048913616,1470295156,1470295156,0
1361048932,1470313500,5,553,110.6,1361048928310,1361048928438,1470309810,1470309938,128
1361048941,1470322564,1,46,46,1361048913144,1361048913144,1470294708,1470294708,0
1361048945,1470326464,1,52,52,1361048917402,1361048917402,1470298866,1470298866,0
1361048945,1470326516,1,52,52,1361048920359,1361048920359,1470301875,1470301875,0
1361048948,1470329500,5,553,110.6,1361048943352,1361048943416,1470324852,1470324916,64
1361048948,1470329516,2,141,70.5,1361048941288,1361048946280,1470322804,1470327796,4992
1361048956,1470337456,2,104,52,1361048948322,1361048948450,1470329778,1470329906,128
1361048956,1470337500,3,193,64.33333333,1361048944312,1361048949432,1470325812,1470330932,5120
1361048956,1470337508,2,104,52,1361048948272,1361048948400,1470329780,1470329908,128
1361048964,1470345608,5,553,110.6,1361048959885,1361048960013,1470341493,1470341621,128
1361048969,1470350868,1,52,52,1361048943686,1361048943686,1470325554,1470325554,0
1361048969,1470350900,1,52,52,1361048944295,1361048944295,1470326195,1470326195,0
1361048970,1470350992,1,52,52,1361048945011,1361048945011,1470326003,1470326003,0
1361048980,1470361580,5,553,110.6,1361048974951,1361048975015,1470356531,1470356595,64
1361048996,1470377616,5,553,110.6,1361048989890,1361048990018,1470371506,1470371634,128
1361048998,1470378988,1,52,52,1361048971893,1361048971893,1470352881,1470352881,0
1361048999,108693708,3,150,50,1361048997534,1361048997726,108692242,108692434,192
1361048999,108693708,133,173780,1306.616541,1361048881693,1361048998237,108576401,108692945,116544
1361048999,108693712,3,150,50,1361048997528,1361048997720,108692240,108692432,192
1361048999,108693716,3,150,50,1361048997527,1361048997719,108692243,108692435,192
1361049004,1470385568,5,1970,394,1361048997361,1361049002545,1470378929,1470384113,5184
1361049004,1470385568,5,1738,347.6,1361048997361,1361049002545,1470378929,1470384113,5184
1361049004,1470385572,5,3614,722.8,1361048997870,1361048998126,1470379442,1470379698,256
1361049004,1470385572,5,2061,412.2,1361048997933,1361048997997,1470379505,1470379569,64
1361049004,1470385576,5,3671,734.2,1361048997928,1361048998312,1470379504,1470379888,384
1361049004,1470385576,4,1205,301.25,1361048998060,1361048998124,1470379636,1470379700,64
1361049004,1470385576,2,92,46,1361048998124,1361048998124,1470379700,1470379700,0
1361049004,1470385576,4,1205,301.25,1361048998124,1361048998188,1470379700,1470379764,64
1361049004,1470385576,5,455,91,1361048998314,1361048998634,1470379890,1470380210,320
1361049004,1470385580,5,455,91,1361048998436,1361048998820,1470380016,1470380400,384
1361049004,1470385580,5,1503,300.6,1361048998631,1361048998695,1470380211,1470380275,64
1361049004,1470385580,3,608,202.6666667,1361048998758,1361048998758,1470380338,1470380338,0
1361049004,1470385580,5,455,91,1361048998758,1361048999078,1470380338,1470380658,320
1361049004,1470385580,6,2009,334.8333333,1361048998758,1361048998822,1470380338,1470380402,64
1361049004,1470385580,4,610,152.5,1361048998758,1361048998758,1470380338,1470380338,0
1361049004,1470385584,5,1940,388,1361048999012,1361048999076,1470380596,1470380660,64
1361049004,1470385584,2,104,52,1361048996962,1361048996962,1470378546,1470378546,0
1361049004,1470385584,170,238186,1401.094118,1361048882018,1361048998754,1470263602,1470380338,116736
1361049004,1470385588,5,455,91,1361048999388,1361048999708,1470380976,1470381296,320
1361049004,1470385616,3,608,202.6666667,1361048997249,1361048997313,1470378865,1470378929,64
1361049004,1470385620,5,1776,355.2,1361048997312,1361049002496,1470378932,1470384116,5184
1361049004,1470385620,2,92,46,1361048997503,1361048997695,1470379123,1470379315,192
1361049004,1470385624,5,1940,388,1361048997884,1361048997948,1470379508,1470379572,64
1361049004,1470385624,5,2061,412.2,1361048997883,1361048998011,1470379507,1470379635,128
1361049004,1470385624,5,1940,388,1361048997883,1361048998011,1470379507,1470379635,128
1361049004,1470385624,21,23189,1104.238095,1361048996283,1361049002363,1470377907,1470383987,6080
1361049004,1470385624,7,3165,452.1428571,1361048998009,1361048998137,1470379633,1470379761,128
1361049004,1470385624,2,92,46,1361048998073,1361048998073,1470379697,1470379697,0
1361049004,1470385624,5,3611,722.2,1361048998136,1361048998264,1470379760,1470379888,128
1361049004,1470385624,3,608,202.6666667,1361048998264,1361048998328,1470379888,1470379952,64
1361049004,1470385628,7,3162,451.7142857,1361048998200,1361048998392,1470379828,1470380020,192
1361049004,1470385628,5,3610,722,1361048998391,1361048998647,1470380019,1470380275,256
1361049004,1470385628,5,455,91,1361048998391,1361048998775,1470380019,1470380403,384
1361049004,1470385628,6,1903,317.1666667,1361048998390,1361048998518,1470380018,1470380146,128
1361049004,1470385648,170,238186,1401.094118,1361048881953,1361048998689,1470263601,1470380337,116736
1361049004,1470385652,6,3680,613.3333333,1361048998944,1361048999264,1470380596,1470380916,320
1361049004,1470385652,5,2065,413,1361048998944,1361048999008,1470380596,1470380660,64
1361049004,1470385652,4,1205,301.25,1361048999071,1361048999135,1470380723,1470380787,64
1361049004,1470385652,2,104,52,1361048996893,1361048996893,1470378545,1470378545,0
1361049004,1470385652,3,150,50,1361048996893,1361048996957,1470378545,1470378609,64
1361049012,1470393592,6,1195,199.1666667,1361048997980,1361049008156,1470379572,1470389748,10176
1361049012,1470393592,4,934,233.5,1361048998298,1361049008346,1470379890,1470389938,10048
1361049012,1470393592,4,646,161.5,1361048998489,1361049008537,1470380081,1470390129,10048
1361049012,1470393636,4,655,163.75,1361048998189,1361049008173,1470379825,1470389809,9984
1361049019,108713684,1,52,52,1361048992372,1361048992372,108687056,108687056,0
1361049019,108713684,6,4452,742,1361048992439,1361048992439,108687123,108687123,0
1361049019,108713732,7,4559,651.2857143,1361048992390,1361048992454,108687122,108687186,64
1361049019,108713732,1,52,52,1361048992324,1361048992324,108687056,108687056,0
1361049019,108713732,5,3897,779.4,1361048992388,1361048992388,108687120,108687120,0
1361049020,1470401656,6,1414,235.6666667,1361048998297,1361049013401,1470379953,1470395057,15104
1361049020,1470401692,6,780,130,1361049015992,1361049016184,1470397684,1470397876,192
1361049020,1470401692,6,654,109,1361049015991,1361049016119,1470397683,1470397811,128
1361049020,1470401704,9,7506,834,1361048998059,1361049018667,1470379763,1470400371,20608
1361049020,1470401704,79,73789,934.0379747,1361049014442,1361049015978,1470396146,1470397682,1536
1361049020,1470401704,338,477634,1413.118343,1361048998633,1361049019241,1470380337,1470400945,20608
1361049022,1470402952,6,1466,244.3333333,1361048997593,1361048997913,1470378545,1470378865,320
1361049023,108717692,13,5767,443.6153846,1361048997932,1361049016044,108692624,108710736,18112
1361049023,108717700,5,1166,233.2,1361048998374,1361049016038,108693074,108710738,17664
1361049023,108717752,3,1320,440,1361048997682,1361048998130,108692434,108692882,448
1361049023,108717752,1,52,52,1361048997872,1361048997872,108692624,108692624,0
1361049023,108717756,1,52,52,1361048998190,1361048998190,108692946,108692946,0
1361049023,108717788,3,1302,434,1361048997646,1361048998030,108692434,108692818,384
1361049023,108717788,3,1073,357.6666667,1361048997646,1361048997902,108692434,108692690,256
1361049023,108717788,1,52,52,1361048997837,1361048997837,108692625,108692625,0
1361049023,108717788,1,52,52,1361048998156,1361048998156,108692944,108692944,0
1361049023,108717788,34,44011,1294.441176,1361048998283,1361048998411,108693071,108693199,128
1361049025,1470406872,6,3657,609.5,1361048996995,1361048997123,1470378867,1470378995,128
1361049025,1470406876,13,9597,738.2307692,1361048997436,1361048998716,1470379312,1470380592,1280
1361049025,1470406880,1,52,52,1361048997690,1361048997690,1470379570,1470379570,0
1361049025,1470406880,4,1418,354.5,1361048997689,1361048998777,1470379569,1470380657,1088
1361049025,1470406884,6,3400,566.6666667,1361048997879,1361048997943,1470379763,1470379827,64
1361049025,1470406884,1,52,52,1361048997879,1361048997879,1470379763,1470379763,0
1361049025,1470406888,1,46,46,1361048998196,1361048998196,1470380084,1470380084,0
1361049025,1470406888,3,2484,828,1361048998259,1361048998387,1470380147,1470380275,128
1361049025,1470406888,1,46,46,1361048998449,1361048998449,1470380337,1470380337,0
1361049025,1470406908,4,318,79.5,1361048998494,1361048998750,1470380402,1470380658,256
1361049025,1470406916,1,52,52,1361048999060,1361048999060,1470380976,1470380976,0
1361049025,1470406916,29,31103,1072.517241,1361048999060,1361049000148,1470380976,1470382064,1088
1361049025,1470406916,4,1966,491.5,1361048999190,1361048999254,1470381106,1470381170,64
1361049026,1470406972,1,52,52,1361048997896,1361048997896,1470378868,1470378868,0
1361049026,1470406972,3,540,180,1361048997896,1361048997960,1470378868,1470378932,64
1361049026,1470406972,1,52,52,1361048997896,1361048997896,1470378868,1470378868,0
1361049026,1470406976,6,4871,811.8333333,1361048998337,1361048998529,1470379313,1470379505,192
1361049026,1470406980,1,52,52,1361048998591,1361048998591,1470379571,1470379571,0
1361049026,1470406980,3,765,255,1361048998655,1361048998655,1470379635,1470379635,0
1361049026,1470406980,16,14426,901.625,1361048998717,1361048998973,1470379697,1470379953,256
1361049026,1470406980,1,52,52,1361048998780,1361048998780,1470379760,1470379760,0
1361049026,1470406980,21,22660,1079.047619,1361048998844,1361048999676,1470379824,1470380656,832
1361049026,1470406980,1,52,52,1361048998908,1361048998908,1470379888,1470379888,0
1361049026,1470406984,4,1013,253.25,1361048998907,1361048999419,1470379891,1470380403,512
1361049026,1470407016,1,52,52,1361048999963,1361048999963,1470380979,1470380979,0
1361049026,1470407016,17,15455,909.1176471,1361048999963,1361049001051,1470380979,1470382067,1088
1361049028,1470409648,6,3446,574.3333333,1361049020001,1361049020065,1470401649,1470401713,64
1361049028,1470409648,11,10689,971.7272727,1361049020001,1361049020065,1470401649,1470401713,64
1361049028,1470409648,5,2582,516.4,1361049020001,1361049020065,1470401649,1470401713,64
1361049028,1470409648,5,2713,542.6,1361049020001,1361049020065,1470401649,1470401713,64
1361049028,1470409648,5,2882,576.4,1361049020001,1361049020065,1470401649,1470401713,64
1361049028,1470409648,6,3300,550,1361049020001,1361049020065,1470401649,1470401713,64
1361049028,1470409648,5,2361,472.2,1361049020001,1361049020065,1470401649,1470401713,64
1361049028,1470409648,7,4612,658.8571429,1361049020001,1361049020065,1470401649,1470401713,64
1361049028,1470409648,11,10649,968.0909091,1361049020001,1361049020065,1470401649,1470401713,64
1361049028,1470409648,4,431,107.75,1361049020000,1361049020128,1470401648,1470401776,128
1361049028,1470409648,17,18875,1110.294118,1361049020000,1361049020128,1470401648,1470401776,128
1361049028,1470409652,12,11907,992.25,1361049020127,1361049024543,1470401779,1470406195,4416
1361049028,1470409652,29,36235,1249.482759,1361049020317,1361049024541,1470401969,1470406193,4224
1361049028,1470409664,16,7165,447.8125,1361049023186,1361049023442,1470404850,1470405106,256
1361049028,1470409664,19,18145,955,1361049018705,1361049019985,1470400369,1470401649,1280
1361049028,1470409664,7,5168,738.2857143,1361049023377,1361049024529,1470405041,1470406193,1152
1361049028,1470409688,22,26999,1227.227273,1361049019259,1361049019963,1470400947,1470401651,704
1361049028,1470409688,9,7668,852,1361049015931,1361049025979,1470397619,1470407667,10048
1361049028,1470409688,5,2005,401,1361049015931,1361049025979,1470397619,1470407667,10048
1361049028,1470409688,5,2749,549.8,1361049015931,1361049025979,1470397619,1470407667,10048
1361049028,1470409688,17,18409,1082.882353,1361049019450,1361049019962,1470401138,1470401650,512
1361049028,1470409688,4,694,173.5,1361049024186,1361049024506,1470405874,1470406194,320
1361049028,1470409688,7,4516,645.1428571,1361049019577,1361049019961,1470401265,1470401649,384
1361049028,1470409688,4,694,173.5,1361049024505,1361049024505,1470406193,1470406193,0
1361049028,1470409692,7,4691,670.1428571,1361049019572,1361049019956,1470401264,1470401648,384
1361049028,1470409692,5,2525,505,1361049019576,1361049019960,1470401268,1470401652,384
1361049028,1470409692,5,1248,249.6,1361049025015,1361049025079,1470406707,1470406771,64
1361049028,1470409692,6,3517,586.1666667,1361049019958,1361049020022,1470401650,1470401714,64
1361049028,1470409692,5,2229,445.8,1361049019958,1361049020022,1470401650,1470401714,64
1361049028,1470409692,30,38560,1285.333333,1361049019957,1361049020085,1470401649,1470401777,128
1361049028,1470409692,15,17117,1141.133333,1361049019957,1361049020021,1470401649,1470401713,64
1361049028,1470409692,6,3607,601.1666667,1361049019957,1361049020021,1470401649,1470401713,64
1361049028,1470409692,7,5392,770.2857143,1361049019957,1361049020021,1470401649,1470401713,64
1361049028,1470409692,12,12803,1066.916667,1361049019957,1361049020021,1470401649,1470401713,64
1361049028,1470409692,13,14067,1082.076923,1361049019956,1361049020020,1470401648,1470401712,64
1361049028,1470409692,7,5276,753.7142857,1361049019956,1361049020020,1470401648,1470401712,64
1361049028,1470409692,7,5449,778.4285714,1361049019956,1361049020020,1470401648,1470401712,64
1361049028,1470409696,16,18604,1162.75,1361049020019,1361049020083,1470401715,1470401779,64
1361049028,1470409696,212,297500,1403.301887,1361049020273,1361049024497,1470401969,1470406193,4224
1361049028,1470409728,9,5812,645.7777778,1361049023313,1361049024465,1470405041,1470406193,1152
1361049028,1470409732,211,296610,1405.734597,1361049023436,1361049024460,1470405168,1470406192,1024
1361049028,1470409732,12,12283,1023.583333,1361049019214,1361049019918,1470400946,1470401650,704
1361049028,1470409732,64,86942,1358.46875,1361049019214,1361049019918,1470400946,1470401650,704
1361049028,1470409732,34,42399,1247.029412,1361049015886,1361049026510,1470397618,1470408242,10624
1361049028,1470409732,70,91321,1304.585714,1361049019213,1361049019917,1470400945,1470401649,704
1361049028,1470409736,10,8956,895.6,1361049019532,1361049019916,1470401268,1470401652,384
1361049028,1470409736,27,23331,864.1111111,1361049019532,1361049019916,1470401268,1470401652,384
1361049028,1470409736,19,20993,1104.894737,1361049016587,1361049019915,1470398323,1470401651,3328
1361049028,1470409736,13,14149,1088.384615,1361049019722,1361049019914,1470401458,1470401650,192
1361049028,1470409736,4,694,173.5,1361049024458,1361049024458,1470406194,1470406194,0
1361049042,1470422932,9,2674,297.1111111,1361049017261,1361049038701,1470398193,1470419633,21440
1361049042,1470423040,4,1052,263,1361049017217,1361049017281,1470398257,1470398321,64
1361049043,108737684,4,1157,289.25,1361049016053,1361049016117,108710737,108710801,64
1361049044,1470425672,10,8847,884.7,1361049038795,1361049038859,1470420467,1470420531,64
1361049044,1470425672,4,431,107.75,1361049038858,1361049038986,1470420530,1470420658,128
1361049044,1470425700,43,56129,1305.325581,1361049024557,1361049038829,1470406257,1470420529,14272
1361049044,1470425700,29,36144,1246.344828,1361049024492,1361049038828,1470406192,1470420528,14336
1361049044,1470425704,36,44914,1247.611111,1361049020073,1361049038825,1470401777,1470420529,18752
1361049044,1470425708,15,6830,455.3333333,1361049020263,1361049037927,1470401971,1470419635,17664
1361049044,1470425712,9,8676,964,1361049038754,1361049038818,1470420466,1470420530,64
1361049044,1470425752,29,31669,1092.034483,1361049024443,1361049038779,1470406195,1470420531,14336
1361049045,1470426852,49,63590,1297.755102,1361049024407,1361049038679,1470406259,1470420531,14272
1361049045,1470426852,25,30579,1223.16,1361049024855,1361049038679,1470406707,1470420531,13824
1361049046,1470426940,4,2606,651.5,1361049021030,1361049021094,1470401970,1470402034,64
1361049049,1470430864,9,8742,971.3333333,1361049021321,1361049021321,1470403185,1470403185,0
1361049049,1470430864,8,8223,1027.875,1361049021321,1361049021321,1470403185,1470403185,0
1361049050,1470430948,8,7375,921.875,1361049022238,1361049022238,1470403186,1470403186,0
1361049050,1470430948,8,7824,978,1361049022237,1361049022237,1470403185,1470403185,0
1361049050,1470431028,14,16635,1188.214286,1361049025164,1361049025228,1470406192,1470406256,64
1361049050,1470431028,21,26556,1264.571429,1361049025167,1361049025231,1470406195,1470406259,64
1361049054,1470434972,7,1196,170.8571429,1361049026054,1361049036166,1470407026,1470417138,10112
1361049054,1470435048,1,46,46,1361049027707,1361049027707,1470408755,1470408755,0
1361049060,1470441680,8,6013,751.625,1361049057600,1361049057792,1470439280,1470439472,192
1361049060,1470441716,5,1716,343.2,1361049059037,1361049059165,1470440753,1470440881,128
1361049060,1470441732,3,760,253.3333333,1361049057741,1361049057869,1470439473,1470439601,128
1361049060,1470441736,8,6149,768.625,1361049057931,1361049058123,1470439667,1470439859,192
1361049060,1470441736,5,662,132.4,1361049057931,1361049058059,1470439667,1470439795,128
1361049060,1470441736,6,810,135,1361049057994,1361049058186,1470439730,1470439922,192
1361049063,108757740,4,1125,281.25,1361049062204,1361049062588,108756944,108757328,384
1361049063,108757744,8,6651,831.375,1361049062395,1361049062587,108757139,108757331,192
1361049063,108757744,7,2766,395.1428571,1361049062395,1361049062587,108757139,108757331,192
1361049063,108757744,8,6148,768.5,1361049062459,1361049062587,108757203,108757331,128
1361049063,108757744,50,65854,1317.08,1361049062587,1361049062715,108757331,108757459,128
1361049063,108757748,5,1822,364.4,1361049062068,1361049062580,108756816,108757328,512
1361049063,108757748,4,1248,312,1361049062196,1361049062580,108756944,108757328,384
1361049063,108757748,4,1372,343,1361049062196,1361049062580,108756944,108757328,384
1361049063,108757748,5,1238,247.6,1361049062455,1361049062583,108757203,108757331,128
1361049063,108757748,8,6148,768.5,1361049062455,1361049062583,108757203,108757331,128
1361049065,1470446920,1,52,52,1361049037779,1361049037779,1470419699,1470419699,0
1361049066,1470446924,11,12773,1161.181818,1361049039604,1361049039604,1470420528,1470420528,0
1361049066,1470446948,3,304,101.3333333,1361049039772,1361049039836,1470420720,1470420784,64
1361049066,1470447032,4,2275,568.75,1361049039498,1361049039498,1470420530,1470420530,0
1361049068,1470449708,4,574,143.5,1361049061222,1361049061670,1470442930,1470443378,448
1361049068,1470449708,19,22245,1170.789474,1361049061285,1361049061669,1470442993,1470443377,384
1361049068,1470449708,2,141,70.5,1361049057252,1361049062244,1470438960,1470443952,4992
1361049068,1470449712,26,30935,1189.807692,1361049061539,1361049061667,1470443251,1470443379,128
1361049068,1470449712,40,48773,1219.325,1361049061539,1361049061667,1470443251,1470443379,128
1361049068,1470449712,12,12684,1057,1361049061539,1361049061667,1470443251,1470443379,128
1361049068,1470449712,19,22586,1188.736842,1361049061539,1361049061667,1470443251,1470443379,128
1361049068,1470449712,37,45932,1241.405405,1361049061603,1361049062051,1470443315,1470443763,448
1361049068,1470449712,15,17169,1144.6,1361049061602,1361049061666,1470443314,1470443378,64
1361049068,1470449712,23,26978,1172.956522,1361049061602,1361049061666,1470443314,1470443378,64
1361049068,1470449712,23,26544,1154.086957,1361049061602,1361049061666,1470443314,1470443378,64
1361049068,1470449712,22,24415,1109.772727,1361049061602,1361049061666,1470443314,1470443378,64
1361049068,1470449712,9,7368,818.6666667,1361049065442,1361049065506,1470447154,1470447218,64
1361049068,1470449712,54,70209,1300.166667,1361049061538,1361049061666,1470443250,1470443378,128
1361049068,1470449712,23,27797,1208.565217,1361049061538,1361049061666,1470443250,1470443378,128
1361049068,1470449712,5,2948,589.6,1361049061538,1361049062562,1470443250,1470444274,1024
1361049068,1470449712,409,577727,1412.535452,1361049061602,1361049064802,1470443314,1470446514,3200
1361049068,1470449712,7,4478,639.7142857,1361049061602,1361049061666,1470443314,1470443378,64
1361049068,1470449712,40,48620,1215.5,1361049061602,1361049062498,1470443314,1470444210,896
1361049068,1470449712,21,23492,1118.666667,1361049061602,1361049061666,1470443314,1470443378,64
1361049068,1470449712,18,21198,1177.666667,1361049061666,1361049061730,1470443378,1470443442,64
1361049068,1470449712,125,168925,1351.4,1361049061666,1361049062754,1470443378,1470444466,1088
1361049068,1470449712,106,137382,1296.056604,1361049061666,1361049062626,1470443378,1470444338,960
1361049068,1470449712,24,28120,1171.666667,1361049061665,1361049062497,1470443377,1470444209,832
1361049068,1470449712,97,126792,1307.134021,1361049061665,1361049063137,1470443377,1470444849,1472
1361049068,1470449712,43,52468,1220.186047,1361049061665,1361049062497,1470443377,1470444209,832
1361049068,1470449712,112,143674,1282.803571,1361049061665,1361049062689,1470443377,1470444401,1024
1361049068,1470449712,107,143876,1344.635514,1361049061665,1361049062561,1470443377,1470444273,896
1361049068,1470449712,96,128278,1336.229167,1361049061665,1361049062433,1470443377,1470444145,768
1361049068,1470449712,121,154434,1276.31405,1361049061665,1361049062945,1470443377,1470444657,1280
1361049068,1470449712,6,3493,582.1666667,1361049061793,1361049062433,1470443505,1470444145,640
1361049068,1470449712,5,2506,501.2,1361049057568,1361049067168,1470439280,1470448880,9600
1361049068,1470449716,9,8058,895.3333333,1361049061979,1361049062427,1470443695,1470444143,448
1361049068,1470449716,4,592,148,1361049060446,1361049061662,1470442162,1470443378,1216
1361049068,1470449716,7,4910,701.4285714,1361049062046,1361049062494,1470443762,1470444210,448
1361049068,1470449716,4,592,148,1361049060446,1361049061662,1470442162,1470443378,1216
1361049068,1470449716,5,3611,722.2,1361049062301,1361049062429,1470444017,1470444145,128
1361049068,1470449716,5,1940,388,1361049062301,1361049062365,1470444017,1470444081,64
1361049068,1470449716,4,654,163.5,1361049062364,1361049062492,1470444080,1470444208,128
1361049068,1470449716,5,1940,388,1361049062300,1361049062364,1470444016,1470444080,64
1361049068,1470449716,4,1205,301.25,1361049062492,1361049062556,1470444208,1470444272,64
1361049068,1470449720,5,2061,412.2,1361049062296,1361049062360,1470444016,1470444080,64
1361049068,1470449720,4,661,165.25,1361049062363,1361049062491,1470444083,1470444211,128
1361049068,1470449720,4,817,204.25,1361049062363,1361049062427,1470444083,1470444147,64
1361049068,1470449720,7,1880,268.5714286,1361049062619,1361049062747,1470444339,1470444467,128
1361049068,1470449720,4,653,163.25,1361049062426,1361049062554,1470444146,1470444274,128
1361049068,1470449720,6,2969,494.8333333,1361049062554,1361049062746,1470444274,1470444466,192
1361049068,1470449720,5,455,91,1361049062681,1361049063065,1470444401,1470444785,384
1361049068,1470449756,62,82353,1328.274194,1361049056949,1361049061621,1470438705,1470443377,4672
1361049068,1470449756,22,25372,1153.272727,1361049056949,1361049061621,1470438705,1470443377,4672
1361049068,1470449756,13,12918,993.6923077,1361049065140,1361049065524,1470446896,1470447280,384
1361049068,1470449760,123,167145,1358.902439,1361049061298,1361049061618,1470443058,1470443378,320
1361049068,1470449760,34,43559,1281.147059,1361049061489,1361049061617,1470443249,1470443377,128
1361049068,1470449760,12,11712,976,1361049061489,1361049061617,1470443249,1470443377,128
1361049068,1470449760,6,3008,501.3333333,1361049065393,1361049065969,1470447153,1470447729,576
1361049068,1470449760,14,14637,1045.5,1361049061553,1361049061617,1470443313,1470443377,64
1361049068,1470449760,81,109682,1354.098765,1361049061553,1361049061681,1470443313,1470443441,128
1361049068,1470449760,6,2078,346.3333333,1361049065393,1361049066545,1470447153,1470448305,1152
1361049068,1470449760,8,1573,196.625,1361049061553,1361049061873,1470443313,1470443633,320
1361049068,1470449760,16,17407,1087.9375,1361049065393,1361049066673,1470447153,1470448433,1280
1361049068,1470449760,20,22332,1116.6,1361049061553,1361049061617,1470443313,1470443377,64
1361049068,1470449760,5,1351,270.2,1361049061553,1361049061617,1470443313,1470443377,64
1361049068,1470449760,9,7661,851.2222222,1361049065393,1361049065457,1470447153,1470447217,64
1361049068,1470449760,9,7334,814.8888889,1361049065393,1361049065457,1470447153,1470447217,64
1361049068,1470449760,43,51513,1197.976744,1361049061488,1361049061616,1470443248,1470443376,128
1361049068,1470449760,5,1100,220,1361049061488,1361049061616,1470443248,1470443376,128
1361049068,1470449760,49,63394,1293.755102,1361049061488,1361049061616,1470443248,1470443376,128
1361049068,1470449760,55,72464,1317.527273,1361049061488,1361049061680,1470443248,1470443440,192
1361049068,1470449760,537,760798,1416.756052,1361049061552,1361049065776,1470443312,1470447536,4224
1361049068,1470449760,9,6392,710.2222222,1361049065520,1361049066672,1470447280,1470448432,1152
1361049068,1470449760,7,4379,625.5714286,1361049061552,1361049061616,1470443312,1470443376,64
1361049068,1470449760,160,215114,1344.4625,1361049061616,1361049062640,1470443376,1470444400,1024
1361049068,1470449760,17,17009,1000.529412,1361049060208,1361049061616,1470441968,1470443376,1408
1361049068,1470449764,87,114438,1315.37931,1361049061612,1361049063404,1470443376,1470445168,1792
1361049068,1470449764,100,134132,1341.32,1361049061612,1361049062444,1470443376,1470444208,832
1361049068,1470449764,23,26322,1144.434783,1361049061676,1361049062444,1470443440,1470444208,768
1361049068,1470449764,135,179619,1330.511111,1361049061675,1361049063659,1470443439,1470445423,1984
1361049068,1470449764,107,143589,1341.953271,1361049061615,1361049062511,1470443379,1470444275,896
1361049068,1470449764,3,608,202.6666667,1361049061615,1361049061679,1470443379,1470443443,64
1361049068,1470449764,45,54069,1201.533333,1361049061615,1361049062447,1470443379,1470444211,832
1361049068,1470449764,36,44216,1228.222222,1361049061615,1361049062447,1470443379,1470444211,832
1361049068,1470449764,50,62213,1244.26,1361049061806,1361049065326,1470443570,1470447090,3520
1361049068,1470449784,62,81783,1319.080645,1361049061915,1361049062427,1470443699,1470444211,512
1361049068,1470449784,6,4404,734,1361049061915,1361049062363,1470443699,1470444147,448
1361049068,1470449784,4,592,148,1361049060378,1361049061594,1470442162,1470443378,1216
1361049068,1470449784,4,592,148,1361049060378,1361049061594,1470442162,1470443378,1216
1361049068,1470449784,7,4917,702.4285714,1361049061977,1361049062425,1470443761,1470444209,448
1361049068,1470449788,5,3618,723.6,1361049062163,1361049062355,1470443951,1470444143,192
1361049068,1470449788,5,2061,412.2,1361049062231,1361049062359,1470444019,1470444147,128
1361049068,1470449788,4,817,204.25,1361049062294,1361049062358,1470444082,1470444146,64
1361049068,1470449788,4,1428,357,1361049062422,1361049062486,1470444210,1470444274,64
1361049068,1470449788,6,2620,436.6666667,1361049062421,1361049062549,1470444209,1470444337,128
1361049068,1470449788,4,1205,301.25,1361049062421,1361049062485,1470444209,1470444273,64
1361049068,1470449788,4,1205,301.25,1361049062611,1361049062675,1470444399,1470444463,64
1361049068,1470449788,5,455,91,1361049062611,1361049062995,1470444399,1470444783,384
1361049068,1470449792,25,29863,1194.52,1361049062993,1361049066129,1470444785,1470447921,3136
1361049071,108765640,9,7656,850.6666667,1361049065697,1361049065761,108760337,108760401,64
1361049076,1470457696,6,3540,590,1361049073074,1361049073266,1470454770,1470454962,192
1361049076,1470457696,13,3879,298.3846154,1361049073138,1361049073458,1470454834,1470455154,320
1361049076,1470457696,7,2519,359.8571429,1361049073201,1361049073329,1470454897,1470455025,128
1361049076,1470457696,6,1741,290.1666667,1361049073201,1361049073585,1470454897,1470455281,384
1361049076,1470457700,4,768,192,1361049073259,1361049073515,1470454959,1470455215,256
1361049076,1470457700,6,1471,245.1666667,1361049073327,1361049073711,1470455027,1470455411,384
1361049076,1470457700,6,1519,253.1666667,1361049073327,1361049073711,1470455027,1470455411,384
1361049076,1470457700,4,413,103.25,1361049073390,1361049073454,1470455090,1470455154,64
1361049076,1470457700,126,174270,1383.095238,1361049065454,1361049070958,1470447154,1470452658,5504
1361049076,1470457700,6,1565,260.8333333,1361049073580,1361049073964,1470455280,1470455664,384
1361049076,1470457700,17,18286,1075.647059,1361049073644,1361049074220,1470455344,1470455920,576
1361049076,1470457704,116,157405,1356.939655,1361049020263,1361049072999,1470401967,1470454703,52736
1361049076,1470457704,10,6434,643.4,1361049073707,1361049074027,1470455411,1470455731,320
1361049076,1470457704,18,20314,1128.555556,1361049073833,1361049074665,1470455537,1470456369,832
1361049076,1470457704,17,17929,1054.647059,1361049073960,1361049074536,1470455664,1470456240,576
1361049076,1470457708,12,9820,818.3333333,1361049074086,1361049074470,1470455794,1470456178,384
1361049076,1470457712,5,1085,217,1361049062755,1361049073571,1470444467,1470455283,10816
1361049076,1470457712,18,20160,1120,1361049070946,1361049071650,1470452658,1470453362,704
1361049076,1470457712,5,2509,501.8,1361049071712,1361049071776,1470453424,1470453488,64
1361049076,1470457712,6,1370,228.3333333,1361049059168,1361049074272,1470440880,1470455984,15104
1361049076,1470457712,4,1495,373.75,1361049071712,1361049071776,1470453424,1470453488,64
1361049076,1470457712,17,12640,743.5294118,1361049071840,1361049072096,1470453552,1470453808,256
1361049076,1470457732,4,876,219,1361049071883,1361049072075,1470453615,1470453807,192
1361049076,1470457732,42,54746,1303.47619,1361049071691,1361049073099,1470453423,1470454831,1408
1361049076,1470457732,6,2516,419.3333333,1361049072011,1361049072331,1470453743,1470454063,320
1361049076,1470457736,15,13458,897.2,1361049071755,1361049072267,1470453491,1470454003,512
1361049076,1470457736,4,611,152.75,1361049071755,1361049072075,1470453491,1470453811,320
1361049076,1470457736,16,16585,1036.5625,1361049071819,1361049072395,1470453555,1470454131,576
1361049076,1470457736,6,1631,271.8333333,1361049071819,1361049072203,1470453555,1470453939,384
1361049076,1470457736,6,1649,274.8333333,1361049072265,1361049072649,1470454001,1470454385,384
1361049076,1470457736,6,1631,271.8333333,1361049072520,1361049072904,1470454256,1470454640,384
1361049076,1470457736,4,2007,501.75,1361049072584,1361049072712,1470454320,1470454448,128
1361049076,1470457740,4,606,151.5,1361049072323,1361049072579,1470454063,1470454319,256
1361049076,1470457740,3,900,300,1361049072711,1361049072839,1470454451,1470454579,128
1361049076,1470457740,4,466,116.5,1361049072838,1361049073222,1470454578,1470454962,384
1361049076,1470457740,6,1447,241.1666667,1361049072518,1361049072902,1470454258,1470454642,384
1361049076,1470457740,6,1485,247.5,1361049072518,1361049072902,1470454258,1470454642,384
1361049076,1470457740,6,1405,234.1666667,1361049072902,1361049073286,1470454642,1470455026,384
1361049076,1470457740,7,2484,354.8571429,1361049072646,1361049072838,1470454386,1470454578,192
1361049076,1470457740,4,2445,611.25,1361049072774,1361049072838,1470454514,1470454578,64
1361049076,1470457740,6,1515,252.5,1361049072901,1361049073285,1470454641,1470455025,384
1361049076,1470457740,6,1519,253.1666667,1361049073092,1361049073476,1470454832,1470455216,384
1361049076,1470457744,20,23586,1179.3,1361049073151,1361049073919,1470454895,1470455663,768
1361049076,1470457744,6,1445,240.8333333,1361049073218,1361049073602,1470454962,1470455346,384
1361049076,1470457744,6,1567,261.1666667,1361049073281,1361049073665,1470455025,1470455409,384
1361049076,1470457748,6,1413,235.5,1361049073471,1361049073791,1470455219,1470455539,320
1361049076,1470457748,10,6286,628.6,1361049073662,1361049074046,1470455410,1470455794,384
1361049076,1470457748,17,21123,1242.529412,1361049073916,1361049073980,1470455664,1470455728,64
1361049076,1470457752,10,8336,833.6,1361049073978,1361049074362,1470455730,1470456114,384
1361049076,1470457752,8,4906,613.25,1361049074169,1361049074553,1470455921,1470456305,384
1361049076,1470457776,27,31887,1181,1361049074465,1361049075553,1470456241,1470457329,1088
1361049076,1470457776,38,50106,1318.578947,1361049074337,1361049075809,1470456113,1470457585,1472
1361049076,1470457776,6,2687,447.8333333,1361049062880,1361049068896,1470444656,1470450672,6016
1361049076,1470457780,15,15994,1066.266667,1361049074590,1361049075166,1470456370,1470456946,576
1361049076,1470457780,4,479,119.75,1361049071645,1361049071709,1470453425,1470453489,64
1361049076,1470457780,6,1381,230.1666667,1361049071708,1361049072092,1470453488,1470453872,384
1361049076,1470457780,24,27776,1157.333333,1361049071708,1361049072732,1470453488,1470454512,1024
1361049076,1470457780,8,5293,661.625,1361049071772,1361049072092,1470453552,1470453872,320
1361049076,1470457784,3,168,56,1361049071579,1361049071643,1470453363,1470453427,64
1361049076,1470457784,20,11272,563.6,1361049071643,1361049071771,1470453427,1470453555,128
1361049076,1470457784,6,1525,254.1666667,1361049072154,1361049072474,1470453938,1470454258,320
1361049076,1470457788,6,1479,246.5,1361049072083,1361049072467,1470453871,1470454255,384
1361049076,1470457788,6,1289,214.8333333,1361049072151,1361049072471,1470453939,1470454259,320
1361049076,1470457788,5,2620,524,1361049072599,1361049072663,1470454387,1470454451,64
1361049076,1470457788,6,1725,287.5,1361049072599,1361049072983,1470454387,1470454771,384
1361049076,1470457788,15,3279,218.6,1361049072726,1361049073174,1470454514,1470454962,448
1361049076,1470457788,4,680,170,1361049072278,1361049072342,1470454066,1470454130,64
1361049076,1470457788,7,2688,384,1361049072726,1361049073238,1470454514,1470455026,512
1361049076,1470457788,4,950,237.5,1361049072726,1361049073174,1470454514,1470454962,448
1361049076,1470457788,6,1381,230.1666667,1361049072726,1361049073174,1470454514,1470454962,448
1361049076,1470457788,6,2277,379.5,1361049072342,1361049072470,1470454130,1470454258,128
1361049076,1470457788,6,1727,287.8333333,1361049072341,1361049072725,1470454129,1470454513,384
1361049076,1470457788,6,1919,319.8333333,1361049072853,1361049073173,1470454641,1470454961,320
1361049076,1470457788,4,986,246.5,1361049072469,1361049072533,1470454257,1470454321,64
1361049076,1470457788,4,884,221,1361049072661,1361049072725,1470454449,1470454513,64
1361049076,1470457788,6,1381,230.1666667,1361049072725,1361049073109,1470454513,1470454897,384
1361049076,1470457788,3,443,147.6666667,1361049072788,1361049073236,1470454576,1470455024,448
1361049076,1470457788,6,1543,257.1666667,1361049072852,1361049073236,1470454640,1470455024,384
1361049076,1470457788,4,575,143.75,1361049072916,1361049073172,1470454704,1470454960,256
1361049075,108769808,5,1221,244.2,1361049062777,1361049078585,108757585,108773393,15808
1361049079,108773636,4,1021,255.25,1361049072933,1361049073061,108767569,108767697,128
1361049079,108773636,42,52771,1256.452381,1361049073125,1361049073509,108767761,108768145,384
1361049079,108773640,8,2472,309,1361049062819,1361049078755,108757459,108773395,15936
1361049079,108773684,4,921,230.25,1361049062901,1361049078709,108757585,108773393,15808
1361049079,108773708,11,10406,946,1361049071965,1361049072221,108766673,108766929,256
1361049081,1470462908,8,3773,471.625,1361049054239,1361049055967,1470436147,1470437875,1728
1361049082,1470462936,10,5783,578.3,1361049055849,1361049080297,1470436785,1470461233,24448
1361049082,1470462936,8,3566,445.75,1361049055849,1361049080297,1470436785,1470461233,24448
1361049082,1470462936,13,9478,729.0769231,1361049055849,1361049080297,1470436785,1470461233,24448
1361049082,1470462948,1,46,46,1361049057117,1361049057117,1470438065,1470438065,0
1361049082,1470462948,3,418,139.3333333,1361049057308,1361049057372,1470438256,1470438320,64
1361049082,1470462984,88,116549,1324.420455,1361049057721,1361049058809,1470438705,1470439793,1088
1361049082,1470463004,30,27758,925.2666667,1361049055399,1361049055783,1470436403,1470436787,384
1361049082,1470463028,28,27978,999.2142857,1361049055756,1361049080204,1470436784,1470461232,24448
1361049082,1470463028,9,4605,511.6666667,1361049055756,1361049080204,1470436784,1470461232,24448
1361049082,1470463028,8,3630,453.75,1361049055756,1361049080204,1470436784,1470461232,24448
1361049082,1470463032,18,18726,1040.333333,1361049056137,1361049056777,1470437169,1470437809,640
1361049082,1470463068,2,574,287,1361049057699,1361049057763,1470438767,1470438831,64
1361049083,108778020,11,10406,946,1361049058404,1361049079204,108753424,108774224,20800
1361049084,1470465700,11,4078,370.7272727,1361049073323,1361049080619,1470455023,1470462319,7296
1361049084,1470465704,3,930,310,1361049077610,1361049077610,1470459314,1470459314,0
1361049084,1470465704,3,1086,362,1361049077609,1361049077673,1470459313,1470459377,64
1361049084,1470465704,7,3422,488.8571429,1361049077736,1361049077992,1470459440,1470459696,256
1361049084,1470465704,16,17182,1073.875,1361049077863,1361049077927,1470459567,1470459631,64
1361049084,1470465704,7,4213,601.8571429,1361049076391,1361049076583,1470458095,1470458287,192
1361049084,1470465708,28,34966,1248.785714,1361049077927,1361049078567,1470459635,1470460275,640
1361049084,1470465708,10,7959,795.9,1361049077990,1361049078118,1470459698,1470459826,128
1361049084,1470465708,5,2808,561.6,1361049078117,1361049079461,1470459825,1470461169,1344
1361049084,1470465712,21,15220,724.7619048,1361049057951,1361049078943,1470439663,1470460655,20992
1361049084,1470465712,47,61950,1318.085106,1361049057951,1361049079007,1470439663,1470460719,21056
1361049084,1470465712,8,5772,721.5,1361049076575,1361049076703,1470458287,1470458415,128
1361049084,1470465712,8,3010,376.25,1361049078434,1361049079458,1470460146,1470461170,1024
1361049084,1470465712,3,581,193.6666667,1361049078498,1361049078626,1470460210,1470460338,128
1361049084,1470465712,8,4794,599.25,1361049076578,1361049076706,1470458290,1470458418,128
1361049084,1470465712,12,12684,1057,1361049078562,1361049078562,1470460274,1470460274,0
1361049084,1470465712,16,16581,1036.3125,1361049078562,1361049078754,1470460274,1470460466,192
1361049084,1470465712,70,93224,1331.771429,1361049078562,1361049078818,1470460274,1470460530,256
1361049084,1470465712,37,41206,1113.675676,1361049078562,1361049078882,1470460274,1470460594,320
1361049084,1470465712,16,17182,1073.875,1361049078562,1361049078626,1470460274,1470460338,64
1361049084,1470465712,14,12087,863.3571429,1361049078561,1361049078945,1470460273,1470460657,384
1361049084,1470465712,4,536,134,1361049078561,1361049078689,1470460273,1470460401,128
1361049084,1470465712,7,5123,731.8571429,1361049062497,1361049079905,1470444209,1470461617,17408
1361049084,1470465712,8,3497,437.125,1361049078625,1361049078689,1470460337,1470460401,64
1361049084,1470465712,14,9746,696.1428571,1361049062497,1361049079905,1470444209,1470461617,17408
1361049084,1470465712,7,2367,338.1428571,1361049078625,1361049078689,1470460337,1470460401,64
1361049084,1470465712,10,4460,446,1361049078625,1361049078817,1470460337,1470460529,192
1361049084,1470465712,32,40265,1258.28125,1361049078688,1361049078752,1470460400,1470460464,64
1361049084,1470465712,5,1882,376.4,1361049078624,1361049078752,1470460336,1470460464,128
1361049084,1470465712,4,543,135.75,1361049078688,1361049078816,1470460400,1470460528,128
1361049084,1470465712,5,1552,310.4,1361049076768,1361049076896,1470458480,1470458608,128
1361049084,1470465712,6,1774,295.6666667,1361049076768,1361049076896,1470458480,1470458608,128
1361049084,1470465712,4,679,169.75,1361049078752,1361049079456,1470460464,1470461168,704
1361049084,1470465712,18,21198,1177.666667,1361049078752,1361049078816,1470460464,1470460528,64
1361049084,1470465712,3,643,214.3333333,1361049078752,1361049078752,1470460464,1470460464,0
1361049084,1470465712,4,817,204.25,1361049062560,1361049079776,1470444272,1470461488,17216
1361049084,1470465716,7,2653,379,1361049078811,1361049078875,1470460527,1470460591,64
1361049084,1470465716,8,3319,414.875,1361049078811,1361049078875,1470460527,1470460591,64
1361049084,1470465716,47,61649,1311.680851,1361049078811,1361049079195,1470460527,1470460911,384
1361049084,1470465716,4,889,222.25,1361049078811,1361049079003,1470460527,1470460719,192
1361049084,1470465716,9,7415,823.8888889,1361049078811,1361049079003,1470460527,1470460719,192
1361049084,1470465716,6,4270,711.6666667,1361049078811,1361049079003,1470460527,1470460719,192
1361049084,1470465716,7,5123,731.8571429,1361049062491,1361049079899,1470444207,1470461615,17408
1361049084,1470465716,6,2279,379.8333333,1361049078811,1361049079003,1470460527,1470460719,192
1361049084,1470465716,443,596944,1347.503386,1361049062495,1361049081503,1470444211,1470463219,19008
1361049084,1470465716,9,7663,851.4444444,1361049078879,1361049078879,1470460595,1470460595,0
1361049084,1470465716,5,1273,254.6,1361049076767,1361049076895,1470458483,1470458611,128
1361049084,1470465716,422,563879,1336.206161,1361049062686,1361049080606,1470444402,1470462322,17920
1361049084,1470465716,8,3153,394.125,1361049078878,1361049079006,1470460594,1470460722,128
1361049084,1470465716,16,12451,778.1875,1361049079005,1361049079069,1470460721,1470460785,64
1361049084,1470465716,4,934,233.5,1361049079005,1361049079069,1470460721,1470460785,64
1361049084,1470465716,5,674,134.8,1361049079005,1361049079069,1470460721,1470460785,64
1361049084,1470465716,10,9135,913.5,1361049079005,1361049079773,1470460721,1470461489,768
1361049084,1470465716,54,51776,958.8148148,1361049079005,1361049079965,1470460721,1470461681,960
1361049084,1470465716,47,61950,1318.085106,1361049079005,1361049079773,1470460721,1470461489,768
1361049084,1470465716,9,5042,560.2222222,1361049079005,1361049079773,1470460721,1470461489,768
1361049084,1470465716,82,81298,991.4390244,1361049079005,1361049080029,1470460721,1470461745,1024
1361049084,1470465716,103,101703,987.407767,1361049079005,1361049079837,1470460721,1470461553,832
1361049084,1470465716,7,1770,252.8571429,1361049076892,1361049077084,1470458608,1470458800,192
1361049084,1470465716,4,592,148,1361049079132,1361049079452,1470460848,1470461168,320
1361049084,1470465716,18,21423,1190.166667,1361049079132,1361049079452,1470460848,1470461168,320
1361049084,1470465716,2,104,52,1361049079196,1361049079196,1470460912,1470460912,0
1361049084,1470465716,27,29112,1078.222222,1361049079259,1361049079771,1470460975,1470461487,512
1361049084,1470465716,25,23428,937.12,1361049079323,1361049080347,1470461039,1470462063,1024
1361049084,1470465736,37,37381,1010.297297,1361049079243,1361049080139,1470460979,1470461875,896
1361049084,1470465736,30,36628,1220.933333,1361049079243,1361049080651,1470460979,1470462387,1408
1361049084,1470465736,14,10740,767.1428571,1361049079307,1361049079755,1470461043,1470461491,448
1361049084,1470465736,41,52818,1288.243902,1361049074506,1361049076042,1470456242,1470457778,1536
1361049084,1470465740,3,428,142.6666667,1361049079303,1361049079367,1470461043,1470461107,64
1361049084,1470465740,7,3187,455.2857143,1361049079430,1361049079686,1470461170,1470461426,256
1361049084,1470465740,5,2700,540,1361049079430,1361049079750,1470461170,1470461490,320
1361049084,1470465740,4,431,107.75,1361049079558,1361049079750,1470461298,1470461490,192
1361049084,1470465740,26,31945,1228.653846,1361049079558,1361049080518,1470461298,1470462258,960
1361049084,1470465740,4,431,107.75,1361049079494,1361049079750,1470461234,1470461490,256
1361049084,1470465740,4,632,158,1361049079493,1361049079749,1470461233,1470461489,256
1361049084,1470465740,581,803374,1382.743546,1361049063429,1361049082757,1470445169,1470464497,19328
1361049084,1470465740,8,1283,160.375,1361049079557,1361049079621,1470461297,1470461361,64
1361049084,1470465740,4,388,97,1361049079749,1361049080581,1470461489,1470462321,832
1361049084,1470465740,33,39107,1185.060606,1361049079621,1361049080581,1470461361,1470462321,960
1361049084,1470465740,10,4722,472.2,1361049079621,1361049080069,1470461361,1470461809,448
1361049084,1470465740,36,39135,1087.083333,1361049079813,1361049080965,1470461553,1470462705,1152
1361049084,1470465740,5,1961,392.2,1361049079877,1361049080005,1470461617,1470461745,128
1361049084,1470465740,14,9746,696.1428571,1361049079876,1361049080580,1470461616,1470462320,704
1361049084,1470465740,4,576,144,1361049079748,1361049079812,1470461488,1470461552,64
1361049084,1470465740,5,4239,847.8,1361049079748,1361049079876,1470461488,1470461616,128
1361049084,1470465740,21,16948,807.047619,1361049080003,1361049080643,1470461743,1470462383,640
1361049084,1470465744,5,1961,392.2,1361049079871,1361049079999,1470461615,1470461743,128
1361049084,1470465744,36,40100,1113.888889,1361049079939,1361049080963,1470461683,1470462707,1024
1361049084,1470465744,5,2876,575.2,1361049080067,1361049080643,1470461811,1470462387,576
1361049084,1470465744,474,629774,1328.637131,1361049063682,1361049081026,1470445426,1470462770,17344
1361049084,1470465744,12,10820,901.6666667,1361049063746,1361049080834,1470445490,1470462578,17088
1361049084,1470465744,7,5123,731.8571429,1361049080258,1361049080450,1470462002,1470462194,192
1361049084,1470465744,5,2039,407.8,1361049063746,1361049080834,1470445490,1470462578,17088
1361049084,1470465744,5,2942,588.4,1361049080193,1361049080449,1470461937,1470462193,256
1361049084,1470465744,17,15981,940.0588235,1361049080321,1361049080769,1470462065,1470462513,448
1361049084,1470465744,8,2857,357.125,1361049080321,1361049080449,1470462065,1470462193,128
1361049084,1470465744,4,800,200,1361049080385,1361049080449,1470462129,1470462193,64
1361049084,1470465744,5,2344,468.8,1361049080385,1361049080577,1470462129,1470462321,192
1361049084,1470465744,4,755,188.75,1361049080449,1361049080577,1470462193,1470462321,128
1361049084,1470465744,5,2178,435.6,1361049080513,1361049080577,1470462257,1470462321,64
1361049084,1470465744,5,2177,435.4,1361049080512,1361049080576,1470462256,1470462320,64
1361049084,1470465744,7,2165,309.2857143,1361049080576,1361049080640,1470462320,1470462384,64
1361049084,1470465744,5,1508,301.6,1361049080448,1361049080576,1470462192,1470462320,128
1361049084,1470465744,5,2182,436.4,1361049080512,1361049080576,1470462256,1470462320,64
1361049084,1470465748,5,1169,233.8,1361049080703,1361049080831,1470462451,1470462579,128
1361049084,1470465752,6,4369,728.1666667,1361049077498,1361049077562,1470459250,1470459314,64
1361049084,1470465752,3,983,327.6666667,1361049077625,1361049077689,1470459377,1470459441,64
1361049084,1470465752,3,1094,364.6666667,1361049077625,1361049077625,1470459377,1470459377,0
1361049084,1470465752,40,48590,1214.75,1361049077880,1361049078520,1470459632,1470460272,640
1361049084,1470465752,69,89454,1296.434783,1361049077880,1361049078520,1470459632,1470460272,640
1361049084,1470465752,91,124392,1366.945055,1361049073656,1361049078904,1470455408,1470460656,5248
1361049084,1470465756,6,4404,734,1361049078003,1361049079411,1470459759,1470461167,1408
1361049084,1470465756,5,594,118.8,1361049077942,1361049078006,1470459698,1470459762,64
1361049084,1470465780,23,27461,1193.956522,1361049057950,1361049078942,1470439730,1470460722,20992
1361049084,1470465780,7,5115,730.7142857,1361049078429,1361049078493,1470460209,1470460273,64
1361049084,1470465780,72,96419,1339.152778,1361049078493,1361049078749,1470460273,1470460529,256
1361049084,1470465780,13,10800,830.7692308,1361049078493,1361049078557,1470460273,1470460337,64
1361049084,1470465780,5,1446,289.2,1361049076508,1361049076636,1470458288,1470458416,128
1361049084,1470465780,38,43585,1146.973684,1361049058076,1361049078876,1470439856,1470460656,20800
1361049084,1470465780,28,35371,1263.25,1361049078428,1361049078556,1470460208,1470460336,128
1361049084,1470465780,15,9798,653.2,1361049062428,1361049079836,1470444208,1470461616,17408
1361049084,1470465780,33,42277,1281.121212,1361049078492,1361049078556,1470460272,1470460336,64
1361049084,1470465780,60,79643,1327.383333,1361049078492,1361049078812,1470460272,1470460592,320
1361049084,1470465780,8,2957,369.625,1361049078555,1361049078683,1470460335,1470460463,128
1361049084,1470465780,8,3539,442.375,1361049078555,1361049078619,1470460335,1470460399,64
1361049084,1470465780,37,45806,1238,1361049078491,1361049078619,1470460271,1470460399,128
1361049084,1470465780,3,635,211.6666667,1361049078555,1361049078747,1470460335,1470460527,192
1361049084,1470465784,33,42040,1273.939394,1361049076503,1361049076823,1470458287,1470458607,320
1361049084,1470465784,28,34498,1232.071429,1361049078615,1361049078679,1470460399,1470460463,64
1361049084,1470465784,10,6692,669.2,1361049078554,1361049078618,1470460338,1470460402,64
1361049084,1470465784,11,7886,716.9090909,1361049078746,1361049078810,1470460530,1470460594,64
1361049084,1470465784,45,58498,1299.955556,1361049078618,1361049078746,1470460402,1470460530,128
1361049084,1470465784,4,971,242.75,1361049078746,1361049078938,1470460530,1470460722,192
1361049084,1470465784,37,44027,1189.918919,1361049078618,1361049078810,1470460402,1470460594,192
1361049084,1470465784,13,8523,655.6153846,1361049078618,1361049078746,1470460402,1470460530,128
1361049084,1470465784,50,65532,1310.64,1361049078746,1361049078938,1470460530,1470460722,192
1361049084,1470465784,5,1159,231.8,1361049076697,1361049076825,1470458481,1470458609,128
1361049084,1470465784,6,1694,282.3333333,1361049076697,1361049076825,1470458481,1470458609,128
1361049084,1470465784,18,20229,1123.833333,1361049078809,1361049078937,1470460593,1470460721,128
1361049084,1470465784,22,26976,1226.181818,1361049078809,1361049078937,1470460593,1470460721,128
1361049084,1470465784,6,2773,462.1666667,1361049078809,1361049079385,1470460593,1470461169,576
1361049084,1470465784,7,2615,373.5714286,1361049078681,1361049079193,1470460465,1470460977,512
1361049084,1470465784,12,5740,478.3333333,1361049078745,1361049078937,1470460529,1470460721,192
1361049084,1470465784,3,634,211.3333333,1361049078745,1361049078745,1470460529,1470460529,0
1361049084,1470465784,10,10112,1011.2,1361049078745,1361049078937,1470460529,1470460721,192
1361049084,1470465784,5,2056,411.2,1361049078745,1361049078937,1470460529,1470460721,192
1361049084,1470465784,7,2988,426.8571429,1361049078745,1361049078937,1470460529,1470460721,192
1361049084,1470465784,5,1428,285.6,1361049076696,1361049076824,1470458480,1470458608,128
1361049084,1470465784,6,818,136.3333333,1361049078936,1361049079000,1470460720,1470460784,64
1361049084,1470465784,24,29087,1211.958333,1361049078808,1361049078936,1470460592,1470460720,128
1361049084,1470465784,26,23795,915.1923077,1361049078936,1361049079768,1470460720,1470461552,832
1361049084,1470465784,16,12588,786.75,1361049058455,1361049079255,1470440239,1470461039,20800
1361049084,1470465788,364,477102,1310.71978,1361049062871,1361049081367,1470444659,1470463155,18496
1361049084,1470465788,23,27461,1193.956522,1361049078934,1361049078998,1470460722,1470460786,64
1361049084,1470465788,53,69754,1316.113208,1361049074518,1361049076438,1470456306,1470458226,1920
1361049084,1470465788,52,69080,1328.461538,1361049078934,1361049079702,1470460722,1470461490,768
1361049084,1470465788,30,38458,1281.933333,1361049078934,1361049079702,1470460722,1470461490,768
1361049084,1470465788,46,59887,1301.891304,1361049076822,1361049077142,1470458610,1470458930,320
1361049084,1470465788,12,5946,495.5,1361049079125,1361049079381,1470460913,1470461169,256
1361049084,1470465788,8,3915,489.375,1361049079061,1361049079765,1470460849,1470461553,704
1361049084,1470465788,12,5942,495.1666667,1361049079125,1361049079509,1470460913,1470461297,384
1361049084,1470465788,16,16400,1025,1361049079188,1361049079764,1470460976,1470461552,576
1361049084,1470465788,23,27680,1203.478261,1361049079188,1361049079700,1470460976,1470461488,512
1361049084,1470465788,297,396347,1334.501684,1361049063060,1361049081108,1470444848,1470462896,18048
1361049084,1470465788,3,279,93,1361049079252,1361049079316,1470461040,1470461104,64
1361049084,1470465788,26,26704,1027.076923,1361049079252,1361049079892,1470461040,1470461680,640
1361049084,1470465792,3,502,167.3333333,1361049079443,1361049079635,1470461235,1470461427,192
1361049084,1470465792,22,23436,1065.272727,1361049079442,1361049080658,1470461234,1470462450,1216
1361049084,1470465792,9,8058,895.3333333,1361049079698,1361049079762,1470461490,1470461554,64
1361049084,1470465792,6,4404,734,1361049079698,1361049079762,1470461490,1470461554,64
1361049084,1470465792,4,1188,297,1361049079698,1361049079826,1470461490,1470461618,128
1361049084,1470465792,10,5466,546.6,1361049079634,1361049080402,1470461426,1470462194,768
1361049084,1470465792,9,5910,656.6666667,1361049079761,1361049080529,1470461553,1470462321,768
1361049084,1470465792,9,6028,669.7777778,1361049079761,1361049080529,1470461553,1470462321,768
1361049084,1470465792,6,2536,422.6666667,1361049063697,1361049080785,1470445489,1470462577,17088
1361049084,1470465792,6,3389,564.8333333,1361049079825,1361049080529,1470461617,1470462321,704
1361049084,1470465792,6,3389,564.8333333,1361049079825,1361049080529,1470461617,1470462321,704
1361049084,1470465792,4,388,97,1361049079697,1361049079761,1470461489,1470461553,64
1361049084,1470465792,5,4244,848.8,1361049079697,1361049079825,1470461489,1470461617,128
1361049084,1470465792,4,1188,297,1361049079697,1361049079825,1470461489,1470461617,128
1361049084,1470465792,65,69140,1063.692308,1361049079889,1361049080593,1470461681,1470462385,704
1361049084,1470465792,8,5175,646.875,1361049079889,1361049080529,1470461681,1470462321,640
1361049084,1470465792,32,33316,1041.125,1361049079761,1361049080721,1470461553,1470462513,960
1361049084,1470465792,15,9835,655.6666667,1361049079824,1361049080528,1470461616,1470462320,704
1361049084,1470465792,9,5239,582.1111111,1361049079888,1361049080848,1470461680,1470462640,960
1361049084,1470465792,7,4443,634.7142857,1361049080016,1361049080592,1470461808,1470462384,576
1361049084,1470465792,11,10932,993.8181818,1361049080144,1361049080528,1470461936,1470462320,384
1361049084,1470465792,6,501,83.5,1361049080016,1361049080464,1470461808,1470462256,448
1361049084,1470465796,5,2983,596.6,1361049080203,1361049080587,1470461999,1470462383,384
1361049084,1470465796,3,1416,472,1361049080203,1361049080587,1470461999,1470462383,384
1361049084,1470465796,10,7410,741,1361049080203,1361049080395,1470461999,1470462191,192
1361049084,1470465796,5,2344,468.8,1361049080335,1361049080527,1470462131,1470462323,192
1361049084,1470465796,3,624,208,1361049080399,1361049080463,1470462195,1470462259,64
1361049084,1470465796,4,652,163,1361049080398,1361049080462,1470462194,1470462258,64
1361049084,1470465796,5,1740,348,1361049080398,1361049080526,1470462194,1470462322,128
1361049084,1470465796,4,409,102.25,1361049080334,1361049080462,1470462130,1470462258,128
1361049084,1470465796,3,540,180,1361049080462,1361049080462,1470462258,1470462258,0
1361049084,1470465796,6,895,149.1666667,1361049080462,1361049080654,1470462258,1470462450,192
1361049084,1470465796,4,548,137,1361049080462,1361049080590,1470462258,1470462386,128
1361049084,1470465796,8,856,107,1361049080462,1361049080654,1470462258,1470462450,192
1361049084,1470465796,5,956,191.2,1361049080398,1361049080526,1470462194,1470462322,128
1361049084,1470465796,5,2176,435.2,1361049080462,1361049080590,1470462258,1470462386,128
1361049084,1470465796,3,858,286,1361049080462,1361049080590,1470462258,1470462386,128
1361049084,1470465796,4,1347,336.75,1361049080462,1361049080782,1470462258,1470462578,320
1361049084,1470465796,4,1344,336,1361049080526,1361049080846,1470462322,1470462642,320
1361049084,1470465820,6,501,83.5,1361049080821,1361049081269,1470462641,1470463089,448
1361049086,1470466928,2,104,52,1361049061040,1361049073840,1470441968,1470454768,12800
1361049086,1470466932,3,215,71.66666667,1361049058223,1361049058287,1470439155,1470439219,64
1361049086,1470466932,3,1180,393.3333333,1361049058412,1361049058476,1470439344,1470439408,64
1361049086,1470466936,2,777,388.5,1361049058538,1361049058602,1470439474,1470439538,64
1361049086,1470466972,1,52,52,1361049059525,1361049059525,1470440497,1470440497,0
1361049086,1470466972,3,889,296.3333333,1361049059716,1361049059780,1470440688,1470440752,64
1361049086,1470467000,2,104,52,1361049059944,1361049073768,1470440944,1470454768,13824
1361049086,1470467016,3,1027,342.3333333,1361049058138,1361049058138,1470439154,1470439154,0
1361049086,1470467016,4,1926,481.5,1361049058202,1361049058266,1470439218,1470439282,64
1361049086,1470467016,2,104,52,1361049060953,1361049073753,1470441969,1470454769,12800
1361049086,1470467016,3,933,311,1361049058201,1361049058265,1470439217,1470439281,64
1361049086,1470467016,3,567,189,1361049058328,1361049058328,1470439344,1470439344,0
1361049086,1470467092,11,5193,472.0909091,1361049060300,1361049062220,1470441392,1470443312,1920
1361049087,108781636,7,5714,816.2857143,1361049079141,1361049079205,108773777,108773841,64
1361049087,108781636,8,6077,759.625,1361049079141,1361049079205,108773777,108773841,64
1361049087,108781636,9,8215,912.7777778,1361049079141,1361049079205,108773777,108773841,64
1361049087,108781636,30,38568,1285.6,1361049079653,1361049079717,108774289,108774353,64
1361049087,108781636,25,31313,1252.52,1361049080164,1361049080804,108774800,108775440,640
1361049087,108781636,8,6861,857.625,1361049080164,1361049080804,108774800,108775440,640
1361049087,108781640,13,12132,933.2307692,1361049080611,1361049080803,108775251,108775443,192
1361049087,108781640,8,6148,768.5,1361049080611,1361049080803,108775251,108775443,192
1361049087,108781640,4,699,174.75,1361049080739,1361049080803,108775379,108775443,64
1361049087,108781640,4,464,116,1361049080803,1361049080803,108775443,108775443,0
1361049087,108781640,22,25118,1141.727273,1361049065250,1361049080802,108759890,108775442,15552
1361049087,108781640,5,1203,240.6,1361049078753,1361049079009,108773393,108773649,256
1361049087,108781640,9,8269,918.7777778,1361049079140,1361049079204,108773780,108773844,64
1361049087,108781644,12,12957,1079.75,1361049079391,1361049079647,108774035,108774291,256
1361049087,108781644,30,38568,1285.6,1361049079711,1361049079775,108774355,108774419,64
1361049087,108781644,11,10406,946,1361049079583,1361049080031,108774227,108774675,448
1361049087,108781644,26,32902,1265.461538,1361049080158,1361049080798,108774802,108775442,640
1361049087,108781644,8,6653,831.625,1361049080413,1361049080797,108775057,108775441,384
1361049087,108781644,7,4950,707.1428571,1361049080605,1361049080669,108775249,108775313,64
1361049087,108781644,8,2587,323.375,1361049080605,1361049080797,108775249,108775441,192
1361049087,108781644,7,2751,393,1361049080605,1361049080797,108775249,108775441,192
1361049087,108781644,4,928,232,1361049080797,1361049080797,108775441,108775441,0
1361049087,108781648,8,6148,768.5,1361049078619,1361049079643,108773267,108774291,1024
1361049087,108781648,5,1477,295.4,1361049078619,1361049079643,108773267,108774291,1024
1361049087,108781648,25,30911,1236.44,1361049062682,1361049080090,108757330,108774738,17408
1361049087,108781876,14,17149,1224.928571,1361049062710,1361049062774,108757586,108757650,64
1361049090,1470471060,3,657,219,1361049062830,1361049062958,1470443890,1470444018,128
1361049092,1470473700,68,90681,1333.544118,1361049084077,1361049085869,1470465777,1470467569,1792
1361049092,1470473700,8,6822,852.75,1361049085420,1361049085868,1470467120,1470467568,448
1361049092,1470473700,28,34837,1244.178571,1361049085420,1361049085868,1470467120,1470467568,448
1361049092,1470473700,37,47568,1285.621622,1361049085420,1361049085868,1470467120,1470467568,448
1361049092,1470473700,211,296610,1405.734597,1361049084076,1361049086060,1470465776,1470467760,1984
1361049092,1470473704,6,3863,643.8333333,1361049085547,1361049085867,1470467251,1470467571,320
1361049092,1470473704,7,5290,755.7142857,1361049085547,1361049085867,1470467251,1470467571,320
1361049092,1470473704,7,5390,770,1361049085546,1361049085866,1470467250,1470467570,320
1361049092,1470473704,5,1092,218.4,1361049085864,1361049086120,1470467568,1470467824,256
1361049092,1470473708,4,576,144,1361049090149,1361049091301,1470471857,1470473009,1152
1361049092,1470473712,7,1975,282.1428571,1361049090401,1361049090465,1470472113,1470472177,64
1361049092,1470473740,8,5362,670.25,1361049090823,1361049091271,1470472563,1470473011,448
1361049092,1470473740,6,4242,707,1361049090823,1361049091271,1470472563,1470473011,448
1361049092,1470473740,7,5265,752.1428571,1361049090823,1361049091271,1470472563,1470473011,448
1361049092,1470473740,5,2822,564.4,1361049091269,1361049091333,1470473009,1470473073,64
1361049092,1470473744,12,11182,931.8333333,1361049088067,1361049091267,1470469811,1470473011,3200
1361049092,1470473744,10,4414,441.4,1361049091267,1361049091523,1470473011,1470473267,256
1361049092,1470473744,89,96088,1079.640449,1361049080641,1361049085121,1470462385,1470466865,4480
1361049092,1470473744,5,762,152.4,1361049080449,1361049085825,1470462193,1470467569,5376
1361049092,1470473744,4,543,135.75,1361049080513,1361049085505,1470462257,1470467249,4992
1361049092,1470473744,37,37480,1012.972973,1361049080769,1361049085185,1470462513,1470466929,4416
1361049092,1470473744,7,4039,577,1361049080576,1361049084160,1470462320,1470465904,3584
1361049092,1470473744,43,46177,1073.883721,1361049080960,1361049085120,1470462704,1470466864,4160
1361049092,1470473744,37,41554,1123.081081,1361049080640,1361049085120,1470462384,1470466864,4480
1361049092,1470473748,53,48278,910.9056604,1361049080763,1361049085115,1470462511,1470466863,4352
1361049092,1470473752,6,3955,659.1666667,1361049085497,1361049085817,1470467249,1470467569,320
1361049092,1470473752,7,5503,786.1428571,1361049085497,1361049085817,1470467249,1470467569,320
1361049092,1470473752,7,5450,778.5714286,1361049085497,1361049085817,1470467249,1470467569,320
1361049092,1470473752,6,4176,696,1361049085497,1361049085817,1470467249,1470467569,320
1361049092,1470473752,7,5495,785,1361049085497,1361049085817,1470467249,1470467569,320
1361049092,1470473752,4,356,89,1361049085687,1361049085815,1470467439,1470467567,128
1361049092,1470473784,4,767,191.75,1361049090586,1361049091226,1470472370,1470473010,640
1361049092,1470473784,311,438542,1410.102894,1361049086810,1361049091226,1470468594,1470473010,4416
1361049092,1470473784,7,3165,452.1428571,1361049090776,1361049091224,1470472560,1470473008,448
1361049092,1470473784,7,5493,784.7142857,1361049090776,1361049091224,1470472560,1470473008,448
1361049092,1470473784,80,104144,1301.8,1361049090776,1361049091224,1470472560,1470473008,448
1361049092,1470473784,26,31422,1208.538462,1361049082711,1361049085783,1470464495,1470467567,3072
1361049092,1470473784,7,5518,788.2857143,1361049090775,1361049091223,1470472559,1470473007,448
1361049092,1470473788,10,9398,939.8,1361049083155,1361049085779,1470464943,1470467567,2624
1361049092,1470473792,26,26877,1033.730769,1361049088400,1361049091216,1470470192,1470473008,2816
1361049092,1470473792,8,4675,584.375,1361049080528,1361049084112,1470462320,1470465904,3584
1361049092,1470473792,5,1152,230.4,1361049080528,1361049085648,1470462320,1470467440,5120
1361049092,1470473792,8,5033,629.125,1361049080527,1361049084111,1470462319,1470465903,3584
1361049092,1470473796,41,43725,1066.463415,1361049080911,1361049085071,1470462707,1470466867,4160
1361049092,1470473796,8,2411,301.375,1361049083726,1361049084686,1470465522,1470466482,960
1361049098,1470478988,1,46,46,1361049073395,1361049073395,1470454383,1470454383,0
1361049098,1470479016,1,52,52,1361049073691,1361049073691,1470454707,1470454707,0
1361049098,1470479016,1,52,52,1361049073688,1361049073688,1470454704,1470454704,0
1361049098,1470479100,1,52,52,1361049073604,1361049073604,1470454704,1470454704,0
1361049098,1470479100,1,52,52,1361049073604,1361049073604,1470454704,1470454704,0
1361049099,108793904,1,52,52,1361049072666,1361049072666,108767570,108767570,0
1361049099,108793904,1,52,52,1361049072665,1361049072665,108767569,108767569,0
1361049099,108793908,20,24979,1248.95,1361049073300,1361049073876,108768208,108768784,576
1361049099,108793912,4,2711,677.75,1361049073616,1361049073616,108768528,108768528,0
1361049099,108793956,1,52,52,1361049072615,1361049072615,108767571,108767571,0
1361049099,108793964,4,1916,479,1361049073567,1361049073567,108768531,108768531,0
1361049100,1470481740,10,4413,441.3,1361049091780,1361049091972,1470473520,1470473712,192
1361049100,1470481776,1112,1567203,1409.355216,1361049090463,1361049097375,1470472239,1470479151,6912
1361049100,1470481788,6,828,138,1361049080531,1361049095635,1470462319,1470477423,15104
1361049102,1470482952,1,46,46,1361049076762,1361049076762,1470457714,1470457714,0
1361049102,1470482964,2,104,52,1361049077134,1361049081166,1470458098,1470462130,4032
1361049102,1470482968,2,854,427,1361049074697,1361049074761,1470455665,1470455729,64
1361049102,1470483164,10,10243,1024.3,1361049075271,1361049075271,1470456435,1470456435,0
1361049103,108797640,4,464,116,1361049080867,1361049102243,108775507,108796883,21376
1361049103,108797640,8,6457,807.125,1361049082848,1361049102240,108777488,108796880,19392
1361049103,108797988,1,52,52,1361049078277,1361049078277,108773265,108773265,0
1361049106,1470487272,1,46,46,1361049078553,1361049078553,1470459825,1470459825,0
1361049106,1470487304,2,112,56,1361049079864,1361049079928,1470461168,1470461232,64
1361049106,1470487316,1,52,52,1361049080877,1361049080877,1470462193,1470462193,0
1361049106,1470487316,2,762,381,1361049080940,1361049080940,1470462256,1470462256,0
1361049106,1470487340,94,128120,1362.978723,1361049081108,1361049102420,1470462448,1470483760,21312
1361049106,1470487340,4,431,107.75,1361049081108,1361049102420,1470462448,1470483760,21312
1361049106,1470487340,22,20636,938,1361049081235,1361049102419,1470462575,1470483759,21184
1361049106,1470487384,1,46,46,1361049078442,1361049078442,1470459826,1470459826,0
1361049106,1470487396,1,52,52,1361049079454,1361049079454,1470460850,1470460850,0
1361049106,1470487428,1,52,52,1361049080765,1361049080765,1470462193,1470462193,0
1361049106,1470487432,3,1266,422,1361049080827,1361049080891,1470462259,1470462323,64
1361049106,1470487432,31,38777,1250.870968,1361049081017,1361049102329,1470462449,1470483761,21312
1361049106,1470487432,4,431,107.75,1361049081017,1361049102329,1470462449,1470483761,21312
1361049106,1470487432,17,14164,833.1764706,1361049081144,1361049102328,1470462576,1470483760,21184
1361049106,1470487432,3,601,200.3333333,1361049081207,1361049102327,1470462639,1470483759,21120
1361049107,108801912,3,425,141.6666667,1361049080851,1361049080851,108775763,108775763,0
1361049108,1470489724,8,2736,342,1361049091925,1361049106901,1470473649,1470488625,14976
1361049108,1470489732,3,533,177.6666667,1361049081870,1361049102030,1470463602,1470483762,20160
1361049108,1470489732,4,592,148,1361049086028,1361049102028,1470467760,1470483760,16000
1361049108,1470489732,4,592,148,1361049086028,1361049102028,1470467760,1470483760,16000
1361049108,1470489732,4,592,148,1361049086028,1361049102028,1470467760,1470483760,16000
1361049108,1470489732,4,592,148,1361049086028,1361049102028,1470467760,1470483760,16000
1361049108,1470489736,37,47775,1291.216216,1361049084873,1361049102025,1470466609,1470483761,17152
1361049108,1470489740,4,791,197.75,1361049106886,1361049106950,1470488626,1470488690,64
1361049108,1470489760,4,356,89,1361049083184,1361049106864,1470464944,1470488624,23680
1361049108,1470489768,105,131024,1247.847619,1361049056810,1361049101994,1470438578,1470483762,45184
1361049108,1470489772,6,1235,205.8333333,1361049091878,1361049106918,1470473650,1470488690,15040
1361049108,1470489800,3,534,178,1361049081801,1361049101961,1470463601,1470483761,20160
1361049108,1470489800,4,592,148,1361049085960,1361049101960,1470467760,1470483760,16000
1361049108,1470489808,18,20877,1159.833333,1361049084802,1361049101954,1470466610,1470483762,17152
1361049108,1470489816,4,766,191.5,1361049083128,1361049106808,1470464944,1470488624,23680
1361049108,1470489844,10,8329,832.9,1361049083613,1361049101917,1470465457,1470483761,18304
1361049108,1470489844,13,6003,461.7692308,1361049083677,1361049101981,1470465521,1470483825,18304
1361049108,1470489844,105,136394,1298.990476,1361049056860,1361049101916,1470438704,1470483760,45056
1361049108,1470489844,115,148966,1295.356522,1361049056860,1361049101916,1470438704,1470483760,45056
1361049108,1470489844,229,306404,1338.008734,1361049056860,1361049101916,1470438704,1470483760,45056
1361049108,1470489844,177,237395,1341.214689,1361049056860,1361049101916,1470438704,1470483760,45056
1361049110,1470491280,1,46,46,1361049084303,1361049084303,1470465583,1470465583,0
1361049110,1470491372,1,52,52,1361049083574,1361049083574,1470464946,1470464946,0
1361049110,1470491456,1,52,52,1361049083487,1361049083487,1470464943,1470464943,0
1361049111,108805648,15,17102,1140.133333,1361049109081,1361049110041,108803729,108804689,960
1361049111,108805652,40,46965,1174.125,1361049108821,1361049110037,108803473,108804689,1216
1361049111,108805652,12,10956,913,1361049108821,1361049110037,108803473,108804689,1216
1361049111,108805652,47,62308,1325.702128,1361049109076,1361049110036,108803728,108804688,960
1361049114,1470495256,1,52,52,1361049086183,1361049086183,1470467439,1470467439,0
1361049114,1470495308,12,10951,912.5833333,1361049088500,1361049088692,1470469808,1470470000,192
1361049114,1470495340,1,52,52,1361049085907,1361049085907,1470467247,1470467247,0
1361049114,1470495340,1,52,52,1361049085907,1361049085907,1470467247,1470467247,0
1361049114,1470495420,5,3671,734.2,1361049088773,1361049088837,1470470193,1470470257,64
1361049116,1470497728,6,3543,590.5,1361049114065,1361049114961,1470495793,1470496689,896
1361049116,1470497728,3,943,314.3333333,1361049114192,1361049114256,1470495920,1470495984,64
1361049116,1470497728,32,40168,1255.25,1361049108560,1361049109840,1470490288,1470491568,1280
1361049116,1470497728,6,889,148.1666667,1361049114192,1361049114256,1470495920,1470495984,64
1361049116,1470497728,7,2708,386.8571429,1361049114128,1361049114960,1470495856,1470496688,832
1361049116,1470497728,3,809,269.6666667,1361049114128,1361049114192,1470495856,1470495920,64
1361049116,1470497728,3,642,214,1361049114255,1361049114255,1470495983,1470495983,0
1361049116,1470497732,3,862,287.3333333,1361049114251,1361049114315,1470495983,1470496047,64
1361049116,1470497732,3,502,167.3333333,1361049114573,1361049114637,1470496305,1470496369,64
1361049116,1470497732,5,2822,564.4,1361049114637,1361049114957,1470496369,1470496689,320
1361049116,1470497736,5,623,124.6,1361049114823,1361049114951,1470496559,1470496687,128
1361049116,1470497736,4,651,162.75,1361049114954,1361049115146,1470496690,1470496882,192
1361049116,1470497736,4,413,103.25,1361049115018,1361049115146,1470496754,1470496882,128
1361049116,1470497736,6,2291,381.8333333,1361049115018,1361049115146,1470496754,1470496882,128
1361049116,1470497736,3,634,211.3333333,1361049115145,1361049115273,1470496881,1470497009,128
1361049116,1470497736,4,698,174.5,1361049115145,1361049115273,1470496881,1470497009,128
1361049116,1470497760,3,642,214,1361049115248,1361049115248,1470497008,1470497008,0
1361049116,1470497760,3,633,211,1361049115247,1361049115311,1470497007,1470497071,64
1361049116,1470497764,3,962,320.6666667,1361049115502,1361049115502,1470497266,1470497266,0
1361049116,1470497764,3,828,276,1361049115437,1361049115501,1470497201,1470497265,64
1361049116,1470497768,8,5741,717.625,1361049113063,1361049113447,1470494831,1470495215,384
1361049116,1470497768,7,3926,560.8571429,1361049113063,1361049113447,1470494831,1470495215,384
1361049116,1470497768,23,11581,503.5217391,1361049113063,1361049113255,1470494831,1470495023,192
1361049116,1470497772,4,652,163,1361049113381,1361049114021,1470495153,1470495793,640
1361049116,1470497772,4,612,153,1361049113381,1361049114021,1470495153,1470495793,640
1361049116,1470497772,6,2276,379.3333333,1361049113507,1361049113635,1470495279,1470495407,128
1361049116,1470497776,1305,1854079,1420.750192,1361049109793,1361049114657,1470491569,1470496433,4864
1361049116,1470497776,5,2823,564.6,1361049113632,1361049114016,1470495408,1470495792,384
1361049116,1470497780,5,2104,420.8,1361049113886,1361049114142,1470495666,1470495922,256
1361049116,1470497780,3,580,193.3333333,1361049113950,1361049114078,1470495730,1470495858,128
1361049116,1470497780,7,2486,355.1428571,1361049113950,1361049114142,1470495730,1470495922,192
1361049116,1470497796,6,1740,290,1361049113995,1361049114059,1470495791,1470495855,64
1361049116,1470497796,6,1817,302.8333333,1361049114059,1361049114123,1470495855,1470495919,64
1361049116,1470497800,3,634,211.3333333,1361049114055,1361049114247,1470495855,1470496047,192
1361049116,1470497800,3,951,317,1361049114186,1361049114186,1470495986,1470495986,0
1361049116,1470497800,6,591,98.5,1361049114185,1361049114505,1470495985,1470496305,320
1361049116,1470497800,3,633,211,1361049114185,1361049114249,1470495985,1470496049,64
1361049116,1470497800,6,2771,461.8333333,1361049114313,1361049114825,1470496113,1470496625,512
1361049116,1470497800,7,3422,488.8571429,1361049114249,1361049114505,1470496049,1470496305,256
1361049116,1470497800,5,2620,524,1361049114376,1361049114888,1470496176,1470496688,512
1361049116,1470497804,7,3313,473.2857143,1361049114757,1361049115077,1470496561,1470496881,320
1361049116,1470497804,5,594,118.8,1361049114821,1361049115077,1470496625,1470496881,256
1361049116,1470497804,12,10353,862.75,1361049114884,1361049115076,1470496688,1470496880,192
1361049116,1470497804,3,580,193.3333333,1361049114884,1361049115076,1470496688,1470496880,192
1361049116,1470497804,1316,1856562,1410.761398,1361049106820,1361049111556,1470488624,1470493360,4736
1361049116,1470497808,223,311583,1397.233184,1361049087362,1361049108482,1470469170,1470490290,21120
1361049116,1470497808,21,25407,1209.857143,1361049115266,1361049115394,1470497074,1470497202,128
1361049116,1470497808,6,2771,461.8333333,1361049115329,1361049115841,1470497137,1470497649,512
1361049116,1470497808,3,881,293.6666667,1361049115521,1361049115585,1470497329,1470497393,64
1361049116,1470497808,3,970,323.3333333,1361049115520,1361049115520,1470497328,1470497328,0
1361049116,1470497812,4,571,142.75,1361049115774,1361049115838,1470497586,1470497650,64
1361049116,1470497812,3,754,251.3333333,1361049112317,1361049112381,1470494129,1470494193,64
1361049116,1470497812,13,13064,1004.923077,1361049112445,1361049112829,1470494257,1470494641,384
1361049116,1470497812,7,3957,565.2857143,1361049113019,1361049113403,1470494831,1470495215,384
1361049116,1470497812,7,4326,618,1361049113019,1361049113403,1470494831,1470495215,384
1361049116,1470497840,15,10792,719.4666667,1361049113121,1361049113185,1470494961,1470495025,64
1361049118,1470499264,3,652,217.3333333,1361049092384,1361049092448,1470473648,1470473712,64
1361049118,1470499276,1,52,52,1361049092755,1361049092755,1470474031,1470474031,0
1361049118,1470499280,5,1687,337.4,1361049092880,1361049107920,1470474160,1470489200,15040
1361049118,1470499344,7,6078,868.2857143,1361049091730,1361049096978,1470473074,1470478322,5248
1361049118,1470499344,7,6540,934.2857143,1361049091730,1361049096978,1470473074,1470478322,5248
1361049118,1470499348,10,10394,1039.4,1361049091726,1361049096974,1470473074,1470478322,5248
1361049118,1470499352,3,652,217.3333333,1361049092297,1361049092361,1470473649,1470473713,64
1361049118,1470499388,9,1300,144.4444444,1361049092708,1361049117796,1470474096,1470499184,25088
1361049118,1470499396,1,52,52,1361049090462,1361049090462,1470471858,1470471858,0
1361049118,1470499432,6,5419,903.1666667,1361049091640,1361049091640,1470473072,1470473072,0
1361049118,1470499432,8,8248,1031,1361049091640,1361049096888,1470473072,1470478320,5248
1361049118,1470499436,3,379,126.3333333,1361049091830,1361049091830,1470473266,1470473266,0
1361049118,1470499436,7,6717,959.5714286,1361049091638,1361049096886,1470473074,1470478322,5248
1361049118,1470499436,1,52,52,1361049091828,1361049091828,1470473264,1470473264,0
1361049115,108809980,5,1356,271.2,1361049114832,1361049115024,108809812,108810004,192
1361049119,108813648,5,1430,286,1361049115355,1361049116891,108810003,108811539,1536
1361049119,108813648,4,1025,256.25,1361049116570,1361049116890,108811218,108811538,320
1361049119,108813648,5,1356,271.2,1361049116889,1361049117337,108811537,108811985,448
1361049119,108813652,29,36725,1266.37931,1361049115413,1361049115477,108810065,108810129,64
1361049119,108813656,5,2360,472,1361049116563,1361049116883,108811219,108811539,320
1361049119,108813656,5,1356,271.2,1361049116883,1361049117331,108811539,108811987,448
1361049119,108813656,11,10406,946,1361049113426,1361049113490,108808082,108808146,64
1361049119,108813656,5,1356,271.2,1361049114128,1361049114256,108808784,108808912,128
1361049119,108813656,22,26200,1190.909091,1361049114512,1361049115152,108809168,108809808,640
1361049122,1470503300,7,3541,505.8571429,1361049097021,1361049097085,1470478321,1470478385,64
1361049122,1470503320,6,1990,331.6666667,1361049097001,1361049097065,1470478321,1470478385,64
1361049122,1470503404,7,3365,480.7142857,1361049096917,1361049096981,1470478321,1470478385,64
1361049124,1470505712,5,617,123.4,1361049117537,1361049117601,1470499249,1470499313,64
1361049124,1470505712,6,2480,413.3333333,1361049117601,1361049117729,1470499313,1470499441,128
1361049124,1470505716,5,623,124.6,1361049116189,1361049116253,1470497905,1470497969,64
1361049124,1470505716,5,674,134.8,1361049116316,1361049116380,1470498032,1470498096,64
1361049124,1470505716,5,1139,227.8,1361049116379,1361049116699,1470498095,1470498415,320
1361049124,1470505720,3,502,167.3333333,1361049116441,1361049116505,1470498161,1470498225,64
1361049124,1470505724,6,1441,240.1666667,1361049116690,1361049117138,1470498414,1470498862,448
1361049124,1470505724,7,3294,470.5714286,1361049118870,1361049119382,1470500594,1470501106,512
1361049124,1470505724,4,1332,333,1361049119124,1361049119316,1470500848,1470501040,192
1361049124,1470505724,5,700,140,1361049119123,1361049119187,1470500847,1470500911,64
1361049124,1470505724,7,2165,309.2857143,1361049119315,1361049119379,1470501039,1470501103,64
1361049124,1470505728,3,279,93,1361049116882,1361049117010,1470498610,1470498738,128
1361049124,1470505728,8,4091,511.375,1361049119313,1361049119377,1470501041,1470501105,64
1361049124,1470505728,5,1085,217,1361049117136,1361049117200,1470498864,1470498928,64
1361049124,1470505728,7,1840,262.8571429,1361049117136,1361049117200,1470498864,1470498928,64
1361049124,1470505728,8,3931,491.375,1361049117199,1361049117263,1470498927,1470498991,64
1361049124,1470505752,6,746,124.3333333,1361049117239,1361049117303,1470498991,1470499055,64
1361049124,1470505752,12,5028,419,1361049117304,1361049119288,1470499056,1470501040,1984
1361049124,1470505756,72,50814,705.75,1361049120116,1361049120308,1470501872,1470502064,192
1361049124,1470505760,2,516,258,1361049117423,1361049119279,1470499183,1470501039,1856
1361049124,1470505764,3,502,167.3333333,1361049117549,1361049117677,1470499313,1470499441,128
1361049124,1470505764,6,3374,562.3333333,1361049117677,1361049118701,1470499441,1470500465,1024
1361049124,1470505764,8,4728,591,1361049116139,1361049116267,1470497903,1470498031,128
1361049124,1470505772,5,644,128.8,1361049116645,1361049117285,1470498417,1470499057,640
1361049124,1470505772,3,580,193.3333333,1361049116581,1361049116773,1470498353,1470498545,192
1361049124,1470505772,18,21404,1189.111111,1361049116645,1361049116773,1470498417,1470498545,128
1361049124,1470505772,12,6018,501.5,1361049116645,1361049116901,1470498417,1470498673,256
1361049124,1470505772,11,5968,542.5454545,1361049116644,1361049117156,1470498416,1470498928,512
1361049124,1470505796,3,634,211.3333333,1361049116749,1361049116941,1470498545,1470498737,192
1361049124,1470505796,5,1885,377,1361049119117,1361049119245,1470500913,1470501041,128
1361049124,1470505796,9,5620,624.4444444,1361049119244,1361049119756,1470501040,1470501552,512
1361049124,1470505796,3,642,214,1361049116875,1361049116939,1470498671,1470498735,64
1361049124,1470505800,7,4022,574.5714286,1361049119239,1361049123079,1470501039,1470504879,3840
1361049124,1470505800,5,325,65,1361049116935,1361049117191,1470498735,1470498991,256
1361049124,1470505800,3,633,211,1361049116934,1361049116998,1470498734,1470498798,64
1361049124,1470505800,11,5835,530.4545455,1361049116938,1361049117066,1470498738,1470498866,128
1361049124,1470505800,6,2786,464.3333333,1361049117065,1361049117449,1470498865,1470499249,384
1361049124,1470505800,9,6402,711.3333333,1361049115143,1361049116615,1470496943,1470498415,1472
1361049124,1470505804,4,582,145.5,1361049115203,1361049116611,1470497007,1470498415,1408
1361049124,1470505804,8,4068,508.5,1361049115589,1361049116357,1470497393,1470498161,768
1361049124,1470505804,8,3346,418.25,1361049120324,1361049120388,1470502128,1470502192,64
1361049124,1470505804,6,3015,502.5,1361049115779,1361049116099,1470497583,1470497903,320
1361049124,1470505804,5,594,118.8,1361049115843,1361049116099,1470497647,1470497903,256
1361049127,108821652,10,3047,304.7,1361049117525,1361049119509,108812177,108814161,1984
1361049127,108821656,8,6861,857.625,1361049118932,1361049119508,108813588,108814164,576
1361049127,108821980,1,52,52,1361049101902,1361049101902,108796882,108796882,0
1361049130,1470511280,1,52,52,1361049102481,1361049102481,1470483761,1470483761,0
1361049130,1470511280,1,52,52,1361049102481,1361049102481,1470483761,1470483761,0
1361049130,1470511280,1,52,52,1361049102481,1361049102481,1470483761,1470483761,0
1361049130,1470511280,1,46,46,1361049102481,1361049102481,1470483761,1470483761,0
1361049130,1470511280,1,52,52,1361049102481,1361049102481,1470483761,1470483761,0
1361049130,1470511280,1,46,46,1361049102480,1361049102480,1470483760,1470483760,0
1361049130,1470511280,1,52,52,1361049102480,1361049102480,1470483760,1470483760,0
1361049130,1470511280,1,46,46,1361049102480,1361049102480,1470483760,1470483760,0
1361049130,1470511280,1,52,52,1361049102480,1361049102480,1470483760,1470483760,0
1361049130,1470511280,1,52,52,1361049102480,1361049102480,1470483760,1470483760,0
1361049130,1470511280,1,46,46,1361049102480,1361049102480,1470483760,1470483760,0
1361049130,1470511280,1,46,46,1361049102479,1361049102479,1470483759,1470483759,0
1361049130,1470511280,1,46,46,1361049102479,1361049102479,1470483759,1470483759,0
1361049130,1470511280,1,52,52,1361049102479,1361049102479,1470483759,1470483759,0
1361049130,1470511280,1,52,52,1361049102479,1361049102479,1470483759,1470483759,0
1361049130,1470511280,1,52,52,1361049102479,1361049102479,1470483759,1470483759,0
1361049130,1470511280,1,46,46,1361049102479,1361049102479,1470483759,1470483759,0
1361049130,1470511368,1,52,52,1361049102394,1361049102394,1470483762,1470483762,0
1361049130,1470511368,1,52,52,1361049102394,1361049102394,1470483762,1470483762,0
1361049130,1470511368,1,46,46,1361049102394,1361049102394,1470483762,1470483762,0
1361049130,1470511368,1,52,52,1361049102394,1361049102394,1470483762,1470483762,0
1361049130,1470511368,1,52,52,1361049102394,1361049102394,1470483762,1470483762,0
1361049130,1470511368,1,52,52,1361049102394,1361049102394,1470483762,1470483762,0
1361049130,1470511368,1,52,52,1361049102394,1361049102394,1470483762,1470483762,0
1361049130,1470511368,1,46,46,1361049102394,1361049102394,1470483762,1470483762,0
1361049130,1470511368,1,52,52,1361049102392,1361049102392,1470483760,1470483760,0
1361049130,1470511368,1,52,52,1361049102392,1361049102392,1470483760,1470483760,0
1361049130,1470511368,1,46,46,1361049102392,1361049102392,1470483760,1470483760,0
1361049130,1470511368,1,52,52,1361049102391,1361049102391,1470483759,1470483759,0
1361049130,1470511368,1,52,52,1361049102391,1361049102391,1470483759,1470483759,0
1361049130,1470511368,1,52,52,1361049102391,1361049102391,1470483759,1470483759,0
1361049130,1470511368,1,52,52,1361049102391,1361049102391,1470483759,1470483759,0
1361049134,1470515344,3,456,152,1361049107282,1361049107346,1470488626,1470488690,64
1361049135,108829892,1,52,52,1361049108519,1361049108519,108803411,108803411,0
1361049135,108829952,1,52,52,1361049108458,1361049108458,108803410,108803410,0
1361049138,1470519444,1,52,52,1361049112747,1361049112747,1470494191,1470494191,0
1361049140,1470521808,5,593,118.6,1361049115071,1361049136255,1470496879,1470518063,21184
1361049140,1470521876,5,453,90.6,1361049136250,1361049136314,1470518126,1470518190,64
1361049142,1470523268,1,52,52,1361049116379,1361049116379,1470497647,1470497647,0
1361049142,1470523276,1,52,52,1361049114450,1361049114450,1470495726,1470495726,0
1361049142,1470523280,1,52,52,1361049114511,1361049114511,1470495791,1470495791,0
1361049146,1470527320,1,46,46,1361049119272,1361049119272,1470500592,1470500592,0
1361049146,1470527348,2,555,277.5,1361049120205,1361049120269,1470501553,1470501617,64
1361049146,1470527432,3,138,46,1361049119418,1361049128506,1470500850,1470509938,9088
1361049148,1470529780,3,581,193.6666667,1361049145562,1361049145754,1470527342,1470527534,192
1361049148,1470529780,3,993,331,1361049145562,1361049145690,1470527342,1470527470,128
1361049148,1470529780,3,643,214.3333333,1361049145883,1361049145947,1470527663,1470527727,64
1361049148,1470529780,4,592,148,1361049145883,1361049145947,1470527663,1470527727,64
1361049148,1470529780,10,5915,591.5,1361049145947,1361049146267,1470527727,1470528047,320
1361049148,1470529784,5,594,118.8,1361049145942,1361049146198,1470527726,1470527982,256
1361049148,1470529784,7,2675,382.1428571,1361049146074,1361049146266,1470527858,1470528050,192
1361049148,1470529784,3,311,103.6666667,1361049146073,1361049146201,1470527857,1470527985,128
1361049148,1470529784,6,2773,462.1666667,1361049146073,1361049146457,1470527857,1470528241,384
1361049148,1470529784,15,16113,1074.2,1361049142487,1361049142871,1470524271,1470524655,384
1361049148,1470529784,8,6861,857.625,1361049146263,1361049146455,1470528047,1470528239,192
1361049148,1470529784,18,12739,707.7222222,1361049142678,1361049143062,1470524462,1470524846,384
1361049148,1470529788,5,1688,337.6,1361049146454,1361049146646,1470528242,1470528434,192
1361049148,1470529788,5,594,118.8,1361049146517,1361049146709,1470528305,1470528497,192
1361049148,1470529788,3,947,315.6666667,1361049142869,1361049143061,1470524657,1470524849,192
1361049148,1470529788,13,12704,977.2307692,1361049142932,1361049143316,1470524720,1470525104,384
1361049148,1470529788,4,1611,402.75,1361049146644,1361049147028,1470528432,1470528816,384
1361049148,1470529788,7,3224,460.5714286,1361049143059,1361049143059,1470524847,1470524847,0
1361049148,1470529788,11,10648,968,1361049143187,1361049143251,1470524975,1470525039,64
1361049148,1470529788,4,2112,528,1361049142995,1361049143187,1470524783,1470524975,192
1361049148,1470529788,5,1366,273.2,1361049143058,1361049143058,1470524846,1470524846,0
1361049148,1470529792,5,824,164.8,1361049143118,1361049143182,1470524910,1470524974,64
1361049148,1470529792,5,965,193,1361049146766,1361049146894,1470528558,1470528686,128
1361049148,1470529792,6,2319,386.5,1361049143246,1361049143438,1470525038,1470525230,192
1361049148,1470529792,5,2765,553,1361049146770,1361049146962,1470528562,1470528754,192
1361049148,1470529792,5,975,195,1361049143186,1361049143250,1470524978,1470525042,64
1361049148,1470529792,8,4816,602,1361049143314,1361049143442,1470525106,1470525234,128
1361049148,1470529792,7,5768,824,1361049143186,1361049143378,1470524978,1470525170,192
1361049148,1470529792,16,18490,1155.625,1361049146834,1361049146962,1470528626,1470528754,128
1361049148,1470529792,4,552,138,1361049143505,1361049143697,1470525297,1470525489,192
1361049148,1470529792,4,1560,390,1361049143440,1361049143504,1470525232,1470525296,64
1361049148,1470529792,28,35680,1274.285714,1361049143440,1361049143632,1470525232,1470525424,192
1361049148,1470529792,5,944,188.8,1361049143632,1361049143696,1470525424,1470525488,64
1361049148,1470529792,5,973,194.6,1361049146960,1361049147088,1470528752,1470528880,128
1361049148,1470529792,5,1539,307.8,1361049147024,1361049147024,1470528816,1470528816,0
1361049148,1470529792,5,2734,546.8,1361049147024,1361049147024,1470528816,1470528816,0
1361049148,1470529792,3,908,302.6666667,1361049143631,1361049143695,1470525423,1470525487,64
1361049148,1470529792,6,2280,380,1361049143631,1361049143695,1470525423,1470525487,64
1361049148,1470529792,40,52503,1312.575,1361049143695,1361049143823,1470525487,1470525615,128
1361049148,1470529792,3,1056,352,1361049143759,1361049143823,1470525551,1470525615,64
1361049148,1470529792,5,982,196.4,1361049143759,1361049143823,1470525551,1470525615,64
1361049148,1470529792,53,70228,1325.056604,1361049143759,1361049143823,1470525551,1470525615,64
1361049148,1470529792,5,774,154.8,1361049147023,1361049147087,1470528815,1470528879,64
1361049148,1470529792,5,864,172.8,1361049147023,1361049147087,1470528815,1470528879,64
1361049148,1470529792,7,5050,721.4285714,1361049143758,1361049143822,1470525550,1470525614,64
1361049148,1470529792,3,647,215.6666667,1361049143758,1361049143886,1470525550,1470525678,128
1361049148,1470529796,42,55210,1314.52381,1361049143818,1361049143946,1470525614,1470525742,128
1361049148,1470529796,6,2767,461.1666667,1361049143818,1361049143882,1470525614,1470525678,64
1361049148,1470529796,5,1268,253.6,1361049143818,1361049143882,1470525614,1470525678,64
1361049148,1470529796,30,37604,1253.466667,1361049143822,1361049143950,1470525618,1470525746,128
1361049148,1470529796,6,2752,458.6666667,1361049143822,1361049143886,1470525618,1470525682,64
1361049148,1470529796,5,1277,255.4,1361049143822,1361049143886,1470525618,1470525682,64
1361049148,1470529796,40,52288,1307.2,1361049147086,1361049147278,1470528882,1470529074,192
1361049148,1470529796,5,1869,373.8,1361049143886,1361049143950,1470525682,1470525746,64
1361049148,1470529796,3,632,210.6666667,1361049143886,1361049143950,1470525682,1470525746,64
1361049148,1470529796,7,4007,572.4285714,1361049147086,1361049147150,1470528882,1470528946,64
1361049148,1470529796,3,961,320.3333333,1361049143886,1361049143950,1470525682,1470525746,64
1361049148,1470529796,7,4022,574.5714286,1361049143949,1361049144717,1470525745,1470526513,768
1361049148,1470529796,8,6284,785.5,1361049147149,1361049147213,1470528945,1470529009,64
1361049148,1470529796,12,12785,1065.416667,1361049144013,1361049144013,1470525809,1470525809,0
1361049148,1470529796,6,3799,633.1666667,1361049143949,1361049143949,1470525745,1470525745,0
1361049148,1470529796,29,35585,1227.068966,1361049143949,1361049144013,1470525745,1470525809,64
1361049148,1470529796,83,113178,1363.590361,1361049147213,1361049147405,1470529009,1470529201,192
1361049148,1470529812,13,13154,1011.846154,1361049143996,1361049144060,1470525808,1470525872,64
1361049148,1470529812,8,6216,777,1361049144059,1361049144123,1470525871,1470525935,64
1361049148,1470529812,8,6217,777.125,1361049144058,1361049144122,1470525870,1470525934,64
1361049148,1470529812,6,4195,699.1666667,1361049144058,1361049144122,1470525870,1470525934,64
1361049148,1470529816,30,37389,1246.3,1361049147258,1361049147322,1470529074,1470529138,64
1361049148,1470529816,30,38129,1270.966667,1361049147321,1361049147385,1470529137,1470529201,64
1361049148,1470529816,6,2962,493.6666667,1361049147385,1361049147449,1470529201,1470529265,64
1361049148,1470529816,37,47497,1283.702703,1361049147385,1361049147513,1470529201,1470529329,128
1361049148,1470529816,5,1319,263.8,1361049147448,1361049147640,1470529264,1470529456,192
1361049148,1470529816,21,24572,1170.095238,1361049147448,1361049147512,1470529264,1470529328,64
1361049148,1470529816,12,12570,1047.5,1361049147511,1361049147575,1470529327,1470529391,64
1361049148,1470529816,7,5065,723.5714286,1361049147575,1361049147639,1470529391,1470529455,64
1361049148,1470529816,11,10747,977,1361049147575,1361049147639,1470529391,1470529455,64
1361049148,1470529816,12,12581,1048.416667,1361049147575,1361049147639,1470529391,1470529455,64
1361049148,1470529816,8,6002,750.25,1361049147639,1361049147703,1470529455,1470529519,64
1361049148,1470529816,8,6000,750,1361049147638,1361049147702,1470529454,1470529518,64
1361049148,1470529816,14,14547,1039.071429,1361049147638,1361049147702,1470529454,1470529518,64
1361049148,1470529816,5,1528,305.6,1361049147638,1361049147702,1470529454,1470529518,64
1361049148,1470529820,4,925,231.25,1361049147702,1361049147830,1470529522,1470529650,128
1361049148,1470529820,4,927,231.75,1361049144565,1361049144629,1470526385,1470526449,64
1361049148,1470529820,3,581,193.6666667,1361049144885,1361049145077,1470526705,1470526897,192
1361049148,1470529820,5,594,118.8,1361049144692,1361049144756,1470526512,1470526576,64
1361049148,1470529820,5,3173,634.6,1361049144692,1361049144820,1470526512,1470526640,128
1361049148,1470529820,3,635,211.6666667,1361049145076,1361049145204,1470526896,1470527024,128
1361049148,1470529820,3,942,314,1361049144948,1361049145012,1470526768,1470526832,64
1361049148,1470529820,7,3422,488.8571429,1361049145012,1361049145268,1470526832,1470527088,256
1361049148,1470529820,3,634,211.3333333,1361049145203,1361049145203,1470527023,1470527023,0
1361049148,1470529820,5,594,118.8,1361049145331,1361049145331,1470527151,1470527151,0
1361049148,1470529820,5,2824,564.8,1361049145331,1361049145651,1470527151,1470527471,320
1361049148,1470529824,3,635,211.6666667,1361049145712,1361049145904,1470527536,1470527728,192
1361049148,1470529824,18,21404,1189.111111,1361049145838,1361049145966,1470527662,1470527790,128
1361049148,1470529828,6,2482,413.6666667,1361049145898,1361049146026,1470527726,1470527854,128
1361049148,1470529828,4,1248,312,1361049145898,1361049145962,1470527726,1470527790,64
1361049148,1470529828,3,634,211.3333333,1361049145902,1361049145902,1470527730,1470527730,0
1361049148,1470529828,5,623,124.6,1361049145902,1361049146030,1470527730,1470527858,128
1361049148,1470529828,9,8552,950.2222222,1361049141996,1361049142380,1470523824,1470524208,384
1361049148,1470529828,7,3558,508.2857143,1361049146028,1361049146220,1470527856,1470528048,192
1361049148,1470529832,6,2768,461.3333333,1361049146409,1361049146665,1470528241,1470528497,256
1361049148,1470529832,11,11119,1010.818182,1361049146345,1361049146537,1470528177,1470528369,192
1361049148,1470529832,21,11352,540.5714286,1361049142569,1361049142697,1470524401,1470524529,128
1361049148,1470529832,5,623,124.6,1361049146409,1361049146473,1470528241,1470528305,64
1361049148,1470529832,3,862,287.3333333,1361049142824,1361049143016,1470524656,1470524848,192
1361049148,1470529832,10,10049,1004.9,1361049142888,1361049142952,1470524720,1470524784,64
1361049148,1470529832,29,35522,1224.896552,1361049142632,1361049143784,1470524464,1470525616,1152
1361049148,1470529832,8,6882,860.25,1361049143014,1361049143014,1470524846,1470524846,0
1361049148,1470529832,5,846,169.2,1361049143014,1361049143014,1470524846,1470524846,0
1361049148,1470529852,5,925,185,1361049143062,1361049143126,1470524914,1470524978,64
1361049148,1470529852,5,974,194.8,1361049143125,1361049143189,1470524977,1470525041,64
1361049148,1470529852,7,5297,756.7142857,1361049143125,1361049143189,1470524977,1470525041,64
1361049148,1470529852,6,747,124.5,1361049143125,1361049143253,1470524977,1470525105,128
1361049148,1470529852,3,899,299.6666667,1361049143125,1361049143253,1470524977,1470525105,128
1361049148,1470529852,9,7440,826.6666667,1361049143189,1361049143381,1470525041,1470525233,192
1361049148,1470529852,6,2677,446.1666667,1361049143189,1361049143253,1470525041,1470525105,64
1361049148,1470529852,4,1570,392.5,1361049146709,1361049146901,1470528561,1470528753,192
1361049148,1470529852,3,443,147.6666667,1361049143189,1361049143381,1470525041,1470525233,192
1361049148,1470529852,37,48401,1308.135135,1361049142997,1361049143125,1470524849,1470524977,128
1361049148,1470529852,7,5773,824.7142857,1361049142996,1361049143060,1470524848,1470524912,64
1361049148,1470529852,6,3088,514.6666667,1361049143252,1361049143380,1470525104,1470525232,128
1361049148,1470529852,8,6823,852.875,1361049143060,1361049143124,1470524912,1470524976,64
1361049148,1470529852,8,6918,864.75,1361049143060,1361049143124,1470524912,1470524976,64
1361049148,1470529852,5,973,194.6,1361049143060,1361049143124,1470524912,1470524976,64
1361049148,1470529852,6,2856,476,1361049143123,1361049143187,1470524975,1470525039,64
1361049148,1470529852,7,3667,523.8571429,1361049143123,1361049143187,1470524975,1470525039,64
1361049148,1470529852,4,651,162.75,1361049143123,1361049143187,1470524975,1470525039,64
1361049148,1470529852,5,971,194.2,1361049146899,1361049146963,1470528751,1470528815,64
1361049148,1470529852,5,1277,255.4,1361049146963,1361049146963,1470528815,1470528815,0
1361049148,1470529852,6,3445,574.1666667,1361049143379,1361049143571,1470525231,1470525423,192
1361049148,1470529852,5,700,140,1361049146963,1361049147027,1470528815,1470528879,64
1361049148,1470529852,5,966,193.2,1361049146899,1361049146963,1470528751,1470528815,64
1361049148,1470529852,5,980,196,1361049146899,1361049146963,1470528751,1470528815,64
1361049148,1470529852,7,4879,697,1361049146963,1361049147027,1470528815,1470528879,64
1361049148,1470529852,6,3073,512.1666667,1361049143443,1361049143571,1470525295,1470525423,128
1361049148,1470529852,5,623,124.6,1361049146963,1361049147027,1470528815,1470528879,64
1361049148,1470529852,32,40797,1274.90625,1361049146962,1361049147026,1470528814,1470528878,64
1361049148,1470529856,5,455,91,1361049146958,1361049147086,1470528814,1470528942,128
1361049148,1470529856,22,26174,1189.727273,1361049143378,1361049143442,1470525234,1470525298,64
1361049148,1470529856,4,1441,360.25,1361049143633,1361049143697,1470525489,1470525553,64
1361049148,1470529856,5,1401,280.2,1361049147025,1361049147089,1470528881,1470528945,64
1361049148,1470529856,7,4159,594.1428571,1361049147089,1361049147281,1470528945,1470529137,192
1361049148,1470529856,7,3203,457.5714286,1361049143697,1361049143761,1470525553,1470525617,64
1361049148,1470529856,7,3539,505.5714286,1361049143697,1361049143761,1470525553,1470525617,64
1361049148,1470529856,5,1898,379.6,1361049143697,1361049143761,1470525553,1470525617,64
1361049148,1470529856,83,113392,1366.168675,1361049143761,1361049143889,1470525617,1470525745,128
1361049148,1470529856,44,57202,1300.045455,1361049147089,1361049147217,1470528945,1470529073,128
1361049148,1470529856,6,2485,414.1666667,1361049143568,1361049143632,1470525424,1470525488,64
1361049148,1470529856,3,1064,354.6666667,1361049143760,1361049143824,1470525616,1470525680,64
1361049148,1470529856,30,38344,1278.133333,1361049143760,1361049143888,1470525616,1470525744,128
1361049148,1470529856,24,29080,1211.666667,1361049143760,1361049143888,1470525616,1470525744,128
1361049148,1470529856,57,75486,1324.315789,1361049143760,1361049143952,1470525616,1470525808,192
1361049148,1470529856,14,14563,1040.214286,1361049143824,1361049143888,1470525680,1470525744,64
1361049148,1470529856,10,9797,979.7,1361049147088,1361049147152,1470528944,1470529008,64
1361049148,1470529856,6,4171,695.1666667,1361049143632,1361049143696,1470525488,1470525552,64
1361049148,1470529856,8,6499,812.375,1361049143632,1361049143696,1470525488,1470525552,64
1361049148,1470529856,21,25777,1227.47619,1361049143824,1361049143952,1470525680,1470525808,128
1361049148,1470529856,44,57417,1304.931818,1361049143696,1361049143760,1470525552,1470525616,64
1361049148,1470529856,53,70014,1321.018868,1361049147152,1361049147280,1470529008,1470529136,128
1361049148,1470529856,5,961,192.2,1361049143696,1361049143760,1470525552,1470525616,64
1361049148,1470529856,7,4166,595.1428571,1361049143824,1361049143952,1470525680,1470525808,128
1361049148,1470529856,7,4063,580.4285714,1361049143696,1361049143760,1470525552,1470525616,64
1361049148,1470529856,3,647,215.6666667,1361049143696,1361049143824,1470525552,1470525680,128
1361049148,1470529856,103,141861,1377.291262,1361049143759,1361049143887,1470525615,1470525743,128
1361049148,1470529856,30,37924,1264.133333,1361049143887,1361049143951,1470525743,1470525807,64
1361049148,1470529856,18,19826,1101.444444,1361049143887,1361049143951,1470525743,1470525807,64
1361049148,1470529856,6,3365,560.8333333,1361049147151,1361049147215,1470529007,1470529071,64
1361049148,1470529856,42,54995,1309.404762,1361049147151,1361049147343,1470529007,1470529199,192
1361049148,1470529856,7,3312,473.1428571,1361049143759,1361049143823,1470525615,1470525679,64
1361049148,1470529856,5,664,132.8,1361049147215,1361049147343,1470529071,1470529199,128
1361049148,1470529856,3,632,210.6666667,1361049143823,1361049143887,1470525679,1470525743,64
1361049148,1470529856,8,4273,534.125,1361049143823,1361049143951,1470525679,1470525807,128
1361049148,1470529856,37,47712,1289.513514,1361049143887,1361049143951,1470525743,1470525807,64
1361049148,1470529856,31,39160,1263.225806,1361049143887,1361049143951,1470525743,1470525807,64
1361049148,1470529856,7,5280,754.2857143,1361049144014,1361049144078,1470525870,1470525934,64
1361049148,1470529856,25,28974,1158.96,1361049143950,1361049144206,1470525806,1470526062,256
1361049148,1470529856,103,141647,1375.213592,1361049147150,1361049147406,1470529006,1470529262,256
1361049148,1470529860,7,3635,519.2857143,1361049147406,1361049147406,1470529266,1470529266,0
1361049148,1470529860,31,38945,1256.290323,1361049147406,1361049147534,1470529266,1470529394,128
1361049148,1470529860,8,7111,888.875,1361049147405,1361049147469,1470529265,1470529329,64
1361049148,1470529860,12,12397,1033.083333,1361049147469,1361049147533,1470529329,1470529393,64
1361049148,1470529860,24,28865,1202.708333,1361049147341,1361049147405,1470529201,1470529265,64
1361049148,1470529860,12,12887,1073.916667,1361049147533,1361049147597,1470529393,1470529457,64
1361049148,1470529860,5,759,151.8,1361049147533,1361049147661,1470529393,1470529521,128
1361049148,1470529860,30,37709,1256.966667,1361049147405,1361049147469,1470529265,1470529329,64
1361049148,1470529860,15,11459,763.9333333,1361049144269,1361049144397,1470526129,1470526257,128
1361049148,1470529860,4,712,178,1361049144205,1361049144397,1470526065,1470526257,192
1361049148,1470529860,7,4030,575.7142857,1361049147596,1361049147660,1470529456,1470529520,64
1361049148,1470529860,5,443,88.6,1361049144396,1361049144460,1470526256,1470526320,64
1361049148,1470529860,4,927,231.75,1361049144522,1361049144586,1470526382,1470526446,64
1361049148,1470529864,3,889,296.3333333,1361049144778,1361049144842,1470526642,1470526706,64
1361049148,1470529864,3,1037,345.6666667,1361049144841,1361049144841,1470526705,1470526705,0
1361049148,1470529864,3,1045,348.3333333,1361049144905,1361049144905,1470526769,1470526769,0
1361049148,1470529864,3,643,214.3333333,1361049145097,1361049145161,1470526961,1470527025,64
1361049148,1470529864,6,2788,464.6666667,1361049145224,1361049145800,1470527088,1470527664,576
1361049147,108841984,5,516,103.2,1361049147080,1361049147144,108842064,108842128,64
1361049151,108845636,5,1590,318,1361049147303,1361049147367,108841939,108842003,64
1361049151,108845636,14,15672,1119.428571,1361049144295,1361049144359,108838931,108838995,64
1361049151,108845636,7,5479,782.7142857,1361049144422,1361049144806,108839058,108839442,384
1361049151,108845636,28,35757,1277.035714,1361049144678,1361049144806,108839314,108839442,128
1361049151,108845636,4,798,199.5,1361049144870,1361049145126,108839506,108839762,256
1361049151,108845636,21,24974,1189.238095,1361049145318,1361049145382,108839954,108840018,64
1361049151,108845636,5,1473,294.6,1361049145190,1361049145382,108839826,108840018,192
1361049151,108845636,4,464,116,1361049145190,1361049145318,108839826,108839954,128
1361049151,108845636,33,42232,1279.757576,1361049145382,1361049145446,108840018,108840082,64
1361049151,108845636,5,1168,233.6,1361049146596,1361049146724,108841232,108841360,128
1361049151,108845636,30,37917,1263.9,1361049146596,1361049146724,108841232,108841360,128
1361049151,108845652,11,10406,946,1361049143000,1361049143000,108837652,108837652,0
1361049151,108845652,5,1596,319.2,1361049147287,1361049147351,108841939,108842003,64
1361049151,108845652,5,516,103.2,1361049147415,1361049147479,108842067,108842131,64
1361049151,108845652,4,675,168.75,1361049143959,1361049144023,108838611,108838675,64
1361049151,108845652,5,2639,527.8,1361049144278,1361049144342,108838930,108838994,64
1361049151,108845652,19,22273,1172.263158,1361049144406,1361049144598,108839058,108839250,192
1361049151,108845652,32,40138,1254.3125,1361049144598,1361049144790,108839250,108839442,192
1361049151,108845652,4,798,199.5,1361049144854,1361049145174,108839506,108839826,320
1361049151,108845652,4,1173,293.25,1361049145173,1361049145173,108839825,108839825,0
1361049151,108845652,5,1473,294.6,1361049145812,1361049145940,108840464,108840592,128
1361049151,108845652,4,803,200.75,1361049146004,1361049146004,108840656,108840656,0
1361049154,1470535336,1,52,52,1361049127702,1361049127702,1470509038,1470509038,0
1361049154,1470535336,4,1040,260,1361049127706,1361049137818,1470509042,1470519154,10112
1361049154,1470535336,7,1196,170.8571429,1361049127833,1361049137945,1470509169,1470519281,10112
1361049156,1470537780,4,927,231.75,1361049150556,1361049150620,1470532336,1470532400,64
1361049156,1470537788,11,9352,850.1818182,1361049154579,1361049154963,1470536367,1470536751,384
1361049156,1470537788,9,4406,489.5555556,1361049147027,1361049152211,1470528815,1470533999,5184
1361049156,1470537816,9,7368,818.6666667,1361049154999,1361049155063,1470536815,1470536879,64
1361049156,1470537820,15,10792,719.4666667,1361049155126,1361049155382,1470536946,1470537202,256
1361049156,1470537820,14,7179,512.7857143,1361049147381,1361049148405,1470529201,1470530225,1024
1361049156,1470537820,23,11493,499.6956522,1361049154997,1361049155189,1470536817,1470537009,192
1361049156,1470537820,1323,1879747,1420.821618,1361049120437,1361049154165,1470502257,1470535985,33728
1361049156,1470537820,6,2127,354.5,1361049155124,1361049155316,1470536944,1470537136,192
1361049156,1470537820,7,2484,354.8571429,1361049155378,1361049155570,1470537198,1470537390,192
1361049156,1470537824,4,652,163,1361049155313,1361049155441,1470537137,1470537265,128
1361049156,1470537824,3,968,322.6666667,1361049155633,1361049155697,1470537457,1470537521,64
1361049156,1470537824,3,840,280,1361049155568,1361049155632,1470537392,1470537456,64
1361049156,1470537824,3,893,297.6666667,1361049155696,1361049155760,1470537520,1470537584,64
1361049156,1470537860,5,1603,320.6,1361049148620,1361049148684,1470530480,1470530544,64
1361049156,1470537864,9,4359,484.3333333,1361049147081,1361049150345,1470528945,1470532209,3264
1361049156,1470537868,4,652,163,1361049154949,1361049155077,1470536817,1470536945,128
1361049156,1470537868,6,2127,354.5,1361049155395,1361049155587,1470537263,1470537455,192
1361049156,1470537872,7,2482,354.5714286,1361049155326,1361049155518,1470537198,1470537390,192
1361049156,1470537892,3,976,325.3333333,1361049155627,1361049155627,1470537519,1470537519,0
1361049159,108853636,31,38872,1253.935484,1361049156520,1361049156648,108851156,108851284,128
1361049159,108853640,4,1137,284.25,1361049156643,1361049156643,108851283,108851283,0
1361049159,108853644,11,10406,946,1361049155423,1361049155679,108850067,108850323,256
1361049159,108853644,7,4746,678,1361049156382,1361049156382,108851026,108851026,0
1361049159,108853644,5,764,152.8,1361049156638,1361049156894,108851282,108851538,256
1361049159,108853644,7,4746,678,1361049156702,1361049156830,108851346,108851474,128
1361049163,108857932,5,3832,766.4,1361049136254,1361049136254,108831186,108831186,0
1361049164,1470545784,11,9120,829.0909091,1361049161687,1361049162071,1470543471,1470543855,384
1361049164,1470545788,3,581,193.6666667,1361049156371,1361049156563,1470538159,1470538351,192
1361049164,1470545788,6,1400,233.3333333,1361049156371,1361049156563,1470538159,1470538351,192
1361049164,1470545792,20,8204,410.2,1361049162193,1361049162385,1470543985,1470544177,192
1361049164,1470545792,21,8237,392.2380952,1361049162193,1361049162385,1470543985,1470544177,192
1361049164,1470545792,4,1224,306,1361049156561,1361049156625,1470538353,1470538417,64
1361049164,1470545792,24,27668,1152.833333,1361049162320,1361049163280,1470544112,1470545072,960
1361049164,1470545796,3,866,288.6666667,1361049162891,1361049162891,1470544687,1470544687,0
1361049164,1470545800,3,919,306.3333333,1361049163014,1361049163014,1470544814,1470544814,0
1361049164,1470545800,3,1008,336,1361049162889,1361049162953,1470544689,1470544753,64
1361049164,1470545812,3,1016,338.6666667,1361049162941,1361049163005,1470544753,1470544817,64
1361049164,1470545816,6,1466,244.3333333,1361049163065,1361049163833,1470544881,1470545649,768
1361049164,1470545824,7,2485,355,1361049155632,1361049156080,1470537456,1470537904,448
1361049164,1470545824,7,3418,488.2857143,1361049155760,1361049156080,1470537584,1470537904,320
1361049164,1470545828,5,594,118.8,1361049156076,1361049156140,1470537904,1470537968,64
1361049164,1470545828,5,2823,564.6,1361049156075,1361049156267,1470537903,1470538095,192
1361049164,1470545828,5,532,106.4,1361049156202,1361049156394,1470538030,1470538222,192
1361049164,1470545832,3,993,331,1361049156330,1361049156458,1470538162,1470538290,128
1361049164,1470545832,3,1471,490.3333333,1361049162088,1361049162216,1470543920,1470544048,128
1361049164,1470545860,6,3561,593.5,1361049162189,1361049162317,1470544049,1470544177,128
1361049164,1470545860,7,2576,368,1361049162189,1361049162381,1470544049,1470544241,192
1361049164,1470545860,15,10792,719.4666667,1361049162251,1361049162443,1470544111,1470544303,192
1361049164,1470545860,9,4272,474.6666667,1361049162315,1361049162507,1470544175,1470544367,192
1361049164,1470545860,6,717,119.5,1361049156619,1361049156939,1470538479,1470538799,320
1361049164,1470545860,4,651,162.75,1361049162379,1361049162507,1470544239,1470544367,128
1361049164,1470545864,6,2343,390.5,1361049162504,1361049162632,1470544368,1470544496,128
1361049164,1470545864,7,3026,432.2857143,1361049162440,1361049162888,1470544304,1470544752,448
1361049164,1470545868,6,3445,574.1666667,1361049162690,1361049162882,1470544558,1470544750,192
1361049164,1470545868,5,532,106.4,1361049162883,1361049163011,1470544751,1470544879,128
1361049164,1470545868,7,4022,574.5714286,1361049162946,1361049163714,1470544814,1470545582,768
1361049164,1470545872,11,10295,935.9090909,1361049163071,1361049163775,1470544943,1470545647,704
1361049164,1470545876,24,28945,1206.041667,1361049155069,1361049156541,1470536945,1470538417,1472
1361049164,1470545880,7,3039,434.1428571,1361049155514,1361049156154,1470537394,1470538034,640
1361049164,1470545880,3,502,167.3333333,1361049163769,1361049163769,1470545649,1470545649,0
1361049164,1470545880,7,2843,406.1428571,1361049155513,1361049155961,1470537393,1470537841,448
1361049164,1470545900,7,2847,406.7142857,1361049155747,1361049156259,1470537647,1470538159,512
1361049167,108861636,4,1153,288.25,1361049165156,1361049165220,108859792,108859856,64
1361049167,108861640,4,1153,288.25,1361049165155,1361049165219,108859795,108859859,64
1361049167,108861640,11,10406,946,1361049162658,1361049162722,108857298,108857362,64
1361049167,108861640,5,1453,290.6,1361049165794,1361049165858,108860434,108860498,64
1361049167,108861640,4,464,116,1361049166626,1361049166690,108861266,108861330,64
1361049167,108861640,5,1590,318,1361049166818,1361049166818,108861458,108861458,0
1361049167,108861640,16,18115,1132.1875,1361049163234,1361049163298,108857874,108857938,64
1361049167,108861644,4,464,116,1361049165214,1361049165214,108859858,108859858,0
1361049167,108861644,4,464,116,1361049165214,1361049165598,108859858,108860242,384
1361049167,108861644,4,1153,288.25,1361049166556,1361049166556,108861200,108861200,0
1361049170,1470551348,1,46,46,1361049145354,1361049145354,1470526702,1470526702,0
1361049170,1470551408,1,46,46,1361049143569,1361049143569,1470524977,1470524977,0
1361049172,1470553788,11,1282,116.5454545,1361049169427,1361049169683,1470551215,1470551471,256
1361049172,1470553788,3,989,329.6666667,1361049165522,1361049165586,1470547310,1470547374,64
1361049172,1470553792,3,997,332.3333333,1361049165585,1361049165585,1470547377,1470547377,0
1361049172,1470553792,5,623,124.6,1361049165585,1361049165649,1470547377,1470547441,64
1361049172,1470553792,3,900,300,1361049165585,1361049165649,1470547377,1470547441,64
1361049172,1470553792,5,453,90.6,1361049169679,1361049169743,1470551471,1470551535,64
1361049172,1470553792,3,642,214,1361049165839,1361049165839,1470547631,1470547631,0
1361049172,1470553792,3,634,211.3333333,1361049165711,1361049165903,1470547503,1470547695,192
1361049172,1470553792,74,53224,719.2432432,1361049169679,1361049169999,1470551471,1470551791,320
1361049172,1470553792,5,1688,337.6,1361049166030,1361049166222,1470547822,1470548014,192
1361049172,1470553796,3,633,211,1361049165837,1361049165901,1470547633,1470547697,64
1361049172,1470553796,5,594,118.8,1361049165901,1361049165965,1470547697,1470547761,64
1361049172,1470553796,6,2771,461.8333333,1361049165965,1361049166477,1470547761,1470548273,512
1361049172,1470553796,4,1611,402.75,1361049166218,1361049166410,1470548014,1470548206,192
1361049172,1470553800,18,21406,1189.222222,1361049166278,1361049166406,1470548078,1470548206,128
1361049172,1470553800,5,2766,553.2,1361049166409,1361049166473,1470548209,1470548273,64
1361049172,1470553800,7,3210,458.5714286,1361049166473,1361049166729,1470548273,1470548529,256
1361049172,1470553800,5,700,140,1361049166473,1361049166537,1470548273,1470548337,64
1361049172,1470553800,8,3355,419.375,1361049170120,1361049170184,1470551920,1470551984,64
1361049172,1470553800,3,643,214.3333333,1361049166536,1361049166600,1470548336,1470548400,64
1361049172,1470553800,3,279,93,1361049166408,1361049166600,1470548208,1470548400,192
1361049172,1470553800,5,623,124.6,1361049166472,1361049166536,1470548272,1470548336,64
1361049172,1470553800,5,1020,204,1361049156551,1361049166215,1470538351,1470548015,9664
1361049172,1470553800,3,502,167.3333333,1361049166471,1361049166663,1470548271,1470548463,192
1361049172,1470553804,5,617,123.4,1361049167107,1361049167171,1470548911,1470548975,64
1361049172,1470553808,3,989,329.6666667,1361049164865,1361049164865,1470546673,1470546673,0
1361049172,1470553832,3,997,332.3333333,1361049164838,1361049164902,1470546670,1470546734,64
1361049172,1470553832,1891,2691561,1423.353252,1361049157030,1361049169126,1470538862,1470550958,12096
1361049172,1470553836,3,634,211.3333333,1361049164898,1361049165026,1470546734,1470546862,128
1361049172,1470553836,4,857,214.25,1361049167205,1361049167397,1470549041,1470549233,192
1361049172,1470553836,3,624,208,1361049167460,1361049167524,1470549296,1470549360,64
1361049172,1470553836,7,5490,784.2857143,1361049167331,1361049167395,1470549167,1470549231,64
1361049172,1470553836,3,703,234.3333333,1361049167523,1361049167587,1470549359,1470549423,64
1361049172,1470553836,3,900,300,1361049164899,1361049164899,1470546735,1470546735,0
1361049172,1470553836,3,1049,349.6666667,1361049167587,1361049167587,1470549423,1470549423,0
1361049172,1470553836,8,3468,433.5,1361049164962,1361049165218,1470546798,1470547054,256
1361049172,1470553840,3,642,214,1361049164961,1361049165025,1470546801,1470546865,64
1361049172,1470553840,6,1432,238.6666667,1361049167521,1361049167649,1470549361,1470549489,128
1361049172,1470553840,5,1740,348,1361049167520,1361049167648,1470549360,1470549488,128
1361049172,1470553840,4,548,137,1361049167520,1361049167712,1470549360,1470549552,192
1361049172,1470553840,7,3782,540.2857143,1361049167647,1361049168415,1470549487,1470550255,768
1361049172,1470553848,8,3925,490.625,1361049168920,1361049168984,1470550768,1470550832,64
1361049172,1470553848,12,6768,564,1361049168727,1361049168855,1470550575,1470550703,128
1361049172,1470553848,3,847,282.3333333,1361049165398,1361049165462,1470547246,1470547310,64
1361049172,1470553852,3,847,282.3333333,1361049163925,1361049163925,1470545777,1470545777,0
1361049172,1470553852,3,580,193.3333333,1361049165525,1361049165653,1470547377,1470547505,128
1361049172,1470553852,6,2481,413.5,1361049165589,1361049165717,1470547441,1470547569,128
1361049172,1470553852,3,580,193.3333333,1361049163989,1361049164117,1470545841,1470545969,128
1361049172,1470553852,7,3449,492.7142857,1361049165588,1361049165844,1470547440,1470547696,256
1361049172,1470553852,5,594,118.8,1361049165588,1361049165844,1470547440,1470547696,256
1361049172,1470553852,6,3426,571,1361049165716,1361049165908,1470547568,1470547760,192
1361049172,1470553872,5,2821,564.2,1361049165886,1361049166078,1470547758,1470547950,192
1361049172,1470553876,3,581,193.6666667,1361049166204,1361049166332,1470548080,1470548208,128
1361049172,1470553876,10,5907,590.7,1361049166204,1361049166524,1470548080,1470548400,320
1361049172,1470553876,4,681,170.25,1361049166394,1361049167482,1470548270,1470549358,1088
1361049172,1470553880,3,634,211.3333333,1361049166584,1361049166584,1470548464,1470548464,0
1361049172,1470553880,3,601,200.3333333,1361049166584,1361049167096,1470548464,1470548976,512
1361049172,1470553880,5,2742,548.4,1361049166648,1361049167096,1470548528,1470548976,448
1361049172,1470553880,10,5489,548.9,1361049166711,1361049167095,1470548591,1470548975,384
1361049172,1470553884,4,1134,283.5,1361049164788,1361049164852,1470546672,1470546736,64
1361049172,1470553884,6,2479,413.1666667,1361049167090,1361049167218,1470548974,1470549102,128
1361049172,1470553888,3,502,167.3333333,1361049167089,1361049167281,1470548977,1470549169,192
1361049172,1470553888,3,633,211,1361049164977,1361049164977,1470546865,1470546865,0
1361049172,1470553888,7,4107,586.7142857,1361049167216,1361049167856,1470549104,1470549744,640
1361049172,1470553888,6,2786,464.3333333,1361049165040,1361049165552,1470546928,1470547440,512
1361049172,1470553888,21,25550,1216.666667,1361049167343,1361049167407,1470549231,1470549295,64
1361049172,1470553888,5,1850,370,1361049167343,1361049167407,1470549231,1470549295,64
1361049172,1470553888,5,617,123.4,1361049167343,1361049167407,1470549231,1470549295,64
1361049172,1470553888,3,899,299.6666667,1361049167343,1361049167407,1470549231,1470549295,64
1361049172,1470553888,4,1318,329.5,1361049167406,1361049167534,1470549294,1470549422,128
1361049172,1470553888,4,652,163,1361049167470,1361049167470,1470549358,1470549358,0
1361049172,1470553888,5,1502,300.4,1361049167470,1361049167534,1470549358,1470549422,64
1361049172,1470553888,3,1041,347,1361049167470,1361049167534,1470549358,1470549422,64
1361049172,1470553892,5,950,190,1361049167466,1361049167530,1470549358,1470549422,64
1361049172,1470553892,3,540,180,1361049167466,1361049167530,1470549358,1470549422,64
1361049172,1470553892,4,543,135.75,1361049167466,1361049167530,1470549358,1470549422,64
1361049172,1470553892,3,808,269.3333333,1361049167466,1361049167530,1470549358,1470549422,64
1361049172,1470553892,6,906,151,1361049167466,1361049167658,1470549358,1470549550,192
1361049172,1470553892,8,856,107,1361049167470,1361049167790,1470549362,1470549682,320
1361049172,1470553892,3,858,286,1361049167469,1361049167661,1470549361,1470549553,192
1361049172,1470553892,3,952,317.3333333,1361049167533,1361049167597,1470549425,1470549489,64
1361049172,1470553892,5,594,118.8,1361049165164,1361049165228,1470547056,1470547120,64
1361049172,1470553892,5,2823,564.6,1361049165227,1361049165419,1470547119,1470547311,192
1361049173,1470553916,6,3219,536.5,1361049164733,1361049164861,1470545649,1470545777,128
1361049173,1470553916,5,700,140,1361049169403,1361049169467,1470550319,1470550383,64
1361049173,1470553920,5,594,118.8,1361049169400,1361049169400,1470550320,1470550320,0
1361049174,1470555324,1,46,46,1361049146338,1361049146338,1470527662,1470527662,0
1361049174,1470555440,7,2297,328.1428571,1361049148785,1361049149297,1470530225,1470530737,512
1361049175,108869640,4,699,174.75,1361049167843,1361049167971,108862483,108862611,128
1361049175,108869644,7,4950,707.1428571,1361049167773,1361049167773,108862417,108862417,0
1361049175,108869652,5,516,103.2,1361049166872,1361049167448,108861524,108862100,576
1361049178,1470559292,3,339,113,1361049150915,1361049150979,1470532207,1470532271,64
1361049178,1470559324,2,244,122,1361049151908,1361049151908,1470533232,1470533232,0
1361049180,1470561888,5,1152,230.4,1361049167535,1361049172783,1470549423,1470554671,5248
1361049180,1470561896,11,4982,452.9090909,1361049169000,1361049174248,1470550896,1470556144,5248
1361049182,1470563300,1,60,60,1361049157050,1361049157050,1470538350,1470538350,0
1361049182,1470563300,13,14436,1110.461538,1361049157052,1361049157116,1470538352,1470538416,64
1361049182,1470563404,1,46,46,1361049157011,1361049157011,1470538415,1470538415,0
1361049183,108877904,1,52,52,1361049156059,1361049156059,108850963,108850963,0
1361049186,1470567352,1,46,46,1361049161223,1361049161223,1470542575,1470542575,0
1361049188,1470569832,15,6670,444.6666667,1361049167655,1361049183719,1470549487,1470565551,16064
1361049190,1470571320,1,46,46,1361049162215,1361049162215,1470543535,1470543535,0
1361049190,1470571404,1,46,46,1361049161876,1361049161876,1470543280,1470543280,0
1361049194,1470575328,1,46,46,1361049167967,1361049167967,1470549295,1470549295,0
1361049194,1470575328,94,127421,1355.542553,1361049168030,1361049168286,1470549358,1470549614,256
1361049194,1470575412,1,46,46,1361049167049,1361049167049,1470548461,1470548461,0
1361049194,1470575420,1,52,52,1361049167875,1361049167875,1470549295,1470549295,0
1361049195,108889916,8,2943,367.875,1361049168526,1361049169102,108863442,108864018,576
1361049198,1470579368,1,46,46,1361049170041,1361049170041,1470551409,1470551409,0
1361049204,1470585808,827,1172376,1417.625151,1361049169663,1361049201919,1470551471,1470583727,32256
1361049204,1470585820,5,453,90.6,1361049199604,1361049199668,1470581424,1470581488,64
1361049206,1470587328,1,52,52,1361049178078,1361049178078,1470559406,1470559406,0
1361049206,1470587332,4,1192,298,1361049178202,1361049188250,1470559534,1470569582,10048
1361049206,1470587344,1,46,46,1361049178703,1361049178703,1470560047,1470560047,0
1361049206,1470587384,1,52,52,1361049179625,1361049179625,1470561009,1470561009,0
1361049206,1470587424,4,628,157,1361049177984,1361049178048,1470559408,1470559472,64
1361049210,1470591348,1,46,46,1361049184075,1361049184075,1470565423,1470565423,0
1361049212,1470593848,13,12574,967.2307692,1361049210904,1361049211288,1470592752,1470593136,384
1361049212,1470593852,4,1496,374,1361049211411,1361049211475,1470593263,1470593327,64
1361049212,1470593852,4,652,163,1361049211411,1361049211475,1470593263,1470593327,64
1361049212,1470593852,4,611,152.75,1361049211411,1361049211539,1470593263,1470593391,128
1361049212,1470593852,20,11227,561.35,1361049211474,1361049211666,1470593326,1470593518,192
1361049212,1470593860,6,2328,388,1361049211529,1361049211657,1470593389,1470593517,128
1361049215,108909648,11,10406,946,1361049212059,1361049212315,108906707,108906963,256
1361049215,108909648,4,801,200.25,1361049212506,1361049212506,108907154,108907154,0
1361049215,108909648,5,1365,273,1361049212442,1361049212506,108907090,108907154,64
1361049215,108909648,4,807,201.75,1361049212826,1361049212826,108907474,108907474,0
1361049215,108909648,27,33871,1254.481481,1361049212826,1361049212890,108907474,108907538,64
1361049215,108909656,4,525,131.25,1361049212819,1361049213267,108907475,108907923,448
1361049215,108909656,5,1365,273,1361049213649,1361049214289,108908305,108908945,640
1361049220,1470601812,3,993,331,1361049212028,1361049212220,1470593840,1470594032,192
1361049220,1470601812,4,1163,290.75,1361049212218,1361049212346,1470594030,1470594158,128
1361049220,1470601812,6,4221,703.5,1361049213625,1361049214585,1470595437,1470596397,960
1361049220,1470601812,3,796,265.3333333,1361049212217,1361049212281,1470594029,1470594093,64
1361049220,1470601816,3,930,310,1361049212277,1361049212277,1470594093,1470594093,0
1361049220,1470601816,3,643,214.3333333,1361049212344,1361049212408,1470594160,1470594224,64
1361049220,1470601816,6,2672,445.3333333,1361049212343,1361049212535,1470594159,1470594351,192
1361049220,1470601816,9,7283,809.2222222,1361049212407,1361049212663,1470594223,1470594479,256
1361049220,1470601816,3,634,211.3333333,1361049212407,1361049212407,1470594223,1470594223,0
1361049220,1470601816,5,958,191.6,1361049214006,1361049214390,1470595822,1470596206,384
1361049220,1470601816,7,3591,513,1361049214006,1361049214390,1470595822,1470596206,384
1361049220,1470601820,4,555,138.75,1361049214325,1361049214453,1470596145,1470596273,128
1361049220,1470601820,5,1152,230.4,1361049214325,1361049214389,1470596145,1470596209,64
1361049220,1470601820,3,798,266,1361049212660,1361049212724,1470594480,1470594544,64
1361049220,1470601820,3,608,202.6666667,1361049214388,1361049214452,1470596208,1470596272,64
1361049220,1470601820,5,667,133.4,1361049214451,1361049214771,1470596271,1470596591,320
1361049220,1470601820,5,594,118.8,1361049212659,1361049212723,1470594479,1470594543,64
1361049220,1470601820,5,667,133.4,1361049214515,1361049214835,1470596335,1470596655,320
1361049220,1470601820,3,932,310.6666667,1361049212723,1361049212787,1470594543,1470594607,64
1361049220,1470601820,4,592,148,1361049214643,1361049214707,1470596463,1470596527,64
1361049220,1470601820,6,4259,709.8333333,1361049212787,1361049214387,1470594607,1470596207,1600
1361049220,1470601820,10,5852,585.2,1361049214706,1361049215026,1470596526,1470596846,320
1361049220,1470601820,12,5955,496.25,1361049214706,1361049215026,1470596526,1470596846,320
1361049220,1470601820,8,3468,433.5,1361049212850,1361049213106,1470594670,1470594926,256
1361049220,1470601820,6,2771,461.8333333,1361049214770,1361049215154,1470596590,1470596974,384
1361049220,1470601820,5,1369,273.8,1361049214769,1361049215153,1470596589,1470596973,384
1361049220,1470601820,3,279,93,1361049214833,1361049214897,1470596653,1470596717,64
1361049220,1470601824,5,1240,248,1361049215024,1361049215984,1470596848,1470597808,960
1361049220,1470601824,3,502,167.3333333,1361049213039,1361049213167,1470594863,1470594991,128
1361049220,1470601824,5,1145,229,1361049215214,1361049215598,1470597038,1470597422,384
1361049220,1470601824,5,594,118.8,1361049215214,1361049215470,1470597038,1470597294,256
1361049220,1470601824,7,3804,543.4285714,1361049215470,1361049217518,1470597294,1470599342,2048
1361049220,1470601824,9,5674,630.4444444,1361049215470,1361049215726,1470597294,1470597550,256
1361049220,1470601824,5,1322,264.4,1361049215597,1361049215661,1470597421,1470597485,64
1361049220,1470601848,6,2940,490,1361049215637,1361049215765,1470597485,1470597613,128
1361049220,1470601848,5,455,91,1361049215509,1361049215573,1470597357,1470597421,64
1361049220,1470601848,4,610,152.5,1361049215701,1361049215829,1470597549,1470597677,128
1361049220,1470601848,19,21640,1138.947368,1361049215701,1361049215765,1470597549,1470597613,64
1361049220,1470601848,5,913,182.6,1361049215705,1361049215769,1470597553,1470597617,64
1361049220,1470601848,3,164,54.66666667,1361049215769,1361049215833,1470597617,1470597681,64
1361049220,1470601848,4,1327,331.75,1361049215832,1361049215960,1470597680,1470597808,128
1361049220,1470601848,3,625,208.3333333,1361049213208,1361049213336,1470595056,1470595184,128
1361049220,1470601848,5,857,171.4,1361049215704,1361049215768,1470597552,1470597616,64
1361049220,1470601848,6,1000,166.6666667,1361049215704,1361049215832,1470597552,1470597680,128
1361049220,1470601848,3,164,54.66666667,1361049215704,1361049215768,1470597552,1470597616,64
1361049220,1470601848,5,1617,323.4,1361049215832,1361049215960,1470597680,1470597808,128
1361049220,1470601848,7,2916,416.5714286,1361049216023,1361049216599,1470597871,1470598447,576
1361049220,1470601852,6,1081,180.1666667,1361049216341,1361049216469,1470598193,1470598321,128
1361049220,1470601852,6,2481,413.5,1361049216468,1361049216660,1470598320,1470598512,192
1361049220,1470601852,17,12640,743.5294118,1361049211667,1361049211987,1470593519,1470593839,320
1361049220,1470601852,5,2760,552,1361049217106,1361049217170,1470598958,1470599022,64
1361049220,1470601856,6,2337,389.5,1361049213392,1361049213584,1470595248,1470595440,192
1361049220,1470601856,3,634,211.3333333,1361049213518,1361049213646,1470595374,1470595502,128
1361049220,1470601856,3,581,193.6666667,1361049212046,1361049212238,1470593902,1470594094,192
1361049220,1470601856,3,642,214,1361049213581,1361049213645,1470595437,1470595501,64
1361049220,1470601860,3,635,211.6666667,1361049212236,1361049212364,1470594096,1470594224,128
1361049220,1470601860,5,1220,244,1361049213644,1361049214668,1470595504,1470596528,1024
1361049220,1470601860,3,938,312.6666667,1361049212236,1361049212300,1470594096,1470594160,64
1361049220,1470601860,9,3544,393.7777778,1361049213708,1361049213900,1470595568,1470595760,192
1361049220,1470601860,7,2593,370.4285714,1361049212298,1361049212490,1470594158,1470594350,192
1361049220,1470601860,3,849,283,1361049212298,1361049212362,1470594158,1470594222,64
1361049220,1470601860,6,2773,462.1666667,1361049212425,1361049212937,1470594285,1470594797,512
1361049220,1470601864,7,4864,694.8571429,1361049214280,1361049214344,1470596144,1470596208,64
1361049220,1470601864,7,2121,303,1361049214344,1361049214728,1470596208,1470596592,384
1361049220,1470601864,4,647,161.75,1361049214344,1361049215944,1470596208,1470597808,1600
1361049220,1470601864,5,1152,230.4,1361049214408,1361049214472,1470596272,1470596336,64
1361049220,1470601888,18,21423,1190.166667,1361049214637,1361049214829,1470596525,1470596717,192
1361049220,1470601888,3,581,193.6666667,1361049214637,1361049214765,1470596525,1470596653,128
1361049220,1470601888,3,851,283.6666667,1361049212717,1361049212781,1470594605,1470594669,64
1361049220,1470601892,3,940,313.3333333,1361049212717,1361049212717,1470594609,1470594609,0
1361049220,1470601892,3,635,211.6666667,1361049214828,1361049215020,1470596720,1470596912,192
1361049220,1470601892,6,2736,456,1361049215083,1361049215339,1470596975,1470597231,256
1361049220,1470601892,5,617,123.4,1361049215082,1361049215146,1470596974,1470597038,64
1361049220,1470601896,7,3798,542.5714286,1361049212905,1361049215401,1470594801,1470597297,2496
1361049220,1470601896,7,4091,584.4285714,1361049212905,1361049213161,1470594801,1470595057,256
1361049220,1470601896,4,414,103.5,1361049212904,1361049212968,1470594800,1470594864,64
1361049220,1470601896,5,1056,211.2,1361049215655,1361049215655,1470597551,1470597551,0
1361049220,1470601896,5,2823,564.6,1361049213030,1361049213286,1470594926,1470595182,256
1361049220,1470601896,3,799,266.3333333,1361049215654,1361049215718,1470597550,1470597614,64
1361049220,1470601896,4,1554,388.5,1361049215654,1361049215718,1470597550,1470597614,64
1361049220,1470601896,32,21681,677.53125,1361049215590,1361049215782,1470597486,1470597678,192
1361049220,1470601896,5,594,118.8,1361049213030,1361049213094,1470594926,1470594990,64
1361049220,1470601896,12,5544,462,1361049215718,1361049215910,1470597614,1470597806,192
1361049220,1470601900,4,757,189.25,1361049215649,1361049215713,1470597549,1470597613,64
1361049220,1470601900,6,1094,182.3333333,1361049215777,1361049216033,1470597677,1470597933,256
1361049220,1470601900,4,1354,338.5,1361049215845,1361049215973,1470597745,1470597873,128
1361049220,1470601900,4,734,183.5,1361049215717,1361049215845,1470597617,1470597745,128
1361049220,1470601900,6,1560,260,1361049215908,1361049216036,1470597808,1470597936,128
1361049220,1470601900,3,634,211.3333333,1361049215908,1361049215972,1470597808,1470597872,64
1361049220,1470601900,4,1360,340,1361049215780,1361049215972,1470597680,1470597872,192
1361049220,1470601900,5,1245,249,1361049215844,1361049216484,1470597744,1470598384,640
1361049220,1470601900,6,1560,260,1361049215844,1361049215972,1470597744,1470597872,128
1361049220,1470601900,6,1560,260,1361049215971,1361049216099,1470597871,1470597999,128
1361049220,1470601900,4,651,162.75,1361049213283,1361049213923,1470595183,1470595823,640
1361049220,1470601900,5,2742,548.4,1361049216035,1361049216419,1470597935,1470598319,384
1361049220,1470601900,3,580,193.3333333,1361049213282,1361049213474,1470595182,1470595374,192
1361049220,1470601904,7,1755,250.7142857,1361049216157,1361049216285,1470598061,1470598189,128
1361049220,1470601904,5,594,118.8,1361049216477,1361049216669,1470598381,1470598573,192
1361049220,1470601904,6,1618,269.6666667,1361049216481,1361049216609,1470598385,1470598513,128
1361049220,1470601904,14,10471,747.9285714,1361049216544,1361049216672,1470598448,1470598576,128
1361049220,1470601904,5,2705,541,1361049211680,1361049211936,1470593584,1470593840,256
1361049220,1470601904,6,3508,584.6666667,1361049216608,1361049216736,1470598512,1470598640,128
1361049220,1470601904,12,5544,462,1361049216736,1361049217184,1470598640,1470599088,448
1361049220,1470601904,4,757,189.25,1361049216607,1361049217183,1470598511,1470599087,576
1361049220,1470601904,7,3199,457,1361049216799,1361049217247,1470598703,1470599151,448
1361049220,1470601904,5,700,140,1361049217118,1361049217182,1470599022,1470599086,64
1361049223,108917644,5,1590,318,1361049217567,1361049217631,108912211,108912275,64
1361049223,108917644,5,1596,319.2,1361049217567,1361049217631,108912211,108912275,64
1361049223,108917644,5,1365,273,1361049215005,1361049215197,108909649,108909841,192
1361049223,108917648,4,1210,302.5,1361049216028,1361049216028,108910676,108910676,0
1361049234,1470615336,1,46,46,1361049208213,1361049208213,1470589549,1470589549,0
1361049236,1470617812,4,521,130.25,1361049233915,1361049233979,1470615727,1470615791,64
1361049236,1470617812,5,408,81.6,1361049233913,1361049233977,1470615725,1470615789,64
1361049236,1470617816,211,296610,1405.734597,1361049234104,1361049234232,1470615920,1470616048,128
1361049236,1470617816,4,521,130.25,1361049234294,1361049234358,1470616110,1470616174,64
1361049236,1470617816,7,5347,763.8571429,1361049234358,1361049235126,1470616174,1470616942,768
1361049236,1470617820,7,5538,791.1428571,1361049234353,1361049234417,1470616173,1470616237,64
1361049236,1470617824,24,28409,1183.708333,1361049228848,1361049234352,1470610672,1470616176,5504
1361049236,1470617824,19,20599,1084.157895,1361049228912,1361049234352,1470610736,1470616176,5440
1361049236,1470617824,17,18864,1109.647059,1361049228912,1361049234352,1470610736,1470616176,5440
1361049236,1470617824,6,2201,366.8333333,1361049235055,1361049235183,1470616879,1470617007,128
1361049236,1470617824,103,142132,1379.92233,1361049235055,1361049235183,1470616879,1470617007,128
1361049236,1470617824,44,58006,1318.318182,1361049235055,1361049235119,1470616879,1470616943,64
1361049236,1470617848,13,5439,418.3846154,1361049221271,1361049235095,1470603119,1470616943,13824
1361049236,1470617856,5,680,136,1361049217550,1361049235406,1470599406,1470617262,17856
1361049236,1470617860,4,766,191.5,1361049233803,1361049233867,1470615663,1470615727,64
1361049236,1470617860,38,46842,1232.684211,1361049228170,1361049233738,1470610030,1470615598,5568
1361049236,1470617864,5,1089,217.8,1361049234121,1361049234377,1470615985,1470616241,256
1361049236,1470617864,25,29377,1175.08,1361049234120,1361049234440,1470615984,1470616304,320
1361049236,1470617864,6,3568,594.6666667,1361049234311,1361049234375,1470616175,1470616239,64
1361049236,1470617864,5,2717,543.4,1361049234310,1361049235078,1470616174,1470616942,768
1361049236,1470617880,20,22604,1130.2,1361049228790,1361049234294,1470610670,1470616174,5504
1361049236,1470617884,30,37849,1261.633333,1361049228787,1361049233843,1470610671,1470615727,5056
1361049236,1470617888,4,638,159.5,1361049235056,1361049235184,1470616944,1470617072,128
1361049239,108933900,1,52,52,1361049212127,1361049212127,108907027,108907027,0
1361049242,1470623300,1,52,52,1361049214843,1361049214843,1470596143,1470596143,0
1361049242,1470623424,2,112,56,1361049216256,1361049216320,1470597680,1470597744,64
1361049242,1470623452,2,112,56,1361049216868,1361049216868,1470598320,1470598320,0
1361049242,1470623460,2,555,277.5,1361049217756,1361049217820,1470599216,1470599280,64
1361049243,108937976,4,464,116,1361049217299,1361049217299,108912275,108912275,0
1361049243,108937976,4,464,116,1361049217297,1361049217297,108912273,108912273,0
1361049244,1470625828,1303,1851227,1420.742134,1361049236841,1361049241961,1470618669,1470623789,5120
1361049244,1470625832,5,698,139.6,1361049229032,1361049237096,1470610864,1470618928,8064
1361049244,1470625852,5,680,136,1361049235410,1361049237074,1470617262,1470618926,1664
1361049244,1470625856,5,841,168.2,1361049237069,1361049237133,1470618925,1470618989,64
1361049244,1470625856,5,878,175.6,1361049235408,1361049237072,1470617264,1470618928,1664
1361049244,1470625856,4,521,130.25,1361049235408,1361049237072,1470617264,1470618928,1664
1361049244,1470625856,41,50240,1225.365854,1361049235727,1361049237135,1470617583,1470618991,1408
1361049244,1470625864,19,14739,775.7368421,1361049236038,1361049237062,1470617902,1470618926,1024
1361049244,1470625864,4,576,144,1361049236038,1361049237062,1470617902,1470618926,1024
1361049244,1470625904,1314,1853710,1410.738204,1361049234976,1361049239328,1470616880,1470621232,4352
1361049244,1470625904,243,339493,1397.090535,1361049235166,1361049237022,1470617070,1470618926,1856
1361049244,1470625904,4,521,130.25,1361049235357,1361049237021,1470617261,1470618925,1664
1361049244,1470625904,5,842,168.4,1361049237021,1361049237085,1470618925,1470618989,64
1361049244,1470625908,4,521,130.25,1361049235356,1361049237020,1470617264,1470618928,1664
1361049244,1470625908,5,1275,255,1361049235356,1361049237020,1470617264,1470618928,1664
1361049244,1470625908,15,12537,835.8,1361049235674,1361049237018,1470617582,1470618926,1344
1361049246,1470627376,1,52,52,1361049218031,1361049218031,1470599407,1470599407,0
1361049250,1470631300,3,714,238,1361049222203,1361049222267,1470603503,1470603567,64
1361049252,1470633820,4,704,176,1361049246514,1361049248690,1470628334,1470630510,2176
1361049252,1470633820,3,969,323,1361049251633,1361049251633,1470633453,1470633453,0
1361049252,1470633828,6,2328,388,1361049251113,1361049251305,1470632941,1470633133,192
1361049252,1470633828,4,612,153,1361049250985,1361049251113,1470632813,1470632941,128
1361049252,1470633828,4,652,163,1361049251049,1361049251113,1470632877,1470632941,64
1361049252,1470633852,16,12588,786.75,1361049251028,1361049251476,1470632880,1470633328,448
1361049252,1470633856,3,581,193.6666667,1361049251536,1361049251728,1470633392,1470633584,192
1361049252,1470633856,3,880,293.3333333,1361049251600,1361049251664,1470633456,1470633520,64
1361049252,1470633856,1309,1859783,1420.766234,1361049243662,1361049250958,1470625518,1470632814,7296
1361049252,1470633860,3,643,214.3333333,1361049251849,1361049251849,1470633709,1470633709,0
1361049252,1470633888,13,12476,959.6923077,1361049250352,1361049250736,1470632240,1470632624,384
1361049252,1470633896,23,11538,501.6521739,1361049250919,1361049251111,1470632815,1470633007,192
1361049252,1470633896,5,2823,564.6,1361049251238,1361049251494,1470633134,1470633390,256
1361049252,1470633896,3,827,275.6666667,1361049251429,1361049251493,1470633325,1470633389,64
1361049252,1470633900,3,635,211.6666667,1361049251683,1361049251811,1470633583,1470633711,128
1361049252,1470633900,3,961,320.3333333,1361049251491,1361049251555,1470633391,1470633455,64
1361049254,1470635316,1,52,52,1361049228713,1361049228713,1470610029,1470610029,0
1361049254,1470635360,1,52,52,1361049229311,1361049229311,1470610671,1470610671,0
1361049254,1470635360,1,52,52,1361049229309,1361049229309,1470610669,1470610669,0
1361049254,1470635364,1,52,52,1361049229305,1361049229305,1470610669,1470610669,0
1361049254,1470635400,1,52,52,1361049228631,1361049228631,1470610031,1470610031,0
1361049254,1470635444,1,52,52,1361049229226,1361049229226,1470610670,1470610670,0
1361049254,1470635444,34,44001,1294.147059,1361049229226,1361049231338,1470610670,1470612782,2112
1361049254,1470635448,1,52,52,1361049229414,1361049229414,1470610862,1470610862,0
1361049254,1470635448,1,52,52,1361049229222,1361049229222,1470610670,1470610670,0
1361049254,1470635448,4,2877,719.25,1361049229414,1361049229414,1470610862,1470610862,0
1361049254,1470635448,1,52,52,1361049229222,1361049229222,1470610670,1470610670,0
1361049255,108949652,4,1074,268.5,1361049254551,1361049254615,108949203,108949267,64
1361049255,108949652,11,10406,946,1361049251415,1361049251863,108946067,108946515,448
1361049255,108949652,6,2284,380.6666667,1361049251862,1361049252566,108946514,108947218,704
1361049255,108949652,4,464,116,1361049252569,1361049252697,108947221,108947349,128
1361049255,108949656,4,1074,268.5,1361049253267,1361049253267,108947923,108947923,0
1361049255,108949656,4,464,116,1361049253331,1361049253395,108947987,108948051,64
1361049255,108949656,5,1374,274.8,1361049253970,1361049254098,108948626,108948754,128
1361049255,108949656,4,464,116,1361049254610,1361049254866,108949266,108949522,256
1361049260,1470641812,3,634,211.3333333,1361049251900,1361049251964,1470633712,1470633776,64
1361049260,1470641812,8,1248,156,1361049245436,1361049256252,1470627248,1470638064,10816
1361049260,1470641812,5,2740,548,1361049253436,1361049253820,1470635248,1470635632,384
1361049260,1470641812,6,1560,260,1361049253499,1361049253627,1470635311,1470635439,128
1361049260,1470641812,5,455,91,1361049253499,1361049253627,1470635311,1470635439,128
1361049260,1470641812,3,581,193.6666667,1361049253690,1361049253818,1470635502,1470635630,128
1361049260,1470641812,3,502,167.3333333,1361049252026,1361049252026,1470633838,1470633838,0
1361049260,1470641812,4,651,162.75,1361049253626,1361049253818,1470635438,1470635630,192
1361049260,1470641812,5,2823,564.6,1361049252025,1361049252217,1470633837,1470634029,192
1361049260,1470641812,6,2343,390.5,1361049253753,1361049253881,1470635565,1470635693,128
1361049260,1470641812,5,623,124.6,1361049253817,1361049253881,1470635629,1470635693,64
1361049260,1470641812,24,26065,1086.041667,1361049253881,1361049254009,1470635693,1470635821,128
1361049260,1470641812,6,2473,412.1666667,1361049253881,1361049254009,1470635693,1470635821,128
1361049260,1470641816,5,594,118.8,1361049253816,1361049254072,1470635632,1470635888,256
1361049260,1470641816,5,857,171.4,1361049253880,1361049253944,1470635696,1470635760,64
1361049260,1470641816,5,1606,321.2,1361049253880,1361049254008,1470635696,1470635824,128
1361049260,1470641816,6,702,117,1361049253880,1361049254264,1470635696,1470636080,384
1361049260,1470641816,3,634,211.3333333,1361049254007,1361049254007,1470635823,1470635823,0
1361049260,1470641816,6,2773,462.1666667,1361049254071,1361049254583,1470635887,1470636399,512
1361049260,1470641816,5,632,126.4,1361049254262,1361049254518,1470636078,1470636334,256
1361049260,1470641816,3,580,193.3333333,1361049252278,1361049252470,1470634094,1470634286,192
1361049260,1470641816,6,1560,260,1361049254262,1361049254390,1470636078,1470636206,128
1361049260,1470641816,3,827,275.6666667,1361049252214,1361049252278,1470634030,1470634094,64
1361049260,1470641816,6,1446,241,1361049254325,1361049254517,1470636141,1470636333,192
1361049260,1470641816,11,5969,542.6363636,1361049254261,1361049254517,1470636077,1470636333,256
1361049260,1470641816,3,969,323,1361049252277,1361049252341,1470634093,1470634157,64
1361049260,1470641816,10,5915,591.5,1361049254325,1361049254517,1470636141,1470636333,192
1361049260,1470641820,5,623,124.6,1361049252404,1361049252468,1470634224,1470634288,64
1361049260,1470641820,4,325,81.25,1361049254451,1361049255539,1470636271,1470637359,1088
1361049260,1470641820,6,1560,260,1361049254579,1361049254707,1470636399,1470636527,128
1361049260,1470641820,7,3173,453.2857143,1361049254579,1361049254835,1470636399,1470636655,256
1361049260,1470641820,3,642,214,1361049254579,1361049254643,1470636399,1470636463,64
1361049260,1470641820,3,634,211.3333333,1361049252467,1361049252595,1470634287,1470634415,128
1361049260,1470641820,3,633,211,1361049254643,1361049254643,1470636463,1470636463,0
1361049260,1470641820,4,414,103.5,1361049252466,1361049252658,1470634286,1470634478,192
1361049260,1470641820,6,2786,464.3333333,1361049254706,1361049255090,1470636526,1470636910,384
1361049260,1470641820,4,1704,426,1361049254770,1361049254962,1470636590,1470636782,192
1361049260,1470641820,3,633,211,1361049252593,1361049252593,1470634413,1470634413,0
1361049260,1470641820,6,1581,263.5,1361049254705,1361049254961,1470636525,1470636781,256
1361049260,1470641820,5,455,91,1361049252593,1361049252721,1470634413,1470634541,128
1361049260,1470641820,3,642,214,1361049252529,1361049252593,1470634349,1470634413,64
1361049260,1470641824,5,2821,564.2,1361049252656,1361049252848,1470634480,1470634672,192
1361049260,1470641824,6,2771,461.8333333,1361049252656,1361049253232,1470634480,1470635056,576
1361049260,1470641824,6,1656,276,1361049254896,1361049255024,1470636720,1470636848,128
1361049260,1470641824,5,700,140,1361049254896,1361049254960,1470636720,1470636784,64
1361049260,1470641824,4,1332,333,1361049254896,1361049254960,1470636720,1470636784,64
1361049260,1470641824,9,5677,630.7777778,1361049252591,1361049252847,1470634415,1470634671,256
1361049260,1470641824,7,856,122.2857143,1361049255086,1361049255214,1470636910,1470637038,128
1361049260,1470641824,5,518,103.6,1361049255086,1361049256430,1470636910,1470638254,1344
1361049260,1470641824,5,857,171.4,1361049252846,1361049252910,1470634670,1470634734,64
1361049260,1470641824,6,1000,166.6666667,1361049252845,1361049252973,1470634669,1470634797,128
1361049260,1470641824,6,2481,413.5,1361049255085,1361049255277,1470636909,1470637101,192
1361049260,1470641828,5,786,157.2,1361049252844,1361049253164,1470634672,1470634992,320
1361049260,1470641828,6,2939,489.8333333,1361049252780,1361049252908,1470634608,1470634736,128
1361049260,1470641828,4,1370,342.5,1361049255276,1361049255532,1470637104,1470637360,256
1361049260,1470641828,23,28398,1234.695652,1361049255276,1361049255340,1470637104,1470637168,64
1361049260,1470641828,5,899,179.8,1361049252844,1361049252908,1470634672,1470634736,64
1361049260,1470641828,6,3508,584.6666667,1361049255339,1361049255531,1470637167,1470637359,192
1361049260,1470641828,4,1318,329.5,1361049255531,1361049255595,1470637359,1470637423,64
1361049260,1470641828,3,703,234.3333333,1361049255531,1361049255595,1470637359,1470637423,64
1361049260,1470641828,3,540,180,1361049255531,1361049255595,1470637359,1470637423,64
1361049260,1470641828,4,628,157,1361049255531,1361049256235,1470637359,1470638063,704
1361049260,1470641828,5,452,90.4,1361049255403,1361049255531,1470637231,1470637359,128
1361049260,1470641828,5,452,90.4,1361049255403,1361049255531,1470637231,1470637359,128
1361049260,1470641828,5,1152,230.4,1361049255658,1361049256234,1470637486,1470638062,576
1361049260,1470641828,6,1094,182.3333333,1361049252970,1361049253226,1470634798,1470635054,256
1361049260,1470641828,4,652,163,1361049255530,1361049255530,1470637358,1470637358,0
1361049260,1470641828,6,959,159.8333333,1361049252906,1361049253034,1470634734,1470634862,128
1361049260,1470641828,7,1552,221.7142857,1361049255530,1361049255722,1470637358,1470637550,192
1361049260,1470641828,3,858,286,1361049255594,1361049255722,1470637422,1470637550,128
1361049260,1470641828,3,961,320.3333333,1361049252970,1361049253034,1470634798,1470634862,64
1361049260,1470641828,3,880,293.3333333,1361049253034,1361049253098,1470634862,1470634926,64
1361049260,1470641828,6,1452,242,1361049252969,1361049256233,1470634797,1470638061,3264
1361049260,1470641844,3,969,323,1361049253017,1361049253017,1470634861,1470634861,0
1361049260,1470641844,3,634,211.3333333,1361049253146,1361049253274,1470634990,1470635118,128
1361049260,1470641844,7,3422,488.8571429,1361049253081,1361049253337,1470634925,1470635181,256
1361049260,1470641844,5,2765,553,1361049255833,1361049256217,1470637677,1470638061,384
1361049260,1470641844,6,2846,474.3333333,1361049253145,1361049253401,1470634989,1470635245,256
1361049260,1470641848,6,1446,241,1361049253208,1361049253464,1470635056,1470635312,256
1361049260,1470641848,3,642,214,1361049253208,1361049253272,1470635056,1470635120,64
1361049260,1470641848,5,700,140,1361049255957,1361049256021,1470637805,1470637869,64
1361049260,1470641848,7,3422,488.8571429,1361049251669,1361049251925,1470633517,1470633773,256
1361049260,1470641852,5,452,90.4,1361049256913,1361049256977,1470638765,1470638829,64
1361049260,1470641856,5,2823,564.6,1361049253392,1361049253584,1470635248,1470635440,192
1361049260,1470641856,12,9073,756.0833333,1361049253455,1361049253839,1470635311,1470635695,384
1361049260,1470641856,6,2773,462.1666667,1361049251983,1361049252367,1470633839,1470634223,384
1361049260,1470641860,6,1108,184.6666667,1361049253833,1361049253897,1470635693,1470635757,64
1361049260,1470641860,6,2480,413.3333333,1361049253768,1361049254280,1470635628,1470636140,512
1361049260,1470641860,3,635,211.6666667,1361049253836,1361049253964,1470635696,1470635824,128
1361049260,1470641860,5,715,143,1361049253836,1361049254092,1470635696,1470635952,256
1361049260,1470641860,6,965,160.8333333,1361049253900,1361049253964,1470635760,1470635824,64
1361049260,1470641860,5,2703,540.6,1361049253836,1361049254092,1470635696,1470635952,256
1361049260,1470641860,6,1094,182.3333333,1361049253900,1361049254092,1470635760,1470635952,192
1361049260,1470641860,3,643,214.3333333,1361049253899,1361049253963,1470635759,1470635823,64
1361049260,1470641860,6,1419,236.5,1361049253963,1361049254219,1470635823,1470636079,256
1361049260,1470641860,3,961,320.3333333,1361049252235,1361049252235,1470634095,1470634095,0
1361049260,1470641860,7,1711,244.4285714,1361049254090,1361049254346,1470635950,1470636206,256
1361049260,1470641860,3,880,293.3333333,1361049252298,1361049252298,1470634158,1470634158,0
1361049260,1470641860,18,21405,1189.166667,1361049254218,1361049254346,1470636078,1470636206,128
1361049260,1470641860,7,3453,493.2857143,1361049252297,1361049252617,1470634157,1470634477,320
1361049260,1470641860,6,3456,576,1361049254281,1361049254473,1470636141,1470636333,192
1361049260,1470641860,4,592,148,1361049254217,1361049254217,1470636077,1470636077,0
1361049260,1470641860,7,1803,257.5714286,1361049254281,1361049254409,1470636141,1470636269,128
1361049260,1470641864,6,2742,457,1361049252357,1361049252485,1470634221,1470634349,128
1361049260,1470641864,3,580,193.3333333,1361049254280,1361049254408,1470636144,1470636272,128
1361049260,1470641864,3,634,211.3333333,1361049254408,1361049254600,1470636272,1470636464,192
1361049260,1470641864,3,502,167.3333333,1361049252424,1361049252552,1470634288,1470634416,128
1361049260,1470641864,6,1129,188.1666667,1361049254536,1361049254664,1470636400,1470636528,128
1361049260,1470641884,5,518,103.6,1361049254513,1361049256177,1470636397,1470638061,1664
1361049260,1470641884,5,1688,337.6,1361049254513,1361049254705,1470636397,1470636589,192
1361049260,1470641888,5,594,118.8,1361049252589,1361049252653,1470634477,1470634541,64
1361049260,1470641888,3,502,167.3333333,1361049254572,1361049254700,1470636460,1470636588,128
1361049260,1470641888,5,1885,377,1361049255023,1361049255087,1470636911,1470636975,64
1361049260,1470641888,5,594,118.8,1361049255086,1361049255278,1470636974,1470637166,192
1361049260,1470641888,10,5888,588.8,1361049254766,1361049255214,1470636654,1470637102,448
1361049260,1470641888,4,216,54,1361049252782,1361049252846,1470634670,1470634734,64
1361049260,1470641888,6,702,117,1361049252782,1361049253166,1470634670,1470635054,384
1361049260,1470641888,6,1108,184.6666667,1361049252781,1361049252845,1470634669,1470634733,64
1361049260,1470641888,6,2821,470.1666667,1361049255149,1361049255405,1470637037,1470637293,256
1361049260,1470641888,5,1606,321.2,1361049252781,1361049252909,1470634669,1470634797,128
1361049260,1470641892,9,908,100.8888889,1361049252776,1361049253032,1470634668,1470634924,256
1361049260,1470641892,6,1560,260,1361049255340,1361049255468,1470637232,1470637360,128
1361049260,1470641892,3,827,275.6666667,1361049252844,1361049252908,1470634736,1470634800,64
1361049260,1470641892,4,1327,331.75,1361049252907,1361049253099,1470634799,1470634991,192
1361049260,1470641892,5,1740,348,1361049255467,1361049255595,1470637359,1470637487,128
1361049260,1470641892,4,543,135.75,1361049255467,1361049255531,1470637359,1470637423,64
1361049260,1470641892,5,1675,335,1361049252907,1361049253099,1470634799,1470634991,192
1361049260,1470641892,5,1508,301.6,1361049255467,1361049255531,1470637359,1470637423,64
1361049260,1470641892,3,580,193.3333333,1361049252907,1361049253099,1470634799,1470634991,192
1361049260,1470641892,3,808,269.3333333,1361049255467,1361049255595,1470637359,1470637487,128
1361049260,1470641892,4,548,137,1361049255467,1361049255659,1470637359,1470637551,192
1361049260,1470641892,6,592,98.66666667,1361049252971,1361049253419,1470634863,1470635311,448
1361049260,1470641892,6,1425,237.5,1361049253035,1361049253995,1470634927,1470635887,960
1361049260,1470641892,7,3199,457,1361049255531,1361049256235,1470637423,1470638127,704
1361049260,1470641892,6,1560,260,1361049253035,1361049253163,1470634927,1470635055,128
1361049260,1470641892,3,624,208,1361049255402,1361049255466,1470637294,1470637358,64
1361049260,1470641892,5,956,191.2,1361049255466,1361049255530,1470637358,1470637422,64
1361049260,1470641892,6,895,149.1666667,1361049255466,1361049255722,1470637358,1470637614,256
1361049260,1470641892,7,804,114.8571429,1361049255530,1361049255658,1470637422,1470637550,128
1361049260,1470641892,7,880,125.7142857,1361049255657,1361049256233,1470637549,1470638125,576
1361049260,1470641892,5,594,118.8,1361049253161,1361049253417,1470635053,1470635309,256
1361049260,1470641892,3,633,211,1361049253225,1361049253289,1470635117,1470635181,64
1361049260,1470641896,4,1195,298.75,1361049255716,1361049255780,1470637612,1470637676,64
1361049260,1470641896,3,502,167.3333333,1361049253352,1361049253352,1470635248,1470635248,0
1361049260,1470641896,6,1560,260,1361049256166,1361049256294,1470638062,1470638190,128
1361049260,1470641896,4,267,66.75,1361049256166,1361049256294,1470638062,1470638190,128
1361049260,1470641896,5,2620,524,1361049251814,1361049252134,1470633710,1470634030,320
1361049260,1470641896,4,1437,359.25,1361049256165,1361049256229,1470638061,1470638125,64
1361049262,1470643300,1,52,52,1361049236604,1361049236604,1470617904,1470617904,0
1361049262,1470643652,1,52,52,1361049235417,1361049235417,1470617069,1470617069,0
1361049262,1470643676,4,924,231,1361049237250,1361049237314,1470618926,1470618990,64
1361049262,1470643676,10,6466,646.6,1361049237249,1361049237313,1470618925,1470618989,64
1361049262,1470643676,4,1038,259.5,1361049237249,1361049237313,1470618925,1470618989,64
1361049262,1470643680,1,52,52,1361049235838,1361049235838,1470617518,1470617518,0
1361049262,1470643688,1,52,52,1361049236214,1361049236214,1470617902,1470617902,0
1361049262,1470643764,4,1025,256.25,1361049237226,1361049237226,1470618990,1470618990,0
1361049262,1470643772,1,52,52,1361049235488,1361049235488,1470617260,1470617260,0
1361049262,1470643772,5,3974,794.8,1361049237283,1361049237283,1470619055,1470619055,0
1361049263,108957648,5,1590,318,1361049255260,1361049255324,108949908,108949972,64
1361049263,108957648,34,43938,1292.294118,1361049255644,1361049255836,108950292,108950484,192
1361049263,108957648,7,4950,707.1428571,1361049255772,1361049255836,108950420,108950484,64
1361049263,108957648,7,1948,278.2857143,1361049256283,1361049256603,108950931,108951251,320
1361049263,108957648,8,2006,250.75,1361049256283,1361049256603,108950931,108951251,320
1361049263,108957652,5,1596,319.2,1361049255255,1361049255319,108949907,108949971,64
1361049263,108957652,6,568,94.66666667,1361049255319,1361049255639,108949971,108950291,320
1361049263,108957652,5,516,103.2,1361049255319,1361049255383,108949971,108950035,64
1361049263,108957652,4,699,174.75,1361049255894,1361049256598,108950546,108951250,704
1361049268,1470649804,4,521,130.25,1361049245571,1361049263683,1470627375,1470645487,18112
1361049268,1470649860,2,104,52,1361049260171,1361049260427,1470642031,1470642287,256
1361049268,1470649892,5,452,90.4,1361049261034,1361049261098,1470642926,1470642990,64
1361049274,1470655348,11,12165,1105.909091,1361049246858,1361049246858,1470628206,1470628206,0
1361049274,1470655416,5,2992,598.4,1361049249094,1361049251142,1470630510,1470632558,2048
1361049274,1470655424,3,631,210.3333333,1361049245949,1361049246013,1470627373,1470627437,64
1361049274,1470655456,25,31898,1275.92,1361049246751,1361049246751,1470628207,1470628207,0
1361049276,1470657820,5,452,90.4,1361049271092,1361049271156,1470652912,1470652976,64
1361049276,1470657860,5,587,117.4,1361049252491,1361049273611,1470634351,1470655471,21120
1361049276,1470657888,5,587,117.4,1361049253101,1361049274285,1470634989,1470656173,21184
1361049278,1470659396,1,52,52,1361049250779,1361049250779,1470632175,1470632175,0
1361049278,1470659396,1,52,52,1361049250777,1361049250777,1470632173,1470632173,0
1361049278,1470659408,3,164,54.66666667,1361049253392,1361049253456,1470634800,1470634864,64
1361049278,1470659484,1,46,46,1361049252993,1361049252993,1470634477,1470634477,0
1361049280,108974216,1,52,52,1361049252299,1361049252299,108946515,108946515,0
1361049280,108974264,1,52,52,1361049252250,1361049252250,108946514,108946514,0
1361049282,1470663364,1,52,52,1361049255674,1361049255674,1470637038,1470637038,0
1361049282,1470663376,4,2207,551.75,1361049256684,1361049256684,1470638060,1470638060,0
1361049282,1470663376,1,46,46,1361049256684,1361049256684,1470638060,1470638060,0
1361049282,1470663448,1,46,46,1361049255464,1361049255464,1470636912,1470636912,0
1361049282,1470663448,1,52,52,1361049255590,1361049255590,1470637038,1470637038,0
1361049282,1470663452,1,46,46,1361049256032,1361049256032,1470637484,1470637484,0
1361049284,1470665812,5,452,90.4,1361049282170,1361049282298,1470663982,1470664110,128
1361049284,1470665820,3,1054,351.3333333,1361049283313,1361049283313,1470665133,1470665133,0
1361049284,1470665840,3,951,317,1361049283293,1361049283357,1470665133,1470665197,64
1361049284,1470665856,9,7704,856,1361049282255,1361049282639,1470664111,1470664495,384
1361049284,1470665888,3,687,229,1361049282862,1361049282990,1470664750,1470664878,128
1361049284,1470665892,3,898,299.3333333,1361049283051,1361049283115,1470664943,1470665007,64
1361049284,1470665892,3,1046,348.6666667,1361049283177,1361049283241,1470665069,1470665133,64
1361049284,1470665896,7,3422,488.8571429,1361049283300,1361049283556,1470665196,1470665452,256
1361049284,1470665896,5,594,118.8,1361049283622,1361049283686,1470665518,1470665582,64
1361049287,108981644,5,1482,296.4,1361049284255,1361049284639,108978899,108979283,384
1361049287,108981648,11,10406,946,1361049283421,1361049284637,108978069,108979285,1216
1361049287,108981648,5,1590,318,1361049286620,1361049286748,108981268,108981396,128
1361049287,108981648,7,2800,400,1361049284635,1361049285595,108979283,108980243,960
1361049287,108981652,5,516,103.2,1361049286744,1361049286808,108981396,108981460,64
1361049290,1470671508,3,469,156.3333333,1361049263979,1361049263979,1470645487,1470645487,0
1361049292,1470673832,5,857,171.4,1361049285416,1361049285480,1470667248,1470667312,64
1361049292,1470673832,3,164,54.66666667,1361049285479,1361049285543,1470667311,1470667375,64
1361049292,1470673832,4,734,183.5,1361049285479,1361049285671,1470667311,1470667503,192
1361049292,1470673832,6,702,117,1361049285479,1361049285863,1470667311,1470667695,384
1361049292,1470673832,3,581,193.6666667,1361049283943,1361049284135,1470665775,1470665967,192
1361049292,1470673832,6,2343,390.5,1361049284006,1361049284134,1470665838,1470665966,128
1361049292,1470673832,48,63989,1333.104167,1361049285733,1361049285861,1470667565,1470667693,128
1361049292,1470673832,6,4257,709.5,1361049285733,1361049287269,1470667565,1470669101,1536
1361049292,1470673832,3,164,54.66666667,1361049285733,1361049285797,1470667565,1470667629,64
1361049292,1470673832,18,21423,1190.166667,1361049285733,1361049285925,1470667565,1470667757,192
1361049292,1470673832,6,640,106.6666667,1361049285733,1361049286693,1470667565,1470668525,960
1361049292,1470673832,6,1108,184.6666667,1361049285733,1361049285797,1470667565,1470667629,64
1361049292,1470673832,9,3329,369.8888889,1361049285796,1361049286372,1470667628,1470668204,576
1361049292,1470673832,7,3427,489.5714286,1361049285796,1361049285924,1470667628,1470667756,128
1361049292,1470673832,10,5915,591.5,1361049285796,1361049285988,1470667628,1470667820,192
1361049292,1470673836,3,279,93,1361049285923,1361049285987,1470667759,1470667823,64
1361049292,1470673836,4,1360,340,1361049285987,1361049286115,1470667823,1470667951,128
1361049292,1470673836,5,1245,249,1361049285922,1361049285986,1470667758,1470667822,64
1361049292,1470673836,5,594,118.8,1361049285986,1361049286242,1470667822,1470668078,256
1361049292,1470673836,6,1613,268.8333333,1361049286050,1361049287522,1470667886,1470669358,1472
1361049292,1470673836,7,3293,470.4285714,1361049285985,1361049286433,1470667821,1470668269,448
1361049292,1470673836,6,1560,260,1361049286113,1361049286177,1470667949,1470668013,64
1361049292,1470673836,3,643,214.3333333,1361049284193,1361049284257,1470666029,1470666093,64
1361049292,1470673836,5,455,91,1361049286176,1361049286304,1470668012,1470668140,128
1361049292,1470673840,3,634,211.3333333,1361049284255,1361049284319,1470666095,1470666159,64
1361049292,1470673840,4,1332,333,1361049286303,1361049286367,1470668143,1470668207,64
1361049292,1470673840,5,700,140,1361049286302,1361049286366,1470668142,1470668206,64
1361049292,1470673840,3,951,317,1361049284382,1361049284446,1470666222,1470666286,64
1361049292,1470673840,5,1885,377,1361049286430,1361049286494,1470668270,1470668334,64
1361049292,1470673840,5,1606,321.2,1361049286430,1361049286558,1470668270,1470668398,128
1361049292,1470673840,7,856,122.2857143,1361049286430,1361049286558,1470668270,1470668398,128
1361049292,1470673840,6,704,117.3333333,1361049286430,1361049286814,1470668270,1470668654,384
1361049292,1470673840,6,1094,182.3333333,1361049286429,1361049286685,1470668269,1470668525,256
1361049292,1470673840,6,965,160.8333333,1361049286493,1361049286557,1470668333,1470668397,64
1361049292,1470673840,4,1327,331.75,1361049286492,1361049286684,1470668332,1470668524,192
1361049292,1470673844,5,1508,301.6,1361049286619,1361049286747,1470668463,1470668591,128
1361049292,1470673844,5,1508,301.6,1361049286747,1361049286811,1470668591,1470668655,64
1361049292,1470673844,6,1560,260,1361049286811,1361049286875,1470668655,1470668719,64
1361049292,1470673844,4,1354,338.5,1361049286874,1361049287066,1470668718,1470668910,192
1361049292,1470673844,3,633,211,1361049284506,1361049284634,1470666350,1470666478,128
1361049292,1470673844,6,1560,260,1361049287001,1361049287129,1470668845,1470668973,128
1361049292,1470673844,5,1508,301.6,1361049287129,1361049287257,1470668973,1470669101,128
1361049292,1470673844,3,632,210.6666667,1361049284632,1361049284696,1470666476,1470666540,64
1361049292,1470673848,4,578,144.5,1361049287256,1361049287320,1470669104,1470669168,64
1361049292,1470673848,4,555,138.75,1361049287256,1361049287384,1470669104,1470669232,128
1361049292,1470673848,6,2784,464,1361049284759,1361049285271,1470666607,1470667119,512
1361049292,1470673848,3,641,213.6666667,1361049284631,1361049284631,1470666479,1470666479,0
1361049292,1470673848,3,608,202.6666667,1361049287319,1361049287383,1470669167,1470669231,64
1361049292,1470673848,5,667,133.4,1361049287447,1361049288919,1470669295,1470670767,1472
1361049292,1470673872,6,1081,180.1666667,1361049287613,1361049287741,1470669485,1470669613,128
1361049292,1470673872,23,11581,503.5217391,1361049282877,1361049284221,1470664749,1470666093,1344
1361049292,1470673872,3,502,167.3333333,1361049284735,1361049284735,1470666607,1470666607,0
1361049292,1470673872,6,1533,255.5,1361049287806,1361049288894,1470669678,1470670766,1088
1361049292,1470673872,5,518,103.6,1361049284797,1361049287229,1470666669,1470669101,2432
1361049292,1470673872,6,2751,458.5,1361049284797,1361049285117,1470666669,1470666989,320
1361049292,1470673876,3,1046,348.6666667,1361049284923,1361049284987,1470666799,1470666863,64
1361049292,1470673876,3,1054,351.3333333,1361049284987,1361049285051,1470666863,1470666927,64
1361049292,1470673876,9,5196,577.3333333,1361049285178,1361049285370,1470667054,1470667246,192
1361049292,1470673876,5,594,118.8,1361049285242,1361049285498,1470667118,1470667374,256
1361049292,1470673876,6,2479,413.1666667,1361049285240,1361049285432,1470667116,1470667308,192
1361049292,1470673880,8,5546,693.25,1361049283639,1361049284279,1470665519,1470666159,640
1361049292,1470673880,8,1326,165.75,1361049288694,1361049288886,1470670574,1470670766,192
1361049292,1470673884,6,2773,462.1666667,1361049285424,1361049285872,1470667308,1470667756,448
1361049292,1470673884,5,899,179.8,1361049285428,1361049285556,1470667312,1470667440,128
1361049292,1470673884,9,908,100.8888889,1361049285427,1361049285747,1470667311,1470667631,320
1361049292,1470673884,5,1020,204,1361049285682,1361049285938,1470667566,1470667822,256
1361049292,1470673884,6,1658,276.3333333,1361049285682,1361049287858,1470667566,1470669742,2176
1361049292,1470673884,6,1094,182.3333333,1361049285746,1361049285938,1470667630,1470667822,192
1361049292,1470673884,6,1000,166.6666667,1361049285681,1361049285809,1470667565,1470667693,128
1361049292,1470673884,4,1327,331.75,1361049285745,1361049285873,1470667629,1470667757,128
1361049292,1470673884,3,164,54.66666667,1361049285745,1361049285809,1470667629,1470667693,64
1361049292,1470673888,6,965,160.8333333,1361049285804,1361049285932,1470667692,1470667820,128
1361049292,1470673888,5,623,124.6,1361049285868,1361049285996,1470667756,1470667884,128
1361049292,1470673888,6,1560,260,1361049285932,1361049285996,1470667820,1470667884,64
1361049292,1470673888,6,2846,474.3333333,1361049285932,1361049286060,1470667820,1470667948,128
1361049292,1470673888,3,635,211.6666667,1361049284080,1361049284208,1470665968,1470666096,128
1361049292,1470673888,5,623,124.6,1361049286062,1361049286190,1470667950,1470668078,128
1361049292,1470673888,12,9183,765.25,1361049286126,1361049286382,1470668014,1470668270,256
1361049292,1470673888,3,898,299.3333333,1361049284205,1361049284269,1470666093,1470666157,64
1361049292,1470673888,3,1046,348.6666667,1361049284268,1361049284268,1470666156,1470666156,0
1361049292,1470673888,3,579,193,1361049284268,1361049284460,1470666156,1470666348,192
1361049292,1470673892,6,1108,184.6666667,1361049286312,1361049286376,1470668204,1470668268,64
1361049292,1470673892,3,1054,351.3333333,1361049284264,1361049284328,1470666156,1470666220,64
1361049292,1470673892,6,2773,462.1666667,1361049284332,1361049284844,1470666224,1470666736,512
1361049292,1470673892,4,805,201.25,1361049286316,1361049286380,1470668208,1470668272,64
1361049292,1470673892,5,857,171.4,1361049286316,1361049286444,1470668208,1470668336,128
1361049292,1470673892,4,216,54,1361049286379,1361049286443,1470668271,1470668335,64
1361049292,1470673892,6,2497,416.1666667,1361049286379,1361049286507,1470668271,1470668399,128
1361049292,1470673892,5,839,167.8,1361049286379,1361049286443,1470668271,1470668335,64
1361049292,1470673892,7,3422,488.8571429,1361049284395,1361049284651,1470666287,1470666543,256
1361049292,1470673908,4,216,54,1361049286424,1361049286552,1470668332,1470668460,128
1361049292,1470673908,10,3916,391.6,1361049286488,1361049287320,1470668396,1470669228,832
1361049292,1470673908,7,1715,245,1361049286488,1361049287256,1470668396,1470669164,768
1361049292,1470673908,4,1370,342.5,1361049286552,1361049287320,1470668460,1470669228,768
1361049292,1470673912,4,216,54,1361049286552,1361049286616,1470668464,1470668528,64
1361049292,1470673912,13,5862,450.9230769,1361049286743,1361049288343,1470668655,1470670255,1600
1361049292,1470673912,8,1976,247,1361049286742,1361049287510,1470668654,1470669422,768
1361049292,1470673912,6,1560,260,1361049286805,1361049286933,1470668717,1470668845,128
1361049292,1470673912,4,805,201.25,1361049286933,1361049287253,1470668845,1470669165,320
1361049293,1470673916,5,1152,230.4,1361049288187,1361049288251,1470669103,1470669167,64
1361049293,1470673916,5,2823,564.6,1361049285691,1361049286203,1470666607,1470667119,512
1361049293,1470673916,5,667,133.4,1361049288314,1361049289850,1470669230,1470670766,1536
1361049293,1470673916,5,1152,230.4,1361049288313,1361049288377,1470669229,1470669293,64
1361049293,1470673920,3,898,299.3333333,1361049285880,1361049285880,1470666800,1470666800,0
1361049293,1470673920,7,1755,250.7142857,1361049288439,1361049288567,1470669359,1470669487,128
1361049293,1470673920,14,10740,767.1428571,1361049283959,1361049285175,1470664879,1470666095,1216
1361049293,1470673920,5,594,118.8,1361049285815,1361049286071,1470666735,1470666991,256
1361049293,1470673920,3,581,193.6666667,1361049285941,1361049286069,1470666861,1470666989,128
1361049293,1470673924,9,7284,809.3333333,1361049286064,1361049286320,1470666988,1470667244,256
1361049293,1470673924,3,951,317,1361049286004,1361049286004,1470666928,1470666928,0
1361049293,1470673924,3,635,211.6666667,1361049286066,1361049286258,1470666990,1470667182,192
1361049293,1470673924,10,2915,291.5,1361049289330,1361049289842,1470670254,1470670766,512
1361049293,1470673924,5,455,91,1361049286066,1361049286194,1470666990,1470667118,128
1361049293,1470673924,3,634,211.3333333,1361049286257,1361049286257,1470667181,1470667181,0
1361049293,1470673928,5,623,124.6,1361049286188,1361049286316,1470667116,1470667244,128
1361049293,1470673928,4,651,162.75,1361049284783,1361049285167,1470665711,1470666095,384
1361049293,1470673928,3,643,214.3333333,1361049286191,1361049286255,1470667119,1470667183,64
1361049293,1470673928,6,1618,269.6666667,1361049289135,1361049289263,1470670063,1470670191,128
1361049293,1470673928,9,2851,316.7777778,1361049289326,1361049289838,1470670254,1470670766,512
1361049293,1470673928,7,1436,205.1428571,1361049289326,1361049289838,1470670254,1470670766,512
1361049293,1470673928,7,3801,543,1361049289838,1361049289902,1470670766,1470670830,64
1361049293,1470673928,13,12970,997.6923077,1361049289645,1361049289837,1470670573,1470670765,192
1361049294,1470675328,4,628,157,1361049266013,1361049266077,1470647341,1470647405,64
1361049294,1470675332,3,576,192,1361049266011,1361049266075,1470647343,1470647407,64
1361049295,108989644,7,1921,274.4285714,1361049287136,1361049287648,108981780,108982292,512
1361049295,108989644,8,2221,277.625,1361049288224,1361049289248,108982868,108983892,1024
1361049300,1470681892,4,647,161.75,1361049287338,1361049294570,1470669230,1470676462,7232
1361049301,1470681952,5,453,90.6,1361049295509,1361049295573,1470676461,1470676525,64
1361049304,108998136,134,174159,1299.69403,1361048998811,1361048999963,108692947,108694099,1152
1361049310,1470691444,1,52,52,1361049282603,1361049282603,1470664047,1470664047,0
1361049310,1470691488,1,46,46,1361049283902,1361049283902,1470665390,1470665390,0
1361049314,1470695456,1,46,46,1361049286748,1361049286748,1470668204,1470668204,0
1361049314,1470695488,1,52,52,1361049287615,1361049287615,1470669103,1470669103,0
1361049325,1470706224,4,1431,357.75,1361049316996,1361049322628,1470698220,1470703852,5632
1361049325,1470706228,16,12588,786.75,1361049319298,1361049319618,1470700526,1470700846,320
1361049325,1470706228,8,3269,408.625,1361049319425,1361049320065,1470700653,1470701293,640
1361049325,1470706228,6,2127,354.5,1361049319488,1361049319616,1470700716,1470700844,128
1361049325,1470706232,3,840,280,1361049319615,1361049319679,1470700847,1470700911,64
1361049325,1470706232,8,2812,351.5,1361049319679,1361049320127,1470700911,1470701359,448
1361049325,1470706232,13,5206,400.4615385,1361049319679,1361049321023,1470700911,1470702255,1344
1361049325,1470706232,3,976,325.3333333,1361049319678,1361049319742,1470700910,1470700974,64
1361049325,1470706232,7,3422,488.8571429,1361049319806,1361049320062,1470701038,1470701294,256
1361049325,1470706232,8,2901,362.625,1361049319805,1361049321021,1470701037,1470702253,1216
1361049325,1470706236,5,594,118.8,1361049320059,1361049320123,1470701295,1470701359,64
1361049325,1470706236,8,5553,694.125,1361049320123,1361049321019,1470701359,1470702255,896
1361049325,1470706252,3,966,322,1361049320362,1361049320362,1470701614,1470701614,0
1361049325,1470706252,3,635,211.6666667,1361049320553,1361049320681,1470701805,1470701933,128
1361049325,1470706252,3,643,214.3333333,1361049320616,1361049320680,1470701868,1470701932,64
1361049325,1470706252,6,2773,462.1666667,1361049320744,1361049321256,1470701996,1470702508,512
1361049325,1470706256,18,21405,1189.166667,1361049321061,1361049321189,1470702317,1470702445,128
1361049325,1470706264,11,8870,806.3636364,1361049318620,1361049319004,1470699884,1470700268,384
1361049325,1470706296,6,1192,198.6666667,1361049318973,1361049319549,1470700269,1470700845,576
1361049325,1470706296,23,11541,501.7826087,1361049319101,1361049319549,1470700397,1470700845,448
1361049325,1470706296,6,2127,354.5,1361049319101,1361049319293,1470700397,1470700589,192
1361049325,1470706300,8,2548,318.5,1361049319353,1361049319609,1470700653,1470700909,256
1361049325,1470706304,3,968,322.6666667,1361049319607,1361049319607,1470700911,1470700911,0
1361049325,1470706304,3,893,297.6666667,1361049319670,1361049319734,1470700974,1470701038,64
1361049325,1470706308,3,838,279.3333333,1361049320242,1361049320306,1470701550,1470701614,64
1361049325,1470706308,3,581,193.6666667,1361049320305,1361049320497,1470701613,1470701805,192
1361049325,1470706308,3,974,324.6666667,1361049320305,1361049320369,1470701613,1470701677,64
1361049325,1470706308,3,891,297,1361049320369,1361049320433,1470701677,1470701741,64
1361049325,1470706308,7,3452,493.1428571,1361049320432,1361049320688,1470701740,1470701996,256
1361049325,1470706312,3,634,211.3333333,1361049320619,1361049320619,1470701931,1470701931,0
1361049325,1470706312,3,582,194,1361049320942,1361049321134,1470702254,1470702446,192
1361049325,1470706312,3,502,167.3333333,1361049320685,1361049320749,1470701997,1470702061,64
1361049325,1470706336,11,5953,541.1818182,1361049320980,1361049321172,1470702316,1470702508,192
1361049325,1470706340,6,717,119.5,1361049321235,1361049321555,1470702575,1470702895,320
1361049326,1470707508,1,46,46,1361049299497,1361049299497,1470681005,1470681005,0
1361049327,109021636,11,10406,946,1361049319013,1361049319397,109013649,109014033,384
1361049327,109021636,5,1437,287.4,1361049320101,1361049320741,109014737,109015377,640
1361049327,109021644,25,29558,1182.32,1361049319840,1361049320736,109014484,109015380,896
1361049330,1470711472,1,52,52,1361049302540,1361049302540,1470684012,1470684012,0
1361049332,1470713892,6,2477,412.8333333,1361049329514,1361049329642,1470711406,1470711534,128
1361049332,1470713892,3,634,211.3333333,1361049329450,1361049329642,1470711342,1470711534,192
1361049332,1470713892,3,624,208,1361049329578,1361049329578,1470711470,1470711470,0
1361049332,1470713892,5,1740,348,1361049329577,1361049329897,1470711469,1470711789,320
1361049332,1470713892,4,543,135.75,1361049329577,1361049329641,1470711469,1470711533,64
1361049332,1470713892,8,3856,482,1361049329513,1361049330153,1470711405,1470712045,640
1361049332,1470713892,7,1486,212.2857143,1361049329577,1361049329769,1470711469,1470711661,192
1361049332,1470713892,4,645,161.25,1361049329577,1361049329897,1470711469,1470711789,320
1361049332,1470713892,6,895,149.1666667,1361049329577,1361049329833,1470711469,1470711725,256
1361049332,1470713892,4,548,137,1361049329577,1361049329769,1470711469,1470711661,192
1361049332,1470713892,4,652,163,1361049329577,1361049329577,1470711469,1470711469,0
1361049332,1470713892,3,858,286,1361049329576,1361049329768,1470711468,1470711660,192
1361049332,1470713896,3,540,180,1361049329639,1361049329639,1470711535,1470711535,0
1361049332,1470713896,9,8392,932.4444444,1361049325798,1361049326310,1470707694,1470708206,512
1361049332,1470713896,7,880,125.7142857,1361049329892,1361049330020,1470711788,1470711916,128
1361049332,1470713896,18,21405,1189.166667,1361049329892,1361049330788,1470711788,1470712684,896
1361049332,1470713896,6,2771,461.8333333,1361049330020,1361049330404,1470711916,1470712300,384
1361049332,1470713900,3,279,93,1361049330018,1361049330082,1470711918,1470711982,64
1361049332,1470713900,3,996,332,1361049326370,1361049326434,1470708270,1470708334,64
1361049332,1470713900,23,8459,367.7826087,1361049326369,1361049327905,1470708269,1470709805,1536
1361049332,1470713904,5,1772,354.4,1361049326555,1361049327579,1470708459,1470709483,1024
1361049332,1470713904,6,2737,456.1666667,1361049330398,1361049330526,1470712302,1470712430,128
1361049332,1470713904,5,455,91,1361049330525,1361049330589,1470712429,1470712493,64
1361049332,1470713904,9,5688,632,1361049330524,1361049330780,1470712428,1470712684,256
1361049332,1470713908,6,3063,510.5,1361049330714,1361049330842,1470712622,1470712750,128
1361049332,1470713908,6,702,117,1361049330777,1361049331097,1470712685,1470713005,320
1361049332,1470713908,6,1000,166.6666667,1361049330777,1361049330905,1470712685,1470712813,128
1361049332,1470713908,5,899,179.8,1361049330777,1361049330905,1470712685,1470712813,128
1361049332,1470713908,5,1606,321.2,1361049330777,1361049331097,1470712685,1470713005,320
1361049332,1470713908,6,965,160.8333333,1361049330840,1361049330968,1470712748,1470712876,128
1361049332,1470713908,11,4061,369.1818182,1361049330904,1361049331096,1470712812,1470713004,192
1361049332,1470713908,6,1419,236.5,1361049330904,1361049331224,1470712812,1470713132,320
1361049332,1470713912,4,1360,340,1361049330900,1361049331156,1470712812,1470713068,256
1361049332,1470713912,5,1749,349.8,1361049330963,1361049331155,1470712875,1470713067,192
1361049332,1470713912,3,164,54.66666667,1361049330967,1361049331095,1470712879,1470713007,128
1361049333,1470713932,7,3422,488.8571429,1361049328555,1361049328811,1470709487,1470709743,256
1361049333,1470713932,6,1560,260,1361049332138,1361049332266,1470713070,1470713198,128
1361049333,1470713932,7,2852,407.4285714,1361049332073,1361049332393,1470713005,1470713325,320
1361049333,1470713932,4,1202,300.5,1361049332137,1361049332265,1470713069,1470713197,128
1361049333,1470713932,10,2362,236.2,1361049332264,1361049332520,1470713196,1470713452,256
1361049333,1470713932,5,2823,564.6,1361049328872,1361049329064,1470709804,1470709996,192
1361049333,1470713932,7,1776,253.7142857,1361049332328,1361049332456,1470713260,1470713388,128
1361049333,1470713936,6,2343,390.5,1361049329127,1361049329319,1470710063,1470710255,192
1361049333,1470713936,7,1823,260.4285714,1361049332327,1361049332519,1470713263,1470713455,192
1361049333,1470713936,5,2828,565.6,1361049329318,1361049329894,1470710254,1470710830,576
1361049333,1470713936,3,634,211.3333333,1361049329445,1361049329445,1470710381,1470710381,0
1361049333,1470713936,6,1102,183.6666667,1361049332453,1361049332581,1470713389,1470713517,128
1361049333,1470713936,3,643,214.3333333,1361049329381,1361049329381,1470710317,1470710317,0
1361049333,1470713936,3,856,285.3333333,1361049329509,1361049329573,1470710445,1470710509,64
1361049333,1470713936,3,909,303,1361049329636,1361049329700,1470710572,1470710636,64
1361049333,1470713936,5,1508,301.6,1361049332708,1361049332836,1470713644,1470713772,128
1361049333,1470713936,8,3468,433.5,1361049329700,1361049329956,1470710636,1470710892,256
1361049333,1470713936,3,996,332,1361049329572,1361049329636,1470710508,1470710572,64
1361049333,1470713936,3,1004,334.6666667,1361049329635,1361049329635,1470710571,1470710571,0
1361049333,1470713936,3,634,211.3333333,1361049329763,1361049329891,1470710699,1470710827,128
1361049333,1470713940,3,633,211,1361049329891,1361049329955,1470710831,1470710895,64
1361049333,1470713940,5,594,118.8,1361049329955,1361049330211,1470710895,1470711151,256
1361049333,1470713940,5,1020,204,1361049321315,1361049331683,1470702255,1470712623,10368
1361049333,1470713940,5,594,118.8,1361049329955,1361049330019,1470710895,1470710959,64
1361049333,1470713940,9,7284,809.3333333,1361049330337,1361049330657,1470711277,1470711597,320
1361049333,1470713940,5,2784,556.8,1361049330401,1361049330529,1470711341,1470711469,128
1361049333,1470713940,5,594,118.8,1361049330528,1361049330720,1470711468,1470711660,192
1361049333,1470713940,5,1508,301.6,1361049330528,1361049330592,1470711468,1470711532,64
1361049333,1470713940,3,808,269.3333333,1361049330528,1361049330656,1470711468,1470711596,128
1361049333,1470713940,4,755,188.75,1361049330528,1361049330592,1470711468,1470711532,64
1361049333,1470713940,5,956,191.2,1361049330527,1361049330591,1470711467,1470711531,64
1361049333,1470713944,8,856,107,1361049330527,1361049330719,1470711471,1470711663,192
1361049333,1470713944,3,642,214,1361049330591,1361049330591,1470711535,1470711535,0
1361049333,1470713944,4,645,161.25,1361049330591,1361049330847,1470711535,1470711791,256
1361049333,1470713944,3,633,211,1361049330782,1361049330846,1470711726,1470711790,64
1361049333,1470713944,3,502,167.3333333,1361049330781,1361049330845,1470711725,1470711789,64
1361049333,1470713944,33,41940,1270.909091,1361049330845,1361049331677,1470711789,1470712621,832
1361049333,1470713944,11,5956,541.4545455,1361049330908,1361049331740,1470711852,1470712684,832
1361049333,1470713948,4,645,161.25,1361049331035,1361049331739,1470711983,1470712687,704
1361049333,1470713948,3,856,285.3333333,1361049327195,1361049327259,1470708143,1470708207,64
1361049333,1470713972,18,8072,448.4444444,1361049327298,1361049328834,1470708270,1470709806,1536
1361049333,1470713972,15,10792,719.4666667,1361049327490,1361049328834,1470708462,1470709806,1344
1361049333,1470713972,3,1004,334.6666667,1361049327361,1361049327425,1470708333,1470708397,64
1361049333,1470713972,5,623,124.6,1361049331264,1361049331328,1470712236,1470712300,64
1361049333,1470713976,5,594,118.8,1361049331327,1361049331583,1470712303,1470712559,256
1361049333,1470713976,5,512,102.4,1361049331454,1361049332030,1470712430,1470713006,576
1361049333,1470713980,6,1108,184.6666667,1361049331707,1361049331771,1470712687,1470712751,64
1361049333,1470713980,4,1318,329.5,1361049331707,1361049331835,1470712687,1470712815,128
1361049333,1470713980,5,857,171.4,1361049331707,1361049332027,1470712687,1470713007,320
1361049333,1470713980,3,164,54.66666667,1361049331707,1361049331707,1470712687,1470712687,0
1361049333,1470713980,7,856,122.2857143,1361049331707,1361049331835,1470712687,1470712815,128
1361049333,1470713980,5,786,157.2,1361049331770,1361049331898,1470712750,1470712878,128
1361049333,1470713980,3,164,54.66666667,1361049331770,1361049331834,1470712750,1470712814,64
1361049333,1470713980,4,1370,342.5,1361049331897,1361049332089,1470712877,1470713069,192
1361049333,1470713980,28,35784,1278,1361049331960,1361049332024,1470712940,1470713004,64
1361049333,1470713980,6,1560,260,1361049332023,1361049332151,1470713003,1470713131,128
1361049333,1470713984,5,1291,258.2,1361049332087,1361049332215,1470713071,1470713199,128
1361049333,1470713984,3,502,167.3333333,1361049328822,1361049328822,1470709806,1470709806,0
1361049333,1470713984,6,1560,260,1361049332086,1361049332214,1470713070,1470713198,128
1361049333,1470713984,6,1560,260,1361049332213,1361049332341,1470713197,1470713325,128
1361049333,1470713984,6,1094,182.3333333,1361049332213,1361049332469,1470713197,1470713453,256
1361049333,1470713988,4,651,162.75,1361049329007,1361049329839,1470709995,1470710827,832
1361049333,1470713988,3,581,193.6666667,1361049329011,1361049329203,1470709999,1470710191,192
1361049333,1470713988,3,635,211.6666667,1361049329203,1361049329395,1470710191,1470710383,192
1361049333,1470713988,3,580,193.3333333,1361049329522,1361049329714,1470710510,1470710702,192
1361049333,1470713988,6542,9306971,1422.64919,1361049241137,1361049329137,1470622125,1470710125,88000
1361049333,1470713988,6,2773,462.1666667,1361049329457,1361049329905,1470710445,1470710893,448
1361049333,1470713988,7,3173,453.2857143,1361049329841,1361049330033,1470710829,1470711021,192
1361049333,1470713988,5,623,124.6,1361049329905,1361049330033,1470710893,1470711021,128
1361049333,1470713988,3,642,214,1361049329776,1361049329840,1470710764,1470710828,64
1361049333,1470713988,5,2823,564.6,1361049329968,1361049330416,1470710956,1470711404,448
1361049333,1470713988,5,2726,545.2,1361049329968,1361049330416,1470710956,1470711404,448
1361049333,1470713988,3,996,332,1361049330160,1361049330224,1470711148,1470711212,64
1361049333,1470713988,10,5610,561,1361049330032,1361049330352,1470711020,1470711340,320
1361049333,1470714004,3,1004,334.6666667,1361049330208,1361049330208,1470711212,1470711212,0
1361049333,1470714004,3,856,285.3333333,1361049330144,1361049330144,1470711148,1470711148,0
1361049333,1470714004,3,580,193.3333333,1361049330207,1361049330335,1470711211,1470711339,128
1361049333,1470714004,3,909,303,1361049330207,1361049330271,1470711211,1470711275,64
1361049334,1470715468,1,52,52,1361049305874,1361049305874,1470687342,1470687342,0
1361049334,1470715468,4,628,157,1361049305874,1361049305938,1470687342,1470687406,64
1361049332,109026296,11,10406,946,1361049327293,1361049328637,109021589,109022933,1344
1361049332,109026296,5,1569,313.8,1361049332093,1361049332093,109026389,109026389,0
1361049335,109029652,7,2582,368.8571429,1361049331673,1361049331737,109026325,109026389,64
1361049335,109029652,9,4021,446.7777778,1361049320791,1361049329303,109015443,109023955,8512
1361049335,109029656,7,4950,707.1428571,1361049329876,1361049329876,109024532,109024532,0
1361049335,109029656,5,1456,291.2,1361049329620,1361049329876,109024276,109024532,256
1361049335,109029656,27,34307,1270.62963,1361049330068,1361049330260,109024724,109024916,192
1361049335,109029656,4,699,174.75,1361049329940,1361049330068,109024596,109024724,128
1361049335,109029656,14,15452,1103.714286,1361049331538,1361049331666,109026194,109026322,128
1361049338,1470719532,1,52,52,1361049312658,1361049312658,1470694190,1470694190,0
1361049340,1470721884,2792,3962745,1419.321275,1361049024946,1361049038194,1470406830,1470420078,13248
1361049340,1470721888,5,632,126.4,1361049332270,1361049332526,1470714158,1470714414,256
1361049340,1470721888,6,4257,709.5,1361049329901,1361049335021,1470711789,1470716909,5120
1361049340,1470721896,3,608,202.6666667,1361049335015,1361049335079,1470716911,1470716975,64
1361049340,1470721896,5,1152,230.4,1361049335140,1361049335204,1470717036,1470717100,64
1361049340,1470721900,5,667,133.4,1361049335394,1361049335586,1470717294,1470717486,192
1361049341,1470721928,1305,1854079,1420.750192,1361049329261,1361049337645,1470710189,1470718573,8384
1361049341,1470721932,5,715,143,1361049332968,1361049333224,1470713900,1470714156,256
1361049341,1470721968,4,555,138.75,1361049335943,1361049336071,1470716911,1470717039,128
1361049341,1470721968,5,693,138.6,1361049336006,1361049340806,1470716974,1470721774,4800
1361049341,1470721968,6,2088,348,1361049335942,1361049336262,1470716910,1470717230,320
1361049341,1470721968,7,3396,485.1428571,1361049336196,1361049336260,1470717164,1470717228,64
1361049341,1470721968,5,667,133.4,1361049336196,1361049336324,1470717164,1470717292,128
1361049341,1470721968,5,319,63.8,1361049336196,1361049336324,1470717164,1470717292,128
1361049341,1470721980,5,1282,256.4,1361049332474,1361049336890,1470713454,1470717870,4416
1361049341,1470721980,6,1419,236.5,1361049332538,1361049337722,1470713518,1470718702,5184
1361049341,1470721980,8,1646,205.75,1361049332601,1361049337785,1470713581,1470718765,5184
1361049341,1470721980,6,1637,272.8333333,1361049332793,1361049332921,1470713773,1470713901,128
1361049342,1470723360,24,28060,1169.166667,1361049316860,1361049316924,1470698220,1470698284,64
1361049342,1470723468,25,31898,1275.92,1361049316753,1361049316753,1470698221,1470698221,0
1361049342,1470723468,5,2992,598.4,1361049316880,1361049320976,1470698348,1470702444,4096
1361049346,1470727540,1,46,46,1361049320968,1361049320968,1470702508,1470702508,0
1361049348,1470729900,11,1282,116.5454545,1361049342817,1361049343009,1470724717,1470724909,192
1361049350,1470731388,2338,3329566,1424.10864,1361049321633,1361049342881,1470703021,1470724269,21248
1361049354,1470735440,1,52,52,1361049328814,1361049328814,1470710254,1470710254,0
1361049354,1470735512,1,46,46,1361049327332,1361049327332,1470708844,1470708844,0
1361049356,1470737888,5,587,117.4,1361049329453,1361049350573,1470711341,1470732461,21120
1361049357,1470737944,5,453,90.6,1361049351518,1361049351582,1470732462,1470732526,64
1361049358,1470739436,1,52,52,1361049331568,1361049331568,1470713004,1470713004,0
1361049358,1470739476,1,52,52,1361049330312,1361049330312,1470711788,1470711788,0
1361049358,1470739556,7,2759,394.1428571,1361049331835,1361049331963,1470713391,1470713519,128
1361049358,1470739556,3,753,251,1361049331899,1361049331899,1470713455,1470713455,0
1361049360,109054268,4,464,116,1361049332118,1361049332182,109026386,109026450,64
1361049360,109054320,11,3390,308.1818182,1361049332068,1361049333028,109026388,109027348,960
1361049362,1470743568,1,52,52,1361049336812,1361049336812,1470718380,1470718380,0
1361049362,1470743568,1,52,52,1361049336812,1361049336812,1470718380,1470718380,0
1361049362,1470743568,1,52,52,1361049336812,1361049336812,1470718380,1470718380,0
1361049374,1470755456,1,52,52,1361049346012,1361049346012,1470727468,1470727468,0
1361049374,1470755456,4,628,157,1361049346011,1361049346075,1470727467,1470727531,64
1361049382,1470763416,1,52,52,1361049356485,1361049356485,1470737901,1470737901,0
1361049386,1470767456,1,52,52,1361049360348,1361049360348,1470741804,1470741804,0
1361049386,1470767540,17,8512,500.7058824,1361049360266,1361049362890,1470741806,1470744430,2624
1361049389,1470769952,5,453,90.6,1361049381526,1361049381590,1470762478,1470762542,64
1361049391,109085656,28,35625,1272.321429,1361049390162,1361049390226,109084818,109084882,64
1361049391,109085656,7,1986,283.7142857,1361049390610,1361049390866,109085266,109085522,256
1361049396,1470777900,5,594,118.8,1361049389409,1361049389665,1470771309,1470771565,256
1361049396,1470777904,6,2916,486,1361049389790,1361049389918,1470771694,1470771822,128
1361049396,1470777904,6,994,165.6666667,1361049389790,1361049389918,1470771694,1470771822,128
1361049396,1470777904,5,1606,321.2,1361049389790,1361049389918,1470771694,1470771822,128
1361049396,1470777904,6,1108,184.6666667,1361049389790,1361049389854,1470771694,1470771758,64
1361049396,1470777904,4,216,54,1361049389854,1361049389918,1470771758,1470771822,64
1361049396,1470777904,5,594,118.8,1361049389854,1361049390046,1470771758,1470771950,192
1361049396,1470777904,6,965,160.8333333,1361049389853,1361049389917,1470771757,1470771821,64
1361049396,1470777904,6,1419,236.5,1361049389917,1361049390173,1470771821,1470772077,256
1361049396,1470777904,6,1452,242,1361049389980,1361049390172,1470771884,1470772076,192
1361049396,1470777904,4,216,54,1361049390044,1361049390108,1470771948,1470772012,64
1361049396,1470777904,7,1709,244.1428571,1361049390107,1361049390491,1470772011,1470772395,384
1361049396,1470777904,6,1560,260,1361049390171,1361049390299,1470772075,1470772203,128
1361049396,1470777904,6,1446,241,1361049390107,1361049390491,1470772011,1470772395,384
1361049396,1470777904,3,156,52,1361049390235,1361049390235,1470772139,1470772139,0
1361049396,1470777904,16,8275,517.1875,1361049390235,1361049390555,1470772139,1470772459,320
1361049396,1470777908,7,1826,260.8571429,1361049390234,1361049390490,1470772142,1470772398,256
1361049396,1470777908,6,1613,268.8333333,1361049390425,1361049390617,1470772333,1470772525,192
1361049396,1470777908,5,2732,546.4,1361049390425,1361049390617,1470772333,1470772525,192
1361049396,1470777908,7,2722,388.8571429,1361049390552,1361049391576,1470772460,1470773484,1024
1361049396,1470777908,5,623,124.6,1361049390679,1361049390807,1470772587,1470772715,128
1361049396,1470777908,5,1508,301.6,1361049390743,1361049390807,1470772651,1470772715,64
1361049397,1470777912,3,502,167.3333333,1361049391739,1361049391931,1470772651,1470772843,192
1361049397,1470777912,6,1081,180.1666667,1361049391870,1361049391998,1470772782,1470772910,128
1361049397,1470777912,10,5652,565.2,1361049391870,1361049392318,1470772782,1470773230,448
1361049397,1470777912,5,956,191.2,1361049392315,1361049392379,1470773227,1470773291,64
1361049397,1470777912,7,1550,221.4285714,1361049392315,1361049392443,1470773227,1470773355,128
1361049397,1470777912,3,540,180,1361049392379,1361049392379,1470773291,1470773291,0
1361049397,1470777912,4,652,163,1361049392315,1361049392315,1470773227,1470773227,0
1361049397,1470777916,4,543,135.75,1361049392310,1361049392374,1470773226,1470773290,64
1361049397,1470777916,5,1508,301.6,1361049392314,1361049392378,1470773230,1470773294,64
1361049397,1470777916,4,548,137,1361049392314,1361049392506,1470773230,1470773422,192
1361049397,1470777916,6,895,149.1666667,1361049392314,1361049392570,1470773230,1470773486,256
1361049397,1470777944,6,1618,269.6666667,1361049392477,1361049392605,1470773421,1470773549,128
1361049397,1470777956,5,455,91,1361049390480,1361049390608,1470771436,1470771564,128
1361049397,1470777956,6,2774,462.3333333,1361049390480,1361049390736,1470771436,1470771692,256
1361049397,1470777956,9,5713,634.7777778,1361049390479,1361049390735,1470771435,1470771691,256
1361049397,1470777960,5,899,179.8,1361049390734,1361049390990,1470771694,1470771950,256
1361049397,1470777960,5,857,171.4,1361049390734,1361049390862,1470771694,1470771822,128
1361049397,1470777960,5,786,157.2,1361049390798,1361049391118,1470771758,1470772078,320
1361049397,1470777960,6,702,117,1361049390734,1361049391054,1470771694,1470772014,320
1361049397,1470777960,9,908,100.8888889,1361049390734,1361049391118,1470771694,1470772078,384
1361049397,1470777960,4,216,54,1361049390861,1361049390989,1470771821,1470771949,128
1361049397,1470777960,6,1094,182.3333333,1361049390924,1361049391116,1470771884,1470772076,192
1361049397,1470777960,6,1560,260,1361049391052,1361049391180,1470772012,1470772140,128
1361049397,1470777964,5,1245,249,1361049391238,1361049391366,1470772202,1470772330,128
1361049397,1470777964,4,805,201.25,1361049391370,1361049392202,1470772334,1470773166,832
1361049397,1470777964,6,1560,260,1361049391433,1361049391561,1470772397,1470772525,128
1361049397,1470777964,8,856,107,1361049391433,1361049391689,1470772397,1470772653,256
1361049397,1470777984,7,3216,459.4285714,1361049391603,1361049391795,1470772587,1470772779,192
1361049397,1470777984,7,1755,250.7142857,1361049391667,1361049391795,1470772651,1470772779,128
1361049397,1470777992,3,624,208,1361049392238,1361049392238,1470773230,1470773230,0
1361049397,1470777992,5,1740,348,1361049392238,1361049392366,1470773230,1470773358,128
1361049397,1470777992,3,703,234.3333333,1361049392238,1361049392302,1470773230,1470773294,64
1361049397,1470777992,5,623,124.6,1361049392173,1361049392237,1470773165,1470773229,64
1361049397,1470777992,3,808,269.3333333,1361049392236,1361049392364,1470773228,1470773356,128
1361049397,1470777992,7,804,114.8571429,1361049392236,1361049392556,1470773228,1470773548,320
1361049397,1470777992,3,858,286,1361049392236,1361049392428,1470773228,1470773420,192
1361049397,1470778000,5,2734,546.8,1361049389986,1361049390178,1470770986,1470771178,192
1361049397,1470778000,5,623,124.6,1361049390245,1361049390309,1470771245,1470771309,64
1361049397,1470778000,6,2742,457,1361049390243,1361049390371,1470771243,1470771371,128
1361049396,109090344,7,4950,707.1428571,1361049391947,1361049392011,109086291,109086355,64
1361049405,1470785948,5,1152,230.4,1361049392409,1361049397593,1470773357,1470778541,5184
1361049405,1470785952,7,1374,196.2857143,1361049392598,1361049396950,1470773550,1470777902,4352
1361049405,1470785964,2105,2990815,1420.814727,1361049350600,1361049397960,1470731564,1470778924,47360
1361049406,1470787588,1,52,52,1361049379158,1361049379158,1470760746,1470760746,0
1361049408,109102284,1,52,52,1361049383815,1361049383815,109078099,109078099,0
1361049413,1470794000,13,13054,1004.153846,1361049406246,1361049406246,1470787246,1470787246,0
1361049413,1470794000,14,13702,978.7142857,1361049406118,1361049406246,1470787118,1470787246,128
1361049413,1470794020,13,13333,1025.615385,1361049406094,1361049406222,1470787114,1470787242,128
1361049413,1470794040,16,17040,1065,1361049406077,1361049406205,1470787117,1470787245,128
1361049413,1470794040,9,7890,876.6666667,1361049406139,1361049406203,1470787179,1470787243,64
1361049413,1470794076,2,92,46,1361049399769,1361049411801,1470780845,1470792877,12032
1361049413,1470794080,20,23808,1190.4,1361049405908,1361049406164,1470786988,1470787244,256
1361049413,1470794080,7,880,125.7142857,1361049392274,1361049407378,1470773354,1470788458,15104
1361049413,1470794084,10,9124,912.4,1361049406096,1361049406160,1470787180,1470787244,64
1361049414,1470795460,1,52,52,1361049386009,1361049386009,1470767469,1470767469,0
1361049414,1470795544,4,628,157,1361049385923,1361049385987,1470767467,1470767531,64
1361049416,109110288,1,52,52,1361049390980,1361049390980,109085268,109085268,0
1361049416,109110336,1,52,52,1361049390932,1361049390932,109085268,109085268,0
1361049418,1470799440,2,112,56,1361049389995,1361049389995,1470771435,1470771435,0
1361049418,1470799536,1,52,52,1361049390154,1361049390154,1470771690,1470771690,0
1361049418,1470799572,3,1266,422,1361049391656,1361049391720,1470773228,1470773292,64
1361049418,1470799576,1,46,46,1361049391974,1361049391974,1470773550,1470773550,0
1361049420,109114264,3,647,215.6666667,1361049392093,1361049392157,109086357,109086421,64
1361049422,1470803516,1,52,52,1361049395679,1361049395679,1470777195,1470777195,0
1361049422,1470803516,3,469,156.3333333,1361049395679,1361049395743,1470777195,1470777259,64
1361049426,1470807532,1,76,76,1361049398801,1361049398801,1470780333,1470780333,0
1361049429,1470810016,9,7694,854.8888889,1361049426581,1361049426645,1470807597,1470807661,64
1361049429,1470810016,10,9409,940.9,1361049426581,1361049426645,1470807597,1470807661,64
1361049429,1470810016,11,10517,956.0909091,1361049426581,1361049426645,1470807597,1470807661,64
1361049429,1470810016,5,453,90.6,1361049426581,1361049426709,1470807597,1470807725,128
1361049429,1470810028,13,13175,1013.461538,1361049406216,1361049426568,1470787244,1470807596,20352
1361049429,1470810060,13,13193,1014.846154,1361049426537,1361049426601,1470807597,1470807661,64
1361049429,1470810060,8,6997,874.625,1361049426537,1361049426601,1470807597,1470807661,64
1361049429,1470810060,10,9898,989.8,1361049426537,1361049426601,1470807597,1470807661,64
1361049429,1470810100,10,9165,916.5,1361049406144,1361049426496,1470787244,1470807596,20352
1361049429,1470810100,9,7820,868.8888889,1361049406144,1361049426496,1470787244,1470807596,20352
1361049429,1470810128,14,15564,1111.714286,1361049425827,1361049426467,1470806955,1470807595,640
1361049430,1470811516,1,52,52,1361049405601,1361049405601,1470787117,1470787117,0
1361049430,1470811624,1,52,52,1361049405493,1361049405493,1470787117,1470787117,0
1361049438,1470819652,4,1018,254.5,1361049413079,1361049413079,1470794731,1470794731,0
1361049438,1470819656,14,14292,1020.857143,1361049413141,1361049414037,1470794797,1470795693,896
1361049445,1470826072,2,104,52,1361049437148,1361049437404,1470818220,1470818476,256
1361049445,1470826072,8,6935,866.875,1361049426651,1361049444635,1470807723,1470825707,17984
1361049450,1470831604,1,52,52,1361049425351,1361049425351,1470806955,1470806955,0
1361049453,1470834004,5,1686,337.2,1361049444894,1361049445214,1470825898,1470826218,320
1361049453,1470834004,211,296610,1405.734597,1361049444897,1361049445217,1470825901,1470826221,320
1361049453,1470834004,5,594,118.8,1361049450591,1361049450847,1470831595,1470831851,256
1361049453,1470834008,4,521,130.25,1361049445149,1361049445213,1470826157,1470826221,64
1361049453,1470834008,7,5329,761.2857143,1361049445213,1361049445277,1470826221,1470826285,64
1361049453,1470834008,7,5070,724.2857143,1361049445213,1361049446045,1470826221,1470827053,832
1361049453,1470834008,6,3605,600.8333333,1361049445213,1361049446045,1470826221,1470827053,832
1361049453,1470834008,7,5354,764.8571429,1361049445213,1361049446045,1470826221,1470827053,832
1361049453,1470834008,6,3503,583.8333333,1361049445213,1361049446045,1470826221,1470827053,832
1361049453,1470834012,4,356,89,1361049426904,1361049445464,1470807916,1470826476,18560
1361049453,1470834012,4,547,136.75,1361049451414,1361049451542,1470832426,1470832554,128
1361049453,1470834012,4,611,152.75,1361049451414,1361049451542,1470832426,1470832554,128
1361049453,1470834012,4,652,163,1361049451414,1361049451606,1470832426,1470832618,192
1361049453,1470834016,16,12588,786.75,1361049451541,1361049451989,1470832557,1470833005,448
1361049453,1470834016,6,2328,388,1361049451605,1361049451733,1470832621,1470832749,128
1361049453,1470834020,3,939,313,1361049452048,1361049452048,1470833068,1470833068,0
1361049453,1470834020,3,860,286.6666667,1361049452112,1361049452176,1470833132,1470833196,64
1361049453,1470834048,5,2725,545,1361049452402,1361049452850,1470833450,1470833898,448
1361049453,1470834048,5,2823,564.6,1361049452466,1361049452722,1470833514,1470833770,256
1361049453,1470834048,26,31950,1228.846154,1361049449523,1361049450611,1470830571,1470831659,1088
1361049453,1470834048,2,534,267,1361049452787,1361049452851,1470833835,1470833899,64
1361049453,1470834048,3,947,315.6666667,1361049452786,1361049452850,1470833834,1470833898,64
1361049453,1470834048,4,766,191.5,1361049444850,1361049445170,1470825898,1470826218,320
1361049453,1470834048,2,814,407,1361049452850,1361049452850,1470833898,1470833898,0
1361049453,1470834056,4,2687,671.75,1361049450668,1361049450732,1470831724,1470831788,64
1361049453,1470834056,7,4513,644.7142857,1361049445163,1361049445995,1470826219,1470827051,832
1361049453,1470834056,6,4107,684.5,1361049445163,1361049445995,1470826219,1470827051,832
1361049453,1470834060,13,12032,925.5384615,1361049450793,1361049451177,1470831853,1470832237,384
1361049453,1470834060,4,431,107.75,1361049426792,1361049446440,1470807852,1470827500,19648
1361049453,1470834060,4,356,89,1361049445416,1361049445992,1470826476,1470827052,576
1361049453,1470834064,25,14126,565.04,1361049451301,1361049451621,1470832365,1470832685,320
1361049453,1470834084,44,54127,1230.159091,1361049443535,1361049445327,1470824619,1470826411,1792
1361049453,1470834084,4,766,191.5,1361049445966,1361049446030,1470827050,1470827114,64
1361049453,1470834088,5,2823,564.6,1361049451722,1361049451914,1470832810,1470833002,192
1361049453,1470834088,3,807,269,1361049451917,1361049451981,1470833005,1470833069,64
1361049453,1470834088,3,580,193.3333333,1361049451981,1361049452109,1470833069,1470833197,128
1361049453,1470834088,1312,1851682,1411.342988,1361049446029,1361049450893,1470827117,1470831981,4864
1361049453,1470834088,3,634,211.3333333,1361049452107,1361049452299,1470833195,1470833387,192
1361049453,1470834088,3,947,315.6666667,1361049451978,1361049452042,1470833066,1470833130,64
1361049453,1470834092,3,642,214,1361049452230,1361049452294,1470833322,1470833386,64
1361049453,1470834092,7,3422,488.8571429,1361049452105,1361049452361,1470833197,1470833453,256
1361049453,1470834092,36,45636,1267.666667,1361049449478,1361049449606,1470830570,1470830698,128
1361049453,1470834092,5,2619,523.8,1361049452230,1361049452358,1470833322,1470833450,128
1361049453,1470834096,3,807,269,1361049452677,1361049452741,1470833773,1470833837,64
1361049453,1470834096,3,633,211,1361049452293,1361049452293,1470833389,1470833389,0
1361049453,1470834096,3,939,313,1361049452741,1361049452741,1470833837,1470833837,0
1361049453,1470834096,5,594,118.8,1361049452357,1361049452421,1470833453,1470833517,64
1361049453,1470834096,5,408,81.6,1361049444802,1361049445122,1470825898,1470826218,320
1361049453,1470834100,7,2823,403.2857143,1361049450113,1361049450433,1470831213,1470831533,320
1361049454,1470835640,1,52,52,1361049426277,1361049426277,1470807917,1470807917,0
1361049455,109149668,5,1368,273.6,1361049452232,1361049452424,109146900,109147092,192
1361049455,109149668,36,46327,1286.861111,1361049449095,1361049449159,109143763,109143827,64
1361049455,109149668,7,2536,362.2857143,1361049452743,1361049453127,109147411,109147795,384
1361049455,109149672,4,1032,258,1361049453318,1361049453382,109147990,109148054,64
1361049455,109149672,5,1368,273.6,1361049453765,1361049453765,109148437,109148437,0
1361049455,109149672,5,1368,273.6,1361049451461,1361049451973,109146133,109146645,512
1361049455,109149672,28,35253,1259.035714,1361049453892,1361049454340,109148564,109149012,448
1361049455,109149672,4,1068,267,1361049454852,1361049454916,109149524,109149588,64
1361049455,109149676,4,464,116,1361049453375,1361049453759,109148051,109148435,384
1361049455,109149676,19,21871,1151.105263,1361049450047,1361049450111,109144723,109144787,64
1361049455,109149676,11,10406,946,1361049451070,1361049451070,109145746,109145746,0
1361049461,1470842004,7,3337,476.7142857,1361049452959,1361049453279,1470833963,1470834283,320
1361049461,1470842004,8,1248,156,1361049446495,1361049456671,1470827499,1470837675,10176
1361049461,1470842004,3,634,211.3333333,1361049453022,1361049453150,1470834026,1470834154,128
1361049461,1470842008,3,502,167.3333333,1361049453212,1361049453276,1470834220,1470834284,64
1361049461,1470842012,11,5904,536.7272727,1361049455447,1361049455639,1470836459,1470836651,192
1361049461,1470842012,3,642,214,1361049455383,1361049455383,1470836395,1470836395,0
1361049461,1470842012,4,592,148,1361049455383,1361049455383,1470836395,1470836395,0
1361049461,1470842012,3,939,313,1361049453463,1361049453527,1470834475,1470834539,64
1361049461,1470842012,3,860,286.6666667,1361049453590,1361049453590,1470834602,1470834602,0
1361049461,1470842016,6,2771,461.8333333,1361049455570,1361049456082,1470836586,1470837098,512
1361049461,1470842016,7,3422,488.8571429,1361049453589,1361049453909,1470834605,1470834925,320
1361049461,1470842016,5,518,103.6,1361049453589,1361049455957,1470834605,1470836973,2368
1361049461,1470842016,5,594,118.8,1361049453652,1361049453908,1470834668,1470834924,256
1361049461,1470842020,3,502,167.3333333,1361049453905,1361049453905,1470834925,1470834925,0
1361049461,1470842020,7,3216,459.4285714,1361049456081,1361049456209,1470837101,1470837229,128
1361049461,1470842020,5,617,123.4,1361049456081,1361049456145,1470837101,1470837165,64
1361049461,1470842020,5,2823,564.6,1361049453904,1361049454288,1470834924,1470835308,384
1361049461,1470842020,6,2774,462.3333333,1361049456080,1361049456528,1470837100,1470837548,448
1361049461,1470842020,5,594,118.8,1361049456080,1361049456336,1470837100,1470837356,256
1361049461,1470842020,4,615,153.75,1361049453904,1361049453968,1470834924,1470834988,64
1361049461,1470842020,1302,1849801,1420.738095,1361049451983,1361049457871,1470833003,1470838891,5888
1361049461,1470842024,8,3856,482,1361049456524,1361049457228,1470837548,1470838252,704
1361049461,1470842024,7,3174,453.4285714,1361049456524,1361049456780,1470837548,1470837804,256
1361049461,1470842024,5,594,118.8,1361049456524,1361049456780,1470837548,1470837804,256
1361049461,1470842044,5,617,123.4,1361049456632,1361049456696,1470837676,1470837740,64
1361049461,1470842044,3,580,193.3333333,1361049454264,1361049454456,1470835308,1470835500,192
1361049461,1470842044,6,2479,413.1666667,1361049454264,1361049454392,1470835308,1470835436,128
1361049461,1470842044,5,594,118.8,1361049454327,1361049454583,1470835371,1470835627,256
1361049461,1470842044,6,2343,390.5,1361049454327,1361049454455,1470835371,1470835499,128
1361049461,1470842044,5,1740,348,1361049456695,1361049456823,1470837739,1470837867,128
1361049461,1470842044,3,703,234.3333333,1361049456695,1361049456823,1470837739,1470837867,128
1361049461,1470842044,3,624,208,1361049456695,1361049456695,1470837739,1470837739,0
1361049461,1470842044,7,1484,212,1361049456695,1361049456887,1470837739,1470837931,192
1361049461,1470842044,3,808,269.3333333,1361049456695,1361049456823,1470837739,1470837867,128
1361049461,1470842044,3,540,180,1361049456759,1361049456759,1470837803,1470837803,0
1361049461,1470842044,3,858,286,1361049456759,1361049456887,1470837803,1470837931,128
1361049461,1470842044,10,5524,552.4,1361049456759,1361049457527,1470837803,1470838571,768
1361049461,1470842044,5,1152,230.4,1361049456823,1361049457527,1470837867,1470838571,704
1361049461,1470842048,3,624,208,1361049457523,1361049457587,1470838571,1470838635,64
1361049461,1470842048,3,703,234.3333333,1361049457587,1361049457651,1470838635,1470838699,64
1361049461,1470842048,5,1508,301.6,1361049457587,1361049457651,1470838635,1470838699,64
1361049461,1470842048,4,413,103.25,1361049452851,1361049452915,1470833899,1470833963,64
1361049461,1470842048,6,895,149.1666667,1361049457587,1361049457779,1470838635,1470838827,192
1361049461,1470842048,8,856,107,1361049457587,1361049457843,1470838635,1470838891,256
1361049461,1470842048,5,956,191.2,1361049457586,1361049457650,1470838634,1470838698,64
1361049461,1470842048,5,2331,466.2,1361049457842,1361049457842,1470838890,1470838890,0
1361049461,1470842048,4,543,135.75,1361049457586,1361049457842,1470838634,1470838890,256
1361049461,1470842052,3,540,180,1361049457777,1361049457841,1470838829,1470838893,64
1361049461,1470842052,3,634,211.3333333,1361049454448,1361049454576,1470835500,1470835628,128
1361049461,1470842052,5,623,124.6,1361049452912,1361049452976,1470833964,1470834028,64
1361049461,1470842052,7,3453,493.2857143,1361049452912,1361049453168,1470833964,1470834220,256
1361049461,1470842052,5,2828,565.6,1361049454448,1361049454832,1470835500,1470835884,384
1361049461,1470842052,5,594,118.8,1361049452911,1361049453167,1470833963,1470834219,256
1361049461,1470842052,3,642,214,1361049453039,1361049453103,1470834091,1470834155,64
1361049461,1470842056,3,633,211,1361049453098,1361049453098,1470834154,1470834154,0
1361049461,1470842056,6,2771,461.8333333,1361049453165,1361049453613,1470834221,1470834669,448
1361049461,1470842056,5,2828,565.6,1361049453165,1361049453357,1470834221,1470834413,192
1361049461,1470842056,5,623,124.6,1361049453229,1361049453293,1470834285,1470834349,64
1361049461,1470842056,4,699,174.75,1361049453228,1361049453356,1470834284,1470834412,128
1361049461,1470842056,18,21405,1189.166667,1361049455339,1361049455403,1470836395,1470836459,64
1361049461,1470842056,4,545,136.25,1361049453354,1361049453610,1470834410,1470834666,256
1361049461,1470842056,3,807,269,1361049453418,1361049453418,1470834474,1470834474,0
1361049461,1470842056,11,5903,536.6363636,1361049455402,1361049455594,1470836458,1470836650,192
1361049461,1470842060,3,947,315.6666667,1361049453478,1361049453542,1470834538,1470834602,64
1361049461,1470842060,3,580,193.3333333,1361049453477,1361049453605,1470834537,1470834665,128
1361049461,1470842060,3,633,211,1361049455337,1361049455401,1470836397,1470836461,64
1361049461,1470842060,3,581,193.6666667,1361049455401,1361049455529,1470836461,1470836589,128
1361049461,1470842060,7,3337,476.7142857,1361049453544,1361049453800,1470834604,1470834860,256
1361049461,1470842060,3,279,93,1361049455464,1361049455528,1470836524,1470836588,64
1361049461,1470842060,3,635,211.6666667,1361049455528,1361049455720,1470836588,1470836780,192
1361049461,1470842060,3,634,211.3333333,1361049453608,1361049453800,1470834668,1470834860,192
1361049461,1470842080,3,643,214.3333333,1361049455826,1361049455890,1470836906,1470836970,64
1361049461,1470842084,3,642,214,1361049453713,1361049453713,1470834797,1470834797,0
1361049461,1470842084,3,634,211.3333333,1361049455889,1361049455953,1470836973,1470837037,64
1361049461,1470842084,3,633,211,1361049453776,1361049453776,1470834860,1470834860,0
1361049461,1470842088,6,2772,462,1361049453833,1361049454281,1470834921,1470835369,448
1361049461,1470842088,1303,1851227,1420.742134,1361049448332,1361049454028,1470829420,1470835116,5696
1361049461,1470842088,4,545,136.25,1361049453900,1361049454220,1470834988,1470835308,320
1361049461,1470842088,10,5651,565.1,1361049456203,1361049456587,1470837291,1470837675,384
1361049461,1470842088,5,956,191.2,1361049456650,1361049456778,1470837738,1470837866,128
1361049461,1470842092,4,1318,329.5,1361049456649,1361049456777,1470837741,1470837869,128
1361049461,1470842092,6,895,149.1666667,1361049456713,1361049456905,1470837805,1470837997,192
1361049461,1470842092,4,548,137,1361049456713,1361049456841,1470837805,1470837933,128
1361049461,1470842092,4,651,162.75,1361049454216,1361049454280,1470835308,1470835372,64
1361049461,1470842092,11,2278,207.0909091,1361049456840,1361049457608,1470837932,1470838700,768
1361049461,1470842092,4,652,163,1361049456646,1361049456710,1470837738,1470837802,64
1361049461,1470842092,4,543,135.75,1361049456646,1361049456774,1470837738,1470837866,128
1361049461,1470842092,5,1508,301.6,1361049456646,1361049456774,1470837738,1470837866,128
1361049461,1470842092,8,856,107,1361049456710,1361049456838,1470837802,1470837930,128
1361049461,1470842096,4,1318,329.5,1361049457475,1361049457539,1470838571,1470838635,64
1361049461,1470842096,4,652,163,1361049457475,1361049457731,1470838571,1470838827,256
1361049461,1470842096,5,1740,348,1361049457475,1361049457795,1470838571,1470838891,320
1361049461,1470842096,5,3446,689.2,1361049457091,1361049457347,1470838187,1470838443,256
1361049461,1470842096,4,548,137,1361049457539,1361049457795,1470838635,1470838891,256
1361049461,1470842096,2,92,46,1361049457730,1361049457730,1470838826,1470838826,0
1361049461,1470842096,3,808,269.3333333,1361049457538,1361049457794,1470838634,1470838890,256
1361049461,1470842096,3,858,286,1361049457538,1361049457730,1470838634,1470838826,192
1361049461,1470842100,4,645,161.25,1361049457790,1361049457854,1470838890,1470838954,64
1361049461,1470842100,7,880,125.7142857,1361049457793,1361049457921,1470838893,1470839021,128
1361049463,109157656,4,699,174.75,1361049456213,1361049456341,109150869,109150997,128
1361049463,109157656,62,79867,1288.177419,1361049456852,1361049457108,109151508,109151764,256
1361049463,109157656,4,699,174.75,1361049457108,1361049457172,109151764,109151828,64
1361049463,109157660,7,4950,707.1428571,1361049456144,1361049456208,109150804,109150868,64
1361049463,109157660,7,4950,707.1428571,1361049456975,1361049457039,109151635,109151699,64
1361049463,109157664,4,464,116,1361049454923,1361049455563,109149587,109150227,640
1361049469,1470850004,4,431,107.75,1361049446495,1361049463839,1470827499,1470844843,17344
1361049469,1470850020,4,1318,329.5,1361049446096,1361049463120,1470827116,1470844140,17024
1361049469,1470850020,5,865,173,1361049446031,1361049463119,1470827051,1470844139,17088
1361049469,1470850024,5,1289,257.8,1361049446089,1361049463113,1470827113,1470844137,17024
1361049469,1470850060,33,39225,1188.636364,1361049463080,1361049468904,1470844140,1470849964,5824
1361049469,1470850080,1310,1861209,1420.770229,1361049455827,1361049462547,1470836907,1470843627,6720
1361049469,1470850088,69,92098,1334.753623,1361049446154,1361049464906,1470827242,1470845994,18752
1361049469,1470850092,4,767,191.75,1361049468744,1361049468872,1470849836,1470849964,128
1361049469,1470850092,9,7827,869.6666667,1361049457799,1361049468871,1470838891,1470849963,11072
1361049469,1470850092,4,645,161.25,1361049457926,1361049462982,1470839018,1470844074,5056
1361049470,1470851608,1,52,52,1361049444101,1361049444101,1470825709,1470825709,0
1361049470,1470851608,1,52,52,1361049444355,1361049444355,1470825963,1470825963,0
1361049470,1470851608,4,628,157,1361049445827,1361049469635,1470827435,1470851243,23808
1361049470,1470851608,1,52,52,1361049445826,1361049445826,1470827434,1470827434,0
1361049470,1470851696,1,52,52,1361049444011,1361049444011,1470825707,1470825707,0
1361049474,1470855544,1,52,52,1361049445953,1361049445953,1470827497,1470827497,0
1361049474,1470855616,5,2992,598.4,1361049449146,1361049463930,1470830762,1470845546,14784
1361049474,1470855712,1,52,52,1361049448858,1361049448858,1470830570,1470830570,0
1361049474,1470855716,1,52,52,1361049449429,1361049449429,1470831145,1470831145,0
1361049477,1470858012,211,296610,1405.734597,1361049468949,1361049469141,1470849961,1470850153,192
1361049477,1470858012,7,5419,774.1428571,1361049469080,1361049469144,1470850092,1470850156,64
1361049477,1470858012,4,521,130.25,1361049469078,1361049469142,1470850090,1470850154,64
1361049477,1470858012,21,23537,1120.809524,1361049469078,1361049469334,1470850090,1470850346,256
1361049477,1470858016,5,453,90.6,1361049475410,1361049475474,1470856426,1470856490,64
1361049477,1470858028,5,593,118.6,1361049454277,1361049475397,1470835305,1470856425,21120
1361049477,1470858044,5,408,81.6,1361049468790,1361049468918,1470849834,1470849962,128
1361049477,1470858048,11,10524,956.7272727,1361049457844,1361049469044,1470838892,1470850092,11200
1361049477,1470858052,4,521,130.25,1361049469039,1361049469103,1470850091,1470850155,64
1361049477,1470858052,6,3552,592,1361049469038,1361049469102,1470850090,1470850154,64
1361049477,1470858096,15,16516,1101.066667,1361049464965,1361049468997,1470846061,1470850093,4032
1361049477,1470858096,20,22791,1139.55,1361049457794,1361049468994,1470838890,1470850090,11200
1361049478,1470859568,1,46,46,1361049452396,1361049452396,1470833964,1470833964,0
1361049478,1470859656,1,46,46,1361049452307,1361049452307,1470833963,1470833963,0
1361049478,1470859656,1,46,46,1361049452307,1361049452307,1470833963,1470833963,0
1361049482,1470863584,1,46,46,1361049456154,1361049456154,1470837738,1470837738,0
1361049482,1470863588,1,46,46,1361049456280,1361049456280,1470837868,1470837868,0
1361049482,1470863596,6,1979,329.8333333,1361049457295,1361049457295,1470838891,1470838891,0
1361049482,1470863672,1,52,52,1361049456067,1361049456067,1470837739,1470837739,0
1361049482,1470863704,6,5155,859.1666667,1361049457187,1361049457187,1470838891,1470838891,0
1361049484,109178408,1,52,52,1361049456459,1361049456459,109150867,109150867,0
1361049485,1470866020,3,634,211.3333333,1361049482447,1361049482575,1470863467,1470863595,128
1361049485,1470866020,7,3167,452.4285714,1361049482510,1361049482638,1470863530,1470863658,128
1361049485,1470866020,5,594,118.8,1361049482574,1361049482830,1470863594,1470863850,256
1361049485,1470866020,3,633,211,1361049482637,1361049482765,1470863657,1470863785,128
1361049485,1470866028,1309,1859783,1420.766234,1361049471688,1361049479880,1470852716,1470860908,8192
1361049485,1470866028,4,1318,329.5,1361049483208,1361049483336,1470864236,1470864364,128
1361049485,1470866028,3,624,208,1361049483207,1361049483271,1470864235,1470864299,64
1361049485,1470866028,4,755,188.75,1361049483207,1361049483335,1470864235,1470864363,128
1361049485,1470866028,4,543,135.75,1361049483207,1361049483335,1470864235,1470864363,128
1361049485,1470866028,7,1496,213.7142857,1361049483271,1361049483399,1470864299,1470864427,128
1361049485,1470866028,4,548,137,1361049483271,1361049483399,1470864299,1470864427,128
1361049485,1470866028,3,957,319,1361049479941,1361049480005,1470860969,1470861033,64
1361049485,1470866028,17,12640,743.5294118,1361049479941,1361049480133,1470860969,1470861161,192
1361049485,1470866032,8,5568,696,1361049480005,1361049480389,1470861037,1470861421,384
1361049485,1470866032,3,965,321.6666667,1361049480069,1361049480133,1470861101,1470861165,64
1361049485,1470866032,3,876,292,1361049480132,1361049480132,1470861164,1470861164,0
1361049485,1470866032,3,502,167.3333333,1361049480451,1361049480515,1470861483,1470861547,64
1361049485,1470866060,6,527,87.83333333,1361049480808,1361049481256,1470861868,1470862316,448
1361049485,1470866068,3,642,214,1361049481821,1361049481885,1470862889,1470862953,64
1361049485,1470866068,3,633,211,1361049481885,1361049481949,1470862953,1470863017,64
1361049485,1470866068,6,2771,461.8333333,1361049482017,1361049482529,1470863085,1470863597,512
1361049485,1470866068,3,580,193.3333333,1361049482209,1361049482401,1470863277,1470863469,192
1361049485,1470866068,10,5920,592,1361049482208,1361049482528,1470863276,1470863596,320
1361049485,1470866068,3,279,93,1361049482336,1361049482464,1470863404,1470863532,128
1361049485,1470866068,3,642,214,1361049482463,1361049482527,1470863531,1470863595,64
1361049485,1470866068,10,5629,562.9,1361049482590,1361049483102,1470863658,1470864170,512
1361049485,1470866068,13,12266,943.5384615,1361049478813,1361049479197,1470859881,1470860265,384
1361049485,1470866072,7,2772,396,1361049482780,1361049483292,1470863852,1470864364,512
1361049485,1470866072,5,2782,556.4,1361049483034,1361049483162,1470864106,1470864234,128
1361049485,1470866072,4,652,163,1361049483161,1361049483225,1470864233,1470864297,64
1361049485,1470866076,5,1740,348,1361049483161,1361049483609,1470864237,1470864685,448
1361049485,1470866076,5,950,190,1361049483161,1361049483289,1470864237,1470864365,128
1361049485,1470866076,8,856,107,1361049483161,1361049483481,1470864237,1470864557,320
1361049485,1470866076,4,855,213.75,1361049483161,1361049483289,1470864237,1470864365,128
1361049485,1470866076,5,1502,300.4,1361049483161,1361049483289,1470864237,1470864365,128
1361049485,1470866076,6,895,149.1666667,1361049483225,1361049483417,1470864301,1470864493,192
1361049485,1470866076,4,586,146.5,1361049483225,1361049484185,1470864301,1470865261,960
1361049485,1470866076,3,858,286,1361049483224,1361049483352,1470864300,1470864428,128
1361049485,1470866076,3,502,167.3333333,1361049483352,1361049483480,1470864428,1470864556,128
1361049485,1470866076,3,823,274.3333333,1361049479831,1361049479895,1470860907,1470860971,64
1361049485,1470866096,20,11378,568.9,1361049479810,1361049480002,1470860906,1470861098,192
1361049485,1470866096,4,612,153,1361049479874,1361049479938,1470860970,1470861034,64
1361049485,1470866096,15,15989,1065.933333,1361049479938,1361049480450,1470861034,1470861546,512
1361049485,1470866096,2614,3703400,1416.75593,1361049469634,1361049483906,1470850730,1470865002,14272
1361049485,1470866100,7,3420,488.5714286,1361049480128,1361049480384,1470861228,1470861484,256
1361049485,1470866100,5,2620,524,1361049480192,1361049480640,1470861292,1470861740,448
1361049485,1470866100,5,2823,564.6,1361049480446,1361049480638,1470861546,1470861738,192
1361049485,1470866104,3,580,193.3333333,1361049480699,1361049480827,1470861803,1470861931,128
1361049485,1470866104,8,1248,156,1361049470139,1361049480635,1470851243,1470861739,10496
1361049485,1470866104,4,651,162.75,1361049480698,1361049480826,1470861802,1470861930,128
1361049485,1470866112,6,2343,390.5,1361049481653,1361049481845,1470862765,1470862957,192
1361049485,1470866112,4,413,103.25,1361049481653,1361049481717,1470862765,1470862829,64
1361049485,1470866112,3,634,211.3333333,1361049481716,1361049481844,1470862828,1470862956,128
1361049485,1470866112,5,2828,565.6,1361049481844,1361049482164,1470862956,1470863276,320
1361049485,1470866112,18,21405,1189.166667,1361049482100,1361049482228,1470863212,1470863340,128
1361049486,1470867532,4,592,148,1361049481679,1361049481743,1470863211,1470863275,64
1361049486,1470867532,11,5972,542.9090909,1361049481743,1361049482063,1470863275,1470863595,320
1361049487,109181660,5,1374,274.8,1361049480209,1361049480401,109174869,109175061,192
1361049487,109181668,11,10406,946,1361049479497,1361049479497,109174165,109174165,0
1361049487,109181668,4,1074,268.5,1361049481672,1361049481736,109176340,109176404,64
1361049487,109181668,4,464,116,1361049481799,1361049481863,109176467,109176531,64
1361049487,109181668,7,4950,707.1428571,1361049482630,1361049482630,109177298,109177298,0
1361049487,109181672,4,699,174.75,1361049482694,1361049482822,109177366,109177494,128
1361049490,1470871560,4,646,161.5,1361049463284,1361049469684,1470844844,1470851244,6400
1361049490,1470871560,4,496,124,1361049463347,1361049468723,1470844907,1470850283,5376
1361049490,1470871588,13,15677,1205.923077,1361049464408,1361049464472,1470845996,1470846060,64
1361049490,1470871588,18,19158,1064.333333,1361049464408,1361049468504,1470845996,1470850092,4096
1361049490,1470871688,12,12682,1056.833333,1361049464369,1361049468401,1470846057,1470850089,4032
1361049493,1470874028,4,645,161.25,1361049483272,1361049488328,1470864300,1470869356,5056
1361049493,1470874028,5,1152,230.4,1361049483336,1361049488584,1470864364,1470869612,5248
1361049493,1470874056,4,628,157,1361049470186,1361049490090,1470851242,1470871146,19904
1361049494,1470875596,3,456,152,1361049469135,1361049469199,1470850731,1470850795,64
1361049494,1470875648,5,4281,856.2,1361049468444,1361049468508,1470850092,1470850156,64
1361049500,109194368,35,46275,1322.142857,1361049474483,1361049474547,109168851,109168915,64
1361049501,1470882024,7,880,125.7142857,1361049483403,1361049498507,1470864427,1470879531,15104
1361049502,1470883616,1,52,52,1361049477370,1361049477370,1470858986,1470858986,0
1361049502,1470883620,1,52,52,1361049477366,1361049477366,1470858986,1470858986,0
1361049502,1470883620,1,52,52,1361049477366,1361049477366,1470858986,1470858986,0
1361049502,1470883624,1,52,52,1361049477429,1361049477429,1470859053,1470859053,0
1361049502,1470883728,1,52,52,1361049477259,1361049477259,1470858987,1470858987,0
1361049508,109202412,24,30832,1284.666667,1361049483080,1361049483144,109177492,109177556,64
1361049509,1470890032,3,164,54.66666667,1361049482499,1361049502403,1470863531,1470883435,19904
1361049509,1470890044,12,11699,974.9166667,1361049504566,1361049507958,1470885610,1470889002,3392
1361049509,1470890048,3,807,269,1361049507955,1361049508019,1470889003,1470889067,64
1361049509,1470890048,3,939,313,1361049508018,1361049508082,1470889066,1470889130,64
1361049509,1470890072,3,939,313,1361049508763,1361049508827,1470889835,1470889899,64
1361049509,1470890072,5,2823,564.6,1361049508506,1361049508698,1470889578,1470889770,192
1361049509,1470890072,2,814,407,1361049508826,1361049508890,1470889898,1470889962,64
1361049509,1470890112,4,611,152.75,1361049507889,1361049508017,1470889001,1470889129,128
1361049509,1470890112,22,11406,518.4545455,1361049507956,1361049508148,1470889068,1470889260,192
1361049509,1470890112,3,947,315.6666667,1361049508020,1361049508084,1470889132,1470889196,64
1361049509,1470890112,15,10792,719.4666667,1361049508084,1361049508148,1470889196,1470889260,64
1361049509,1470890112,3,860,286.6666667,1361049508083,1361049508147,1470889195,1470889259,64
1361049509,1470890112,7,3422,488.8571429,1361049508147,1361049508403,1470889259,1470889515,256
1361049509,1470890116,5,594,118.8,1361049508398,1361049508462,1470889514,1470889578,64
1361049509,1470890120,3,807,269,1361049508652,1361049508716,1470889772,1470889836,64
1361049509,1470890120,3,947,315.6666667,1361049508779,1361049508779,1470889899,1470889899,0
1361049510,1470891624,1,46,46,1361049482738,1361049482738,1470864362,1470864362,0
1361049510,1470891764,1,52,52,1361049485670,1361049485670,1470867434,1470867434,0
1361049508,109202468,11,10406,946,1361049507858,1361049507922,109202326,109202390,64
1361049511,109205668,4,464,116,1361049508296,1361049508360,109202964,109203028,64
1361049511,109205668,4,1068,267,1361049509766,1361049509830,109204434,109204498,64
1361049511,109205672,4,1068,267,1361049508291,1361049508291,109202963,109202963,0
1361049511,109205676,4,464,116,1361049509825,1361049509825,109204501,109204501,0
1361049511,109205676,4,1068,267,1361049510464,1361049510528,109205140,109205204,64
1361049511,109205676,4,464,116,1361049510528,1361049510592,109205204,109205268,64
1361049511,109205676,14,15435,1102.5,1361049510912,1361049510912,109205588,109205588,0
1361049514,1470895856,4,1040,260,1361049489289,1361049499337,1470871145,1470881193,10048
1361049514,1470895860,7,1196,170.8571429,1361049489350,1361049499462,1470871210,1470881322,10112
1361049517,1470898052,9,4485,498.3333333,1361049510512,1361049510640,1470891564,1470891692,128
1361049517,1470898052,5,1162,232.4,1361049510638,1361049510958,1470891690,1470892010,320
1361049517,1470898052,3,502,167.3333333,1361049510702,1361049511662,1470891754,1470892714,960
1361049517,1470898056,5,594,118.8,1361049510828,1361049511020,1470891884,1470892076,192
1361049517,1470898056,5,518,103.6,1361049510764,1361049512748,1470891820,1470893804,1984
1361049517,1470898056,3,939,313,1361049511018,1361049511018,1470892074,1470892074,0
1361049517,1470898060,3,860,286.6666667,1361049511081,1361049511145,1470892141,1470892205,64
1361049517,1470898060,5,1056,211.2,1361049511208,1361049511272,1470892268,1470892332,64
1361049517,1470898060,7,792,113.1428571,1361049511272,1361049511336,1470892332,1470892396,64
1361049517,1470898060,7,3422,488.8571429,1361049511144,1361049511400,1470892204,1470892460,256
1361049517,1470898060,8,3505,438.125,1361049511207,1361049511335,1470892267,1470892395,128
1361049517,1470898060,6,2507,417.8333333,1361049511399,1361049511527,1470892459,1470892587,128
1361049517,1470898060,3,502,167.3333333,1361049511462,1361049511526,1470892522,1470892586,64
1361049517,1470898060,7,559,79.85714286,1361049511397,1361049511589,1470892457,1470892649,192
1361049517,1470898064,5,623,124.6,1361049511460,1361049511588,1470892524,1470892652,128
1361049517,1470898064,4,468,117,1361049511714,1361049511842,1470892778,1470892906,128
1361049517,1470898064,7,1935,276.4285714,1361049511778,1361049511970,1470892842,1470893034,192
1361049517,1470898064,4,805,201.25,1361049511970,1361049512034,1470893034,1470893098,64
1361049517,1470898068,4,611,152.75,1361049516192,1361049516256,1470897260,1470897324,64
1361049517,1470898068,8,856,107,1361049511968,1361049512288,1470893036,1470893356,320
1361049517,1470898068,4,1327,331.75,1361049512032,1361049512224,1470893100,1470893292,192
1361049517,1470898068,5,1508,301.6,1361049512159,1361049512287,1470893227,1470893355,128
1361049517,1470898068,3,961,320.3333333,1361049516319,1361049516383,1470897387,1470897451,64
1361049517,1470898068,5,594,118.8,1361049512350,1361049512606,1470893418,1470893674,256
1361049517,1470898068,3,880,293.3333333,1361049516382,1361049516446,1470897450,1470897514,64
1361049517,1470898068,17,12640,743.5294118,1361049516382,1361049516510,1470897450,1470897578,128
1361049517,1470898068,4,592,148,1361049512286,1361049512350,1470893354,1470893418,64
1361049517,1470898068,6,2793,465.5,1361049512350,1361049512606,1470893418,1470893674,256
1361049517,1470898068,13,6006,462,1361049512350,1361049512670,1470893418,1470893738,320
1361049517,1470898068,3,279,93,1361049512477,1361049512477,1470893545,1470893545,0
1361049517,1470898068,5,455,91,1361049512605,1361049512733,1470893673,1470893801,128
1361049517,1470898092,8,4508,563.5,1361049512585,1361049515721,1470893677,1470896813,3136
1361049517,1470898092,3,939,313,1361049510278,1361049510278,1470891370,1470891370,0
1361049517,1470898092,5,1056,211.2,1361049512774,1361049512838,1470893866,1470893930,64
1361049517,1470898092,5,623,124.6,1361049512838,1361049512902,1470893930,1470893994,64
1361049517,1470898092,6,2503,417.1666667,1361049512838,1361049513094,1470893930,1470894186,256
1361049517,1470898092,4,1554,388.5,1361049512838,1361049512902,1470893930,1470893994,64
1361049517,1470898092,5,594,118.8,1361049516742,1361049516806,1470897834,1470897898,64
1361049517,1470898096,5,623,124.6,1361049513093,1361049513157,1470894189,1470894253,64
1361049517,1470898096,10,2915,291.5,1361049513284,1361049513476,1470894380,1470894572,192
1361049517,1470898096,6,1203,200.5,1361049513284,1361049513476,1470894380,1470894572,192
1361049517,1470898096,25,29568,1182.72,1361049512835,1361049513027,1470893931,1470894123,192
1361049517,1470898096,5,594,118.8,1361049512899,1361049513155,1470893995,1470894251,256
1361049517,1470898096,7,3453,493.2857143,1361049510339,1361049510659,1470891435,1470891755,320
1361049517,1470898096,6,3353,558.8333333,1361049508738,1361049509250,1470889834,1470890346,512
1361049517,1470898096,7,1932,276,1361049513282,1361049513538,1470894378,1470894634,256
1361049517,1470898100,4,756,189,1361049513469,1361049513597,1470894569,1470894697,128
1361049517,1470898100,4,740,185,1361049513597,1361049513661,1470894697,1470894761,64
1361049517,1470898100,7,3422,488.8571429,1361049508863,1361049509119,1470889963,1470890219,256
1361049517,1470898100,5,2619,523.8,1361049508863,1361049508991,1470889963,1470890091,128
1361049517,1470898100,6,720,120,1361049510589,1361049510653,1470891689,1470891753,64
1361049517,1470898104,4,413,103.25,1361049508985,1361049509049,1470890089,1470890153,64
1361049517,1470898104,5,2828,565.6,1361049510652,1361049510908,1470891756,1470892012,256
1361049517,1470898104,6,2793,465.5,1361049510716,1361049510844,1470891820,1470891948,128
1361049517,1470898104,5,594,118.8,1361049509115,1361049509179,1470890219,1470890283,64
1361049517,1470898104,5,2823,564.6,1361049509179,1361049509307,1470890283,1470890411,128
1361049517,1470898104,4,1428,357,1361049509242,1361049509306,1470890346,1470890410,64
1361049517,1470898104,5,594,118.8,1361049509242,1361049509498,1470890346,1470890602,256
1361049517,1470898104,5,1534,306.8,1361049510969,1361049511225,1470892073,1470892329,256
1361049517,1470898108,3,807,269,1361049510901,1361049510965,1470892009,1470892073,64
1361049517,1470898108,8,4508,563.5,1361049510965,1361049515701,1470892073,1470896809,4736
1361049517,1470898108,6,2772,462,1361049510969,1361049511353,1470892077,1470892461,384
1361049517,1470898108,5,455,91,1361049510968,1361049511096,1470892076,1470892204,128
1361049517,1470898108,3,947,315.6666667,1361049511032,1361049511032,1470892140,1470892140,0
1361049517,1470898108,4,1554,388.5,1361049511158,1361049511286,1470892266,1470892394,128
1361049517,1470898108,25,29569,1182.76,1361049511158,1361049511350,1470892266,1470892458,192
1361049517,1470898108,5,913,182.6,1361049511221,1361049511221,1470892329,1470892329,0
1361049517,1470898112,32,41153,1286.03125,1361049511412,1361049511540,1470892524,1470892652,128
1361049517,1470898112,6,504,84,1361049511476,1361049511604,1470892588,1470892716,128
1361049517,1470898112,6,746,124.3333333,1361049511411,1361049511475,1470892523,1470892587,64
1361049517,1470898112,5,2823,564.6,1361049511475,1361049511667,1470892587,1470892779,192
1361049517,1470898112,5,594,118.8,1361049511474,1361049511730,1470892586,1470892842,256
1361049517,1470898112,4,520,130,1361049511602,1361049511666,1470892714,1470892778,64
1361049517,1470898132,6,2771,461.8333333,1361049511648,1361049512160,1470892780,1470893292,512
1361049517,1470898132,10,2915,291.5,1361049511647,1361049511903,1470892779,1470893035,256
1361049517,1470898132,6,1203,200.5,1361049511711,1361049512991,1470892843,1470894123,1280
1361049517,1470898132,4,650,162.5,1361049511647,1361049511711,1470892779,1470892843,64
1361049517,1470898132,13,12268,943.6923077,1361049515743,1361049516127,1470896875,1470897259,384
1361049517,1470898132,6,2371,395.1666667,1361049511711,1361049511903,1470892843,1470893035,192
1361049517,1470898132,5,2828,565.6,1361049511902,1361049512094,1470893034,1470893226,192
1361049517,1470898132,7,611,87.28571429,1361049516125,1361049516125,1470897257,1470897257,0
1361049517,1470898132,3,827,275.6666667,1361049516125,1361049516189,1470897257,1470897321,64
1361049517,1470898132,4,547,136.75,1361049516125,1361049516189,1470897257,1470897321,64
1361049517,1470898136,3,164,54.66666667,1361049512219,1361049515611,1470893355,1470896747,3392
1361049517,1470898136,6,2774,462.3333333,1361049512219,1361049512731,1470893355,1470893867,512
1361049517,1470898136,7,3422,488.8571429,1361049516379,1361049516635,1470897515,1470897771,256
1361049517,1470898136,18,21404,1189.111111,1361049512218,1361049512346,1470893354,1470893482,128
1361049517,1470898136,10,5852,585.2,1361049512282,1361049512602,1470893418,1470893738,320
1361049517,1470898136,23,11623,505.3478261,1361049516250,1361049516442,1470897386,1470897578,192
1361049517,1470898136,7,611,87.28571429,1361049512410,1361049512474,1470893546,1470893610,64
1361049517,1470898136,3,969,323,1361049516313,1361049516313,1470897449,1470897449,0
1361049517,1470898140,3,807,269,1361049510168,1361049510168,1470891308,1470891308,0
1361049517,1470898140,8,4191,523.875,1361049510168,1361049510360,1470891308,1470891500,192
1361049517,1470898140,5,913,182.6,1361049512791,1361049512855,1470893931,1470893995,64
1361049517,1470898140,3,860,286.6666667,1361049510295,1361049510295,1470891435,1470891435,0
1361049517,1470898140,6,504,84,1361049512983,1361049513175,1470894123,1470894315,192
1361049517,1470898140,6,2771,461.8333333,1361049510230,1361049510678,1470891370,1470891818,448
1361049517,1470898140,3,947,315.6666667,1361049510230,1361049510294,1470891370,1470891434,64
1361049517,1470898140,7,559,79.85714286,1361049512982,1361049513174,1470894122,1470894314,192
1361049517,1470898140,4,805,201.25,1361049513429,1361049513493,1470894569,1470894633,64
1361049517,1470898144,4,1327,331.75,1361049513553,1361049514193,1470894697,1470895337,640
1361049517,1470898144,5,1508,301.6,1361049514132,1361049514260,1470895276,1470895404,128
1361049519,109213664,7,2923,417.5714286,1361049511054,1361049511054,109205718,109205718,0
1361049519,109213664,4,464,116,1361049511886,1361049511950,109206550,109206614,64
1361049519,109213664,6,629,104.8333333,1361049512077,1361049512141,109206741,109206805,64
1361049519,109213664,27,33552,1242.666667,1361049512653,1361049512717,109207317,109207381,64
1361049519,109213664,4,464,116,1361049511245,1361049511309,109205909,109205973,64
1361049519,109213664,4,1074,268.5,1361049517131,1361049517131,109211795,109211795,0
1361049519,109213668,4,1068,267,1361049511881,1361049511881,109206549,109206549,0
1361049519,109213668,11,10406,946,1361049515913,1361049515977,109210581,109210645,64
1361049519,109213668,7,2923,417.5714286,1361049512072,1361049512072,109206740,109206740,0
1361049519,109213668,6,629,104.8333333,1361049511048,1361049511112,109205716,109205780,64
1361049519,109213668,4,1068,267,1361049511239,1361049511239,109205907,109205907,0
1361049519,109213668,4,1074,268.5,1361049516551,1361049516615,109211219,109211283,64
1361049519,109213668,4,464,116,1361049516615,1361049516679,109211283,109211347,64
1361049519,109213672,4,464,116,1361049517126,1361049517190,109211798,109211862,64
1361049519,109213672,5,1864,372.8,1361049518276,1361049518404,109212948,109213076,128
1361049519,109213672,4,1026,256.5,1361049518276,1361049518596,109212948,109213268,320
1361049520,109214376,1,52,52,1361049492782,1361049492782,109187158,109187158,0
1361049520,109214408,1,52,52,1361049492685,1361049492685,109187093,109187093,0
1361049520,109214408,1,52,52,1361049492748,1361049492748,109187156,109187156,0
1361049524,109218432,1,52,52,1361049498676,1361049498676,109193108,109193108,0
1361049524,109218448,1,52,52,1361049499686,1361049499686,109194134,109194134,0
1361049525,1470906048,5,857,171.4,1361049518579,1361049518643,1470899627,1470899691,64
1361049525,1470906048,6,1000,166.6666667,1361049518579,1361049518707,1470899627,1470899755,128
1361049525,1470906048,5,903,180.6,1361049518579,1361049518707,1470899627,1470899755,128
1361049525,1470906048,5,1606,321.2,1361049518579,1361049518707,1470899627,1470899755,128
1361049525,1470906048,4,216,54,1361049518643,1361049518707,1470899691,1470899755,64
1361049525,1470906048,6,702,117,1361049518643,1361049518899,1470899691,1470899947,256
1361049525,1470906048,5,2156,431.2,1361049518643,1361049518771,1470899691,1470899819,128
1361049525,1470906048,3,581,193.6666667,1361049517106,1361049517234,1470898154,1470898282,128
1361049525,1470906048,5,654,130.8,1361049518706,1361049518834,1470899754,1470899882,128
1361049525,1470906048,6,1419,236.5,1361049518705,1361049518961,1470899753,1470900009,256
1361049525,1470906048,4,216,54,1361049518769,1361049518833,1470899817,1470899881,64
1361049525,1470906048,4,651,162.75,1361049517041,1361049517169,1470898089,1470898217,128
1361049525,1470906048,6,1452,242,1361049518769,1361049519025,1470899817,1470900073,256
1361049525,1470906052,6,1560,260,1361049518896,1361049519024,1470899948,1470900076,128
1361049525,1470906052,6,1446,241,1361049518960,1361049519152,1470900012,1470900204,192
1361049525,1470906052,5,1291,258.2,1361049518959,1361049519023,1470900011,1470900075,64
1361049525,1470906052,5,2619,523.8,1361049517231,1361049517295,1470898283,1470898347,64
1361049525,1470906052,5,1711,342.2,1361049519022,1361049519342,1470900074,1470900394,320
1361049525,1470906056,3,634,211.3333333,1361049517418,1361049517418,1470898474,1470898474,0
1361049525,1470906060,4,592,148,1361049517608,1361049517608,1470898668,1470898668,0
1361049525,1470906060,12,6024,502,1361049517608,1361049517928,1470898668,1470898988,320
1361049525,1470906060,3,279,93,1361049517734,1361049517798,1470898794,1470898858,64
1361049525,1470906060,4,611,152.75,1361049523814,1361049523878,1470904874,1470904938,64
1361049525,1470906060,3,939,313,1361049523877,1361049523941,1470904937,1470905001,64
1361049525,1470906064,3,860,286.6666667,1361049524068,1361049524068,1470905132,1470905132,0
1361049525,1470906064,3,642,214,1361049517924,1361049517924,1470898988,1470898988,0
1361049525,1470906064,6,1637,272.8333333,1361049520164,1361049520356,1470901228,1470901420,192
1361049525,1470906064,7,3422,488.8571429,1361049524131,1361049524387,1470905195,1470905451,256
1361049525,1470906064,3,633,211,1361049517986,1361049518050,1470899050,1470899114,64
1361049525,1470906084,5,594,118.8,1361049524368,1361049524432,1470905452,1470905516,64
1361049525,1470906084,6,2874,479,1361049518093,1361049518285,1470899177,1470899369,192
1361049525,1470906084,5,632,126.4,1361049520589,1361049520845,1470901673,1470901929,256
1361049525,1470906088,3,860,286.6666667,1361049524683,1361049524683,1470905771,1470905771,0
1361049525,1470906088,5,623,124.6,1361049518282,1361049518346,1470899370,1470899434,64
1361049525,1470906088,12,9143,761.9166667,1361049518282,1361049518538,1470899370,1470899626,256
1361049525,1470906092,5,2620,524,1361049524744,1361049524872,1470905836,1470905964,128
1361049525,1470906096,6,1108,184.6666667,1361049518531,1361049518595,1470899627,1470899691,64
1361049525,1470906096,30,35137,1171.233333,1361049518531,1361049518659,1470899627,1470899755,128
1361049525,1470906096,5,839,167.8,1361049518531,1361049518659,1470899627,1470899755,128
1361049525,1470906096,6,2460,410,1361049518595,1361049518723,1470899691,1470899819,128
1361049525,1470906096,5,786,157.2,1361049518595,1361049518915,1470899691,1470900011,320
1361049525,1470906096,6,1203,200.5,1361049518595,1361049518851,1470899691,1470899947,256
1361049525,1470906096,3,502,167.3333333,1361049518595,1361049518787,1470899691,1470899883,192
1361049525,1470906096,6,965,160.8333333,1361049518659,1361049518723,1470899755,1470899819,64
1361049525,1470906096,7,1841,263,1361049518722,1361049518978,1470899818,1470900074,256
1361049525,1470906096,6,527,87.83333333,1361049517057,1361049517505,1470898153,1470898601,448
1361049525,1470906096,6,2371,395.1666667,1361049517121,1361049517249,1470898217,1470898345,128
1361049525,1470906100,6,1560,260,1361049518912,1361049519040,1470900012,1470900140,128
1361049525,1470906100,6,1636,272.6666667,1361049519039,1361049519295,1470900139,1470900395,256
1361049525,1470906100,6,1560,260,1361049519103,1361049519231,1470900203,1470900331,128
1361049525,1470906100,3,635,211.6666667,1361049517183,1361049517375,1470898283,1470898475,192
1361049525,1470906100,5,2828,565.6,1361049517246,1361049517438,1470898346,1470898538,192
1361049525,1470906100,1302,1849801,1420.738095,1361049517246,1361049520766,1470898346,1470901866,3520
1361049525,1470906100,7,1776,253.7142857,1361049519230,1361049519358,1470900330,1470900458,128
1361049525,1470906100,3,643,214.3333333,1361049517310,1361049517310,1470898410,1470898410,0
1361049525,1470906100,6,1102,183.6666667,1361049519357,1361049519485,1470900457,1470900585,128
1361049525,1470906128,13,11916,916.6153846,1361049523361,1361049523745,1470904489,1470904873,384
1361049525,1470906128,6,1554,259,1361049519524,1361049520164,1470900652,1470901292,640
1361049525,1470906128,18,21404,1189.111111,1361049517539,1361049517603,1470898667,1470898731,64
1361049525,1470906128,13,6072,467.0769231,1361049517539,1361049517859,1470898667,1470898987,320
1361049525,1470906128,3,580,193.3333333,1361049517539,1361049517731,1470898667,1470898859,192
1361049525,1470906128,6,2773,462.1666667,1361049517538,1361049518050,1470898666,1470899178,512
1361049525,1470906132,20,11326,566.3,1361049523805,1361049523933,1470904937,1470905065,128
1361049525,1470906132,3,807,269,1361049523744,1361049523808,1470904876,1470904940,64
1361049525,1470906132,4,413,103.25,1361049517728,1361049517856,1470898860,1470898988,128
1361049525,1470906132,3,634,211.3333333,1361049517728,1361049517856,1470898860,1470898988,128
1361049525,1470906132,3,947,315.6666667,1361049523871,1361049523935,1470905003,1470905067,64
1361049525,1470906132,15,10792,719.4666667,1361049523935,1361049523999,1470905067,1470905131,64
1361049525,1470906132,5,715,143,1361049520221,1361049520541,1470901353,1470901673,320
1361049525,1470906136,5,2618,523.6,1361049518044,1361049518556,1470899180,1470899692,512
1361049525,1470906136,5,623,124.6,1361049518044,1361049518108,1470899180,1470899244,64
1361049525,1470906136,5,594,118.8,1361049518107,1361049518299,1470899243,1470899435,192
1361049525,1470906136,5,2822,564.4,1361049524315,1361049524507,1470905451,1470905643,192
1361049525,1470906136,3,939,313,1361049524506,1361049524570,1470905642,1470905706,64
1361049525,1470906136,3,807,269,1361049524506,1361049524506,1470905642,1470905642,0
1361049525,1470906136,3,947,315.6666667,1361049524570,1361049524634,1470905706,1470905770,64
1361049525,1470906140,5,455,91,1361049518232,1361049518360,1470899372,1470899500,128
1361049525,1470906140,5,2824,564.8,1361049516696,1361049516952,1470897836,1470898092,256
1361049527,109221652,4,1068,267,1361049524119,1361049524183,109218771,109218835,64
1361049527,109221656,6,629,104.8333333,1361049525142,1361049525206,109219798,109219862,64
1361049527,109221656,4,1068,267,1361049525781,1361049525845,109220437,109220501,64
1361049527,109221656,9,3336,370.6666667,1361049526100,1361049526164,109220756,109220820,64
1361049527,109221656,4,1068,267,1361049526420,1361049526484,109221076,109221140,64
1361049527,109221656,5,516,103.2,1361049526611,1361049526675,109221267,109221331,64
1361049527,109221656,5,1860,372,1361049518931,1361049519763,109213587,109214419,832
1361049527,109221656,11,10406,946,1361049523538,1361049523602,109218194,109218258,64
1361049527,109221660,4,464,116,1361049524178,1361049524178,109218838,109218838,0
1361049527,109221660,4,464,116,1361049524817,1361049524817,109219477,109219477,0
1361049527,109221660,4,1068,267,1361049524753,1361049524817,109219413,109219477,64
1361049527,109221660,7,2923,417.5714286,1361049525073,1361049525137,109219733,109219797,64
1361049527,109221660,4,464,116,1361049525840,1361049525968,109220500,109220628,128
1361049527,109221660,4,464,116,1361049526479,1361049526543,109221139,109221203,64
1361049527,109221660,5,1569,313.8,1361049526543,1361049526607,109221203,109221267,64
1361049533,1470914044,5,1056,211.2,1361049526647,1361049526711,1470907691,1470907755,64
1361049533,1470914044,5,594,118.8,1361049524983,1361049525047,1470906027,1470906091,64
1361049533,1470914044,5,857,171.4,1361049526647,1361049526711,1470907691,1470907755,64
1361049533,1470914044,3,164,54.66666667,1361049526647,1361049526711,1470907691,1470907755,64
1361049533,1470914044,6,1000,166.6666667,1361049526647,1361049526775,1470907691,1470907819,128
1361049533,1470914044,4,734,183.5,1361049526711,1361049526839,1470907755,1470907883,128
1361049533,1470914044,6,702,117,1361049526710,1361049527030,1470907754,1470908074,320
1361049533,1470914044,5,913,182.6,1361049526710,1361049526774,1470907754,1470907818,64
1361049533,1470914044,3,164,54.66666667,1361049526774,1361049526774,1470907818,1470907818,0
1361049533,1470914044,6,2768,461.3333333,1361049526774,1361049526966,1470907818,1470908010,192
1361049533,1470914044,4,1360,340,1361049526838,1361049526966,1470907882,1470908010,128
1361049533,1470914044,5,594,118.8,1361049526838,1361049527094,1470907882,1470908138,256
1361049533,1470914044,4,1327,331.75,1361049526774,1361049526902,1470907818,1470907946,128
1361049533,1470914044,5,623,124.6,1361049525109,1361049525173,1470906153,1470906217,64
1361049533,1470914044,4,651,162.75,1361049526901,1361049526965,1470907945,1470908009,64
1361049533,1470914048,6,1560,260,1361049526964,1361049527092,1470908012,1470908140,128
1361049533,1470914048,6,1203,200.5,1361049527092,1361049527284,1470908140,1470908332,192
1361049533,1470914048,9,4485,498.3333333,1361049525236,1361049525364,1470906284,1470906412,128
1361049533,1470914048,7,1935,276.4285714,1361049527091,1361049527411,1470908139,1470908459,320
1361049533,1470914048,5,455,91,1361049525299,1361049525363,1470906347,1470906411,64
1361049533,1470914048,6,1560,260,1361049527155,1361049527283,1470908203,1470908331,128
1361049533,1470914048,3,939,313,1361049525299,1361049525299,1470906347,1470906347,0
1361049533,1470914048,5,2725,545,1361049525299,1361049525747,1470906347,1470906795,448
1361049533,1470914048,3,947,315.6666667,1361049525298,1361049525362,1470906346,1470906410,64
1361049533,1470914048,5,2827,565.4,1361049527154,1361049527346,1470908202,1470908394,192
1361049533,1470914048,3,860,286.6666667,1361049525362,1361049525362,1470906410,1470906410,0
1361049533,1470914052,4,592,148,1361049527469,1361049527533,1470908521,1470908585,64
1361049533,1470914052,12,7328,610.6666667,1361049527472,1361049528240,1470908524,1470909292,768
1361049533,1470914052,4,1327,331.75,1361049527663,1361049527791,1470908715,1470908843,128
1361049533,1470914052,5,594,118.8,1361049527535,1361049527791,1470908587,1470908843,256
1361049533,1470914052,5,455,91,1361049527662,1361049529454,1470908714,1470910506,1792
1361049533,1470914052,6,1568,261.3333333,1361049527725,1361049528749,1470908777,1470909801,1024
1361049533,1470914056,5,2828,565.6,1361049525675,1361049525867,1470906731,1470906923,192
1361049533,1470914056,6,2794,465.6666667,1361049528233,1361049528489,1470909289,1470909545,256
1361049533,1470914056,3,502,167.3333333,1361049528232,1361049528424,1470909288,1470909480,192
1361049533,1470914060,5,455,91,1361049528487,1361049530023,1470909547,1470911083,1536
1361049533,1470914080,6,2793,465.5,1361049526226,1361049526354,1470907306,1470907434,128
1361049533,1470914084,3,947,315.6666667,1361049526284,1361049526348,1470907368,1470907432,64
1361049533,1470914084,5,623,124.6,1361049526352,1361049526480,1470907436,1470907564,128
1361049533,1470914084,6,2771,461.8333333,1361049524624,1361049525136,1470905708,1470906220,512
1361049533,1470914084,7,3422,488.8571429,1361049524687,1361049524943,1470905771,1470906027,256
1361049533,1470914088,7,611,87.28571429,1361049526474,1361049526538,1470907562,1470907626,64
1361049533,1470914088,4,1554,388.5,1361049526601,1361049526729,1470907689,1470907817,128
1361049533,1470914088,5,2823,564.6,1361049525001,1361049525193,1470906089,1470906281,192
1361049533,1470914088,7,611,87.28571429,1361049530633,1361049530697,1470911721,1470911785,64
1361049533,1470914088,25,29569,1182.76,1361049526601,1361049526857,1470907689,1470907945,256
1361049533,1470914088,9,908,100.8888889,1361049526665,1361049526985,1470907753,1470908073,320
1361049533,1470914088,5,594,118.8,1361049526665,1361049526665,1470907753,1470907753,0
1361049533,1470914088,5,2823,564.6,1361049526665,1361049526857,1470907753,1470907945,192
1361049533,1470914088,6,2793,465.5,1361049525064,1361049525192,1470906152,1470906280,128
1361049533,1470914092,6,504,84,1361049526920,1361049527048,1470908012,1470908140,128
1361049533,1470914092,5,594,118.8,1361049525128,1361049525384,1470906220,1470906476,256
1361049533,1470914092,3,164,54.66666667,1361049526792,1361049526792,1470907884,1470907884,0
1361049533,1470914092,6,2371,395.1666667,1361049526920,1361049527112,1470908012,1470908204,192
1361049533,1470914092,7,559,79.85714286,1361049526856,1361049526984,1470907948,1470908076,128
1361049533,1470914092,3,807,269,1361049525191,1361049525255,1470906283,1470906347,64
1361049533,1470914092,6,1560,260,1361049526855,1361049526983,1470907947,1470908075,128
1361049533,1470914092,6,2771,461.8333333,1361049526919,1361049527367,1470908011,1470908459,448
1361049533,1470914092,5,623,124.6,1361049525191,1361049525255,1470906283,1470906347,64
1361049533,1470914092,5,455,91,1361049526919,1361049528839,1470908011,1470909931,1920
1361049533,1470914092,9,4281,475.6666667,1361049526983,1361049532103,1470908075,1470913195,5120
1361049533,1470914092,4,1354,338.5,1361049526983,1361049527111,1470908075,1470908203,128
1361049533,1470914092,10,2915,291.5,1361049526982,1361049527238,1470908074,1470908330,256
1361049533,1470914092,7,5137,733.8571429,1361049527174,1361049528262,1470908266,1470909354,1088
1361049533,1470914092,13,9813,754.8461538,1361049525318,1361049525446,1470906410,1470906538,128
1361049533,1470914092,7,792,113.1428571,1361049525317,1361049525445,1470906409,1470906537,128
1361049533,1470914092,7,3453,493.2857143,1361049525317,1361049525637,1470906409,1470906729,320
1361049533,1470914092,18,21402,1189,1361049527429,1361049527493,1470908521,1470908585,64
1361049533,1470914092,5,623,124.6,1361049527493,1361049527557,1470908585,1470908649,64
1361049533,1470914092,10,1392,139.2,1361049527493,1361049528197,1470908585,1470909289,704
1361049533,1470914096,3,279,93,1361049527556,1361049527620,1470908652,1470908716,64
1361049533,1470914096,4,805,201.25,1361049527428,1361049527492,1470908524,1470908588,64
1361049533,1470914096,6,2793,465.5,1361049527428,1361049527556,1470908524,1470908652,128
1361049533,1470914096,12,5955,496.25,1361049527428,1361049528196,1470908524,1470909292,768
1361049533,1470914096,6,2774,462.3333333,1361049527492,1361049528196,1470908588,1470909292,704
1361049533,1470914096,6,746,124.3333333,1361049525507,1361049525507,1470906603,1470906603,0
1361049533,1470914096,5,623,124.6,1361049527554,1361049527618,1470908650,1470908714,64
1361049533,1470914172,5,594,118.8,1361049525556,1361049525620,1470906728,1470906792,64
1361049533,1470914180,3,807,269,1361049526128,1361049526128,1470907308,1470907308,0
1361049533,1470914180,5,623,124.6,1361049526127,1361049526191,1470907307,1470907371,64
1361049533,1470914180,5,594,118.8,1361049526191,1361049526447,1470907371,1470907627,256
1361049533,1470914180,3,860,286.6666667,1361049526254,1361049526254,1470907434,1470907434,0
1361049533,1470914180,3,939,313,1361049526190,1361049526190,1470907370,1470907370,0
1361049533,1470914180,6,2772,462,1361049526189,1361049526701,1470907369,1470907881,512
1361049533,1470914184,7,3422,488.8571429,1361049526252,1361049526508,1470907436,1470907692,256
1361049533,1470914184,5,455,91,1361049526316,1361049526380,1470907500,1470907564,64
1361049533,1470914184,4,413,103.25,1361049524780,1361049524844,1470905964,1470906028,64
1361049533,1470914184,9,5853,650.3333333,1361049526315,1361049526571,1470907499,1470907755,256
1361049534,1470915652,1,46,46,1361049508309,1361049508309,1470889961,1470889961,0
1361049535,109229668,41,53246,1298.682927,1361049527818,1361049528010,109222486,109222678,192
1361049535,109229672,4,1068,267,1361049526979,1361049527043,109221651,109221715,64
1361049535,109229676,4,464,116,1361049527042,1361049527106,109221718,109221782,64
1361049538,1470919832,1,46,46,1361049512739,1361049512739,1470894571,1470894571,0
1361049541,1470922056,22,25778,1171.727273,1361049539688,1361049540264,1470920744,1470921320,576
1361049541,1470922060,9,4375,486.1111111,1361049528550,1361049533670,1470909610,1470914730,5120
1361049541,1470922084,211,296610,1405.734597,1361049540237,1361049540429,1470921321,1470921513,192
1361049541,1470922136,5,2578,515.6,1361049540058,1361049540186,1470921194,1470921322,128
1361049546,1470927644,1,46,46,1361049517983,1361049517983,1470899627,1470899627,0
1361049546,1470927648,4,216,54,1361049518299,1361049520795,1470899947,1470902443,2496
1361049546,1470927660,1,46,46,1361049519248,1361049519248,1470900908,1470900908,0
1361049549,1470930056,1312,1850859,1410.715701,1361049541163,1361049544939,1470922219,1470925995,3776
1361049549,1470930056,4,767,191.75,1361049541163,1361049541227,1470922219,1470922283,64
1361049549,1470930060,4,521,130.25,1361049541479,1361049541543,1470922539,1470922603,64
1361049549,1470930060,7,5243,749,1361049541479,1361049541543,1470922539,1470922603,64
1361049549,1470930060,7,5442,777.4285714,1361049541479,1361049541543,1470922539,1470922603,64
1361049549,1470930088,24,26014,1083.916667,1361049540808,1361049541576,1470921896,1470922664,768
1361049549,1470930096,5,587,117.4,1361049526723,1361049547779,1470907819,1470928875,21056
1361049549,1470930100,5,408,81.6,1361049541116,1361049541180,1470922216,1470922280,64
1361049549,1470930128,6,4131,688.5,1361049541410,1361049541410,1470922538,1470922538,0
1361049549,1470930128,6,3767,627.8333333,1361049541409,1361049541473,1470922537,1470922601,64
1361049549,1470930128,7,5341,763,1361049541409,1361049541409,1470922537,1470922537,0
1361049549,1470930128,6,3903,650.5,1361049541409,1361049541409,1470922537,1470922537,0
1361049549,1470930176,4,533,133.25,1361049540723,1361049541363,1470921899,1470922539,640
1361049550,1470931840,1,46,46,1361049524057,1361049524057,1470905897,1470905897,0
1361049554,1470935752,2,92,46,1361049526962,1361049527026,1470908714,1470908778,64
1361049554,1470935780,5,593,118.6,1361049527446,1361049548630,1470909226,1470930410,21184
1361049557,1470938052,6,1446,241,1361049554480,1361049554736,1470935532,1470935788,256
1361049557,1470938052,9,5847,649.6666667,1361049554479,1361049554735,1470935531,1470935787,256
1361049557,1470938052,7,3453,493.2857143,1361049554542,1361049554862,1470935594,1470935914,320
1361049557,1470938052,5,857,171.4,1361049554669,1361049554733,1470935721,1470935785,64
1361049557,1470938052,6,1560,260,1361049554669,1361049554797,1470935721,1470935849,128
1361049557,1470938052,4,805,201.25,1361049554733,1361049554797,1470935785,1470935849,64
1361049557,1470938052,6,702,117,1361049554733,1361049554989,1470935785,1470936041,256
1361049557,1470938052,7,1777,253.8571429,1361049554796,1361049554988,1470935848,1470936040,192
1361049557,1470938056,7,2635,376.4285714,1361049554859,1361049555243,1470935915,1470936299,384
1361049557,1470938056,5,594,118.8,1361049554858,1361049554922,1470935914,1470935978,64
1361049557,1470938056,5,2828,565.6,1361049554858,1361049555114,1470935914,1470936170,256
1361049557,1470938056,7,559,79.85714286,1361049554921,1361049555113,1470935977,1470936169,192
1361049557,1470938056,6,1103,183.8333333,1361049554985,1361049555113,1470936041,1470936169,128
1361049557,1470938056,6,1560,260,1361049555049,1361049555113,1470936105,1470936169,64
1361049557,1470938056,3,827,275.6666667,1361049555112,1361049555112,1470936168,1470936168,0
1361049557,1470938060,7,2039,291.2857143,1361049555108,1361049555364,1470936168,1470936424,256
1361049557,1470938060,3,969,323,1361049555176,1361049555240,1470936236,1470936300,64
1361049557,1470938060,6,591,98.5,1361049555239,1361049555687,1470936299,1470936747,448
1361049557,1470938060,6,1555,259.1666667,1361049555111,1361049555367,1470936171,1470936427,256
1361049557,1470938060,7,3422,488.8571429,1361049555239,1361049555559,1470936299,1470936619,320
1361049557,1470938060,8,2799,349.875,1361049555239,1361049555495,1470936299,1470936555,256
1361049557,1470938060,3,580,193.3333333,1361049555175,1361049555303,1470936235,1470936363,128
1361049557,1470938060,3,880,293.3333333,1361049555238,1361049555238,1470936298,1470936298,0
1361049557,1470938060,4,805,201.25,1361049555302,1361049555366,1470936362,1470936426,64
1361049557,1470938060,3,634,211.3333333,1361049555301,1361049555493,1470936361,1470936553,192
1361049557,1470938060,3,633,211,1361049555493,1361049555493,1470936553,1470936553,0
1361049557,1470938060,4,602,150.5,1361049555365,1361049555813,1470936425,1470936873,448
1361049557,1470938060,9,908,100.8888889,1361049555492,1361049555812,1470936552,1470936872,320
1361049557,1470938064,3,961,320.3333333,1361049552100,1361049552100,1470933164,1470933164,0
1361049557,1470938064,16,11010,688.125,1361049552100,1361049552612,1470933164,1470933676,512
1361049557,1470938064,17,12640,743.5294118,1361049552163,1361049552611,1470933227,1470933675,448
1361049557,1470938064,3,880,293.3333333,1361049552291,1361049552355,1470933355,1470933419,64
1361049557,1470938064,7,3422,488.8571429,1361049552354,1361049552610,1470933418,1470933674,256
1361049557,1470938064,6,2371,395.1666667,1361049555810,1361049555938,1470936874,1470937002,128
1361049557,1470938064,5,2823,564.6,1361049552609,1361049552865,1470933673,1470933929,256
1361049557,1470938064,3,635,211.6666667,1361049555937,1361049556065,1470937001,1470937129,128
1361049557,1470938064,3,634,211.3333333,1361049556065,1361049556129,1470937129,1470937193,64
1361049557,1470938064,5,2828,565.6,1361049555937,1361049556257,1470937001,1470937321,320
1361049557,1470938064,3,502,167.3333333,1361049556128,1361049556256,1470937192,1470937320,128
1361049557,1470938064,8,3856,482,1361049556128,1361049556640,1470937192,1470937704,512
1361049557,1470938064,3,643,214.3333333,1361049556064,1361049556064,1470937128,1470937128,0
1361049557,1470938068,3,580,193.3333333,1361049552864,1361049553056,1470933932,1470934124,192
1361049557,1470938068,3,827,275.6666667,1361049552799,1361049552863,1470933867,1470933931,64
1361049557,1470938068,3,880,293.3333333,1361049552927,1361049552991,1470933995,1470934059,64
1361049557,1470938068,3,961,320.3333333,1361049552863,1361049552927,1470933931,1470933995,64
1361049557,1470938068,4,592,148,1361049556255,1361049556575,1470937323,1470937643,320
1361049557,1470938068,5,2619,523.8,1361049552991,1361049553759,1470934059,1470934827,768
1361049557,1470938068,7,3422,488.8571429,1361049552991,1361049553247,1470934059,1470934315,256
1361049557,1470938068,3,580,193.3333333,1361049556255,1361049556447,1470937323,1470937515,192
1361049557,1470938096,6,2771,461.8333333,1361049553282,1361049553730,1470934378,1470934826,448
1361049557,1470938096,5,857,171.4,1361049556545,1361049556673,1470937641,1470937769,128
1361049557,1470938096,5,764,152.8,1361049556544,1361049556608,1470937640,1470937704,64
1361049557,1470938100,3,502,167.3333333,1361049553792,1361049553920,1470934892,1470935020,128
1361049557,1470938100,3,634,211.3333333,1361049553792,1361049553792,1470934892,1470934892,0
1361049557,1470938100,3,643,214.3333333,1361049553728,1361049553792,1470934828,1470934892,64
1361049557,1470938100,3,634,211.3333333,1361049556608,1361049556800,1470937708,1470937900,192
1361049557,1470938100,5,748,149.6,1361049556672,1361049556672,1470937772,1470937772,0
1361049557,1470938100,5,455,91,1361049553854,1361049553982,1470934954,1470935082,128
1361049557,1470938100,9,5767,640.7777778,1361049553918,1361049554174,1470935018,1470935274,256
1361049557,1470938100,5,455,91,1361049556734,1361049556862,1470937834,1470937962,128
1361049557,1470938100,3,642,214,1361049556734,1361049556734,1470937834,1470937834,0
1361049557,1470938100,6,507,84.5,1361049556733,1361049556861,1470937833,1470937961,128
1361049557,1470938100,6,1108,184.6666667,1361049554109,1361049554173,1470935209,1470935273,64
1361049557,1470938100,25,29676,1187.04,1361049554109,1361049554301,1470935209,1470935401,192
1361049557,1470938100,4,216,54,1361049554109,1361049554173,1470935209,1470935273,64
1361049557,1470938100,4,216,54,1361049554237,1361049554301,1470935337,1470935401,64
1361049557,1470938100,3,969,323,1361049554429,1361049554429,1470935529,1470935529,0
1361049557,1470938104,6,838,139.6666667,1361049554168,1361049554488,1470935272,1470935592,320
1361049557,1470938104,5,623,124.6,1361049554232,1361049554360,1470935336,1470935464,128
1361049557,1470938104,6,2793,465.5,1361049554232,1361049554424,1470935336,1470935528,192
1361049557,1470938104,6,1452,242,1361049554300,1361049554492,1470935404,1470935596,192
1361049557,1470938104,6,1462,243.6666667,1361049554300,1361049554556,1470935404,1470935660,256
1361049557,1470938104,5,594,118.8,1361049554300,1361049554556,1470935404,1470935660,256
1361049557,1470938104,3,961,320.3333333,1361049554364,1361049554428,1470935468,1470935532,64
1361049557,1470938104,5,1305,261,1361049554427,1361049554491,1470935531,1470935595,64
1361049557,1470938104,6,1560,260,1361049554490,1361049554618,1470935594,1470935722,128
1361049557,1470938104,10,2362,236.2,1361049554490,1361049554682,1470935594,1470935786,192
1361049557,1470938104,6,1203,200.5,1361049554490,1361049554746,1470935594,1470935850,256
1361049557,1470938104,6,1560,260,1361049554490,1361049554618,1470935594,1470935722,128
1361049557,1470938104,7,1959,279.8571429,1361049554489,1361049554745,1470935593,1470935849,256
1361049557,1470938104,6,1643,273.8333333,1361049554553,1361049554809,1470935657,1470935913,256
1361049557,1470938108,6,1108,184.6666667,1361049554612,1361049554676,1470935720,1470935784,64
1361049557,1470938108,5,1606,321.2,1361049554680,1361049554808,1470935788,1470935916,128
1361049557,1470938108,8,2799,349.875,1361049554680,1361049554872,1470935788,1470935980,192
1361049557,1470938108,25,29661,1186.44,1361049554680,1361049554872,1470935788,1470935980,192
1361049557,1470938108,6,965,160.8333333,1361049554679,1361049554807,1470935787,1470935915,128
1361049557,1470938108,5,839,167.8,1361049554743,1361049554871,1470935851,1470935979,128
1361049557,1470938108,6,1419,236.5,1361049554742,1361049555062,1470935850,1470936170,320
1361049557,1470938108,5,654,130.8,1361049554868,1361049555060,1470935976,1470936168,192
1361049557,1470938108,5,1508,301.6,1361049554932,1361049554996,1470936040,1470936104,64
1361049557,1470938112,9,2310,256.6666667,1361049555059,1361049555187,1470936171,1470936299,128
1361049557,1470938112,6,1203,200.5,1361049555058,1361049555314,1470936170,1470936426,256
1361049557,1470938112,3,961,320.3333333,1361049555122,1361049555122,1470936234,1470936234,0
1361049557,1470938112,6,1560,260,1361049555121,1361049555249,1470936233,1470936361,128
1361049557,1470938112,13,12352,950.1538462,1361049551537,1361049551985,1470932649,1470933097,448
1361049557,1470938112,4,787,196.75,1361049555249,1361049555313,1470936361,1470936425,64
1361049557,1470938116,6,1632,272,1361049555248,1361049555376,1470936364,1470936492,128
1361049557,1470938116,7,611,87.28571429,1361049551855,1361049551855,1470932971,1470932971,0
1361049557,1470938116,3,642,214,1361049555375,1361049555439,1470936491,1470936555,64
1361049557,1470938116,4,546,136.5,1361049551983,1361049552559,1470933099,1470933675,576
1361049557,1470938116,4,612,153,1361049551983,1361049552559,1470933099,1470933675,576
1361049557,1470938116,3,827,275.6666667,1361049551919,1361049551983,1470933035,1470933099,64
1361049557,1470938116,5,594,118.8,1361049555502,1361049555566,1470936618,1470936682,64
1361049557,1470938116,5,2823,564.6,1361049555502,1361049555758,1470936618,1470936874,256
1361049557,1470938136,6,2772,462,1361049555480,1361049555992,1470936616,1470937128,512
1361049557,1470938136,3,969,323,1361049552092,1361049552156,1470933228,1470933292,64
1361049557,1470938136,4,651,162.75,1361049555675,1361049555739,1470936811,1470936875,64
1361049557,1470938136,3,581,193.6666667,1361049555675,1361049555867,1470936811,1470937003,192
1361049557,1470938136,9,1617,179.6666667,1361049541659,1361049552539,1470922795,1470933675,10880
1361049557,1470938136,3,502,167.3333333,1361049552538,1361049552602,1470933674,1470933738,64
1361049557,1470938136,6,2794,465.6666667,1361049555993,1361049556249,1470937129,1470937385,256
1361049557,1470938140,3,969,323,1361049552852,1361049552852,1470933992,1470933992,0
1361049557,1470938140,18,21402,1189,1361049556180,1361049556244,1470937320,1470937384,64
1361049557,1470938140,7,2819,402.7142857,1361049556120,1361049556504,1470937260,1470937644,384
1361049557,1470938140,3,634,211.3333333,1361049552983,1361049553111,1470934123,1470934251,128
1361049557,1470938140,9,5754,639.3333333,1361049556311,1361049556503,1470937451,1470937643,192
1361049557,1470938140,3,642,214,1361049553111,1361049553111,1470934251,1470934251,0
1361049557,1470938140,13,6073,467.1538462,1361049556183,1361049556567,1470937323,1470937707,384
1361049557,1470938140,12,6022,501.8333333,1361049556183,1361049556567,1470937323,1470937707,384
1361049557,1470938140,3,633,211,1361049553110,1361049553174,1470934250,1470934314,64
1361049557,1470938140,3,502,167.3333333,1361049553174,1361049553238,1470934314,1470934378,64
1361049557,1470938140,5,2823,564.6,1361049553238,1361049553686,1470934378,1470934826,448
1361049557,1470938140,3,827,275.6666667,1361049553365,1361049554325,1470934505,1470935465,960
1361049557,1470938140,5,1606,321.2,1361049556501,1361049556693,1470937641,1470937833,192
1361049557,1470938140,6,702,117,1361049556565,1361049556821,1470937705,1470937961,256
1361049557,1470938140,3,279,93,1361049556565,1361049556693,1470937705,1470937833,128
1361049557,1470938140,5,594,118.8,1361049556565,1361049556821,1470937705,1470937961,256
1361049557,1470938140,3,581,193.6666667,1361049553429,1361049553621,1470934569,1470934761,192
1361049557,1470938140,4,413,103.25,1361049553493,1361049553685,1470934633,1470934825,192
1361049557,1470938140,6,1108,184.6666667,1361049556501,1361049556565,1470937641,1470937705,64
1361049557,1470938140,6,2793,465.5,1361049556501,1361049556629,1470937641,1470937769,128
1361049557,1470938140,3,635,211.6666667,1361049553621,1361049553749,1470934761,1470934889,128
1361049557,1470938144,25,29666,1186.64,1361049556560,1361049556688,1470937704,1470937832,128
1361049557,1470938144,6,2793,465.5,1361049553680,1361049553808,1470934824,1470934952,128
1361049557,1470938144,6,2773,462.1666667,1361049553812,1361049554260,1470934956,1470935404,448
1361049557,1470938144,6,965,160.8333333,1361049556627,1361049556691,1470937771,1470937835,64
1361049557,1470938144,3,633,211,1361049556755,1361049556755,1470937899,1470937899,0
1361049557,1470938144,5,857,171.4,1361049554067,1361049554131,1470935211,1470935275,64
1361049557,1470938144,5,899,179.8,1361049554067,1361049554131,1470935211,1470935275,64
1361049557,1470938144,6,1000,166.6666667,1361049554067,1361049554195,1470935211,1470935339,128
1361049557,1470938144,5,1606,321.2,1361049554067,1361049554195,1470935211,1470935339,128
1361049557,1470938144,6,702,117,1361049554067,1361049554387,1470935211,1470935531,320
1361049557,1470938144,7,856,122.2857143,1361049554067,1361049554259,1470935211,1470935403,192
1361049557,1470938144,6,965,160.8333333,1361049554131,1361049554195,1470935275,1470935339,64
1361049557,1470938144,6,1419,236.5,1361049554194,1361049554450,1470935338,1470935594,256
1361049557,1470938144,7,1848,264,1361049554194,1361049554450,1470935338,1470935594,256
1361049557,1470938144,4,216,54,1361049554322,1361049554386,1470935466,1470935530,64
1361049557,1470938144,5,623,124.6,1361049554386,1361049554450,1470935530,1470935594,64
1361049557,1470938144,7,559,79.85714286,1361049554258,1361049554450,1470935402,1470935594,192
1361049557,1470938144,5,455,91,1361049554386,1361049554514,1470935530,1470935658,128
1361049557,1470938144,6,1560,260,1361049554386,1361049554514,1470935530,1470935658,128
1361049557,1470938144,3,880,293.3333333,1361049554450,1361049554450,1470935594,1470935594,0
1361049559,109253668,4,1074,268.5,1361049555786,1361049555850,109250454,109250518,64
1361049559,109253668,5,516,103.2,1361049556680,1361049556872,109251348,109251540,192
1361049559,109253668,5,516,103.2,1361049556999,1361049557767,109251667,109252435,768
1361049559,109253672,5,1374,274.8,1361049555269,1361049555333,109249941,109250005,64
1361049559,109253672,4,699,174.75,1361049558277,1361049558405,109252949,109253077,128
1361049559,109253672,11,10406,946,1361049551748,1361049552132,109246420,109246804,384
1361049559,109253672,4,464,116,1361049555844,1361049556100,109250516,109250772,256
1361049559,109253672,7,2584,369.1428571,1361049552387,1361049553283,109247059,109247955,896
1361049559,109253672,5,1569,313.8,1361049556483,1361049556547,109251155,109251219,64
1361049559,109253676,5,1570,314,1361049556994,1361049556994,109251670,109251670,0
1361049559,109253676,7,1922,274.5714286,1361049554049,1361049554113,109248725,109248789,64
1361049559,109253676,5,1571,314.2,1361049554625,1361049554689,109249301,109249365,64
1361049559,109253676,5,1374,274.8,1361049554689,1361049554817,109249365,109249493,128
1361049559,109253676,5,516,103.2,1361049554688,1361049554816,109249364,109249492,128
1361049559,109253676,7,4950,707.1428571,1361049558208,1361049558272,109252884,109252948,64
1361049565,1470946056,5,1508,301.6,1361049558572,1361049558636,1470939628,1470939692,64
1361049565,1470946056,11,2540,230.9090909,1361049556971,1361049558379,1470938027,1470939435,1408
1361049565,1470946056,5,2236,447.2,1361049558635,1361049558763,1470939691,1470939819,128
1361049565,1470946056,7,1959,279.8571429,1361049556971,1361049557291,1470938027,1470938347,320
1361049565,1470946056,7,1624,232,1361049556971,1361049557995,1470938027,1470939051,1024
1361049565,1470946056,7,1168,166.8571429,1361049556970,1361049558058,1470938026,1470939114,1088
1361049565,1470946056,4,1073,268.25,1361049558762,1361049558826,1470939818,1470939882,64
1361049565,1470946056,5,1606,321.2,1361049557034,1361049557354,1470938090,1470938410,320
1361049565,1470946056,4,652,163,1361049558762,1361049558826,1470939818,1470939882,64
1361049565,1470946056,3,703,234.3333333,1361049558762,1361049558826,1470939818,1470939882,64
1361049565,1470946056,5,1508,301.6,1361049558762,1361049558826,1470939818,1470939882,64
1361049565,1470946056,7,1562,223.1428571,1361049558762,1361049558890,1470939818,1470939946,128
1361049565,1470946056,4,1318,329.5,1361049558762,1361049558890,1470939818,1470939946,128
1361049565,1470946056,6,895,149.1666667,1361049558762,1361049559018,1470939818,1470940074,256
1361049565,1470946056,3,858,286,1361049558826,1361049558954,1470939882,1470940010,128
1361049565,1470946056,3,624,208,1361049558762,1361049558762,1470939818,1470939818,0
1361049565,1470946056,6,1203,200.5,1361049556970,1361049557290,1470938026,1470938346,320
1361049565,1470946056,6,1498,249.6666667,1361049556969,1361049557289,1470938025,1470938345,320
1361049565,1470946056,8,856,107,1361049558761,1361049559081,1470939817,1470940137,320
1361049565,1470946056,6,1198,199.6666667,1361049558824,1361049564136,1470939880,1470945192,5312
1361049565,1470946060,6,804,134,1361049557285,1361049557413,1470938345,1470938473,128
1361049565,1470946060,7,3159,451.2857143,1361049557349,1361049557605,1470938409,1470938665,256
1361049565,1470946064,7,559,79.85714286,1361049557284,1361049557412,1470938348,1470938476,128
1361049565,1470946064,6,1446,241,1361049557409,1361049557665,1470938473,1470938729,256
1361049565,1470946064,7,1932,276,1361049557473,1361049557729,1470938537,1470938793,256
1361049565,1470946064,6,1203,200.5,1361049557473,1361049557729,1470938537,1470938793,256
1361049565,1470946068,4,1327,331.75,1361049555420,1361049558556,1470936488,1470939624,3136
1361049565,1470946068,7,5407,772.4285714,1361049541468,1361049561884,1470922536,1470942952,20416
1361049565,1470946068,5,1508,301.6,1361049557535,1361049557663,1470938603,1470938731,128
1361049565,1470946068,11,5983,543.9090909,1361049557599,1361049558239,1470938667,1470939307,640
1361049565,1470946068,4,623,155.75,1361049563678,1361049563742,1470944746,1470944810,64
1361049565,1470946068,4,805,201.25,1361049557662,1361049558238,1470938730,1470939306,576
1361049565,1470946068,4,628,157,1361049541789,1361049561629,1470922857,1470942697,19840
1361049565,1470946072,6,965,160.8333333,1361049558043,1361049558107,1470939115,1470939179,64
1361049565,1470946072,7,5123,731.8571429,1361049558169,1361049558233,1470939241,1470939305,64
1361049565,1470946100,9,2851,316.7777778,1361049558272,1361049558720,1470939372,1470939820,448
1361049565,1470946100,6,1419,236.5,1361049556734,1361049556926,1470937834,1470938026,192
1361049565,1470946100,7,5408,772.5714286,1361049561853,1361049563645,1470942953,1470944745,1792
1361049565,1470946100,5,2165,433,1361049561853,1361049563645,1470942953,1470944745,1792
1361049565,1470946100,7,5545,792.1428571,1361049561853,1361049563645,1470942953,1470944745,1792
1361049565,1470946104,5,680,136,1361049561976,1361049563640,1470943080,1470944744,1664
1361049565,1470946104,4,409,102.25,1361049558586,1361049558714,1470939690,1470939818,128
1361049565,1470946104,7,1329,189.8571429,1361049556985,1361049557241,1470938089,1470938345,256
1361049565,1470946104,25,29677,1187.08,1361049556985,1361049557241,1470938089,1470938345,256
1361049565,1470946104,5,589,117.8,1361049558712,1361049559864,1470939816,1470940968,1152
1361049565,1470946104,3,808,269.3333333,1361049558712,1361049558840,1470939816,1470939944,128
1361049565,1470946104,5,956,191.2,1361049558712,1361049558776,1470939816,1470939880,64
1361049565,1470946104,7,748,106.8571429,1361049556984,1361049557368,1470938088,1470938472,384
1361049565,1470946104,5,1740,348,1361049558712,1361049558840,1470939816,1470939944,128
1361049565,1470946104,3,540,180,1361049558712,1361049558776,1470939816,1470939880,64
1361049565,1470946112,6,1419,236.5,1361049557232,1361049557424,1470938344,1470938536,192
1361049565,1470946112,3,502,167.3333333,1361049557299,1361049557491,1470938411,1470938603,192
1361049565,1470946112,4,1327,331.75,1361049557298,1361049557490,1470938410,1470938602,192
1361049565,1470946112,4,1370,342.5,1361049557425,1361049557553,1470938537,1470938665,128
1361049565,1470946112,6,1560,260,1361049557425,1361049557553,1470938537,1470938665,128
1361049565,1470946116,5,1508,301.6,1361049557424,1361049557488,1470938540,1470938604,64
1361049565,1470946136,6,1560,260,1361049557529,1361049557657,1470938665,1470938793,128
1361049565,1470946136,5,1282,256.4,1361049557592,1361049558168,1470938728,1470939304,576
1361049565,1470946140,4,267,66.75,1361049563608,1361049563672,1470944748,1470944812,64
1361049565,1470946140,5,1508,301.6,1361049557846,1361049557910,1470938986,1470939050,64
1361049565,1470946140,4,1327,331.75,1361049557718,1361049558230,1470938858,1470939370,512
1361049565,1470946144,6,3803,633.8333333,1361049558099,1361049558163,1470939243,1470939307,64
1361049565,1470946144,5,455,91,1361049556305,1361049558737,1470937449,1470939881,2432
1361049565,1470946144,5,518,103.6,1361049556497,1361049557073,1470937641,1470938217,576
1361049565,1470946144,5,1664,332.8,1361049558096,1361049558160,1470939240,1470939304,64
1361049565,1470946148,3,431,143.6666667,1361049558221,1361049558349,1470939369,1470939497,128
1361049565,1470946148,7,2818,402.5714286,1361049556813,1361049557261,1470937961,1470938409,448
1361049565,1470946148,9,5849,649.8888889,1361049556685,1361049556941,1470937833,1470938089,256
1361049565,1470946148,9,2851,316.7777778,1361049558220,1361049558668,1470939368,1470939816,448
1361049565,1470946152,5,3195,639,1361049558284,1361049558540,1470939436,1470939692,256
1361049565,1470946152,6,3083,513.8333333,1361049561803,1361049563595,1470942955,1470944747,1792
1361049565,1470946152,6,4230,705,1361049561803,1361049563595,1470942955,1470944747,1792
1361049566,1470947724,1,52,52,1361049540813,1361049540813,1470922537,1470922537,0
1361049566,1470947724,1,52,52,1361049540813,1361049540813,1470922537,1470922537,0
1361049566,1470947724,1,52,52,1361049540813,1361049540813,1470922537,1470922537,0
1361049566,1470947748,3,304,101.3333333,1361049540981,1361049540981,1470922729,1470922729,0
1361049566,1470947748,1,52,52,1361049540980,1361049540980,1470922728,1470922728,0
1361049566,1470947756,1,52,52,1361049541100,1361049541100,1470922856,1470922856,0
1361049566,1470947836,1,52,52,1361049540700,1361049540700,1470922536,1470922536,0
1361049566,1470947844,1,52,52,1361049541076,1361049541076,1470922920,1470922920,0
1361049566,1470947844,1,52,52,1361049538903,1361049538903,1470920747,1470920747,0
1361049566,1470947844,3,379,126.3333333,1361049541078,1361049541206,1470922922,1470923050,128
1361049566,1470947872,1,52,52,1361049539324,1361049539324,1470921196,1470921196,0
1361049566,1470947880,1,52,52,1361049539952,1361049539952,1470921832,1470921832,0
1361049573,1470954084,9,4673,519.2222222,1361049571727,1361049571919,1470952811,1470953003,192
1361049573,1470954084,7,5445,777.8571429,1361049571727,1361049571855,1470952811,1470952939,128
1361049573,1470954084,1302,1849801,1420.738095,1361049568653,1361049572749,1470949737,1470953833,4096
1361049573,1470954128,1304,1852653,1420.746166,1361049543970,1361049568610,1470925098,1470949738,24640
1361049573,1470954128,6,4098,683,1361049571681,1361049571681,1470952809,1470952809,0
1361049573,1470954128,5,2364,472.8,1361049571681,1361049571681,1470952809,1470952809,0
1361049573,1470954128,8,3219,402.375,1361049571681,1361049571873,1470952809,1470953001,192
1361049573,1470954144,6,3395,565.8333333,1361049571666,1361049571666,1470952810,1470952810,0
1361049573,1470954144,7,2021,288.7142857,1361049571666,1361049571794,1470952810,1470952938,128
1361049573,1470954144,7,5536,790.8571429,1361049571666,1361049571794,1470952810,1470952938,128
1361049573,1470954144,7,5362,766,1361049571666,1361049571794,1470952810,1470952938,128
1361049573,1470954152,5,1092,218.4,1361049561546,1361049571658,1470942698,1470952810,10112
1361049578,1470959672,1,46,46,1361049550915,1361049550915,1470932587,1470932587,0
1361049578,1470959672,1,46,46,1361049550915,1361049550915,1470932587,1470932587,0
1361049578,1470959796,5,587,117.4,1361049553029,1361049574085,1470934825,1470955881,21056
1361049578,1470959824,1,46,46,1361049553386,1361049553386,1470935210,1470935210,0
1361049581,1470962172,7,880,125.7142857,1361049558838,1361049573878,1470940010,1470955050,15040
1361049581,1470962172,3,634,211.3333333,1361049578806,1361049578934,1470959978,1470960106,128
1361049581,1470962172,8,5553,694.125,1361049578869,1361049579637,1470960041,1470960809,768
1361049581,1470962172,3,633,211,1361049578933,1361049578997,1470960105,1470960169,64
1361049581,1470962172,4,216,54,1361049557236,1361049575860,1470938408,1470957032,18624
1361049581,1470962176,7,3422,488.8571429,1361049579250,1361049579506,1470960426,1470960682,256
1361049581,1470962176,3,634,211.3333333,1361049579250,1361049579442,1470960426,1470960618,192
1361049581,1470962176,3,642,214,1361049579377,1361049579377,1470960553,1470960553,0
1361049581,1470962176,3,633,211,1361049579441,1361049579441,1470960617,1470960617,0
1361049581,1470962180,6,2793,465.5,1361049579503,1361049579759,1470960683,1470960939,256
1361049581,1470962180,6,2772,462,1361049579567,1361049580079,1470960747,1470961259,512
1361049581,1470962180,3,1046,348.6666667,1361049579695,1361049579695,1470960875,1470960875,0
1361049581,1470962180,3,581,193.6666667,1361049579694,1361049579822,1470960874,1470961002,128
1361049581,1470962180,3,951,317,1361049579757,1361049579821,1470960937,1470961001,64
1361049581,1470962180,9,7284,809.3333333,1361049579821,1361049580077,1470961001,1470961257,256
1361049581,1470962180,9,5750,638.8888889,1361049579821,1361049580077,1470961001,1470961257,256
1361049581,1470962180,3,635,211.6666667,1361049579821,1361049580013,1470961001,1470961193,192
1361049581,1470962184,21,11350,540.4761905,1361049576556,1361049578604,1470957740,1470959788,2048
1361049581,1470962184,5,715,143,1361049580011,1361049580267,1470961195,1470961451,256
1361049581,1470962184,3,634,211.3333333,1361049580011,1361049580075,1470961195,1470961259,64
1361049581,1470962184,5,623,124.6,1361049580011,1361049580139,1470961195,1470961323,128
1361049581,1470962184,6,1000,166.6666667,1361049580011,1361049580139,1470961195,1470961323,128
1361049581,1470962184,5,786,157.2,1361049580075,1361049580395,1470961259,1470961579,320
1361049581,1470962184,5,594,118.8,1361049580075,1361049580331,1470961259,1470961515,256
1361049581,1470962184,4,216,54,1361049580138,1361049580202,1470961322,1470961386,64
1361049581,1470962184,5,1932,386.4,1361049580138,1361049580266,1470961322,1470961450,128
1361049581,1470962184,6,1049,174.8333333,1361049571946,1361049580778,1470953130,1470961962,8832
1361049581,1470962184,5,632,126.4,1361049580266,1361049580522,1470961450,1470961706,256
1361049581,1470962184,5,594,118.8,1361049580202,1361049580266,1470961386,1470961450,64
1361049581,1470962184,5,623,124.6,1361049580265,1361049580329,1470961449,1470961513,64
1361049581,1470962184,18,21405,1189.166667,1361049580265,1361049580393,1470961449,1470961577,128
1361049581,1470962184,3,1046,348.6666667,1361049577001,1361049577001,1470958185,1470958185,0
1361049581,1470962184,12,6020,501.6666667,1361049580265,1361049580649,1470961449,1470961833,384
1361049581,1470962184,5,2062,412.4,1361049577065,1361049578025,1470958249,1470959209,960
1361049581,1470962184,3,279,93,1361049580456,1361049580584,1470961640,1470961768,128
1361049581,1470962212,10,2362,236.2,1361049580428,1361049580620,1470961640,1470961832,192
1361049581,1470962212,6,1203,200.5,1361049580428,1361049580684,1470961640,1470961896,256
1361049581,1470962212,5,623,124.6,1361049580492,1361049580556,1470961704,1470961768,64
1361049581,1470962212,6,2764,460.6666667,1361049580492,1361049580748,1470961704,1470961960,256
1361049581,1470962216,5,1282,256.4,1361049580618,1361049580746,1470961834,1470961962,128
1361049581,1470962216,4,805,201.25,1361049580618,1361049580746,1470961834,1470961962,128
1361049581,1470962220,3,951,317,1361049577992,1361049578056,1470959212,1470959276,64
1361049581,1470962220,7,3422,488.8571429,1361049578055,1361049578311,1470959275,1470959531,256
1361049581,1470962220,5,594,118.8,1361049578310,1361049578374,1470959530,1470959594,64
1361049581,1470962220,4,651,162.75,1361049578565,1361049579461,1470959785,1470960681,896
1361049581,1470962220,3,580,193.3333333,1361049578565,1361049578693,1470959785,1470959913,128
1361049581,1470962220,6,2371,395.1666667,1361049578628,1361049578820,1470959848,1470960040,192
1361049581,1470962224,3,642,214,1361049578818,1361049578882,1470960042,1470960106,64
1361049581,1470962224,6,2771,461.8333333,1361049579009,1361049579521,1470960233,1470960745,512
1361049581,1470962224,3,898,299.3333333,1361049579009,1361049579009,1470960233,1470960233,0
1361049581,1470962228,3,1046,348.6666667,1361049579068,1361049579068,1470960296,1470960296,0
1361049581,1470962228,3,1054,351.3333333,1361049579068,1361049579132,1470960296,1470960360,64
1361049581,1470962228,3,580,193.3333333,1361049579072,1361049579200,1470960300,1470960428,128
1361049581,1470962228,3,951,317,1361049579135,1361049579199,1470960363,1470960427,64
1361049581,1470962228,5,594,118.8,1361049579452,1361049579516,1470960680,1470960744,64
1361049581,1470962232,5,594,118.8,1361049579512,1361049579768,1470960744,1470961000,256
1361049581,1470962232,3,898,299.3333333,1361049579579,1361049579643,1470960811,1470960875,64
1361049581,1470962232,9,7778,864.2222222,1361049575930,1361049576442,1470957162,1470957674,512
1361049581,1470962232,3,1054,351.3333333,1361049579642,1361049579706,1470960874,1470960938,64
1361049581,1470962232,3,643,214.3333333,1361049579897,1361049579961,1470961129,1470961193,64
1361049581,1470962232,5,899,179.8,1361049579960,1361049580024,1470961192,1470961256,64
1361049581,1470962232,6,1108,184.6666667,1361049579960,1361049580024,1470961192,1470961256,64
1361049581,1470962232,5,1606,321.2,1361049579960,1361049580088,1470961192,1470961320,128
1361049581,1470962232,25,29634,1185.36,1361049579960,1361049580152,1470961192,1470961384,192
1361049581,1470962256,4,1327,331.75,1361049580067,1361049580195,1470961323,1470961451,128
1361049581,1470962256,5,857,171.4,1361049579939,1361049580003,1470961195,1470961259,64
1361049581,1470962256,4,216,54,1361049579939,1361049580003,1470961195,1470961259,64
1361049581,1470962256,7,748,106.8571429,1361049579939,1361049580259,1470961195,1470961515,320
1361049581,1470962256,6,2824,470.6666667,1361049579938,1361049580130,1470961194,1470961386,192
1361049581,1470962256,15,15982,1065.466667,1361049576546,1361049578530,1470957802,1470959786,1984
1361049581,1470962256,6,965,160.8333333,1361049580002,1361049580066,1470961258,1470961322,64
1361049581,1470962256,4,944,236,1361049576802,1361049577890,1470958058,1470959146,1088
1361049581,1470962256,7,2819,402.7142857,1361049580066,1361049580450,1470961322,1470961706,384
1361049581,1470962256,15,10792,719.4666667,1361049576546,1361049578466,1470957802,1470959722,1920
1361049581,1470962256,4,216,54,1361049580194,1361049580258,1470961450,1470961514,64
1361049581,1470962256,6,1709,284.8333333,1361049580194,1361049580258,1470961450,1470961514,64
1361049581,1470962256,6,1560,260,1361049580194,1361049580322,1470961450,1470961578,128
1361049581,1470962256,6,504,84,1361049580193,1361049580385,1470961449,1470961641,192
1361049581,1470962256,4,592,148,1361049580193,1361049580193,1470961449,1470961449,0
1361049581,1470962256,4,1354,338.5,1361049580257,1361049580449,1470961513,1470961705,192
1361049581,1470962256,7,559,79.85714286,1361049580192,1361049580384,1470961448,1470961640,192
1361049581,1470962256,4,1360,340,1361049580256,1361049580384,1470961512,1470961640,128
1361049581,1470962260,6,1560,260,1361049580380,1361049580508,1470961640,1470961768,128
1361049581,1470962260,7,1859,265.5714286,1361049580383,1361049580639,1470961643,1470961899,256
1361049581,1470962260,6,1560,260,1361049580383,1361049580511,1470961643,1470961771,128
1361049581,1470962260,5,594,118.8,1361049580510,1361049580702,1470961770,1470961962,192
1361049581,1470962260,7,1917,273.8571429,1361049580573,1361049580701,1470961833,1470961961,128
1361049582,1470963660,5,2823,564.6,1361049577869,1361049578125,1470959529,1470959785,256
1361049582,1470963744,2,92,46,1361049556220,1361049556348,1470937964,1470938092,128
1361049582,1470963744,1,52,52,1361049556283,1361049556283,1470938027,1470938027,0
1361049583,109277664,7,1923,274.7142857,1361049580877,1361049580941,109275541,109275605,64
1361049583,109277664,11,10406,946,1361049581772,1361049581836,109276436,109276500,64
1361049583,109277668,4,1182,295.5,1361049578314,1361049578314,109272982,109272982,0
1361049583,109277668,5,1482,296.4,1361049579274,1361049579658,109273942,109274326,384
1361049583,109277668,11,10406,946,1361049576329,1361049578249,109270997,109272917,1920
1361049583,109277668,5,516,103.2,1361049580169,1361049580233,109274837,109274901,64
1361049583,109277668,5,1569,313.8,1361049580105,1361049580169,109274773,109274837,64
1361049583,109277672,6,1782,297,1361049578309,1361049579141,109272981,109273813,832
1361049583,109277672,6,3588,598,1361049582853,1361049582853,109277525,109277525,0
1361049586,1470967676,3,496,165.3333333,1361049558204,1361049558268,1470939880,1470939944,64
1361049589,1470970072,6,1243,207.1666667,1361049580889,1361049581017,1470961961,1470962089,128
1361049589,1470970072,5,455,91,1361049580953,1361049581721,1470962025,1470962793,768
1361049589,1470970072,8,2989,373.625,1361049582616,1361049583320,1470963688,1470964392,704
1361049589,1470970072,3,968,322.6666667,1361049582616,1361049582680,1470963688,1470963752,64
1361049589,1470970072,5,1508,301.6,1361049581016,1361049581080,1470962088,1470962152,64
1361049589,1470970076,8,2535,316.875,1361049582679,1361049583319,1470963755,1470964395,640
1361049589,1470970076,3,976,325.3333333,1361049582679,1361049582679,1470963755,1470963755,0
1361049589,1470970076,3,893,297.6666667,1361049582743,1361049582743,1470963819,1470963819,0
1361049589,1470970076,5,857,171.4,1361049581141,1361049581205,1470962217,1470962281,64
1361049589,1470970076,6,1221,203.5,1361049581205,1361049581397,1470962281,1470962473,192
1361049589,1470970076,6,721,120.1666667,1361049581204,1361049581460,1470962280,1470962536,256
1361049589,1470970080,3,138,46,1361049581267,1361049581651,1470962347,1470962731,384
1361049589,1470970080,8,1857,232.125,1361049581266,1361049581458,1470962346,1470962538,192
1361049589,1470970080,3,840,280,1361049583314,1361049583314,1470964394,1470964394,0
1361049589,1470970080,3,968,322.6666667,1361049583314,1361049583378,1470964394,1470964458,64
1361049589,1470970080,9,7284,809.3333333,1361049583441,1361049583761,1470964521,1470964841,320
1361049589,1470970080,4,718,179.5,1361049581328,1361049581392,1470962408,1470962472,64
1361049589,1470970080,4,805,201.25,1361049581328,1361049581392,1470962408,1470962472,64
1361049589,1470970084,4,1354,338.5,1361049581452,1361049582284,1470962536,1470963368,832
1361049589,1470970084,7,1329,189.8571429,1361049581391,1361049582223,1470962475,1470963307,832
1361049589,1470970084,3,633,211,1361049583631,1361049583695,1470964715,1470964779,64
1361049589,1470970084,3,164,54.66666667,1361049579661,1361049581645,1470960745,1470962729,1984
1361049589,1470970084,4,325,81.25,1361049584012,1361049585164,1470965096,1470966248,1152
1361049589,1470970088,5,455,91,1361049579914,1361049581578,1470961002,1470962666,1664
1361049589,1470970108,9,5389,598.7777778,1361049580404,1361049581620,1470961512,1470962728,1216
1361049589,1470970108,20,11344,567.2,1361049582135,1361049582263,1470963243,1470963371,128
1361049589,1470970108,6,2155,359.1666667,1361049582134,1361049582326,1470963242,1470963434,192
1361049589,1470970108,17,12640,743.5294118,1361049582198,1361049582326,1470963306,1470963434,128
1361049589,1470970108,8,1978,247.25,1361049580534,1361049580918,1470961642,1470962026,384
1361049589,1470970108,4,652,163,1361049582324,1361049583284,1470963432,1470964392,960
1361049589,1470970112,13,5283,406.3846154,1361049582451,1361049583283,1470963563,1470964395,832
1361049589,1470970112,10,6201,620.1,1361049580912,1361049581168,1470962024,1470962280,256
1361049589,1470970112,3,840,280,1361049582512,1361049582576,1470963624,1470963688,64
1361049589,1470970116,7,1735,247.8571429,1361049581038,1361049581230,1470962154,1470962346,192
1361049589,1470970116,7,3422,488.8571429,1361049582702,1361049582958,1470963818,1470964074,256
1361049589,1470970116,7,1932,276,1361049581165,1361049581357,1470962281,1470962473,192
1361049589,1470970116,6,1108,184.6666667,1361049581101,1361049581165,1470962217,1470962281,64
1361049589,1470970116,6,965,160.8333333,1361049581165,1361049581229,1470962281,1470962345,64
1361049589,1470970116,5,1606,321.2,1361049581101,1361049581229,1470962217,1470962345,128
1361049589,1470970116,5,594,118.8,1361049582956,1361049583020,1470964072,1470964136,64
1361049589,1470970116,7,1788,255.4285714,1361049581228,1361049581356,1470962344,1470962472,128
1361049589,1470970116,5,2823,564.6,1361049583020,1361049583276,1470964136,1470964392,256
1361049589,1470970120,9,908,100.8888889,1361049581163,1361049581547,1470962283,1470962667,384
1361049589,1470970120,8,2246,280.75,1361049581291,1361049581483,1470962411,1470962603,192
1361049589,1470970120,3,580,193.3333333,1361049583274,1361049583466,1470964394,1470964586,192
1361049589,1470970120,3,976,325.3333333,1361049583338,1361049583338,1470964458,1470964458,0
1361049589,1470970120,3,893,297.6666667,1361049583402,1361049583402,1470964522,1470964522,0
1361049589,1470970120,3,634,211.3333333,1361049583465,1361049583593,1470964585,1470964713,128
1361049589,1470970120,3,138,46,1361049581417,1361049581609,1470962537,1470962729,192
1361049589,1470970120,9,2863,318.1111111,1361049581417,1361049581609,1470962537,1470962729,192
1361049589,1470970120,3,642,214,1361049583529,1361049583593,1470964649,1470964713,64
1361049589,1470970120,4,702,175.5,1361049581353,1361049582185,1470962473,1470963305,832
1361049589,1470970120,5,2725,545,1361049583720,1361049584104,1470964840,1470965224,384
1361049589,1470970120,3,164,54.66666667,1361049581544,1361049581608,1470962664,1470962728,64
1361049589,1470970124,18,21423,1190.166667,1361049583847,1361049584039,1470964971,1470965163,192
1361049589,1470970124,5,594,118.8,1361049583783,1361049583847,1470964907,1470964971,64
1361049589,1470970124,4,592,148,1361049583783,1361049584039,1470964907,1470965163,256
1361049589,1470970124,12,6001,500.0833333,1361049583847,1361049584231,1470964971,1470965355,384
1361049589,1470970152,5,623,124.6,1361049584009,1361049584201,1470965161,1470965353,192
1361049589,1470970152,8,3334,416.75,1361049584009,1361049584521,1470965161,1470965673,512
1361049589,1470970152,3,502,167.3333333,1361049584073,1361049584329,1470965225,1470965481,256
1361049589,1470970156,11,8968,815.2727273,1361049581639,1361049582023,1470962795,1470963179,384
1361049589,1470970160,5,455,91,1361049580291,1361049581187,1470961451,1470962347,896
1361049589,1470970160,4,652,163,1361049581955,1361049582147,1470963115,1470963307,192
1361049589,1470970160,6,4261,710.1666667,1361049580226,1361049587074,1470961386,1470968234,6848
1361049589,1470970160,6,798,133,1361049584897,1361049585345,1470966057,1470966505,448
1361049589,1470970164,8,2799,349.875,1361049580671,1361049580863,1470961835,1470962027,192
1361049589,1470970164,4,1327,331.75,1361049580798,1361049580926,1470961962,1470962090,128
1361049589,1470970164,3,164,54.66666667,1361049580798,1361049581566,1470961962,1470962730,768
1361049589,1470970164,6,2155,359.1666667,1361049582398,1361049582526,1470963562,1470963690,128
1361049589,1470970164,13,5288,406.7692308,1361049582398,1361049583230,1470963562,1470964394,832
1361049590,1470971840,3,1043,347.6666667,1361049562907,1361049562907,1470944747,1470944747,0
1361049591,109285656,5,1437,287.4,1361049582868,1361049583636,109277524,109278292,768
1361049592,109286388,1,46,46,1361049564643,1361049564643,109259031,109259031,0
1361049592,109286388,22,28418,1291.727273,1361049564642,1361049564706,109259030,109259094,64
1361049592,109286420,1,46,46,1361049564610,1361049564610,109259030,109259030,0
1361049597,1470978108,9,8520,946.6666667,1361049594999,1361049595511,1470976107,1470976619,512
1361049597,1470978108,6,4259,709.8333333,1361049583796,1361049593716,1470964904,1470974824,9920
1361049597,1470978112,3,924,308,1361049595507,1361049595507,1470976619,1470976619,0
1361049597,1470978112,22,8507,386.6818182,1361049595570,1361049596658,1470976682,1470977770,1088
1361049597,1470978112,3,1098,366,1361049595569,1361049595633,1470976681,1470976745,64
1361049597,1470978116,17,12640,743.5294118,1361049595822,1361049596654,1470976938,1470977770,832
1361049597,1470978116,3,977,325.6666667,1361049595822,1361049595886,1470976938,1470977002,64
1361049597,1470978140,5,2823,564.6,1361049596374,1361049596630,1470977514,1470977770,256
1361049597,1470978140,3,580,193.3333333,1361049596565,1361049596757,1470977705,1470977897,192
1361049597,1470978144,2,588,294,1361049596755,1361049596819,1470977899,1470977963,64
1361049597,1470978144,6,2371,395.1666667,1361049596626,1361049596754,1470977770,1470977898,128
1361049597,1470978180,19,8408,442.5263158,1361049595501,1361049596589,1470976681,1470977769,1088
1361049597,1470978180,3,1106,368.6666667,1361049595564,1361049595628,1470976744,1470976808,64
1361049597,1470978184,6,798,133,1361049589929,1361049590377,1470971113,1470971561,448
1361049597,1470978184,7,3422,488.8571429,1361049596009,1361049596265,1470977193,1470977449,256
1361049597,1470978188,3,502,167.3333333,1361049596262,1361049596326,1470977450,1470977514,64
1361049597,1470978188,4,651,162.75,1361049596516,1361049596580,1470977704,1470977768,64
1361049597,1470978192,2,596,298,1361049596770,1361049596834,1470977962,1470978026,64
1361049598,1470979760,6,5484,914,1361049571432,1361049571496,1470953192,1470953256,64
1361049598,1470979760,6,5371,895.1666667,1361049571432,1361049571496,1470953192,1470953256,64
1361049598,1470979836,1,52,52,1361049570908,1361049570908,1470952744,1470952744,0
1361049598,1470979868,5,3611,722.2,1361049571327,1361049571391,1470953195,1470953259,64
1361049599,109293668,7,2932,418.8571429,1361049596617,1361049597449,109291285,109292117,832
1361049599,109293668,4,1248,312,1361049598027,1361049598027,109292695,109292695,0
1361049599,109293672,5,1548,309.6,1361049596164,1361049596228,109290836,109290900,64
1361049599,109293676,11,10406,946,1361049595391,1361049596223,109290067,109290899,832
1361049605,1470986068,3,924,308,1361049597020,1361049597020,1470978088,1470978088,0
1361049605,1470986072,3,1098,366,1361049597019,1361049597083,1470978091,1470978155,64
1361049605,1470986072,3,977,325.6666667,1361049597147,1361049597147,1470978219,1470978219,0
1361049605,1470986072,3,580,193.3333333,1361049597082,1361049597210,1470978154,1470978282,128
1361049605,1470986072,7,3422,488.8571429,1361049597146,1361049597402,1470978218,1470978474,256
1361049605,1470986072,3,1106,368.6666667,1361049597081,1361049597145,1470978153,1470978217,64
1361049605,1470986072,3,634,211.3333333,1361049597209,1361049597401,1470978281,1470978473,192
1361049605,1470986076,5,594,118.8,1361049597462,1361049597462,1470978538,1470978538,0
1361049605,1470986076,11,1282,116.5454545,1361049599445,1361049599637,1470980521,1470980713,192
1361049605,1470986076,5,623,124.6,1361049599445,1361049599509,1470980521,1470980585,64
1361049605,1470986076,6,2774,462.3333333,1361049599445,1361049599701,1470980521,1470980777,256
1361049605,1470986076,11,6005,545.9090909,1361049599509,1361049599701,1470980585,1470980777,192
1361049605,1470986076,6,1203,200.5,1361049599509,1361049599701,1470980585,1470980777,192
1361049605,1470986076,3,624,208,1361049599572,1361049599572,1470980648,1470980648,0
1361049605,1470986076,3,703,234.3333333,1361049599572,1361049599700,1470980648,1470980776,128
1361049605,1470986080,3,642,214,1361049599567,1361049599631,1470980647,1470980711,64
1361049605,1470986080,5,956,191.2,1361049599567,1361049599695,1470980647,1470980775,128
1361049605,1470986080,5,1508,301.6,1361049599567,1361049599695,1470980647,1470980775,128
1361049605,1470986080,3,540,180,1361049599631,1361049599631,1470980711,1470980711,0
1361049605,1470986080,6,895,149.1666667,1361049599635,1361049599827,1470980715,1470980907,192
1361049605,1470986080,4,548,137,1361049599635,1361049599763,1470980715,1470980843,128
1361049605,1470986080,3,633,211,1361049599635,1361049599699,1470980715,1470980779,64
1361049605,1470986080,5,2726,545.2,1361049597459,1361049597971,1470978539,1470979051,512
1361049605,1470986080,3,1098,366,1361049597650,1361049597714,1470978730,1470978794,64
1361049605,1470986080,3,582,194,1361049597714,1361049597842,1470978794,1470978922,128
1361049605,1470986080,3,623,207.6666667,1361049599762,1361049599826,1470980842,1470980906,64
1361049605,1470986080,4,805,201.25,1361049599762,1361049599826,1470980842,1470980906,64
1361049605,1470986080,5,948,189.6,1361049599762,1361049599890,1470980842,1470980970,128
1361049605,1470986080,4,645,161.25,1361049599762,1361049599890,1470980842,1470980970,128
1361049605,1470986080,7,880,125.7142857,1361049599826,1361049600082,1470980906,1470981162,256
1361049605,1470986080,3,1106,368.6666667,1361049597713,1361049597777,1470978793,1470978857,64
1361049605,1470986080,5,455,91,1361049599825,1361049599953,1470980905,1470981033,128
1361049605,1470986080,3,647,215.6666667,1361049599825,1361049600081,1470980905,1470981161,256
1361049605,1470986080,6,2772,462,1361049599825,1361049600337,1470980905,1470981417,512
1361049605,1470986080,10,7271,727.1,1361049599825,1361049600081,1470980905,1470981161,256
1361049605,1470986080,5,594,118.8,1361049597584,1361049597840,1470978664,1470978920,256
1361049605,1470986084,3,924,308,1361049597643,1361049597643,1470978727,1470978727,0
1361049605,1470986084,4,645,161.25,1361049599951,1361049600079,1470981035,1470981163,128
1361049605,1470986084,5,1503,300.6,1361049600015,1361049600079,1470981099,1470981163,64
1361049605,1470986084,5,715,143,1361049600079,1361049600335,1470981163,1470981419,256
1361049605,1470986084,6,1108,184.6666667,1361049600079,1361049600143,1470981163,1470981227,64
1361049605,1470986084,5,1606,321.2,1361049600078,1361049600206,1470981162,1470981290,128
1361049605,1470986084,3,635,211.6666667,1361049597966,1361049598030,1470979050,1470979114,64
1361049605,1470986084,3,977,325.6666667,1361049597774,1361049597774,1470978858,1470978858,0
1361049605,1470986084,6,1419,236.5,1361049600206,1361049600974,1470981290,1470982058,768
1361049605,1470986084,7,4185,597.8571429,1361049600333,1361049600653,1470981417,1470981737,320
1361049605,1470986084,5,632,126.4,1361049600333,1361049600589,1470981417,1470981673,256
1361049605,1470986084,3,636,212,1361049597836,1361049598028,1470978920,1470979112,192
1361049605,1470986084,5,594,118.8,1361049600396,1361049600652,1470981480,1470981736,256
1361049605,1470986088,7,3245,463.5714286,1361049597899,1361049598219,1470978987,1470979307,320
1361049605,1470986088,8,5175,646.875,1361049600587,1361049600907,1470981675,1470981995,320
1361049605,1470986088,27,33082,1225.259259,1361049600779,1361049600907,1470981867,1470981995,128
1361049605,1470986088,10,2362,236.2,1361049600779,1361049600971,1470981867,1470982059,192
1361049605,1470986088,10,5639,563.9,1361049598218,1361049598538,1470979306,1470979626,320
1361049605,1470986112,9,5679,631,1361049600690,1361049600946,1470981802,1470982058,256
1361049605,1470986112,6,1094,182.3333333,1361049600753,1361049601009,1470981865,1470982121,256
1361049605,1470986112,6,2886,481,1361049600880,1361049601008,1470981992,1470982120,128
1361049605,1470986112,7,1959,279.8571429,1361049600752,1361049601008,1470981864,1470982120,256
1361049605,1470986112,4,216,54,1361049598256,1361049598320,1470979368,1470979432,64
1361049605,1470986112,6,504,84,1361049598256,1361049598384,1470979368,1470979496,128
1361049605,1470986112,5,857,171.4,1361049600944,1361049601008,1470982056,1470982120,64
1361049605,1470986116,25,29738,1189.52,1361049598059,1361049598187,1470979175,1470979303,128
1361049605,1470986116,5,1606,321.2,1361049598063,1361049598191,1470979179,1470979307,128
1361049605,1470986116,6,702,117,1361049600943,1361049601327,1470982059,1470982443,384
1361049605,1470986116,4,805,201.25,1361049600942,1361049601006,1470982058,1470982122,64
1361049605,1470986116,7,1249,178.4285714,1361049601070,1361049601390,1470982186,1470982506,320
1361049605,1470986116,5,899,179.8,1361049598126,1361049598190,1470979242,1470979306,64
1361049605,1470986116,6,1446,241,1361049601006,1361049601198,1470982122,1470982314,192
1361049605,1470986116,33,41096,1245.333333,1361049601133,1361049601261,1470982249,1470982377,128
1361049605,1470986116,5,1503,300.6,1361049601196,1361049601260,1470982312,1470982376,64
1361049605,1470986116,4,805,201.25,1361049601260,1361049601260,1470982376,1470982376,0
1361049605,1470986116,6,1555,259.1666667,1361049601260,1361049601388,1470982376,1470982504,128
1361049605,1470986120,7,468,66.85714286,1361049598248,1361049603368,1470979368,1470984488,5120
1361049605,1470986120,4,1370,342.5,1361049601127,1361049601319,1470982247,1470982439,192
1361049605,1470986120,6,1555,259.1666667,1361049601191,1361049601319,1470982311,1470982439,128
1361049605,1470986120,4,216,54,1361049598315,1361049598379,1470979435,1470979499,64
1361049605,1470986120,18,21405,1189.166667,1361049598442,1361049598506,1470979562,1470979626,64
1361049605,1470986120,5,1503,300.6,1361049601833,1361049601897,1470982953,1470983017,64
1361049605,1470986124,3,633,211,1361049596903,1361049596967,1470978027,1470978091,64
1361049605,1470986124,6,2771,461.8333333,1361049597028,1361049597540,1470978152,1470978664,512
1361049605,1470986128,3,633,211,1361049597281,1361049597345,1470978409,1470978473,64
1361049605,1470986128,3,642,214,1361049597280,1361049597280,1470978408,1470978408,0
1361049605,1470986132,4,592,148,1361049599387,1361049599387,1470980519,1470980519,0
1361049605,1470986132,5,594,118.8,1361049599455,1361049599647,1470980587,1470980779,192
1361049605,1470986132,3,279,93,1361049599391,1361049599455,1470980523,1470980587,64
1361049605,1470986132,5,1664,332.8,1361049599391,1361049599455,1470980523,1470980587,64
1361049605,1470986132,10,2362,236.2,1361049599391,1361049599583,1470980523,1470980715,192
1361049605,1470986132,3,359,119.6666667,1361049599390,1361049599518,1470980522,1470980650,128
1361049605,1470986132,7,1940,277.1428571,1361049599454,1361049599646,1470980586,1470980778,192
1361049605,1470986132,3,634,211.3333333,1361049599454,1361049599582,1470980586,1470980714,128
1361049605,1470986132,5,623,124.6,1361049597534,1361049597598,1470978666,1470978730,64
1361049605,1470986132,4,1318,329.5,1361049599518,1361049599710,1470980650,1470980842,192
1361049605,1470986132,6,2793,465.5,1361049597534,1361049597790,1470978666,1470978922,256
1361049605,1470986132,3,808,269.3333333,1361049599518,1361049599646,1470980650,1470980778,128
1361049605,1470986132,7,1484,212,1361049599518,1361049599710,1470980650,1470980842,192
1361049605,1470986132,4,652,163,1361049599518,1361049599582,1470980650,1470980714,64
1361049605,1470986132,3,858,286,1361049599581,1361049599709,1470980713,1470980841,128
1361049605,1470986132,3,931,310.3333333,1361049599581,1361049599773,1470980713,1470980905,192
1361049605,1470986132,5,1740,348,1361049599581,1361049599709,1470980713,1470980841,128
1361049605,1470986132,4,543,135.75,1361049599517,1361049599773,1470980649,1470980905,256
1361049605,1470986132,9,2851,316.7777778,1361049599581,1361049599965,1470980713,1470981097,384
1361049605,1470986132,8,856,107,1361049599581,1361049599773,1470980713,1470980905,192
1361049605,1470986156,5,623,124.6,1361049599750,1361049599814,1470980906,1470980970,64
1361049605,1470986156,3,540,180,1361049599750,1361049599750,1470980906,1470980906,0
1361049605,1470986156,5,1373,274.6,1361049599812,1361049600196,1470980968,1470981352,384
1361049605,1470986156,4,1360,340,1361049599812,1361049600004,1470980968,1470981160,192
1361049605,1470986160,5,1503,300.6,1361049599939,1361049600003,1470981099,1470981163,64
1361049605,1470986160,7,3857,551,1361049600003,1361049600067,1470981163,1470981227,64
1361049605,1470986160,5,857,171.4,1361049600002,1361049600066,1470981162,1470981226,64
1361049605,1470986160,5,455,91,1361049597762,1361049597890,1470978922,1470979050,128
1361049605,1470986160,7,1174,167.7142857,1361049600002,1361049600834,1470981162,1470981994,832
1361049605,1470986160,6,965,160.8333333,1361049600066,1361049600130,1470981226,1470981290,64
1361049605,1470986160,3,644,214.6666667,1361049597889,1361049597889,1470979049,1470979049,0
1361049605,1470986160,4,477,119.25,1361049600128,1361049600576,1470981288,1470981736,448
1361049605,1470986160,7,3449,492.7142857,1361049597696,1361049598016,1470978856,1470979176,320
1361049605,1470986160,5,617,123.4,1361049600256,1361049600320,1470981416,1470981480,64
1361049605,1470986164,6,1555,259.1666667,1361049600319,1361049600575,1470981483,1470981739,256
1361049605,1470986164,9,4554,506,1361049597823,1361049602943,1470978987,1470984107,5120
1361049605,1470986164,6,1108,184.6666667,1361049598015,1361049598079,1470979179,1470979243,64
1361049605,1470986164,5,623,124.6,1361049597822,1361049597950,1470978986,1470979114,128
1361049605,1470986164,5,857,171.4,1361049600510,1361049600830,1470981674,1470981994,320
1361049605,1470986164,4,216,54,1361049598078,1361049598142,1470979242,1470979306,64
1361049605,1470986164,5,2828,565.6,1361049598078,1361049598270,1470979242,1470979434,192
1361049605,1470986164,3,502,167.3333333,1361049597885,1361049598077,1470979049,1470979241,192
1361049605,1470986164,5,786,157.2,1361049598077,1361049598397,1470979241,1470979561,320
1361049605,1470986164,5,455,91,1361049600637,1361049603197,1470981801,1470984361,2560
1361049605,1470986164,5,455,91,1361049600700,1361049601020,1470981864,1470982184,320
1361049605,1470986164,6,507,84.5,1361049598204,1361049598332,1470979368,1470979496,128
1361049605,1470986164,6,1108,184.6666667,1361049600828,1361049600892,1470981992,1470982056,64
1361049605,1470986164,6,2775,462.5,1361049598012,1361049598524,1470979176,1470979688,512
1361049605,1470986168,5,715,143,1361049600887,1361049601143,1470982055,1470982311,256
1361049605,1470986168,9,2851,316.7777778,1361049600891,1361049601275,1470982059,1470982443,384
1361049605,1470986168,5,1606,321.2,1361049600827,1361049600955,1470981995,1470982123,128
1361049605,1470986168,5,594,118.8,1361049598011,1361049598075,1470979179,1470979243,64
1361049605,1470986168,7,856,122.2857143,1361049600955,1361049601083,1470982123,1470982251,128
1361049605,1470986168,6,965,160.8333333,1361049600890,1361049600954,1470982058,1470982122,64
1361049605,1470986168,6,965,160.8333333,1361049598074,1361049598202,1470979242,1470979370,128
1361049605,1470986168,7,2039,291.2857143,1361049601018,1361049601210,1470982186,1470982378,192
1361049605,1470986168,7,1465,209.2857143,1361049601018,1361049601402,1470982186,1470982570,384
1361049605,1470986168,9,2310,256.6666667,1361049600954,1361049601146,1470982122,1470982314,192
1361049605,1470986168,4,1327,331.75,1361049601017,1361049601273,1470982185,1470982441,256
1361049605,1470986168,3,580,193.3333333,1361049598393,1361049598585,1470979561,1470979753,192
1361049605,1470986168,5,632,126.4,1361049601144,1361049601400,1470982312,1470982568,256
1361049605,1470986168,9,2851,316.7777778,1361049601144,1361049601400,1470982312,1470982568,256
1361049605,1470986172,5,1503,300.6,1361049601207,1361049601335,1470982379,1470982507,128
1361049605,1470986172,4,787,196.75,1361049601207,1361049601271,1470982379,1470982443,64
1361049605,1470986172,6,1555,259.1666667,1361049601526,1361049601654,1470982698,1470982826,128
1361049605,1470986172,2884,4108308,1424.517337,1361049585398,1361049598774,1470966570,1470979946,13376
1361049605,1470986172,8,5553,694.125,1361049596724,1361049597876,1470977896,1470979048,1152
1361049607,1470988096,13,7584,583.3846154,1361049581505,1361049581697,1470962601,1470962793,192
1361049607,1470988140,1,52,52,1361049582420,1361049582420,1470963560,1470963560,0
1361049607,109301664,7,4950,707.1428571,1361049599054,1361049599118,109293718,109293782,64
1361049607,109301664,4,699,174.75,1361049599181,1361049599245,109293845,109293909,64
1361049607,109301664,7,1921,274.4285714,1361049600589,1361049600845,109295253,109295509,256
1361049607,109301668,4,464,116,1361049598985,1361049599049,109293653,109293717,64
1361049607,109301668,33,42024,1273.454545,1361049598985,1361049599113,109293653,109293781,128
1361049607,109301668,7,1924,274.8571429,1361049600328,1361049600456,109294996,109295124,128
1361049608,109302444,1,52,52,1361049581289,1361049581289,109275733,109275733,0
1361049611,1470992024,9,5627,625.2222222,1361049584650,1361049584970,1470965674,1470965994,320
1361049613,1470994104,8,3856,482,1361049597818,1361049607546,1470978922,1470988650,9728
1361049613,1470994136,8,1538,192.25,1361049601371,1361049606555,1470982507,1470987691,5184
1361049613,1470994144,7,3804,543.4285714,1361049599441,1361049611025,1470980585,1470992169,11584
1361049613,1470994184,6,1419,236.5,1361049601258,1361049606506,1470982442,1470987690,5248
1361049615,1470996056,1,46,46,1361049589994,1361049589994,1470971050,1470971050,0
1361049623,1471004000,1,46,46,1361049597027,1361049597027,1470978027,1470978027,0
1361049623,1471004016,6,408,68,1361049597713,1361049597713,1470978729,1470978729,0
1361049623,1471004088,1,52,52,1361049598599,1361049598599,1470979687,1470979687,0
1361049623,1471004092,1,46,46,1361049596931,1361049596931,1470978023,1470978023,0
1361049624,109318684,1,52,52,1361049598136,1361049598136,109292820,109292820,0
1361049627,1471008004,1,52,52,1361049599710,1361049599710,1470980714,1470980714,0
1361049627,1471008036,5,593,118.6,1361049600702,1361049621822,1470981738,1471002858,21120
1361049627,1471008040,3,550,183.3333333,1361049601399,1361049601399,1470982439,1470982439,0
1361049627,1471008092,1,46,46,1361049599750,1361049599750,1470980842,1470980842,0
1361049629,1471010104,7,1101,157.2857143,1361049610873,1361049628153,1470991977,1471009257,17280
1361049629,1471010108,4,521,130.25,1361049627127,1361049627383,1471008235,1471008491,256
1361049629,1471010112,7,5513,787.5714286,1361049627443,1361049627443,1471008555,1471008555,0
1361049629,1471010112,7,5388,769.7142857,1361049627443,1361049628787,1471008555,1471009899,1344
1361049629,1471010116,6,1049,174.8333333,1361049628140,1361049628780,1471009256,1471009896,640
1361049629,1471010116,7,1930,275.7142857,1361049628140,1361049628204,1471009256,1471009320,64
1361049629,1471010144,4,766,191.5,1361049628496,1361049628752,1471009640,1471009896,256
1361049629,1471010148,4,628,157,1361049628749,1361049628813,1471009897,1471009961,64
1361049629,1471010152,60,74127,1235.45,1361049617993,1361049627529,1470999145,1471008681,9536
1361049629,1471010152,28,33696,1203.428571,1361049618504,1361049628744,1470999656,1471009896,10240
1361049629,1471010156,6,1010,168.3333333,1361049627013,1361049627333,1471008169,1471008489,320
1361049629,1471010156,240,335275,1396.979167,1361049627076,1361049627332,1471008232,1471008488,256
1361049629,1471010160,4,521,130.25,1361049627330,1361049627394,1471008490,1471008554,64
1361049629,1471010160,6,4249,708.1666667,1361049627393,1361049628737,1471008553,1471009897,1344
1361049629,1471010160,6,4344,724,1361049627393,1361049628737,1471008553,1471009897,1344
1361049629,1471010180,12,4778,398.1666667,1361049611822,1361049628718,1470993002,1471009898,16896
1361049629,1471010184,4,508,127,1361049628135,1361049628711,1471009319,1471009895,576
1361049629,1471010192,35,42269,1207.685714,1361049618402,1361049627362,1470999594,1471008554,8960
1361049629,1471010192,17,17209,1012.294118,1361049618402,1361049628706,1470999594,1471009898,10304
1361049631,1471012188,3,215,71.66666667,1361049604453,1361049604453,1470985641,1470985641,0
1361049637,1471018156,3,279,93,1361049634822,1361049634886,1471015978,1471016042,64
1361049637,1471018156,5,1874,374.8,1361049634822,1361049634950,1471015978,1471016106,128
1361049637,1471018156,5,654,130.8,1361049634822,1361049634950,1471015978,1471016106,128
1361049637,1471018156,5,1092,218.4,1361049634822,1361049635014,1471015978,1471016170,192
1361049637,1471018156,4,1392,348,1361049634822,1361049635014,1471015978,1471016170,192
1361049637,1471018156,3,633,211,1361049634886,1361049635014,1471016042,1471016170,128
1361049637,1471018156,6,1709,284.8333333,1361049634950,1361049635014,1471016106,1471016170,64
1361049637,1471018156,6,1555,259.1666667,1361049634950,1361049635142,1471016106,1471016298,192
1361049637,1471018156,6,1555,259.1666667,1361049634950,1361049635142,1471016106,1471016298,192
1361049637,1471018156,12,4711,392.5833333,1361049635014,1361049635334,1471016170,1471016490,320
1361049637,1471018156,7,3113,444.7142857,1361049635077,1361049635333,1471016233,1471016489,256
1361049637,1471018156,4,805,201.25,1361049635077,1361049635269,1471016233,1471016425,192
1361049637,1471018156,6,2770,461.6666667,1361049635141,1361049635525,1471016297,1471016681,384
1361049637,1471018156,4,1365,341.25,1361049635205,1361049635269,1471016361,1471016425,64
1361049637,1471018156,4,1554,388.5,1361049635268,1361049635332,1471016424,1471016488,64
1361049637,1471018156,7,3833,547.5714286,1361049635267,1361049635331,1471016423,1471016487,64
1361049637,1471018156,5,913,182.6,1361049635331,1361049635395,1471016487,1471016551,64
1361049637,1471018156,4,610,152.5,1361049635331,1361049635587,1471016487,1471016743,256
1361049637,1471018156,5,1503,300.6,1361049635267,1361049635395,1471016423,1471016551,128
1361049637,1471018156,6,1498,249.6666667,1361049635331,1361049635523,1471016487,1471016679,192
1361049637,1471018156,5,1503,300.6,1361049635331,1361049635395,1471016487,1471016551,64
1361049637,1471018160,6,1243,207.1666667,1361049635331,1361049635459,1471016491,1471016619,128
1361049637,1471018160,8,2246,280.75,1361049635394,1361049635586,1471016554,1471016746,192
1361049637,1471018160,5,1898,379.6,1361049635394,1361049635586,1471016554,1471016746,192
1361049637,1471018160,4,1365,341.25,1361049635458,1361049635586,1471016618,1471016746,128
1361049637,1471018160,4,1392,348,1361049635458,1361049635586,1471016618,1471016746,128
1361049637,1471018160,4,612,153,1361049631169,1361049632577,1471012329,1471013737,1408
1361049637,1471018160,7,3154,450.5714286,1361049635521,1361049635841,1471016681,1471017001,320
1361049637,1471018160,6,1555,259.1666667,1361049635585,1361049635713,1471016745,1471016873,128
1361049637,1471018160,3,1049,349.6666667,1361049631296,1361049631360,1471012456,1471012520,64
1361049637,1471018160,3,928,309.3333333,1361049631360,1361049631360,1471012520,1471012520,0
1361049637,1471018164,5,594,118.8,1361049631677,1361049632701,1471012841,1471013865,1024
1361049637,1471018164,8,5548,693.5,1361049631740,1361049632572,1471012904,1471013736,832
1361049637,1471018168,3,1041,347,1361049631994,1361049631994,1471013162,1471013162,0
1361049637,1471018168,3,928,309.3333333,1361049632058,1361049632058,1471013226,1471013226,0
1361049637,1471018168,3,635,211.6666667,1361049632249,1361049632377,1471013417,1471013545,128
1361049637,1471018168,3,643,214.3333333,1361049632312,1361049632376,1471013480,1471013544,64
1361049637,1471018168,3,634,211.3333333,1361049632375,1361049632439,1471013543,1471013607,64
1361049637,1471018172,3,875,291.6666667,1361049632566,1361049632630,1471013738,1471013802,64
1361049637,1471018172,3,580,193.3333333,1361049632630,1361049632758,1471013802,1471013930,128
1361049637,1471018172,3,928,309.3333333,1361049632694,1361049632758,1471013866,1471013930,64
1361049637,1471018172,7,3453,493.2857143,1361049632757,1361049633013,1471013929,1471014185,256
1361049637,1471018172,3,634,211.3333333,1361049632821,1361049632949,1471013993,1471014121,128
1361049637,1471018172,5,623,124.6,1361049632884,1361049632948,1471014056,1471014120,64
1361049637,1471018172,6,2763,460.5,1361049632883,1361049633075,1471014055,1471014247,192
1361049637,1471018172,3,633,211,1361049632947,1361049633011,1471014119,1471014183,64
1361049637,1471018172,5,594,118.8,1361049633075,1361049633075,1471014247,1471014247,0
1361049637,1471018196,5,617,123.4,1361049633055,1361049633119,1471014251,1471014315,64
1361049637,1471018196,5,2828,565.6,1361049633054,1361049633310,1471014250,1471014506,256
1361049637,1471018196,8,5731,716.375,1361049633054,1361049633310,1471014250,1471014506,256
1361049637,1471018196,5,455,91,1361049633118,1361049633182,1471014314,1471014378,64
1361049637,1471018196,6,2898,483,1361049633181,1361049633309,1471014377,1471014505,128
1361049637,1471018196,4,1554,388.5,1361049633244,1361049633372,1471014440,1471014568,128
1361049637,1471018196,3,1041,347,1361049633308,1361049633372,1471014504,1471014568,64
1361049637,1471018196,4,719,179.75,1361049633244,1361049633308,1471014440,1471014504,64
1361049637,1471018196,4,612,153,1361049633308,1361049633436,1471014504,1471014632,128
1361049637,1471018196,3,928,309.3333333,1361049633371,1361049633435,1471014567,1471014631,64
1361049637,1471018200,7,3070,438.5714286,1361049633367,1361049633559,1471014567,1471014759,192
1361049637,1471018200,3,164,54.66666667,1361049633367,1361049633431,1471014567,1471014631,64
1361049637,1471018200,7,3422,488.8571429,1361049633431,1361049633687,1471014631,1471014887,256
1361049637,1471018200,12,10418,868.1666667,1361049630618,1361049631130,1471011818,1471012330,512
1361049637,1471018200,5,617,123.4,1361049633562,1361049633626,1471014762,1471014826,64
1361049637,1471018200,7,1912,273.1428571,1361049633625,1361049633753,1471014825,1471014953,128
1361049637,1471018200,5,1282,256.4,1361049633689,1361049634201,1471014889,1471015401,512
1361049637,1471018200,4,805,201.25,1361049633689,1361049634201,1471014889,1471015401,512
1361049637,1471018200,5,2824,564.8,1361049633753,1361049634201,1471014953,1471015401,448
1361049637,1471018200,7,2946,420.8571429,1361049633753,1361049634201,1471014953,1471015401,448
1361049637,1471018200,6,2770,461.6666667,1361049633817,1361049634201,1471015017,1471015401,384
1361049637,1471018200,6,1555,259.1666667,1361049633560,1361049633688,1471014760,1471014888,128
1361049637,1471018200,5,617,123.4,1361049633752,1361049633816,1471014952,1471015016,64
1361049637,1471018200,5,1503,300.6,1361049633879,1361049633943,1471015079,1471015143,64
1361049637,1471018200,3,679,226.3333333,1361049633943,1361049634135,1471015143,1471015335,192
1361049637,1471018204,3,580,193.3333333,1361049634067,1361049634195,1471015271,1471015399,128
1361049637,1471018204,3,687,229,1361049634067,1361049634067,1471015271,1471015271,0
1361049637,1471018204,3,674,224.6666667,1361049634067,1361049634131,1471015271,1471015335,64
1361049637,1471018204,5,623,124.6,1361049634198,1361049634262,1471015402,1471015466,64
1361049637,1471018204,3,634,211.3333333,1361049634262,1361049634390,1471015466,1471015594,128
1361049637,1471018204,3,164,54.66666667,1361049634582,1361049634646,1471015786,1471015850,64
1361049637,1471018204,5,913,182.6,1361049634646,1361049634710,1471015850,1471015914,64
1361049637,1471018204,6,669,111.5,1361049634326,1361049634454,1471015530,1471015658,128
1361049637,1471018204,3,633,211,1361049634389,1361049634453,1471015593,1471015657,64
1361049637,1471018204,5,857,171.4,1361049634581,1361049634709,1471015785,1471015913,128
1361049637,1471018204,4,592,148,1361049634581,1361049634645,1471015785,1471015849,64
1361049637,1471018204,5,839,167.8,1361049634581,1361049634709,1471015785,1471015913,128
1361049637,1471018204,4,1554,388.5,1361049634581,1361049634709,1471015785,1471015913,128
1361049637,1471018204,4,610,152.5,1361049634645,1361049634901,1471015849,1471016105,256
1361049637,1471018204,12,5956,496.3333333,1361049634645,1361049634837,1471015849,1471016041,192
1361049637,1471018204,3,164,54.66666667,1361049634709,1361049634709,1471015913,1471015913,0
1361049637,1471018204,3,164,54.66666667,1361049634772,1361049634772,1471015976,1471015976,0
1361049637,1471018204,21,25746,1226,1361049634772,1361049634900,1471015976,1471016104,128
1361049637,1471018204,4,1365,341.25,1361049634772,1361049634964,1471015976,1471016168,192
1361049637,1471018204,4,1398,349.5,1361049634772,1361049634964,1471015976,1471016168,192
1361049637,1471018204,10,7493,749.3,1361049634964,1361049635284,1471016168,1471016488,320
1361049637,1471018204,3,641,213.6666667,1361049634963,1361049635027,1471016167,1471016231,64
1361049637,1471018204,6,1555,259.1666667,1361049634899,1361049635091,1471016103,1471016295,192
1361049637,1471018204,6,2766,461,1361049634963,1361049635155,1471016167,1471016359,192
1361049637,1471018204,5,623,124.6,1361049634963,1361049635027,1471016167,1471016231,64
1361049637,1471018204,3,632,210.6666667,1361049635027,1361049635027,1471016231,1471016231,0
1361049637,1471018204,3,502,167.3333333,1361049635027,1361049635155,1471016231,1471016359,128
1361049637,1471018208,7,856,122.2857143,1361049635087,1361049635215,1471016295,1471016423,128
1361049637,1471018208,5,617,123.4,1361049635151,1361049635215,1471016359,1471016423,64
1361049637,1471018208,5,455,91,1361049635155,1361049635283,1471016363,1471016491,128
1361049637,1471018208,7,1912,273.1428571,1361049635155,1361049635283,1471016363,1471016491,128
1361049637,1471018208,5,1056,211.2,1361049635219,1361049635283,1471016427,1471016491,64
1361049637,1471018208,5,1282,256.4,1361049635282,1361049635474,1471016490,1471016682,192
1361049637,1471018208,5,1866,373.2,1361049635346,1361049635474,1471016554,1471016682,128
1361049637,1471018208,5,1218,243.6,1361049635345,1361049635537,1471016553,1471016745,192
1361049637,1471018208,6,3949,658.1666667,1361049631121,1361049632529,1471012329,1471013737,1408
1361049637,1471018208,6,1745,290.8333333,1361049635473,1361049635601,1471016681,1471016809,128
1361049637,1471018208,23,11492,499.6521739,1361049631185,1361049632529,1471012393,1471013737,1344
1361049637,1471018208,3,1041,347,1361049631185,1361049631249,1471012393,1471012457,64
1361049637,1471018208,3,875,291.6666667,1361049631121,1361049631121,1471012329,1471012329,0
1361049637,1471018208,3,540,180,1361049635536,1361049635600,1471016744,1471016808,64
1361049637,1471018208,5,594,118.8,1361049635536,1361049635792,1471016744,1471017000,256
1361049637,1471018208,3,623,207.6666667,1361049635472,1361049635536,1471016680,1471016744,64
1361049637,1471018208,15,10792,719.4666667,1361049631312,1361049632528,1471012520,1471013736,1216
1361049637,1471018208,6,1555,259.1666667,1361049635536,1361049635728,1471016744,1471016936,192
1361049637,1471018208,5,1503,300.6,1361049635663,1361049635727,1471016871,1471016935,64
1361049637,1471018208,7,1783,254.7142857,1361049635599,1361049635727,1471016807,1471016935,128
1361049637,1471018212,7,3422,488.8571429,1361049631374,1361049631630,1471012586,1471012842,256
1361049637,1471018232,3,875,291.6666667,1361049631864,1361049631928,1471013096,1471013160,64
1361049637,1471018232,3,1049,349.6666667,1361049631927,1361049631991,1471013159,1471013223,64
1361049637,1471018236,3,581,193.6666667,1361049631991,1361049632119,1471013227,1471013355,128
1361049637,1471018236,7,3418,488.2857143,1361049632054,1361049632310,1471013290,1471013546,256
1361049637,1471018236,3,502,167.3333333,1361049632310,1361049632310,1471013546,1471013546,0
1361049637,1471018236,6,2773,462.1666667,1361049632500,1361049632884,1471013736,1471014120,384
1361049637,1471018236,3,1041,347,1361049632564,1361049632564,1471013800,1471013800,0
1361049637,1471018236,3,1049,349.6666667,1361049632564,1361049632628,1471013800,1471013864,64
1361049637,1471018240,4,413,103.25,1361049632623,1361049633199,1471013863,1471014439,576
1361049637,1471018240,1311,1850256,1411.331808,1361049628211,1361049632435,1471009451,1471013675,4224
1361049637,1471018240,3,642,214,1361049632817,1361049632881,1471014057,1471014121,64
1361049637,1471018240,7,2817,402.4285714,1361049633009,1361049633521,1471014249,1471014761,512
1361049637,1471018240,3,502,167.3333333,1361049632880,1361049633072,1471014120,1471014312,192
1361049637,1471018240,6,1333,222.1666667,1361049630192,1361049630256,1471011432,1471011496,64
1361049637,1471018240,1302,1849801,1420.738095,1361049630255,1361049634799,1471011495,1471016039,4544
1361049637,1471018244,3,875,291.6666667,1361049633199,1361049633263,1471014443,1471014507,64
1361049637,1471018244,8,2402,300.25,1361049633199,1361049633455,1471014443,1471014699,256
1361049637,1471018244,3,795,265,1361049633198,1361049633262,1471014442,1471014506,64
1361049637,1471018244,5,1056,211.2,1361049633198,1361049633262,1471014442,1471014506,64
1361049637,1471018244,6,1000,166.6666667,1361049633262,1361049633390,1471014506,1471014634,128
1361049637,1471018244,4,734,183.5,1361049633262,1361049633390,1471014506,1471014634,128
1361049637,1471018244,3,164,54.66666667,1361049633262,1361049633326,1471014506,1471014570,64
1361049637,1471018244,5,1201,240.2,1361049633262,1361049633518,1471014506,1471014762,256
1361049637,1471018244,5,913,182.6,1361049633326,1361049633326,1471014570,1471014570,0
1361049637,1471018244,3,1049,349.6666667,1361049633326,1361049633326,1471014570,1471014570,0
1361049637,1471018244,3,580,193.3333333,1361049633261,1361049633453,1471014505,1471014697,192
1361049637,1471018244,11,5481,498.2727273,1361049633261,1361049633453,1471014505,1471014697,192
1361049637,1471018244,5,1982,396.4,1361049633325,1361049633517,1471014569,1471014761,192
1361049637,1471018244,4,1398,349.5,1361049633389,1361049633517,1471014633,1471014761,128
1361049637,1471018244,4,1392,348,1361049633388,1361049633516,1471014632,1471014760,128
1361049637,1471018244,3,164,54.66666667,1361049633388,1361049633452,1471014632,1471014696,64
1361049637,1471018244,3,634,211.3333333,1361049633452,1361049633644,1471014696,1471014888,192
1361049637,1471018244,6,1555,259.1666667,1361049633515,1361049633643,1471014759,1471014887,128
1361049637,1471018244,11,4647,422.4545455,1361049633515,1361049634219,1471014759,1471015463,704
1361049637,1471018244,5,1890,378,1361049633515,1361049634155,1471014759,1471015399,640
1361049637,1471018248,3,633,211,1361049633643,1361049633707,1471014891,1471014955,64
1361049637,1471018248,3,502,167.3333333,1361049633707,1361049633707,1471014955,1471014955,0
1361049637,1471018248,6,1555,259.1666667,1361049633514,1361049633642,1471014762,1471014890,128
1361049637,1471018248,6,2372,395.3333333,1361049633514,1361049633706,1471014762,1471014954,192
1361049637,1471018248,5,594,118.8,1361049633514,1361049633770,1471014762,1471015018,256
1361049637,1471018248,7,1329,189.8571429,1361049634026,1361049634154,1471015274,1471015402,128
1361049637,1471018248,6,2366,394.3333333,1361049634090,1361049634154,1471015338,1471015402,64
1361049637,1471018248,3,642,214,1361049633578,1361049633642,1471014826,1471014890,64
1361049637,1471018248,6,2767,461.1666667,1361049634154,1361049634282,1471015402,1471015530,128
1361049637,1471018248,5,594,118.8,1361049634218,1361049634410,1471015466,1471015658,192
1361049637,1471018248,6,1243,207.1666667,1361049633706,1361049633834,1471014954,1471015082,128
1361049637,1471018248,3,621,207,1361049633706,1361049633898,1471014954,1471015146,192
1361049637,1471018248,3,642,214,1361049634282,1361049634346,1471015530,1471015594,64
1361049637,1471018248,8,5853,731.625,1361049634346,1361049634538,1471015594,1471015786,192
1361049637,1471018248,7,1783,254.7142857,1361049633897,1361049634025,1471015145,1471015273,128
1361049637,1471018248,4,651,162.75,1361049633961,1361049634153,1471015209,1471015401,192
1361049637,1471018248,6,2198,366.3333333,1361049634153,1361049634409,1471015401,1471015657,256
1361049637,1471018248,5,2828,565.6,1361049634217,1361049634537,1471015465,1471015785,320
1361049637,1471018248,5,654,130.8,1361049618664,1361049628776,1470999912,1471010024,10112
1361049637,1471018248,5,455,91,1361049634344,1361049634472,1471015592,1471015720,128
1361049637,1471018248,6,2771,461.8333333,1361049634472,1361049634920,1471015720,1471016168,448
1361049637,1471018248,3,502,167.3333333,1361049634472,1361049634600,1471015720,1471015848,128
1361049637,1471018248,5,1056,211.2,1361049634536,1361049634600,1471015784,1471015848,64
1361049637,1471018248,3,579,193,1361049634536,1361049634728,1471015784,1471015976,192
1361049639,1471020008,3,795,265,1361049634776,1361049634840,1471015784,1471015848,64
1361049639,1471020008,6,1000,166.6666667,1361049634776,1361049634904,1471015784,1471015912,128
1361049639,1471020008,7,3861,551.5714286,1361049634776,1361049634904,1471015784,1471015912,128
1361049639,1471020008,18,21404,1189.111111,1361049634776,1361049634904,1471015784,1471015912,128
1361049639,1471020008,12,5948,495.6666667,1361049634840,1361049635224,1471015848,1471016232,384
1361049639,1471020008,4,734,183.5,1361049634840,1361049634968,1471015848,1471015976,128
1361049639,1471020008,5,1982,396.4,1361049634904,1361049635160,1471015912,1471016168,256
1361049639,1471020136,1,52,52,1361049611865,1361049611865,1470993001,1470993001,0
1361049639,109333672,11,10406,946,1361049630983,1361049632199,109325655,109326871,1216
1361049639,109333672,9,3218,357.5555556,1361049633220,1361049633860,109327892,109328532,640
1361049639,109333680,5,1460,292,1361049632190,1361049632958,109326870,109327638,768
1361049639,109333680,5,1460,292,1361049632956,1361049633212,109327636,109327892,256
1361049639,109333684,5,1460,292,1361049634233,1361049634553,109328917,109329237,320
1361049639,109333684,5,1460,292,1361049631545,1361049632185,109326229,109326869,640
1361049639,109333684,7,1921,274.4285714,1361049634617,1361049634873,109329301,109329557,256
1361049639,109333696,7,1921,274.4285714,1361049634990,1361049635182,109329686,109329878,192
1361049643,1471024112,1,52,52,1361049618481,1361049618481,1470999593,1470999593,0
1361049643,1471024112,26,33337,1282.192308,1361049618481,1361049618609,1470999593,1470999721,128
1361049643,1471024112,9,8865,985,1361049618608,1361049618672,1470999720,1470999784,64
1361049643,1471024196,12,11953,996.0833333,1361049617693,1361049617885,1470998889,1470999081,192
1361049643,1471024200,1,52,52,1361049618394,1361049618394,1470999594,1470999594,0
1361049643,1471024204,1,52,52,1361049618451,1361049618451,1470999655,1470999655,0
1361049645,1471026160,6,1463,243.8333333,1361049635647,1361049640831,1471016807,1471021991,5184
1361049645,1471026256,6,1333,222.1666667,1361049641955,1361049642019,1471023211,1471023275,64
1361049647,1471028052,1,52,52,1361049618862,1361049618862,1470999914,1470999914,0
1361049647,1471028068,1,52,52,1361049621531,1361049621531,1471002599,1471002599,0
1361049655,1471036128,1,46,46,1361049630623,1361049630623,1471011751,1471011751,0
1361049655,1471036132,1,46,46,1361049630619,1361049630619,1471011751,1471011751,0
1361049659,1471040212,1,52,52,1361049634062,1361049634062,1471015274,1471015274,0
1361049660,109354652,4,1279,319.75,1361049635483,1361049635547,109330135,109330199,64
1361049660,109354692,22,28448,1293.090909,1361049635441,1361049635505,109330133,109330197,64
1361049661,1471042156,5,593,118.6,1361049635588,1361049656644,1471016744,1471037800,21056
1361049661,1471042164,5,453,90.6,1361049656699,1361049656763,1471037863,1471037927,64
1361049661,1471042168,7,5293,756.1428571,1361049656889,1361049656953,1471038057,1471038121,64
1361049661,1471042168,66,86138,1305.121212,1361049656889,1361049657273,1471038057,1471038441,384
1361049661,1471042168,6,4253,708.8333333,1361049656889,1361049656953,1471038057,1471038121,64
1361049661,1471042168,8,6305,788.125,1361049656889,1361049656953,1471038057,1471038121,64
1361049661,1471042168,7,5465,780.7142857,1361049656888,1361049656952,1471038056,1471038120,64
1361049661,1471042188,7,5494,784.8571429,1361049657444,1361049657508,1471038632,1471038696,64
1361049661,1471042188,5,2331,466.2,1361049657444,1361049657636,1471038632,1471038824,192
1361049661,1471042188,10,4403,440.3,1361049657444,1361049657828,1471038632,1471039016,384
1361049661,1471042188,7,5184,740.5714286,1361049657507,1361049657635,1471038695,1471038823,128
1361049661,1471042236,10,4411,441.1,1361049656821,1361049657205,1471038057,1471038441,384
1361049661,1471042236,7,5356,765.1428571,1361049656821,1361049656885,1471038057,1471038121,64
1361049661,1471042236,7,5432,776,1361049656819,1361049656883,1471038055,1471038119,64
1361049661,1471042240,7,5405,772.1428571,1361049657391,1361049657583,1471038631,1471038823,192
1361049661,1471042240,6,3124,520.6666667,1361049657391,1361049657455,1471038631,1471038695,64
1361049661,1471042240,6,3663,610.5,1361049657455,1361049657583,1471038695,1471038823,128
1361049661,1471042240,7,5075,725,1361049657455,1361049657583,1471038695,1471038823,128
1361049661,1471042244,110,147640,1342.181818,1361049654443,1361049656811,1471035687,1471038055,2368
1361049661,1471042244,11,5850,531.8181818,1361049657386,1361049657706,1471038630,1471038950,320
1361049663,1471044076,7,2759,394.1428571,1361049635731,1361049635859,1471016807,1471016935,128
1361049663,1471044180,6,1277,212.8333333,1361049635757,1361049635885,1471016937,1471017065,128
1361049663,1471044200,11,2133,193.9090909,1361049638105,1361049658905,1471019305,1471040105,20800
1361049664,109358672,1,52,52,1361049636549,1361049636549,109331221,109331221,0
1361049669,1471050476,27,33159,1228.111111,1361049663299,1361049663363,1471044775,1471044839,64
1361049669,1471050480,61,82594,1354,1361049663615,1361049663679,1471045095,1471045159,64
1361049669,1471050480,66,89308,1353.151515,1361049663615,1361049663743,1471045095,1471045223,128
1361049669,1471050528,25,30495,1219.8,1361049663249,1361049663313,1471044777,1471044841,64
1361049669,1471050528,28,35527,1268.821429,1361049663248,1361049663312,1471044776,1471044840,64
1361049674,1471056116,4,1040,260,1361049647748,1361049657732,1471029864,1471039848,9984
1361049676,1471058160,3,961,320.3333333,1361049673945,1361049674009,1471056105,1471056169,64
1361049676,1471058160,3,969,323,1361049674009,1361049674009,1471056169,1471056169,0
1361049676,1471058160,3,880,293.3333333,1361049674009,1361049674073,1471056169,1471056233,64
1361049676,1471058160,6,591,98.5,1361049674008,1361049674520,1471056168,1471056680,512
1361049676,1471058160,5,1664,332.8,1361049674136,1361049674136,1471056296,1471056296,0
1361049676,1471058160,3,633,211,1361049674136,1361049674328,1471056296,1471056488,192
1361049676,1471058160,5,617,123.4,1361049674199,1361049674327,1471056359,1471056487,128
1361049676,1471058160,33,41933,1270.69697,1361049674263,1361049674327,1471056423,1471056487,64
1361049676,1471058160,5,617,123.4,1361049674263,1361049674327,1471056423,1471056487,64
1361049676,1471058160,3,641,213.6666667,1361049674263,1361049674327,1471056423,1471056487,64
1361049676,1471058164,5,1740,348,1361049674323,1361049674451,1471056487,1471056615,128
1361049676,1471058164,7,1550,221.4285714,1361049674387,1361049674515,1471056551,1471056679,128
1361049676,1471058164,3,632,210.6666667,1361049674322,1361049674386,1471056486,1471056550,64
1361049676,1471058164,5,956,191.2,1361049674390,1361049674454,1471056554,1471056618,64
1361049676,1471058164,5,594,118.8,1361049674390,1361049674454,1471056554,1471056618,64
1361049676,1471058164,6,564,94,1361049674390,1361049675030,1471056554,1471057194,640
1361049676,1471058164,3,808,269.3333333,1361049674390,1361049674454,1471056554,1471056618,64
1361049676,1471058164,6,895,149.1666667,1361049674389,1361049674581,1471056553,1471056745,192
1361049676,1471058164,5,455,91,1361049674453,1361049674581,1471056617,1471056745,128
1361049676,1471058164,3,540,180,1361049674389,1361049674453,1471056553,1471056617,64
1361049676,1471058164,4,1318,329.5,1361049674388,1361049674516,1471056552,1471056680,128
1361049676,1471058164,7,804,114.8571429,1361049674388,1361049674580,1471056552,1471056744,192
1361049676,1471058164,4,645,161.25,1361049674452,1361049674580,1471056616,1471056744,128
1361049676,1471058164,5,2823,564.6,1361049674388,1361049674644,1471056552,1471056808,256
1361049676,1471058164,6,1333,222.1666667,1361049674516,1361049674580,1471056680,1471056744,64
1361049676,1471058164,6,2770,461.6666667,1361049674452,1361049674964,1471056616,1471057128,512
1361049676,1471058164,4,651,162.75,1361049674643,1361049674707,1471056807,1471056871,64
1361049676,1471058164,6,2925,487.5,1361049674643,1361049674771,1471056807,1471056935,128
1361049676,1471058164,3,580,193.3333333,1361049674707,1361049674835,1471056871,1471056999,128
1361049676,1471058168,5,453,90.6,1361049670670,1361049670734,1471052838,1471052902,64
1361049676,1471058168,3,633,211,1361049675023,1361049675023,1471057191,1471057191,0
1361049677,1471058172,13,12350,950,1361049672242,1361049672754,1471053414,1471053926,512
1361049677,1471058172,4,592,148,1361049676150,1361049676214,1471057322,1471057386,64
1361049677,1471058172,7,3240,462.8571429,1361049675958,1361049676086,1471057130,1471057258,128
1361049677,1471058172,3,581,193.6666667,1361049676213,1361049676341,1471057385,1471057513,128
1361049677,1471058172,3,642,214,1361049675957,1361049676021,1471057129,1471057193,64
1361049677,1471058172,11,5966,542.3636364,1361049676213,1361049676469,1471057385,1471057641,256
1361049677,1471058172,3,279,93,1361049676339,1361049676467,1471057511,1471057639,128
1361049677,1471058176,3,643,214.3333333,1361049676530,1361049676530,1471057706,1471057706,0
1361049677,1471058176,3,827,275.6666667,1361049672818,1361049672882,1471053994,1471054058,64
1361049677,1471058176,6,2766,461,1361049676593,1361049676721,1471057769,1471057897,128
1361049677,1471058176,4,612,153,1361049672881,1361049673137,1471054057,1471054313,256
1361049677,1471058176,20,11391,569.55,1361049672945,1361049673073,1471054121,1471054249,128
1361049677,1471058196,3,961,320.3333333,1361049672988,1361049672988,1471054184,1471054184,0
1361049677,1471058200,3,502,167.3333333,1361049673431,1361049673431,1471054631,1471054631,0
1361049677,1471058200,5,2823,564.6,1361049673431,1361049673623,1471054631,1471054823,192
1361049677,1471058200,3,961,320.3333333,1361049673623,1361049673687,1471054823,1471054887,64
1361049677,1471058204,3,969,323,1361049673682,1361049673746,1471054886,1471054950,64
1361049677,1471058204,3,634,211.3333333,1361049673810,1361049674002,1471055014,1471055206,192
1361049677,1471058204,3,642,214,1361049673942,1361049674006,1471055146,1471055210,64
1361049677,1471058204,3,827,275.6666667,1361049674262,1361049674262,1471055466,1471055466,0
1361049677,1471058204,1303,1849853,1419.687644,1361049642070,1361049675542,1471023274,1471056746,33472
1361049677,1471058204,3,880,293.3333333,1361049673749,1361049673749,1471054953,1471054953,0
1361049677,1471058204,7,3422,488.8571429,1361049673749,1361049674005,1471054953,1471055209,256
1361049677,1471058204,3,642,214,1361049674581,1361049674581,1471055785,1471055785,0
1361049677,1471058204,7,2817,402.4285714,1361049674709,1361049675221,1471055913,1471056425,512
1361049677,1471058204,3,961,320.3333333,1361049674260,1361049674324,1471055464,1471055528,64
1361049677,1471058204,4,413,103.25,1361049674324,1361049674388,1471055528,1471055592,64
1361049677,1471058204,3,634,211.3333333,1361049674452,1361049674644,1471055656,1471055848,192
1361049677,1471058204,5,594,118.8,1361049674452,1361049674708,1471055656,1471055912,256
1361049677,1471058208,3,633,211,1361049674578,1361049674642,1471055786,1471055850,64
1361049677,1471058208,5,2828,565.6,1361049674706,1361049674898,1471055914,1471056106,192
1361049677,1471058208,3,827,275.6666667,1361049674896,1361049674896,1471056104,1471056104,0
1361049677,1471058208,3,579,193,1361049674959,1361049675087,1471056167,1471056295,128
1361049677,1471058208,7,3422,488.8571429,1361049675023,1361049675279,1471056231,1471056487,256
1361049677,1471058212,5,2735,547,1361049675018,1361049675146,1471056230,1471056358,128
1361049677,1471058212,6,2766,461,1361049675213,1361049675341,1471056425,1471056553,128
1361049677,1471058212,5,594,118.8,1361049675213,1361049675469,1471056425,1471056681,256
1361049677,1471058212,4,543,135.75,1361049675276,1361049675404,1471056488,1471056616,128
1361049677,1471058212,4,652,163,1361049675276,1361049675340,1471056488,1471056552,64
1361049677,1471058212,3,624,208,1361049675276,1361049675340,1471056488,1471056552,64
1361049677,1471058212,3,703,234.3333333,1361049675339,1361049675403,1471056551,1471056615,64
1361049677,1471058212,5,1503,300.6,1361049675339,1361049675403,1471056551,1471056615,64
1361049677,1471058212,4,548,137,1361049675339,1361049675531,1471056551,1471056743,192
1361049677,1471058212,3,858,286,1361049675339,1361049675467,1471056551,1471056679,128
1361049677,1471058216,7,892,127.4285714,1361049675466,1361049675594,1471056682,1471056810,128
1361049677,1471058216,4,645,161.25,1361049675593,1361049675721,1471056809,1471056937,128
1361049677,1471058216,6,2366,394.3333333,1361049675656,1361049675784,1471056872,1471057000,128
1361049677,1471058216,4,267,66.75,1361049675720,1361049675784,1471056936,1471057000,64
1361049677,1471058216,5,1713,342.6,1361049675719,1361049675783,1471056935,1471056999,64
1361049677,1471058236,3,634,211.3333333,1361049675763,1361049675955,1471056999,1471057191,192
1361049677,1471058236,5,2828,565.6,1361049675827,1361049676019,1471057063,1471057255,192
1361049677,1471058240,10,5598,559.8,1361049676018,1361049676338,1471057258,1471057578,320
1361049677,1471058240,6,2771,461.8333333,1361049676017,1361049676529,1471057257,1471057769,512
1361049677,1471058240,5,594,118.8,1361049675889,1361049676145,1471057129,1471057385,256
1361049677,1471058240,18,21405,1189.166667,1361049676079,1361049676143,1471057319,1471057383,64
1361049677,1471058240,11,5968,542.5454545,1361049676142,1361049676334,1471057382,1471057574,192
1361049677,1471058244,4,860,215,1361049676398,1361049676462,1471057642,1471057706,64
1361049677,1471058244,3,635,211.6666667,1361049676333,1361049676461,1471057577,1471057705,128
1361049677,1471058244,7,5307,758.1428571,1361049676461,1361049676525,1471057705,1471057769,64
1361049677,1471058244,4,1493,373.25,1361049672749,1361049672813,1471053993,1471054057,64
1361049677,1471058244,3,634,211.3333333,1361049676525,1361049676525,1471057769,1471057769,0
1361049677,1471058244,5,594,118.8,1361049676588,1361049676844,1471057832,1471058088,256
1361049677,1471058244,5,1870,374,1361049676588,1361049676652,1471057832,1471057896,64
1361049677,1471058244,17,12640,743.5294118,1361049672940,1361049673132,1471054184,1471054376,192
1361049677,1471058244,3,969,323,1361049672939,1361049673003,1471054183,1471054247,64
1361049677,1471058244,3,880,293.3333333,1361049673067,1361049673067,1471054311,1471054311,0
1361049677,1471058244,7,3422,488.8571429,1361049673067,1361049673387,1471054311,1471054631,320
1361049677,1471058248,3,827,275.6666667,1361049673576,1361049673576,1471054824,1471054824,0
1361049677,1471058248,5,2620,524,1361049673703,1361049673767,1471054951,1471055015,64
1361049677,1471058248,3,580,193.3333333,1361049673639,1361049673767,1471054887,1471055015,128
1361049677,1471058248,3,633,211,1361049673959,1361049673959,1471055207,1471055207,0
1361049677,1471058248,5,594,118.8,1361049674023,1361049674023,1471055271,1471055271,0
1361049677,1471058248,5,2823,564.6,1361049674023,1361049674215,1471055271,1471055463,192
1361049677,1471058248,6,2771,461.8333333,1361049674023,1361049674407,1471055271,1471055655,384
1361049677,1471058252,3,580,193.3333333,1361049674274,1361049674402,1471055526,1471055654,128
1361049677,1471058252,3,969,323,1361049674274,1361049674338,1471055526,1471055590,64
1361049677,1471058252,3,880,293.3333333,1361049674338,1361049674338,1471055590,1471055590,0
1361049677,1471058252,7,3453,493.2857143,1361049674342,1361049674598,1471055594,1471055850,256
1361049677,1471058252,5,623,124.6,1361049674406,1361049674470,1471055658,1471055722,64
1361049677,1471058252,7,3238,462.5714286,1361049674406,1361049674598,1471055658,1471055850,192
1361049677,1471058252,5,594,118.8,1361049674662,1361049674662,1471055914,1471055914,0
1361049677,1471058252,10,5679,567.9,1361049674597,1361049675045,1471055849,1471056297,448
1361049679,1471060176,1,46,46,1361049654769,1361049654769,1471035945,1471035945,0
1361049679,109373660,11,10406,946,1361049672720,1361049672720,109367380,109367380,0
1361049679,109373660,7,4950,707.1428571,1361049676304,1361049676368,109370964,109371028,64
1361049679,109373664,4,464,116,1361049673359,1361049673359,109368023,109368023,0
1361049679,109373664,4,464,116,1361049674636,1361049674636,109369300,109369300,0
1361049679,109373664,4,464,116,1361049675851,1361049676235,109370515,109370899,384
1361049679,109373664,4,699,174.75,1361049674959,1361049675087,109369623,109369751,128
1361049679,109373668,4,1074,268.5,1361049675275,1361049675339,109369943,109370007,64
1361049679,109373668,4,1074,268.5,1361049675850,1361049675850,109370518,109370518,0
1361049679,109373672,4,699,174.75,1361049676743,1361049676807,109371415,109371479,64
1361049679,109373672,4,1074,268.5,1361049673287,1361049673351,109367959,109368023,64
1361049679,109373672,5,1374,274.8,1361049673925,1361049673989,109368597,109368661,64
1361049679,109373672,4,1074,268.5,1361049674564,1361049674628,109369236,109369300,64
1361049679,109373676,7,4950,707.1428571,1361049674883,1361049674883,109369559,109369559,0
1361049679,109373688,4,464,116,1361049675319,1361049675383,109370007,109370071,64
1361049682,1471064132,1,52,52,1361049655924,1361049655924,1471038056,1471038056,0
1361049682,1471064168,6,5305,884.1666667,1361049657295,1361049657295,1471039463,1471039463,0
1361049682,1471064168,6,1979,329.8333333,1361049657295,1361049657359,1471039463,1471039527,64
1361049682,1471064168,6,5348,891.3333333,1361049657295,1361049657295,1471039463,1471039463,0
1361049683,1471064220,1,52,52,1361049656834,1361049656834,1471038054,1471038054,0
1361049683,1471064256,6,4753,792.1666667,1361049658208,1361049658208,1471039464,1471039464,0
1361049683,1471064256,6,5391,898.5,1361049658208,1361049658208,1471039464,1471039464,0
1361049683,1471064256,5,3918,783.6,1361049658208,1361049658208,1471039464,1471039464,0
1361049683,1471064256,6,2486,414.3333333,1361049658208,1361049658272,1471039464,1471039528,64
1361049683,1471064256,6,5222,870.3333333,1361049658206,1361049658206,1471039462,1471039462,0
1361049685,1471066180,13,5590,430,1361049679020,1361049683756,1471060200,1471064936,4736
1361049685,1471066184,4,652,163,1361049677094,1361049677094,1471058278,1471058278,0
1361049685,1471066184,5,956,191.2,1361049677098,1361049677162,1471058282,1471058346,64
1361049685,1471066184,5,1503,300.6,1361049677098,1361049677162,1471058282,1471058346,64
1361049685,1471066184,9,5713,634.7777778,1361049677097,1361049677545,1471058281,1471058729,448
1361049685,1471066184,4,543,135.75,1361049677097,1361049677161,1471058281,1471058345,64
1361049685,1471066184,5,455,91,1361049677097,1361049677225,1471058281,1471058409,128
1361049685,1471066184,3,808,269.3333333,1361049677097,1361049677225,1471058281,1471058409,128
1361049685,1471066184,6,906,151,1361049677096,1361049677352,1471058280,1471058536,256
1361049685,1471066184,4,548,137,1361049677096,1361049677288,1471058280,1471058472,192
1361049685,1471066184,3,858,286,1361049677096,1361049677288,1471058280,1471058472,192
1361049685,1471066184,8,856,107,1361049677160,1361049677288,1471058344,1471058472,128
1361049685,1471066188,5,455,91,1361049677348,1361049677476,1471058536,1471058664,128
1361049685,1471066188,9,5827,647.4444444,1361049677347,1361049677603,1471058535,1471058791,256
1361049685,1471066188,4,645,161.25,1361049677411,1361049677539,1471058599,1471058727,128
1361049685,1471066192,6,2928,488,1361049677536,1361049677600,1471058728,1471058792,64
1361049685,1471066192,6,1108,184.6666667,1361049677536,1361049677600,1471058728,1471058792,64
1361049685,1471066192,5,809,161.8,1361049677535,1361049677663,1471058727,1471058855,128
1361049685,1471066192,6,702,117,1361049677535,1361049677919,1471058727,1471059111,384
1361049685,1471066192,6,2930,488.3333333,1361049677535,1361049677663,1471058727,1471058855,128
1361049685,1471066192,6,1108,184.6666667,1361049677535,1361049677599,1471058727,1471058791,64
1361049685,1471066192,5,786,157.2,1361049677599,1361049677855,1471058791,1471059047,256
1361049685,1471066192,5,899,179.8,1361049677598,1361049677662,1471058790,1471058854,64
1361049685,1471066196,6,965,160.8333333,1361049677597,1361049677661,1471058793,1471058857,64
1361049685,1471066196,13,5590,430,1361049677661,1361049677853,1471058857,1471059049,192
1361049685,1471066196,5,654,130.8,1361049677660,1361049677788,1471058856,1471058984,128
1361049685,1471066196,4,1327,331.75,1361049677660,1361049677788,1471058856,1471058984,128
1361049685,1471066196,6,1094,182.3333333,1361049677660,1361049677916,1471058856,1471059112,256
1361049685,1471066196,6,1452,242,1361049677723,1361049677915,1471058919,1471059111,192
1361049685,1471066196,5,1726,345.2,1361049677723,1361049677915,1471058919,1471059111,192
1361049685,1471066200,6,1554,259,1361049677786,1361049677914,1471058986,1471059114,128
1361049685,1471066220,6,1560,260,1361049677892,1361049678020,1471059112,1471059240,128
1361049685,1471066220,6,1613,268.8333333,1361049677955,1361049678275,1471059175,1471059495,320
1361049685,1471066224,7,1749,249.8571429,1361049678271,1361049678399,1471059495,1471059623,128
1361049685,1471066232,5,809,161.8,1361049678840,1361049683704,1471060072,1471064936,4864
1361049685,1471066232,3,624,208,1361049677047,1361049677047,1471058279,1471058279,0
1361049685,1471066236,3,540,180,1361049677110,1361049677110,1471058346,1471058346,0
1361049685,1471066236,4,1318,329.5,1361049677045,1361049677109,1471058281,1471058345,64
1361049685,1471066236,5,1740,348,1361049677045,1361049677109,1471058281,1471058345,64
1361049685,1471066236,3,703,234.3333333,1361049677045,1361049677109,1471058281,1471058345,64
1361049685,1471066236,7,1496,213.7142857,1361049677045,1361049677173,1471058281,1471058409,128
1361049685,1471066260,3,502,167.3333333,1361049677148,1361049677340,1471058408,1471058600,192
1361049685,1471066260,6,2766,461,1361049677085,1361049677277,1471058345,1471058537,192
1361049685,1471066260,4,645,161.25,1361049677148,1361049677276,1471058408,1471058536,128
1361049685,1471066260,9,4342,482.4444444,1361049675355,1361049680475,1471056615,1471061735,5120
1361049685,1471066264,7,880,125.7142857,1361049677206,1361049677334,1471058470,1471058598,128
1361049685,1471066264,1308,1858357,1420.762232,1361049675481,1361049679449,1471056745,1471060713,3968
1361049685,1471066264,6,994,165.6666667,1361049677462,1361049677590,1471058726,1471058854,128
1361049685,1471066264,5,857,171.4,1361049677462,1361049677526,1471058726,1471058790,64
1361049685,1471066268,6,702,117,1361049677525,1361049677909,1471058793,1471059177,384
1361049685,1471066268,5,857,171.4,1361049677460,1361049677524,1471058728,1471058792,64
1361049685,1471066268,5,1606,321.2,1361049677460,1361049677588,1471058728,1471058856,128
1361049685,1471066268,5,839,167.8,1361049677523,1361049677587,1471058791,1471058855,64
1361049685,1471066268,5,1606,321.2,1361049677523,1361049677651,1471058791,1471058919,128
1361049685,1471066272,6,965,160.8333333,1361049677582,1361049677646,1471058854,1471058918,64
1361049685,1471066272,6,1560,260,1361049677714,1361049677842,1471058986,1471059114,128
1361049685,1471066272,4,1327,331.75,1361049677585,1361049677777,1471058857,1471059049,192
1361049685,1471066272,5,1245,249,1361049677777,1361049678161,1471059049,1471059433,384
1361049685,1471066272,6,1203,200.5,1361049677649,1361049677905,1471058921,1471059177,256
1361049685,1471066276,6,1446,241,1361049677901,1361049678221,1471059177,1471059497,320
1361049685,1471066276,6,1446,241,1361049677900,1361049678220,1471059176,1471059496,320
1361049685,1471066276,5,512,102.4,1361049676492,1361049677132,1471057768,1471058408,640
1361049685,1471066276,6,2774,462.3333333,1361049676619,1361049677131,1471057895,1471058407,512
1361049685,1471066296,6,1075,179.1666667,1361049678330,1361049678458,1471059626,1471059754,128
1361049685,1471066296,6,1554,259,1361049678201,1361049678265,1471059497,1471059561,64
1361049685,1471066296,6,1554,259,1361049678201,1361049678329,1471059497,1471059625,128
1361049685,1471066296,8,1625,203.125,1361049678457,1361049683705,1471059753,1471065001,5248
1361049685,1471066300,6,1618,269.6666667,1361049678645,1361049678773,1471059945,1471060073,128
1361049690,1471072104,2,104,52,1361049663375,1361049674831,1471045479,1471056935,11456
1361049694,1471076156,1,369,369,1361049667165,1361049667165,1471049321,1471049321,0
1361049695,109389676,11,10406,946,1361049693762,1361049693826,109388438,109388502,64
1361049695,109389676,4,1182,295.5,1361049694656,1361049694656,109389332,109389332,0
1361049700,109394628,1,52,52,1361049673328,1361049673328,109367956,109367956,0
1361049701,1471082232,5,680,136,1361049698871,1361049698935,1471080103,1471080167,64
1361049701,1471082232,3,502,167.3333333,1361049698998,1361049699062,1471080230,1471080294,64
1361049701,1471082236,3,634,211.3333333,1361049695157,1361049695285,1471076393,1471076521,128
1361049701,1471082236,4,606,151.5,1361049695347,1361049695603,1471076583,1471076839,256
1361049701,1471082236,4,682,170.5,1361049695346,1361049695410,1471076582,1471076646,64
1361049701,1471082240,9,7746,860.6666667,1361049693361,1361049693873,1471074601,1471075113,512
1361049701,1471082240,5,623,124.6,1361049695792,1361049695856,1471077032,1471077096,64
1361049701,1471082240,3,898,299.3333333,1361049695856,1361049695856,1471077096,1471077096,0
1361049701,1471082240,3,1046,348.6666667,1361049695855,1361049695919,1471077095,1471077159,64
1361049701,1471082240,3,1054,351.3333333,1361049695919,1361049695919,1471077159,1471077159,0
1361049701,1471082240,3,951,317,1361049695919,1361049695983,1471077159,1471077223,64
1361049701,1471082244,5,623,124.6,1361049696109,1361049696173,1471077353,1471077417,64
1361049701,1471082244,3,580,193.3333333,1361049695917,1361049696045,1471077161,1471077289,128
1361049701,1471082244,5,594,118.8,1361049696300,1361049696300,1471077544,1471077544,0
1361049701,1471082244,5,455,91,1361049696107,1361049696235,1471077351,1471077479,128
1361049701,1471082244,5,715,143,1361049696363,1361049696619,1471077607,1471077863,256
1361049701,1471082244,6,702,117,1361049696363,1361049696747,1471077607,1471077991,384
1361049701,1471082244,4,734,183.5,1361049696427,1361049696555,1471077671,1471077799,128
1361049701,1471082248,4,216,54,1361049696486,1361049696550,1471077734,1471077798,64
1361049701,1471082248,4,1327,331.75,1361049696486,1361049696614,1471077734,1471077862,128
1361049701,1471082248,5,1823,364.6,1361049696486,1361049696614,1471077734,1471077862,128
1361049701,1471082248,4,216,54,1361049696554,1361049696682,1471077802,1471077930,128
1361049701,1471082248,6,1108,184.6666667,1361049696361,1361049696425,1471077609,1471077673,64
1361049701,1471082248,3,951,317,1361049696617,1361049696681,1471077865,1471077929,64
1361049701,1471082248,5,1606,321.2,1361049696361,1361049696489,1471077609,1471077737,128
1361049701,1471082248,6,965,160.8333333,1361049696425,1361049696489,1471077673,1471077737,64
1361049701,1471082248,7,3159,451.2857143,1361049696745,1361049697001,1471077993,1471078249,256
1361049701,1471082248,23,28511,1239.608696,1361049696425,1361049696553,1471077673,1471077801,128
1361049701,1471082248,3,502,167.3333333,1361049696744,1361049696936,1471077992,1471078184,192
1361049701,1471082248,4,1360,340,1361049696552,1361049696680,1471077800,1471077928,128
1361049701,1471082248,3,643,214.3333333,1361049696808,1361049696872,1471078056,1471078120,64
1361049701,1471082248,3,1054,351.3333333,1361049696552,1361049696616,1471077800,1471077864,64
1361049701,1471082248,5,632,126.4,1361049696616,1361049696872,1471077864,1471078120,256
1361049701,1471082248,6,1560,260,1361049696679,1361049696807,1471077927,1471078055,128
1361049701,1471082248,7,1917,273.8571429,1361049696935,1361049697063,1471078183,1471078311,128
1361049701,1471082248,3,156,52,1361049696679,1361049696743,1471077927,1471077991,64
1361049701,1471082248,3,635,211.6666667,1361049696679,1361049696871,1471077927,1471078119,192
1361049701,1471082248,10,2362,236.2,1361049696679,1361049696935,1471077927,1471078183,256
1361049701,1471082252,5,594,118.8,1361049696930,1361049696994,1471078182,1471078246,64
1361049701,1471082272,3,1046,348.6666667,1361049694097,1361049694161,1471075369,1471075433,64
1361049701,1471082272,3,1054,351.3333333,1361049694223,1361049694223,1471075495,1471075495,0
1361049701,1471082276,9,8684,964.8888889,1361049697226,1361049697738,1471078502,1471079014,512
1361049701,1471082276,22,11538,524.4545455,1361049697803,1361049698315,1471079079,1471079591,512
1361049701,1471082276,15,10792,719.4666667,1361049697867,1361049698315,1471079143,1471079591,448
1361049701,1471082280,3,502,167.3333333,1361049694601,1361049694665,1471075881,1471075945,64
1361049701,1471082280,5,2823,564.6,1361049694601,1361049694857,1471075881,1471076137,256
1361049701,1471082280,4,652,163,1361049698311,1361049698823,1471079591,1471080103,512
1361049701,1471082280,8,2545,318.125,1361049698311,1361049698503,1471079591,1471079783,192
1361049701,1471082284,8,2537,317.125,1361049698566,1361049698822,1471079850,1471080106,256
1361049701,1471082284,3,840,280,1361049698502,1361049698566,1471079786,1471079850,64
1361049701,1471082284,3,893,297.6666667,1361049698630,1361049698630,1471079914,1471079914,0
1361049701,1471082284,3,976,325.3333333,1361049698565,1361049698629,1471079849,1471079913,64
1361049701,1471082284,3,580,193.3333333,1361049694916,1361049695108,1471076200,1471076392,192
1361049701,1471082284,5,2467,493.4,1361049695042,1361049695298,1471076326,1471076582,256
1361049701,1471082288,3,642,214,1361049695233,1361049695233,1471076521,1471076521,0
1361049701,1471082288,3,633,211,1361049695297,1361049695297,1471076585,1471076585,0
1361049701,1471082288,3,164,54.66666667,1361049677056,1361049693248,1471058344,1471074536,16192
1361049701,1471082288,6,2371,395.1666667,1361049695360,1361049695552,1471076648,1471076840,192
1361049701,1471082288,6,2771,461.8333333,1361049695360,1361049695808,1471076648,1471077096,448
1361049701,1471082288,6,690,115,1361049699263,1361049699711,1471080551,1471080999,448
1361049701,1471082288,5,2828,565.6,1361049695550,1361049695742,1471076838,1471077030,192
1361049701,1471082292,6,2788,464.6666667,1361049695741,1361049696061,1471077033,1471077353,320
1361049701,1471082292,3,502,167.3333333,1361049695805,1361049695997,1471077097,1471077289,192
1361049701,1471082312,7,3422,488.8571429,1361049695911,1361049696167,1471077223,1471077479,256
1361049701,1471082312,3,634,211.3333333,1361049695975,1361049696167,1471077287,1471077479,192
1361049701,1471082312,3,164,54.66666667,1361049675816,1361049693224,1471057128,1471074536,17408
1361049701,1471082312,10,6236,623.6,1361049696104,1361049696296,1471077416,1471077608,192
1361049701,1471082312,3,642,214,1361049696104,1361049696104,1471077416,1471077416,0
1361049701,1471082312,3,633,211,1361049696104,1361049696168,1471077416,1471077480,64
1361049701,1471082312,6,2772,462,1361049696231,1361049696679,1471077543,1471077991,448
1361049701,1471082312,5,2823,564.6,1361049696231,1361049696423,1471077543,1471077735,192
1361049701,1471082312,5,857,171.4,1361049696294,1361049696358,1471077606,1471077670,64
1361049701,1471082312,5,899,179.8,1361049696294,1361049696358,1471077606,1471077670,64
1361049701,1471082312,6,2791,465.1666667,1361049696230,1361049696358,1471077542,1471077670,128
1361049701,1471082316,4,216,54,1361049696290,1361049696354,1471077606,1471077670,64
1361049701,1471082316,6,1000,166.6666667,1361049696290,1361049696418,1471077606,1471077734,128
1361049701,1471082316,6,1203,200.5,1361049696354,1361049696546,1471077670,1471077862,192
1361049701,1471082316,15,16113,1074.2,1361049693797,1361049693989,1471075113,1471075305,192
1361049701,1471082316,3,898,299.3333333,1361049696421,1361049696485,1471077737,1471077801,64
1361049701,1471082316,3,1046,348.6666667,1361049696485,1361049696485,1471077801,1471077801,0
1361049701,1471082316,3,581,193.6666667,1361049696485,1361049696613,1471077801,1471077929,128
1361049701,1471082316,6,1709,284.8333333,1361049696548,1361049696612,1471077864,1471077928,64
1361049701,1471082316,6,1560,260,1361049696548,1361049696676,1471077864,1471077992,128
1361049701,1471082316,7,3453,493.2857143,1361049696611,1361049696867,1471077927,1471078183,256
1361049701,1471082316,19,11096,584,1361049693859,1361049693987,1471075175,1471075303,128
1361049701,1471082316,7,1859,265.5714286,1361049696675,1361049696867,1471077991,1471078183,192
1361049701,1471082316,5,623,124.6,1361049696675,1361049696739,1471077991,1471078055,64
1361049701,1471082316,7,1932,276,1361049696675,1361049696931,1471077991,1471078247,256
1361049701,1471082316,4,1354,338.5,1361049696675,1361049696867,1471077991,1471078183,192
1361049701,1471082316,3,898,299.3333333,1361049693986,1361049693986,1471075302,1471075302,0
1361049701,1471082316,3,634,211.3333333,1361049696802,1361049696802,1471078118,1471078118,0
1361049701,1471082320,15,10792,719.4666667,1361049693982,1361049694558,1471075302,1471075878,576
1361049701,1471082320,9,2851,316.7777778,1361049696798,1361049697054,1471078118,1471078374,256
1361049701,1471082320,6,1560,260,1361049696802,1361049696930,1471078122,1471078250,128
1361049701,1471082320,4,756,189,1361049696865,1361049696929,1471078185,1471078249,64
1361049701,1471082320,4,805,201.25,1361049696865,1361049696929,1471078185,1471078249,64
1361049701,1471082320,5,2727,545.4,1361049696865,1361049697313,1471078185,1471078633,448
1361049701,1471082320,4,740,185,1361049696929,1361049697057,1471078249,1471078377,128
1361049701,1471082320,6,1243,207.1666667,1361049696993,1361049697121,1471078313,1471078441,128
1361049701,1471082320,4,1327,331.75,1361049696993,1361049697121,1471078313,1471078441,128
1361049701,1471082320,3,164,54.66666667,1361049696929,1361049697121,1471078249,1471078441,192
1361049701,1471082324,3,951,317,1361049694173,1361049694237,1471075497,1471075561,64
1361049701,1471082324,7,3422,488.8571429,1361049694236,1361049694556,1471075560,1471075880,320
1361049701,1471082324,4,652,163,1361049697818,1361049698266,1471079142,1471079590,448
1361049701,1471082328,6,2155,359.1666667,1361049698071,1361049698199,1471079399,1471079527,128
1361049701,1471082328,4,533,133.25,1361049698071,1361049698263,1471079399,1471079591,192
1361049701,1471082332,8,2527,315.875,1361049698261,1361049698389,1471079593,1471079721,128
1361049701,1471082332,8,2946,368.25,1361049698453,1361049699029,1471079785,1471080361,576
1361049701,1471082332,6,2155,359.1666667,1361049698325,1361049698453,1471079657,1471079785,128
1361049701,1471082332,3,968,322.6666667,1361049698517,1361049698517,1471079849,1471079849,0
1361049701,1471082332,8,2830,353.75,1361049698389,1361049698901,1471079721,1471080233,512
1361049701,1471082512,7,3422,488.8571429,1361049698464,1361049698720,1471079976,1471080232,256
1361049701,1471082512,6,2741,456.8333333,1361049698464,1361049698912,1471079976,1471080424,448
1361049703,1471084252,4,216,54,1361049677475,1361049693283,1471058727,1471074535,15808
1361049703,1471084252,1,52,52,1361049677474,1361049677474,1471058726,1471058726,0
1361049703,109397668,5,1570,314,1361049696459,1361049696459,109391127,109391127,0
1361049703,109397668,5,1413,282.6,1361049696714,1361049696906,109391382,109391574,192
1361049703,109397668,11,10406,946,1361049697608,1361049698056,109392276,109392724,448
1361049703,109397672,5,1482,296.4,1361049695559,1361049695751,109390231,109390423,192
1361049703,109397672,7,3652,521.7142857,1361049698885,1361049698885,109393557,109393557,0
1361049703,109397672,5,1482,296.4,1361049696196,1361049696324,109390868,109390996,128
1361049703,109397676,5,516,103.2,1361049696451,1361049696579,109391127,109391255,128
1361049703,109397680,4,464,116,1361049694655,1361049695039,109389335,109389719,384
1361049709,1471090244,3,970,323.3333333,1361049706732,1361049706796,1471087976,1471088040,64
1361049709,1471090244,3,883,294.3333333,1361049706795,1361049706859,1471088039,1471088103,64
1361049709,1471090244,7,3453,493.2857143,1361049706859,1361049707115,1471088103,1471088359,256
1361049709,1471090244,7,3159,451.2857143,1361049706859,1361049706987,1471088103,1471088231,128
1361049709,1471090244,3,634,211.3333333,1361049706859,1361049707051,1471088103,1471088295,192
1361049709,1471090248,3,642,214,1361049706985,1361049707049,1471088233,1471088297,64
1361049709,1471090248,3,502,167.3333333,1361049707175,1361049707175,1471088423,1471088423,0
1361049709,1471090248,5,857,171.4,1361049707175,1361049707303,1471088423,1471088551,128
1361049709,1471090248,5,899,179.8,1361049707239,1361049707303,1471088487,1471088551,64
1361049709,1471090248,3,164,54.66666667,1361049707239,1361049707239,1471088487,1471088487,0
1361049709,1471090248,6,1000,166.6666667,1361049707239,1361049707367,1471088487,1471088615,128
1361049709,1471090248,6,702,117,1361049707239,1361049707623,1471088487,1471088871,384
1361049709,1471090248,4,734,183.5,1361049707238,1361049707366,1471088486,1471088614,128
1361049709,1471090252,36,46366,1287.944444,1361049707302,1361049707430,1471088554,1471088682,128
1361049709,1471090252,4,1360,340,1361049707429,1361049707557,1471088681,1471088809,128
1361049709,1471090252,4,592,148,1361049707492,1361049707556,1471088744,1471088808,64
1361049709,1471090252,9,2298,255.3333333,1361049707556,1361049708068,1471088808,1471089320,512
1361049709,1471090252,5,1291,258.2,1361049707492,1361049707620,1471088744,1471088872,128
1361049709,1471090252,6,1560,260,1361049707556,1361049707684,1471088808,1471088936,128
1361049709,1471090252,7,1935,276.4285714,1361049707556,1361049707812,1471088808,1471089064,256
1361049709,1471090252,3,502,167.3333333,1361049707619,1361049707747,1471088871,1471088999,128
1361049709,1471090252,4,1354,338.5,1361049707683,1361049707875,1471088935,1471089127,192
1361049709,1471090252,5,455,91,1361049707747,1361049707811,1471088999,1471089063,64
1361049709,1471090252,3,642,214,1361049707747,1361049707747,1471088999,1471088999,0
1361049709,1471090252,8,856,107,1361049707810,1361049708002,1471089062,1471089254,192
1361049709,1471090256,7,1776,253.7142857,1361049707873,1361049708001,1471089129,1471089257,128
1361049709,1471090256,6,1560,260,1361049707873,1361049708001,1471089129,1471089257,128
1361049709,1471090256,6,1108,184.6666667,1361049707937,1361049708001,1471089193,1471089257,64
1361049709,1471090256,4,1327,331.75,1361049707873,1361049708065,1471089129,1471089321,192
1361049709,1471090256,4,1554,388.5,1361049707937,1361049708001,1471089193,1471089257,64
1361049709,1471090256,6,1419,236.5,1361049708064,1361049708320,1471089320,1471089576,256
1361049709,1471090256,6,1102,183.6666667,1361049708000,1361049708128,1471089256,1471089384,128
1361049709,1471090256,5,1508,301.6,1361049708000,1361049708128,1471089256,1471089384,128
1361049709,1471090256,3,830,276.6666667,1361049704735,1361049704735,1471085991,1471085991,0
1361049709,1471090256,3,962,320.6666667,1361049704799,1361049704799,1471086055,1471086055,0
1361049709,1471090256,3,970,323.3333333,1361049704863,1361049704927,1471086119,1471086183,64
1361049709,1471090256,21,8224,391.6190476,1361049704798,1361049705502,1471086054,1471086758,704
1361049709,1471090256,6,1560,260,1361049708190,1361049708318,1471089446,1471089574,128
1361049709,1471090256,15,10792,719.4666667,1361049704862,1361049705502,1471086118,1471086758,640
1361049709,1471090256,4,805,201.25,1361049708318,1361049708382,1471089574,1471089638,64
1361049709,1471090260,7,3422,488.8571429,1361049705053,1361049705309,1471086313,1471086569,256
1361049709,1471090260,6,2769,461.5,1361049708381,1361049708509,1471089641,1471089769,128
1361049709,1471090260,3,502,167.3333333,1361049708445,1361049708573,1471089705,1471089833,128
1361049709,1471090260,6,1560,260,1361049708508,1361049708700,1471089768,1471089960,192
1361049709,1471090284,3,502,167.3333333,1361049705285,1361049705349,1471086569,1471086633,64
1361049709,1471090284,5,2823,564.6,1361049705349,1361049705541,1471086633,1471086825,192
1361049709,1471090284,6,2371,395.1666667,1361049705604,1361049705732,1471086888,1471087016,128
1361049709,1471090284,4,651,162.75,1361049705476,1361049705604,1471086760,1471086888,128
1361049709,1471090284,3,581,193.6666667,1361049705539,1361049705731,1471086823,1471087015,192
1361049709,1471090284,3,635,211.6666667,1361049705731,1361049705859,1471087015,1471087143,128
1361049709,1471090288,3,643,214.3333333,1361049705793,1361049705857,1471087081,1471087145,64
1361049709,1471090288,5,1056,211.2,1361049708801,1361049708865,1471090089,1471090153,64
1361049709,1471090288,7,3422,488.8571429,1361049706113,1361049706433,1471087401,1471087721,320
1361049709,1471090288,3,641,213.6666667,1361049706305,1361049706305,1471087593,1471087593,0
1361049709,1471090288,5,518,103.6,1361049706369,1361049708865,1471087657,1471090153,2496
1361049709,1471090288,6,2770,461.6666667,1361049706433,1361049706817,1471087721,1471088105,384
1361049709,1471090288,3,830,276.6666667,1361049705921,1361049705985,1471087209,1471087273,64
1361049709,1471090288,6,2773,462.1666667,1361049705984,1361049706432,1471087272,1471087720,448
1361049709,1471090288,3,633,211,1361049706176,1361049706304,1471087464,1471087592,128
1361049709,1471090288,5,594,118.8,1361049706432,1361049706688,1471087720,1471087976,256
1361049709,1471090288,3,830,276.6666667,1361049706623,1361049706623,1471087911,1471087911,0
1361049709,1471090288,3,580,193.3333333,1361049706687,1361049706815,1471087975,1471088103,128
1361049709,1471090292,3,502,167.3333333,1361049706877,1361049707005,1471088169,1471088297,128
1361049709,1471090292,3,633,211,1361049707003,1361049707003,1471088295,1471088295,0
1361049709,1471090296,5,1606,321.2,1361049707193,1361049707321,1471088489,1471088617,128
1361049709,1471090296,6,2771,461.8333333,1361049707129,1361049707513,1471088425,1471088809,384
1361049709,1471090296,5,2828,565.6,1361049707129,1361049707321,1471088425,1471088617,192
1361049709,1471090296,5,870,174,1361049707129,1361049707257,1471088425,1471088553,128
1361049709,1471090296,6,1108,184.6666667,1361049707193,1361049707257,1471088489,1471088553,64
1361049709,1471090296,5,839,167.8,1361049707193,1361049707257,1471088489,1471088553,64
1361049709,1471090296,3,164,54.66666667,1361049707256,1361049707320,1471088552,1471088616,64
1361049709,1471090296,6,965,160.8333333,1361049707256,1361049707320,1471088552,1471088616,64
1361049709,1471090296,5,1749,349.8,1361049707320,1361049707448,1471088616,1471088744,128
1361049709,1471090296,5,654,130.8,1361049707320,1361049707384,1471088616,1471088680,64
1361049709,1471090296,3,164,54.66666667,1361049707320,1361049707384,1471088616,1471088680,64
1361049709,1471090296,5,1373,274.6,1361049707320,1361049707960,1471088616,1471089256,640
1361049709,1471090296,6,1203,200.5,1361049707319,1361049707575,1471088615,1471088871,256
1361049709,1471090296,3,580,193.3333333,1361049707383,1361049707575,1471088679,1471088871,192
1361049709,1471090296,18,21423,1190.166667,1361049707511,1361049707575,1471088807,1471088871,64
1361049709,1471090296,13,6047,465.1538462,1361049707510,1361049707766,1471088806,1471089062,256
1361049709,1471090296,5,518,103.6,1361049707510,1361049708406,1471088806,1471089702,896
1361049709,1471090296,6,2765,460.8333333,1361049707510,1361049707638,1471088806,1471088934,128
1361049709,1471090296,3,634,211.3333333,1361049707574,1361049707702,1471088870,1471088998,128
1361049709,1471090300,3,279,93,1361049707701,1361049707765,1471089001,1471089065,64
1361049709,1471090300,6,1636,272.6666667,1361049707637,1361049707829,1471088937,1471089129,192
1361049709,1471090300,9,8366,929.5555556,1361049704245,1361049704757,1471085545,1471086057,512
1361049709,1471090300,9,5663,629.2222222,1361049707701,1361049707893,1471089001,1471089193,192
1361049709,1471090300,4,805,201.25,1361049707701,1361049707765,1471089001,1471089065,64
1361049709,1471090300,3,633,211,1361049707700,1361049707764,1471089000,1471089064,64
1361049709,1471090300,6,2772,462,1361049707828,1361049708340,1471089128,1471089640,512
1361049709,1471090300,6,1560,260,1361049707828,1361049707956,1471089128,1471089256,128
1361049709,1471090300,6,2917,486.1666667,1361049707892,1361049708020,1471089192,1471089320,128
1361049709,1471090300,7,748,106.8571429,1361049707891,1361049708339,1471089191,1471089639,448
1361049709,1471090300,4,740,185,1361049708019,1361049708083,1471089319,1471089383,64
1361049709,1471090300,5,857,171.4,1361049707891,1361049707955,1471089191,1471089255,64
1361049709,1471090300,4,756,189,1361049707891,1361049707955,1471089191,1471089255,64
1361049709,1471090324,11,4647,422.4545455,1361049707995,1361049708315,1471089319,1471089639,320
1361049709,1471090324,7,1940,277.1428571,1361049708062,1361049708318,1471089386,1471089642,256
1361049709,1471090324,21,8321,396.2380952,1361049704733,1361049705437,1471086057,1471086761,704
1361049709,1471090324,9,2863,318.1111111,1361049707933,1361049708125,1471089257,1471089449,192
1361049709,1471090324,6,965,160.8333333,1361049707933,1361049708061,1471089257,1471089385,128
1361049709,1471090324,6,1203,200.5,1361049708059,1361049708251,1471089383,1471089575,192
1361049709,1471090324,3,623,207.6666667,1361049708251,1361049708251,1471089575,1471089575,0
1361049709,1471090328,3,883,294.3333333,1361049704921,1361049704921,1471086249,1471086249,0
1361049709,1471090328,3,540,180,1361049708313,1361049708313,1471089641,1471089641,0
1361049709,1471090328,4,1354,338.5,1361049708312,1361049708824,1471089640,1471090152,512
1361049709,1471090328,10,6304,630.4,1361049708567,1361049708823,1471089895,1471090151,256
1361049709,1471090328,5,455,91,1361049708567,1361049708695,1471089895,1471090023,128
1361049709,1471090332,5,2828,565.6,1361049705749,1361049706325,1471087081,1471087657,576
1361049709,1471090332,3,962,320.6666667,1361049705940,1361049706004,1471087272,1471087336,64
1361049709,1471090332,3,579,193,1361049705940,1361049706132,1471087272,1471087464,192
1361049709,1471090332,3,970,323.3333333,1361049706003,1361049706067,1471087335,1471087399,64
1361049709,1471090332,5,857,171.4,1361049708755,1361049708819,1471090087,1471090151,64
1361049709,1471090332,3,634,211.3333333,1361049705811,1361049705875,1471087143,1471087207,64
1361049709,1471090332,5,2823,564.6,1361049706386,1361049706578,1471087718,1471087910,192
1361049709,1471090332,3,883,294.3333333,1361049706066,1361049706066,1471087398,1471087398,0
1361049709,1471090336,5,455,91,1361049706578,1361049706706,1471087914,1471088042,128
1361049709,1471090336,3,962,320.6666667,1361049706642,1361049706642,1471087978,1471087978,0
1361049709,1471090336,3,632,210.6666667,1361049706257,1361049706321,1471087593,1471087657,64
1361049709,1471090336,6,2767,461.1666667,1361049706321,1361049706513,1471087657,1471087849,192
1361049709,1471090336,3,502,167.3333333,1361049706385,1361049706449,1471087721,1471087785,64
1361049709,1471090336,9,5765,640.5555556,1361049706576,1361049707152,1471087912,1471088488,576
1361049711,1471092192,1,46,46,1361049684000,1361049684000,1471065192,1471065192,0
1361049711,109405656,5,1570,314,1361049709652,1361049709716,109404308,109404372,64
1361049711,109405660,4,1126,281.5,1361049706387,1361049706451,109401047,109401111,64
1361049711,109405660,6,568,94.66666667,1361049709715,1361049709907,109404375,109404567,192
1361049711,109405660,6,1702,283.6666667,1361049706450,1361049706898,109401110,109401558,448
1361049711,109405660,4,1126,281.5,1361049707218,1361049707218,109401878,109401878,0
1361049711,109405660,4,464,116,1361049707282,1361049707282,109401942,109401942,0
1361049711,109405660,7,1922,274.5714286,1361049707794,1361049708050,109402454,109402710,256
1361049711,109405660,11,10406,946,1361049704592,1361049705232,109399252,109399892,640
1361049711,109405664,7,2688,384,1361049705231,1361049706127,109399895,109400791,896
1361049711,109405664,5,1569,313.8,1361049707276,1361049707276,109401940,109401940,0
1361049711,109405664,5,516,103.2,1361049707276,1361049707404,109401940,109402068,128
1361049717,1471098264,4,1327,331.75,1361049708952,1361049709080,1471090216,1471090344,128
1361049717,1471098272,2176,3098306,1423.85386,1361049699855,1361049711119,1471081127,1471092391,11264
1361049717,1471098276,4,805,201.25,1361049709901,1361049709965,1471091177,1471091241,64
1361049717,1471098276,5,654,130.8,1361049709900,1361049710028,1471091176,1471091304,128
1361049717,1471098276,6,1631,271.8333333,1361049709900,1361049710028,1471091176,1471091304,128
1361049717,1471098276,3,623,207.6666667,1361049710027,1361049710027,1471091303,1471091303,0
1361049717,1471098276,4,1327,331.75,1361049710027,1361049710219,1471091303,1471091495,192
1361049717,1471098276,4,740,185,1361049709963,1361049710091,1471091239,1471091367,128
1361049717,1471098276,5,632,126.4,1361049710026,1361049710282,1471091302,1471091558,256
1361049717,1471098276,6,1333,222.1666667,1361049710090,1361049710154,1471091366,1471091430,64
1361049717,1471098280,6,1554,259,1361049710090,1361049710218,1471091370,1471091498,128
1361049717,1471098280,6,1407,234.5,1361049708425,1361049711689,1471089705,1471092969,3264
1361049717,1471098280,5,1502,300.4,1361049710216,1361049710280,1471091496,1471091560,64
1361049717,1471098296,7,1932,276,1361049708854,1361049709046,1471090150,1471090342,192
1361049717,1471098300,5,1606,321.2,1361049708788,1361049708916,1471090088,1471090216,128
1361049717,1471098300,6,965,160.8333333,1361049708850,1361049708978,1471090150,1471090278,128
1361049717,1471098304,11,4647,422.4545455,1361049708913,1361049709233,1471090217,1471090537,320
1361049717,1471098304,17,7211,424.1764706,1361049711342,1361049711662,1471092646,1471092966,320
1361049717,1471098308,5,1502,300.4,1361049711659,1361049711723,1471092967,1471093031,64
1361049717,1471098312,6,702,117,1361049708840,1361049709224,1471090152,1471090536,384
1361049717,1471098316,4,756,189,1361049709861,1361049709925,1471091177,1471091241,64
1361049717,1471098316,6,1554,259,1361049709861,1361049709989,1471091177,1471091305,128
1361049717,1471098316,4,1462,365.5,1361049708131,1361049709155,1471089447,1471090471,1024
1361049717,1471098336,4,1354,338.5,1361049709903,1361049710031,1471091239,1471091367,128
1361049717,1471098344,6,3383,563.8333333,1361049708742,1361049709126,1471090086,1471090470,384
1361049717,1471098344,6,1203,200.5,1361049708809,1361049709001,1471090153,1471090345,192
1361049717,1471098348,5,839,167.8,1361049708802,1361049708866,1471090150,1471090214,64
1361049718,1471100128,1,46,46,1361049692409,1361049692409,1471074537,1471074537,0
1361049723,1471104180,1,52,52,1361049697002,1361049697002,1471078182,1471078182,0
1361049723,1471104216,1,52,52,1361049698185,1361049698185,1471079401,1471079401,0
1361049723,1471104268,5,2828,565.6,1361049696981,1361049697173,1471078249,1471078441,192
1361049723,1471104268,1,60,60,1361049697171,1361049697171,1471078439,1471078439,0
1361049723,1471104268,1,46,46,1361049697170,1361049697170,1471078438,1471078438,0
1361049727,1471108220,5,2823,564.6,1361049699074,1361049699202,1471080294,1471080422,128
1361049733,1471114276,5,453,90.6,1361049729483,1361049729547,1471110759,1471110823,64
1361049733,1471114300,5,593,118.6,1361049706803,1361049727987,1471088103,1471109287,21184
1361049733,1471114332,5,593,118.6,1361049708306,1361049729426,1471089638,1471110758,21120
1361049739,1471120132,1,52,52,1361049709020,1361049709020,1471090152,1471090152,0
1361049741,1471122256,24,28001,1166.708333,1361049731295,1361049738719,1471112551,1471119975,7424
1361049741,1471122256,17,18310,1077.058824,1361049731422,1361049737374,1471112678,1471118630,5952
1361049741,1471122260,13,11916,916.6153846,1361049739673,1361049740185,1471120933,1471121445,512
1361049741,1471122268,211,296610,1405.734597,1361049737041,1361049737233,1471118309,1471118501,192
1361049741,1471122268,5,408,81.6,1361049736916,1361049737044,1471118184,1471118312,128
1361049741,1471122268,4,521,130.25,1361049737363,1361049737427,1471118631,1471118695,64
1361049741,1471122268,4,376,94,1361049737363,1361049737363,1471118631,1471118631,0
1361049741,1471122268,4,376,94,1361049737363,1361049737363,1471118631,1471118631,0
1361049741,1471122268,25,30262,1210.48,1361049737363,1361049737619,1471118631,1471118887,256
1361049741,1471122268,7,5509,787,1361049737363,1361049737363,1471118631,1471118631,0
1361049741,1471122292,5,1092,218.4,1361049737594,1361049738682,1471118886,1471119974,1088
1361049741,1471122292,9,2982,331.3333333,1361049726266,1361049738682,1471107558,1471119974,12416
1361049741,1471122292,4,377,94.25,1361049737721,1361049738681,1471119013,1471119973,960
1361049741,1471122296,103,142132,1379.92233,1361049737912,1361049738680,1471119208,1471119976,768
1361049741,1471122296,44,58006,1318.318182,1361049737912,1361049738680,1471119208,1471119976,768
1361049741,1471122296,7,4085,583.5714286,1361049738551,1361049738679,1471119847,1471119975,128
1361049741,1471122296,6,1770,295,1361049738167,1361049738679,1471119463,1471119975,512
1361049741,1471122296,4,628,157,1361049738550,1361049738678,1471119846,1471119974,128
1361049741,1471122304,16,17546,1096.625,1361049731248,1361049737328,1471112552,1471118632,6080
1361049741,1471122304,5,654,130.8,1361049731438,1361049738734,1471112742,1471120038,7296
1361049741,1471122308,7,1101,157.2857143,1361049728106,1361049738666,1471109414,1471119974,10560
1361049741,1471122336,4,767,191.75,1361049736848,1361049736976,1471118184,1471118312,128
1361049741,1471122336,3,781,260.3333333,1361049740688,1361049740688,1471122024,1471122024,0
1361049741,1471122336,4,377,94.25,1361049737294,1361049737294,1471118630,1471118630,0
1361049741,1471122336,7,5529,789.8571429,1361049737294,1361049737294,1471118630,1471118630,0
1361049741,1471122336,5,2475,495,1361049737294,1361049737294,1471118630,1471118630,0
1361049741,1471122336,7,5450,778.5714286,1361049737294,1361049737294,1471118630,1471118630,0
1361049741,1471122340,18,20907,1161.5,1361049734539,1361049737035,1471115879,1471118375,2496
1361049741,1471122340,6,1802,300.3333333,1361049737929,1361049738633,1471119269,1471119973,704
1361049741,1471122344,223,311583,1397.233184,1361049738121,1361049738761,1471119465,1471120105,640
1361049741,1471122344,34,43003,1264.794118,1361049738249,1361049738633,1471119593,1471119977,384
1361049741,1471122344,10,7207,720.7,1361049738504,1361049738632,1471119848,1471119976,128
1361049743,1471124148,38,47041,1237.921053,1361049730891,1361049737163,1471112039,1471118311,6272
1361049743,109437664,32,40716,1272.375,1361049738125,1361049738445,109432789,109433109,320
1361049743,109437664,7,2512,358.8571429,1361049741517,1361049742797,109436181,109437461,1280
1361049743,109437664,11,10901,991,1361049738508,1361049738572,109433172,109433236,64
1361049743,109437668,11,10406,946,1361049740491,1361049741515,109435159,109436183,1024
1361049743,109437668,4,1038,259.5,1361049741513,1361049741513,109436181,109436181,0
1361049749,1471130268,5,455,91,1361049742802,1361049742866,1471124070,1471124134,64
1361049749,1471130268,5,415,83,1361049746897,1361049747345,1471128165,1471128613,448
1361049749,1471130272,9,5770,641.1111111,1361049742797,1361049743117,1471124069,1471124389,320
1361049749,1471130272,6,871,145.1666667,1361049747024,1361049747152,1471128296,1471128424,128
1361049749,1471130272,5,1940,388,1361049747151,1361049747215,1471128423,1471128487,64
1361049749,1471130272,6,2864,477.3333333,1361049743055,1361049743311,1471124327,1471124583,256
1361049749,1471130272,3,795,265,1361049743055,1361049743119,1471124327,1471124391,64
1361049749,1471130272,7,1329,189.8571429,1361049743054,1361049743310,1471124326,1471124582,256
1361049749,1471130272,4,1554,388.5,1361049743054,1361049743118,1471124326,1471124390,64
1361049749,1471130272,14,8062,575.8571429,1361049739214,1361049741710,1471120486,1471122982,2496
1361049749,1471130272,3,905,301.6666667,1361049743054,1361049743118,1471124326,1471124390,64
1361049749,1471130272,4,610,152.5,1361049743054,1361049743182,1471124326,1471124454,128
1361049749,1471130272,4,734,183.5,1361049743118,1361049743246,1471124390,1471124518,128
1361049749,1471130272,6,3872,645.3333333,1361049747086,1361049747598,1471128358,1471128870,512
1361049749,1471130272,5,913,182.6,1361049743118,1361049743182,1471124390,1471124454,64
1361049749,1471130272,3,913,304.3333333,1361049743118,1361049743182,1471124390,1471124454,64
1361049749,1471130272,3,834,278,1361049741197,1361049741261,1471122469,1471122533,64
1361049749,1471130276,7,3422,488.8571429,1361049743177,1361049743497,1471124453,1471124773,320
1361049749,1471130276,4,661,165.25,1361049747213,1361049747405,1471128489,1471128681,192
1361049749,1471130276,6,1203,200.5,1361049743245,1361049743437,1471124521,1471124713,192
1361049749,1471130276,4,1360,340,1361049743245,1361049743373,1471124521,1471124649,128
1361049749,1471130276,7,3422,488.8571429,1361049741261,1361049741517,1471122537,1471122793,256
1361049749,1471130276,3,634,211.3333333,1361049743244,1361049743436,1471124520,1471124712,192
1361049749,1471130276,5,1291,258.2,1361049743308,1361049743436,1471124584,1471124712,128
1361049749,1471130276,3,642,214,1361049743372,1361049743436,1471124648,1471124712,64
1361049749,1471130276,6,2762,460.3333333,1361049743372,1361049743500,1471124648,1471124776,128
1361049749,1471130276,6,1549,258.1666667,1361049743371,1361049743499,1471124647,1471124775,128
1361049749,1471130276,5,623,124.6,1361049743371,1361049743563,1471124647,1471124839,192
1361049749,1471130276,6,1549,258.1666667,1361049743371,1361049743499,1471124647,1471124775,128
1361049749,1471130276,3,502,167.3333333,1361049743371,1361049743563,1471124647,1471124839,192
1361049749,1471130276,6,1498,249.6666667,1361049743435,1361049743755,1471124711,1471125031,320
1361049749,1471130276,4,1428,357,1361049747339,1361049747659,1471128615,1471128935,320
1361049749,1471130276,3,623,207.6666667,1361049743435,1361049743435,1471124711,1471124711,0
1361049749,1471130276,3,633,211,1361049743435,1361049743499,1471124711,1471124775,64
1361049749,1471130276,6,1636,272.6666667,1361049743499,1361049743819,1471124775,1471125095,320
1361049749,1471130276,5,2823,564.6,1361049743562,1361049743754,1471124838,1471125030,192
1361049749,1471130276,9,5770,641.1111111,1361049743562,1361049743818,1471124838,1471125094,256
1361049749,1471130276,4,1327,331.75,1361049743562,1361049743818,1471124838,1471125094,256
1361049749,1471130276,5,455,91,1361049743562,1361049743690,1471124838,1471124966,128
1361049749,1471130280,2,92,46,1361049747657,1361049747657,1471128937,1471128937,0
1361049749,1471130280,54,69446,1286.037037,1361049739721,1361049741705,1471121001,1471122985,1984
1361049749,1471130280,5,1497,299.4,1361049743689,1361049743753,1471124969,1471125033,64
1361049749,1471130280,6,2868,478,1361049743753,1361049743881,1471125033,1471125161,128
1361049749,1471130280,7,1329,189.8571429,1361049743753,1361049743945,1471125033,1471125225,192
1361049749,1471130280,4,1327,331.75,1361049743816,1361049743944,1471125096,1471125224,128
1361049749,1471130280,6,1203,200.5,1361049743944,1361049744136,1471125224,1471125416,192
1361049749,1471130280,4,1205,301.25,1361049747720,1361049747784,1471129000,1471129064,64
1361049749,1471130280,3,502,167.3333333,1361049743943,1361049744135,1471125223,1471125415,192
1361049749,1471130280,4,1462,365.5,1361049744007,1361049744327,1471125287,1471125607,320
1361049749,1471130280,4,920,230,1361049744007,1361049744263,1471125287,1471125543,256
1361049749,1471130280,9,2851,316.7777778,1361049744071,1361049744327,1471125351,1471125607,256
1361049749,1471130280,4,805,201.25,1361049744007,1361049744263,1471125287,1471125543,256
1361049749,1471130280,6,1549,258.1666667,1361049744006,1361049744134,1471125286,1471125414,128
1361049749,1471130280,6,1626,271,1361049744134,1361049744262,1471125414,1471125542,128
1361049749,1471130280,15,6543,436.2,1361049744070,1361049744454,1471125350,1471125734,384
1361049749,1471130280,3,633,211,1361049744070,1361049744134,1471125350,1471125414,64
1361049749,1471130284,4,592,148,1361049744261,1361049744325,1471125545,1471125609,64
1361049749,1471130284,18,21402,1189,1361049744261,1361049744325,1471125545,1471125609,64
1361049749,1471130284,6,2033,338.8333333,1361049744261,1361049744389,1471125545,1471125673,128
1361049749,1471130284,12,5954,496.1666667,1361049744325,1361049744517,1471125609,1471125801,192
1361049749,1471130284,3,581,193.6666667,1361049744325,1361049744453,1471125609,1471125737,128
1361049749,1471130284,3,905,301.6666667,1361049741764,1361049741764,1471123048,1471123048,0
1361049749,1471130284,3,781,260.3333333,1361049741700,1361049741764,1471122984,1471123048,64
1361049749,1471130284,3,913,304.3333333,1361049741763,1361049741827,1471123047,1471123111,64
1361049749,1471130284,5,623,124.6,1361049744771,1361049744835,1471126055,1471126119,64
1361049749,1471130284,3,502,167.3333333,1361049744834,1361049744962,1471126118,1471126246,128
1361049749,1471130284,3,279,93,1361049744770,1361049744834,1471126054,1471126118,64
1361049749,1471130284,17,12640,743.5294118,1361049740738,1361049741698,1471122022,1471122982,960
1361049749,1471130284,7,3422,488.8571429,1361049741890,1361049742146,1471123174,1471123430,256
1361049749,1471130304,3,635,211.6666667,1361049744814,1361049744942,1471126118,1471126246,128
1361049749,1471130304,3,834,278,1361049741806,1361049741870,1471123110,1471123174,64
1361049749,1471130304,4,549,137.25,1361049744814,1361049745646,1471126118,1471126950,832
1361049749,1471130308,5,623,124.6,1361049744873,1361049744937,1471126181,1471126245,64
1361049749,1471130308,3,621,207,1361049744940,1361049745068,1471126248,1471126376,128
1361049749,1471130308,4,2838,709.5,1361049744940,1361049745004,1471126248,1471126312,64
1361049749,1471130308,1302,1849801,1420.738095,1361049740715,1361049745387,1471122023,1471126695,4672
1361049749,1471130308,24,14023,584.2916667,1361049740715,1361049741739,1471122023,1471123047,1024
1361049749,1471130308,8,5175,646.875,1361049740715,1361049741675,1471122023,1471122983,960
1361049749,1471130308,3,679,226.3333333,1361049745067,1361049745259,1471126375,1471126567,192
1361049749,1471130308,6,3005,500.8333333,1361049740715,1361049741675,1471122023,1471122983,960
1361049749,1471130308,11,7874,715.8181818,1361049745131,1361049745579,1471126439,1471126887,448
1361049749,1471130312,1305,1854079,1420.750192,1361049710181,1361049744229,1471091493,1471125541,34048
1361049749,1471130312,3,633,211,1361049742057,1361049742121,1471123369,1471123433,64
1361049749,1471130312,3,781,260.3333333,1361049742312,1361049742376,1471123624,1471123688,64
1361049749,1471130312,5,594,118.8,1361049742120,1361049742184,1471123432,1471123496,64
1361049749,1471130312,3,905,301.6666667,1361049742376,1361049742376,1471123688,1471123688,0
1361049749,1471130312,3,687,229,1361049745256,1361049745256,1471126568,1471126568,0
1361049749,1471130312,3,674,224.6666667,1361049745255,1361049745319,1471126567,1471126631,64
1361049749,1471130312,5,623,124.6,1361049745511,1361049745639,1471126823,1471126951,128
1361049749,1471130312,6,2198,366.3333333,1361049745383,1361049745639,1471126695,1471126951,256
1361049749,1471130312,6,4326,721,1361049745382,1361049745574,1471126694,1471126886,192
1361049749,1471130312,5,730,146,1361049745574,1361049745702,1471126886,1471127014,128
1361049749,1471130312,6,2762,460.3333333,1361049742566,1361049742694,1471123878,1471124006,128
1361049749,1471130312,4,1087,271.75,1361049745638,1361049745766,1471126950,1471127078,128
1361049749,1471130312,4,732,183,1361049745638,1361049745702,1471126950,1471127014,64
1361049749,1471130312,3,502,167.3333333,1361049742566,1361049742758,1471123878,1471124070,192
1361049749,1471130312,4,1225,306.25,1361049745638,1361049745766,1471126950,1471127078,128
1361049749,1471130312,5,455,91,1361049745702,1361049745766,1471127014,1471127078,64
1361049749,1471130312,1312,1850859,1410.715701,1361049737894,1361049741542,1471119206,1471122854,3648
1361049749,1471130312,5,544,108.8,1361049745702,1361049745766,1471127014,1471127078,64
1361049749,1471130312,10,7324,732.4,1361049745702,1361049746022,1471127014,1471127334,320
1361049749,1471130312,3,642,214,1361049742629,1361049742693,1471123941,1471124005,64
1361049749,1471130316,4,784,196,1361049745573,1361049745637,1471126889,1471126953,64
1361049749,1471130316,5,765,153,1361049745637,1361049745701,1471126953,1471127017,64
1361049749,1471130316,4,1081,270.25,1361049745637,1361049745765,1471126953,1471127081,128
1361049749,1471130316,4,930,232.5,1361049745637,1361049745701,1471126953,1471127017,64
1361049749,1471130316,6,2050,341.6666667,1361049745700,1361049745828,1471127016,1471127144,128
1361049749,1471130316,3,717,239,1361049745700,1361049745764,1471127016,1471127080,64
1361049749,1471130316,3,738,246,1361049745764,1361049745828,1471127080,1471127144,64
1361049749,1471130316,3,633,211,1361049742692,1361049742756,1471124008,1471124072,64
1361049749,1471130316,3,624,208,1361049745764,1361049745828,1471127080,1471127144,64
1361049749,1471130316,4,652,163,1361049745764,1361049745828,1471127080,1471127144,64
1361049749,1471130316,5,1502,300.4,1361049745828,1361049745892,1471127144,1471127208,64
1361049749,1471130316,3,540,180,1361049745828,1361049745828,1471127144,1471127144,0
1361049749,1471130316,4,1318,329.5,1361049745828,1361049745956,1471127144,1471127272,128
1361049749,1471130316,7,1550,221.4285714,1361049745827,1361049746019,1471127143,1471127335,192
1361049749,1471130316,5,1169,233.8,1361049745827,1361049746019,1471127143,1471127335,192
1361049749,1471130316,3,808,269.3333333,1361049745827,1361049745891,1471127143,1471127207,64
1361049749,1471130316,5,1056,211.2,1361049745891,1361049745955,1471127207,1471127271,64
1361049749,1471130316,3,164,54.66666667,1361049745955,1361049746019,1471127271,1471127335,64
1361049749,1471130316,7,1896,270.8571429,1361049746019,1361049746147,1471127335,1471127463,128
1361049749,1471130316,6,994,165.6666667,1361049746019,1361049746147,1471127335,1471127463,128
1361049749,1471130316,3,764,254.6666667,1361049745827,1361049745891,1471127143,1471127207,64
1361049749,1471130316,4,734,183.5,1361049746019,1361049746147,1471127335,1471127463,128
1361049749,1471130316,3,858,286,1361049745827,1361049746019,1471127143,1471127335,192
1361049749,1471130316,4,645,161.25,1361049745891,1361049746019,1471127207,1471127335,128
1361049749,1471130316,3,731,243.6666667,1361049745891,1361049746019,1471127207,1471127335,128
1361049749,1471130316,4,1594,398.5,1361049746147,1361049746403,1471127463,1471127719,256
1361049749,1471130316,5,1999,399.8,1361049745955,1361049746019,1471127271,1471127335,64
1361049749,1471130316,7,856,122.2857143,1361049746018,1361049746402,1471127334,1471127718,384
1361049749,1471130316,7,880,125.7142857,1361049746018,1361049746402,1471127334,1471127718,384
1361049749,1471130316,15,15614,1040.933333,1361049746018,1361049746402,1471127334,1471127718,384
1361049749,1471130316,4,645,161.25,1361049746210,1361049746402,1471127526,1471127718,192
1361049749,1471130316,3,164,54.66666667,1361049746082,1361049746082,1471127398,1471127398,0
1361049749,1471130316,6,1549,258.1666667,1361049746274,1361049746402,1471127590,1471127718,128
1361049749,1471130316,8,4048,506,1361049746146,1361049746466,1471127462,1471127782,320
1361049749,1471130316,5,967,193.4,1361049746274,1361049746338,1471127590,1471127654,64
1361049749,1471130316,4,1360,340,1361049746274,1361049746402,1471127590,1471127718,128
1361049749,1471130316,4,1370,342.5,1361049746274,1361049746402,1471127590,1471127718,128
1361049749,1471130316,6,820,136.6666667,1361049746274,1361049746402,1471127590,1471127718,128
1361049749,1471130316,6,438,73,1361049746337,1361049746465,1471127653,1471127781,128
1361049749,1471130316,7,1766,252.2857143,1361049746337,1361049746465,1471127653,1471127781,128
1361049749,1471130316,5,969,193.8,1361049746337,1361049746465,1471127653,1471127781,128
1361049749,1471130320,9,7410,823.3333333,1361049746397,1361049747293,1471127717,1471128613,896
1361049749,1471130320,6,2845,474.1666667,1361049746397,1361049746461,1471127717,1471127781,64
1361049749,1471130320,6,1549,258.1666667,1361049746397,1361049746525,1471127717,1471127845,128
1361049749,1471130320,6,1549,258.1666667,1361049746465,1361049746593,1471127785,1471127913,128
1361049749,1471130320,29,36073,1243.896552,1361049746529,1361049747297,1471127849,1471128617,768
1361049749,1471130320,11,4647,422.4545455,1361049746528,1361049747360,1471127848,1471128680,832
1361049749,1471130320,5,1458,291.6,1361049746656,1361049747296,1471127976,1471128616,640
1361049749,1471130320,6,1203,200.5,1361049746528,1361049747360,1471127848,1471128680,832
1361049749,1471130320,6,1555,259.1666667,1361049746656,1361049747360,1471127976,1471128680,704
1361049749,1471130320,4,1327,331.75,1361049746720,1361049747360,1471128040,1471128680,640
1361049749,1471130320,5,594,118.8,1361049742752,1361049742816,1471124072,1471124136,64
1361049749,1471130320,6,2769,461.5,1361049742816,1361049743264,1471124136,1471124584,448
1361049749,1471130320,6,3847,641.1666667,1361049746847,1361049747295,1471128167,1471128615,448
1361049749,1471130320,8,3455,431.875,1361049746847,1361049747103,1471128167,1471128423,256
1361049749,1471130320,8,6444,805.5,1361049746847,1361049747295,1471128167,1471128615,448
1361049749,1471130320,3,905,301.6666667,1361049740959,1361049741023,1471122279,1471122343,64
1361049749,1471130320,5,1503,300.6,1361049746846,1361049746974,1471128166,1471128294,128
1361049749,1471130324,3,781,260.3333333,1361049742937,1361049743001,1471124261,1471124325,64
1361049749,1471130324,5,857,171.4,1361049743001,1361049743065,1471124325,1471124389,64
1361049749,1471130324,3,164,54.66666667,1361049743005,1361049743069,1471124329,1471124393,64
1361049749,1471130324,5,2082,416.4,1361049747165,1361049747293,1471128489,1471128617,128
1361049749,1471130324,6,994,165.6666667,1361049743005,1361049743133,1471124329,1471124457,128
1361049749,1471130324,5,1056,211.2,1361049743005,1361049743069,1471124329,1471124393,64
1361049749,1471130324,5,455,91,1361049741021,1361049741405,1471122345,1471122729,384
1361049749,1471130324,3,913,304.3333333,1361049741021,1361049741085,1471122345,1471122409,64
1361049749,1471130324,3,580,193.3333333,1361049743069,1361049743197,1471124393,1471124521,128
1361049749,1471130324,3,164,54.66666667,1361049743069,1361049743133,1471124393,1471124457,64
1361049749,1471130324,3,834,278,1361049743132,1361049743132,1471124456,1471124456,0
1361049749,1471130324,7,3459,494.1428571,1361049743132,1361049743388,1471124456,1471124712,256
1361049749,1471130324,3,164,54.66666667,1361049743132,1361049743196,1471124456,1471124520,64
1361049749,1471130324,4,1327,331.75,1361049743196,1361049743324,1471124520,1471124648,128
1361049749,1471130324,6,1627,271.1666667,1361049747228,1361049747356,1471128552,1471128680,128
1361049749,1471130324,4,1354,338.5,1361049743195,1361049743323,1471124519,1471124647,128
1361049749,1471130324,4,1205,301.25,1361049747291,1361049747419,1471128615,1471128743,128
1361049749,1471130324,5,878,175.6,1361049739291,1361049741659,1471120615,1471122983,2368
1361049749,1471130324,11,4647,422.4545455,1361049743323,1361049743771,1471124647,1471125095,448
1361049749,1471130324,6,1549,258.1666667,1361049743323,1361049743451,1471124647,1471124775,128
1361049749,1471130348,3,540,180,1361049743428,1361049743492,1471124776,1471124840,64
1361049749,1471130348,3,502,167.3333333,1361049743428,1361049743492,1471124776,1471124840,64
1361049749,1471130348,6,2728,454.6666667,1361049743492,1361049743876,1471124840,1471125224,384
1361049749,1471130348,5,1056,211.2,1361049743682,1361049743746,1471125030,1471125094,64
1361049749,1471130348,7,1771,253,1361049743618,1361049743746,1471124966,1471125094,128
1361049749,1471130348,4,651,162.75,1361049743682,1361049743746,1471125030,1471125094,64
1361049749,1471130348,5,913,182.6,1361049743746,1361049743810,1471125094,1471125158,64
1361049749,1471130348,4,1554,388.5,1361049743682,1361049743746,1471125030,1471125094,64
1361049749,1471130348,4,610,152.5,1361049743682,1361049743874,1471125030,1471125222,192
1361049749,1471130348,3,580,193.3333333,1361049743682,1361049743874,1471125030,1471125222,192
1361049749,1471130348,6,2360,393.3333333,1361049743745,1361049743873,1471125093,1471125221,128
1361049749,1471130352,6,1096,182.6666667,1361049743741,1361049743869,1471125093,1471125221,128
1361049749,1471130352,8,2246,280.75,1361049743809,1361049744001,1471125161,1471125353,192
1361049749,1471130352,5,1843,368.6,1361049743808,1361049744000,1471125160,1471125352,192
1361049749,1471130352,4,1354,338.5,1361049743872,1361049744000,1471125224,1471125352,128
1361049749,1471130352,7,3804,543.4285714,1361049743872,1361049746176,1471125224,1471127528,2304
1361049749,1471130352,3,634,211.3333333,1361049743872,1361049744000,1471125224,1471125352,128
1361049749,1471130352,5,680,136,1361049747775,1361049748415,1471129127,1471129767,640
1361049749,1471130352,6,1549,258.1666667,1361049743871,1361049743999,1471125223,1471125351,128
1361049749,1471130352,5,2828,565.6,1361049743871,1361049744191,1471125223,1471125543,320
1361049749,1471130352,3,642,214,1361049743935,1361049743999,1471125287,1471125351,64
1361049749,1471130352,4,1327,331.75,1361049744062,1361049744318,1471125414,1471125670,256
1361049749,1471130352,5,2725,545,1361049744125,1361049744637,1471125477,1471125989,512
1361049749,1471130356,3,623,207.6666667,1361049744189,1361049744253,1471125545,1471125609,64
1361049749,1471130356,3,540,180,1361049744252,1361049744252,1471125608,1471125608,0
1361049749,1471130356,3,502,167.3333333,1361049741436,1361049741500,1471122792,1471122856,64
1361049749,1471130356,5,2823,564.6,1361049741500,1361049741692,1471122856,1471123048,192
1361049749,1471130356,5,1497,299.4,1361049744252,1361049744316,1471125608,1471125672,64
1361049749,1471130360,3,634,211.3333333,1361049741881,1361049742009,1471123241,1471123369,128
1361049749,1471130360,6,2400,400,1361049744696,1361049744824,1471126056,1471126184,128
1361049749,1471130360,3,643,214.3333333,1361049744824,1361049744888,1471126184,1471126248,64
1361049749,1471130360,3,634,211.3333333,1361049744888,1361049744888,1471126248,1471126248,0
1361049749,1471130360,3,580,193.3333333,1361049741687,1361049741879,1471123047,1471123239,192
1361049749,1471130360,6,2774,462.3333333,1361049744951,1361049745463,1471126311,1471126823,512
1361049749,1471130360,27,33228,1230.666667,1361049745078,1361049745526,1471126438,1471126886,448
1361049749,1471130360,4,612,153,1361049740726,1361049741622,1471122086,1471122982,896
1361049749,1471130360,4,414,103.5,1361049741750,1361049742966,1471123110,1471124326,1216
1361049749,1471130364,6,3013,502.1666667,1361049745205,1361049745333,1471126569,1471126697,128
1361049749,1471130364,4,607,151.75,1361049745205,1361049745525,1471126569,1471126889,320
1361049749,1471130364,35,45706,1305.885714,1361049745077,1361049745525,1471126441,1471126889,448
1361049749,1471130364,8,5435,679.375,1361049742069,1361049742965,1471123433,1471124329,896
1361049749,1471130364,5,2725,545,1361049742133,1361049742517,1471123497,1471123881,384
1361049749,1471130364,3,642,214,1361049741940,1361049742004,1471123304,1471123368,64
1361049749,1471130364,3,608,202.6666667,1361049745203,1361049745203,1471126567,1471126567,0
1361049749,1471130364,3,580,193.3333333,1361049742323,1361049742515,1471123687,1471123879,192
1361049749,1471130364,3,834,278,1361049742386,1361049742450,1471123750,1471123814,64
1361049749,1471130364,4,1799,449.75,1361049745394,1361049745458,1471126758,1471126822,64
1361049749,1471130364,7,3453,493.2857143,1361049742450,1361049742706,1471123814,1471124070,256
1361049749,1471130364,6,2796,466,1361049745458,1361049745586,1471126822,1471126950,128
1361049749,1471130364,3,502,167.3333333,1361049745457,1361049745649,1471126821,1471127013,192
1361049749,1471130368,5,623,124.6,1361049742577,1361049742769,1471123945,1471124137,192
1361049749,1471130368,7,3456,493.7142857,1361049745457,1361049745649,1471126825,1471127017,192
1361049749,1471130368,6,993,165.5,1361049745521,1361049745649,1471126889,1471127017,128
1361049749,1471130368,5,998,199.6,1361049745521,1361049745649,1471126889,1471127017,128
1361049749,1471130368,5,1364,272.8,1361049745521,1361049745649,1471126889,1471127017,128
1361049749,1471130368,4,897,224.25,1361049745521,1361049745585,1471126889,1471126953,64
1361049749,1471130388,3,913,304.3333333,1361049742298,1361049742362,1471123686,1471123750,64
1361049749,1471130388,4,739,184.75,1361049745626,1361049745690,1471127014,1471127078,64
1361049749,1471130388,4,763,190.75,1361049745626,1361049745754,1471127014,1471127142,128
1361049749,1471130388,7,2738,391.1428571,1361049745690,1361049745882,1471127078,1471127270,192
1361049749,1471130388,5,1740,348,1361049745690,1361049745882,1471127078,1471127270,192
1361049749,1471130388,3,705,235,1361049745754,1361049745818,1471127142,1471127206,64
1361049749,1471130388,6,906,151,1361049745754,1361049745946,1471127142,1471127334,192
1361049749,1471130388,8,856,107,1361049745754,1361049745946,1471127142,1471127334,192
1361049749,1471130388,3,634,211.3333333,1361049742490,1361049742618,1471123878,1471124006,128
1361049749,1471130392,3,795,265,1361049745813,1361049745877,1471127205,1471127269,64
1361049749,1471130392,3,164,54.66666667,1361049745813,1361049745877,1471127205,1471127269,64
1361049749,1471130392,3,666,222,1361049745881,1361049746009,1471127273,1471127401,128
1361049749,1471130392,7,1998,285.4285714,1361049745881,1361049746329,1471127273,1471127721,448
1361049749,1471130392,4,1554,388.5,1361049745945,1361049746329,1471127337,1471127721,384
1361049749,1471130392,6,2020,336.6666667,1361049745945,1361049746073,1471127337,1471127465,128
1361049749,1471130392,4,477,119.25,1361049745945,1361049746329,1471127337,1471127721,384
1361049749,1471130392,5,1647,329.4,1361049745945,1361049746137,1471127337,1471127529,192
1361049749,1471130392,3,539,179.6666667,1361049746137,1361049746265,1471127529,1471127657,128
1361049749,1471130392,3,502,167.3333333,1361049745560,1361049745752,1471126952,1471127144,192
1361049749,1471130392,4,569,142.25,1361049745624,1361049745752,1471127016,1471127144,128
1361049749,1471130392,3,701,233.6666667,1361049745624,1361049745688,1471127016,1471127080,64
1361049749,1471130392,8,2874,359.25,1361049746264,1361049746776,1471127656,1471128168,512
1361049749,1471130392,3,735,245,1361049745688,1361049745816,1471127080,1471127208,128
1361049749,1471130392,5,950,190,1361049745752,1361049745816,1471127144,1471127208,64
1361049749,1471130392,4,439,109.75,1361049746264,1361049746392,1471127656,1471127784,128
1361049749,1471130392,4,543,135.75,1361049745752,1361049745816,1471127144,1471127208,64
1361049749,1471130392,4,548,137,1361049745752,1361049745944,1471127144,1471127336,192
1361049749,1471130392,6,1549,258.1666667,1361049746328,1361049746456,1471127720,1471127848,128
1361049749,1471130392,6,3805,634.1666667,1361049745816,1361049745880,1471127208,1471127272,64
1361049749,1471130392,5,1110,222,1361049746392,1361049747224,1471127784,1471128616,832
1361049749,1471130392,6,1097,182.8333333,1361049746456,1361049746584,1471127848,1471127976,128
1361049749,1471130392,5,913,182.6,1361049745879,1361049745943,1471127271,1471127335,64
1361049749,1471130392,6,702,117,1361049745943,1361049746327,1471127335,1471127719,384
1361049749,1471130392,5,1282,256.4,1361049746583,1361049747223,1471127975,1471128615,640
1361049749,1471130392,5,1553,310.6,1361049746071,1361049746327,1471127463,1471127719,256
1361049749,1471130392,8,5175,646.875,1361049746326,1361049747222,1471127718,1471128614,896
1361049749,1471130392,4,468,117,1361049746454,1361049747350,1471127846,1471128742,896
1361049749,1471130392,5,455,91,1361049746454,1361049746774,1471127846,1471128166,320
1361049749,1471130392,5,1840,368,1361049746454,1361049747286,1471127846,1471128678,832
1361049749,1471130392,6,871,145.1666667,1361049746454,1361049746582,1471127846,1471127974,128
1361049751,1471132212,1,89,89,1361049724681,1361049724681,1471105893,1471105893,0
1361049751,109445660,5,1340,268,1361049745427,1361049745491,109440087,109440151,64
1361049751,109445660,7,4950,707.1428571,1361049745491,1361049745555,109440151,109440215,64
1361049751,109445664,6,1476,246,1361049744015,1361049745359,109438679,109440023,1344
1361049751,109445664,9,3095,343.8888889,1361049743118,1361049743502,109437782,109438166,384
1361049751,109445664,5,1171,234.2,1361049745420,1361049745484,109440084,109440148,64
1361049751,109445664,4,699,174.75,1361049745616,1361049745680,109440280,109440344,64
1361049751,109445664,4,477,119.25,1361049745808,1361049746192,109440472,109440856,384
1361049751,109445668,5,1570,314,1361049743627,1361049743691,109438295,109438359,64
1361049751,109445668,7,1922,274.5714286,1361049746315,1361049747083,109440983,109441751,768
1361049751,109445668,4,464,116,1361049742794,1361049743114,109437462,109437782,320
1361049751,109445668,6,1390,231.6666667,1361049743689,1361049744009,109438357,109438677,320
1361049757,1471138260,7,3422,488.8571429,1361049750940,1361049751260,1471132200,1471132520,320
1361049757,1471138264,5,2620,524,1361049751449,1361049752345,1471132713,1471133609,896
1361049757,1471138264,3,580,193.3333333,1361049751576,1361049751704,1471132840,1471132968,128
1361049757,1471138264,3,880,293.3333333,1361049751576,1361049751640,1471132840,1471132904,64
1361049757,1471138264,7,3422,488.8571429,1361049751640,1361049751896,1471132904,1471133160,256
1361049757,1471138264,3,634,211.3333333,1361049755479,1361049755671,1471136743,1471136935,192
1361049757,1471138264,3,642,214,1361049751830,1361049751830,1471133094,1471133094,0
1361049757,1471138268,4,414,103.5,1361049752021,1361049752277,1471133289,1471133545,256
1361049757,1471138268,3,969,323,1361049752148,1361049752212,1471133416,1471133480,64
1361049757,1471138268,3,961,320.3333333,1361049752084,1361049752148,1471133352,1471133416,64
1361049757,1471138268,3,880,293.3333333,1361049752212,1361049752212,1471133480,1471133480,0
1361049757,1471138268,9,7284,809.3333333,1361049752211,1361049752531,1471133479,1471133799,320
1361049757,1471138268,3,634,211.3333333,1361049752275,1361049752467,1471133543,1471133735,192
1361049757,1471138268,7,3291,470.1428571,1361049752339,1361049752467,1471133607,1471133735,128
1361049757,1471138268,3,502,167.3333333,1361049752339,1361049752531,1471133607,1471133799,192
1361049757,1471138268,13,12326,948.1538462,1361049749778,1361049750290,1471131046,1471131558,512
1361049757,1471138268,3,633,211,1361049752466,1361049752466,1471133734,1471133734,0
1361049757,1471138272,3,969,323,1361049752593,1361049752657,1471133865,1471133929,64
1361049757,1471138272,6,591,98.5,1361049752657,1361049753105,1471133929,1471134377,448
1361049757,1471138272,3,880,293.3333333,1361049752657,1361049752721,1471133929,1471133993,64
1361049757,1471138272,3,608,202.6666667,1361049752657,1361049752721,1471133929,1471133993,64
1361049757,1471138272,3,603,201,1361049752721,1361049752785,1471133993,1471134057,64
1361049757,1471138272,5,667,133.4,1361049752911,1361049753039,1471134183,1471134311,128
1361049757,1471138272,4,915,228.75,1361049752911,1361049752975,1471134183,1471134247,64
1361049757,1471138272,32,40168,1255.25,1361049752911,1361049753039,1471134183,1471134311,128
1361049757,1471138272,4,409,102.25,1361049752911,1361049753039,1471134183,1471134311,128
1361049757,1471138272,3,657,219,1361049752911,1361049752975,1471134183,1471134247,64
1361049757,1471138272,4,757,189.25,1361049752975,1361049753039,1471134247,1471134311,64
1361049757,1471138272,4,543,135.75,1361049752975,1361049753103,1471134247,1471134375,128
1361049757,1471138272,3,808,269.3333333,1361049752974,1361049753102,1471134246,1471134374,128
1361049757,1471138272,3,540,180,1361049753102,1361049753166,1471134374,1471134438,64
1361049757,1471138272,4,1318,329.5,1361049753102,1361049753230,1471134374,1471134502,128
1361049757,1471138272,4,1428,357,1361049753102,1361049754638,1471134374,1471135910,1536
1361049757,1471138272,5,1508,301.6,1361049753102,1361049753230,1471134374,1471134502,128
1361049757,1471138272,5,2501,500.2,1361049753102,1361049754638,1471134374,1471135910,1536
1361049757,1471138296,8,6798,849.75,1361049753269,1361049754613,1471134565,1471135909,1344
1361049757,1471138296,6,1770,295,1361049753464,1361049754616,1471134760,1471135912,1152
1361049757,1471138296,14,13812,986.5714286,1361049753590,1361049753782,1471134886,1471135078,192
1361049757,1471138296,3,827,275.6666667,1361049750646,1361049750646,1471131942,1471131942,0
1361049757,1471138296,4,817,204.25,1361049753590,1361049754614,1471134886,1471135910,1024
1361049757,1471138300,22,11420,519.0909091,1361049750644,1361049752308,1471131944,1471133608,1664
1361049757,1471138300,3,961,320.3333333,1361049750708,1361049750708,1471132008,1471132008,0
1361049757,1471138300,6,2523,420.5,1361049754354,1361049754674,1471135654,1471135974,320
1361049757,1471138300,4,682,170.5,1361049754609,1361049754673,1471135909,1471135973,64
1361049757,1471138304,3,969,323,1361049750832,1361049750832,1471132136,1471132136,0
1361049757,1471138304,3,880,293.3333333,1361049750832,1361049750896,1471132136,1471132200,64
1361049757,1471138304,5,594,118.8,1361049751214,1361049751278,1471132518,1471132582,64
1361049757,1471138304,8,5548,693.5,1361049751213,1361049752301,1471132517,1471133605,1088
1361049757,1471138308,3,827,275.6666667,1361049751468,1361049751468,1471132776,1471132776,0
1361049757,1471138308,3,961,320.3333333,1361049751468,1361049751532,1471132776,1471132840,64
1361049757,1471138308,3,969,323,1361049751532,1361049751532,1471132840,1471132840,0
1361049757,1471138308,3,580,193.3333333,1361049755243,1361049755435,1471136551,1471136743,192
1361049757,1471138308,3,634,211.3333333,1361049751659,1361049751851,1471132967,1471133159,192
1361049757,1471138308,10,1359,135.9,1361049747435,1361049753003,1471128743,1471134311,5568
1361049757,1471138308,3,279,93,1361049755371,1361049755435,1471136679,1471136743,64
1361049757,1471138308,3,633,211,1361049751786,1361049751850,1471133094,1471133158,64
1361049757,1471138308,6,2771,461.8333333,1361049751914,1361049752298,1471133222,1471133606,384
1361049757,1471138308,5,594,118.8,1361049751850,1361049751914,1471133158,1471133222,64
1361049757,1471138312,3,580,193.3333333,1361049752101,1361049752229,1471133413,1471133541,128
1361049757,1471138312,3,642,214,1361049755557,1361049755621,1471136869,1471136933,64
1361049757,1471138312,5,1305,261,1361049747625,1361049752937,1471128937,1471134249,5312
1361049757,1471138312,3,827,275.6666667,1361049752041,1361049752041,1471133353,1471133353,0
1361049757,1471138312,3,633,211,1361049755624,1361049755688,1471136936,1471137000,64
1361049757,1471138312,6,2772,462,1361049755751,1361049756263,1471137063,1471137575,512
1361049757,1471138312,3,642,214,1361049752358,1361049752422,1471133670,1471133734,64
1361049757,1471138336,3,827,275.6666667,1361049752465,1361049752529,1471133801,1471133865,64
1361049757,1471138336,10,5471,547.1,1361049752401,1361049752913,1471133737,1471134249,512
1361049757,1471138336,3,961,320.3333333,1361049752529,1361049752529,1471133865,1471133865,0
1361049757,1471138336,7,3401,485.8571429,1361049752465,1361049752977,1471133801,1471134313,512
1361049757,1471138336,5,594,118.8,1361049752464,1361049752528,1471133800,1471133864,64
1361049757,1471138336,5,4215,843,1361049752528,1361049752592,1471133864,1471133928,64
1361049757,1471138336,7,3386,483.7142857,1361049752592,1361049752912,1471133928,1471134248,320
1361049757,1471138336,5,1152,230.4,1361049752592,1361049752656,1471133928,1471133992,64
1361049757,1471138336,7,3422,488.8571429,1361049752655,1361049752911,1471133991,1471134247,256
1361049757,1471138336,26,31950,1228.846154,1361049752719,1361049752911,1471134055,1471134247,192
1361049757,1471138336,5,1152,230.4,1361049752718,1361049752782,1471134054,1471134118,64
1361049757,1471138340,3,624,208,1361049752908,1361049752908,1471134248,1471134248,0
1361049757,1471138340,5,1740,348,1361049752908,1361049753036,1471134248,1471134376,128
1361049757,1471138340,7,1484,212,1361049752908,1361049753100,1471134248,1471134440,192
1361049757,1471138340,4,548,137,1361049752972,1361049753100,1471134312,1471134440,128
1361049757,1471138340,7,2898,414,1361049756172,1361049756364,1471137512,1471137704,192
1361049757,1471138340,5,594,118.8,1361049756235,1361049756491,1471137575,1471137831,256
1361049757,1471138340,5,594,118.8,1361049753035,1361049753099,1471134375,1471134439,64
1361049757,1471138340,10,10660,1066,1361049753035,1361049753227,1471134375,1471134567,192
1361049757,1471138340,4,463,115.75,1361049753035,1361049754571,1471134375,1471135911,1536
1361049757,1471138340,5,956,191.2,1361049753035,1361049753163,1471134375,1471134503,128
1361049757,1471138340,6,895,149.1666667,1361049753035,1361049753163,1471134375,1471134503,128
1361049757,1471138340,3,858,286,1361049753098,1361049753226,1471134438,1471134566,128
1361049757,1471138340,12,4233,352.75,1361049753098,1361049754570,1471134438,1471135910,1472
1361049757,1471138340,5,594,118.8,1361049753098,1361049753354,1471134438,1471134694,256
1361049757,1471138340,8,856,107,1361049753098,1361049753290,1471134438,1471134630,192
1361049757,1471138340,8,3797,474.625,1361049753162,1361049753418,1471134502,1471134758,256
1361049757,1471138340,5,1152,230.4,1361049753162,1361049754570,1471134502,1471135910,1408
1361049757,1471138340,8,3162,395.25,1361049753289,1361049754569,1471134629,1471135909,1280
1361049757,1471138344,5,1664,332.8,1361049753416,1361049754568,1471134760,1471135912,1152
1361049757,1471138344,5,2010,402,1361049753479,1361049753607,1471134823,1471134951,128
1361049757,1471138344,4,1205,301.25,1361049753670,1361049753734,1471135014,1471135078,64
1361049757,1471138344,4,611,152.75,1361049750598,1361049752198,1471131942,1471133542,1600
1361049757,1471138344,15,10792,719.4666667,1361049750597,1361049752197,1471131941,1471133541,1600
1361049757,1471138348,3,164,54.66666667,1361049745605,1361049749637,1471126953,1471130985,4032
1361049757,1471138348,6,2451,408.5,1361049754627,1361049754819,1471135975,1471136167,192
1361049759,1471140200,1,52,52,1361049731349,1361049731349,1471112549,1471112549,0
1361049759,1471140200,1,52,52,1361049731349,1361049731349,1471112549,1471112549,0
1361049759,1471140200,11,10939,994.4545455,1361049731352,1361049757912,1471112552,1471139112,26560
1361049759,1471140272,1,52,52,1361049734607,1361049734607,1471115879,1471115879,0
1361049759,1471140284,1,52,52,1361049731268,1361049731268,1471112552,1471112552,0
1361049759,1471140284,1,52,52,1361049731330,1361049731330,1471112614,1471112614,0
1361049759,1471140476,1,52,52,1361049734404,1361049734404,1471115880,1471115880,0
1361049759,109453652,7,4950,707.1428571,1361049752665,1361049752729,109447317,109447381,64
1361049759,109453652,4,699,174.75,1361049752857,1361049752985,109447509,109447637,128
1361049759,109453652,10,4386,438.6,1361049753113,1361049754393,109447765,109449045,1280
1361049759,109453652,4,525,131.25,1361049753624,1361049754392,109448276,109449044,768
1361049759,109453656,7,2584,369.1428571,1361049751252,1361049752084,109445908,109446740,832
1361049759,109453660,25,28500,1140,1361049753683,1361049754387,109448343,109449047,704
1361049759,109453660,11,10406,946,1361049750418,1361049752082,109445078,109446742,1664
1361049763,1471144424,4,1052,263,1361049738807,1361049739063,1471120231,1471120487,256
1361049763,1471144472,1,46,46,1361049737159,1361049737159,1471118631,1471118631,0
1361049763,1471144472,1,46,46,1361049737157,1361049737157,1471118629,1471118629,0
1361049763,1471144472,1,46,46,1361049737157,1361049737157,1471118629,1471118629,0
1361049763,1471144512,14,12544,896,1361049738720,1361049739040,1471120232,1471120552,320
1361049763,1471144552,1,46,46,1361049737078,1361049737078,1471118630,1471118630,0
1361049763,1471144556,1,46,46,1361049737332,1361049737332,1471118888,1471118888,0
1361049763,1471144592,1,52,52,1361049738253,1361049738253,1471119845,1471119845,0
1361049764,109458648,32,40717,1272.40625,1361049738525,1361049738781,109433173,109433429,256
1361049764,109458688,1,52,52,1361049738102,1361049738102,109432790,109432790,0
1361049765,1471146280,9,7559,839.8888889,1361049757829,1361049758469,1471139109,1471139749,640
1361049765,1471146280,10,5734,573.4,1361049757829,1361049758469,1471139109,1471139749,640
1361049765,1471146284,8,6531,816.375,1361049757825,1361049758465,1471139109,1471139749,640
1361049765,1471146288,5,455,91,1361049756481,1361049761409,1471137769,1471142697,4928
1361049765,1471146288,5,2130,426,1361049758463,1361049758527,1471139751,1471139815,64
1361049765,1471146316,88,117191,1331.715909,1361049757794,1361049758434,1471139110,1471139750,640
1361049765,1471146316,9,8485,942.7777778,1361049757793,1361049758433,1471139109,1471139749,640
1361049765,1471146348,9,4292,476.8888889,1361049756420,1361049761540,1471137768,1471142888,5120
1361049765,1471146348,2230,3175804,1424.127354,1361049753347,1361049759363,1471134695,1471140711,6016
1361049765,1471146348,7,5282,754.5714286,1361049758401,1361049758465,1471139749,1471139813,64
1361049765,1471146352,6,3858,643,1361049758399,1361049758399,1471139751,1471139751,0
1361049767,1471148360,259,364175,1406.081081,1361049460727,1361049462775,1470842087,1470844135,2048
1361049767,1471148408,3,524,174.6666667,1361049739080,1361049739144,1471120488,1471120552,64
1361049771,1471152556,1,46,46,1361049745140,1361049745140,1471126696,1471126696,0
1361049771,1471152560,1,46,46,1361049745389,1361049745389,1471126949,1471126949,0
1361049771,1471152580,1,46,46,1361049745883,1361049745883,1471127463,1471127463,0
1361049771,1471152580,1,46,46,1361049745947,1361049745947,1471127527,1471127527,0
1361049772,109466708,1,46,46,1361049745762,1361049745762,109440470,109440470,0
1361049772,109466732,36,46866,1301.833333,1361049747404,1361049747468,109442136,109442200,64
1361049773,1471154296,18,21405,1189.166667,1361049755253,1361049765301,1471136549,1471146597,10048
1361049775,1471156444,3,631,210.3333333,1361049748900,1361049748964,1471130344,1471130408,64
1361049775,1471156444,10,1764,176.4,1361049748900,1361049768676,1471130344,1471150120,19776
1361049775,1471156444,2,317,158.5,1361049748964,1361049748964,1471130408,1471130408,0
1361049775,1471156456,6,5071,845.1666667,1361049747478,1361049747478,1471128934,1471128934,0
1361049775,1471156532,3,469,156.3333333,1361049748811,1361049748875,1471130343,1471130407,64
1361049775,1471156536,4,1964,491,1361049749061,1361049749061,1471130597,1471130597,0
1361049775,1471156536,11,9857,896.0909091,1361049749063,1361049749063,1471130599,1471130599,0
1361049775,1471156564,13,9694,745.6923077,1361049747371,1361049747499,1471128935,1471129063,128
1361049779,1471160440,5,593,118.6,1361049752168,1361049773224,1471133608,1471154664,21056
1361049779,1471160480,1,46,46,1361049753281,1361049753281,1471134761,1471134761,0
1361049779,1471160516,4,2783,695.75,1361049754650,1361049754842,1471136166,1471136358,192
1361049779,1471160608,3,554,184.6666667,1361049754365,1361049754493,1471135973,1471136101,128
1361049780,109474756,1,52,52,1361049753523,1361049753523,109448279,109448279,0
1361049780,109474764,4,1322,330.5,1361049754921,1361049754921,109449685,109449685,0
1361049781,1471162304,9,6408,712,1361049776368,1361049780528,1471157672,1471161832,4160
1361049781,1471162308,5,593,118.6,1361049756204,1361049777324,1471137512,1471158632,21120
1361049781,1471162344,9,8042,893.5555556,1361049776325,1361049780485,1471157669,1471161829,4160
1361049781,1471162376,7,4664,666.2857143,1361049758375,1361049776295,1471139751,1471157671,17920
1361049783,1471164468,1,52,52,1361049757644,1361049757644,1471139112,1471139112,0
1361049783,1471164472,1,52,52,1361049757830,1361049757830,1471139302,1471139302,0
1361049783,1471164472,4,463,115.75,1361049756038,1361049780934,1471137510,1471162406,24896
1361049783,109477676,11,10406,946,1361049781122,1361049782018,109475798,109476694,896
1361049783,1471164540,3,540,180,1361049755012,1361049755012,1471136552,1471136552,0
1361049783,1471164540,8,5815,726.875,1361049755074,1361049755202,1471136614,1471136742,128
1361049783,1471164540,8,5813,726.625,1361049755010,1361049755138,1471136550,1471136678,128
1361049783,1471164560,2,104,52,1361049757552,1361049757552,1471139112,1471139112,0
1361049783,1471164596,4,1040,260,1361049758154,1361049768010,1471139750,1471149606,9856
1361049789,1471170296,5,2710,542,1361049783542,1361049783862,1471164838,1471165158,320
1361049789,1471170300,3,898,299.3333333,1361049781300,1361049781364,1471162600,1471162664,64
1361049789,1471170300,15,10792,719.4666667,1361049781300,1361049782196,1471162600,1471163496,896
1361049789,1471170300,3,580,193.3333333,1361049783923,1361049784115,1471165223,1471165415,192
1361049789,1471170300,3,1046,348.6666667,1361049781427,1361049781427,1471162727,1471162727,0
1361049789,1471170300,3,951,317,1361049783987,1361049784051,1471165287,1471165351,64
1361049789,1471170300,3,898,299.3333333,1361049783859,1361049783923,1471165159,1471165223,64
1361049789,1471170300,3,1046,348.6666667,1361049783923,1361049783923,1471165223,1471165223,0
1361049789,1471170300,3,1054,351.3333333,1361049781490,1361049781490,1471162790,1471162790,0
1361049789,1471170300,3,642,214,1361049784177,1361049784241,1471165477,1471165541,64
1361049789,1471170304,5,594,118.8,1361049784304,1361049784368,1471165608,1471165672,64
1361049789,1471170304,6,688,114.6666667,1361049787760,1361049788208,1471169064,1471169512,448
1361049789,1471170304,4,216,54,1361049784623,1361049785007,1471165927,1471166311,384
1361049789,1471170304,3,164,54.66666667,1361049784686,1361049785006,1471165990,1471166310,320
1361049789,1471170304,3,502,167.3333333,1361049781805,1361049781869,1471163109,1471163173,64
1361049789,1471170308,5,2501,500.2,1361049781868,1361049782252,1471163176,1471163560,384
1361049789,1471170308,6,1192,198.6666667,1361049785514,1361049785898,1471166822,1471167206,384
1361049789,1471170308,8,3135,391.875,1361049782058,1361049782250,1471163366,1471163558,192
1361049789,1471170332,9,3451,383.4444444,1361049782225,1361049783121,1471163557,1471164453,896
1361049789,1471170332,13,5268,405.2307692,1361049786065,1361049786705,1471167397,1471168037,640
1361049789,1471170332,3,968,322.6666667,1361049786065,1361049786129,1471167397,1471167461,64
1361049789,1471170336,7,3422,488.8571429,1361049786191,1361049786447,1471167527,1471167783,256
1361049789,1471170336,3,502,167.3333333,1361049786446,1361049786510,1471167782,1471167846,64
1361049789,1471170336,5,2501,500.2,1361049786510,1361049786702,1471167846,1471168038,192
1361049789,1471170336,5,960,192,1361049786702,1361049786766,1471168038,1471168102,64
1361049789,1471170340,1302,1849801,1420.738095,1361049783180,1361049786636,1471164520,1471167976,3456
1361049789,1471170340,4,649,162.25,1361049783243,1361049783819,1471164583,1471165159,576
1361049789,1471170340,6,2451,408.5,1361049783306,1361049783498,1471164646,1471164838,192
1361049789,1471170340,4,463,115.75,1361049781065,1361049781257,1471162405,1471162597,192
1361049789,1471170344,20,11371,568.55,1361049781192,1361049781320,1471162536,1471162664,128
1361049789,1471170344,7,6280,897.1428571,1361049781127,1361049781319,1471162471,1471162663,192
1361049789,1471170348,7,3422,488.8571429,1361049784004,1361049784260,1471165352,1471165608,256
1361049789,1471170348,3,1054,351.3333333,1361049783876,1361049783940,1471165224,1471165288,64
1361049789,1471170348,3,634,211.3333333,1361049784067,1361049784195,1471165415,1471165543,128
1361049789,1471170348,3,951,317,1361049781443,1361049781507,1471162791,1471162855,64
1361049789,1471170348,3,633,211,1361049784195,1361049784195,1471165543,1471165543,0
1361049789,1471170348,7,3422,488.8571429,1361049781506,1361049781762,1471162854,1471163110,256
1361049789,1471170348,6,2772,462,1361049784258,1361049784706,1471165606,1471166054,448
1361049789,1471170348,5,2501,500.2,1361049784257,1361049784641,1471165605,1471165989,384
1361049789,1471170364,5,995,199,1361049784498,1361049784626,1471165862,1471165990,128
1361049789,1471170368,7,2893,413.2857143,1361049784621,1361049784941,1471165989,1471166309,320
1361049789,1471170368,5,594,118.8,1361049784688,1361049784944,1471166056,1471166312,256
1361049789,1471170368,9,7778,864.2222222,1361049780526,1361049781038,1471161894,1471162406,512
1361049789,1471170368,9,8678,964.2222222,1361049785069,1361049785517,1471166437,1471166885,448
1361049789,1471170372,22,11523,523.7727273,1361049785514,1361049785834,1471166886,1471167206,320
1361049789,1471170376,6,2235,372.5,1361049785573,1361049785701,1471166949,1471167077,128
1361049789,1471170376,17,12640,743.5294118,1361049785576,1361049785832,1471166952,1471167208,256
1361049789,1471170376,8,2535,316.875,1361049785832,1361049786024,1471167208,1471167400,192
1361049789,1471170376,13,5352,411.6923077,1361049785832,1361049786664,1471167208,1471168040,832
1361049789,1471170376,3,840,280,1361049785959,1361049786023,1471167335,1471167399,64
1361049789,1471170376,6,2235,372.5,1361049785830,1361049785958,1471167206,1471167334,128
1361049789,1471170376,3,976,325.3333333,1361049786086,1361049786086,1471167462,1471167462,0
1361049789,1471170380,7,2833,404.7142857,1361049786081,1361049786657,1471167461,1471168037,576
1361049789,1471170380,3,893,297.6666667,1361049786084,1361049786148,1471167464,1471167528,64
1361049791,109485668,11,10406,946,1361049785417,1361049785673,109480085,109480341,256
1361049791,109485672,4,464,116,1361049783688,1361049784456,109478360,109479128,768
1361049791,109485672,6,2500,416.6666667,1361049782918,1361049783622,109477590,109478294,704
1361049791,109485676,6,3588,598,1361049786433,1361049786497,109481109,109481173,64
1361049795,1471176588,9,8901,989,1361049768276,1361049768340,1471149864,1471149928,64
1361049797,1471178292,3,960,320,1361049795705,1361049795769,1471176997,1471177061,64
1361049797,1471178292,3,968,322.6666667,1361049795769,1361049795769,1471177061,1471177061,0
1361049797,1471178296,3,580,193.3333333,1361049795768,1361049795896,1471177064,1471177192,128
1361049797,1471178296,3,881,293.6666667,1361049795768,1361049795832,1471177064,1471177128,64
1361049797,1471178296,3,634,211.3333333,1361049795896,1361049796088,1471177192,1471177384,192
1361049797,1471178296,3,642,214,1361049796022,1361049796022,1471177318,1471177318,0
1361049797,1471178300,5,983,196.6,1361049796275,1361049796403,1471177575,1471177703,128
1361049797,1471178300,9,8360,928.8888889,1361049792883,1361049793395,1471174183,1471174695,512
1361049797,1471178304,3,881,293.6666667,1361049793711,1361049793711,1471175015,1471175015,0
1361049797,1471178304,3,828,276,1361049793454,1361049793518,1471174758,1471174822,64
1361049797,1471178304,21,8302,395.3333333,1361049793454,1361049793646,1471174758,1471174950,192
1361049797,1471178304,7,3418,488.2857143,1361049793774,1361049794030,1471175078,1471175334,256
1361049797,1471178320,5,2502,500.4,1361049794079,1361049795231,1471175399,1471176551,1152
1361049797,1471178324,8,3123,390.375,1361049794266,1361049795226,1471175590,1471176550,960
1361049797,1471178328,4,651,162.75,1361049795221,1361049795285,1471176549,1471176613,64
1361049797,1471178332,6,2451,408.5,1361049795284,1361049795476,1471176616,1471176808,192
1361049797,1471178332,8,5231,653.875,1361049795474,1361049796370,1471176806,1471177702,896
1361049797,1471178332,3,828,276,1361049795601,1361049795665,1471176933,1471176997,64
1361049797,1471178336,7,3418,488.2857143,1361049795791,1361049796047,1471177127,1471177383,256
1361049797,1471178340,3,502,167.3333333,1361049796044,1361049796108,1471177384,1471177448,64
1361049797,1471178368,23,8414,365.826087,1361049793391,1361049793583,1471174759,1471174951,192
1361049797,1471178368,3,960,320,1361049793454,1361049793518,1471174822,1471174886,64
1361049797,1471178368,3,968,322.6666667,1361049793518,1361049793518,1471174886,1471174886,0
1361049797,1471178372,15,10792,719.4666667,1361049793515,1361049793579,1471174887,1471174951,64
1361049797,1471178372,3,502,167.3333333,1361049793960,1361049794024,1471175332,1471175396,64
1361049797,1471178376,16,7159,447.4375,1361049786727,1361049795175,1471168103,1471176551,8448
1361049799,109493664,4,464,116,1361049797965,1361049798349,109492629,109493013,384
1361049799,109493664,7,2684,383.4285714,1361049795021,1361049796173,109489685,109490837,1152
1361049799,109493668,10,8130,813,1361049787468,1361049796172,109482136,109490840,8704
1361049799,109493668,11,10406,946,1361049793354,1361049795018,109488022,109489686,1664
1361049799,109493668,4,1124,281,1361049797960,1361049797960,109492628,109492628,0
1361049803,1471184484,5,3296,659.2,1361049776188,1361049776252,1471157672,1471157736,64
1361049803,1471184484,6,1979,329.8333333,1361049776252,1361049776252,1471157736,1471157736,0
1361049803,1471184484,7,3935,562.1428571,1361049776187,1361049776251,1471157671,1471157735,64
1361049803,1471184484,6,1979,329.8333333,1361049776251,1361049776251,1471157735,1471157735,0
1361049803,1471184584,6,3108,518,1361049776085,1361049776149,1471157669,1471157733,64
1361049803,1471184584,5,3296,659.2,1361049776085,1361049776149,1471157669,1471157733,64
1361049805,1471186416,3,642,214,1361049799167,1361049799167,1471180583,1471180583,0
1361049805,1471186416,3,633,211,1361049799167,1361049799231,1471180583,1471180647,64
1361049805,1471186416,6,2772,462,1361049797116,1361049797564,1471178532,1471178980,448
1361049805,1471186420,5,1372,274.4,1361049797116,1361049797564,1471178536,1471178984,448
1361049805,1471186420,4,1579,394.75,1361049799483,1361049799867,1471180903,1471181287,384
1361049805,1471186420,5,1505,301,1361049803515,1361049803643,1471184935,1471185063,128
1361049805,1471186420,6,2008,334.6666667,1361049803515,1361049803643,1471184935,1471185063,128
1361049805,1471186420,4,386,96.5,1361049803515,1361049803579,1471184935,1471184999,64
1361049805,1471186420,4,1314,328.5,1361049803515,1361049803579,1471184935,1471184999,64
1361049805,1471186420,4,750,187.5,1361049803515,1361049803515,1471184935,1471184935,0
1361049805,1471186420,4,849,212.25,1361049803515,1361049803579,1471184935,1471184999,64
1361049805,1471186420,4,952,238,1361049803515,1361049803579,1471184935,1471184999,64
1361049805,1471186420,6,438,73,1361049803515,1361049803643,1471184935,1471185063,128
1361049805,1471186420,6,2008,334.6666667,1361049803515,1361049803643,1471184935,1471185063,128
1361049805,1471186420,3,785,261.6666667,1361049803515,1361049803643,1471184935,1471185063,128
1361049805,1471186420,4,439,109.75,1361049803515,1361049803579,1471184935,1471184999,64
1361049805,1471186420,3,486,162,1361049803515,1361049803579,1471184935,1471184999,64
1361049805,1471186420,5,956,191.2,1361049803515,1361049803643,1471184935,1471185063,128
1361049805,1471186420,4,543,135.75,1361049803515,1361049803643,1471184935,1471185063,128
1361049805,1471186420,4,1138,284.5,1361049803515,1361049803643,1471184935,1471185063,128
1361049805,1471186420,5,748,149.6,1361049803514,1361049803642,1471184934,1471185062,128
1361049805,1471186420,4,1318,329.5,1361049803514,1361049803642,1471184934,1471185062,128
1361049805,1471186420,6,4357,726.1666667,1361049803514,1361049803706,1471184934,1471185126,192
1361049805,1471186420,3,540,180,1361049803578,1361049803578,1471184998,1471184998,0
1361049805,1471186420,4,849,212.25,1361049803578,1361049803642,1471184998,1471185062,64
1361049805,1471186420,5,932,186.4,1361049803578,1361049803706,1471184998,1471185126,128
1361049805,1471186420,26,31958,1229.153846,1361049803641,1361049803705,1471185061,1471185125,64
1361049805,1471186424,6,2008,334.6666667,1361049803701,1361049803829,1471185125,1471185253,128
1361049805,1471186424,5,1664,332.8,1361049803700,1361049803764,1471185124,1471185188,64
1361049805,1471186424,4,645,161.25,1361049803700,1361049803956,1471185124,1471185380,256
1361049805,1471186424,5,544,108.8,1361049803700,1361049803764,1471185124,1471185188,64
1361049805,1471186424,3,542,180.6666667,1361049803700,1361049803764,1471185124,1471185188,64
1361049805,1471186424,6,2032,338.6666667,1361049803700,1361049803828,1471185124,1471185252,128
1361049805,1471186424,7,5171,738.7142857,1361049803704,1361049803768,1471185128,1471185192,64
1361049805,1471186424,4,672,168,1361049803704,1361049803768,1471185128,1471185192,64
1361049805,1471186424,7,2510,358.5714286,1361049799800,1361049800120,1471181224,1471181544,320
1361049805,1471186424,6,2032,338.6666667,1361049803704,1361049803832,1471185128,1471185256,128
1361049805,1471186424,4,657,164.25,1361049803704,1361049803832,1471185128,1471185256,128
1361049805,1471186424,7,892,127.4285714,1361049803768,1361049803896,1471185192,1471185320,128
1361049805,1471186424,6,2056,342.6666667,1361049803703,1361049803831,1471185127,1471185255,128
1361049805,1471186424,4,976,244,1361049803703,1361049803831,1471185127,1471185255,128
1361049805,1471186424,18,21405,1189.166667,1361049799990,1361049800054,1471181414,1471181478,64
1361049805,1471186424,5,824,164.8,1361049803894,1361049804214,1471185318,1471185638,320
1361049805,1471186424,4,645,161.25,1361049800117,1361049800245,1471181541,1471181669,128
1361049805,1471186428,3,679,226.3333333,1361049800308,1361049800500,1471181736,1471181928,192
1361049805,1471186428,6,4326,721,1361049800372,1361049800436,1471181800,1471181864,64
1361049805,1471186428,5,1851,370.2,1361049800372,1361049800436,1471181800,1471181864,64
1361049805,1471186428,7,3456,493.7142857,1361049800435,1361049800627,1471181863,1471182055,192
1361049805,1471186428,6,1445,240.8333333,1361049796275,1361049796915,1471177703,1471178343,640
1361049805,1471186432,4,921,230.25,1361049801136,1361049801200,1471182568,1471182632,64
1361049805,1471186432,3,960,320,1361049798000,1361049798064,1471179432,1471179496,64
1361049805,1471186432,4,790,197.5,1361049801136,1361049801264,1471182568,1471182696,128
1361049805,1471186432,7,2910,415.7142857,1361049798064,1361049798320,1471179496,1471179752,256
1361049805,1471186432,5,512,102.4,1361049798064,1361049798704,1471179496,1471180136,640
1361049805,1471186432,3,968,322.6666667,1361049798063,1361049798127,1471179495,1471179559,64
1361049805,1471186432,4,759,189.75,1361049801199,1361049801263,1471182631,1471182695,64
1361049805,1471186432,4,785,196.25,1361049801071,1361049801135,1471182503,1471182567,64
1361049805,1471186432,5,765,153,1361049801135,1361049801199,1471182567,1471182631,64
1361049805,1471186452,6,999,166.5,1361049801115,1361049801243,1471182567,1471182695,128
1361049805,1471186452,3,502,167.3333333,1361049798043,1361049798235,1471179495,1471179687,192
1361049805,1471186452,8,3499,437.375,1361049798106,1361049798426,1471179558,1471179878,320
1361049805,1471186456,9,4333,481.4444444,1361049798424,1361049803736,1471179880,1471185192,5312
1361049805,1471186456,2,104,52,1361049798742,1361049798742,1471180198,1471180198,0
1361049805,1471186456,3,580,193.3333333,1361049798806,1361049798934,1471180262,1471180390,128
1361049805,1471186456,4,592,148,1361049798741,1361049799701,1471180197,1471181157,960
1361049805,1471186456,12,5993,499.4166667,1361049798741,1361049799765,1471180197,1471181221,1024
1361049805,1471186456,5,544,108.8,1361049802133,1361049802197,1471183589,1471183653,64
1361049805,1471186456,4,816,204,1361049802133,1361049802197,1471183589,1471183653,64
1361049805,1471186456,4,769,192.25,1361049802133,1361049802197,1471183589,1471183653,64
1361049805,1471186456,3,729,243,1361049802196,1361049802324,1471183652,1471183780,128
1361049805,1471186460,4,718,179.5,1361049802452,1361049802516,1471183912,1471183976,64
1361049805,1471186460,4,1879,469.75,1361049802643,1361049802771,1471184103,1471184231,128
1361049805,1471186460,4,815,203.75,1361049802643,1361049802707,1471184103,1471184167,64
1361049805,1471186460,7,3415,487.8571429,1361049802451,1361049802643,1471183911,1471184103,192
1361049805,1471186460,5,964,192.8,1361049802707,1361049802771,1471184167,1471184231,64
1361049805,1471186460,6,2021,336.8333333,1361049802451,1361049802579,1471183911,1471184039,128
1361049805,1471186460,4,762,190.5,1361049802579,1361049802643,1471184039,1471184103,64
1361049805,1471186460,6,3805,634.1666667,1361049802579,1361049802643,1471184039,1471184103,64
1361049805,1471186460,3,539,179.6666667,1361049802579,1361049802707,1471184039,1471184167,128
1361049805,1471186460,4,731,182.75,1361049802706,1361049802770,1471184166,1471184230,64
1361049805,1471186460,5,331,66.2,1361049802706,1361049802898,1471184166,1471184358,192
1361049805,1471186460,3,634,211.3333333,1361049798929,1361049799121,1471180389,1471180581,192
1361049805,1471186464,7,2818,402.5714286,1361049799246,1361049799758,1471180710,1471181222,512
1361049805,1471186464,4,1584,396,1361049799246,1361049799438,1471180710,1471180902,192
1361049805,1471186464,3,828,276,1361049797005,1361049797069,1471178469,1471178533,64
1361049805,1471186468,5,822,164.4,1361049803467,1361049803531,1471184935,1471184999,64
1361049805,1471186468,4,700,175,1361049803467,1361049803531,1471184935,1471184999,64
1361049805,1471186468,4,673,168.25,1361049803467,1361049803531,1471184935,1471184999,64
1361049805,1471186468,4,652,163,1361049803467,1361049803531,1471184935,1471184999,64
1361049805,1471186468,3,624,208,1361049803467,1361049803467,1471184935,1471184935,0
1361049805,1471186468,6,2008,334.6666667,1361049803467,1361049803595,1471184935,1471185063,128
1361049805,1471186468,5,1503,300.6,1361049803467,1361049803595,1471184935,1471185063,128
1361049805,1471186468,6,2326,387.6666667,1361049803467,1361049803595,1471184935,1471185063,128
1361049805,1471186468,6,895,149.1666667,1361049803467,1361049803595,1471184935,1471185063,128
1361049805,1471186468,7,1565,223.5714286,1361049803467,1361049803659,1471184935,1471185127,192
1361049805,1471186468,3,703,234.3333333,1361049803467,1361049803595,1471184935,1471185063,128
1361049805,1471186468,4,869,217.25,1361049803466,1361049803594,1471184934,1471185062,128
1361049805,1471186468,5,765,153,1361049803466,1361049803594,1471184934,1471185062,128
1361049805,1471186468,7,804,114.8571429,1361049803466,1361049803786,1471184934,1471185254,320
1361049805,1471186468,3,808,269.3333333,1361049803466,1361049803594,1471184934,1471185062,128
1361049805,1471186468,5,969,193.8,1361049803466,1361049803594,1471184934,1471185062,128
1361049805,1471186468,5,1171,234.2,1361049803466,1361049803658,1471184934,1471185126,192
1361049805,1471186468,13,10852,834.7692308,1361049799626,1361049799882,1471181094,1471181350,256
1361049805,1471186468,3,858,286,1361049803530,1361049803658,1471184998,1471185126,128
1361049805,1471186468,4,548,137,1361049803530,1361049803658,1471184998,1471185126,128
1361049805,1471186468,6,2008,334.6666667,1361049803530,1361049803658,1471184998,1471185126,128
1361049805,1471186468,4,618,154.5,1361049803529,1361049803657,1471184997,1471185125,128
1361049805,1471186468,6,2032,338.6666667,1361049803656,1361049803784,1471185124,1471185252,128
1361049805,1471186472,7,5123,731.8571429,1361049803656,1361049803720,1471185128,1471185192,64
1361049805,1471186472,8,2795,349.375,1361049799880,1361049800200,1471181352,1471181672,320
1361049805,1471186472,4,725,181.25,1361049803656,1361049803720,1471185128,1471185192,64
1361049805,1471186472,5,594,118.8,1361049799752,1361049800072,1471181224,1471181544,320
1361049805,1471186472,4,1239,309.75,1361049803719,1361049803783,1471185191,1471185255,64
1361049805,1471186472,4,602,150.5,1361049803719,1361049803783,1471185191,1471185255,64
1361049805,1471186472,5,455,91,1361049803783,1361049804103,1471185255,1471185575,320
1361049805,1471186472,3,279,93,1361049800071,1361049800199,1471181543,1471181671,128
1361049805,1471186472,11,8039,730.8181818,1361049800070,1361049800198,1471181542,1471181670,128
1361049805,1471186472,3,633,211,1361049795846,1361049796870,1471177318,1471178342,1024
1361049805,1471186472,3,621,207,1361049800134,1361049800262,1471181606,1471181734,128
1361049805,1471186472,5,3071,614.2,1361049800198,1361049800326,1471181670,1471181798,128
1361049805,1471186492,3,608,202.6666667,1361049800178,1361049800178,1471181670,1471181670,0
1361049805,1471186492,4,607,151.75,1361049800179,1361049800307,1471181671,1471181799,128
1361049805,1471186492,4,897,224.25,1361049800434,1361049800498,1471181926,1471181990,64
1361049805,1471186492,4,1087,271.75,1361049800434,1361049800498,1471181926,1471181990,64
1361049805,1471186492,4,1081,270.25,1361049800433,1361049800561,1471181925,1471182053,128
1361049805,1471186496,5,551,110.2,1361049804144,1361049804272,1471185640,1471185768,128
1361049805,1471186496,8,2979,372.375,1361049797997,1361049798125,1471179493,1471179621,128
1361049805,1471186496,2234,3180911,1423.863474,1361049788141,1361049796973,1471169637,1471178469,8832
1361049805,1471186500,3,687,229,1361049801004,1361049801068,1471182504,1471182568,64
1361049805,1471186500,4,769,192.25,1361049801068,1361049801132,1471182568,1471182632,64
1361049805,1471186500,7,2102,300.2857143,1361049801068,1361049801196,1471182568,1471182696,128
1361049805,1471186500,5,730,146,1361049801068,1361049801132,1471182568,1471182632,64
1361049805,1471186500,3,881,293.6666667,1361049798060,1361049798060,1471179560,1471179560,0
1361049805,1471186500,5,998,199.6,1361049801068,1361049801132,1471182568,1471182632,64
1361049805,1471186500,3,674,224.6666667,1361049801068,1361049801132,1471182568,1471182632,64
1361049805,1471186500,4,732,183,1361049801068,1361049801132,1471182568,1471182632,64
1361049805,1471186500,4,571,142.75,1361049801068,1361049801260,1471182568,1471182760,192
1361049805,1471186500,3,711,237,1361049801068,1361049801196,1471182568,1471182696,128
1361049805,1471186500,4,1225,306.25,1361049801131,1361049801259,1471182631,1471182759,128
1361049805,1471186500,5,2153,430.6,1361049801195,1361049801387,1471182695,1471182887,192
1361049805,1471186500,11,1282,116.5454545,1361049796650,1361049796842,1471178150,1471178342,192
1361049805,1471186504,5,455,91,1361049798312,1361049798824,1471179816,1471180328,512
1361049805,1471186504,5,594,118.8,1361049798376,1361049798440,1471179880,1471179944,64
1361049805,1471186504,5,2828,565.6,1361049798376,1361049798568,1471179880,1471180072,192
1361049805,1471186504,2,104,52,1361049798695,1361049798695,1471180199,1471180199,0
1361049805,1471186504,4,753,188.25,1361049802085,1361049802149,1471183589,1471183653,64
1361049805,1471186504,3,721,240.3333333,1361049802085,1361049802149,1471183589,1471183653,64
1361049805,1471186504,3,687,229,1361049802085,1361049802149,1471183589,1471183653,64
1361049805,1471186504,7,2954,422,1361049802085,1361049802405,1471183589,1471183909,320
1361049805,1471186504,3,502,167.3333333,1361049802149,1361049802277,1471183653,1471183781,128
1361049805,1471186508,3,608,202.6666667,1361049802400,1361049802400,1471183908,1471183908,0
1361049805,1471186508,8,4714,589.25,1361049802404,1361049802532,1471183912,1471184040,128
1361049805,1471186508,4,1594,398.5,1361049802532,1361049802596,1471184040,1471184104,64
1361049805,1471186508,5,967,193.4,1361049802660,1361049802724,1471184168,1471184232,64
1361049805,1471186508,4,955,238.75,1361049802659,1361049802723,1471184167,1471184231,64
1361049807,1471188484,4,477,119.25,1361049802683,1361049803067,1471184167,1471184551,384
1361049807,1471188484,4,826,206.5,1361049802683,1361049802811,1471184167,1471184295,128
1361049807,109501656,4,525,131.25,1361049800152,1361049800408,109494808,109495064,256
1361049807,109501656,4,805,201.25,1361049801047,1361049801047,109495703,109495703,0
1361049807,109501656,4,1057,264.25,1361049799637,1361049799701,109494293,109494357,64
1361049807,109501656,8,2063,257.875,1361049802389,1361049802581,109497045,109497237,192
1361049807,109501656,7,4950,707.1428571,1361049803093,1361049803093,109497749,109497749,0
1361049807,109501660,4,699,174.75,1361049803412,1361049803540,109498072,109498200,128
1361049807,109501660,4,815,203.75,1361049800147,1361049800147,109494807,109494807,0
1361049807,109501660,6,1704,284,1361049801042,1361049801106,109495702,109495766,64
1361049807,109501660,4,525,131.25,1361049801042,1361049801106,109495702,109495766,64
1361049807,109501660,5,516,103.2,1361049801106,1361049801106,109495766,109495766,0
1361049807,109501660,5,1424,284.8,1361049798676,1361049799700,109493336,109494360,1024
1361049807,109501664,4,1187,296.75,1361049799951,1361049800143,109494615,109494807,192
1361049807,109501664,19,22092,1162.736842,1361049803087,1361049803151,109497751,109497815,64
1361049807,1471188528,1,46,46,1361049781647,1361049781647,1471163175,1471163175,0
1361049807,1471188616,1,46,46,1361049780215,1361049780215,1471161831,1471161831,0
1361049808,109502900,1,52,52,1361049782688,1361049782688,109477588,109477588,0
1361049811,1471192488,1,46,46,1361049784821,1361049784821,1471166309,1471166309,0
1361049811,1471192572,1,60,60,1361049784737,1361049784737,1471166309,1471166309,0
1361049812,109506888,1,60,60,1361049787245,1361049787245,109482133,109482133,0
1361049813,1471194304,4,662,165.5,1361049803948,1361049804972,1471185252,1471186276,1024
1361049813,1471194308,4,645,161.25,1361049804008,1361049809064,1471185316,1471190372,5056
1361049813,1471194344,2,141,70.5,1361049807365,1361049812357,1471188709,1471193701,4992
1361049813,1471194376,5,1981,396.2,1361049803876,1361049809956,1471185252,1471191332,6080
1361049815,1471196480,1,46,46,1361049787453,1361049787453,1471168933,1471168933,0
1361049821,1471202340,3,156,52,1361049814540,1361049815244,1471195880,1471196584,704
1361049823,1471204564,1,52,52,1361049798635,1361049798635,1471180199,1471180199,0
1361049823,1471204644,1,46,46,1361049798554,1361049798554,1471180198,1471180198,0
1361049827,1471208572,5,593,118.6,1361049799649,1361049820833,1471181221,1471202405,21184
1361049828,109522872,1,52,52,1361049801085,1361049801085,109495957,109495957,0
1361049829,1471210320,4,761,190.25,1361049825311,1361049825375,1471206631,1471206695,64
1361049829,1471210320,4,780,195,1361049825502,1361049825566,1471206822,1471206886,64
1361049829,1471210336,4,756,189,1361049825676,1361049825740,1471207012,1471207076,64
1361049829,1471210384,4,742,185.5,1361049825820,1361049825884,1471207204,1471207268,64
1361049829,1471210388,4,747,186.75,1361049826330,1361049826394,1471207718,1471207782,64
1361049829,1471210388,4,754,188.5,1361049826713,1361049826777,1471208101,1471208165,64
1361049831,1471212500,2,529,264.5,1361049803753,1361049803817,1471185253,1471185317,64
1361049831,1471212524,4,968,242,1361049805522,1361049830674,1471187046,1471212198,25152
1361049831,1471212528,3,571,190.3333333,1361049804047,1361049804111,1471185575,1471185639,64
1361049831,1471212528,3,215,71.66666667,1361049804047,1361049804111,1471185575,1471185639,64
1361049831,1471212528,5,3589,717.8,1361049804047,1361049804111,1471185575,1471185639,64
1361049831,1471212528,10,5319,531.9,1361049804236,1361049829452,1471185764,1471210980,25216
1361049831,1471212604,1,52,52,1361049803522,1361049803522,1471185126,1471185126,0
1361049831,1471212608,9,4053,450.3333333,1361049803708,1361049803964,1471185316,1471185572,256
1361049831,1471212620,2,555,277.5,1361049804145,1361049804145,1471185765,1471185765,0
1361049835,1471216504,1,52,52,1361049808229,1361049808229,1471189733,1471189733,0
1361049835,1471216528,1,52,52,1361049808528,1361049808528,1471190056,1471190056,0
1361049835,1471216532,4,628,157,1361049808521,1361049808585,1471190053,1471190117,64
1361049835,1471216616,1,52,52,1361049808118,1361049808118,1471189734,1471189734,0
1361049837,1471218300,9,8144,904.8888889,1361049828913,1361049829361,1471210213,1471210661,448
1361049837,1471218316,15,16570,1104.666667,1361049828448,1361049828896,1471209764,1471210212,448
1361049837,1471218320,10,10122,1012.2,1361049828832,1361049828896,1471210152,1471210216,64
1361049837,1471218336,10,9670,967,1361049828876,1361049829324,1471210212,1471210660,448
1361049837,1471218340,4,399,99.75,1361049829129,1361049829321,1471210469,1471210661,192
1361049837,1471218344,4,356,89,1361049829318,1361049829318,1471210662,1471210662,0
1361049837,1471218376,11,10878,988.9090909,1361049828836,1361049829028,1471210212,1471210404,192
1361049837,1471218380,10,9192,919.2,1361049828835,1361049829027,1471210215,1471210407,192
1361049845,1471226316,8,1570,196.25,1361049844448,1361049844832,1471225764,1471226148,384
1361049845,1471226320,4,803,200.75,1361049841502,1361049841694,1471222822,1471223014,192
1361049845,1471226320,4,592,148,1361049844446,1361049844830,1471225766,1471226150,384
1361049845,1471226324,3,608,202.6666667,1361049844764,1361049844828,1471226088,1471226152,64
1361049845,1471226344,4,1336,334,1361049842052,1361049842180,1471223396,1471223524,128
1361049845,1471226356,4,574,143.5,1361049843770,1361049844794,1471225126,1471226150,1024
1361049845,1471226360,21,23106,1100.285714,1361049843831,1361049844855,1471225191,1471226215,1024
1361049845,1471226364,4,377,94.25,1361049844403,1361049844787,1471225767,1471226151,384
1361049845,1471226384,7,3552,507.4285714,1361049844702,1361049844830,1471226086,1471226214,128
1361049845,1471226384,10,11122,1112.2,1361049841628,1361049841820,1471223012,1471223204,192
1361049845,1471226388,53,66417,1253.150943,1361049841752,1361049844760,1471223140,1471226148,3008
1361049847,109541668,4,1248,312,1361049844747,1361049845131,109539415,109539799,384
1361049847,109541668,4,1372,343,1361049844747,1361049845195,109539415,109539863,448
1361049847,109541668,4,1125,281.25,1361049845131,1361049845259,109539799,109539927,128
1361049847,109541668,4,807,201.75,1361049845387,1361049845387,109540055,109540055,0
1361049847,109541668,4,525,131.25,1361049845450,1361049845450,109540118,109540118,0
1361049847,109541668,27,34013,1259.740741,1361049845514,1361049845642,109540182,109540310,128
1361049847,109541668,4,924,231,1361049845578,1361049845642,109540246,109540310,64
1361049847,109541668,8,6148,768.5,1361049845514,1361049845642,109540182,109540310,128
1361049847,109541672,4,1373,343.25,1361049844742,1361049845190,109539414,109539862,448
1361049847,109541672,4,1124,281,1361049844742,1361049844998,109539414,109539670,256
1361049847,109541672,5,1221,244.2,1361049845509,1361049845637,109540181,109540309,128
1361049847,109541672,5,1207,241.4,1361049845509,1361049845637,109540181,109540309,128
1361049847,109541672,6,1468,244.6666667,1361049845509,1361049845637,109540181,109540309,128
1361049853,1471234300,21,24628,1172.761905,1361049845041,1361049845105,1471226341,1471226405,64
1361049853,1471234308,4,653,163.25,1361049845291,1361049845419,1471226599,1471226727,128
1361049853,1471234308,6,2806,467.6666667,1361049845417,1361049845545,1471226725,1471226853,128
1361049853,1471234308,8,5254,656.75,1361049845417,1361049845481,1471226725,1471226789,64
1361049853,1471234308,48,62888,1310.166667,1361049845417,1361049845481,1471226725,1471226789,64
1361049853,1471234308,48,62888,1310.166667,1361049845417,1361049845481,1471226725,1471226789,64
1361049853,1471234308,8,7278,909.75,1361049845480,1361049845544,1471226788,1471226852,64
1361049853,1471234312,4,694,173.5,1361049845543,1361049845607,1471226855,1471226919,64
1361049853,1471234312,7,3226,460.8571429,1361049845542,1361049845734,1471226854,1471227046,192
1361049853,1471234312,6,3832,638.6666667,1361049845606,1361049845670,1471226918,1471226982,64
1361049853,1471234312,85,116499,1370.576471,1361049845606,1361049845734,1471226918,1471227046,128
1361049853,1471234312,7,1945,277.8571429,1361049845606,1361049845734,1471226918,1471227046,128
1361049853,1471234312,7,1945,277.8571429,1361049845606,1361049845734,1471226918,1471227046,128
1361049853,1471234312,85,116499,1370.576471,1361049845669,1361049845861,1471226981,1471227173,192
1361049853,1471234316,8,6479,809.875,1361049845858,1361049846946,1471227174,1471228262,1088
1361049853,1471234316,4,1057,264.25,1361049844833,1361049845025,1471226149,1471226341,192
1361049853,1471234316,40,49144,1228.6,1361049844896,1361049845024,1471226212,1471226340,128
1361049853,1471234320,19,16137,849.3157895,1361049841887,1361049847391,1471223207,1471228711,5504
1361049853,1471234320,12,9696,808,1361049841887,1361049846303,1471223207,1471227623,4416
1361049853,1471234344,28,20842,744.3571429,1361049842054,1361049846854,1471223398,1471228198,4800
1361049853,1471234344,17,11625,683.8235294,1361049842244,1361049846468,1471223588,1471227812,4224
1361049853,1471234352,6,3166,527.6666667,1361049844923,1361049845243,1471226275,1471226595,320
1361049853,1471234352,27,29770,1102.592593,1361049844991,1361049845375,1471226343,1471226727,384
1361049853,1471234352,5,2509,501.8,1361049843388,1361049848572,1471224740,1471229924,5184
1361049853,1471234356,4,1261,315.25,1361049845369,1361049845369,1471226725,1471226725,0
1361049853,1471234356,69,89617,1298.797101,1361049845369,1361049845561,1471226725,1471226917,192
1361049853,1471234356,4,654,163.5,1361049845369,1361049845561,1471226725,1471226917,192
1361049853,1471234356,48,62888,1310.166667,1361049845305,1361049845433,1471226661,1471226789,128
1361049853,1471234356,9,8375,930.5555556,1361049845368,1361049845496,1471226724,1471226852,128
1361049853,1471234360,6,3832,638.6666667,1361049845495,1361049845559,1471226855,1471226919,64
1361049853,1471234360,7,1945,277.8571429,1361049845558,1361049845686,1471226918,1471227046,128
1361049853,1471234360,43,55702,1295.395349,1361049845557,1361049845685,1471226917,1471227045,128
1361049853,1471234360,15,16419,1094.6,1361049845557,1361049845685,1471226917,1471227045,128
1361049853,1471234360,170,238186,1401.094118,1361049845557,1361049845877,1471226917,1471227237,320
1361049853,1471234380,37,46509,1257,1361049845601,1361049845729,1471226981,1471227109,128
1361049853,1471234380,8,6485,810.625,1361049845792,1361049845920,1471227172,1471227300,128
1361049853,1471234380,9,7411,823.4444444,1361049845728,1361049845920,1471227108,1471227300,192
1361049853,1471234388,4,951,237.75,1361049844763,1361049844891,1471226151,1471226279,128
1361049853,1471234388,4,1067,266.75,1361049844763,1361049844955,1471226151,1471226343,192
1361049853,1471234388,10,8152,815.2,1361049841819,1361049846235,1471223207,1471227623,4416
1361049853,1471234388,12,9858,821.5,1361049841819,1361049846235,1471223207,1471227623,4416
1361049853,1471234388,25,29764,1190.56,1361049841819,1361049846235,1471223207,1471227623,4416
1361049853,1471234388,22,22393,1017.863636,1361049841818,1361049846234,1471223206,1471227622,4416
1361049853,1471234388,33,31225,946.2121212,1361049842009,1361049846809,1471223397,1471228197,4800
1361049853,1471234388,19,13409,705.7368421,1361049842200,1361049846424,1471223588,1471227812,4224
1361049853,1471234388,16,8838,552.375,1361049842200,1361049846424,1471223588,1471227812,4224
1361049853,1471234392,16,12009,750.5625,1361049842263,1361049846423,1471223655,1471227815,4160
1361049855,109549664,4,1124,281,1361049853454,1361049853902,109548118,109548566,448
1361049855,1471236568,1,52,52,1361049828645,1361049828645,1471210213,1471210213,0
1361049855,1471236616,1,52,52,1361049828149,1361049828149,1471209765,1471209765,0
1361049855,1471236620,1,52,52,1361049828144,1361049828144,1471209764,1471209764,0
1361049855,1471236624,1,52,52,1361049828524,1361049828524,1471210148,1471210148,0
1361049861,1471242320,5,2017,403.4,1361049859356,1361049860764,1471240676,1471242084,1408
1361049861,1471242328,7,1520,217.1428571,1361049853271,1361049853591,1471234599,1471234919,320
1361049861,1471242328,4,2687,671.75,1361049859926,1361049860118,1471241254,1471241446,192
1361049861,1471242328,7,2892,413.1428571,1361049860117,1361049860437,1471241445,1471241765,320
1361049861,1471242332,14,15288,1092,1361049853459,1361049853523,1471234791,1471234855,64
1361049861,1471242332,24,26682,1111.75,1361049853459,1361049854099,1471234791,1471235431,640
1361049861,1471242332,13,13355,1027.307692,1361049853523,1361049853587,1471234855,1471234919,64
1361049861,1471242332,24,28197,1174.875,1361049853459,1361049853587,1471234791,1471234919,128
1361049861,1471242332,9,1618,179.7777778,1361049856786,1361049857170,1471238118,1471238502,384
1361049861,1471242332,41,52251,1274.414634,1361049853649,1361049853713,1471234981,1471235045,64
1361049861,1471242332,4,592,148,1361049856657,1361049856721,1471237989,1471238053,64
1361049861,1471242332,55,72876,1325.018182,1361049853585,1361049853713,1471234917,1471235045,128
1361049861,1471242332,25,30276,1211.04,1361049853585,1361049853649,1471234917,1471234981,64
1361049861,1471242332,16,15388,961.75,1361049856785,1361049857169,1471238117,1471238501,384
1361049861,1471242332,68,87550,1287.5,1361049853585,1361049853777,1471234917,1471235109,192
1361049861,1471242332,7,3857,551,1361049860753,1361049860817,1471242085,1471242149,64
1361049861,1471242332,5,455,91,1361049860496,1361049860624,1471241828,1471241956,128
1361049861,1471242332,5,899,179.8,1361049860752,1361049860880,1471242084,1471242212,128
1361049861,1471242332,5,2061,412.2,1361049857104,1361049857168,1471238436,1471238500,64
1361049861,1471242332,10,7405,740.5,1361049860560,1361049860816,1471241892,1471242148,256
1361049861,1471242332,3,608,202.6666667,1361049856912,1361049856976,1471238244,1471238308,64
1361049861,1471242332,6,965,160.8333333,1361049860816,1361049860880,1471242148,1471242212,64
1361049861,1471242332,10,10661,1066.1,1361049857040,1361049857104,1471238372,1471238436,64
1361049861,1471242336,10,4722,472.2,1361049857231,1361049857999,1471238567,1471239335,768
1361049861,1471242336,15,12227,815.1333333,1361049852687,1361049853455,1471234023,1471234791,768
1361049861,1471242336,5,2061,412.2,1361049857678,1361049857806,1471239014,1471239142,128
1361049861,1471242336,5,1940,388,1361049857741,1361049857805,1471239077,1471239141,64
1361049861,1471242336,5,1470,294,1361049857740,1361049858124,1471239076,1471239460,384
1361049861,1471242336,5,2061,412.2,1361049857740,1361049857804,1471239076,1471239140,64
1361049861,1471242336,4,661,165.25,1361049857740,1361049858124,1471239076,1471239460,384
1361049861,1471242364,5,480,96,1361049858163,1361049858291,1471239527,1471239655,128
1361049861,1471242364,4,578,144.5,1361049858482,1361049858482,1471239846,1471239846,0
1361049861,1471242364,4,1205,301.25,1361049858162,1361049858226,1471239526,1471239590,64
1361049861,1471242364,7,1562,223.1428571,1361049858290,1361049860850,1471239654,1471242214,2560
1361049861,1471242368,14,12760,911.4285714,1361049859246,1361049860718,1471240614,1471242086,1472
1361049861,1471242368,13,13078,1006,1361049859246,1361049860718,1471240614,1471242086,1472
1361049861,1471242368,5,2036,407.2,1361049859500,1361049860716,1471240868,1471242084,1216
1361049861,1471242376,17,19531,1148.882353,1361049853415,1361049853479,1471234791,1471234855,64
1361049861,1471242376,12,12613,1051.083333,1361049853415,1361049853479,1471234791,1471234855,64
1361049861,1471242376,11,11070,1006.363636,1361049853415,1361049853479,1471234791,1471234855,64
1361049861,1471242376,5,623,124.6,1361049860071,1361049860135,1471241447,1471241511,64
1361049861,1471242376,48,62890,1310.208333,1361049853414,1361049853542,1471234790,1471234918,128
1361049861,1471242376,19,20955,1102.894737,1361049853414,1361049853542,1471234790,1471234918,128
1361049861,1471242376,3,502,167.3333333,1361049860134,1361049860262,1471241510,1471241638,128
1361049861,1471242376,53,69217,1305.981132,1361049853414,1361049853734,1471234790,1471235110,320
1361049861,1471242376,8,7092,886.5,1361049856421,1361049856677,1471237797,1471238053,256
1361049861,1471242376,13,14251,1096.230769,1361049853413,1361049853477,1471234789,1471234853,64
1361049861,1471242376,4,592,148,1361049853413,1361049853477,1471234789,1471234853,64
1361049861,1471242376,7,3815,545,1361049853413,1361049853605,1471234789,1471234981,192
1361049861,1471242376,13,14208,1092.923077,1361049853412,1361049853476,1471234788,1471234852,64
1361049861,1471242376,19,21795,1147.105263,1361049853412,1361049853540,1471234788,1471234916,128
1361049861,1471242380,5,623,124.6,1361049860387,1361049860451,1471241767,1471241831,64
1361049861,1471242380,8,5232,654,1361049856739,1361049856867,1471238119,1471238247,128
1361049861,1471242380,5,578,115.6,1361049856739,1361049856931,1471238119,1471238311,192
1361049861,1471242380,20,11377,568.85,1361049856675,1361049856803,1471238055,1471238183,128
1361049861,1471242380,33,41453,1256.151515,1361049853538,1361049853602,1471234918,1471234982,64
1361049861,1471242380,13,5562,427.8461538,1361049856738,1361049857058,1471238118,1471238438,320
1361049861,1471242380,40,51288,1282.2,1361049853666,1361049853794,1471235046,1471235174,128
1361049861,1471242380,6,1108,184.6666667,1361049860706,1361049860770,1471242086,1471242150,64
1361049861,1471242380,7,4563,651.8571429,1361049856866,1361049856994,1471238246,1471238374,128
1361049861,1471242380,21,24465,1165,1361049856929,1361049856993,1471238309,1471238373,64
1361049861,1471242380,63,83798,1330.126984,1361049853601,1361049853793,1471234981,1471235173,192
1361049861,1471242380,5,1940,388,1361049857057,1361049857121,1471238437,1471238501,64
1361049861,1471242392,6,1000,166.6666667,1361049860693,1361049860821,1471242085,1471242213,128
1361049861,1471242392,5,1606,321.2,1361049860693,1361049860821,1471242085,1471242213,128
1361049861,1471242392,7,856,122.2857143,1361049860692,1361049860884,1471242084,1471242276,192
1361049861,1471242392,5,3620,724,1361049856980,1361049857300,1471238372,1471238692,320
1361049861,1471242392,4,216,54,1361049860692,1361049860820,1471242084,1471242212,128
1361049861,1471242396,21,24628,1172.761905,1361049857040,1361049857104,1471238436,1471238500,64
1361049861,1471242396,7,4936,705.1428571,1361049857043,1361049857619,1471238439,1471239015,576
1361049861,1471242396,4,695,173.75,1361049857043,1361049857619,1471238439,1471239015,576
1361049861,1471242396,7,4933,704.7142857,1361049857043,1361049857619,1471238439,1471239015,576
1361049861,1471242396,4,632,158,1361049857107,1361049857619,1471238503,1471239015,512
1361049861,1471242396,5,3598,719.6,1361049857617,1361049857873,1471239013,1471239269,256
1361049861,1471242396,5,3597,719.4,1361049857681,1361049857873,1471239077,1471239269,192
1361049861,1471242396,6,2727,454.5,1361049854096,1361049854288,1471235492,1471235684,192
1361049861,1471242396,2,92,46,1361049857744,1361049857744,1471239140,1471239140,0
1361049861,1471242396,15,9798,653.2,1361049857744,1361049858064,1471239140,1471239460,320
1361049861,1471242400,5,1940,388,1361049857679,1361049857743,1471239079,1471239143,64
1361049861,1471242400,5,455,91,1361049858125,1361049858509,1471239525,1471239909,384
1361049861,1471242400,4,1205,301.25,1361049857805,1361049857869,1471239205,1471239269,64
1361049861,1471242400,3,502,167.3333333,1361049858316,1361049858508,1471239716,1471239908,192
1361049861,1471242400,4,817,204.25,1361049857932,1361049858060,1471239332,1471239460,128
1361049861,1471242404,5,2674,534.8,1361049857995,1361049858187,1471239399,1471239591,192
1361049861,1471242404,4,578,144.5,1361049858571,1361049858635,1471239975,1471240039,64
1361049861,1471242404,4,1428,357,1361049858059,1361049858123,1471239463,1471239527,64
1361049861,1471242404,5,453,90.6,1361049858059,1361049858187,1471239463,1471239591,128
1361049861,1471242404,7,5123,731.8571429,1361049858123,1361049858187,1471239527,1471239591,64
1361049861,1471242404,4,1205,301.25,1361049858123,1361049858187,1471239527,1471239591,64
1361049861,1471242404,5,455,91,1361049858122,1361049858506,1471239526,1471239910,384
1361049861,1471242404,4,578,144.5,1361049858186,1361049858250,1471239590,1471239654,64
1361049861,1471242404,5,455,91,1361049858314,1361049858698,1471239718,1471240102,384
1361049861,1471242404,4,1205,301.25,1361049858378,1361049858442,1471239782,1471239846,64
1361049863,109557652,10,9697,969.7,1361049857561,1361049857625,109552213,109552277,64
1361049863,109557652,8,6961,870.125,1361049857561,1361049857945,109552213,109552597,384
1361049863,109557652,13,13101,1007.769231,1361049857625,1361049857945,109552277,109552597,320
1361049863,109557652,12,12490,1040.833333,1361049857565,1361049857949,109552217,109552601,384
1361049863,109557652,4,464,116,1361049857628,1361049857948,109552280,109552600,320
1361049863,109557652,4,464,116,1361049857628,1361049857948,109552280,109552600,320
1361049863,109557656,6,2012,335.3333333,1361049854168,1361049857496,109548824,109552152,3328
1361049863,109557656,10,3237,323.7,1361049857944,1361049861976,109552600,109556632,4032
1361049863,109557656,4,1010,252.5,1361049857561,1361049857561,109552217,109552217,0
1361049863,109557656,4,1010,252.5,1361049857561,1361049857561,109552217,109552217,0
1361049863,109557656,8,6396,799.5,1361049857561,1361049857625,109552217,109552281,64
1361049863,109557660,4,464,116,1361049857620,1361049857940,109552280,109552600,320
1361049863,109557660,37,47216,1276.108108,1361049857876,1361049857940,109552536,109552600,64
1361049863,109557660,5,2099,419.8,1361049859538,1361049860562,109554198,109555222,1024
1361049867,1471248616,28,35036,1251.285714,1361049841526,1361049864310,1471223142,1471245926,22784
1361049867,1471248616,12,11117,926.4166667,1361049841652,1361049864308,1471223268,1471245924,22656
1361049867,1471248620,14,10211,729.3571429,1361049842032,1361049864304,1471223652,1471245924,22272
1361049867,1471248640,20,23889,1194.45,1361049842588,1361049864284,1471224228,1471245924,21696
1361049867,1471248640,45,58037,1289.711111,1361049842588,1361049864284,1471224228,1471245924,21696
1361049867,1471248644,4,924,231,1361049842585,1361049864281,1471224229,1471245925,21696
1361049867,1471248688,6,2344,390.6666667,1361049840110,1361049840814,1471221798,1471222502,704
1361049867,1471248720,18,20499,1138.833333,1361049841420,1361049864204,1471223140,1471245924,22784
1361049867,1471248724,49,65027,1327.081633,1361049841415,1361049864199,1471223139,1471245923,22784
1361049867,1471248724,8,6573,821.625,1361049841417,1361049864201,1471223141,1471245925,22784
1361049867,1471248736,5,1676,335.2,1361049842494,1361049864190,1471224230,1471245926,21696
1361049867,1471248740,9,8057,895.2222222,1361049842491,1361049864187,1471224231,1471245927,21696
1361049869,1471250320,5,1450,290,1361049860894,1361049861278,1471242214,1471242598,384
1361049869,1471250320,6,1777,296.1666667,1361049860958,1361049861342,1471242278,1471242662,384
1361049869,1471250320,4,216,54,1361049861020,1361049861084,1471242340,1471242404,64
1361049869,1471250324,10,5344,534.4,1361049847643,1361049864603,1471228967,1471245927,16960
1361049869,1471250324,4,635,158.75,1361049843417,1361049865113,1471224741,1471246437,21696
1361049869,1471250324,16,16581,1036.3125,1361049843481,1361049864601,1471224805,1471245925,21120
1361049869,1471250324,6,1555,259.1666667,1361049861272,1361049861400,1471242596,1471242724,128
1361049869,1471250324,6,1555,259.1666667,1361049861336,1361049861464,1471242660,1471242788,128
1361049869,1471250324,6,2002,333.6666667,1361049861399,1361049862167,1471242723,1471243491,768
1361049869,1471250328,4,676,169,1361049843799,1361049864599,1471225127,1471245927,20800
1361049869,1471250328,5,1201,240.2,1361049861398,1361049862166,1471242726,1471243494,768
1361049869,1471250328,12,4711,392.5833333,1361049861526,1361049862166,1471242854,1471243494,640
1361049869,1471250328,5,455,91,1361049861398,1361049861782,1471242726,1471243110,384
1361049869,1471250328,10,4695,469.5,1361049843861,1361049864661,1471225189,1471245989,20800
1361049869,1471250328,7,1798,256.8571429,1361049861589,1361049861717,1471242917,1471243045,128
1361049869,1471250332,3,623,207.6666667,1361049861778,1361049861842,1471243110,1471243174,64
1361049869,1471250332,4,477,119.25,1361049860881,1361049861265,1471242213,1471242597,384
1361049869,1471250332,38,44017,1158.342105,1361049845969,1361049864593,1471227301,1471245925,18624
1361049869,1471250332,278,388362,1396.985612,1361049846032,1361049864592,1471227364,1471245924,18560
1361049869,1471250332,6,1555,259.1666667,1361049862223,1361049862351,1471243555,1471243683,128
1361049869,1471250356,17,19195,1129.117647,1361049846266,1361049864570,1471227622,1471245926,18304
1361049869,1471250360,14,7008,500.5714286,1361049860916,1361049862196,1471242276,1471243556,1280
1361049869,1471250364,6,1555,259.1666667,1361049860978,1361049861106,1471242342,1471242470,128
1361049869,1471250364,6,1555,259.1666667,1361049861041,1361049861169,1471242405,1471242533,128
1361049869,1471250364,41,51762,1262.487805,1361049843121,1361049864561,1471224485,1471245925,21440
1361049869,1471250364,11,5399,490.8181818,1361049847600,1361049864560,1471228964,1471245924,16960
1361049869,1471250368,6,2828,471.3333333,1361049861230,1361049862126,1471242598,1471243494,896
1361049869,1471250368,8,5175,646.875,1361049861230,1361049862126,1471242598,1471243494,896
1361049869,1471250368,4,632,158,1361049843757,1361049864557,1471225125,1471245925,20800
1361049869,1471250368,6,1950,325,1361049861484,1361049862124,1471242852,1471243492,640
1361049869,1471250372,43,56119,1305.093023,1361049861543,1361049862119,1471242915,1471243491,576
1361049869,1471250372,6,1129,188.1666667,1361049861673,1361049861801,1471243045,1471243173,128
1361049869,1471250396,6,702,117,1361049860688,1361049861072,1471242084,1471242468,384
1361049869,1471250400,3,540,180,1361049861771,1361049861771,1471243171,1471243171,0
1361049869,1471250400,5,786,157.2,1361049860747,1361049861067,1471242147,1471242467,320
1361049869,1471250400,4,1365,341.25,1361049861775,1361049862095,1471243175,1471243495,320
1361049869,1471250400,6,1651,275.1666667,1361049861838,1361049861966,1471243238,1471243366,128
1361049869,1471250400,70,92197,1317.1,1361049845966,1361049864526,1471227366,1471245926,18560
1361049869,1471250400,5,1417,283.4,1361049860813,1361049860941,1471242213,1471242341,128
1361049869,1471250400,4,216,54,1361049860813,1361049860877,1471242213,1471242277,64
1361049869,1471250400,7,856,122.2857143,1361049861965,1361049862093,1471243365,1471243493,128
1361049869,1471250400,41,52416,1278.439024,1361049845964,1361049864524,1471227364,1471245924,18560
1361049869,1471250400,5,1503,300.6,1361049862092,1361049862220,1471243492,1471243620,128
1361049869,1471250400,4,653,163.25,1361049854028,1361049864076,1471235428,1471245476,10048
1361049869,1471250404,36,45714,1269.833333,1361049846218,1361049864522,1471227622,1471245926,18304
1361049871,109565656,63,77144,1224.507937,1361049845845,1361049864405,109540501,109559061,18560
1361049871,109565656,41,47550,1159.756098,1361049845845,1361049864405,109540501,109559061,18560
1361049871,109565660,26,32499,1249.961538,1361049847635,1361049864403,109542295,109559063,16768
1361049871,109565660,30,38568,1285.6,1361049847763,1361049864403,109542423,109559063,16640
1361049871,109565664,162,216867,1338.685185,1361049845839,1361049864399,109540503,109559063,18560
1361049871,109565664,74,93885,1268.716216,1361049845839,1361049864399,109540503,109559063,18560
1361049871,109565664,41,45376,1106.731707,1361049845839,1361049864399,109540503,109559063,18560
1361049871,109565664,113,147316,1303.681416,1361049845839,1361049864399,109540503,109559063,18560
1361049871,109565664,4,1159,289.75,1361049847757,1361049864397,109542421,109559061,16640
1361049871,109565664,30,38568,1285.6,1361049847757,1361049864397,109542421,109559061,16640
1361049871,1471252640,23,22008,956.8695652,1361049845663,1361049845855,1471227303,1471227495,192
1361049871,1471252640,24,23706,987.75,1361049845726,1361049845918,1471227366,1471227558,192
1361049871,1471252640,1,52,52,1361049844445,1361049844445,1471226085,1471226085,0
1361049877,1471258336,5,553,110.6,1361049872653,1361049872717,1471253989,1471254053,64
1361049877,1471258340,5,453,90.6,1361049873096,1361049873160,1471254436,1471254500,64
1361049880,109574940,11,11879,1079.909091,1361049853882,1361049853946,109548822,109548886,64
1361049883,1471264620,1,46,46,1361049856817,1361049856817,1471238437,1471238437,0
1361049883,1471264632,8,5175,646.875,1361049857829,1361049857957,1471239461,1471239589,128
1361049883,1471264700,1,46,46,1361049856545,1361049856545,1471238245,1471238245,0
1361049883,1471264704,1,46,46,1361049856797,1361049856797,1471238501,1471238501,0
1361049883,1471264712,1,46,46,1361049857622,1361049857622,1471239334,1471239334,0
1361049883,1471264740,1,46,46,1361049858233,1361049858233,1471239973,1471239973,0
1361049884,109578920,1,46,46,1361049857293,1361049857293,109552213,109552213,0
1361049884,109578920,1,46,46,1361049857293,1361049857293,109552213,109552213,0
1361049884,109578924,36,46866,1301.833333,1361049857802,1361049857930,109552726,109552854,128
1361049884,109578924,36,47170,1310.277778,1361049857802,1361049857930,109552726,109552854,128
1361049884,109578924,18,22072,1226.222222,1361049857929,1361049857993,109552853,109552917,64
1361049884,109578972,1,46,46,1361049857178,1361049857178,109552150,109552150,0
1361049884,109578972,1,46,46,1361049857242,1361049857242,109552214,109552214,0
1361049884,109578976,1,52,52,1361049857495,1361049857495,109552471,109552471,0
1361049887,1471268608,1,52,52,1361049859007,1361049859007,1471240615,1471240615,0
1361049887,1471268688,1,52,52,1361049858924,1361049858924,1471240612,1471240612,0
1361049891,1471272576,1,52,52,1361049863199,1361049863199,1471244775,1471244775,0
1361049891,1471272588,10,10330,1033,1361049864146,1361049864146,1471245734,1471245734,0
1361049891,1471272588,1,46,46,1361049864336,1361049864336,1471245924,1471245924,0
1361049891,1471272588,1,46,46,1361049864336,1361049864336,1471245924,1471245924,0
1361049891,1471272588,1,46,46,1361049864335,1361049864335,1471245923,1471245923,0
1361049891,1471272588,1,46,46,1361049864335,1361049864335,1471245923,1471245923,0
1361049891,1471272588,1,46,46,1361049864335,1361049864335,1471245923,1471245923,0
1361049891,1471272652,9,8988,998.6666667,1361049866575,1361049866575,1471248227,1471248227,0
1361049891,1471272668,17,20684,1216.705882,1361049864064,1361049866560,1471245732,1471248228,2496
1361049891,1471272700,1,46,46,1361049864226,1361049864226,1471245926,1471245926,0
1361049891,1471272700,1,46,46,1361049864226,1361049864226,1471245926,1471245926,0
1361049891,1471272700,1,46,46,1361049864226,1361049864226,1471245926,1471245926,0
1361049891,1471272700,1,46,46,1361049864226,1361049864226,1471245926,1471245926,0
1361049891,1471272700,1,46,46,1361049864226,1361049864226,1471245926,1471245926,0
1361049891,1471272700,1,46,46,1361049864226,1361049864226,1471245926,1471245926,0
1361049891,1471272700,1,46,46,1361049864225,1361049864225,1471245925,1471245925,0
1361049891,1471272700,1,46,46,1361049864225,1361049864225,1471245925,1471245925,0
1361049891,1471272744,7,7197,1028.142857,1361049866485,1361049866485,1471248229,1471248229,0
1361049893,1471274340,5,553,110.6,1361049887752,1361049887880,1471269092,1471269220,128
1361049893,1471274344,5,453,90.6,1361049888069,1361049888197,1471269413,1471269541,128
1361049898,1471279084,1,52,52,1361049871367,1361049871367,1471252451,1471252451,0
1361049898,1471279084,1276,1816836,1423.852665,1361049590409,1361049597641,1470971493,1470978725,7232
1361049909,1471290392,5,553,110.6,1361049902549,1361049902677,1471283941,1471284069,128
1361049915,1471296696,1,46,46,1361049890531,1361049890531,1471272227,1471272227,0
1361049915,1471296740,1,52,52,1361049888184,1361049888184,1471269924,1471269924,0
1361049925,1471306348,10,5469,546.9,1361049920319,1361049920895,1471301667,1471302243,576
1361049925,1471306348,5,594,118.8,1361049920383,1361049920575,1471301731,1471301923,192
1361049925,1471306352,7,3002,428.8571429,1361049920700,1361049920892,1471302052,1471302244,192
1361049925,1471306352,5,594,118.8,1361049920764,1361049921020,1471302116,1471302372,256
1361049925,1471306352,10,7410,741,1361049920764,1361049920892,1471302116,1471302244,128
1361049925,1471306352,7,5123,731.8571429,1361049920827,1361049920891,1471302179,1471302243,64
1361049925,1471306352,5,553,110.6,1361049917627,1361049917755,1471298979,1471299107,128
1361049925,1471306352,4,409,102.25,1361049920955,1361049921083,1471302307,1471302435,128
1361049925,1471306356,4,996,249,1361049920954,1361049921018,1471302310,1471302374,64
1361049925,1471306356,5,956,191.2,1361049921018,1361049921146,1471302374,1471302502,128
1361049925,1471306356,4,463,115.75,1361049921081,1361049921145,1471302437,1471302501,64
1361049925,1471306356,3,624,208,1361049921017,1361049921017,1471302373,1471302373,0
1361049925,1471306356,4,652,163,1361049921017,1361049921081,1471302373,1471302437,64
1361049925,1471306356,4,548,137,1361049921081,1361049921209,1471302437,1471302565,128
1361049925,1471306356,3,858,286,1361049921081,1361049921209,1471302437,1471302565,128
1361049925,1471306356,5,1503,300.6,1361049921017,1361049921145,1471302373,1471302501,128
1361049925,1471306356,4,543,135.75,1361049921016,1361049921144,1471302372,1471302500,128
1361049925,1471306356,6,895,149.1666667,1361049921016,1361049921144,1471302372,1471302500,128
1361049925,1471306364,5,617,123.4,1361049918770,1361049918834,1471300134,1471300198,64
1361049925,1471306388,5,2733,546.6,1361049920408,1361049920600,1471301796,1471301988,192
1361049925,1471306388,5,2947,589.4,1361049920663,1361049920855,1471302051,1471302243,192
1361049925,1471306392,5,617,123.4,1361049920662,1361049920726,1471302054,1471302118,64
1361049925,1471306392,2,141,70.5,1361049917525,1361049922517,1471298917,1471303909,4992
1361049925,1471306392,5,617,123.4,1361049920917,1361049920981,1471302309,1471302373,64
1361049925,1471306392,5,455,91,1361049920917,1361049920981,1471302309,1471302373,64
1361049925,1471306392,5,617,123.4,1361049920917,1361049920981,1471302309,1471302373,64
1361049925,1471306392,4,1318,329.5,1361049920981,1361049921109,1471302373,1471302501,128
1361049925,1471306392,7,1499,214.1428571,1361049920981,1361049921173,1471302373,1471302565,192
1361049925,1471306392,3,808,269.3333333,1361049920981,1361049921109,1471302373,1471302501,128
1361049925,1471306392,6,2125,354.1666667,1361049920980,1361049921108,1471302372,1471302500,128
1361049925,1471306392,3,703,234.3333333,1361049920980,1361049921108,1471302372,1471302500,128
1361049925,1471306392,8,856,107,1361049920980,1361049921300,1471302372,1471302692,320
1361049925,1471306392,3,540,180,1361049921044,1361049921044,1471302436,1471302436,0
1361049925,1471306424,5,453,90.6,1361049918006,1361049918134,1471299430,1471299558,128
1361049925,1471306424,6,2779,463.1666667,1361049918259,1361049918579,1471299683,1471300003,320
1361049925,1471306428,8,3372,421.5,1361049918641,1361049918961,1471300069,1471300389,320
1361049927,109621652,4,699,174.75,1361049920858,1361049920986,109615510,109615638,128
1361049927,109621656,7,4950,707.1428571,1361049920790,1361049920854,109615446,109615510,64
1361049933,1471314364,5,553,110.6,1361049932594,1361049932722,1471313958,1471314086,128
1361049933,1471314432,12,7678,639.8333333,1361049920877,1361049926061,1471302309,1471307493,5184
1361049933,1471314432,5,1152,230.4,1361049921067,1361049926315,1471302499,1471307747,5248
1361049936,1471316996,1,76,76,1361049910369,1361049910369,1471291365,1471291365,0
1361049941,1471322360,7,880,125.7142857,1361049921205,1361049936309,1471302565,1471317669,15104
1361049948,1471328956,1,52,52,1361049921414,1361049921414,1471302370,1471302370,0
1361049948,1471328980,3,411,137,1361049922032,1361049922096,1471303012,1471303076,64
1361049949,1471330368,5,553,110.6,1361049947628,1361049947692,1471328996,1471329060,64
1361049965,1471346392,5,453,90.6,1361049963091,1361049963411,1471344483,1471344803,320
1361049965,1471346436,5,553,110.6,1361049962534,1361049962662,1471343970,1471344098,128
1361049981,1471362352,5,553,110.6,1361049977659,1361049977787,1471359011,1471359139,128
1361049981,1471362428,5,2733,546.6,1361049978609,1361049978801,1471360037,1471360229,192
1361049981,1471362428,7,2915,416.4285714,1361049978864,1361049978992,1471360292,1471360420,128
1361049989,1471370356,6,2682,447,1361049981047,1361049981367,1471362403,1471362723,320
1361049989,1471370356,9,4554,506,1361049981047,1361049986231,1471362403,1471367587,5184
1361049989,1471370360,6,1108,184.6666667,1361049981361,1361049981425,1471362721,1471362785,64
1361049989,1471370364,4,216,54,1361049981360,1361049981424,1471362724,1471362788,64
1361049989,1471370364,25,29825,1193,1361049981424,1361049981616,1471362788,1471362980,192
1361049989,1471370364,5,2206,441.2,1361049981424,1361049984624,1471362788,1471365988,3200
1361049989,1471370364,4,216,54,1361049981488,1361049981552,1471362852,1471362916,64
1361049989,1471370368,6,2895,482.5,1361049981741,1361049982125,1471363109,1471363493,384
1361049989,1471370368,6,504,84,1361049981676,1361049981804,1471363044,1471363172,128
1361049989,1471370368,5,1905,381,1361049984940,1361049985260,1471366308,1471366628,320
1361049989,1471370372,5,942,188.4,1361049982181,1361049982245,1471363553,1471363617,64
1361049989,1471370372,6,1452,242,1361049982312,1361049987432,1471363684,1471368804,5120
1361049989,1471370408,3,502,167.3333333,1361049980995,1361049981187,1471362403,1471362595,192
1361049989,1471370408,5,455,91,1361049980995,1361049981507,1471362403,1471362915,512
1361049989,1471370412,5,899,179.8,1361049981310,1361049981438,1471362722,1471362850,128
1361049989,1471370412,5,1606,321.2,1361049981310,1361049981438,1471362722,1471362850,128
1361049989,1471370412,5,786,157.2,1361049981374,1361049981694,1471362786,1471363106,320
1361049989,1471370416,6,965,160.8333333,1361049981437,1361049981501,1471362853,1471362917,64
1361049989,1471370416,5,594,118.8,1361049981499,1361049981755,1471362915,1471363171,256
1361049989,1471370420,10,3089,308.9,1361049981493,1361049982133,1471362913,1471363553,640
1361049989,1471370440,4,216,54,1361049981541,1361049981605,1471362981,1471363045,64
1361049989,1471370440,6,1709,284.8333333,1361049981669,1361049982053,1471363109,1471363493,384
1361049989,1471370440,6,777,129.5,1361049981541,1361049981733,1471362981,1471363173,192
1361049989,1471370440,7,479,68.42857143,1361049981795,1361049986915,1471363235,1471368355,5120
1361049989,1471370440,7,2039,291.2857143,1361049981859,1361049982115,1471363299,1471363555,256
1361049989,1471370444,5,1503,300.6,1361049985310,1361049985374,1471366754,1471366818,64
1361049989,1471370444,4,787,196.75,1361049982113,1361049982177,1471363557,1471363621,64
1361049989,1471370444,4,1327,331.75,1361049982176,1361049985312,1471363620,1471366756,3136
1361049989,1471370444,5,1497,299.4,1361049982367,1361049982431,1471363811,1471363875,64
1361049991,109685712,4,1026,256.5,1361049984481,1361049984737,109679193,109679449,256
1361049991,109685720,8,2312,289,1361049984473,1361049984729,109679193,109679449,256
1361049997,1471378360,5,553,110.6,1361049992626,1361049992754,1471373986,1471374114,128
1361050004,1471385268,5,593,118.6,1361049979025,1361050000081,1471360293,1471381349,21056
1361050004,1471385272,1,52,52,1361049979020,1361049979020,1471360292,1471360292,0
1361050004,1471385272,3,411,137,1361049979020,1361049979020,1471360292,1471360292,0
1361050004,1471385360,1,52,52,1361049979122,1361049979122,1471360482,1471360482,0
1361050004,1471385364,1,52,52,1361049979181,1361049979181,1471360545,1471360545,0
1361050008,1471389196,3,550,183.3333333,1361049982423,1361049982487,1471363619,1471363683,64
1361050008,1471389240,1,46,46,1361049981164,1361049981164,1471362404,1471362404,0
1361050008,1471389284,3,753,251,1361049982209,1361049982273,1471363493,1471363557,64
1361050012,1471393192,1,46,46,1361049986780,1361049986780,1471367972,1471367972,0
1361050013,109707140,24,30445,1268.541667,1361049985629,1361049985693,109679769,109679833,64
1361050013,109707140,7,2260,322.8571429,1361049985693,1361049985693,109679833,109679833,0
1361050013,1471394664,5,553,110.6,1361050007364,1361050007428,1471389028,1471389092,64
1361050016,1471397228,1,52,52,1361049989174,1361049989174,1471370402,1471370402,0
1361050029,1471410400,55442,79054551,1425.89645,1361049858569,1361050028873,1471239969,1471410273,170304
1361050029,1471410440,5,553,110.6,1361050022563,1361050022691,1471404003,1471404131,128
1361050036,1471417144,1,52,52,1361050008457,1361050008457,1471389601,1471389601,0
1361050036,1471417256,1,46,46,1361050009241,1361050009241,1471390497,1471390497,0
1361050044,1471425148,1,52,52,1361050016647,1361050016647,1471397795,1471397795,0
1361050044,1471425148,1,52,52,1361050016583,1361050016583,1471397731,1471397731,0
1361050044,1471425232,1,52,52,1361050016498,1361050016498,1471397730,1471397730,0
1361050044,1471425232,1,52,52,1361050016561,1361050016561,1471397793,1471397793,0
1361050045,1471426368,5,455,91,1361050040618,1361050041066,1471421986,1471422434,448
1361050045,1471426372,5,1606,321.2,1361050040869,1361050040997,1471422241,1471422369,128
1361050045,1471426372,5,786,157.2,1361050040872,1361050041192,1471422244,1471422564,320
1361050045,1471426372,5,553,110.6,1361050037672,1361050037736,1471419044,1471419108,64
1361050045,1471426372,6,1452,242,1361050041000,1361050041192,1471422372,1471422564,192
1361050045,1471426372,6,1108,184.6666667,1361050040808,1361050040936,1471422180,1471422308,128
1361050045,1471426372,25,29825,1193,1361050040871,1361050041063,1471422243,1471422435,192
1361050045,1471426372,9,908,100.8888889,1361050040871,1361050041255,1471422243,1471422627,384
1361050045,1471426372,6,504,84,1361050041127,1361050041255,1471422499,1471422627,128
1361050045,1471426372,6,2894,482.3333333,1361050041254,1361050041318,1471422626,1471422690,64
1361050045,1471426376,6,2779,463.1666667,1361050041441,1361050041697,1471422817,1471423073,256
1361050045,1471426376,6,1555,259.1666667,1361050041505,1361050041633,1471422881,1471423009,128
1361050045,1471426376,5,594,118.8,1361050041827,1361050042083,1471423203,1471423459,256
1361050045,1471426400,4,1318,329.5,1361050042316,1361050042444,1471423716,1471423844,128
1361050045,1471426400,5,1508,301.6,1361050042316,1361050042380,1471423716,1471423780,64
1361050045,1471426400,7,804,114.8571429,1361050042316,1361050042636,1471423716,1471424036,320
1361050045,1471426400,3,359,119.6666667,1361050042188,1361050042316,1471423588,1471423716,128
1361050045,1471426400,3,931,310.3333333,1361050042316,1361050042444,1471423716,1471423844,128
1361050045,1471426400,4,543,135.75,1361050042315,1361050042379,1471423715,1471423779,64
1361050045,1471426400,3,808,269.3333333,1361050042315,1361050042379,1471423715,1471423779,64
1361050045,1471426400,6,895,149.1666667,1361050042315,1361050042443,1471423715,1471423843,128
1361050045,1471426400,3,540,180,1361050042314,1361050042378,1471423714,1471423778,64
1361050045,1471426400,3,858,286,1361050042314,1361050042506,1471423714,1471423906,192
1361050045,1471426412,3,502,167.3333333,1361050040573,1361050040765,1471421985,1471422177,192
1361050045,1471426416,10,5806,580.6,1361050040572,1361050040956,1471421988,1471422372,384
1361050045,1471426416,5,857,171.4,1361050040763,1361050040891,1471422179,1471422307,128
1361050045,1471426416,6,1000,166.6666667,1361050040827,1361050040891,1471422243,1471422307,64
1361050045,1471426416,6,702,117,1361050040827,1361050041211,1471422243,1471422627,384
1361050045,1471426416,5,899,179.8,1361050040763,1361050040891,1471422179,1471422307,128
1361050045,1471426416,4,216,54,1361050040827,1361050040891,1471422243,1471422307,64
1361050045,1471426416,6,965,160.8333333,1361050040891,1361050040955,1471422307,1471422371,64
1361050045,1471426416,4,216,54,1361050040891,1361050041019,1471422307,1471422435,128
1361050045,1471426416,6,1419,236.5,1361050040955,1361050041147,1471422371,1471422563,192
1361050045,1471426416,6,777,129.5,1361050041018,1361050041210,1471422434,1471422626,192
1361050045,1471426416,6,1555,259.1666667,1361050041145,1361050041273,1471422561,1471422689,128
1361050045,1471426416,6,1555,259.1666667,1361050041145,1361050041273,1471422561,1471422689,128
1361050045,1471426416,6,1446,241,1361050041273,1361050041465,1471422689,1471422881,192
1361050045,1471426436,6,1203,200.5,1361050041381,1361050042149,1471422817,1471423585,768
1361050045,1471426440,5,453,90.6,1361050038052,1361050038180,1471419492,1471419620,128
1361050045,1471426440,8,3372,421.5,1361050041571,1361050041763,1471423011,1471423203,192
1361050045,1471426440,5,623,124.6,1361050041570,1361050041634,1471423010,1471423074,64
1361050045,1471426440,10,5514,551.4,1361050041762,1361050042146,1471423202,1471423586,384
1361050045,1471426440,5,2733,546.6,1361050038817,1361050039009,1471420257,1471420449,192
1361050045,1471426444,7,2915,416.4285714,1361050038943,1361050039263,1471420387,1471420707,320
1361050045,1471426444,8,3850,481.25,1361050038942,1361050039646,1471420386,1471421090,704
1361050045,1471426444,5,518,103.6,1361050042142,1361050042974,1471423586,1471424418,832
1361050045,1471426444,6,2125,354.1666667,1361050042270,1361050042398,1471423714,1471423842,128
1361050045,1471426444,3,624,208,1361050042269,1361050042269,1471423713,1471423713,0
1361050045,1471426444,3,703,234.3333333,1361050042269,1361050042333,1471423713,1471423777,64
1361050045,1471426444,4,652,163,1361050042269,1361050042269,1471423713,1471423713,0
1361050045,1471426444,4,548,137,1361050042269,1361050042461,1471423713,1471423905,192
1361050045,1471426444,5,956,191.2,1361050042269,1361050042333,1471423713,1471423777,64
1361050045,1471426448,7,1565,223.5714286,1361050042265,1361050042457,1471423713,1471423905,192
1361050047,109741704,34,43230,1271.470588,1361050042023,1361050042087,109736727,109736791,64
1361050047,109741704,7,4950,707.1428571,1361050042087,1361050042151,109736791,109736855,64
1361050047,109741704,4,699,174.75,1361050043110,1361050043366,109737814,109738070,256
1361050053,1471434372,7,438,62.57142857,1361050040999,1361050046119,1471422371,1471427491,5120
1361050053,1471434376,14,6108,436.2857143,1361050049890,1361050052514,1471431266,1471433890,2624
1361050053,1471434400,5,1152,230.4,1361050042379,1361050047627,1471423779,1471429027,5248
1361050053,1471434416,5,553,110.6,1361050052602,1361050052730,1471434018,1471434146,128
1361050061,1471442376,23,26756,1163.304348,1361050054051,1361050054755,1471435427,1471436131,704
1361050061,1471442376,19,20872,1098.526316,1361050054050,1361050054754,1471435426,1471436130,704
1361050061,1471442380,4,431,107.75,1361050054431,1361050054815,1471435811,1471436195,384
1361050061,1471442404,7,880,125.7142857,1361050042504,1361050057608,1471423908,1471439012,15104
1361050061,1471442416,14,15091,1077.928571,1361050052474,1361050053946,1471433890,1471435362,1472
1361050061,1471442440,9,8054,894.8888889,1361050054114,1361050054690,1471435554,1471436130,576
1361050061,1471442444,4,356,89,1361050054687,1361050054687,1471436131,1471436131,0
1361050064,1471445232,1,52,52,1361050038512,1361050038512,1471419744,1471419744,0
1361050064,1471445236,1,46,46,1361050039021,1361050039021,1471420257,1471420257,0
1361050064,1471445348,1,46,46,1361050038908,1361050038908,1471420256,1471420256,0
1361050068,1471449172,3,164,54.66666667,1361050041261,1361050041325,1471422433,1471422497,64
1361050068,1471449200,1,52,52,1361050042001,1361050042001,1471423201,1471423201,0
1361050068,1471449208,1,46,46,1361050042506,1361050042506,1471423714,1471423714,0
1361050068,1471449212,2,601,300.5,1361050042632,1361050042696,1471423844,1471423908,64
1361050068,1471449252,1,52,52,1361050040927,1361050040927,1471422179,1471422179,0
1361050068,1471449328,1,46,46,1361050043667,1361050043667,1471424995,1471424995,0
1361050069,1471450408,48,64013,1333.604167,1361050067009,1361050067137,1471448417,1471448545,128
1361050069,1471450412,10,9665,966.5,1361050067136,1361050067200,1471448548,1471448612,64
1361050069,1471450456,15,15980,1065.333333,1361050066960,1361050067088,1471448416,1471448544,128
1361050069,1471450456,10,9356,935.6,1361050066960,1361050067088,1471448416,1471448544,128
1361050069,1471450460,16,16792,1049.5,1361050066640,1361050067088,1471448100,1471448548,448
1361050072,1471453132,5,553,110.6,1361050067926,1361050067990,1471449058,1471449122,64
1361050072,1471453188,3,215,71.66666667,1361050044767,1361050044831,1471425955,1471426019,64
1361050072,1471453220,33,41700,1263.636364,1361050045052,1361050045116,1471426272,1471426336,64
1361050076,1471457512,1,52,52,1361050048600,1361050048600,1471430112,1471430112,0
1361050077,1471458380,170,238186,1401.094118,1361049845852,1361050075036,1471227232,1471456416,229184
1361050077,1471458404,12,12700,1058.333333,1361050071302,1361050075782,1471452706,1471457186,4480
1361050077,1471458408,4,767,191.75,1361050075012,1361050075076,1471456420,1471456484,64
1361050077,1471458408,5,408,81.6,1361050075203,1361050075523,1471456611,1471456931,320
1361050077,1471458408,211,296610,1405.734597,1361050075395,1361050075587,1471456803,1471456995,192
1361050077,1471458408,14,15800,1128.571429,1361050075522,1361050075714,1471456930,1471457122,192
1361050077,1471458408,5,1090,218,1361050075522,1361050075970,1471456930,1471457378,448
1361050077,1471458408,7,5329,761.2857143,1361050075777,1361050075777,1471457185,1471457185,0
1361050077,1471458408,7,5299,757,1361050075777,1361050075777,1471457185,1471457185,0
1361050077,1471458456,25,29246,1169.84,1361050074451,1361050074899,1471455907,1471456355,448
1361050077,1471458456,13,12786,983.5384615,1361050071251,1361050075731,1471452707,1471457187,4480
1361050077,1471458456,4,1189,297.25,1361050074961,1361050075153,1471456417,1471456609,192
1361050077,1471458460,5,2480,496,1361050075152,1361050075216,1471456612,1471456676,64
1361050077,1471458460,4,521,130.25,1361050075151,1361050075215,1471456611,1471456675,64
1361050077,1471458460,25,28975,1159,1361050075470,1361050075790,1471456930,1471457250,320
1361050078,1471459620,4,521,130.25,1361050075438,1361050075502,1471457058,1471457122,64
1361050078,1471459620,5,2963,592.6,1361050075502,1361050075566,1471457122,1471457186,64
1361050078,1471459620,7,5399,771.2857143,1361050075566,1361050075566,1471457186,1471457186,0
1361050078,1471459620,6,3684,614,1361050075566,1361050075630,1471457186,1471457250,64
1361050080,1471461336,1,52,52,1361050052554,1361050052554,1471433890,1471433890,0
1361050080,1471461364,1,52,52,1361050054062,1361050054062,1471435426,1471435426,0
1361050080,1471461368,1,52,52,1361050054059,1361050054059,1471435427,1471435427,0
1361050080,1471461448,1,52,52,1361050053977,1361050053977,1471435425,1471435425,0
1361050085,1471466380,223,311583,1397.233184,1361050076895,1361050077791,1471458275,1471459171,896
1361050085,1471466384,1314,1852349,1409.702435,1361050076696,1361050081240,1471458080,1471462624,4544
1361050085,1471466388,5,1128,225.6,1361050076696,1361050077784,1471458084,1471459172,1088
1361050085,1471466388,4,634,158.5,1361050077717,1361050077781,1471459105,1471459169,64
1361050085,1471466392,4,1108,277,1361050077776,1361050077776,1471459168,1471459168,0
1361050085,1471466424,7,5516,788,1361050075760,1361050077744,1471457184,1471459168,1984
1361050085,1471466428,5,680,136,1361050077101,1361050077741,1471458529,1471459169,640
1361050085,1471466432,23,10622,461.826087,1361050060139,1361050077739,1471441571,1471459171,17600
1361050085,1471466432,5,1275,255,1361050077162,1361050077738,1471458594,1471459170,576
1361050085,1471466432,103,142132,1379.92233,1361050076649,1361050077737,1471458081,1471459169,1088
1361050085,1471466472,5,553,110.6,1361050082627,1361050082755,1471464099,1471464227,128
1361050085,1471466476,5,698,139.6,1361050067391,1361050077759,1471448867,1471459235,10368
1361050088,1471469356,7,5182,740.2857143,1361050075831,1361050077815,1471457187,1471459171,1984
1361050092,1471473548,1,52,52,1361050066549,1361050066549,1471448097,1471448097,0
1361050092,1471473552,1,52,52,1361050066866,1361050066866,1471448418,1471448418,0
1361050100,1471481520,1,46,46,1361050075409,1361050075409,1471456929,1471456929,0
1361050101,1471482376,13,11912,916.3076923,1361050096225,1361050096609,1471477601,1471477985,384
1361050101,1471482380,3,779,259.6666667,1361050100060,1361050100060,1471481440,1471481440,0
1361050101,1471482380,3,911,303.6666667,1361050100126,1361050100190,1471481506,1471481570,64
1361050101,1471482380,3,832,277.3333333,1361050100190,1361050100190,1471481570,1471481570,0
1361050101,1471482384,3,779,259.6666667,1361050096600,1361050096664,1471477984,1471478048,64
1361050101,1471482384,3,1410,470,1361050100443,1361050100699,1471481827,1471482083,256
1361050101,1471482384,4,1578,394.5,1361050100697,1361050100889,1471482081,1471482273,192
1361050101,1471482384,3,832,277.3333333,1361050096921,1361050096985,1471478305,1471478369,64
1361050101,1471482384,7,3422,488.8571429,1361050097048,1361050097304,1471478432,1471478688,256
1361050101,1471482388,3,911,303.6666667,1361050100759,1361050100823,1471482147,1471482211,64
1361050101,1471482388,4,628,157,1361050097239,1361050097303,1471478627,1471478691,64
1361050101,1471482388,5,594,118.8,1361050097302,1361050097366,1471478690,1471478754,64
1361050101,1471482388,5,2619,523.8,1361050097557,1361050098133,1471478945,1471479521,576
1361050101,1471482416,2616,3719454,1421.809633,1361050079416,1361050097400,1471460832,1471478816,17984
1361050101,1471482420,3,779,259.6666667,1361050098487,1361050098487,1471479907,1471479907,0
1361050101,1471482420,3,903,301,1361050098487,1361050098551,1471479907,1471479971,64
1361050101,1471482420,3,911,303.6666667,1361050098551,1361050098615,1471479971,1471480035,64
1361050101,1471482420,3,832,277.3333333,1361050098614,1361050098614,1471480034,1471480034,0
1361050101,1471482420,3,502,167.3333333,1361050098869,1361050098933,1471480289,1471480353,64
1361050101,1471482420,5,914,182.8,1361050099124,1361050100020,1471480544,1471481440,896
1361050101,1471482424,7,1455,207.8571429,1361050099251,1361050100019,1471480675,1471481443,768
1361050101,1471482428,5,1303,260.6,1361050100014,1361050100334,1471481442,1471481762,320
1361050101,1471482428,3,903,301,1361050100014,1361050100078,1471481442,1471481506,64
1361050101,1471482428,7,3453,493.2857143,1361050100140,1361050100460,1471481568,1471481888,320
1361050101,1471482428,8,3035,379.375,1361050100140,1361050100332,1471481568,1471481760,192
1361050101,1471482432,4,479,119.75,1361050096618,1361050096682,1471478050,1471478114,64
1361050101,1471482432,4,547,136.75,1361050096618,1361050096682,1471478050,1471478114,64
1361050101,1471482432,4,612,153,1361050096618,1361050096682,1471478050,1471478114,64
1361050101,1471482432,3,903,301,1361050096618,1361050096682,1471478050,1471478114,64
1361050101,1471482432,5,594,118.8,1361050100458,1361050100522,1471481890,1471481954,64
1361050101,1471482432,5,2828,565.6,1361050100458,1361050100650,1471481890,1471482082,192
1361050101,1471482432,25,14074,562.96,1361050096746,1361050097002,1471478178,1471478434,256
1361050101,1471482432,3,911,303.6666667,1361050096745,1361050096745,1471478177,1471478177,0
1361050101,1471482432,3,779,259.6666667,1361050100649,1361050100649,1471482081,1471482081,0
1361050101,1471482432,3,903,301,1361050100648,1361050100712,1471482080,1471482144,64
1361050101,1471482436,3,580,193.3333333,1361050100708,1361050100836,1471482144,1471482272,128
1361050101,1471482448,17,12640,743.5294118,1361050096923,1361050097051,1471478371,1471478499,128
1361050101,1471482448,3,832,277.3333333,1361050100761,1361050100761,1471482209,1471482209,0
1361050101,1471482452,8,3054,381.75,1361050097430,1361050098070,1471478882,1471479522,640
1361050101,1471482452,5,2501,500.2,1361050097302,1361050097430,1471478754,1471478882,128
1361050101,1471482452,9,3460,384.4444444,1361050097685,1361050098389,1471479137,1471479841,704
1361050101,1471482456,8,1248,156,1361050087056,1361050097232,1471468512,1471478688,10176
1361050101,1471482456,4,414,103.5,1361050098064,1361050098128,1471479520,1471479584,64
1361050101,1471482460,7,3422,488.8571429,1361050098573,1361050098829,1471480033,1471480289,256
1361050101,1471482464,5,2501,500.2,1361050098890,1361050099978,1471480354,1471481442,1088
1361050103,109797704,4,1036,259,1361050100522,1361050100586,109795226,109795290,64
1361050103,109797704,4,1057,264.25,1361050100905,1361050100905,109795609,109795609,0
1361050103,109797704,4,641,160.25,1361050101671,1361050101671,109796375,109796375,0
1361050103,109797704,4,1036,259,1361050101991,1361050101991,109796695,109796695,0
1361050103,109797704,5,1336,267.2,1361050098343,1361050099879,109793047,109794583,1536
1361050103,109797704,4,464,116,1361050101991,1361050102055,109796695,109796759,64
1361050103,109797704,5,516,103.2,1361050102183,1361050102375,109796887,109797079,192
1361050103,109797704,5,1569,313.8,1361050102183,1361050102183,109796887,109796887,0
1361050103,109797708,4,464,116,1361050100580,1361050100900,109795288,109795608,320
1361050103,109797708,11,10406,946,1361050096804,1361050096804,109791512,109791512,0
1361050103,109797708,7,1868,266.8571429,1361050101666,1361050101794,109796374,109796502,128
1361050103,109797712,5,1336,267.2,1361050099872,1361050100192,109794584,109794904,320
1361050104,1471485404,1,52,52,1361050076870,1361050076870,1471458274,1471458274,0
1361050104,1471485416,1,46,46,1361050077115,1361050077115,1471458531,1471458531,0
1361050104,1471485416,1,46,46,1361050077178,1361050077178,1471458594,1471458594,0
1361050104,1471485464,18,21503,1194.611111,1361050078474,1361050078794,1471459938,1471460258,320
1361050104,1471485464,3,983,327.6666667,1361050078474,1361050078474,1471459938,1471459938,0
1361050104,1471485464,5,2960,592,1361050078473,1361050078537,1471459937,1471460001,64
1361050104,1471485544,1,46,46,1361050077564,1361050077564,1471459108,1471459108,0
1361050104,1471485544,10,6556,655.6,1361050077690,1361050087226,1471459234,1471468770,9536
1361050104,1471485572,23,28074,1220.608696,1361050078108,1361050101852,1471459680,1471483424,23744
1361050104,1471485576,1,46,46,1361050078360,1361050078360,1471459936,1471459936,0
1361050104,1471485576,6,2821,470.1666667,1361050078360,1361050092056,1471459936,1471473632,13696
1361050104,1471485580,6,3629,604.8333333,1361050078356,1361050092052,1471459936,1471473632,13696
1361050104,1471485580,3,1394,464.6666667,1361050078423,1361050078423,1471460003,1471460003,0
1361050104,1471485580,1,46,46,1361050078614,1361050078614,1471460194,1471460194,0
1361050104,1471485580,4,826,206.5,1361050078549,1361050087189,1471460129,1471468769,8640
1361050104,1471485580,5,3846,769.2,1361050078613,1361050078677,1471460193,1471460257,64
1361050109,1471490364,13,12348,949.8461538,1361050103980,1361050104492,1471485344,1471485856,512
1361050109,1471490364,5,832,166.4,1361050100972,1361050101100,1471482336,1471482464,128
1361050109,1471490364,3,827,275.6666667,1361050108079,1361050108079,1471489443,1471489443,0
1361050109,1471490364,4,1579,394.75,1361050108142,1361050108654,1471489506,1471490018,512
1361050109,1471490364,3,961,320.3333333,1361050108077,1361050108141,1471489441,1471489505,64
1361050109,1471490364,3,880,293.3333333,1361050108205,1361050108205,1471489569,1471489569,0
1361050109,1471490364,7,3422,488.8571429,1361050108205,1361050108525,1471489569,1471489889,320
1361050109,1471490364,5,2501,500.2,1361050101165,1361050101421,1471482529,1471482785,256
1361050109,1471490364,3,961,320.3333333,1361050104556,1361050104620,1471485920,1471485984,64
1361050109,1471490368,15,10792,719.4666667,1361050104683,1361050106027,1471486051,1471487395,1344
1361050109,1471490368,6,2814,469,1361050108585,1361050108777,1471489953,1471490145,192
1361050109,1471490368,7,1455,207.8571429,1361050101417,1361050102121,1471482785,1471483489,704
1361050109,1471490368,3,502,167.3333333,1361050105065,1361050105129,1471486433,1471486497,64
1361050109,1471490368,5,2501,500.2,1361050105129,1361050106089,1471486497,1471487457,960
1361050109,1471490372,5,2722,544.4,1361050108711,1361050108839,1471490083,1471490211,128
1361050109,1471490372,5,1669,333.8,1361050108711,1361050108839,1471490083,1471490211,128
1361050109,1471490372,7,2900,414.2857143,1361050101607,1361050101863,1471482979,1471483235,256
1361050109,1471490372,7,1504,214.8571429,1361050105447,1361050106215,1471486819,1471487587,768
1361050109,1471490372,4,777,194.25,1361050108775,1361050108839,1471490147,1471490211,64
1361050109,1471490372,5,2619,523.8,1361050105510,1361050106086,1471486882,1471487458,576
1361050109,1471490372,5,594,118.8,1361050101670,1361050101862,1471483042,1471483234,192
1361050109,1471490372,6,2262,377,1361050101860,1361050101924,1471483232,1471483296,64
1361050109,1471490376,4,764,191,1361050101923,1361050101987,1471483299,1471483363,64
1361050109,1471490376,2,104,52,1361050101923,1361050101923,1471483299,1471483299,0
1361050109,1471490376,5,1669,333.8,1361050101923,1361050102051,1471483299,1471483427,128
1361050109,1471490376,5,1056,211.2,1361050102051,1361050102115,1471483427,1471483491,64
1361050109,1471490376,3,799,266.3333333,1361050102115,1361050102179,1471483491,1471483555,64
1361050109,1471490376,3,623,207.6666667,1361050102051,1361050102115,1471483427,1471483491,64
1361050109,1471490376,5,857,171.4,1361050102051,1361050102115,1471483427,1471483491,64
1361050109,1471490376,4,439,109.75,1361050102115,1361050102307,1471483491,1471483683,192
1361050109,1471490376,4,1392,348,1361050102243,1361050102371,1471483619,1471483747,128
1361050109,1471490376,5,820,164,1361050102114,1361050102306,1471483490,1471483682,192
1361050109,1471490376,4,610,152.5,1361050102114,1361050102242,1471483490,1471483618,128
1361050109,1471490376,32,41449,1295.28125,1361050102178,1361050102242,1471483554,1471483618,64
1361050109,1471490376,4,1078,269.5,1361050102178,1361050102242,1471483554,1471483618,64
1361050109,1471490376,4,1365,341.25,1361050102178,1361050102306,1471483554,1471483682,128
1361050109,1471490376,3,164,54.66666667,1361050102178,1361050102242,1471483554,1471483618,64
1361050109,1471490376,4,869,217.25,1361050102242,1361050102306,1471483618,1471483682,64
1361050109,1471490376,4,1398,349.5,1361050102242,1361050102306,1471483618,1471483682,64
1361050109,1471490376,6,1549,258.1666667,1361050102306,1361050102370,1471483682,1471483746,64
1361050109,1471490376,5,949,189.8,1361050102242,1361050102306,1471483618,1471483682,64
1361050109,1471490376,6,1549,258.1666667,1361050102369,1361050102497,1471483745,1471483873,128
1361050109,1471490376,4,761,190.25,1361050102305,1361050102433,1471483681,1471483809,128
1361050109,1471490376,3,961,320.3333333,1361050106209,1361050106273,1471487585,1471487649,64
1361050109,1471490400,11,5758,523.4545455,1361050102345,1361050102601,1471483745,1471484001,256
1361050109,1471490400,3,880,293.3333333,1361050106313,1361050106313,1471487713,1471487713,0
1361050109,1471490400,7,1906,272.2857143,1361050102473,1361050102601,1471483873,1471484001,128
1361050109,1471490400,7,3241,463,1361050106569,1361050107273,1471487969,1471488673,704
1361050109,1471490400,4,805,201.25,1361050102409,1361050102537,1471483809,1471483937,128
1361050109,1471490400,5,1332,266.4,1361050102473,1361050102537,1471483873,1471483937,64
1361050109,1471490400,5,613,122.6,1361050102472,1361050102472,1471483872,1471483872,0
1361050109,1471490400,3,581,193.6666667,1361050102664,1361050102920,1471484064,1471484320,256
1361050109,1471490400,5,1497,299.4,1361050102664,1361050102856,1471484064,1471484256,192
1361050109,1471490404,4,1365,341.25,1361050102532,1361050102596,1471483936,1471484000,64
1361050109,1471490404,4,1579,394.75,1361050102727,1361050102983,1471484131,1471484387,256
1361050109,1471490404,20,24256,1212.8,1361050102662,1361050103238,1471484066,1471484642,576
1361050109,1471490404,5,2501,500.2,1361050106630,1361050107206,1471488034,1471488610,576
1361050109,1471490404,7,1797,256.7142857,1361050102918,1361050103494,1471484322,1471484898,576
1361050109,1471490404,6,1237,206.1666667,1361050102790,1361050102918,1471484194,1471484322,128
1361050109,1471490404,3,643,214.3333333,1361050103044,1361050103108,1471484448,1471484512,64
1361050109,1471490408,4,628,157,1361050107075,1361050107203,1471488483,1471488611,128
1361050109,1471490408,5,2728,545.6,1361050103299,1361050103747,1471484707,1471485155,448
1361050109,1471490408,4,645,161.25,1361050103299,1361050103491,1471484707,1471484899,192
1361050109,1471490408,4,757,189.25,1361050103426,1361050103490,1471484834,1471484898,64
1361050109,1471490408,5,654,130.8,1361050103426,1361050103490,1471484834,1471484898,64
1361050109,1471490408,6,2814,469,1361050107266,1361050107522,1471488674,1471488930,256
1361050109,1471490408,6,2248,374.6666667,1361050107265,1361050107521,1471488673,1471488929,256
1361050109,1471490408,3,279,93,1361050103297,1361050103425,1471484705,1471484833,128
1361050109,1471490408,5,1669,333.8,1361050107393,1361050107521,1471488801,1471488929,128
1361050109,1471490408,6,2814,469,1361050103297,1361050103425,1471484705,1471484833,128
1361050109,1471490408,5,680,136,1361050107201,1361050107265,1471488609,1471488673,64
1361050109,1471490408,4,607,151.75,1361050103553,1361050103681,1471484961,1471485089,128
1361050109,1471490408,5,1669,333.8,1361050103424,1361050103488,1471484832,1471484896,64
1361050109,1471490408,5,1410,282,1361050107520,1361050107648,1471488928,1471489056,128
1361050109,1471490412,1307,1856931,1420.758225,1361050083007,1361050108543,1471464419,1471489955,25536
1361050109,1471490412,3,969,323,1361050107583,1361050107583,1471488995,1471488995,0
1361050109,1471490412,8,2913,364.125,1361050107647,1361050108031,1471489059,1471489443,384
1361050109,1471490412,9,7284,809.3333333,1361050107647,1361050107967,1471489059,1471489379,320
1361050109,1471490412,33,42870,1299.090909,1361050107518,1361050107966,1471488930,1471489378,448
1361050109,1471490412,7,3079,439.8571429,1361050107518,1361050108030,1471488930,1471489442,512
1361050109,1471490412,4,607,151.75,1361050107518,1361050108030,1471488930,1471489442,512
1361050109,1471490412,5,824,164.8,1361050107582,1361050107710,1471488994,1471489122,128
1361050109,1471490412,5,594,118.8,1361050108028,1361050108028,1471489440,1471489440,0
1361050109,1471490416,3,642,214,1361050100987,1361050101051,1471482403,1471482467,64
1361050109,1471490416,3,969,323,1361050108090,1361050108154,1471489506,1471489570,64
1361050109,1471490416,3,633,211,1361050101050,1361050101114,1471482466,1471482530,64
1361050109,1471490416,6,591,98.5,1361050108090,1361050108602,1471489506,1471490018,512
1361050109,1471490416,3,827,275.6666667,1361050104441,1361050104505,1471485857,1471485921,64
1361050109,1471490416,8,814,101.75,1361050101049,1361050101241,1471482465,1471482657,192
1361050109,1471490416,5,594,118.8,1361050101113,1361050101113,1471482529,1471482529,0
1361050109,1471490416,4,611,152.75,1361050104441,1361050106041,1471485857,1471487457,1600
1361050109,1471490416,22,11593,526.9545455,1361050104505,1361050106041,1471485921,1471487457,1536
1361050109,1471490416,5,2726,545.2,1361050101177,1361050101561,1471482593,1471482977,384
1361050109,1471490416,3,880,293.3333333,1361050104632,1361050104696,1471486048,1471486112,64
1361050109,1471490416,6,2407,401.1666667,1361050108216,1361050108536,1471489632,1471489952,320
1361050109,1471490416,3,969,323,1361050104568,1361050104632,1471485984,1471486048,64
1361050109,1471490416,7,3422,488.8571429,1361050104760,1361050105016,1471486176,1471486432,256
1361050109,1471490432,5,923,184.6,1361050101291,1361050101355,1471482723,1471482787,64
1361050109,1471490436,6,2401,400.1666667,1361050101223,1361050101735,1471482659,1471483171,512
1361050109,1471490436,3,608,202.6666667,1361050108519,1361050108583,1471489955,1471490019,64
1361050109,1471490436,5,594,118.8,1361050108455,1361050108519,1471489891,1471489955,64
1361050109,1471490436,6,2266,377.6666667,1361050108518,1361050108646,1471489954,1471490082,128
1361050109,1471490436,5,2618,523.6,1361050108454,1361050108646,1471489890,1471490082,192
1361050109,1471490436,4,645,161.25,1361050108517,1361050108645,1471489953,1471490081,128
1361050109,1471490436,5,1010,202,1361050105253,1361050106021,1471486689,1471487457,768
1361050109,1471490440,5,1030,206,1361050108704,1361050108768,1471490144,1471490208,64
1361050109,1471490440,5,653,130.6,1361050108707,1361050108899,1471490147,1471490339,192
1361050109,1471490440,33,42468,1286.909091,1361050108771,1361050108835,1471490211,1471490275,64
1361050109,1471490440,5,623,124.6,1361050101538,1361050101602,1471482978,1471483042,64
1361050109,1471490440,7,3422,488.8571429,1361050100770,1361050101026,1471482210,1471482466,256
1361050109,1471490440,3,634,211.3333333,1361050100833,1361050101025,1471482273,1471482465,192
1361050109,1471490440,8,5715,714.375,1361050101792,1361050101984,1471483232,1471483424,192
1361050109,1471490440,3,608,202.6666667,1361050101728,1361050101792,1471483168,1471483232,64
1361050109,1471490440,6,2814,469,1361050101792,1361050102944,1471483232,1471484384,1152
1361050109,1471490440,4,645,161.25,1361050101792,1361050101856,1471483232,1471483296,64
1361050109,1471490440,3,164,54.66666667,1361050101792,1361050103776,1471483232,1471485216,1984
1361050109,1471490444,5,1151,230.2,1361050101983,1361050102047,1471483427,1471483491,64
1361050109,1471490444,3,827,275.6666667,1361050106143,1361050106143,1471487587,1471487587,0
1361050109,1471490444,28,35069,1252.464286,1361050101983,1361050102047,1471483427,1471483491,64
1361050109,1471490444,4,607,151.75,1361050101983,1361050102175,1471483427,1471483619,192
1361050109,1471490444,4,777,194.25,1361050102047,1361050102111,1471483491,1471483555,64
1361050109,1471490444,3,164,54.66666667,1361050102046,1361050102110,1471483490,1471483554,64
1361050109,1471490444,3,540,180,1361050102046,1361050102110,1471483490,1471483554,64
1361050109,1471490444,4,734,183.5,1361050102046,1361050102238,1471483490,1471483682,192
1361050109,1471490444,12,4405,367.0833333,1361050106270,1361050107422,1471487714,1471488866,1152
1361050109,1471490444,4,651,162.75,1361050102110,1361050102174,1471483554,1471483618,64
1361050109,1471490444,5,913,182.6,1361050102110,1361050102174,1471483554,1471483618,64
1361050109,1471490444,5,1201,240.2,1361050102110,1361050102238,1471483554,1471483682,128
1361050109,1471490444,4,1554,388.5,1361050102045,1361050102109,1471483489,1471483553,64
1361050109,1471490444,6,994,165.6666667,1361050102045,1361050102173,1471483489,1471483617,128
1361050109,1471490444,4,680,170,1361050102045,1361050102173,1471483489,1471483617,128
1361050109,1471490444,4,414,103.5,1361050106013,1361050106077,1471487457,1471487521,64
1361050109,1471490444,5,1314,262.8,1361050102109,1361050102173,1471483553,1471483617,64
1361050109,1471490444,8,2913,364.125,1361050102173,1361050102429,1471483617,1471483873,256
1361050109,1471490444,3,164,54.66666667,1361050102173,1361050102237,1471483617,1471483681,64
1361050109,1471490444,6,1709,284.8333333,1361050102172,1361050102300,1471483616,1471483744,128
1361050109,1471490444,5,1982,396.4,1361050102108,1361050102236,1471483552,1471483680,128
1361050109,1471490444,4,869,217.25,1361050102172,1361050102236,1471483616,1471483680,64
1361050109,1471490444,6,1549,258.1666667,1361050102236,1361050102364,1471483680,1471483808,128
1361050109,1471490444,6,2445,407.5,1361050102172,1361050102300,1471483616,1471483744,128
1361050109,1471490444,5,573,114.6,1361050102236,1361050102620,1471483680,1471484064,384
1361050109,1471490444,5,2828,565.6,1361050102300,1361050102492,1471483744,1471483936,192
1361050109,1471490448,4,955,238.75,1361050102360,1361050102488,1471483808,1471483936,128
1361050109,1471490448,7,2252,321.7142857,1361050106139,1361050107163,1471487587,1471488611,1024
1361050109,1471490448,5,1890,378,1361050102299,1361050102427,1471483747,1471483875,128
1361050109,1471490448,6,1869,311.5,1361050102299,1361050102427,1471483747,1471483875,128
1361050109,1471490448,3,969,323,1361050106203,1361050106267,1471487651,1471487715,64
1361050109,1471490448,5,613,122.6,1361050102427,1361050102427,1471483875,1471483875,0
1361050109,1471490448,8,3468,433.5,1361050106267,1361050106523,1471487715,1471487971,256
1361050109,1471490448,3,1410,470,1361050102490,1361050102682,1471483938,1471484130,192
1361050109,1471490448,10,2915,291.5,1361050102490,1361050102810,1471483938,1471484258,320
1361050109,1471490448,13,6005,461.9230769,1361050102681,1361050103065,1471484129,1471484513,384
1361050109,1471490448,5,1020,204,1361050102617,1361050103129,1471484065,1471484577,512
1361050109,1471490448,11,5900,536.3636364,1361050102681,1361050103065,1471484129,1471484513,384
1361050109,1471490448,9,3380,375.5555556,1361050106777,1361050107225,1471488225,1471488673,448
1361050109,1471490448,5,594,118.8,1361050106585,1361050106585,1471488033,1471488033,0
1361050109,1471490452,8,3208,401,1361050102871,1361050103255,1471484323,1471484707,384
1361050109,1471490452,3,635,211.6666667,1361050102935,1361050103063,1471484387,1471484515,128
1361050109,1471490452,3,634,211.3333333,1361050103127,1361050103127,1471484579,1471484579,0
1361050109,1471490452,7,1777,253.8571429,1361050103062,1361050103190,1471484514,1471484642,128
1361050109,1471490452,6,2244,374,1361050103253,1361050103381,1471484705,1471484833,128
1361050109,1471490452,5,839,167.8,1361050103253,1361050103381,1471484705,1471484833,128
1361050109,1471490452,3,608,202.6666667,1361050107221,1361050107285,1471488673,1471488737,64
1361050109,1471490452,4,645,161.25,1361050107221,1361050107477,1471488673,1471488929,256
1361050109,1471490452,5,2717,543.4,1361050107349,1361050107413,1471488801,1471488865,64
1361050109,1471490452,3,827,275.6666667,1361050107412,1361050107476,1471488864,1471488928,64
1361050109,1471490452,3,608,202.6666667,1361050103252,1361050103252,1471484704,1471484704,0
1361050109,1471490476,4,777,194.25,1361050103420,1361050103484,1471484896,1471484960,64
1361050109,1471490476,5,816,163.2,1361050103484,1361050103676,1471484960,1471485152,192
1361050109,1471490480,3,961,320.3333333,1361050107450,1361050107514,1471488930,1471488994,64
1361050109,1471490480,5,955,191,1361050107577,1361050107641,1471489057,1471489121,64
1361050109,1471490480,3,880,293.3333333,1361050107512,1361050107576,1471488992,1471489056,64
1361050109,1471490480,5,573,114.6,1361050107640,1361050107832,1471489120,1471489312,192
1361050109,1471490480,5,1760,352,1361050107832,1361050108024,1471489312,1471489504,192
1361050109,109803260,6,1810,301.6666667,1361050108838,1361050108902,109803098,109803162,64
1361050111,109805704,4,641,160.25,1361050103145,1361050103337,109797849,109798041,192
1361050111,109805704,5,1374,274.8,1361050106024,1361050107048,109800728,109801752,1024
1361050111,109805704,4,1225,306.25,1361050106791,1361050107047,109801495,109801751,256
1361050111,109805704,9,3052,339.1111111,1361050107111,1361050107367,109801815,109802071,256
1361050111,109805708,4,641,160.25,1361050108389,1361050108453,109803097,109803161,64
1361050111,109805708,5,516,103.2,1361050108453,1361050108645,109803161,109803353,192
1361050111,109805708,11,10406,946,1361050104485,1361050105893,109799193,109800601,1408
1361050111,109805708,7,1880,268.5714286,1361050103140,1361050103332,109797848,109798040,192
1361050111,109805708,5,1374,274.8,1361050109411,1361050110115,109804119,109804823,704
1361050111,109805708,5,1277,255.4,1361050110115,1361050110179,109804823,109804887,64
1361050111,109805708,4,641,160.25,1361050107107,1361050107363,109801815,109802071,256
1361050111,109805708,5,1374,274.8,1361050110435,1361050110627,109805143,109805335,192
1361050111,109805708,4,464,116,1361050107362,1361050107874,109802070,109802582,512
1361050111,109805708,20,23285,1164.25,1361050110434,1361050110626,109805142,109805334,192
1361050111,109805708,5,1336,267.2,1361050102630,1361050103142,109797338,109797850,512
1361050111,109805712,4,1117,279.25,1361050102817,1361050103137,109797529,109797849,320
1361050117,1471498392,5,955,191,1361050108946,1361050109010,1471490338,1471490402,64
1361050117,1471498392,5,573,114.6,1361050109009,1361050109137,1471490401,1471490529,128
1361050117,1471498400,1302,1849801,1420.738095,1361050108553,1361050112073,1471489953,1471493473,3520
1361050117,1471498400,7,1515,216.4285714,1361050108808,1361050109576,1471490208,1471490976,768
1361050117,1471498404,4,651,162.75,1361050109575,1361050110279,1471490979,1471491683,704
1361050117,1471498404,5,1421,284.2,1361050109639,1361050110279,1471491043,1471491683,640
1361050117,1471498404,5,824,164.8,1361050108807,1361050108935,1471490211,1471490339,128
1361050117,1471498404,6,2320,386.6666667,1361050108806,1361050110278,1471490210,1471491682,1472
1361050117,1471498404,7,3241,463,1361050109956,1361050110340,1471491360,1471491744,384
1361050117,1471498404,5,455,91,1361050101828,1361050113540,1471483232,1471494944,11712
1361050117,1471498408,4,592,148,1361050110592,1361050110784,1471492000,1471492192,192
1361050117,1471498412,3,279,93,1361050110847,1361050110975,1471492259,1471492387,128
1361050117,1471498424,5,913,182.6,1361050111152,1361050111216,1471492576,1471492640,64
1361050117,1471498424,5,824,164.8,1361050111216,1361050111344,1471492640,1471492768,128
1361050117,1471498428,6,1142,190.3333333,1361050111279,1361050111343,1471492707,1471492771,64
1361050117,1471498428,5,955,191,1361050111406,1361050111470,1471492834,1471492898,64
1361050117,1471498444,6,2446,407.6666667,1361050109661,1361050109789,1471491105,1471491233,128
1361050117,1471498444,13,5703,438.6923077,1361050109661,1361050110493,1471491105,1471491937,832
1361050117,1471498468,5,2633,526.6,1361050109764,1361050110212,1471491232,1471491680,448
1361050117,1471498472,8,3402,425.25,1361050110015,1361050110207,1471491487,1471491679,192
1361050117,1471498472,5,1018,203.6,1361050110147,1361050110211,1471491619,1471491683,64
1361050117,1471498472,6,2508,418,1361050110274,1361050110722,1471491746,1471492194,448
1361050117,1471498472,18,21404,1189.111111,1361050110529,1361050110721,1471492001,1471492193,192
1361050117,1471498472,12,6022,501.8333333,1361050110593,1361050110913,1471492065,1471492385,320
1361050117,1471498472,12,6024,502,1361050110593,1361050110913,1471492065,1471492385,320
1361050117,1471498472,7,2326,332.2857143,1361050110720,1361050111104,1471492192,1471492576,384
1361050117,1471498476,3,608,202.6666667,1361050110719,1361050110783,1471492195,1471492259,64
1361050117,1471498476,6,2814,469,1361050110719,1361050111103,1471492195,1471492579,384
1361050117,1471498476,4,645,161.25,1361050110719,1361050110847,1471492195,1471492323,128
1361050117,1471498476,6,3186,531,1361050110975,1361050111103,1471492451,1471492579,128
1361050117,1471498476,5,1669,333.8,1361050111039,1361050111103,1471492515,1471492579,64
1361050117,1471498476,4,777,194.25,1361050111102,1361050111166,1471492578,1471492642,64
1361050117,1471498476,4,607,151.75,1361050111102,1361050111230,1471492578,1471492706,128
1361050117,1471498476,5,573,114.6,1361050111293,1361050111485,1471492769,1471492961,192
1361050119,109813700,8,2175,271.875,1361050110636,1361050111020,109805336,109805720,384
1361050119,109813704,4,641,160.25,1361050110631,1361050111015,109805335,109805719,384
1361050124,1471505404,1,46,46,1361050096135,1361050096135,1471477539,1471477539,0
1361050124,1471505492,1,52,52,1361050096045,1361050096045,1471477537,1471477537,0
1361050124,1471505532,1,46,46,1361050097605,1361050097605,1471479137,1471479137,0
1361050124,1471505576,1,63,63,1361050099354,1361050099354,1471480930,1471480930,0
1361050125,109819196,1,52,52,1361050098851,1361050098851,109793047,109793047,0
1361050128,1471509528,1,52,52,1361050103113,1361050103113,1471484641,1471484641,0
1361050128,1471509532,1,60,60,1361050103685,1361050103685,1471485217,1471485217,0
1361050128,1471509536,1,60,60,1361050103683,1361050103683,1471485219,1471485219,0
1361050128,1471509568,1,63,63,1361050101473,1361050101473,1471483041,1471483041,0
1361050128,1471509568,1,46,46,1361050101663,1361050101663,1471483231,1471483231,0
1361050128,1471509620,1,46,46,1361050103659,1361050103659,1471485279,1471485279,0
1361050130,1471511692,1,60,60,1361050103526,1361050103526,1471485218,1471485218,0
1361050130,1471511692,1,48,48,1361050103590,1361050103590,1471485282,1471485282,0
1361050132,1471513428,2,104,52,1361050104235,1361050111403,1471485663,1471492831,7168
1361050132,1471513520,1,46,46,1361050104592,1361050104592,1471486112,1471486112,0
1361050133,1471514424,6,4259,709.8333333,1361050108017,1361050126705,1471489441,1471508129,18688
1361050133,1471514460,3,608,202.6666667,1361050126669,1361050126733,1471508129,1471508193,64
1361050133,1471514460,5,1152,230.4,1361050126668,1361050126732,1471508128,1471508192,64
1361050133,1471514460,3,603,201,1361050126668,1361050132812,1471508128,1471514272,6144
1361050133,1471514516,5,1152,230.4,1361050126679,1361050126743,1471508195,1471508259,64
1361050136,1471517548,1,52,52,1361050111156,1361050111156,1471492704,1471492704,0
1361050136,1471517552,3,215,71.66666667,1361050111282,1361050111346,1471492834,1471492898,64
1361050136,1471517640,1,52,52,1361050111064,1361050111064,1471492704,1471492704,0
1361050136,1471517640,5,2414,482.8,1361050111128,1361050111384,1471492768,1471493024,256
1361050136,1471517640,25,32222,1288.88,1361050110936,1361050111000,1471492576,1471492640,64
1361050136,1471517644,7,5804,829.1428571,1361050111123,1361050111187,1471492767,1471492831,64
1361050137,109831172,19,7642,402.2105263,1361050111742,1361050135870,109805914,109830042,24128
1361050137,109831216,14,16245,1160.357143,1361050111505,1361050111569,109805721,109805785,64
1361050141,1471522412,3,1046,348.6666667,1361050135999,1361050135999,1471517411,1471517411,0
1361050141,1471522412,7,3422,488.8571429,1361050136126,1361050136382,1471517538,1471517794,256
1361050141,1471522412,3,1054,351.3333333,1361050135998,1361050136062,1471517410,1471517474,64
1361050141,1471522412,5,960,192,1361050140030,1361050140094,1471521442,1471521506,64
1361050141,1471522412,7,1485,212.1428571,1361050140093,1361050140797,1471521505,1471522209,704
1361050141,1471522416,5,594,118.8,1361050136378,1361050136442,1471517794,1471517858,64
1361050141,1471522416,5,2501,500.2,1361050136378,1361050136698,1471517794,1471518114,320
1361050141,1471522416,5,984,196.8,1361050136632,1361050136696,1471518048,1471518112,64
1361050141,1471522416,10,6406,640.6,1361050136695,1361050138231,1471518111,1471519647,1536
1361050141,1471522452,22,11471,521.4090909,1361050138773,1361050138965,1471520225,1471520417,192
1361050141,1471522452,15,10792,719.4666667,1361050138837,1361050138965,1471520289,1471520417,128
1361050141,1471522452,6,2230,371.6666667,1361050139091,1361050139219,1471520543,1471520671,128
1361050141,1471522456,3,898,299.3333333,1361050135827,1361050135891,1471517283,1471517347,64
1361050141,1471522456,3,968,322.6666667,1361050139347,1361050139347,1471520803,1471520803,0
1361050141,1471522456,3,893,297.6666667,1361050139474,1361050139474,1471520930,1471520930,0
1361050141,1471522456,7,3422,488.8571429,1361050139474,1361050139730,1471520930,1471521186,256
1361050141,1471522456,4,704,176,1361050127697,1361050133905,1471509153,1471515361,6208
1361050141,1471522456,8,2550,318.75,1361050139281,1361050139409,1471520737,1471520865,128
1361050141,1471522456,8,2984,373,1361050139473,1361050140049,1471520929,1471521505,576
1361050141,1471522456,5,594,118.8,1361050139727,1361050139791,1471521183,1471521247,64
1361050141,1471522456,5,2501,500.2,1361050139791,1361050140047,1471521247,1471521503,256
1361050141,1471522460,3,951,317,1361050136014,1361050136078,1471517474,1471517538,64
1361050141,1471522488,5,453,90.6,1361050133423,1361050133487,1471514911,1471514975,64
1361050141,1471522496,11,8890,808.1818182,1361050138217,1361050138729,1471519713,1471520225,512
1361050141,1471522496,9,7776,864,1361050134824,1361050135336,1471516320,1471516832,512
1361050141,1471522500,4,652,163,1361050138726,1361050138854,1471520226,1471520354,128
1361050141,1471522500,15,15982,1065.466667,1361050135526,1361050135782,1471517026,1471517282,256
1361050141,1471522500,6,2230,371.6666667,1361050138789,1361050138917,1471520289,1471520417,128
1361050141,1471522500,15,10792,719.4666667,1361050135717,1361050136613,1471517217,1471518113,896
1361050141,1471522500,20,11422,571.1,1361050135588,1361050135716,1471517088,1471517216,128
1361050141,1471522500,8,2538,317.25,1361050139108,1361050139236,1471520608,1471520736,128
1361050141,1471522500,8,3046,380.75,1361050139300,1361050139940,1471520800,1471521440,640
1361050141,1471522500,3,976,325.3333333,1361050139300,1361050139364,1471520800,1471520864,64
1361050141,1471522504,4,652,163,1361050138978,1361050139106,1471520482,1471520610,128
1361050141,1471522504,13,5369,413,1361050139106,1361050139618,1471520610,1471521122,512
1361050141,1471522504,3,840,280,1361050139169,1361050139233,1471520673,1471520737,64
1361050143,109837708,11,10406,946,1361050135654,1361050135718,109830362,109830426,64
1361050143,109837708,6,3588,598,1361050139878,1361050139942,109834586,109834650,64
1361050143,109837708,8,2786,348.25,1361050135334,1361050135654,109830042,109830362,320
1361050143,109837712,11,10406,946,1361050138786,1361050139042,109833498,109833754,256
1361050149,1471530436,5,2467,493.4,1361050148196,1361050148452,1471529632,1471529888,256
1361050149,1471530436,8,3060,382.5,1361050148195,1361050148515,1471529631,1471529951,320
1361050149,1471530440,4,682,170.5,1361050148447,1361050148511,1471529887,1471529951,64
1361050149,1471530444,6,2446,407.6666667,1361050148507,1361050148635,1471529951,1471530079,128
1361050149,1471530480,20,8297,414.85,1361050146490,1361050146682,1471527970,1471528162,192
1361050149,1471530480,3,1000,333.3333333,1361050146553,1361050146617,1471528033,1471528097,64
1361050149,1471530480,5,680,136,1361050147191,1361050148087,1471528671,1471529567,896
1361050149,1471530492,4,606,151.5,1361050148398,1361050148654,1471529890,1471530146,256
1361050149,1471530492,4,1636,409,1361050148398,1361050148590,1471529890,1471530082,192
1361050149,1471530516,6,720,120,1361050140755,1361050141203,1471522271,1471522719,448
1361050149,1471530524,9,8376,930.6666667,1361050145741,1361050146253,1471527265,1471527777,512
1361050149,1471530528,3,854,284.6666667,1361050146311,1361050146375,1471527839,1471527903,64
1361050149,1471530528,3,992,330.6666667,1361050146442,1361050146442,1471527970,1471527970,0
1361050149,1471530528,22,8307,377.5909091,1361050146442,1361050146634,1471527970,1471528162,192
1361050149,1471530528,3,907,302.3333333,1361050146569,1361050146633,1471528097,1471528161,64
1361050149,1471530528,18,14066,781.4444444,1361050146633,1361050146825,1471528161,1471528353,192
1361050149,1471530528,7,3422,488.8571429,1361050146633,1361050146889,1471528161,1471528417,256
1361050149,1471530528,3,502,167.3333333,1361050146952,1361050146952,1471528480,1471528480,0
1361050149,1471530528,5,2501,500.2,1361050146952,1361050148040,1471528480,1471529568,1088
1361050149,1471530528,7,2229,318.4285714,1361050147144,1361050148104,1471528672,1471529632,960
1361050149,1471530528,7,1510,215.7142857,1361050147272,1361050148040,1471528800,1471529568,768
1361050151,109845696,4,1156,289,1361050149362,1361050149426,109844058,109844122,64
1361050151,109845700,4,1156,289,1361050148014,1361050148078,109842714,109842778,64
1361050151,109845700,12,12813,1067.75,1361050148717,1361050149357,109843417,109844057,640
1361050151,109845700,4,464,116,1361050149420,1361050149868,109844120,109844568,448
1361050151,109845704,11,10406,946,1361050146602,1361050146666,109841306,109841370,64
1361050151,109845704,4,464,116,1361050148072,1361050148392,109842776,109843096,320
1361050152,1471533492,1,46,46,1361050126638,1361050126638,1471508130,1471508130,0
1361050152,1471533492,3,503,167.6666667,1361050126637,1361050126701,1471508129,1471508193,64
1361050152,1471533492,5,667,133.4,1361050126765,1361050151789,1471508257,1471533281,25024
1361050152,1471533604,5,667,133.4,1361050126587,1361050151675,1471508191,1471533279,25088
1361050152,1471533604,25,31899,1275.96,1361050126845,1361050127485,1471508449,1471509089,640
1361050157,1471538468,7,1580,225.7142857,1361050149062,1361050149510,1471530530,1471530978,448
1361050157,1471538472,5,2633,526.6,1361050148609,1361050149505,1471530081,1471530977,896
1361050157,1471538472,5,1507,301.4,1361050149504,1361050149952,1471530976,1471531424,448
1361050157,1471538472,3,1000,333.3333333,1361050149568,1361050149568,1471531040,1471531040,0
1361050157,1471538472,3,907,302.3333333,1361050149567,1361050149631,1471531039,1471531103,64
1361050157,1471538476,7,3422,488.8571429,1361050149627,1361050149883,1471531103,1471531359,256
1361050157,1471538476,9,3369,374.3333333,1361050149566,1361050149950,1471531042,1471531426,384
1361050157,1471538476,5,1100,220,1361050149757,1361050150013,1471531233,1471531489,256
1361050157,1471538480,11,6898,627.0909091,1361050150007,1361050151351,1471531487,1471532831,1344
1361050157,1471538480,12,4368,364,1361050150392,1361050151352,1471531872,1471532832,960
1361050157,1471538504,3,854,284.6666667,1361050151138,1361050151138,1471532642,1471532642,0
1361050157,1471538504,3,992,330.6666667,1361050151202,1361050151266,1471532706,1471532770,64
1361050157,1471538504,3,907,302.3333333,1361050151330,1361050151330,1471532834,1471532834,0
1361050157,1471538508,5,594,118.8,1361050151774,1361050151774,1471533282,1471533282,0
1361050157,1471538512,2610,3710898,1421.8,1361050124825,1361050149977,1471506337,1471531489,25152
1361050157,1471538512,3,279,93,1361050151961,1361050152089,1471533473,1471533601,128
1361050157,1471538520,3,1447,482.3333333,1361050148562,1361050149458,1471530082,1471530978,896
1361050157,1471538520,3,854,284.6666667,1361050149393,1361050149457,1471530913,1471530977,64
1361050157,1471538520,3,992,330.6666667,1361050149457,1361050149521,1471530977,1471531041,64
1361050157,1471538520,8,3378,422.25,1361050148752,1361050149456,1471530272,1471530976,704
1361050157,1471538544,7,2275,325,1361050150074,1361050151290,1471531618,1471532834,1216
1361050157,1471538544,5,594,118.8,1361050149882,1361050149946,1471531426,1471531490,64
1361050157,1471538544,5,2501,500.2,1361050149882,1361050150074,1471531426,1471531618,192
1361050157,1471538548,4,1636,409,1361050151347,1361050151539,1471532895,1471533087,192
1361050157,1471538552,3,1000,333.3333333,1361050151215,1361050151215,1471532767,1471532767,0
1361050157,1471538552,9,7280,808.8888889,1361050151282,1361050151602,1471532834,1471533154,320
1361050159,109853700,5,1456,291.2,1361050151085,1361050151277,109845785,109845977,192
1361050160,1471541508,1,46,46,1361050133403,1361050133403,1471514911,1471514911,0
1361050160,1471541604,5,2992,598.4,1361050133757,1361050140093,1471515361,1471521697,6336
1361050165,1471546492,9,8270,918.8888889,1361050159854,1361050160878,1471541346,1471542370,1024
1361050165,1471546492,9,7941,882.3333333,1361050159854,1361050160878,1471541346,1471542370,1024
1361050165,1471546492,11,10456,950.5454545,1361050159854,1361050160878,1471541346,1471542370,1024
1361050165,1471546492,4,431,107.75,1361050160045,1361050161005,1471541537,1471542497,960
1361050165,1471546500,11,4558,414.3636364,1361050156326,1361050160870,1471537826,1471542370,4544
1361050165,1471546508,5,1152,230.4,1361050161693,1361050161757,1471543201,1471543265,64
1361050165,1471546532,14,14474,1033.857143,1361050159300,1361050159748,1471540832,1471541280,448
1361050165,1471546536,7,5770,824.2857143,1361050159743,1361050159807,1471541279,1471541343,64
1361050165,1471546536,9,7520,835.5555556,1361050159743,1361050159807,1471541279,1471541343,64
1361050165,1471546536,9,8296,921.7777778,1361050159746,1361050159810,1471541282,1471541346,64
1361050165,1471546548,2764,3937285,1424.488061,1361050141430,1361050161910,1471522978,1471543458,20480
1361050165,1471546572,3,608,202.6666667,1361050161500,1361050161564,1471543072,1471543136,64
1361050165,1471546572,6,1198,199.6666667,1361050161563,1361050161627,1471543135,1471543199,64
1361050165,1471546580,16,7165,447.8125,1361050162198,1361050162454,1471543778,1471544034,256
1361050165,1471546580,6,4259,709.8333333,1361050151701,1361050161493,1471533281,1471543073,9792
1361050165,1471546580,18,21423,1190.166667,1361050151701,1361050161813,1471533281,1471543393,10112
1361050167,109861704,33,40416,1224.727273,1361050160874,1361050161002,109855578,109855706,128
1361050173,1471554516,2,104,52,1361050171158,1361050171286,1471552674,1471552802,128
1361050173,1471554560,4,649,162.25,1361050161578,1361050169834,1471543138,1471551394,8256
1361050173,1471554560,5,453,90.6,1361050169833,1361050169897,1471551393,1471551457,64
1361050176,1471557564,2,1400,700,1361050151524,1361050151652,1471533088,1471533216,128
1361050176,1471557564,3,540,180,1361050151715,1361050151715,1471533279,1471533279,0
1361050176,1471557568,10,6311,631.1,1361050151778,1361050161634,1471533346,1471543202,9856
1361050176,1471557568,2,555,277.5,1361050151777,1361050151777,1471533345,1471533345,0
1361050176,1471557572,1,46,46,1361050147996,1361050147996,1471529568,1471529568,0
1361050181,1471562520,7,4537,648.1428571,1361050178257,1361050178321,1471559777,1471559841,64
1361050181,1471562520,9,8556,950.6666667,1361050178257,1361050178321,1471559777,1471559841,64
1361050181,1471562572,31,38583,1244.612903,1361050161820,1361050175580,1471543392,1471557152,13760
1361050181,1471562572,11,10650,968.1818182,1361050161884,1361050174876,1471543456,1471556448,12992
1361050181,1471562572,13,13149,1011.461538,1361050178203,1361050178267,1471559775,1471559839,64
1361050181,1471562576,9,8687,965.2222222,1361050175575,1361050175575,1471557151,1471557151,0
1361050183,109877696,5,1258,251.6,1361050174962,1361050175602,109869658,109870298,640
1361050184,1471565616,1,52,52,1361050159662,1361050159662,1471541278,1471541278,0
1361050184,1471565704,1,52,52,1361050159129,1361050159129,1471540833,1471540833,0
1361050184,1471565704,1,52,52,1361050159127,1361050159127,1471540831,1471540831,0
1361050188,1471569564,1,52,52,1361050161510,1361050161510,1471543074,1471543074,0
1361050188,1471569572,1,52,52,1361050162142,1361050162142,1471543714,1471543714,0
1361050188,1471569648,3,503,167.6666667,1361050161425,1361050161489,1471543073,1471543137,64
1361050188,1471569648,3,563,187.6666667,1361050161679,1361050161743,1471543327,1471543391,64
1361050188,1471569716,1,52,52,1361050163404,1361050163404,1471545120,1471545120,0
1361050189,1471570484,7,5139,734.1428571,1361050188531,1361050188595,1471570015,1471570079,64
1361050189,1471570484,6,3837,639.5,1361050188530,1361050188594,1471570014,1471570078,64
1361050189,1471570484,7,5445,777.8571429,1361050188530,1361050188594,1471570014,1471570078,64
1361050189,1471570488,9,7663,851.4444444,1361050181488,1361050181488,1471562976,1471562976,0
1361050189,1471570524,10,9282,928.2,1361050183501,1361050184845,1471565025,1471566369,1344
1361050189,1471570536,8,6573,821.625,1361050188480,1361050188544,1471570016,1471570080,64
1361050189,1471570536,5,2560,512,1361050188480,1361050188544,1471570016,1471570080,64
1361050189,1471570560,7,5235,747.8571429,1361050188458,1361050188522,1471570018,1471570082,64
1361050189,1471570560,5,2309,461.8,1361050188458,1361050188522,1471570018,1471570082,64
1361050189,1471570560,11,10897,990.6363636,1361050188458,1361050188522,1471570018,1471570082,64
1361050189,1471570560,5,453,90.6,1361050184809,1361050184873,1471566369,1471566433,64
1361050189,1471570560,10,9744,974.4,1361050181351,1361050181415,1471562911,1471562975,64
1361050189,1471570560,12,12466,1038.833333,1361050181415,1361050181415,1471562975,1471562975,0
1361050189,1471570572,4107,5851993,1424.882639,1361050175070,1361050186014,1471556642,1471567586,10944
1361050189,1471570572,12,12395,1032.916667,1361050183451,1361050184795,1471565023,1471566367,1344
1361050189,1471570572,8,6986,873.25,1361050183451,1361050184795,1471565023,1471566367,1344
1361050189,1471570596,19,22062,1161.157895,1361050175554,1361050181378,1471557150,1471562974,5824
1361050196,1471577644,5,1048,209.6,1361050169810,1361050170386,1471551454,1471552030,576
1361050196,1471577644,3,554,184.6666667,1361050169814,1361050169942,1471551458,1471551586,128
1361050196,1471577680,1,52,52,1361050171121,1361050171121,1471552801,1471552801,0
1361050197,1471578492,2,92,46,1361050192171,1361050193195,1471573663,1471574687,1024
1361050205,1471586544,5,453,90.6,1361050199863,1361050199927,1471581407,1471581471,64
1361050220,1471601532,1,46,46,1361050192772,1361050192772,1471574304,1471574304,0
1361050220,1471601692,1,46,46,1361050194722,1361050194722,1471576414,1471576414,0
1361050220,1471601700,1,46,46,1361050195291,1361050195291,1471576991,1471576991,0
1361050221,1471602560,6,690,115,1361050215016,1361050215336,1471596576,1471596896,320
1361050232,1471613896,9,8901,989,1361050204823,1361050204823,1471586719,1471586719,0
1361050245,1471626564,4,401,100.25,1361050244834,1361050244834,1471626398,1471626398,0
1361050257,1471637924,1,52,52,1361050229989,1361050229989,1471610913,1471610913,0
1361050257,1471638044,1,52,52,1361050230892,1361050230892,1471611936,1471611936,0
1361050265,109959500,1,52,52,1361050238901,1361050238901,109933401,109933401,0
1361050273,1471653936,1,52,52,1361050245526,1361050245526,1471626462,1471626462,0
1361050277,1471658628,2,92,46,1361050274722,1361050274722,1471656350,1471656350,0
1361050277,1471658632,2,104,52,1361050274781,1361050274781,1471656413,1471656413,0
1361050277,1471658632,2,104,52,1361050274785,1361050274785,1471656417,1471656417,0
1361050277,1471658632,2,92,46,1361050274721,1361050274721,1471656353,1471656353,0
1361050277,1471658632,2,92,46,1361050274785,1361050274785,1471656417,1471656417,0
1361050277,1471658680,2,92,46,1361050274669,1361050274669,1471656349,1471656349,0
1361050277,1471658684,2,92,46,1361050274665,1361050274665,1471656349,1471656349,0
1361050277,1471658684,2,92,46,1361050274729,1361050274729,1471656413,1471656413,0
1361050277,1471658684,2,92,46,1361050274729,1361050274729,1471656413,1471656413,0
1361050293,1471674660,5,453,90.6,1361050289732,1361050289796,1471671392,1471671456,64
1361050301,1471682000,1,52,52,1361050275350,1361050275350,1471656350,1471656350,0
1361050301,1471682000,1,52,52,1361050275350,1361050275350,1471656350,1471656350,0
1361050301,1471682000,1,52,52,1361050275349,1361050275349,1471656349,1471656349,0
1361050301,1471682000,1,52,52,1361050275413,1361050275413,1471656413,1471656413,0
1361050301,1471682000,1,52,52,1361050275413,1361050275413,1471656413,1471656413,0
1361050301,1471682000,1,46,46,1361050275413,1361050275413,1471656413,1471656413,0
1361050301,1471682000,1,46,46,1361050275413,1361050275413,1471656413,1471656413,0
1361050301,1471682000,1,52,52,1361050275413,1361050275413,1471656413,1471656413,0
1361050301,1471682000,1,46,46,1361050275413,1361050275413,1471656413,1471656413,0
1361050301,1471682004,1,46,46,1361050275409,1361050275409,1471656413,1471656413,0
1361050301,1471682004,1,46,46,1361050275409,1361050275409,1471656413,1471656413,0
1361050301,1471682004,1,52,52,1361050275412,1361050275412,1471656416,1471656416,0
1361050301,1471682004,1,52,52,1361050275348,1361050275348,1471656352,1471656352,0
1361050301,1471682004,1,46,46,1361050275347,1361050275347,1471656351,1471656351,0
1361050301,1471682004,1,52,52,1361050275411,1361050275411,1471656415,1471656415,0
1361050301,1471682004,1,52,52,1361050275411,1361050275411,1471656415,1471656415,0
1361050301,1471682004,1,46,46,1361050275411,1361050275411,1471656415,1471656415,0
1361050301,1471682084,1,52,52,1361050275268,1361050275268,1471656352,1471656352,0
1361050301,1471682084,1,52,52,1361050275268,1361050275268,1471656352,1471656352,0
1361050301,1471682084,1,52,52,1361050275268,1361050275268,1471656352,1471656352,0
1361050301,1471682084,1,52,52,1361050275268,1361050275268,1471656352,1471656352,0
1361050301,1471682084,1,46,46,1361050275268,1361050275268,1471656352,1471656352,0
1361050301,1471682084,1,46,46,1361050275332,1361050275332,1471656416,1471656416,0
1361050301,1471682084,1,46,46,1361050275332,1361050275332,1471656416,1471656416,0
1361050301,1471682084,5,400,80,1361050275331,1361050290307,1471656415,1471671391,14976
1361050301,1471682084,1,46,46,1361050275331,1361050275331,1471656415,1471656415,0
1361050301,1471682084,1,46,46,1361050275331,1361050275331,1471656415,1471656415,0
1361050301,1471682084,1,46,46,1361050275395,1361050275395,1471656479,1471656479,0
1361050301,1471682104,1,46,46,1361050275248,1361050275248,1471656352,1471656352,0
1361050301,1471682104,1,46,46,1361050275248,1361050275248,1471656352,1471656352,0
1361050301,1471682104,1,46,46,1361050275312,1361050275312,1471656416,1471656416,0
1361050301,1471682104,1,46,46,1361050275312,1361050275312,1471656416,1471656416,0
1361050301,1471682104,1,52,52,1361050275312,1361050275312,1471656416,1471656416,0
1361050301,1471682104,1,46,46,1361050275309,1361050275309,1471656413,1471656413,0
1361050301,1471682108,1,52,52,1361050275308,1361050275308,1471656416,1471656416,0
1361050301,109995464,1,52,52,1361050275097,1361050275097,109969561,109969561,0
1361050301,109995464,1,52,52,1361050275097,1361050275097,109969561,109969561,0
1361050301,109995468,1,52,52,1361050275031,1361050275031,109969499,109969499,0
1361050301,109995468,1,52,52,1361050275095,1361050275095,109969563,109969563,0
1361050301,109995584,1,52,52,1361050274915,1361050274915,109969499,109969499,0
1361050301,109995584,1,46,46,1361050274979,1361050274979,109969563,109969563,0
1361050301,109995584,1,52,52,1361050274976,1361050274976,109969560,109969560,0
1361050301,109995584,1,52,52,1361050274976,1361050274976,109969560,109969560,0
1361050333,1471714092,1,80,80,1361050306299,1361050306299,1471687391,1471687391,0
1361050365,1471746196,1,80,80,1361050338259,1361050338259,1471719455,1471719455,0
1361050366,1471747048,5,453,90.6,1361050365351,1361050365415,1471746399,1471746463,64
1361050429,1471810348,1,80,80,1361050402169,1361050402169,1471783517,1471783517,0
1361050449,1471830524,9,684,76,1361050422857,1361050438857,1471804381,1471820381,16000
1361050469,1471850664,1,46,46,1361050442749,1361050442749,1471824413,1471824413,0
1361050493,1471874672,1,80,80,1361050465909,1361050465909,1471847581,1471847581,0
1361050501,110195672,3,586,195.3333333,1361050474059,1361050474059,110168731,110168731,0
1361050501,1471882704,37,49510,1338.108108,1361050473877,1361050473941,1471855581,1471855645,64
1361050502,1471883188,5,453,90.6,1361050500182,1361050500310,1471881370,1471881498,128
1361050529,110223912,1,52,52,1361050503769,1361050503769,110198681,110198681,0
1361050529,1471910764,1,52,52,1361050503767,1361050503767,1471885531,1471885531,0
1361050557,1471938892,1,80,80,1361050529814,1361050529814,1471911706,1471911706,0
1361050590,1471971316,4,349,87.25,1361050587800,1361050587864,1471969116,1471969180,64
1361050590,1471971352,8,2575,321.875,1361050586547,1361050589811,1471967899,1471971163,3264
1361050598,1471979368,4,523,130.75,1361050589796,1361050589860,1471971164,1471971228,64
1361050598,1471979372,9,1672,185.7777778,1361050586525,1361050592285,1471967897,1471973657,5760
1361050598,1471979380,6,1376,229.3333333,1361050595733,1361050595797,1471977113,1471977177,64
1361050606,1471987328,6,1376,229.3333333,1361050598092,1361050598156,1471979420,1471979484,64
1361050613,1471994816,54,65802,1218.555556,1361050585571,1361050597539,1471967387,1471979355,11968
1361050613,1471994844,26,30268,1164.153846,1361050586053,1361050601093,1471967897,1471982937,15040
1361050613,1471994848,17,8385,493.2352941,1361050586369,1361050597505,1471968217,1471979353,11136
1361050613,1471994852,14,14544,1038.857143,1361050586558,1361050601086,1471968410,1471982938,14528
1361050613,1471994856,3,304,101.3333333,1361050586811,1361050586811,1471968667,1471968667,0
1361050613,1471994888,14,11791,842.2142857,1361050587675,1361050588123,1471969563,1471970011,448
1361050613,1471994896,6,5150,858.3333333,1361050588371,1361050588435,1471970267,1471970331,64
1361050613,1471994900,6,4813,802.1666667,1361050588364,1361050588428,1471970264,1471970328,64
1361050614,1471994960,9,3748,416.4444444,1361050587384,1361050598392,1471968344,1471979352,11008
1361050614,1471994964,16,17598,1099.875,1361050587447,1361050601975,1471968411,1471982939,14528
1361050614,1471994964,6,5312,885.3333333,1361050587447,1361050587511,1471968411,1471968475,64
1361050614,1471994964,15,16898,1126.533333,1361050587447,1361050601975,1471968411,1471982939,14528
1361050614,1471994964,10,10017,1001.7,1361050587446,1361050601974,1471968410,1471982938,14528
1361050614,1471994964,9,8721,969,1361050587446,1361050601462,1471968410,1471982426,14016
1361050614,1471994976,5,1522,304.4,1361050588585,1361050589545,1471969561,1471970521,960
1361050614,1471995008,3,524,174.6666667,1361050588936,1361050588936,1471969944,1471969944,0
1361050614,1471995288,1319,1869603,1417.439727,1361050602419,1361050613107,1471983707,1471994395,10688
1361050614,1471995360,6,1376,229.3333333,1361050607594,1361050607722,1471988954,1471989082,128
1361050617,1471998824,10,1764,176.4,1361050589916,1361050610076,1471971740,1471991900,20160
1361050617,1471998824,5,1504,300.8,1361050589915,1361050600027,1471971739,1471981851,10112
1361050618,1471998936,3,379,126.3333333,1361050590738,1361050590866,1471971674,1471971802,128
1361050622,1472002944,1,80,80,1361050594824,1361050594824,1471975768,1471975768,0
1361050626,1472007004,8,4299,537.375,1361050601421,1361050601677,1471982425,1471982681,256
1361050629,1472010880,8,5176,647,1361050601059,1361050601315,1471982939,1471983195,256
1361050630,1472010968,8,4457,557.125,1361050601971,1361050602291,1471982939,1471983259,320
1361050631,110325756,15,16886,1125.733333,1361050629880,1361050629944,110324636,110324700,64
1361050638,1472019292,16,7165,447.8125,1361050630445,1361050630701,1472011737,1472011993,256
1361050646,1472026980,3,568,189.3333333,1361050620967,1361050621031,1472001947,1472002011,64
1361050646,1472027276,2623,3729436,1421.820816,1361050598205,1361050643517,1471979481,1472024793,45312
1361050650,1472030944,1,89,89,1361050624968,1361050624968,1472005912,1472005912,0
1361050654,1472035340,1312,1862687,1419.730945,1361050613055,1361050650623,1471994395,1472031963,37568
1361050654,1472035372,255,358103,1404.32549,1361050586719,1361050650591,1471968091,1472031963,63872
1361050654,1472035372,235,323671,1377.323404,1361050587036,1361050650588,1471968408,1472031960,63552
1361050654,1472035412,218,305512,1401.431193,1361050587831,1361050650551,1471969243,1472031963,62720
1361050678,1472058984,1,52,52,1361050650979,1361050650979,1472031963,1472031963,0
1361050678,1472058984,1,52,52,1361050650979,1361050650979,1472031963,1472031963,0
1361050678,1472058984,1,52,52,1361050650979,1361050650979,1472031963,1472031963,0
1361050678,1472058984,1,52,52,1361050650979,1361050650979,1472031963,1472031963,0
1361050678,1472058984,1,52,52,1361050650977,1361050650977,1472031961,1472031961,0
1361050678,1472058984,1,52,52,1361050650977,1361050650977,1472031961,1472031961,0
1361050678,1472058984,1,52,52,1361050650977,1361050650977,1472031961,1472031961,0
1361050678,1472058984,1,52,52,1361050650977,1361050650977,1472031961,1472031961,0
1361050678,1472058984,1,52,52,1361050650977,1361050650977,1472031961,1472031961,0
1361050678,1472058984,1,52,52,1361050650977,1361050650977,1472031961,1472031961,0
1361050678,1472058984,1,52,52,1361050650977,1361050650977,1472031961,1472031961,0
1361050678,1472058984,1,52,52,1361050650976,1361050650976,1472031960,1472031960,0
1361050678,1472059096,1,46,46,1361050650863,1361050650863,1472031959,1472031959,0
1361050678,1472059096,1,52,52,1361050650863,1361050650863,1472031959,1472031959,0
1361050678,1472059100,1,52,52,1361050650859,1361050650859,1472031959,1472031959,0
1361050678,1472059100,2,104,52,1361050650859,1361050650859,1472031959,1472031959,0
1361050678,1472059100,1,52,52,1361050650859,1361050650859,1472031959,1472031959,0
1361050678,1472059100,1,52,52,1361050650859,1361050650859,1472031959,1472031959,0
1361050678,1472059100,1,52,52,1361050650859,1361050650859,1472031959,1472031959,0
1361050678,1472059100,1,52,52,1361050650859,1361050650859,1472031959,1472031959,0
1361050678,1472059100,1,52,52,1361050650859,1361050650859,1472031959,1472031959,0
1361050678,1472059100,1,52,52,1361050650859,1361050650859,1472031959,1472031959,0
1361050678,1472059100,1,52,52,1361050650859,1361050650859,1472031959,1472031959,0
1361050686,1472066980,1,80,80,1361050658851,1361050658851,1472039831,1472039831,0
1361050702,1472083640,12,1328,110.6666667,1361050701263,1361050701455,1472082903,1472083095,192
1361050750,1472131348,1,80,80,1361050722610,1361050722610,1472103958,1472103958,0
1361050814,1472195652,1,68,68,1361050786372,1361050786372,1472168024,1472168024,0
1361050902,1472283684,1897,2683473,1414.58777,1361050589601,1361050597793,1471971285,1471979477,8192
1361050902,1472283684,1242,1762904,1419.407407,1361050589665,1361050597601,1471971349,1471979285,7936
1361050963,1472343936,1,76,76,1361050936395,1361050936395,1472317331,1472317331,0
1361050975,1472356064,12,1328,110.6666667,1361050971019,1361050971147,1472352083,1472352211,128
1361050999,1472380336,6,1796,299.3333333,1361050991166,1361050991294,1472372502,1472372630,128
1361051007,1472388164,23,25959,1128.652174,1361050991078,1361051002150,1472372242,1472383314,11072
1361051007,1472388172,5,1594,318.8,1361050995553,1361051001761,1472376725,1472382933,6208
1361051007,1472388212,5,1094,218.8,1361051002873,1361051002937,1472384085,1472384149,64
1361051007,1472388240,5,1093,218.6,1361051003419,1361051003483,1472384659,1472384723,64
1361051007,110701828,7,1140,162.8571429,1361051006002,1361051006834,110700830,110701662,832
1361051007,110701828,5,872,174.4,1361051002289,1361051002353,110697117,110697181,64
1361051007,110701828,11,5208,473.4545455,1361051002352,1361051003056,110697180,110697884,704
1361051007,110701832,11,9022,820.1818182,1361051003056,1361051003440,110697888,110698272,384
1361051015,1472396440,2,92,46,1361051014549,1361051014549,1472395989,1472395989,0
1361051015,110709828,9,7046,782.8888889,1361051014834,1361051014898,110709662,110709726,64
1361051015,110709832,9,1462,162.4444444,1361051013933,1361051014509,110708765,110709341,576
1361051015,110709832,8,1570,196.25,1361051014640,1361051014832,110709472,110709664,192
1361051019,1472400244,6,3532,588.6666667,1361050991834,1361050991962,1472373078,1472373206,128
1361051022,110716476,3,753,251,1361050996305,1361050996305,110690781,110690781,0
1361051022,110716524,9,9520,1057.777778,1361050996324,1361050996388,110690848,110690912,64
1361051023,1472404180,4,727,181.75,1361050996440,1361050998232,1472377620,1472379412,1792
1361051023,1472404256,3,540,180,1361050998155,1361050998155,1472379411,1472379411,0
1361051023,1472404256,3,540,180,1361050998155,1361050998155,1472379411,1472379411,0
1361051023,1472404348,3,540,180,1361050998063,1361050998063,1472379411,1472379411,0
1361051023,1472404348,3,540,180,1361050998063,1361050998063,1472379411,1472379411,0
1361051022,110716544,9,1606,178.4444444,1361051021903,1361051022607,110716447,110717151,704
1361051023,110717944,12,7938,661.5,1361051014975,1361051015231,110709919,110710175,256
1361051023,110717944,9,1350,150,1361051022845,1361051022909,110717789,110717853,64
1361051023,110717944,7,1524,217.7142857,1361051022845,1361051022845,110717789,110717789,0
1361051023,110717944,7,1524,217.7142857,1361051022845,1361051022909,110717789,110717853,64
1361051023,110717944,7,1524,217.7142857,1361051015293,1361051015805,110710237,110710749,512
1361051023,110717944,8,2232,279,1361051015741,1361051016253,110710685,110711197,512
1361051023,110717944,7,1524,217.7142857,1361051016192,1361051016256,110711136,110711200,64
1361051023,110717944,8,1490,186.25,1361051016320,1361051016448,110711264,110711392,128
1361051023,110717944,15,11859,790.6,1361051016320,1361051020160,110711264,110715104,3840
1361051023,110717948,8,1698,212.25,1361051016316,1361051016508,110711264,110711456,192
1361051023,110717948,10,7034,703.4,1361051021050,1361051021178,110715998,110716126,128
1361051023,110717948,7,1486,212.2857143,1361051021433,1361051021497,110716381,110716445,64
1361051023,110717948,15,12019,801.2666667,1361051014969,1361051015225,110709917,110710173,256
1361051023,110717948,8,2232,279,1361051021881,1361051021881,110716829,110716829,0
1361051023,110717948,16,14455,903.4375,1361051022264,1361051022520,110717212,110717468,256
1361051023,110717948,7,1502,214.5714286,1361051022204,1361051022268,110717152,110717216,64
1361051023,110717952,7,1188,169.7142857,1361051022520,1361051022712,110717472,110717664,192
1361051023,110717952,8,1346,168.25,1361051022711,1361051022839,110717663,110717791,128
1361051023,110717952,7,1524,217.7142857,1361051022839,1361051022839,110717791,110717791,0
1361051023,110717952,7,1524,217.7142857,1361051022839,1361051022839,110717791,110717791,0
1361051023,110717952,7,1524,217.7142857,1361051015287,1361051016183,110710239,110711135,896
1361051023,110717952,10,2634,263.4,1361051016310,1361051016630,110711262,110711582,320
1361051023,110717952,7,1524,217.7142857,1361051016182,1361051016246,110711134,110711198,64
1361051023,110717952,9,1718,190.8888889,1361051016310,1361051017078,110711262,110712030,768
1361051023,110717952,10,2474,247.4,1361051016310,1361051016566,110711262,110711518,256
1361051023,110717952,8,1730,216.25,1361051020149,1361051022581,110715101,110717533,2432
1361051023,110717952,9,1350,150,1361051020148,1361051020468,110715100,110715420,320
1361051023,110717956,11,7886,716.9090909,1361051021427,1361051021683,110716383,110716639,256
1361051031,110725956,9,1350,150,1361051025524,1361051025780,110720480,110720736,256
1361051031,110725956,13,8502,654,1361051022898,1361051023090,110717854,110718046,192
1361051031,110725956,9,1350,150,1361051023154,1361051023282,110718110,110718238,128
1361051031,110725956,9,1638,182,1361051022898,1361051023026,110717854,110717982,128
1361051031,110725956,8,1394,174.25,1361051030577,1361051030641,110725533,110725597,64
1361051031,110725956,11,7166,651.4545455,1361051030640,1361051030768,110725596,110725724,128
1361051031,110725960,9,1350,150,1361051028461,1361051028653,110723421,110723613,192
1361051031,110725964,8,1730,216.25,1361051023083,1361051023339,110718047,110718303,256
1361051031,110725964,8,1442,180.25,1361051022891,1361051023019,110717855,110717983,128
1361051031,110725964,9,1510,167.7777778,1361051022891,1361051023019,110717855,110717983,128
1361051039,1472420216,1,46,46,1361051014709,1361051014709,1472395925,1472395925,0
1361051039,1472420396,15,13453,896.8666667,1361051017023,1361051032767,1472398419,1472414163,15744
1361051039,110733944,7,1630,232.8571429,1361051031359,1361051031423,110726303,110726367,64
1361051039,110733944,9,1638,182,1361051031423,1361051031551,110726367,110726495,128
1361051039,110733944,13,10251,788.5384615,1361051031551,1361051031935,110726495,110726879,384
1361051039,110733944,9,1350,150,1361051032062,1361051032190,110727006,110727134,128
1361051039,110733948,11,7886,716.9090909,1361051031353,1361051031545,110726301,110726493,192
1361051039,110733952,8,2232,279,1361051031672,1361051031736,110726624,110726688,64
1361051039,110733952,7,1188,169.7142857,1361051032056,1361051032120,110727008,110727072,64
1361051043,1472424184,6,2036,339.3333333,1361051017490,1361051017682,1472398674,1472398866,192
1361051047,110741952,11,7086,644.1818182,1361051039797,1361051039861,110734749,110734813,64
1361051047,110741952,11,7886,716.9090909,1361051039989,1361051040181,110734941,110735133,192
1361051047,110741952,8,2232,279,1361051040376,1361051040568,110735328,110735520,192
1361051047,110741956,7,1188,169.7142857,1361051040564,1361051040692,110735520,110735648,128
1361051047,110741956,6,1472,245.3333333,1361051040692,1361051040756,110735648,110735712,64
1361051047,110741956,7,1524,217.7142857,1361051040692,1361051040756,110735648,110735712,64
1361051047,110741956,8,1586,198.25,1361051040820,1361051040948,110735776,110735904,128
1361051047,110741956,8,1730,216.25,1361051040947,1361051041203,110735903,110736159,256
1361051047,110741956,12,8514,709.5,1361051040819,1361051040947,110735775,110735903,128
1361051047,110741960,16,14455,903.4375,1361051039983,1361051040303,110734943,110735263,320
1361051047,110741960,8,1346,168.25,1361051040558,1361051040750,110735518,110735710,192
1361051047,110741960,9,1350,150,1361051040622,1361051040750,110735582,110735710,128
1361051047,110741960,7,1524,217.7142857,1361051040686,1361051040750,110735646,110735710,64
1361051047,110741960,7,1524,217.7142857,1361051040750,1361051040750,110735710,110735710,0
1361051047,110741960,8,1442,180.25,1361051040814,1361051040878,110735774,110735838,64
1361051047,110741960,9,1350,150,1361051040941,1361051041197,110735901,110736157,256
1361051047,110741960,9,1510,167.7777778,1361051040813,1361051040877,110735773,110735837,64
1361051055,110749940,7,799,114.1428571,1361051050306,1361051050306,110745246,110745246,0
1361051055,110749940,6,1674,279,1361051050306,1361051050370,110745246,110745310,64
1361051055,110749948,13,9190,706.9230769,1361051050364,1361051050428,110745312,110745376,64
1361051075,1472456268,4,2740,685,1361051048895,1361051048959,1472430163,1472430227,64
1361051131,1472512500,2,104,52,1361051106712,1361051106712,1472488212,1472488212,0
1361051138,110832680,1,52,52,1361051111688,1361051111688,110806368,110806368,0
1361051138,110832680,1,52,52,1361051111687,1361051111687,110806367,110806367,0
1361051139,1472520376,1,52,52,1361051112784,1361051112784,1472494160,1472494160,0
1361051139,1472520376,1,52,52,1361051112784,1361051112784,1472494160,1472494160,0
1361051139,1472520460,1,52,52,1361051112701,1361051112701,1472494161,1472494161,0
1361051139,1472520460,1,52,52,1361051112701,1361051112701,1472494161,1472494161,0
1361051139,1472520464,1,52,52,1361051112700,1361051112700,1472494164,1472494164,0
1361051143,1472524400,14,17152,1225.142857,1361051115833,1361051115897,1472497233,1472497297,64
1361051159,1472540576,1,46,46,1361051132745,1361051132745,1472514321,1472514321,0
1361051191,1472572580,1,52,52,1361051163589,1361051163589,1472545169,1472545169,0
1361051207,1472588780,87,123995,1425.229885,1361051181500,1361051181564,1472563280,1472563344,64
1361051368,1472749336,9,5463,607,1361051348536,1361051359928,1472729872,1472741264,11392
1361051368,1472749380,9,5464,607.1111111,1361051348491,1361051360843,1472729871,1472742223,12352
1361051368,1472749380,9,5411,601.2222222,1361051348490,1361051366666,1472729870,1472748046,18176
1361051376,1472757172,6,2467,411.1666667,1361051348825,1361051348953,1472729997,1472730125,128
1361051440,1472821408,2,92,46,1361051431982,1361051431982,1472813390,1472813390,0
1361051440,1472821420,607,850684,1401.456343,1361051248995,1361051431907,1472630415,1472813327,182912
1361051440,1472821456,2,92,46,1361051431933,1361051431933,1472813389,1472813389,0
1361051460,1472841132,1,46,46,1361051432255,1361051432255,1472813387,1472813387,0
1361051476,1472857172,1,76,76,1361051450201,1361051450201,1472831373,1472831373,0
1361051488,1472869492,45,56807,1262.377778,1361051468246,1361051485590,1472849738,1472867082,17344
1361051492,1472873076,1,46,46,1361051464313,1361051464313,1472845389,1472845389,0
1361051496,1472877140,6,2598,433,1361051468727,1361051468791,1472849867,1472849931,64
1361051496,1472877256,6,2502,417,1361051468867,1361051469059,1472850123,1472850315,192
1361051552,1472933208,1,89,89,1361051524725,1361051524725,1472905933,1472905933,0
1361051600,1472981628,6,2583,430.5,1361051588304,1361051593552,1472969932,1472975180,5248
1361051608,1472989412,1,46,46,1361051583592,1361051583592,1472965004,1472965004,0
1361051608,1472989412,1,46,46,1361051583719,1361051583719,1472965131,1472965131,0
1361051608,1472989504,1,46,46,1361051583563,1361051583563,1472965067,1472965067,0
1361051608,1472989648,9,5463,607,1361051588796,1361051600060,1472970444,1472981708,11264
1361051712,1473093780,2,92,46,1361051704373,1361051704373,1473086153,1473086153,0
1361051989,1473370256,1,76,76,1361051962110,1361051962110,1473343366,1473343366,0
1361052346,1473727580,8,3311,413.875,1361052344500,1361052344564,1473726080,1473726144,64
1361052346,1473727580,41,53052,1293.95122,1361052344818,1361052344946,1473726398,1473726526,128
1361052346,1473727584,66,89311,1353.19697,1361052345136,1361052345456,1473726720,1473727040,320
1361052346,1473727628,100,137412,1374.12,1361052345475,1361052345539,1473727103,1473727167,64
1361052354,1473735560,146,202963,1390.157534,1361052346888,1361052347016,1473728448,1473728576,128
1361052354,1473735600,151,210696,1395.337748,1361052345823,1361052345951,1473727423,1473727551,128
1361052354,1473735604,144,201084,1396.416667,1361052346137,1361052346265,1473727741,1473727869,128
1361052354,1473735604,150,209298,1395.32,1361052346460,1361052346652,1473728064,1473728256,192
1361052450,1473831808,1,89,89,1361052424141,1361052424141,1473805949,1473805949,0
1361052502,1473883824,1,76,76,1361052475517,1361052475517,1473857341,1473857341,0
1361052739,1474120256,3,540,180,1361052711728,1361052711728,1474092984,1474092984,0
1361052739,1474120256,3,540,180,1361052711728,1361052711728,1474092984,1474092984,0
1361052739,1474120256,3,540,180,1361052711728,1361052711728,1474092984,1474092984,0
1361052739,1474120332,3,540,180,1361052711655,1361052711655,1474092987,1474092987,0
1361052739,1474120332,3,540,180,1361052711654,1361052711654,1474092986,1474092986,0
1361052851,1474232444,1,52,52,1361052826549,1361052826549,1474207993,1474207993,0
1361052851,1474232444,1,52,52,1361052826547,1361052826547,1474207991,1474207991,0
1361052851,1474232580,1,52,52,1361052826411,1361052826411,1474207991,1474207991,0
1361052851,1474232608,1,52,52,1361052826382,1361052826382,1474207990,1474207990,0
1361052851,1474232608,1,52,52,1361052826382,1361052826382,1474207990,1474207990,0
1361052915,1474296760,16,7165,447.8125,1361052907959,1361052908215,1474289719,1474289975,256
1361053011,1474392820,1,76,76,1361052986553,1361052986553,1474368373,1474368373,0
1361053156,1474537032,3,1114,371.3333333,1361053128906,1361053128906,1474509938,1474509938,0
1361053156,1474537164,14,14227,1016.214286,1361053128839,1361053129223,1474510003,1474510387,384
1361053268,1474649616,1,52,52,1361053243395,1361053243395,1474625011,1474625011,0
1361053268,1474649616,1,52,52,1361053243394,1361053243394,1474625010,1474625010,0
1361053300,1474681784,16,7165,447.8125,1361053297560,1361053297880,1474679344,1474679664,320
1361053344,113038576,11,5208,473.4545455,1361053343420,1361053343420,113037996,113037996,0
1361053344,113038576,5,947,189.4,1361053343356,1361053343356,113037932,113037932,0
1361053344,113038576,11,9230,839.0909091,1361053343420,1361053343484,113037996,113038060,64
1361053348,1474729564,14,10268,733.4285714,1361053322546,1361053322866,1474704110,1474704430,320
1361053348,1474729564,4,1467,366.75,1361053322804,1361053322868,1474704368,1474704432,64
1361053348,1474729720,7,5221,745.8571429,1361053322648,1361053322712,1474704368,1474704432,64
1361053352,113046580,9,1558,173.1111111,1361053349946,1361053350202,113044526,113044782,256
1361053352,113046580,12,7938,661.5,1361053350457,1361053350777,113045037,113045357,320
1361053352,113046580,15,12019,801.2666667,1361053350457,1361053350649,113045037,113045229,192
1361053352,113046580,7,1604,229.1428571,1361053350648,1361053350968,113045228,113045548,320
1361053352,113046580,7,1604,229.1428571,1361053350968,1361053351224,113045548,113045804,256
1361053352,113046580,10,2474,247.4,1361053351291,1361053351547,113045871,113046127,256
1361053352,113046584,11,7150,650,1361053350196,1361053350324,113044780,113044908,128
1361053352,113046584,7,1518,216.8571429,1361053350196,1361053350196,113044780,113044780,0
1361053352,113046588,7,1604,229.1428571,1361053350643,1361053350963,113045231,113045551,320
1361053352,113046588,7,1604,229.1428571,1361053350962,1361053351218,113045550,113045806,256
1361053352,113046588,8,2232,279,1361053351282,1361053351282,113045870,113045870,0
1361053352,113046588,10,2634,263.4,1361053351282,1361053351538,113045870,113046126,256
1361053352,113046588,9,1542,171.3333333,1361053351282,1361053351410,113045870,113045998,128
1361053352,113046588,9,1750,194.4444444,1361053351281,1361053351473,113045869,113046061,192
1361053352,1474733620,1,89,89,1361053324347,1361053324347,1474705967,1474705967,0
1361053352,1474733648,4,968,242,1361053325728,1361053325728,1474707376,1474707376,0
1361053352,1474733648,3,540,180,1361053325792,1361053325792,1474707440,1474707440,0
1361053352,1474733648,4,968,242,1361053325727,1361053325791,1474707375,1474707439,64
1361053360,113054580,9,1350,150,1361053354362,1361053354554,113048942,113049134,192
1361053360,113054580,7,1678,239.7142857,1361053354361,1361053356089,113048941,113050669,1728
1361053360,113054580,9,1718,190.8888889,1361053351288,1361053351992,113045868,113046572,704
1361053360,113054588,15,11859,790.6,1361053351345,1361053354353,113045933,113048941,3008
1361053360,113054588,12,8466,705.5,1361053356080,1361053356208,113050668,113050796,128
1361053360,113054588,7,1188,169.7142857,1361053356272,1361053356464,113050860,113051052,192
1361053368,113062580,12,9138,761.5,1361053365945,1361053366073,113060525,113060653,128
1361053368,113062588,7,799,114.1428571,1361053365875,1361053365875,113060463,113060463,0
1361053368,113062588,7,1710,244.2857143,1361053365939,1361053365939,113060527,113060527,0
1361053372,1474753808,12,1328,110.6666667,1361053369344,1361053369472,1474751152,1474751280,128
1361053372,1474753884,14,13343,953.0714286,1361053351154,1361053366322,1474733038,1474748206,15168
1361053465,1474846176,2,92,46,1361053438070,1361053438070,1474819246,1474819246,0
1361053465,1474846288,2,92,46,1361053437960,1361053437960,1474819248,1474819248,0
1361053465,1474846292,1,52,52,1361053437889,1361053437889,1474819181,1474819181,0
1361053469,1474850144,1,52,52,1361053441045,1361053441045,1474822189,1474822189,0
1361053469,1474850148,1,52,52,1361053441043,1361053441043,1474822191,1474822191,0
1361053469,1474850236,1,52,52,1361053440956,1361053440956,1474822192,1474822192,0
1361053525,1474906236,1,76,76,1361053498171,1361053498171,1474879407,1474879407,0
1361053835,1475215932,1,46,46,1361053806437,1361053806437,1475187369,1475187369,0
1361053872,1475253508,1,46,46,1361053844004,1361053844004,1475225512,1475225512,0
1361054034,1475415656,1,76,76,1361054008718,1361054008718,1475390374,1475390374,0
1361054251,1475632416,1,89,89,1361054224572,1361054224572,1475605988,1475605988,0
1361054399,1475780840,1,48,48,1361054371407,1361054371407,1475753247,1475753247,0
1361054444,1475824996,1,48,48,1361054418906,1361054418906,1475799902,1475799902,0
1361054548,1475929360,1,76,76,1361054520045,1361054520045,1475901405,1475901405,0
1361054608,1475989500,1,46,46,1361054582753,1361054582753,1475964253,1475964253,0
1361055057,1476438200,1,76,76,1361055032196,1361055032196,1476413396,1476413396,0
1361055065,1476446096,3,928,309.3333333,1361055040428,1361055040492,1476421524,1476421588,64
1361055065,1476446172,15,17278,1151.866667,1361055040418,1361055040994,1476421590,1476422166,576
1361055149,1476530288,1,89,89,1361055124655,1361055124655,1476505943,1476505943,0
1361055181,1476562532,1,52,52,1361055155066,1361055155066,1476536598,1476536598,0
1361055181,1476562532,1,52,52,1361055155066,1361055155066,1476536598,1476536598,0
1361055490,1476871396,1,46,46,1361055465722,1361055465722,1476847118,1476847118,0
1361055570,1476951448,1,76,76,1361055542982,1361055542982,1476924430,1476924430,0
1361056051,1477432264,1,89,89,1361056024697,1361056024697,1477405961,1477405961,0
1361056083,1477464168,1,76,76,1361056055253,1361056055253,1477436421,1477436421,0
1361056593,1477973916,1,76,76,1361056567499,1361056567499,1477948415,1477948415,0
1361056797,1478178532,10,9714,971.4,1361056772767,1361056773279,1478154299,1478154811,512
1361056797,1478178592,3,937,312.3333333,1361056772643,1361056772707,1478154235,1478154299,64
1361056886,1478267380,1,52,52,1361056859703,1361056859703,1478241083,1478241083,0
1361056913,1478294760,1,52,52,1361056888571,1361056888571,1478270331,1478270331,0
1361056913,1478294760,1,52,52,1361056887546,1361056887546,1478269306,1478269306,0
1361056942,1478323696,1,52,52,1361056914616,1361056914616,1478296312,1478296312,0
1361056950,1478330984,1,89,89,1361056924993,1361056924993,1478305977,1478305977,0
1361057104,1478485672,145,192345,1326.517241,1361057079505,1361057095889,1478461177,1478477561,16384
1361057106,1478487432,1,76,76,1361057080960,1361057080960,1478462392,1478462392,0
1361057106,1478487520,9,4770,530,1361057081128,1361057081320,1478462648,1478462840,192
1361057112,1478493656,3,193,64.33333333,1361057111198,1361057111198,1478492854,1478492854,0
1361057539,1478920068,2,122,61,1361057513638,1361057516070,1478894706,1478897138,2432
1361057619,1479000204,1,76,76,1361057594204,1361057594204,1478975408,1478975408,0
1361057851,1479232736,1,89,89,1361057824259,1361057824259,1479205995,1479205995,0
1361057868,1479248956,1,60,60,1361057843216,1361057843216,1479224172,1479224172,0
1361057924,1479305076,1,60,60,1361057896471,1361057896471,1479277547,1479277547,0
1361057988,1479369280,1,60,60,1361057959947,1361057959947,1479341227,1479341227,0
1361058132,1479513584,1,76,76,1361058106840,1361058106840,1479488424,1479488424,0
1361058797,1480178488,1,46,46,1361058771309,1361058771309,1480152797,1480152797,0
1361060441,1481821956,1,60,60,1361060414249,1361060414249,1481795205,1481795205,0
1361060473,1481853988,1,60,60,1361060446024,1361060446024,1481827012,1481827012,0
1361061126,1482507420,1,46,46,1361061100367,1361061100367,1482481787,1482481787,0
1361061299,1482679960,1,48,48,1361061272920,1361061272920,1482653880,1482653880,0
1361061303,1482684040,1,48,48,1361061276871,1361061276871,1482657911,1482657911,0
1361061428,1482809256,5,408,81.6,1361061424749,1361061426605,1482806005,1482807861,1856
1361061436,1482817324,2,178,89,1361061428712,1361061433064,1482810036,1482814388,4352
1361061460,1482841276,2,178,89,1361061441752,1361061459032,1482823028,1482840308,17280
1361061519,1482900628,1,89,89,1361061493242,1361061493242,1482874870,1482874870,0
1361063512,1484893640,2,96,48,1361063485773,1361063491405,1484867413,1484873045,5632
1361064355,1485736000,1,46,46,1361064327938,1361064327938,1485708938,1485708938,0
1361065058,1486439732,1,60,60,1361065032794,1361065032794,1486414526,1486414526,0
1361065123,1486503896,2,112,56,1361065097949,1361065097949,1486478845,1486478845,0
1361065159,1486540076,1,46,46,1361065131943,1361065131943,1486513019,1486513019,0
1361065680,1487061180,1,46,46,1361065652603,1361065652603,1487033783,1487033783,0
1361066568,1487949728,1,48,48,1361066539527,1361066539527,1487921255,1487921255,0
1361066655,1488036284,2,120,60,1361066629571,1361066632579,1488010855,1488013863,3008
1361067517,1488897896,1,48,48,1361067492218,1361067492218,1488873114,1488873114,0
1361069922,1491303596,1,48,48,1361069893656,1361069893656,1491275252,1491275252,0
1361071881,1493262896,1,60,60,1361071853455,1361071853455,1493235351,1493235351,0
1361072395,1493775972,1,60,60,1361072369957,1361072369957,1493750929,1493750929,0
1361072519,1493900088,1,46,46,1361072490925,1361072490925,1493872013,1493872013,0
1361073020,1494401304,1,441,441,1361072994383,1361072994383,1494375687,1494375687,0
1361076784,1498165364,1,46,46,1361076758297,1361076758297,1498139661,1498139661,0
1361077477,1498858808,1,92,92,1361077452626,1361077452626,1498834434,1498834434,0
1361079015,1500396688,2,96,48,1361078989234,1361078992242,1500370922,1500373930,3008
1361079024,1500404908,4,570,142.5,1361079023742,1361079023806,1500404650,1500404714,64
1361079024,1500404908,6,654,109,1361079020029,1361079020221,1500400937,1500401129,192
1361079024,1500404916,80,73509,918.8625,1361079018230,1361079020342,1500399146,1500401258,2112
1361079024,1500404920,21,21222,1010.571429,1361079018739,1361079023795,1500399659,1500404715,5056
1361079024,1500404920,18,18006,1000.333333,1361079018993,1361079023793,1500399913,1500404713,4800
1361079024,1500404920,35,41185,1176.714286,1361079018801,1361079023793,1500399721,1500404713,4992
1361079024,1500404924,14,14065,1004.642857,1361079018992,1361079023792,1500399916,1500404716,4800
1361079024,1500404956,5,526,105.2,1361079023696,1361079023760,1500404652,1500404716,64
1361079024,1500404956,5,728,145.6,1361079019981,1361079020109,1500400937,1500401065,128
1361079024,1500404960,7,562,80.28571429,1361079020363,1361079020491,1500401323,1500401451,128
1361079024,1500404992,18,17587,977.0555556,1361079018921,1361079023721,1500399913,1500404713,4800
1361079032,1500412836,12,1086,90.5,1361079028294,1361079028614,1500409130,1500409450,320
1361079032,1500412840,13,1288,99.07692308,1361079028612,1361079028996,1500409452,1500409836,384
1361079032,1500412848,18,7669,426.0555556,1361079026876,1361079028348,1500407724,1500409196,1472
1361079032,1500412884,12,1334,111.1666667,1361079029079,1361079029463,1500409963,1500410347,384
1361079038,138732740,11,5208,473.4545455,1361079032704,1361079033088,138727444,138727828,384
1361079038,138732744,5,947,189.4,1361079032637,1361079032701,138727381,138727445,64
1361079038,138732744,13,9494,730.3076923,1361079033084,1361079033212,138727828,138727956,128
1361079040,1500420824,5,2287,457.4,1361079018900,1361079032980,1500399724,1500413804,14080
1361079040,1500420824,9,6480,720,1361079018900,1361079033300,1500399724,1500414124,14400
1361079040,1500420824,13,11484,883.3846154,1361079018898,1361079033298,1500399722,1500414122,14400
1361079040,1500420852,7,1177,168.1428571,1361079020470,1361079035574,1500401322,1500416426,15104
1361079040,1500420856,5,1094,218.8,1361079033649,1361079033905,1500414505,1500414761,256
1361079040,1500420864,8,4696,587,1361079018856,1361079033000,1500399720,1500413864,14144
1361079040,1500420864,8,4572,571.5,1361079018856,1361079033000,1500399720,1500413864,14144
1361079040,1500420864,27,31908,1181.777778,1361079018856,1361079033256,1500399720,1500414120,14400
1361079040,1500420864,4,1168,292,1361079019371,1361079033387,1500400235,1500414251,14016
1361079043,1500424684,15,3688,245.8666667,1361079015480,1361079028088,1500397164,1500409772,12608
1361079046,138740436,3,473,157.6666667,1361079019697,1361079019697,138714133,138714133,0
1361079046,138740732,9,1558,173.1111111,1361079042826,1361079043338,138737558,138738070,512
1361079046,138740732,7,1518,216.8571429,1361079043402,1361079043402,138738134,138738134,0
1361079046,138740732,11,7150,650,1361079043401,1361079043465,138738133,138738197,64
1361079046,138740732,12,7938,661.5,1361079043657,1361079043785,138738389,138738517,128
1361079046,138740732,7,1604,229.1428571,1361079043849,1361079044489,138738581,138739221,640
1361079046,138740732,10,2634,263.4,1361079044553,1361079044809,138739285,138739541,256
1361079046,138740732,9,1542,171.3333333,1361079044553,1361079044681,138739285,138739413,128
1361079046,138740732,7,1604,229.1428571,1361079044425,1361079044553,138739157,138739285,128
1361079046,138740736,15,12035,802.3333333,1361079043654,1361079043782,138738390,138738518,128
1361079046,138740736,7,1604,229.1428571,1361079043846,1361079044486,138738582,138739222,640
1361079046,138740736,8,2457,307.125,1361079044101,1361079045573,138738837,138740309,1472
1361079046,138740736,7,1604,229.1428571,1361079044421,1361079044485,138739157,138739221,64
1361079046,138740736,9,1718,190.8888889,1361079044549,1361079045381,138739285,138740117,832
1361079046,138740736,10,2474,247.4,1361079044549,1361079044805,138739285,138739541,256
1361079046,138740736,8,1714,214.25,1361079044549,1361079044805,138739285,138739541,256
1361079051,1500432572,1,64,64,1361079023207,1361079023207,1500404779,1500404779,0
1361079051,1500432580,5,1396,279.2,1361079023520,1361079030688,1500405100,1500412268,7168
1361079051,1500432580,4,968,242,1361079023520,1361079030688,1500405100,1500412268,7168
1361079051,1500432660,8,6048,756,1361079025872,1361079026064,1500407532,1500407724,192
1361079051,1500432668,1,60,60,1361079022982,1361079022982,1500404650,1500404650,0
1361079051,1500432692,6,1582,263.6666667,1361079023279,1361079030575,1500404971,1500412267,7296
1361079051,1500432692,4,968,242,1361079023405,1361079030573,1500405097,1500412265,7168
1361079054,138748436,9,1494,166,1361079054003,1361079054067,138748439,138748503,64
1361079054,138748740,8,1730,216.25,1361079047617,1361079049281,138742357,138744021,1664
1361079054,138748740,9,1350,150,1361079047617,1361079047809,138742357,138742549,192
1361079054,138748740,7,1486,212.2857143,1361079052287,1361079052351,138747027,138747091,64
1361079054,138748740,6,1450,241.6666667,1361079052671,1361079052799,138747411,138747539,128
1361079054,138748740,8,2546,318.25,1361079053311,1361079053631,138748051,138748371,320
1361079054,138748740,7,1524,217.7142857,1361079053379,1361079053379,138748119,138748119,0
1361079054,138748740,15,9278,618.5333333,1361079053699,1361079053891,138748439,138748631,192
1361079054,138748740,8,1506,188.25,1361079053699,1361079053763,138748439,138748503,64
1361079054,138748740,9,1510,167.7777778,1361079053699,1361079053763,138748439,138748503,64
1361079054,138748744,11,7086,644.1818182,1361079052029,1361079052093,138746773,138746837,64
1361079054,138748744,15,11859,790.6,1361079044668,1361079047612,138739412,138742356,2944
1361079054,138748744,12,7938,661.5,1361079052284,1361079052476,138747028,138747220,192
1361079054,138748744,8,2232,279,1361079052604,1361079052668,138747348,138747412,64
1361079054,138748744,10,2015,201.5,1361079052988,1361079053436,138747732,138748180,448
1361079054,138748744,9,1606,178.4444444,1361079052348,1361079052668,138747092,138747412,320
1361079054,138748744,9,1350,150,1361079053307,1361079053435,138748051,138748179,128
1361079054,138748744,7,1524,217.7142857,1361079053307,1361079053371,138748051,138748115,64
1361079054,138748744,16,14503,906.4375,1361079052731,1361079052923,138747475,138747667,192
1361079054,138748744,7,1524,217.7142857,1361079053307,1361079053371,138748051,138748115,64
1361079062,138756728,8,1730,216.25,1361079053901,1361079054093,138748629,138748821,192
1361079062,138756728,9,1350,150,1361079053901,1361079054093,138748629,138748821,192
1361079062,138756728,7,1188,169.7142857,1361079060299,1361079060363,138755027,138755091,64
1361079062,138756732,9,1350,150,1361079057227,1361079057483,138751959,138752215,256
1361079062,138756732,14,10815,772.5,1361079059529,1361079059913,138754261,138754645,384
1361079062,138756732,9,1350,150,1361079055881,1361079056073,138750613,138750805,192
1361079062,138756732,11,1503,136.6363636,1361079056520,1361079056904,138751252,138751636,384
1361079062,138756732,9,1350,150,1361079060296,1361079060424,138755028,138755156,128
1361079062,138756732,8,1354,169.25,1361079053191,1361079054215,138747923,138748947,1024
1361079064,1500444892,31,35492,1144.903226,1361079045645,1361079061389,1500426537,1500442281,15744
1361079070,138764744,8,2680,335,1361079062526,1361079062654,138757270,138757398,128
1361079070,138764744,13,10683,821.7692308,1361079064061,1361079064317,138758805,138759061,256
1361079070,138764744,9,1350,150,1361079064508,1361079064764,138759252,138759508,256
1361079070,138764748,14,10543,753.0714286,1361079061819,1361079062459,138756567,138757207,640
1361079070,138764748,7,1188,169.7142857,1361079062650,1361079062714,138757398,138757462,64
1361079070,138764748,9,1350,150,1361079062714,1361079062778,138757462,138757526,64
1361079070,138764748,7,1087,155.2857143,1361079067961,1361079068025,138762709,138762773,64
1361079070,138764748,7,1470,210,1361079067897,1361079067961,138762645,138762709,64
1361079070,138764748,7,1188,169.7142857,1361079064440,1361079064696,138759188,138759444,256
1361079071,1500452756,6,2036,339.3333333,1361079044973,1361079045101,1500426729,1500426857,128
1361079078,138772740,7,799,114.1428571,1361079075585,1361079075585,138770325,138770325,0
1361079078,138772744,13,9190,706.9230769,1361079075646,1361079075774,138770390,138770518,128
1361079078,138772744,7,1710,244.2857143,1361079075581,1361079075645,138770325,138770389,64
1361079087,1500468668,1,52,52,1361079060614,1361079060614,1500442282,1500442282,0
1361079087,1500468668,1,52,52,1361079060614,1361079060614,1500442282,1500442282,0
1361079087,1500468668,1,52,52,1361079060613,1361079060613,1500442281,1500442281,0
1361079087,1500468776,1,52,52,1361079060505,1361079060505,1500442281,1500442281,0
1361079087,1500468776,1,52,52,1361079060505,1361079060505,1500442281,1500442281,0
1361079087,1500468776,1,52,52,1361079060505,1361079060505,1500442281,1500442281,0
1361079087,1500468776,1,52,52,1361079060505,1361079060505,1500442281,1500442281,0
1361079087,1500468776,1,46,46,1361079060505,1361079060505,1500442281,1500442281,0
1361079088,1500468972,16,7165,447.8125,1361079082303,1361079082559,1500463275,1500463531,256
1361079106,138800488,1,52,52,1361079081150,1361079081150,138775638,138775638,0
1361079107,1500488680,1,46,46,1361079080891,1361079080891,1500462571,1500462571,0
1361079107,1500488680,1,52,52,1361079080762,1361079080762,1500462442,1500462442,0
1361079107,1500488784,1,52,52,1361079080657,1361079080657,1500462441,1500462441,0
1361079107,1500488784,1,46,46,1361079080656,1361079080656,1500462440,1500462440,0
1361079107,1500488784,1,52,52,1361079080656,1361079080656,1500462440,1500462440,0
1361079107,1500488784,1,52,52,1361079080656,1361079080656,1500462440,1500462440,0
1361079110,138804732,8,1745,218.125,1361079105739,1361079105803,138800471,138800535,64
1361079110,138804732,8,1185,148.125,1361079105739,1361079105803,138800471,138800535,64
1361079110,138804732,10,6841,684.1,1361079105803,1361079105867,138800535,138800599,64
1361079110,138804732,8,1457,182.125,1361079105739,1361079105803,138800471,138800535,64
1361079110,138804732,9,2421,269,1361079105931,1361079105931,138800663,138800663,0
1361079110,138804732,9,2239,248.7777778,1361079105481,1361079105545,138800213,138800277,64
1361079110,138804732,50,52807,1056.14,1361079105481,1361079105609,138800213,138800341,128
1361079110,138804732,35,42523,1214.942857,1361079105545,1361079105609,138800277,138800341,64
1361079110,138804732,7,1607,229.5714286,1361079105545,1361079105609,138800277,138800341,64
1361079110,138804732,9,2239,248.7777778,1361079105673,1361079105737,138800405,138800469,64
1361079110,138804732,14,9171,655.0714286,1361079105417,1361079105481,138800149,138800213,64
1361079110,138804732,9,2239,248.7777778,1361079105481,1361079105545,138800213,138800277,64
1361079110,138804732,9,2623,291.4444444,1361079105673,1361079105737,138800405,138800469,64
1361079110,138804732,16,15648,978,1361079105544,1361079105608,138800276,138800340,64
1361079110,138804732,17,16164,950.8235294,1361079105544,1361079105608,138800276,138800340,64
1361079110,138804732,8,1761,220.125,1361079105736,1361079105800,138800468,138800532,64
1361079110,138804732,9,3445,382.7777778,1361079105735,1361079105799,138800467,138800531,64
1361079110,138804732,12,10086,840.5,1361079105735,1361079105799,138800467,138800531,64
1361079110,138804736,8,1377,172.125,1361079105799,1361079105799,138800535,138800535,0
1361079110,138804736,10,6377,637.7,1361079105799,1361079105863,138800535,138800599,64
1361079110,138804736,9,2399,266.5555556,1361079105863,1361079105863,138800599,138800599,0
1361079110,138804736,11,4671,424.6363636,1361079105285,1361079105349,138800021,138800085,64
1361079110,138804736,8,1115,139.375,1361079105476,1361079105540,138800212,138800276,64
1361079110,138804736,5,872,174.4,1361079105220,1361079105284,138799956,138800020,64
1361079110,138804736,27,30790,1140.37037,1361079105540,1361079105604,138800276,138800340,64
1361079110,138804736,8,2011,251.375,1361079105476,1361079105540,138800212,138800276,64
1361079110,138804736,8,2507,313.375,1361079105476,1361079105540,138800212,138800276,64
1361079110,138804736,9,2367,263,1361079105540,1361079105604,138800276,138800340,64
1361079110,138804736,8,1899,237.375,1361079105668,1361079105732,138800404,138800468,64
1361079110,138804736,8,1627,203.375,1361079105668,1361079105732,138800404,138800468,64
1361079112,1500492900,4,917,229.25,1361079096195,1361079105155,1500477095,1500486055,8960
1361079118,138812536,8,1153,144.125,1361079117967,1361079117967,138812503,138812503,0
1361079118,138812744,8,1339,167.375,1361079117759,1361079117823,138812503,138812567,64
1361079118,138812744,7,1085,155,1361079117759,1361079117823,138812503,138812567,64
1361079118,138812744,9,1775,197.2222222,1361079115261,1361079116797,138810005,138811541,1536
1361079118,138812744,12,7195,599.5833333,1361079112125,1361079112189,138806869,138806933,64
1361079118,138812744,11,5767,524.2727273,1361079112252,1361079112252,138806996,138806996,0
1361079118,138812744,11,5367,487.9090909,1361079112252,1361079112252,138806996,138806996,0
1361079118,138812744,9,2127,236.3333333,1361079112636,1361079112700,138807380,138807444,64
1361079118,138812744,12,10080,840,1361079112636,1361079112700,138807380,138807444,64
1361079118,138812744,13,10868,836,1361079112636,1361079112700,138807380,138807444,64
1361079118,138812744,8,2411,301.375,1361079112700,1361079112764,138807444,138807508,64
1361079118,138812744,9,5247,583,1361079112700,1361079112764,138807444,138807508,64
1361079118,138812744,8,1579,197.375,1361079112764,1361079112828,138807508,138807572,64
1361079118,138812744,9,3935,437.2222222,1361079112831,1361079112831,138807575,138807575,0
1361079118,138812744,8,1979,247.375,1361079112639,1361079112639,138807383,138807383,0
1361079118,138812744,8,1361,170.125,1361079112895,1361079112959,138807639,138807703,64
1361079118,138812744,14,12456,889.7142857,1361079112703,1361079112767,138807447,138807511,64
1361079118,138812744,21,22425,1067.857143,1361079112831,1361079112895,138807575,138807639,64
1361079118,138812744,11,4919,447.1818182,1361079112831,1361079112895,138807575,138807639,64
1361079118,138812744,9,4127,458.5555556,1361079112831,1361079112895,138807575,138807639,64
1361079118,138812748,8,1457,182.125,1361079112891,1361079112891,138807639,138807639,0
1361079118,138812748,8,1105,138.125,1361079112955,1361079112955,138807703,138807703,0
1361079118,138812748,8,1297,162.125,1361079112955,1361079112955,138807703,138807703,0
1361079118,138812748,8,1569,196.125,1361079112955,1361079113019,138807703,138807767,64
1361079118,138812748,14,12894,921,1361079112955,1361079113019,138807703,138807767,64
1361079118,138812748,10,1763,176.3,1361079113019,1361079113467,138807767,138808215,448
1361079118,138812748,9,2575,286.1111111,1361079113019,1361079113275,138807767,138808023,256
1361079118,138812748,10,1823,182.3,1361079113083,1361079113339,138807831,138808087,256
1361079118,138812748,9,2287,254.1111111,1361079113275,1361079113275,138808023,138808023,0
1361079118,138812748,9,4933,548.1111111,1361079113275,1361079113339,138808023,138808087,64
1361079118,138812748,8,1105,138.125,1361079113339,1361079113339,138808087,138808087,0
1361079118,138812748,8,1569,196.125,1361079113339,1361079113403,138808087,138808151,64
1361079118,138812748,8,1569,196.125,1361079113339,1361079113403,138808087,138808151,64
1361079118,138812748,8,1569,196.125,1361079113403,1361079113403,138808151,138808151,0
1361079118,138812748,8,1569,196.125,1361079113403,1361079113403,138808151,138808151,0
1361079118,138812748,8,1377,172.125,1361079113403,1361079113403,138808151,138808151,0
1361079118,138812748,10,1651,165.1,1361079117050,1361079117242,138811798,138811990,192
1361079118,138812748,17,14548,855.7647059,1361079117306,1361079117498,138812054,138812246,192
1361079118,138812748,12,7131,594.25,1361079116858,1361079116922,138811606,138811670,64
1361079118,138812748,8,1275,159.375,1361079117626,1361079117626,138812374,138812374,0
1361079118,138812748,9,3503,389.2222222,1361079117626,1361079117626,138812374,138812374,0
1361079118,138812748,8,1403,175.375,1361079117626,1361079117690,138812374,138812438,64
1361079118,138812748,12,9936,828,1361079117690,1361079117690,138812438,138812438,0
1361079118,138812748,9,2799,311,1361079117626,1361079117690,138812374,138812438,64
1361079118,138812748,8,1419,177.375,1361079117690,1361079117690,138812438,138812438,0
1361079118,138812748,8,1137,142.125,1361079117754,1361079117818,138812502,138812566,64
1361079118,138812748,8,1233,154.125,1361079117754,1361079117818,138812502,138812566,64
1361079118,138812748,8,1137,142.125,1361079117754,1361079117818,138812502,138812566,64
1361079118,138812748,8,1137,142.125,1361079117818,1361079117818,138812566,138812566,0
1361079118,138812748,8,1137,142.125,1361079117817,1361079117817,138812565,138812565,0
1361079118,138812748,8,1137,142.125,1361079117817,1361079117817,138812565,138812565,0
1361079118,138812748,9,2789,309.8888889,1361079117817,1361079117881,138812565,138812629,64
1361079118,138812748,8,1313,164.125,1361079117817,1361079117881,138812565,138812629,64
1361079118,138812748,8,1681,210.125,1361079115256,1361079115320,138810004,138810068,64
1361079118,138812748,8,1291,161.375,1361079115256,1361079115256,138810004,138810004,0
1361079118,138812748,10,1507,150.7,1361079111672,1361079112056,138806420,138806804,384
1361079118,138812752,8,1563,195.375,1361079112055,1361079112119,138806807,138806871,64
1361079118,138812752,9,4591,510.1111111,1361079112247,1361079112247,138806999,138806999,0
1361079118,138812752,9,3775,419.4444444,1361079112247,1361079112247,138806999,138806999,0
1361079118,138812752,14,12696,906.8571429,1361079112247,1361079112247,138806999,138806999,0
1361079118,138812752,11,8231,748.2727273,1361079112247,1361079112247,138806999,138806999,0
1361079118,138812752,10,6355,635.5,1361079112247,1361079112311,138806999,138807063,64
1361079118,138812752,9,4079,453.2222222,1361079112247,1361079112311,138806999,138807063,64
1361079118,138812752,16,12080,755,1361079112311,1361079112439,138807063,138807191,128
1361079118,138812752,13,7983,614.0769231,1361079112311,1361079112439,138807063,138807191,128
1361079118,138812752,18,18141,1007.833333,1361079112631,1361079112695,138807383,138807447,64
1361079118,138812752,9,2959,328.7777778,1361079112631,1361079112695,138807383,138807447,64
1361079118,138812752,12,9920,826.6666667,1361079112631,1361079112695,138807383,138807447,64
1361079118,138812752,9,3807,423,1361079112695,1361079112759,138807447,138807511,64
1361079118,138812752,9,4687,520.7777778,1361079112695,1361079112759,138807447,138807511,64
1361079118,138812752,15,13804,920.2666667,1361079112758,1361079112822,138807510,138807574,64
1361079118,138812752,8,2267,283.375,1361079112630,1361079112630,138807382,138807382,0
1361079118,138812752,24,26560,1106.666667,1361079112886,1361079112886,138807638,138807638,0
1361079118,138812752,8,1361,170.125,1361079112886,1361079112950,138807638,138807702,64
1361079118,138812752,8,1345,168.125,1361079112950,1361079112950,138807702,138807702,0
1361079118,138812752,8,1457,182.125,1361079112950,1361079113014,138807702,138807766,64
1361079118,138812752,15,14172,944.8,1361079112694,1361079112758,138807446,138807510,64
1361079118,138812752,9,1517,168.5555556,1361079113014,1361079113974,138807766,138808726,960
1361079118,138812752,8,2331,291.375,1361079112822,1361079112822,138807574,138807574,0
1361079118,138812752,14,12648,903.4285714,1361079112822,1361079112886,138807574,138807638,64
1361079118,138812752,8,1217,152.125,1361079112822,1361079112886,138807574,138807638,64
1361079118,138812752,8,1217,152.125,1361079112886,1361079112886,138807638,138807638,0
1361079118,138812752,8,1185,148.125,1361079112886,1361079112950,138807638,138807702,64
1361079118,138812752,8,1457,182.125,1361079112950,1361079112950,138807702,138807702,0
1361079118,138812752,8,1569,196.125,1361079112950,1361079113014,138807702,138807766,64
1361079118,138812752,9,3429,381,1361079112950,1361079113014,138807702,138807766,64
1361079118,138812752,8,1697,212.125,1361079112950,1361079113014,138807702,138807766,64
1361079118,138812752,9,2277,253,1361079113014,1361079113078,138807766,138807830,64
1361079118,138812752,8,1483,185.375,1361079113014,1361079113142,138807766,138807894,128
1361079118,138812752,10,2467,246.7,1361079113014,1361079113206,138807766,138807958,192
1361079118,138812752,14,11800,842.8571429,1361079113142,1361079115190,138807894,138809942,2048
1361079118,138812752,7,1677,239.5714286,1361079113270,1361079113334,138808022,138808086,64
1361079118,138812752,9,4805,533.8888889,1361079113462,1361079113526,138808214,138808278,64
1361079118,138812752,8,1531,191.375,1361079116981,1361079117045,138811733,138811797,64
1361079119,1500500760,27,33224,1230.518519,1361079094505,1361079095337,1500476265,1500477097,832
1361079119,1500500808,49,65488,1336.489796,1361079093816,1361079095288,1500475624,1500477096,1472
1361079119,1500500808,78,104664,1341.846154,1361079093880,1361079095288,1500475688,1500477096,1408
1361079120,1500500832,39,47966,1229.897436,1361079094857,1361079096265,1500475689,1500477097,1408
1361079120,1500500832,10,9705,970.5,1361079095432,1361079096264,1500476264,1500477096,832
1361079118,138812752,13,7983,614.0769231,1361079116981,1361079117173,138811733,138811925,192
1361079118,138812752,9,2277,253,1361079117237,1361079117237,138811989,138811989,0
1361079118,138812752,8,1547,193.375,1361079117237,1361079117301,138811989,138812053,64
1361079118,138812752,9,2623,291.4444444,1361079117557,1361079117621,138812309,138812373,64
1361079118,138812752,9,2783,309.2222222,1361079117621,1361079117621,138812373,138812373,0
1361079118,138812752,8,1579,197.375,1361079117621,1361079117621,138812373,138812373,0
1361079118,138812752,9,3935,437.2222222,1361079117621,1361079117621,138812373,138812373,0
1361079118,138812752,10,7123,712.3,1361079117685,1361079117685,138812437,138812437,0
1361079118,138812752,8,1291,161.375,1361079117621,1361079117685,138812373,138812437,64
1361079118,138812752,13,11636,895.0769231,1361079117685,1361079117749,138812437,138812501,64
1361079118,138812752,8,1435,179.375,1361079117685,1361079117685,138812437,138812437,0
1361079122,138816488,86,114481,1331.174419,1361079094397,1361079096061,138788885,138790549,1664
1361079122,138816488,70,88034,1257.628571,1361079094397,1361079096061,138788885,138790549,1664
1361079122,138816488,82,107927,1316.182927,1361079094396,1361079096060,138788884,138790548,1664
1361079122,138816488,63,81284,1290.222222,1361079094396,1361079096060,138788884,138790548,1664
1361079122,138816496,23,29540,1284.347826,1361079095926,1361079095990,138790422,138790486,64
1361079122,138816496,29,38516,1328.137931,1361079096117,1361079096181,138790613,138790677,64
1361079122,138816496,3,1107,369,1361079096117,1361079096117,138790613,138790613,0
1361079122,138816516,71,92769,1306.605634,1361079094370,1361079096034,138788886,138790550,1664
1361079122,138816524,29,38516,1328.137931,1361079096091,1361079096155,138790615,138790679,64
1361079123,1500504784,10,5344,534.4,1361079095249,1361079095569,1500477033,1500477353,320
1361079124,1500504872,10,5347,534.7,1361079096162,1361079096482,1500477034,1500477354,320
1361079124,1500504984,37,49240,1330.810811,1361079099569,1361079099633,1500480553,1500480617,64
1361079126,138820516,3,586,195.3333333,1361079099232,1361079099232,138793748,138793748,0
1361079126,138820536,8,1569,196.125,1361079118223,1361079118223,138812759,138812759,0
1361079126,138820536,8,1569,196.125,1361079118223,1361079118223,138812759,138812759,0
1361079126,138820536,8,1569,196.125,1361079118223,1361079118223,138812759,138812759,0
1361079126,138820536,15,9271,618.0666667,1361079118095,1361079118287,138812631,138812823,192
1361079126,138820536,8,1291,161.375,1361079118159,1361079118159,138812695,138812695,0
1361079126,138820536,9,1343,149.2222222,1361079118351,1361079118351,138812887,138812887,0
1361079126,138820740,8,1233,154.125,1361079123521,1361079123585,138818261,138818325,64
1361079126,138820740,9,2789,309.8888889,1361079123585,1361079123585,138818325,138818325,0
1361079126,138820740,9,1343,149.2222222,1361079120641,1361079120641,138815381,138815381,0
1361079126,138820740,8,1121,140.125,1361079123585,1361079123585,138818325,138818325,0
1361079126,138820740,10,1395,139.5,1361079123649,1361079123713,138818389,138818453,64
1361079126,138820740,13,10484,806.4615385,1361079125440,1361079125952,138820180,138820692,512
1361079126,138820740,9,1551,172.3333333,1361079117888,1361079118016,138812628,138812756,128
1361079126,138820740,9,1503,167,1361079117888,1361079118016,138812628,138812756,128
1361079126,138820740,9,1487,165.2222222,1361079117888,1361079118016,138812628,138812756,128
1361079126,138820740,8,1569,196.125,1361079117952,1361079118016,138812692,138812756,64
1361079126,138820744,11,1879,170.8181818,1361079118143,1361079118207,138812887,138812951,64
1361079126,138820744,15,10860,724,1361079123006,1361079123390,138817750,138818134,384
1361079126,138820744,9,2773,308.1111111,1361079123582,1361079123582,138818326,138818326,0
1361079126,138820744,13,10788,829.8461538,1361079123518,1361079123518,138818262,138818262,0
1361079126,138820744,8,1393,174.125,1361079123582,1361079123582,138818326,138818326,0
1361079127,1500508756,36,47729,1325.805556,1361079101997,1361079102189,1500483753,1500483945,192
1361079127,1500508756,3,540,180,1361079102444,1361079102508,1500484200,1500484264,64
1361079127,1500508756,3,540,180,1361079102508,1361079102508,1500484264,1500484264,0
1361079127,1500508760,3,540,180,1361079102443,1361079102507,1500484203,1500484267,64
1361079127,1500508800,17,20831,1225.352941,1361079101954,1361079102082,1500483754,1500483882,128
1361079128,1500508832,15,16528,1101.866667,1361079103114,1361079103370,1500483946,1500484202,256
1361079128,1500508832,3,540,180,1361079103367,1361079103431,1500484199,1500484263,64
1361079134,138828728,8,1233,154.125,1361079126092,1361079126092,138820820,138820820,0
1361079134,138828728,9,2725,302.7777778,1361079126092,1361079126092,138820820,138820820,0
1361079134,138828728,10,1395,139.5,1361079126156,1361079126220,138820884,138820948,64
1361079134,138828728,10,1395,139.5,1361079130192,1361079130256,138824920,138824984,64
1361079134,138828728,8,1233,154.125,1361079130127,1361079130127,138824855,138824855,0
1361079134,138828732,15,10572,704.8,1361079132681,1361079133193,138827413,138827925,512
1361079134,138828732,10,1395,139.5,1361079133384,1361079133512,138828116,138828244,128
1361079134,138828732,8,1233,154.125,1361079133384,1361079133384,138828116,138828116,0
1361079134,138828732,8,1132,141.5,1361079130120,1361079130120,138824852,138824852,0
1361079134,138828732,5459,7775387,1424.324418,1361079130188,1361079132876,138824920,138827608,2688
1361079134,138828736,15,10780,718.6666667,1361079128454,1361079128646,138823190,138823382,192
1361079136,1500516924,29,34146,1177.448276,1361079114029,1361079129133,1500494953,1500510057,15104
1361079142,138836740,15,10860,724,1361079135554,1361079135874,138830294,138830614,320
1361079142,138836740,15,11244,749.6,1361079139713,1361079140289,138834453,138835029,576
1361079142,138836740,8,1233,154.125,1361079140416,1361079140416,138835156,138835156,0
1361079142,138836744,10,1395,139.5,1361079136061,1361079136125,138830805,138830869,64
1361079142,138836744,8,1233,154.125,1361079135997,1361079135997,138830741,138830741,0
1361079142,138836744,10,1395,139.5,1361079140413,1361079140477,138835157,138835221,64
1361079150,138844740,777,1096690,1411.441441,1361079147586,1361079148482,138842326,138843222,896
1361079150,138844744,10,1156,115.6,1361079147391,1361079147583,138842135,138842327,192
1361079154,138848524,2,104,52,1361079126169,1361079126169,138820693,138820693,0
1361079154,138848548,1,52,52,1361079129153,1361079129153,138823701,138823701,0
1361079155,1500536788,1,52,52,1361079128782,1361079128782,1500510570,1500510570,0
1361079160,1500540976,6,4035,672.5,1361079153655,1361079153783,1500534631,1500534759,128
1361079182,138876736,108,142938,1323.5,1361079094149,1361079177605,138788885,138872341,83456
1361079184,1500565152,2,104,52,1361079177992,1361079177992,1500559144,1500559144,0
1361079184,1500565200,3,150,50,1361079177946,1361079178010,1500559146,1500559210,64
1361079188,1500568972,272,380363,1398.393382,1361079094716,1361079178172,1500475688,1500559144,83456
1361079190,138884744,2462,3482923,1414.672218,1361079183934,1361079185022,138878678,138879766,1088
1361079190,138884748,8,1052,131.5,1361079183674,1361079183930,138878422,138878678,256
1361079190,138884748,1215,1714787,1411.347325,1361079187833,1361079188473,138882581,138883221,640
1361079190,138884748,8,1036,129.5,1361079187833,1361079187833,138882581,138882581,0
1361079198,138892740,501,694105,1385.439122,1361079192450,1361079192770,138887190,138887510,320
1361079198,138892740,8,1052,131.5,1361079192386,1361079192450,138887126,138887190,64
1361079198,138892744,8,1243,155.375,1361079192958,1361079192958,138887702,138887702,0
1361079198,138892744,12,7099,591.5833333,1361079196158,1361079196222,138890902,138890966,64
1361079202,138896668,1,52,52,1361079177675,1361079177675,138872343,138872343,0
1361079202,138896668,1,52,52,1361079177675,1361079177675,138872343,138872343,0
1361079202,138896668,1,52,52,1361079177675,1361079177675,138872343,138872343,0
1361079202,138896668,1,52,52,1361079177675,1361079177675,138872343,138872343,0
1361079202,138896668,1,52,52,1361079177675,1361079177675,138872343,138872343,0
1361079204,1500585020,1,52,52,1361079178124,1361079178124,1500559144,1500559144,0
1361079204,1500585020,1,52,52,1361079178124,1361079178124,1500559144,1500559144,0
1361079204,1500585020,1,52,52,1361079178124,1361079178124,1500559144,1500559144,0
1361079204,1500585020,1,52,52,1361079178124,1361079178124,1500559144,1500559144,0
1361079204,1500585020,1,52,52,1361079178124,1361079178124,1500559144,1500559144,0
1361079204,1500585020,1,52,52,1361079178124,1361079178124,1500559144,1500559144,0
1361079204,1500585072,1,52,52,1361079178071,1361079178071,1500559143,1500559143,0
1361079204,1500585072,1,52,52,1361079178070,1361079178070,1500559142,1500559142,0
1361079204,1500585072,1,52,52,1361079178070,1361079178070,1500559142,1500559142,0
1361079204,1500585072,1,46,46,1361079178070,1361079178070,1500559142,1500559142,0
1361079204,1500585076,1,52,52,1361079178069,1361079178069,1500559145,1500559145,0
1361079204,1500585076,1,52,52,1361079178069,1361079178069,1500559145,1500559145,0
1361079204,1500585076,1,46,46,1361079178069,1361079178069,1500559145,1500559145,0
1361079202,138896692,1,52,52,1361079177652,1361079177652,138872344,138872344,0
1361079202,138896692,1,52,52,1361079177652,1361079177652,138872344,138872344,0
1361079202,138896692,1,52,52,1361079177651,1361079177651,138872343,138872343,0
1361079202,138896692,1,52,52,1361079177651,1361079177651,138872343,138872343,0
1361079206,138900744,8,1036,129.5,1361079198016,1361079198080,138892760,138892824,64
1361079206,138900744,1588,2254191,1419.515743,1361079198080,1361079198784,138892824,138893528,704
1361079206,138900744,6395,9094952,1422.197342,1361079202367,1361079205375,138897111,138900119,3008
1361079206,138900744,8,1036,129.5,1361079202303,1361079202367,138897047,138897111,64
1361079230,138924748,10,1140,114,1361079227322,1361079227514,138922070,138922262,192
1361079238,138932748,6455,9191787,1423.979396,1361079227515,1361079230331,138922263,138925079,2816
1361079316,1500697292,5,1708,341.6,1361079290617,1361079290681,1500671909,1500671973,64
1361079328,1500709168,184,246277,1338.461957,1361079018422,1361079023478,1500399590,1500404646,5056
1361079332,1500713288,70,91099,1301.414286,1361079305471,1361079307711,1500686759,1500688999,2240
1361079348,1500729448,1,76,76,1361079321055,1361079321055,1500702503,1500702503,0
1361079364,1500745444,1,52,52,1361079337570,1361079337570,1500719014,1500719014,0
1361079364,1500745516,1,52,52,1361079337432,1361079337432,1500718948,1500718948,0
1361079366,139060984,100,135883,1358.83,1361079067790,1361079067982,138762774,138762966,192
1361079410,139104940,10,1395,139.5,1361079409914,1361079410042,139104854,139104982,128
1361079414,139108916,18,14559,808.8333333,1361079409237,1361079409749,139104153,139104665,512
1361079414,139108916,8,1233,154.125,1361079409877,1361079409941,139104793,139104857,64
1361079430,139124876,15,10860,724,1361079423356,1361079423740,139118232,139118616,384
1361079430,139124876,11,1455,132.2727273,1361079424827,1361079425787,139119703,139120663,960
1361079430,139124876,9,1293,143.6666667,1361079423931,1361079424763,139118807,139119639,832
1361079446,139140876,9,1088,120.8888889,1361079444026,1361079444154,139138902,139139030,128
1361079446,139140880,880,1242579,1412.021591,1361079444150,1361079444662,139139030,139139542,512
1361079452,1500833532,3,138,46,1361079426378,1361079435402,1500807910,1500816934,9024
1361079518,139212872,15,10588,705.8666667,1361079514238,1361079514814,139209110,139209686,576
1361079518,139212880,8,1233,154.125,1361079515002,1361079515066,139209882,139209946,64
1361079518,139212880,10,1395,139.5,1361079515066,1361079515130,139209946,139210010,64
1361079526,139220872,8,1515,189.375,1361079523454,1361079523518,139218326,139218390,64
1361079526,139220876,8,1036,129.5,1361079523518,1361079523582,139218394,139218458,64
1361079526,139220876,18,13920,773.3333333,1361079520700,1361079521596,139215576,139216472,896
1361079526,139220876,8,1233,154.125,1361079521724,1361079521788,139216600,139216664,64
1361079526,139220880,10,1395,139.5,1361079521784,1361079521848,139216664,139216728,64
1361079526,139220880,8,1036,129.5,1361079521720,1361079521784,139216600,139216664,64
1361079534,139228876,5472,7791146,1423.820541,1361079523582,1361079526270,139218458,139221146,2688
1361079558,139252872,15,10860,724,1361079555135,1361079555583,139250007,139250455,448
1361079558,139252872,8,1233,154.125,1361079555710,1361079555774,139250582,139250646,64
1361079558,139252876,10,1395,139.5,1361079552893,1361079553021,139247769,139247897,128
1361079558,139252876,16,10856,678.5,1361079551291,1361079552635,139246167,139247511,1344
1361079558,139252876,9,1343,149.2222222,1361079555771,1361079555899,139250647,139250775,128
1361079558,139252880,8,1036,129.5,1361079552890,1361079552890,139247770,139247770,0
1361079558,139252880,8,1233,154.125,1361079552825,1361079552889,139247705,139247769,64
1361079598,139292880,15,16883,1125.533333,1361079594423,1361079594487,139289303,139289367,64
1361079601,1500981904,17,7211,424.1764706,1361079595320,1361079595640,1500976224,1500976544,320
1361079785,1501165920,1,46,46,1361079757734,1361079757734,1501138654,1501138654,0
1361079823,139517460,3547,5049924,1423.716944,1361079522205,1361079523869,139216665,139218329,1664
1361079859,139553388,3786,5389364,1423.498151,1361079553445,1361079555685,139247833,139250073,2240
1361079861,1501242176,1,76,76,1361079833319,1361079833319,1501214495,1501214495,0
1361079953,1501334448,2,141,70.5,1361079928403,1361079928403,1501309851,1501309851,0
1361080371,1501751892,1,76,76,1361080344697,1361080344697,1501725589,1501725589,0
1361080611,1501992464,1,48,48,1361080583865,1361080583865,1501965329,1501965329,0
1361080856,1502236996,1,89,89,1361080828873,1361080828873,1502209869,1502209869,0
1361080884,1502265104,1,76,76,1361080857376,1361080857376,1502238480,1502238480,0
1361080928,1502309140,36,47949,1331.916667,1361080901050,1361080901114,1502282190,1502282254,64
1361080929,140623040,3,586,195.3333333,1361080901320,1361080901384,140595360,140595424,64
1361080956,1502337460,1,52,52,1361080930617,1361080930617,1502312077,1502312077,0
1361080957,140651056,1,52,52,1361080931259,1361080931259,140625315,140625315,0
1361081084,1502465456,4,1078,269.5,1361081056573,1361081056637,1502438029,1502438093,64
1361081084,1502465532,8,6434,804.25,1361081056561,1361081057329,1502438093,1502438861,768
1361081112,1502493544,1,52,52,1361081087329,1361081087329,1502468873,1502468873,0
1361081112,1502493548,1,52,52,1361081087325,1361081087325,1502468873,1502468873,0
1361081396,1502777784,1,76,76,1361081369710,1361081369710,1502751494,1502751494,0
1361081546,1502927236,9,3914,434.8888889,1361081545681,1361081545873,1502926917,1502927109,192
1361081546,1502927248,9,3737,415.2222222,1361081544645,1361081545029,1502925893,1502926277,384
1361081554,1502935212,9,3735,415,1361081546793,1361081547049,1502928005,1502928261,256
1361081554,1502935216,9,3647,405.2222222,1361081547749,1361081548517,1502928965,1502929733,768
1361081753,1503134716,1,89,89,1361081728173,1361081728173,1503109889,1503109889,0
1361081910,1503290908,1,76,76,1361081884625,1361081884625,1503265533,1503265533,0
1361082391,142085620,11,4687,426.0909091,1361082388110,1361082388238,142082730,142082858,128
1361082391,142085624,10,1875,187.5,1361082388234,1361082388554,142082858,142083178,320
1361082391,142085624,13,8719,670.6923077,1361082388554,1361082388874,142083178,142083498,320
1361082422,1503803384,1,76,76,1361082395120,1361082395120,1503776504,1503776504,0
1361084783,1506164224,1,46,46,1361084756713,1361084756713,1506137937,1506137937,0
1361084887,1506268600,1,46,46,1361084860977,1361084860977,1506242577,1506242577,0
1361084982,1506363028,4,319,79.75,1361084980395,1361084981163,1506361423,1506362191,768
1361084990,1506371032,3,267,89,1361084982118,1361084988198,1506363150,1506369230,6080
1361085014,1506395068,2,178,89,1361084996165,1361085012229,1506377233,1506393297,16064
1361085071,1506452680,1,89,89,1361085043744,1361085043744,1506425424,1506425424,0
1361085925,1507306600,1,56,56,1361085898977,1361085898977,1507280577,1507280577,0
1361087375,1508756760,1,48,48,1361087348333,1361087348333,1508730093,1508730093,0
1361088069,1509449952,2,120,60,1361088042121,1361088045065,1509423073,1509426017,2944
1361088333,1509714312,1,46,46,1361088308063,1361088308063,1509689375,1509689375,0
1361088371,1509752292,1,46,46,1361088343537,1361088343537,1509724829,1509724829,0
1361089091,1510471848,1,46,46,1361089066465,1361089066465,1510447313,1510447313,0
1361089391,1510772448,1,46,46,1361089366531,1361089366531,1510747979,1510747979,0
1361091454,1512835412,1,48,48,1361091425289,1361091425289,1512806701,1512806701,0
1361091544,1512924936,1,46,46,1361091516835,1361091516835,1512897771,1512897771,0
1361092001,1513382316,1,60,60,1361091976353,1361091976353,1513357669,1513357669,0
1361092218,1513599088,1,46,46,1361092193604,1361092193604,1513574692,1513574692,0
1361092635,1514016060,1,46,46,1361092607127,1361092607127,1513988187,1513988187,0
1361093020,1514401068,1,46,46,1361092994376,1361092994376,1514375444,1514375444,0
1361094723,1516103960,1,46,46,1361094696221,1361094696221,1516077181,1516077181,0
1361095063,1516444552,1,46,46,1361095035400,1361095035400,1516416952,1516416952,0
1361095717,1517098204,1,46,46,1361095689113,1361095689113,1517070317,1517070317,0
1361095813,1517194460,1,46,46,1361095785813,1361095785813,1517167273,1517167273,0
1361096370,1517751240,1,46,46,1361096342124,1361096342124,1517723364,1517723364,0
1361097524,1518905680,1,46,46,1361097496418,1361097496418,1518878098,1518878098,0
1361097577,1518958048,1,46,46,1361097548953,1361097548953,1518930001,1518930001,0
1361098952,1520333196,1,46,46,1361098927408,1361098927408,1520308604,1520308604,0
1361101040,1522421740,1,46,46,1361101014576,1361101014576,1522396316,1522396316,0
1361101558,1522939084,1,52,52,1361101530040,1361101530040,1522911124,1522911124,0
1361102844,1524225456,1,46,46,1361102818737,1361102818737,1524200193,1524200193,0
1361103594,1524974752,1,46,46,1361103567526,1361103567526,1524948278,1524948278,0
1361103874,1525255336,1,46,46,1361103847385,1361103847385,1525228721,1525228721,0
1361103886,1525267316,1,46,46,1361103860971,1361103860971,1525242287,1525242287,0
1361103958,1525339364,1,46,46,1361103930169,1361103930169,1525311533,1525311533,0
1361104875,1526256304,1,48,48,1361104847658,1361104847658,1526228962,1526228962,0
1361105069,1526449864,1,76,76,1361105042142,1361105042142,1526423006,1526423006,0
1361105606,1526987444,1,48,48,1361105578002,1361105578002,1526959446,1526959446,0
1361106732,1528113616,1,46,46,1361106705684,1361106705684,1528087300,1528087300,0
1361107181,1528562616,2,120,60,1361107156623,1361107159631,1528538239,1528541247,3008
1361111707,1533088576,2,120,60,1361111682162,1361111683186,1533063738,1533064762,1024
1361111768,1533148792,1,46,46,1361111739967,1361111739967,1533120759,1533120759,0
1361111800,1533180928,1,46,46,1361111774009,1361111774009,1533154937,1533154937,0
1361112140,1533521504,1,48,48,1361112112884,1361112112884,1533494388,1533494388,0
1361112525,1533906112,1,46,46,1361112500854,1361112500854,1533881966,1533881966,0
1361113764,1535145632,1,56,56,1361113738140,1361113738140,1535119772,1535119772,0
1361113800,1535181668,1,48,48,1361113775605,1361113775605,1535157273,1535157273,0
1361114140,1535520984,1,48,48,1361114111132,1361114111132,1535492116,1535492116,0
1361114262,1535643488,1,46,46,1361114234533,1361114234533,1535616021,1535616021,0
1361114755,1536135808,1,48,48,1361114729350,1361114729350,1536110158,1536110158,0
1361115773,1537154236,1,46,46,1361115747336,1361115747336,1537128572,1537128572,0
1361115889,1537270360,3,138,46,1361115861067,1361115870155,1537242427,1537251515,9088
1361116069,1537450488,1,48,48,1361116043081,1361116043081,1537424569,1537424569,0
1361118407,1539788096,1,48,48,1361118379374,1361118379374,1539760470,1539760470,0
1361121176,1542556932,1,127,127,1361121149607,1361121149607,1542530539,1542530539,0
1361121929,1543310156,1,46,46,1361121901691,1361121901691,1543282847,1543282847,0
1361122140,181834624,1,46,46,1361122114512,1361122114512,181809136,181809136,0
1361122563,1543944304,1,46,46,1361122535196,1361122535196,1543916500,1543916500,0
1361126191,1547572168,1,46,46,1361126164652,1361126164652,1547545820,1547545820,0
1361126415,1547795956,1,435,435,1361126389759,1361126389759,1547770715,1547770715,0
1361127425,1548806408,1,46,46,1361127400426,1361127400426,1548781834,1548781834,0
1361128244,1549625216,1,46,46,1361128217312,1361128217312,1549598528,1549598528,0
1361129016,1550397048,2,122,61,1361128990972,1361128993276,1550372020,1550374324,2304
1361129973,1551354512,6,324,54,1361129946395,1361129962203,1551327907,1551343715,15808
1361130250,1551631292,1,46,46,1361130221686,1361130221686,1551602978,1551602978,0
1361132631,1554012552,1,48,48,1361132606157,1361132606157,1553987709,1553987709,0
1361132699,1554080568,3,138,46,1361132673083,1361132682235,1554054651,1554063803,9152
1361132714,192408736,1,46,46,1361132688993,1361132688993,192383729,192383729,0
1361133096,1554477492,1,60,60,1361133068609,1361133068609,1554450101,1554450101,0
1361133216,1554597628,1,46,46,1361133189240,1361133189240,1554570868,1554570868,0
1361281998,1703378640,2,122,61,1361281971756,1361281973996,1703352396,1703354636,2240
1361282703,1704083600,8,3069,383.625,1361282700296,1361282701064,1704080896,1704081664,768
1361282711,1704091596,12,1086,90.5,1361282705933,1361282706189,1704086529,1704086785,256
1361282711,1704091600,13,1384,106.4615385,1361282706761,1361282707145,1704087361,1704087745,384
1361282711,1704091636,18,9166,509.2222222,1361282705573,1361282706149,1704086209,1704086785,576
1361282711,1704091640,13,1292,99.38461538,1361282706210,1361282706594,1704086850,1704087234,384
1361282719,342412984,5,872,174.4,1361282713313,1361282713377,342407297,342407361,64
1361282719,342412984,10,5156,515.6,1361282713376,1361282713760,342407360,342407744,384
1361282719,342412984,11,8558,778,1361282713760,1361282713888,342407744,342407872,128
1361282719,1704099628,5,1094,218.8,1361282713390,1361282713518,1704094018,1704094146,128
1361282719,1704099628,5,1093,218.6,1361282713516,1361282713644,1704094144,1704094272,128
1361282727,342420984,8,2312,289,1361282723618,1361282723746,342417602,342417730,128
1361282727,342420984,7,1604,229.1428571,1361282723617,1361282723809,342417601,342417793,192
1361282727,342420984,10,2634,263.4,1361282723809,1361282724513,342417793,342418497,704
1361282727,342420984,9,1766,196.2222222,1361282723809,1361282724129,342417793,342418113,320
1361282727,342420988,11,7150,650,1361282721885,1361282721949,342415873,342415937,64
1361282727,342420988,11,7886,716.9090909,1361282722204,1361282722844,342416192,342416832,640
1361282727,342420992,9,1708,189.7777778,1361282722906,1361282723610,342416898,342417602,704
1361282727,342420992,7,1604,229.1428571,1361282723609,1361282723801,342417601,342417793,192
1361282727,342420992,10,1722,172.2,1361282723800,1361282725080,342417792,342419072,1280
1361282727,342420992,10,2486,248.6,1361282723800,1361282724248,342417792,342418240,448
1361282727,342420992,9,1554,172.6666667,1361282723800,1361282724056,342417792,342418048,256
1361282727,342420996,9,1474,163.7777778,1361282721492,1361282721748,342415488,342415744,256
1361282727,342420996,7,1518,216.8571429,1361282721812,1361282721876,342415808,342415872,64
1361282727,342421008,16,12083,755.1875,1361282722186,1361282722762,342416194,342416770,576
1361282727,342421008,8,1656,207,1361282722888,1361282723720,342416896,342417728,832
1361282728,1704108160,5,380,76,1361282703810,1361282711810,1704083970,1704091970,8000
1361282728,1704108188,7,619,88.42857143,1361282701603,1361282706979,1704081791,1704087167,5376
1361282735,342428980,10,7034,703.4,1361282727717,1361282727845,342421697,342421825,128
1361282735,342428980,15,11967,797.8,1361282723813,1361282731173,342417793,342425153,7360
1361282735,342428980,13,8002,615.5384615,1361282728101,1361282728421,342422081,342422401,320
1361282735,342428980,16,14455,903.4375,1361282729187,1361282729763,342423167,342423743,576
1361282735,342428984,9,1410,156.6666667,1361282730146,1361282730402,342424130,342424386,256
1361282735,342428984,7,1188,169.7142857,1361282729890,1361282730274,342423874,342424258,384
1361282735,342428984,6,1472,245.3333333,1361282730273,1361282730401,342424257,342424385,128
1361282735,342428984,9,1638,182,1361282730401,1361282730657,342424385,342424641,256
1361282735,342428984,9,1510,167.7777778,1361282730401,1361282730657,342424385,342424641,256
1361282735,342428984,6,1472,245.3333333,1361282730273,1361282730337,342424257,342424321,64
1361282735,342428984,9,1350,150,1361282730273,1361282730401,342424257,342424385,128
1361282735,342428984,9,1794,199.3333333,1361282730784,1361282731168,342424768,342425152,384
1361282735,342428988,8,1538,192.25,1361282728092,1361282728156,342422080,342422144,64
1361282735,342428988,10,1658,165.8,1361282728155,1361282729051,342422143,342423039,896
1361282735,342428988,8,2232,279,1361282728539,1361282728603,342422527,342422591,64
1361282735,342428992,9,1606,178.4444444,1361282729050,1361282729178,342423042,342423170,128
1361282735,342428992,6,1472,245.3333333,1361282730265,1361282730329,342424257,342424321,64
1361282735,342428992,9,1494,166,1361282730393,1361282730649,342424385,342424641,256
1361282735,342428992,13,8502,654,1361282730393,1361282730777,342424385,342424769,384
1361282735,342428992,9,1350,150,1361282730776,1361282731032,342424768,342425024,256
1361282735,342428992,6,1472,245.3333333,1361282730264,1361282730392,342424256,342424384,128
1361282743,342436968,13,10907,839,1361282737712,1361282738608,342431680,342432576,896
1361282743,342436972,9,1350,150,1361282735020,1361282735276,342428992,342429248,256
1361282743,342436976,7,1188,169.7142857,1361282738919,1361282738983,342432895,342432959,64
1361282743,342436980,9,1350,150,1361282738982,1361282739046,342432962,342433026,64
1361282743,1704123620,24,27253,1135.541667,1361282724146,1361282739698,1704104766,1704120318,15552
1361282752,1704132232,6,2036,339.3333333,1361282724727,1361282724791,1704104959,1704105023,64
1361282775,342468980,199,288533,1449.914573,1361282771622,1361282772006,342465602,342465986,384
1361282775,342468984,9,1175,130.5555556,1361282770976,1361282771488,342464960,342465472,512
1361282807,342500984,11,8622,783.8181818,1361282805601,1361282805729,342499585,342499713,128
1361282807,342500992,6,747,124.5,1361282805465,1361282805465,342499457,342499457,0
1361282807,342500992,9,1830,203.3333333,1361282805529,1361282805593,342499521,342499585,64
1361282831,342525036,10,4619,461.9,1361282829870,1361282829934,342523906,342523970,64
1361282831,342525036,8,1115,139.375,1361282830062,1361282830062,342524098,342524098,0
1361282831,342525036,5,872,174.4,1361282829806,1361282829870,342523842,342523906,64
1361282831,342525036,32,35394,1106.0625,1361282830062,1361282830126,342524098,342524162,64
1361282831,342525036,9,2239,248.7777778,1361282830062,1361282830126,342524098,342524162,64
1361282831,342525036,22,24318,1105.363636,1361282830061,1361282830381,342524097,342524417,320
1361282831,342525036,18,15752,875.1111111,1361282830061,1361282830189,342524097,342524225,128
1361282831,342525036,9,2623,291.4444444,1361282830189,1361282830253,342524225,342524289,64
1361282831,342525036,8,1627,203.375,1361282830253,1361282830253,342524289,342524289,0
1361282831,342525036,10,1763,176.3,1361282830125,1361282830189,342524161,342524225,64
1361282831,342525036,11,2471,224.6363636,1361282830125,1361282830253,342524161,342524289,128
1361282831,342525036,9,2239,248.7777778,1361282830253,1361282830317,342524289,342524353,64
1361282831,342525036,9,6325,702.7777778,1361282830573,1361282830637,342524609,342524673,64
1361282831,342525036,8,1761,220.125,1361282830509,1361282830573,342524545,342524609,64
1361282831,342525036,9,3445,382.7777778,1361282830509,1361282830573,342524545,342524609,64
1361282831,342525044,8,2011,251.375,1361282830055,1361282830055,342524099,342524099,0
1361282831,342525044,36,46852,1301.444444,1361282830055,1361282830375,342524099,342524419,320
1361282831,342525044,13,8655,665.7692308,1361282829927,1361282829991,342523971,342524035,64
1361282831,342525044,37,45536,1230.702703,1361282830055,1361282830439,342524099,342524483,384
1361282831,342525044,10,2003,200.3,1361282830182,1361282830246,342524226,342524290,64
1361282831,342525044,9,2239,248.7777778,1361282830054,1361282830054,342524098,342524098,0
1361282831,342525044,9,2559,284.3333333,1361282830054,1361282830054,342524098,342524098,0
1361282831,342525044,10,6921,692.1,1361282830502,1361282830566,342524546,342524610,64
1361282831,342525044,8,1457,182.125,1361282830566,1361282830630,342524610,342524674,64
1361282831,342525044,12,10086,840.5,1361282830501,1361282830565,342524545,342524609,64
1361282831,342525044,8,1745,218.125,1361282830501,1361282830565,342524545,342524609,64
1361282831,342525044,8,1457,182.125,1361282830501,1361282830565,342524545,342524609,64
1361282831,342525044,9,2399,266.5555556,1361282830629,1361282830629,342524673,342524673,0
1361282839,342533040,10,1507,150.7,1361282837483,1361282838251,342531523,342532291,768
1361282839,342533040,10,1667,166.7,1361282838250,1361282838314,342532290,342532354,64
1361282839,342533040,15,12028,801.8666667,1361282838633,1361282838825,342532673,342532865,192
1361282839,342533040,14,12696,906.8571429,1361282838505,1361282838569,342532545,342532609,64
1361282839,342533040,10,5315,531.5,1361282838505,1361282838569,342532545,342532609,64
1361282839,342533040,9,3775,419.4444444,1361282838505,1361282838569,342532545,342532609,64
1361282839,342533040,9,2127,236.3333333,1361282838888,1361282838952,342532928,342532992,64
1361282839,342533048,10,7091,709.1,1361282838306,1361282838434,342532354,342532482,128
1361282839,342533048,9,4079,453.2222222,1361282838562,1361282838562,342532610,342532610,0
1361282839,342533048,12,8283,690.25,1361282838498,1361282838562,342532546,342532610,64
1361282839,342533048,11,5767,524.2727273,1361282838498,1361282838562,342532546,342532610,64
1361282839,342533048,12,7931,660.9166667,1361282838626,1361282838818,342532674,342532866,192
1361282839,342533048,9,4591,510.1111111,1361282838498,1361282838562,342532546,342532610,64
1361282839,342533048,9,6303,700.3333333,1361282838562,1361282838562,342532610,342532610,0
1361282839,342533048,8,1979,247.375,1361282838881,1361282838945,342532929,342532993,64
1361282839,1704219668,4,917,229.25,1361282823682,1361282835074,1704204350,1704215742,11392
1361282840,1704220404,1,46,46,1361282814921,1361282814921,1704195325,1704195325,0
1361282843,342537396,62,83910,1353.387097,1361282817414,1361282824070,342511810,342518466,6656
1361282843,342537396,24,29599,1233.291667,1361282817414,1361282824070,342511810,342518466,6656
1361282843,342537432,75,102884,1371.786667,1361282817378,1361282824034,342511810,342518466,6656
1361282843,342537432,93,130292,1400.989247,1361282817378,1361282824034,342511810,342518466,6656
1361282844,1704224420,8,7875,984.375,1361282818812,1361282823868,1704199232,1704204288,5056
1361282844,1704224460,66,92927,1407.984848,1361282817554,1361282824210,1704198014,1704204670,6656
1361282844,1704224464,30,38549,1284.966667,1361282817935,1361282824271,1704198399,1704204735,6336
1361282844,1704224464,52,73219,1408.057692,1361282817934,1361282824206,1704198398,1704204670,6272
1361282844,1704224472,22,28553,1297.863636,1361282818760,1361282824712,1704199232,1704205184,5952
1361282843,342537440,8,1457,182.125,1361282838875,1361282838939,342533315,342533379,64
1361282843,342537440,8,2267,283.375,1361282838555,1361282838619,342532995,342533059,64
1361282847,342541040,14,12894,921,1361282839339,1361282839339,342533379,342533379,0
1361282847,342541040,8,1105,138.125,1361282839339,1361282839403,342533379,342533443,64
1361282847,342541040,8,1729,216.125,1361282839339,1361282839403,342533379,342533443,64
1361282847,342541040,9,1759,195.4444444,1361282839403,1361282839659,342533443,342533699,256
1361282847,342541040,10,1651,165.1,1361282843499,1361282843627,342537539,342537667,128
1361282847,342541040,16,12012,750.75,1361282839403,1361282845355,342533443,342539395,5952
1361282847,342541040,9,2287,254.1111111,1361282839594,1361282839658,342533634,342533698,64
1361282847,342541040,8,1569,196.125,1361282839658,1361282839658,342533698,342533698,0
1361282847,342541040,8,1377,172.125,1361282839658,1361282839658,342533698,342533698,0
1361282847,342541040,8,1569,196.125,1361282839594,1361282839658,342533634,342533698,64
1361282847,342541040,13,10132,779.3846154,1361282839018,1361282839082,342533058,342533122,64
1361282847,342541040,9,4687,520.7777778,1361282839082,1361282839082,342533122,342533122,0
1361282847,342541040,17,14500,852.9411765,1361282843626,1361282844074,342537666,342538114,448
1361282847,342541040,12,10816,901.3333333,1361282839082,1361282839082,342533122,342533122,0
1361282847,342541040,9,5247,583,1361282839081,1361282839145,342533121,342533185,64
1361282847,342541040,9,2463,273.6666667,1361282839081,1361282839145,342533121,342533185,64
1361282847,342541040,20,22373,1118.65,1361282839145,1361282839209,342533185,342533249,64
1361282847,342541040,9,3935,437.2222222,1361282839145,1361282839209,342533185,342533249,64
1361282847,342541040,8,1579,197.375,1361282839145,1361282839145,342533185,342533185,0
1361282847,342541040,23,26508,1152.521739,1361282839209,1361282839273,342533249,342533313,64
1361282847,342541040,9,2383,264.7777778,1361282839145,1361282839209,342533185,342533249,64
1361282847,342541040,8,1457,182.125,1361282839208,1361282839208,342533248,342533248,0
1361282847,342541040,8,3451,431.375,1361282844136,1361282844200,342538176,342538240,64
1361282847,342541040,8,1403,175.375,1361282844200,1361282844200,342538240,342538240,0
1361282847,342541040,7,1527,218.1428571,1361282844136,1361282844200,342538176,342538240,64
1361282847,342541040,8,2731,341.375,1361282844136,1361282844200,342538176,342538240,64
1361282847,342541040,12,9936,828,1361282844199,1361282844263,342538239,342538303,64
1361282847,342541044,7,1085,155,1361282844327,1361282844455,342538371,342538499,128
1361282847,342541044,10,1455,145.5,1361282844327,1361282844455,342538371,342538499,128
1361282847,342541044,7,1101,157.2857143,1361282844327,1361282844455,342538371,342538499,128
1361282847,342541044,8,1297,162.125,1361282839271,1361282839271,342533315,342533315,0
1361282847,342541044,8,1361,170.125,1361282839271,1361282839271,342533315,342533315,0
1361282847,342541044,8,1137,142.125,1361282844327,1361282844519,342538371,342538563,192
1361282847,342541044,8,1313,164.125,1361282844455,1361282844519,342538499,342538563,64
1361282847,342541044,8,1451,181.375,1361282844519,1361282844903,342538563,342538947,384
1361282847,342541044,9,2789,309.8888889,1361282844455,1361282844519,342538499,342538563,64
1361282847,342541044,8,1291,161.375,1361282844583,1361282844647,342538627,342538691,64
1361282847,342541044,7,1383,197.5714286,1361282844582,1361282844966,342538626,342539010,384
1361282847,342541044,7,1517,216.7142857,1361282844710,1361282844774,342538754,342538818,64
1361282847,342541044,8,1723,215.375,1361282845094,1361282845350,342539138,342539394,256
1361282847,342541044,8,1291,161.375,1361282845093,1361282845157,342539137,342539201,64
1361282847,342541044,11,7079,643.5454545,1361282842212,1361282842404,342536256,342536448,192
1361282847,342541044,8,1531,191.375,1361282842471,1361282842599,342536515,342536643,128
1361282847,342541044,10,1651,165.1,1361282842599,1361282843495,342536643,342537539,896
1361282847,342541048,8,2225,278.125,1361282842979,1361282842979,342537027,342537027,0
1361282847,342541048,8,1569,196.125,1361282839266,1361282839330,342533314,342533378,64
1361282847,342541048,8,1697,212.125,1361282839330,1361282839330,342533378,342533378,0
1361282847,342541048,8,1569,196.125,1361282839330,1361282839330,342533378,342533378,0
1361282847,342541048,20,18269,913.45,1361282838946,1361282839010,342532994,342533058,64
1361282847,342541048,9,2277,253,1361282839330,1361282839394,342533378,342533442,64
1361282847,342541048,8,1457,182.125,1361282839330,1361282839330,342533378,342533378,0
1361282847,342541048,9,3429,381,1361282839330,1361282839394,342533378,342533442,64
1361282847,342541048,9,4933,548.1111111,1361282839330,1361282839394,342533378,342533442,64
1361282847,342541048,11,2679,243.5454545,1361282839394,1361282839714,342533442,342533762,320
1361282847,342541048,10,1727,172.7,1361282839394,1361282839970,342533442,342534018,576
1361282847,342541048,10,1587,158.7,1361282839394,1361282839522,342533442,342533570,128
1361282847,342541048,9,2415,268.3333333,1361282839394,1361282839586,342533442,342533634,192
1361282847,342541048,9,2959,328.7777778,1361282839009,1361282839009,342533057,342533057,0
1361282847,342541048,8,1569,196.125,1361282839521,1361282839585,342533569,342533633,64
1361282847,342541048,8,1569,196.125,1361282839649,1361282839649,342533697,342533697,0
1361282847,342541048,14,10024,716,1361282839009,1361282839073,342533057,342533121,64
1361282847,342541048,9,3807,423,1361282839073,1361282839073,342533121,342533121,0
1361282847,342541048,13,12404,954.1538462,1361282839073,1361282839073,342533121,342533121,0
1361282847,342541048,9,4805,533.8888889,1361282839969,1361282840033,342534017,342534081,64
1361282847,342541048,15,14172,944.8,1361282839072,1361282839136,342533120,342533184,64
1361282847,342541048,14,13752,982.2857143,1361282839072,1361282839136,342533120,342533184,64
1361282847,342541048,14,12648,903.4285714,1361282839136,1361282839200,342533184,342533248,64
1361282847,342541048,9,4815,535,1361282839136,1361282839200,342533184,342533248,64
1361282847,342541048,9,4127,458.5555556,1361282839135,1361282839199,342533183,342533247,64
1361282847,342541048,8,1217,152.125,1361282839203,1361282839203,342533251,342533251,0
1361282847,342541048,8,1217,152.125,1361282839203,1361282839267,342533251,342533315,64
1361282847,342541052,8,2571,321.375,1361282844127,1361282844191,342538179,342538243,64
1361282847,342541052,7,1223,174.7142857,1361282844127,1361282844191,342538179,342538243,64
1361282847,342541052,9,3935,437.2222222,1361282844127,1361282844191,342538179,342538243,64
1361282847,342541052,12,7227,602.25,1361282844191,1361282844255,342538243,342538307,64
1361282847,342541052,8,2747,343.375,1361282844127,1361282844191,342538179,342538243,64
1361282847,342541052,7,1367,195.2857143,1361282844191,1361282844255,342538243,342538307,64
1361282847,342541052,8,1441,180.125,1361282839263,1361282839263,342533315,342533315,0
1361282847,342541052,8,1291,161.375,1361282844191,1361282844191,342538243,342538243,0
1361282847,342541052,14,11688,834.8571429,1361282844191,1361282844255,342538243,342538307,64
1361282847,342541052,8,1435,179.375,1361282844191,1361282844255,342538243,342538307,64
1361282847,342541052,7,1181,168.7142857,1361282844318,1361282844382,342538370,342538434,64
1361282847,342541052,8,1137,142.125,1361282844318,1361282844510,342538370,342538562,192
1361282847,342541052,8,1185,148.125,1361282839262,1361282839262,342533314,342533314,0
1361282847,342541052,8,1105,138.125,1361282839262,1361282839262,342533314,342533314,0
1361282847,342541052,8,1345,168.125,1361282839262,1361282839262,342533314,342533314,0
1361282847,342541052,8,1137,142.125,1361282844382,1361282844510,342538434,342538562,128
1361282847,342541052,8,1137,142.125,1361282844446,1361282844574,342538498,342538626,128
1361282847,342541052,7,1527,218.1428571,1361282844510,1361282844958,342538562,342539010,448
1361282847,342541052,8,1137,142.125,1361282844446,1361282844574,342538498,342538626,128
1361282847,342541052,10,1685,168.5,1361282844574,1361282844702,342538626,342538754,128
1361282847,342541052,14,8547,610.5,1361282844509,1361282845021,342538561,342539073,512
1361282847,342541052,7,1517,216.7142857,1361282844637,1361282844765,342538689,342538817,128
1361282847,342541052,8,1457,182.125,1361282839261,1361282839325,342533313,342533377,64
1361282847,342541052,8,1681,210.125,1361282845084,1361282845148,342539136,342539200,64
1361282847,342541064,12,7931,660.9166667,1361282842450,1361282842898,342536514,342536962,448
1361282851,342545384,28,38464,1373.714286,1361282823824,1361282823952,342518208,342518336,128
1361282851,342545412,30,41107,1370.233333,1361282823796,1361282823924,342518208,342518336,128
1361282851,342545412,3,1107,369,1361282823796,1361282823796,342518208,342518208,0
1361282851,342545412,28,38464,1373.714286,1361282823796,1361282823924,342518208,342518336,128
1361282852,1704232416,17,20831,1225.352941,1361282827648,1361282827712,1704208064,1704208128,64
1361282852,1704232416,13,9794,753.3846154,1361282823934,1361282824318,1704204350,1704204734,384
1361282852,1704232416,8,5245,655.625,1361282823934,1361282824254,1704204350,1704204670,320
1361282852,1704232460,35,47689,1362.542857,1361282827604,1361282827732,1704208064,1704208192,128
1361282852,1704232460,14,16477,1176.928571,1361282827795,1361282828051,1704208255,1704208511,256
1361282855,342549028,190,272146,1432.347368,1361282851893,1361282852405,342545921,342546433,512
1361282855,342549028,8,1116,139.5,1361282851765,1361282851829,342545793,342545857,64
1361282855,342549032,12,10736,894.6666667,1361282849010,1361282849074,342543042,342543106,64
1361282855,342549032,8,1393,174.125,1361282849073,1361282849137,342543105,342543169,64
1361282855,342549032,8,1233,154.125,1361282849073,1361282849137,342543105,342543169,64
1361282855,342549032,9,1343,149.2222222,1361282849137,1361282849201,342543169,342543233,64
1361282855,342549036,12,10848,904,1361282847980,1361282848940,342542016,342542976,960
1361282855,342549040,8,2737,342.125,1361282849066,1361282849130,342543106,342543170,64
1361282855,342549040,7,1069,152.7142857,1361282849066,1361282849130,342543106,342543170,64
1361282855,342549040,9,2773,308.1111111,1361282849066,1361282849130,342543106,342543170,64
1361282855,1704235744,27,31251,1157.444444,1361282839479,1361282854583,1704220223,1704235327,15104
1361282856,1704236376,3,540,180,1361282828135,1361282828199,1704208511,1704208575,64
1361282856,1704236376,3,540,180,1361282828135,1361282828199,1704208511,1704208575,64
1361282856,1704236376,3,540,180,1361282828133,1361282828197,1704208509,1704208573,64
1361282856,1704236424,3,540,180,1361282828087,1361282828151,1704208511,1704208575,64
1361282871,342565436,6,1465,244.1666667,1361282844318,1361282844382,342538754,342538818,64
1361282887,342581100,116,159452,1374.586207,1361282817711,1361282881839,342511811,342575939,64128
1361282887,342581104,110,151569,1377.9,1361282817704,1361282881832,342511808,342575936,64128
1361282887,1704267716,2,104,52,1361282881745,1361282881745,1704262461,1704262461,0
1361282887,1704267760,296,434773,1468.827703,1361282817637,1361282881701,1704198397,1704262461,64064
1361282887,1704267760,2,104,52,1361282881701,1361282881701,1704262461,1704262461,0
1361282907,342601576,1,52,52,1361282881363,1361282881363,342575939,342575939,0
1361282907,342601576,1,52,52,1361282881363,1361282881363,342575939,342575939,0
1361282907,342601576,1,52,52,1361282881363,1361282881363,342575939,342575939,0
1361282907,342601576,1,52,52,1361282881363,1361282881363,342575939,342575939,0
1361282907,342601612,1,52,52,1361282881324,1361282881324,342575936,342575936,0
1361282907,342601612,1,52,52,1361282881324,1361282881324,342575936,342575936,0
1361282907,342601612,1,52,52,1361282881324,1361282881324,342575936,342575936,0
1361282907,342601612,1,52,52,1361282881324,1361282881324,342575936,342575936,0
1361282908,1704288528,1,52,52,1361282881931,1361282881931,1704262459,1704262459,0
1361282908,1704288532,1,52,52,1361282881931,1361282881931,1704262463,1704262463,0
1361282908,1704288532,1,52,52,1361282881930,1361282881930,1704262462,1704262462,0
1361282908,1704288532,1,52,52,1361282881930,1361282881930,1704262462,1704262462,0
1361282908,1704288596,1,52,52,1361282881865,1361282881865,1704262461,1704262461,0
1361282908,1704288596,1,52,52,1361282881865,1361282881865,1704262461,1704262461,0
1361282908,1704288596,1,52,52,1361282881864,1361282881864,1704262460,1704262460,0
1361282908,1704288600,1,52,52,1361282881863,1361282881863,1704262463,1704262463,0
1361282908,1704288600,1,52,52,1361282881863,1361282881863,1704262463,1704262463,0
1361282908,1704288600,1,52,52,1361282881863,1361282881863,1704262463,1704262463,0
1361282908,1704288600,1,52,52,1361282881863,1361282881863,1704262463,1704262463,0
1361282908,1704288600,1,46,46,1361282881863,1361282881863,1704262463,1704262463,0
1361282908,1704288600,1,46,46,1361282881863,1361282881863,1704262463,1704262463,0
1361283205,1704585472,1,76,76,1361283178498,1361283178498,1704558970,1704558970,0
1361283367,1704748072,7,6463,923.2857143,1361283366437,1361283366565,1704747509,1704747637,128
1361283392,343086188,3,586,195.3333333,1361283366745,1361283366745,343060933,343060933,0
1361283393,1704773944,1,46,46,1361283368036,1361283368036,1704748980,1704748980,0
1361283393,1704773960,37,51486,1391.513514,1361283366484,1361283366548,1704747444,1704747508,64
1361283421,1704801916,1,52,52,1361283396544,1361283396544,1704777460,1704777460,0
1361283424,343118352,1,52,52,1361283396597,1361283396597,343090949,343090949,0
1361283633,1705014128,2,141,70.5,1361283606060,1361283606060,1704987188,1704987188,0
1361283718,1705098284,1,76,76,1361283692659,1361283692659,1705072943,1705072943,0
1361283758,1705138408,1,48,48,1361283733239,1361283733239,1705113647,1705113647,0
1361284231,1705611744,1,76,76,1361284206240,1361284206240,1705586984,1705586984,0
1361284532,1705912476,1,89,89,1361284506729,1361284506729,1705887205,1705887205,0
1361284748,1706128796,1,76,76,1361284720167,1361284720167,1706100963,1706100963,0
1361285169,1706549712,7,6444,920.5714286,1361285168625,1361285168817,1706549337,1706549529,192
1361285193,1706573564,43,59122,1374.930233,1361285168710,1361285168838,1706549274,1706549402,128
1361285195,344888936,3,586,195.3333333,1361285168866,1361285168866,344862802,344862802,0
1361285197,1706577484,1,46,46,1361285169238,1361285169238,1706549722,1706549722,0
1361285223,344917012,1,52,52,1361285198742,1361285198742,344892754,344892754,0
1361285225,1706605556,1,52,52,1361285198734,1361285198734,1706579290,1706579290,0
1361285257,1706637624,1,76,76,1361285231368,1361285231368,1706611992,1706611992,0
1361285361,1706741904,9,3914,434.8888889,1361285358512,1361285358704,1706739416,1706739608,192
1361285361,1706741928,9,3735,415,1361285359575,1361285359767,1706740503,1706740695,192
1361285361,1706741964,9,3737,415.2222222,1361285357427,1361285357619,1706738391,1706738583,192
1361285369,1706749900,9,3646,405.1111111,1361285360565,1361285361333,1706741465,1706742233,768
1361285433,1706813792,1,89,89,1361285406429,1361285406429,1706787221,1706787221,0
1361285770,1707150656,1,76,76,1361285744352,1361285744352,1707125008,1707125008,0
1361285883,1707263180,1,46,46,1361285856187,1361285856187,1707236367,1707236367,0
1361286284,1707664400,1,76,76,1361286257563,1361286257563,1707637963,1707637963,0
1361286332,1707712316,1,89,89,1361286306927,1361286306927,1707687243,1707687243,0
1361287011,1708391248,15,6998,466.5333333,1361287003429,1361287004005,1708383677,1708384253,576
1361287011,1708391280,12,1339,111.5833333,1361287004679,1361287004999,1708384959,1708385279,320
1361287011,1708391324,12,1086,90.5,1361287003867,1361287004123,1708384191,1708384447,256
1361287011,1708391328,12,1246,103.8333333,1361287004184,1361287004504,1708384512,1708384832,320
1361287025,1708405640,8,608,76,1361286999840,1361287013856,1708380480,1708394496,14016
1361287025,1708405652,15,3688,245.8666667,1361286997332,1361287004116,1708377984,1708384768,6784
1361287025,1708405676,2,141,70.5,1361286998265,1361286998265,1708378941,1708378941,0
1361287080,346774444,20,18439,921.95,1361287079155,1361287079667,346773599,346774111,512
1361287080,346774468,8,1329,166.125,1361287079899,1361287079899,346774367,346774367,0
1361287080,346774472,8,1339,167.375,1361287079830,1361287079894,346774302,346774366,64
1361287088,346782440,9,1583,175.8888889,1361287079927,1361287080119,346774367,346774559,192
1361287088,346782440,9,1599,177.6666667,1361287079927,1361287080119,346774367,346774559,192
1361287088,346782440,8,1569,196.125,1361287079991,1361287079991,346774431,346774431,0
1361287088,346782440,8,1569,196.125,1361287079991,1361287080055,346774431,346774495,64
1361287088,346782440,8,1569,196.125,1361287080054,1361287080118,346774494,346774558,64
1361287088,346782440,10,1827,182.7,1361287080245,1361287080309,346774685,346774749,64
1361287088,346782440,12,7099,591.5833333,1361287081523,1361287081651,346775963,346776091,128
1361287088,346782444,10,7827,782.7,1361287081715,1361287081907,346776159,346776351,192
1361287088,346782444,8,1569,196.125,1361287082097,1361287082481,346776541,346776925,384
1361287088,346782444,9,2415,268.3333333,1361287082224,1361287082736,346776668,346777180,512
1361287088,346782444,8,1707,213.375,1361287082224,1361287082736,346776668,346777180,512
1361287088,346782444,11,2679,243.5454545,1361287082224,1361287082544,346776668,346776988,320
1361287088,346782444,10,1715,171.5,1361287082224,1361287083248,346776668,346777692,1024
1361287088,346782448,8,1569,196.125,1361287082415,1361287082735,346776863,346777183,320
1361287088,346782448,10,1673,167.3,1361287082479,1361287082735,346776927,346777183,256
1361287088,346782452,8,1547,193.375,1361287087850,1361287087914,346782302,346782366,64
1361287088,346782452,13,8495,653.4615385,1361287079914,1361287080170,346774366,346774622,256
1361287088,346782452,9,1727,191.8888889,1361287079913,1361287080105,346774365,346774557,192
1361287088,346782452,8,1291,161.375,1361287079977,1361287079977,346774429,346774429,0
1361287088,346782452,8,1569,196.125,1361287079977,1361287080041,346774429,346774493,64
1361287088,346782452,8,1291,161.375,1361287080235,1361287080235,346774687,346774687,0
1361287088,346782464,15,12028,801.8666667,1361287081693,1361287081885,346776157,346776349,192
1361287088,346782468,8,1569,196.125,1361287082075,1361287082523,346776543,346776991,448
1361287088,346782468,8,2225,278.125,1361287082075,1361287082139,346776543,346776607,64
1361287088,346782468,15,11960,797.3333333,1361287082202,1361287087386,346776670,346781854,5184
1361287088,346782468,10,1599,159.9,1361287082202,1361287082522,346776670,346776990,320
1361287088,346782468,8,1569,196.125,1361287082329,1361287082585,346776797,346777053,256
1361287088,346782468,10,1673,167.3,1361287082392,1361287082712,346776860,346777180,320
1361287088,346782468,10,7027,702.7,1361287087064,1361287087192,346781532,346781660,128
1361287088,346782468,10,7827,782.7,1361287087259,1361287087515,346781727,346781983,256
1361287088,346782472,8,1531,191.375,1361287087255,1361287087383,346781727,346781855,128
1361287088,346782472,8,1547,193.375,1361287087382,1361287087830,346781854,346782302,448
1361287088,346782472,9,2277,253,1361287087637,1361287087637,346782109,346782109,0
1361287096,346790436,10,1443,144.3,1361287088504,1361287088632,346782940,346783068,128
1361287096,346790436,10,1407,140.7,1361287088632,1361287088760,346783068,346783196,128
1361287096,346790436,7,1517,216.7142857,1361287088695,1361287088759,346783131,346783195,64
1361287096,346790436,7,1517,216.7142857,1361287088695,1361287088759,346783131,346783195,64
1361287096,346790436,10,1539,153.9,1361287088567,1361287088823,346783003,346783259,256
1361287096,346790440,8,1291,161.375,1361287088886,1361287088886,346783326,346783326,0
1361287096,346790444,17,14500,852.9411765,1361287087921,1361287088369,346782365,346782813,448
1361287096,346790448,7,1181,168.7142857,1361287088493,1361287088557,346782941,346783005,64
1361287096,346790448,8,1451,181.375,1361287088556,1361287088812,346783004,346783260,256
1361287096,346790448,8,1569,196.125,1361287088620,1361287088620,346783068,346783068,0
1361287096,346790448,7,1517,216.7142857,1361287088684,1361287088748,346783132,346783196,64
1361287096,346790448,13,8095,622.6923077,1361287088556,1361287088812,346783004,346783260,256
1361287096,346790448,10,1603,160.3,1361287088556,1361287088812,346783004,346783260,256
1361287096,346790460,8,1723,215.375,1361287088867,1361287089059,346783327,346783519,192
1361287099,1708479328,30,35491,1183.033333,1361287083222,1361287098326,1708463550,1708478654,15104
1361287136,346830532,14,10360,740,1361287131994,1361287132826,346826526,346827358,832
1361287136,346830532,8,1233,154.125,1361287132952,1361287133016,346827484,346827548,64
1361287136,346830532,8,1291,161.375,1361287133016,1361287133080,346827548,346827612,64
1361287144,346838512,8,1233,154.125,1361287136366,1361287136366,346830878,346830878,0
1361287144,346838532,9,2725,302.7777778,1361287136345,1361287136345,346830877,346830877,0
1361287144,346838532,9,1343,149.2222222,1361287136408,1361287136408,346830940,346830940,0
1361287144,346838536,14,10408,743.4285714,1361287135382,1361287136214,346829918,346830750,832
1361287145,1708525936,1,52,52,1361287118903,1361287118903,1708499839,1708499839,0
1361287160,346854508,7,1591,227.2857143,1361287158706,1361287158770,346853214,346853278,64
1361287160,346854508,7,559,79.85714286,1361287158897,1361287158961,346853405,346853469,64
1361287160,346854508,12,7147,595.5833333,1361287158961,1361287159089,346853469,346853597,128
1361287160,346854508,14,10672,762.2857143,1361287158896,1361287159216,346853404,346853724,320
1361287160,346854512,14,10632,759.4285714,1361287159151,1361287159471,346853663,346853983,320
1361287160,346854512,10,1395,139.5,1361287159726,1361287159790,346854238,346854302,64
1361287160,346854512,9,6159,684.3333333,1361287159597,1361287159597,346854109,346854109,0
1361287160,346854528,12,7147,595.5833333,1361287158750,1361287158878,346853278,346853406,128
1361287160,346854528,10,7827,782.7,1361287159135,1361287159391,346853663,346853919,256
1361287160,346854532,9,2277,253,1361287159451,1361287159515,346853983,346854047,64
1361287160,346854532,8,1233,154.125,1361287159578,1361287159578,346854110,346854110,0
1361287160,346854532,8,1132,141.5,1361287159706,1361287159770,346854238,346854302,64
1361287168,346862528,1673,2493151,1490.227735,1361287159772,1361287160860,346854300,346855388,1088
1361287200,346894516,10,1619,161.9,1361287199402,1361287199658,346893918,346894174,256
1361287200,346894516,8,1052,131.5,1361287199656,1361287199656,346894172,346894172,0
1361287208,346902500,1698,2529203,1489.518846,1361287199674,1361287200954,346894174,346895454,1280
1361287402,1708782804,9,684,76,1361287376693,1361287392693,1708757497,1708773497,16000
1361287571,1708951656,8,6493,811.625,1361287569928,1361287570248,1708950584,1708950904,320
1361287594,347288428,3,586,195.3333333,1361287569606,1361287569606,347264034,347264034,0
1361287595,1708975372,41,56484,1377.658537,1361287570210,1361287570274,1708950582,1708950646,64
1361287626,347320432,1,52,52,1361287599616,1361287599616,347294048,347294048,0
1361287627,1709007316,1,52,52,1361287600215,1361287600215,1708980531,1708980531,0
1361287692,1709072784,1,46,46,1361287666372,1361287666372,1709047156,1709047156,0
1361288521,1709901368,1,52,52,1361288493081,1361288493081,1709873449,1709873449,0
1361288524,1709905132,12,1086,90.5,1361288520988,1361288521244,1709902120,1709902376,256
1361288524,1709905196,15,6998,466.5333333,1361288520413,1361288520989,1709901609,1709902185,576
1361288524,1709905200,13,1292,99.38461538,1361288521239,1361288521623,1709902439,1709902823,384
1361288525,1709905252,13,1384,106.4615385,1361288522766,1361288524046,1709903018,1709904298,1280
1361288541,1709921472,15,3688,245.8666667,1361288516080,1361288522288,1709896552,1709902760,6208
1361288545,1709925444,8,608,76,1361288517132,1361288531084,1709897576,1709911528,13952
1361288545,1709925500,2,141,70.5,1361288516948,1361288516948,1709897448,1709897448,0
1361288605,1709985544,1,76,76,1361288580008,1361288580008,1709960552,1709960552,0
1361288697,1710077816,1,60,60,1361288670486,1361288670486,1710051302,1710051302,0
1361289118,1710498708,1,76,76,1361289090873,1361289090873,1710471581,1710471581,0
1361289447,1710827340,2,141,70.5,1361289422439,1361289422439,1710802779,1710802779,0
1361289553,349247304,10,7827,782.7,1361289545293,1361289545741,349239597,349240045,448
1361289553,349247304,11,7095,645,1361289549516,1361289549772,349243820,349244076,256
1361289553,349247308,12,7147,595.5833333,1361289549770,1361289550154,349244078,349244462,384
1361289553,349247308,12,10528,877.3333333,1361289550216,1361289550728,349244524,349245036,512
1361289553,349247308,8,1291,161.375,1361289547016,1361289547080,349241324,349241388,64
1361289553,349247312,9,6159,684.3333333,1361289550918,1361289550982,349245230,349245294,64
1361289553,349247312,7,1181,168.7142857,1361289550918,1361289550918,349245230,349245230,0
1361289553,349247312,8,1132,141.5,1361289551110,1361289551174,349245422,349245486,64
1361289553,349247316,15,11070,738,1361289544898,1361289545154,349239214,349239470,256
1361289553,349247316,12,10400,866.6666667,1361289545281,1361289546817,349239597,349241133,1536
1361289553,349247316,9,1695,188.3333333,1361289549378,1361289549506,349243694,349243822,128
1361289553,349247332,8,2305,288.125,1361289545778,1361289545842,349240110,349240174,64
1361289553,349247332,8,1233,154.125,1361289546928,1361289546992,349241260,349241324,64
1361289553,349247332,12,7931,660.9166667,1361289550195,1361289550707,349244527,349245039,512
1361289553,349247336,9,2277,253,1361289550893,1361289550893,349245229,349245229,0
1361289553,349247336,10,1395,139.5,1361289551084,1361289551148,349245420,349245484,64
1361289561,349255308,8,1052,131.5,1361289553034,1361289553866,349247342,349248174,832
1361289561,349255308,7,1463,209,1361289552905,1361289553033,349247213,349247341,128
1361289561,349255336,6071,9094662,1498.050074,1361289553837,1361289560749,349248173,349255085,6912
1361289561,349255344,10,1619,161.9,1361289555814,1361289555878,349250158,349250222,64
1361289561,349255344,8,1052,131.5,1361289555878,1361289555942,349250222,349250286,64
1361289561,349255344,6026,9026963,1498.002489,1361289551141,1361289555621,349245485,349249965,4480
1361289569,349263316,6043,9056606,1498.693695,1361289555969,1361289562753,349250285,349257069,6784
1361289569,349263332,7,1463,209,1361289565872,1361289565936,349260204,349260268,64
1361289569,349263332,7,1000,142.8571429,1361289565936,1361289566000,349260268,349260332,64
1361289577,349271000,1,60,60,1361289550077,1361289550077,349244077,349244077,0
1361289577,349271044,1,60,60,1361289550032,1361289550032,349244076,349244076,0
1361289577,349271312,6028,9029185,1497.874088,1361289566022,1361289571654,349260334,349265966,5632
1361289627,1711007764,1,76,76,1361289602809,1361289602809,1710983573,1710983573,0
1361290061,1711442124,8,6429,803.625,1361290053774,1361290054030,1711434898,1711435154,256
1361290081,1711461264,39,53258,1365.589744,1361290054568,1361290054632,1711434832,1711434896,64
1361290082,349775836,3,586,195.3333333,1361290054502,1361290054502,349748338,349748338,0
1361290109,1711489444,1,52,52,1361290084402,1361290084402,1711464846,1711464846,0
1361290110,349803904,1,52,52,1361290084449,1361290084449,349778353,349778353,0
1361290141,1711521456,1,76,76,1361290116136,1361290116136,1711496592,1711496592,0
1361290349,1711730068,1,89,89,1361290321728,1361290321728,1711702796,1711702796,0
1361290542,1711922740,1,46,46,1361290515717,1361290515717,1711896457,1711896457,0
1361290654,1712035040,1,76,76,1361290628504,1361290628504,1712009544,1712009544,0
1361290907,1712287724,3,144,48,1361290881551,1361290890383,1712262275,1712271107,8832
1361291168,1712548344,1,76,76,1361291141254,1361291141254,1712521598,1712521598,0
1361291248,1712628644,1,89,89,1361291222171,1361291222171,1712602815,1712602815,0
1361291505,1712885316,2,96,48,1361291480476,1361291483484,1712860792,1712863800,3008
1361291565,1712945564,3,144,48,1361291537639,1361291546599,1712918203,1712927163,8960
1361291677,1713057992,1,76,76,1361291651577,1361291651577,1713032569,1713032569,0
1361291830,351524380,1,48,48,1361291800079,1361291800079,351494459,351494459,0
1361291863,1713243236,8,6386,798.25,1361291856105,1361291856361,1713236341,1713236597,256
1361291880,351574076,3,586,195.3333333,1361291855744,1361291856640,351549820,351550716,896
1361291882,1713262644,40,55634,1390.85,1361291856914,1361291856978,1713237558,1713237622,64
1361291910,1713290752,1,52,52,1361291885540,1361291885540,1713266292,1713266292,0
1361291912,351606276,1,52,52,1361291885496,1361291885496,351579772,351579772,0
1361292033,1713413488,1,48,48,1361292003882,1361292003882,1713384370,1713384370,0
1361292143,1713524084,5,605,121,1361292139349,1361292139413,1713520433,1713520497,64
1361292143,1713524084,4,366,91.5,1361292139539,1361292139859,1713520623,1713520943,320
1361292143,1713524088,6,2713,452.1666667,1361292139342,1361292139406,1713520430,1713520494,64
1361292144,1713524152,15,5402,360.1333333,1361292140472,1361292140920,1713520624,1713521072,448
1361292144,1713524152,10,2776,277.6,1361292140663,1361292140727,1713520815,1713520879,64
1361292144,1713524160,40,55235,1380.875,1361292141234,1361292141490,1713521394,1713521650,256
1361292147,1713527420,1,89,89,1361292122411,1361292122411,1713502831,1713502831,0
1361292191,1713571360,1,76,76,1361292166247,1361292166247,1713546607,1713546607,0
1361292330,352023892,11,8615,783.1818182,1361292329403,1361292329467,352023295,352023359,64
1361292330,352023904,11,4687,426.0909091,1361292329136,1361292329200,352023040,352023104,64
1361292330,352023904,8,1771,221.375,1361292329200,1361292329392,352023104,352023296,192
1361300166,1721546444,1,60,60,1361300139033,1361300139033,1721519477,1721519477,0
1361300458,1721838804,3,138,46,1361300431533,1361300432877,1721812337,1721813681,1344
1361300458,1721838848,1,46,46,1361300432834,1361300432834,1721813682,1721813682,0
1361300458,1721838872,18,5962,331.2222222,1361300433067,1361300448683,1721813939,1721829555,15616
1361300458,1721838908,2,92,46,1361300431428,1361300432836,1721812336,1721813744,1408
1361300458,1721838956,1,46,46,1361300432724,1361300432724,1721813680,1721813680,0
1361300462,1721842864,3,184,61.33333333,1361300434097,1361300434481,1721814961,1721815345,384
1361300486,1721867096,2,550,275,1361300460681,1361300485065,1721841777,1721866161,24384
1361300562,1721942908,1,275,275,1361300534019,1361300534019,1721914927,1721914927,0
1361300598,1721978984,21,6585,313.5714286,1361300570742,1361300581686,1721951726,1721962670,10944
1361300598,1721979060,3,184,61.33333333,1361300569964,1361300570348,1721951024,1721951408,384
1361300626,1722006984,7,1558,222.5714286,1361300599542,1361300619638,1721980526,1722000622,20096
1361300658,1722039064,1,275,275,1361300631400,1361300631400,1722012464,1722012464,0
1361300666,1722047052,1,251,251,1361300640305,1361300640305,1722021357,1722021357,0
1361300707,1722087328,1,251,251,1361300682500,1361300682500,1722062828,1722062828,0
1361300779,1722159348,1,275,275,1361300752113,1361300752113,1722132461,1722132461,0
1361300791,1722171464,1,251,251,1361300765373,1361300765373,1722145837,1722145837,0
1361300899,1722279820,1,275,275,1361300871640,1361300871640,1722252460,1722252460,0
1361300911,1722291900,1,251,251,1361300884934,1361300884934,1722265834,1722265834,0
1361301020,1722400156,1,275,275,1361300992301,1361300992301,1722372457,1722372457,0
1361301032,1722412360,1,251,251,1361301005471,1361301005471,1722385831,1722385831,0
1361301064,1722444512,2,104,52,1361301061448,1361301062472,1722441960,1722442984,1024
1361301072,1722452448,2,104,52,1361301064584,1361301068744,1722445032,1722449192,4160
1361301096,1722476664,2,104,52,1361301076847,1361301093487,1722457511,1722474151,16640
1361301140,1722520340,1,275,275,1361301112180,1361301112180,1722492520,1722492520,0
1361301152,1722532892,1,52,52,1361301126538,1361301126538,1722507430,1722507430,0
1361301152,1722532936,1,251,251,1361301124895,1361301124895,1722505831,1722505831,0
1361301220,1722600848,1,52,52,1361301193140,1361301193140,1722573988,1722573988,0
1361301257,1722637128,1,275,275,1361301232389,1361301232389,1722612517,1722612517,0
1361301272,1722653048,1,251,251,1361301244779,1361301244779,1722625827,1722625827,0
1361301377,1722757252,1,275,275,1361301352262,1361301352262,1722732514,1722732514,0
1361301393,1722773220,1,251,251,1361301365606,1361301365606,1722745826,1722745826,0
1361301497,1722877652,1,275,275,1361301471860,1361301471860,1722852512,1722852512,0
1361301504,1722884904,3,156,52,1361301498810,1361301502202,1722879714,1722883106,3392
1361301513,1722893612,1,251,251,1361301485214,1361301485214,1722865826,1722865826,0
1361301536,1722917016,2,104,52,1361301515530,1361301533450,1722896546,1722914466,17920
1361301597,1722977676,1,52,52,1361301569629,1361301569629,1722950305,1722950305,0
1361301618,1722998144,1,275,275,1361301592368,1361301592368,1722972512,1722972512,0
1361301633,1723013744,1,251,251,1361301605078,1361301605078,1722985822,1722985822,0
1361301669,1723049720,1,52,52,1361301641263,1361301641263,1723021983,1723021983,0
1361301737,1723117804,1,275,275,1361301711704,1361301711704,1723092508,1723092508,0
1361301905,1723285976,1,46,46,1361301880236,1361301880236,1723261212,1723261212,0
1361301990,1723370360,1,60,60,1361301963473,1361301963473,1723343833,1723343833,0
1361301990,1723370460,1,60,60,1361301963309,1361301963309,1723343769,1723343769,0
1361302513,1723893396,12,1086,90.5,1361302511653,1361302511909,1723892049,1723892305,256
1361302513,1723893400,13,1292,99.38461538,1361302511969,1361302512289,1723892369,1723892689,320
1361302513,1723893488,12,1338,111.5,1361302512328,1361302512712,1723892816,1723893200,384
1361302513,1723893520,16,7038,439.875,1361302511081,1361302511593,1723891601,1723892113,512
1361302527,1723907980,15,3688,245.8666667,1361302500383,1361302511647,1723881363,1723892627,11264
1361302549,362242964,15,11038,735.8666667,1361302548727,1361302548855,362242691,362242819,128
1361302557,362250944,11,7879,716.2727273,1361302548940,1361302549196,362242884,362243140,256
1361302557,362250956,8,1649,206.125,1361302549312,1361302549376,362243268,362243332,64
1361302557,362250956,8,1649,206.125,1361302549376,1361302549376,362243332,362243332,0
1361302557,362250960,9,1663,184.7777778,1361302549371,1361302550267,362243331,362244227,896
1361302557,362250960,11,2519,229,1361302549371,1361302549755,362243331,362243715,384
1361302557,362250960,15,11948,796.5333333,1361302549435,1361302553339,362243395,362247299,3904
1361302557,362250960,8,1569,196.125,1361302549626,1361302549690,362243586,362243650,64
1361302557,362250960,11,7879,716.2727273,1361302552953,1361302553209,362246913,362247169,256
1361302557,362250960,8,1569,196.125,1361302549625,1361302549625,362243585,362243585,0
1361302557,362250960,10,1651,165.1,1361302553532,1361302553596,362247492,362247556,64
1361302557,362250964,17,14548,855.7647059,1361302553592,1361302554232,362247556,362248196,640
1361302557,362250964,8,1339,167.375,1361302554423,1361302554487,362248387,362248451,64
1361302557,362250964,10,1395,139.5,1361302554485,1361302554613,362248449,362248577,128
1361302557,362250964,8,1569,196.125,1361302554613,1361302554613,362248577,362248577,0
1361302557,362250964,13,9295,715,1361302554485,1361302554677,362248449,362248641,192
1361302557,362250964,8,1569,196.125,1361302554549,1361302554549,362248513,362248513,0
1361302557,362250964,8,1291,161.375,1361302554740,1361302554740,362248704,362248704,0
1361302557,362250980,9,2357,261.8888889,1361302549286,1361302549350,362243266,362243330,64
1361302557,362250980,9,1535,170.5555556,1361302549350,1361302549542,362243330,362243522,192
1361302557,362250980,11,2679,243.5454545,1361302549350,1361302549798,362243330,362243778,448
1361302557,362250980,9,1759,195.4444444,1361302549350,1361302549606,362243330,362243586,256
1361302557,362250980,10,7027,702.7,1361302552741,1361302552869,362246721,362246849,128
1361302557,362250980,8,1569,196.125,1361302549541,1361302549605,362243521,362243585,64
1361302557,362250980,8,1627,203.375,1361302552932,1361302553060,362246912,362247040,128
1361302557,362250980,8,1547,193.375,1361302553064,1361302553512,362247044,362247492,448
1361302557,362250984,8,1569,196.125,1361302549604,1361302549668,362243588,362243652,64
1361302557,362250984,9,2277,253,1361302553252,1361302553316,362247236,362247300,64
1361302557,362250984,16,12064,754,1361302548899,1361302549155,362242883,362243139,256
1361302557,362250984,8,1233,154.125,1361302554402,1361302554402,362248386,362248386,0
1361302557,362250988,10,1539,153.9,1361302554464,1361302554592,362248452,362248580,128
1361302557,362250988,9,1551,172.3333333,1361302554464,1361302554656,362248452,362248644,192
1361302557,362250988,8,1569,196.125,1361302554592,1361302554592,362248580,362248580,0
1361302557,362250988,8,1451,181.375,1361302554463,1361302554655,362248451,362248643,192
1361302557,362250988,8,1569,196.125,1361302554463,1361302554527,362248451,362248515,64
1361302557,362250988,9,1775,197.2222222,1361302554719,1361302554847,362248707,362248835,128
1361302565,362258964,15,10988,732.5333333,1361302561207,1361302562231,362255171,362256195,1024
1361302565,362258964,8,1233,154.125,1361302562293,1361302562357,362256257,362256321,64
1361302565,362258964,10,1395,139.5,1361302562357,1361302562421,362256321,362256385,64
1361302569,1723949480,26,28718,1104.538462,1361302549648,1361302564880,1723930128,1723945360,15232
1361302573,362266960,10,1395,139.5,1361302572025,1361302572089,362265985,362266049,64
1361302573,362266960,8,1233,154.125,1361302571960,1361302572024,362265920,362265984,64
1361302573,362266992,15,11260,750.6666667,1361302571034,1361302571802,362265026,362265794,768
1361302581,362274968,2299,3262080,1418.912571,1361302578480,1361302579184,362272448,362273152,704
1361302581,362274992,8,1132,141.5,1361302578395,1361302578459,362272387,362272451,64
1361302636,1724016432,1,52,52,1361302608513,1361302608513,1723988945,1723988945,0
1361302644,1724024352,1,76,76,1361302616337,1361302616337,1723996689,1723996689,0
1361303153,1724533752,1,76,76,1361303127927,1361303127927,1724508679,1724508679,0
1361303438,1724818216,2,141,70.5,1361303412428,1361303412428,1724792644,1724792644,0
1361303586,1724966828,8,6432,804,1361303585191,1361303585511,1724966019,1724966339,320
1361303610,1724990492,38,50935,1340.394737,1361303585526,1361303585590,1724966018,1724966082,64
1361303613,363306804,3,586,195.3333333,1361303585692,1361303585692,363279496,363279496,0
1361303618,1724998808,9,3737,415.2222222,1361303614202,1361303614394,1724995010,1724995202,192
1361303618,1724998836,9,3914,434.8888889,1361303615197,1361303615389,1724996033,1724996225,192
1361303618,1724998876,9,3735,415,1361303616246,1361303616502,1724997122,1724997378,256
1361303626,1725006752,9,3646,405.1111111,1361303617331,1361303618099,1724998083,1724998851,768
1361303641,363334808,1,52,52,1361303615707,1361303615707,363309515,363309515,0
1361303642,1725022544,1,52,52,1361303615423,1361303615423,1724995967,1724995967,0
1361303666,1725046616,1,76,76,1361303641082,1361303641082,1725021698,1725021698,0
1361304132,1725512804,1,46,46,1361304104372,1361304104372,1725485176,1725485176,0
1361304179,1725559716,1,76,76,1361304152013,1361304152013,1725532729,1725532729,0
1361304339,1725719852,1,89,89,1361304311809,1361304311809,1725692661,1725692661,0
1361304693,1726073092,1,76,76,1361304665654,1361304665654,1726045746,1726045746,0
1361305202,1726582672,1,76,76,1361305177065,1361305177065,1726557737,1726557737,0
1361305238,1726618676,1,89,89,1361305212006,1361305212006,1726592682,1726592682,0
1361305387,1726767976,8,6433,804.125,1361305386549,1361305386869,1726767525,1726767845,320
1361305411,365105332,3,586,195.3333333,1361305386650,1361305386650,365080982,365080982,0
1361305415,1726795136,40,53591,1339.775,1361305387327,1361305387391,1726767463,1726767527,64
1361305443,1726823184,1,52,52,1361305417293,1361305417293,1726797477,1726797477,0
1361305443,365137268,1,52,52,1361305416729,1361305416729,365110997,365110997,0
1361660233,2081612888,3,402,134,1361660205521,1361660211537,2081585409,2081591425,6016
1361661040,2082419860,1,46,46,1361661012514,1361661012514,2082392374,2082392374,0
1361661617,2082996904,1,52,52,1361661588909,1361661588909,2082968813,2082968813,0
1361661678,2083057408,1,52,52,1361661651611,1361661651611,2083031019,2083031019,0
1361662268,2083647356,1,46,46,1361662240645,1361662240645,2083620001,2083620001,0
1361663079,2084458852,1,46,46,1361663051210,1361663051210,2084431062,2084431062,0
1361663200,2084578992,1,46,46,1361663172710,1361663172710,2084551702,2084551702,0
1361663440,2084819396,1,46,46,1361663411979,1361663411979,2084791375,2084791375,0
1361663610,723303504,15,11575,771.6666667,1361663607546,1361663607674,723301050,723301178,128
1361663610,723303504,7,767,109.5714286,1361663607674,1361663607738,723301178,723301242,64
1361663610,723303504,7,767,109.5714286,1361663607674,1361663607738,723301178,723301242,64
1361663610,723303504,6,811,135.1666667,1361663607738,1361663607738,723301242,723301242,0
1361663610,723303504,7,767,109.5714286,1361663607674,1361663607738,723301178,723301242,64
1361663610,723303504,7,863,123.2857143,1361663607738,1361663607802,723301242,723301306,64
1361663610,723303504,7,863,123.2857143,1361663607738,1361663607802,723301242,723301306,64
1361663610,723303504,7,863,123.2857143,1361663607738,1361663607866,723301242,723301370,128
1361663610,723303504,11,7886,716.9090909,1361663607865,1361663608057,723301369,723301561,192
1361663610,723303504,14,14223,1015.928571,1361663608057,1361663608441,723301561,723301945,384
1361663610,723303504,7,1604,229.1428571,1361663608185,1361663608505,723301689,723302009,320
1361663610,723303504,8,2312,289,1361663608376,1361663608504,723301880,723302008,128
1361663610,723303504,8,3384,423,1361663608888,1361663609016,723302392,723302520,128
1361663610,723303504,7,1524,217.7142857,1361663609016,1361663609016,723302520,723302520,0
1361663610,723303504,9,1814,201.5555556,1361663609144,1361663609912,723302648,723303416,768
1361663610,723303504,8,1714,214.25,1361663609144,1361663609336,723302648,723302840,192
1361663610,723303504,9,2550,283.3333333,1361663609144,1361663609336,723302648,723302840,192
1361663610,723303508,7,767,109.5714286,1361663607669,1361663607733,723301177,723301241,64
1361663610,723303508,7,767,109.5714286,1361663607669,1361663607733,723301177,723301241,64
1361663610,723303508,7,767,109.5714286,1361663607669,1361663607733,723301177,723301241,64
1361663610,723303508,7,863,123.2857143,1361663607733,1361663607797,723301241,723301305,64
1361663610,723303508,7,863,123.2857143,1361663607733,1361663607797,723301241,723301305,64
1361663610,723303508,7,863,123.2857143,1361663607733,1361663607797,723301241,723301305,64
1361663610,723303508,7,767,109.5714286,1361663607797,1361663607861,723301305,723301369,64
1361663610,723303508,15,12035,802.3333333,1361663607860,1361663607988,723301368,723301496,128
1361663610,723303508,14,13933,995.2142857,1361663608052,1361663608756,723301560,723302264,704
1361663610,723303508,7,1604,229.1428571,1361663608180,1361663608500,723301688,723302008,320
1361663610,723303508,7,1524,217.7142857,1361663609011,1361663609011,723302519,723302519,0
1361663610,723303512,8,1490,186.25,1361663609139,1361663609267,723302651,723302779,128
1361663610,723303512,9,2582,286.8888889,1361663609139,1361663609395,723302651,723302907,256
1361663618,723311504,9,1350,150,1361663612346,1361663612538,723305850,723306042,192
1361663618,723311504,7,1332,190.2857143,1361663609591,1361663610039,723303095,723303543,448
1361663618,723311504,8,4760,595,1361663609591,1361663610039,723303095,723303543,448
1361663618,723311504,8,2242,280.25,1361663609591,1361663610039,723303095,723303543,448
1361663618,723311508,8,1730,216.25,1361663612341,1361663614261,723305849,723307769,1920
1361663618,723311508,7,1636,233.7142857,1361663612341,1361663612469,723305849,723305977,128
1361663618,723311512,15,11651,776.7333333,1361663609138,1361663612274,723302650,723305786,3136
1361663633,2085012124,40,49193,1229.825,1361663609817,1361663625433,2084988941,2085004557,15616
1361663637,2085016000,6,2036,339.3333333,1361663610263,1361663610391,2084989263,2084989391,128
1361663690,723383508,13,7335,564.2307692,1361663687798,1361663689654,723381306,723383162,1856
1361663690,723383508,7,1486,212.2857143,1361663688885,1361663688885,723382393,723382393,0
1361663690,723383508,8,2578,322.25,1361663689588,1361663689716,723383096,723383224,128
1361663690,723383508,8,2232,279,1361663689140,1361663689204,723382648,723382712,64
1361663690,723383508,9,7078,786.4444444,1361663689716,1361663689844,723383224,723383352,128
1361663690,723383508,7,1374,196.2857143,1361663689716,1361663689844,723383224,723383352,128
1361663690,723383508,12,11591,965.9166667,1361663689844,1361663689908,723383352,723383416,64
1361663690,723383508,7,1534,219.1428571,1361663689588,1361663689716,723383096,723383224,128
1361663690,723383508,8,3890,486.25,1361663689588,1361663689716,723383096,723383224,128
1361663690,723383508,8,2754,344.25,1361663689716,1361663689780,723383224,723383288,64
1361663690,723383508,7,1246,178,1361663689716,1361663689844,723383224,723383352,128
1361663690,723383508,7,1188,169.7142857,1361663689844,1361663689908,723383352,723383416,64
1361663690,723383508,6,1040,173.3333333,1361663689844,1361663689908,723383352,723383416,64
1361663690,723383512,12,7938,661.5,1361663688881,1361663689009,723382393,723382521,128
1361663690,723383512,9,1606,178.4444444,1361663688945,1361663689265,723382457,723382777,320
1361663690,723383512,16,14455,903.4375,1361663689329,1361663689585,723382841,723383097,256
1361663690,723383512,8,1554,194.25,1361663689265,1361663689329,723382777,723382841,64
1361663690,723383512,7,1230,175.7142857,1361663689584,1361663689712,723383096,723383224,128
1361663690,723383512,8,2738,342.25,1361663689584,1361663689712,723383096,723383224,128
1361663690,723383512,8,3458,432.25,1361663689584,1361663689712,723383096,723383224,128
1361663690,723383512,11,9891,899.1818182,1361663689712,1361663689904,723383224,723383416,192
1361663690,723383512,7,1390,198.5714286,1361663689776,1361663689840,723383288,723383352,64
1361663690,723383512,7,1358,194,1361663689712,1361663689840,723383224,723383352,128
1361663690,723383512,7,1092,156,1361663689840,1361663689904,723383352,723383416,64
1361663698,723391500,8,2744,343,1361663690111,1361663690111,723383611,723383611,0
1361663698,723391500,7,1524,217.7142857,1361663690111,1361663690111,723383611,723383611,0
1361663698,723391500,7,1524,217.7142857,1361663690111,1361663690111,723383611,723383611,0
1361663698,723391500,10,1610,161,1361663690175,1361663690367,723383675,723383867,192
1361663698,723391500,8,1458,182.25,1361663690175,1361663690367,723383675,723383867,192
1361663698,723391500,14,8778,627,1361663690174,1361663690430,723383674,723383930,256
1361663698,723391500,9,1350,150,1361663693757,1361663694013,723387257,723387513,256
1361663698,723391500,9,1350,150,1361663690492,1361663690684,723383992,723384184,192
1361663698,723391500,7,1092,156,1361663689852,1361663690108,723383352,723383608,256
1361663698,723391500,7,1108,158.2857143,1361663689916,1361663690108,723383416,723383608,192
1361663698,723391504,8,1346,168.25,1361663690043,1361663690107,723383547,723383611,64
1361663698,723391504,7,1268,181.1428571,1361663690107,1361663690107,723383611,723383611,0
1361663698,723391504,9,1350,150,1361663690107,1361663690171,723383611,723383675,64
1361663698,723391504,7,1524,217.7142857,1361663690107,1361663690107,723383611,723383611,0
1361663698,723391504,7,1524,217.7142857,1361663690107,1361663690107,723383611,723383611,0
1361663698,723391504,9,1494,166,1361663690171,1361663690299,723383675,723383803,128
1361663698,723391504,9,1350,150,1361663692538,1361663692730,723386042,723386234,192
1361663698,723391504,9,1350,150,1361663693049,1361663693241,723386553,723386745,192
1361663698,723391504,8,1730,216.25,1361663690489,1361663690681,723383993,723384185,192
1361663698,723391504,7,1092,156,1361663689912,1361663690104,723383416,723383608,192
1361663698,723391504,7,1092,156,1361663689912,1361663690104,723383416,723383608,192
1361663698,723391504,7,1092,156,1361663689912,1361663690040,723383416,723383544,128
1361663706,723399508,7,1076,153.7142857,1361663698487,1361663698615,723391995,723392123,128
1361663706,723399508,12,10743,895.25,1361663698486,1361663698614,723391994,723392122,128
1361663706,723399508,8,2744,343,1361663698486,1361663698614,723391994,723392122,128
1361663706,723399508,7,1188,169.7142857,1361663698677,1361663698805,723392185,723392313,128
1361663706,723399512,7,1348,192.5714286,1361663698480,1361663698608,723391992,723392120,128
1361663706,723399512,14,10943,781.6428571,1361663697584,1361663698096,723391096,723391608,512
1361663706,723399512,8,2728,341,1361663698480,1361663698608,723391992,723392120,128
1361663706,723399516,9,1350,150,1361663698735,1361663698863,723392251,723392379,128
1361663714,723407500,7,1087,155.2857143,1361663708668,1361663708732,723402168,723402232,64
1361663714,723407500,27,30355,1124.259259,1361663708796,1361663708924,723402296,723402424,128
1361663715,723408348,1,52,52,1361663690199,1361663690199,723383547,723383547,0
1361663753,2085132320,1,46,46,1361663725266,1361663725266,2085104586,2085104586,0
1361663793,2085172392,10,9086,908.6,1361663767371,1361663779723,2085146763,2085159115,12352
1361663793,2085172452,7,8432,1204.571429,1361663766094,1361663766350,2085145546,2085145802,256
1361663793,2085172460,84,104336,1242.095238,1361663767175,1361663784455,2085146635,2085163915,17280
1361663793,2085172460,23,28931,1257.869565,1361663767302,1361663779654,2085146762,2085159114,12352
1361663793,2085172464,6,2849,474.8333333,1361663767429,1361663779653,2085146893,2085159117,12224
1361663793,2085172464,14,17667,1261.928571,1361663767301,1361663779589,2085146765,2085159053,12288
1361663793,2085172464,13,14810,1139.230769,1361663767428,1361663779588,2085146892,2085159052,12160
1361663821,2085200516,18,23165,1286.944444,1361663795278,1361663819790,2085174794,2085199306,24512
1361663853,2085232464,49,60437,1233.408163,1361663828163,1361663848195,2085207627,2085227659,20032
1361663873,2085252520,3,402,134,1361663846540,1361663852620,2085226060,2085232140,6080
1361663873,2085252768,11,6904,627.6363636,1361663861906,1361663872658,2085241674,2085252426,10752
1361663873,2085252772,5,727,145.4,1361663862287,1361663872655,2085242059,2085252427,10368
1361663882,2085261012,12,8366,697.1666667,1361663873415,1361663879303,2085252427,2085258315,5888
1361663887,723580368,3,1519,506.3333333,1361663862597,1361663862661,723555965,723556029,64
1361663887,723580368,41,54039,1318.02439,1361663862597,1361663862853,723555965,723556221,256
1361663887,723580372,12,13359,1113.25,1361663862592,1361663862848,723555964,723556220,256
1361663887,723580396,44,58264,1324.181818,1361663862567,1361663862823,723555963,723556219,256
1361663921,2085300804,1,52,52,1361663894255,1361663894255,2085274059,2085274059,0
1361663921,2085300804,1,52,52,1361663894254,1361663894254,2085274058,2085274058,0
1361663921,2085300804,1,52,52,1361663894254,1361663894254,2085274058,2085274058,0
1361663921,2085300868,1,52,52,1361663894187,1361663894187,2085274055,2085274055,0
1361663921,2085300868,1,52,52,1361663894187,1361663894187,2085274055,2085274055,0
1361663921,2085300872,1,52,52,1361663894186,1361663894186,2085274058,2085274058,0
1361663925,2085304816,1,46,46,1361663900320,1361663900320,2085280136,2085280136,0
1361663938,2085317120,12,6095,507.9166667,1361663925465,1361663931033,2085304585,2085310153,5568
1361663962,2085341148,12,4903,408.5833333,1361663955835,1361663961531,2085334983,2085340679,5696
1361663970,2085349108,18,19481,1082.277778,1361663956642,1361663963938,2085335750,2085343046,7296
1361663981,2085360800,1,52,52,1361663955183,1361663955183,2085334983,2085334983,0
1361663986,2085365152,11,8444,767.6363636,1361663977402,1361663982906,2085356554,2085362058,5504
1361663989,2085368876,1,52,52,1361663963172,1361663963172,2085343048,2085343048,0
1361663989,2085368876,1,52,52,1361663963171,1361663963171,2085343047,2085343047,0
1361664003,723696604,1,52,52,1361663977367,1361663977367,723670971,723670971,0
1361664003,723696604,1,52,52,1361663977367,1361663977367,723670971,723670971,0
1361664003,723696644,1,52,52,1361663977328,1361663977328,723670972,723670972,0
1361664003,723696644,1,52,52,1361663977328,1361663977328,723670972,723670972,0
1361664106,2085485304,20,10462,523.1,1361664096093,1361664101725,2085475397,2085481029,5632
1361664226,2085605272,25,11888,475.52,1361664218943,1361664224895,2085598215,2085604167,5952
1361664414,2085793268,1,76,76,1361664388028,1361664388028,2085767296,2085767296,0
1361664518,2085897348,1,46,46,1361664492459,1361664492459,2085871807,2085871807,0
1361664562,2085941608,27,5366,198.7407407,1361664555622,1361664561446,2085935230,2085941054,5824
1361664594,2085973668,7,4328,618.2857143,1361664580844,1361664586476,2085960512,2085966144,5632
1361664602,2085981688,7,4477,639.5714286,1361664595289,1361664600921,2085974977,2085980609,5632
1361664606,2085985484,1,52,52,1361664581025,1361664581025,2085960509,2085960509,0
1361664622,2086001592,1,52,52,1361664595384,1361664595384,2085974976,2085974976,0
1361664698,2086077764,8,4515,564.375,1361664687370,1361664693322,2086067134,2086073086,5952
1361664706,2086085804,16,11098,693.625,1361664693280,1361664703264,2086073084,2086083068,9984
1361664724,724417704,14,14968,1069.142857,1361664697274,1361664697658,724390978,724391362,384
1361664742,2086121800,40,51782,1294.55,1361664716709,1361664736101,2086096509,2086115901,19392
1361664742,2086121800,10,12851,1285.1,1361664716836,1361664717028,2086096636,2086096828,192
1361664770,2086149812,57,69079,1211.912281,1361664742810,1361664761754,2086122622,2086141566,18944
1361664787,2086166080,8,5622,702.75,1361664776884,1361664783156,2086155964,2086162236,6272
1361664795,2086174060,9,5519,613.2222222,1361664783177,1361664788937,2086162237,2086167997,5760
1361664810,2086189920,3,144,48,1361664783594,1361664792490,2086163514,2086172410,8896
1361664839,2086217984,1,52,52,1361664813012,1361664813012,2086191996,2086191996,0
1361664840,724533848,1,52,52,1361664813098,1361664813098,724506946,724506946,0
1361664858,2086237896,1,52,52,1361664832005,1361664832005,2086211901,2086211901,0
1361664859,2086238088,14,10011,715.0714286,1361664846250,1361664851882,2086225338,2086230970,5632
1361664903,2086281988,1,52,52,1361664877902,1361664877902,2086256890,2086256890,0
1361664903,2086281988,1,52,52,1361664877965,1361664877965,2086256953,2086256953,0
1361664915,2086294296,10,9798,979.8,1361664909146,1361664914522,2086288442,2086293818,5376
1361664926,2086305904,1,76,76,1361664898362,1361664898362,2086278266,2086278266,0
1361665051,2086430388,14,10077,719.7857143,1361665042110,1361665047614,2086421498,2086427002,5504
1361665091,2086470472,5,1594,318.8,1361665081321,1361665086441,2086460793,2086465913,5120
1361665099,2086478468,14,10140,724.2857143,1361665086892,1361665092524,2086466360,2086471992,5632
1361665109,724802108,9,9566,1062.888889,1361665082000,1361665082064,724775108,724775172,64
1361665109,724802132,4,1394,348.5,1361665081718,1361665081974,724774850,724775106,256
1361665146,724839924,7,1726,246.5714286,1361665138846,1361665138910,724832770,724832834,64
1361665146,724839924,11,5224,474.9090909,1361665138782,1361665138846,724832706,724832770,64
1361665147,724839932,12,8674,722.8333333,1361665139904,1361665139968,724832836,724832900,64
1361665155,2086534552,4,1008,252,1361665144535,1361665146839,2086524087,2086526391,2304
1361665155,2086534552,4,465,116.25,1361665144535,1361665146839,2086524087,2086526391,2304
1361665155,2086534584,1031,1444693,1401.254122,1361665146487,1361665147959,2086526071,2086527543,1472
1361665171,2086550360,24,24601,1025.041667,1361665143829,1361665147029,2086523189,2086526389,3200
1361665171,2086550360,31,38112,1229.419355,1361665144341,1361665153301,2086523701,2086532661,8960
1361665171,2086550360,9,8748,972,1361665144341,1361665145109,2086523701,2086524469,768
1361665171,2086550364,4,2457,614.25,1361665144596,1361665144660,2086523960,2086524024,64
1361665171,2086550364,6,5589,931.5,1361665144531,1361665144595,2086523895,2086523959,64
1361665171,2086550388,10,10717,1071.7,1361665145081,1361665147001,2086524469,2086526389,1920
1361665171,2086550388,13,14881,1144.692308,1361665145081,1361665147001,2086524469,2086526389,1920
1361665171,2086550388,20,23902,1195.1,1361665145081,1361665153273,2086524469,2086532661,8192
1361665171,2086550388,22,26731,1215.045455,1361665145081,1361665153273,2086524469,2086532661,8192
1361665171,2086550388,5,3760,752,1361665145081,1361665145145,2086524469,2086524533,64
1361665171,2086550388,5,3543,708.6,1361665145081,1361665145145,2086524469,2086524533,64
1361665171,2086550392,3,379,126.3333333,1361665145140,1361665145524,2086524532,2086524916,384
1361665171,2086550436,40,52689,1317.225,1361665144266,1361665146954,2086523702,2086526390,2688
1361665171,2086550464,12,13938,1161.5,1361665145005,1361665146925,2086524469,2086526389,1920
1361665171,2086550464,8,7699,962.375,1361665145008,1361665146928,2086524472,2086526392,1920
1361665171,2086550464,9,8745,971.6666667,1361665145008,1361665146928,2086524472,2086526392,1920
1361665171,2086550464,5,3729,745.8,1361665145008,1361665145008,2086524472,2086524472,0
1361665171,2086550464,9,8883,987,1361665145008,1361665145008,2086524472,2086524472,0
1361665171,2086550464,32,41374,1292.9375,1361665145008,1361665153200,2086524472,2086532664,8192
1361665171,2086550464,26,32969,1268.038462,1361665145007,1361665153199,2086524471,2086532663,8192
1361665171,2086550464,3,304,101.3333333,1361665145326,1361665145326,2086524790,2086524790,0
1361665171,2086550476,3,652,217.3333333,1361665146148,1361665146148,2086525624,2086525624,0
1361665175,2086554360,1,46,46,1361665147031,1361665147031,2086526391,2086526391,0
1361665175,2086554360,3,586,195.3333333,1361665147031,1361665147095,2086526391,2086526455,64
1361665175,2086554416,3,885,295,1361665146976,1361665146976,2086526392,2086526392,0
1361665175,2086554416,10,10612,1061.2,1361665146976,1361665146976,2086526392,2086526392,0
1361665203,2086582436,3,1116,372,1361665178121,1361665178185,2086557557,2086557621,64
1361665203,2086582440,10,9336,933.6,1361665178312,1361665178824,2086557752,2086558264,512
1361665221,724914372,1,52,52,1361665196743,1361665196743,724890115,724890115,0
1361665221,724914400,1,52,52,1361665196716,1361665196716,724890116,724890116,0
1361665287,2086666596,1,52,52,1361665259497,1361665259497,2086639093,2086639093,0
1361665287,2086666596,1,52,52,1361665259496,1361665259496,2086639092,2086639092,0
1361665287,2086666596,1,52,52,1361665259496,1361665259496,2086639092,2086639092,0
1361665287,2086666596,1,52,52,1361665259496,1361665259496,2086639092,2086639092,0
1361665287,2086666596,1,52,52,1361665259624,1361665259624,2086639220,2086639220,0
1361665287,2086666632,1,52,52,1361665261445,1361665261445,2086641077,2086641077,0
1361665287,2086666632,1,52,52,1361665261445,1361665261445,2086641077,2086641077,0
1361665287,2086666632,1,52,52,1361665261445,1361665261445,2086641077,2086641077,0
1361665287,2086666632,1,52,52,1361665261445,1361665261445,2086641077,2086641077,0
1361665287,2086666632,1,52,52,1361665261445,1361665261445,2086641077,2086641077,0
1361665287,2086666644,1,52,52,1361665259450,1361665259450,2086639094,2086639094,0
1361665287,2086666644,1,52,52,1361665259450,1361665259450,2086639094,2086639094,0
1361665287,2086666644,1,52,52,1361665259450,1361665259450,2086639094,2086639094,0
1361665287,2086666644,1,52,52,1361665259449,1361665259449,2086639093,2086639093,0
1361665287,2086666676,1,52,52,1361665260378,1361665260378,2086640054,2086640054,0
1361665287,2086666684,1,52,52,1361665261394,1361665261394,2086641078,2086641078,0
1361665287,2086666684,1,52,52,1361665261394,1361665261394,2086641078,2086641078,0
1361665287,2086666684,1,52,52,1361665261394,1361665261394,2086641078,2086641078,0
1361665287,2086666684,1,52,52,1361665261393,1361665261393,2086641077,2086641077,0
1361665287,2086666684,1,52,52,1361665261393,1361665261393,2086641077,2086641077,0
1361665295,2086674596,1,52,52,1361665267497,1361665267497,2086647093,2086647093,0
1361665295,2086674596,1,52,52,1361665267496,1361665267496,2086647092,2086647092,0
1361665295,2086674668,1,52,52,1361665267425,1361665267425,2086647093,2086647093,0
1361665295,2086674668,1,52,52,1361665267425,1361665267425,2086647093,2086647093,0
1361665295,2086674668,1,52,52,1361665267425,1361665267425,2086647093,2086647093,0
1361665319,2086698580,1,52,52,1361665292471,1361665292471,2086672051,2086672051,0
1361665319,2086698612,1,52,52,1361665293464,1361665293464,2086673076,2086673076,0
1361665419,2086798684,30,32234,1074.466667,1361665391823,1361665409295,2086771507,2086788979,17472
1361665419,2086798692,3,694,231.3333333,1361665392776,1361665392776,2086772468,2086772468,0
1361665419,2086798724,3,652,217.3333333,1361665394024,1361665394024,2086773748,2086773748,0
1361665419,2086798724,3,304,101.3333333,1361665394342,1361665394406,2086774066,2086774130,64
1361665419,2086798724,5,4197,839.4,1361665394086,1361665394086,2086773810,2086773810,0
1361665419,2086798724,4,1909,477.25,1361665394086,1361665394086,2086773810,2086773810,0
1361665419,2086798724,4,2959,739.75,1361665394086,1361665394086,2086773810,2086773810,0
1361665419,2086798724,5,3391,678.2,1361665394085,1361665394149,2086773809,2086773873,64
1361665419,2086798764,8,5985,748.125,1361665392641,1361665393281,2086772405,2086773045,640
1361665419,2086798792,5,3809,761.8,1361665394021,1361665394021,2086773813,2086773813,0
1361665419,2086798792,5,3262,652.4,1361665394021,1361665394021,2086773813,2086773813,0
1361665419,2086798792,5,3827,765.4,1361665394020,1361665394084,2086773812,2086773876,64
1361665423,2086802720,11,2228,202.5454545,1361665394989,1361665415085,2086774709,2086794805,20096
1361665423,2086802768,4,1040,260,1361665395002,1361665414970,2086774770,2086794738,19968
1361665423,2086802768,3,379,126.3333333,1361665395001,1361665395321,2086774769,2086775089,320
1361665439,2086818780,1,76,76,1361665411504,1361665411504,2086791284,2086791284,0
1361665451,2086830756,1,464,464,1361665425159,1361665425159,2086804915,2086804915,0
1361665451,2086830896,6,1136,189.3333333,1361665424952,1361665428984,2086804848,2086808880,4032
1361665467,2086846772,2,645,322.5,1361665439220,1361665439284,2086818992,2086819056,64
1361665491,2086870764,3,568,189.3333333,1361665463037,1361665463037,2086842801,2086842801,0
1361665500,2086879052,10678,15208903,1424.321315,1361665422600,1361665499336,2086801652,2086878388,76736
1361665508,2086887072,17528,24961328,1424.083067,1361665413938,1361665507442,2086793010,2086886514,93504
1361665523,2086902836,6,1136,189.3333333,1361665496886,1361665505014,2086876722,2086884850,8128
1361665527,2086906760,5,2925,585,1361665499264,1361665504512,2086879024,2086884272,5248
1361665527,2086906776,11,12038,1094.363636,1361665500595,1361665500659,2086880371,2086880435,64
1361665527,2086906776,4,4899,1224.75,1361665500595,1361665500595,2086880371,2086880371,0
1361665527,2086906776,12,13053,1087.75,1361665500595,1361665500659,2086880371,2086880435,64
1361665527,2086906776,8,10038,1254.75,1361665500595,1361665500595,2086880371,2086880371,0
1361665527,2086906776,7,9130,1304.285714,1361665500594,1361665500594,2086880370,2086880370,0
1361665527,2086906848,11,11686,1062.363636,1361665500521,1361665500585,2086880369,2086880433,64
1361665527,2086906848,11,14359,1305.363636,1361665500521,1361665500585,2086880369,2086880433,64
1361665527,2086906848,8,11353,1419.125,1361665500520,1361665500520,2086880368,2086880368,0
1361665527,2086906848,9,9084,1009.333333,1361665500520,1361665500584,2086880368,2086880432,64
1361665527,2086906848,10,10521,1052.1,1361665500520,1361665500584,2086880368,2086880432,64
1361665527,2086906848,8,10220,1277.5,1361665500520,1361665500520,2086880368,2086880368,0
1361665527,2086906848,11,14996,1363.272727,1361665500520,1361665500584,2086880368,2086880432,64
1361665535,2086914808,1,52,52,1361665507473,1361665507473,2086887281,2086887281,0
1361665535,2086914808,1,46,46,1361665507473,1361665507473,2086887281,2086887281,0
1361665535,2086914808,1,46,46,1361665507473,1361665507473,2086887281,2086887281,0
1361665535,2086914860,1,52,52,1361665510558,1361665510558,2086890418,2086890418,0
1361665535,2086914896,1,52,52,1361665508346,1361665508346,2086888242,2086888242,0
1361665535,2086914896,1,52,52,1361665508346,1361665508346,2086888242,2086888242,0
1361665535,2086914916,1,52,52,1361665509347,1361665509347,2086889263,2086889263,0
1361665555,2086934856,3,568,189.3333333,1361665530466,1361665530530,2086910322,2086910386,64
1361665556,2086935052,14,10101,721.5,1361665544005,1361665549509,2086923057,2086928561,5504
1361665567,2086946828,1,52,52,1361665540414,1361665540414,2086920242,2086920242,0
1361665643,2087022908,1,52,52,1361665615274,1361665615274,2086995182,2086995182,0
1361665643,2087022908,1,52,52,1361665615274,1361665615274,2086995182,2086995182,0
1361665643,2087022908,1,52,52,1361665615274,1361665615274,2086995182,2086995182,0
1361665643,2087022908,1,52,52,1361665615274,1361665615274,2086995182,2086995182,0
1361665643,2087022912,1,52,52,1361665615273,1361665615273,2086995185,2086995185,0
1361665643,2087022912,1,52,52,1361665615273,1361665615273,2086995185,2086995185,0
1361665644,2087022960,1,52,52,1361665616223,1361665616223,2086995183,2086995183,0
1361665644,2087022960,1,52,52,1361665616223,1361665616223,2086995183,2086995183,0
1361665644,2087022960,1,52,52,1361665616223,1361665616223,2086995183,2086995183,0
1361665644,2087022960,1,52,52,1361665616223,1361665616223,2086995183,2086995183,0
1361665644,2087022960,1,52,52,1361665616223,1361665616223,2086995183,2086995183,0
1361665644,2087022960,1,52,52,1361665616223,1361665616223,2086995183,2086995183,0
1361665648,2087027004,5,3534,706.8,1361665620082,1361665620146,2086999086,2086999150,64
1361665648,2087027004,1,52,52,1361665620082,1361665620082,2086999086,2086999086,0
1361665672,2087051052,1,52,52,1361665646147,1361665646147,2087025199,2087025199,0
1361665680,2087059000,8,6466,808.25,1361665653560,1361665659064,2087032560,2087038064,5504
1361665680,2087059000,8,7505,938.125,1361665653559,1361665659063,2087032559,2087038063,5504
1361665680,2087059000,7,6302,900.2857143,1361665653559,1361665659063,2087032559,2087038063,5504
1361665680,2087059080,11,11214,1019.454545,1361665653479,1361665668583,2087032559,2087047663,15104
1361665680,2087059080,8,7473,934.125,1361665653479,1361665658983,2087032559,2087038063,5504
1361665680,2087059080,5,3369,673.8,1361665653479,1361665653543,2087032559,2087032623,64
1361665684,2087063060,7,4429,632.7142857,1361665659001,1361665659193,2087038061,2087038253,192
1361665684,2087063140,11,10634,966.7272727,1361665658925,1361665672877,2087038065,2087052017,13952
1361665684,2087063140,7,5126,732.2857143,1361665658925,1361665659117,2087038065,2087038257,192
1361665684,2087063140,9,8420,935.5555556,1361665658924,1361665668524,2087038064,2087047664,9600
1361665696,2087075080,11,9161,832.8181818,1361665668583,1361665672935,2087047663,2087052015,4352
1361665709,2087088784,3333,4721838,1416.693069,1361665392614,1361665405158,2086772398,2086784942,12544
1361665716,2087094992,1848,2623944,1419.883117,1361665407232,1361665412032,2086786224,2086791024,4800
1361665720,2087098968,5861,8335224,1422.150486,1361665393429,1361665413973,2086772397,2086792941,20544
1361665720,2087098968,396,559505,1412.891414,1361665412308,1361665413972,2086791276,2086792940,1664
1361665724,2087103004,1081,1536313,1421.196115,1361665415411,1361665418675,2086794415,2086797679,3264
1361665736,2087115392,17,7850,461.7647059,1361665708527,1361665734383,2087087919,2087113775,25856
1361665760,2087139364,40,47752,1193.8,1361665733196,1361665754380,2087112560,2087133744,21184
1361665760,2087139368,26,34276,1318.307692,1361665733702,1361665737734,2087113070,2087117102,4032
1361665760,2087139368,11,12230,1111.818182,1361665733638,1361665733702,2087113006,2087113070,64
1361665760,2087139368,28,34307,1225.25,1361665733638,1361665753990,2087113006,2087133358,20352
1361665760,2087139368,7,8946,1278,1361665733702,1361665733702,2087113070,2087113070,0
1361665760,2087139444,1,52,52,1361665733114,1361665733114,2087112558,2087112558,0
1361665760,2087139448,15,20331,1355.4,1361665733623,1361665753911,2087113071,2087133359,20288
1361665760,2087139448,15,16826,1121.733333,1361665733557,1361665753909,2087113005,2087133357,20352
1361665760,2087139448,4,646,161.5,1361665734004,1361665754868,2087113452,2087134316,20864
1361665760,2087139476,2,2765,1382.5,1361665734106,1361665734106,2087113582,2087113582,0
1361665780,2087159492,3,652,217.3333333,1361665753738,1361665753802,2087133230,2087133294,64
1361665780,2087159492,5,3516,703.2,1361665753866,1361665753866,2087133358,2087133358,0
1361665780,2087159492,3,3586,1195.333333,1361665753865,1361665753865,2087133357,2087133357,0
1361665780,2087159492,4,3774,943.5,1361665753864,1361665753864,2087133356,2087133356,0
1361665780,2087159496,1,192,192,1361665754182,1361665754182,2087133678,2087133678,0
1361665780,2087159496,8,5977,747.125,1361665754182,1361665754502,2087133678,2087133998,320
1361665780,2087159500,10,1764,176.4,1361665754816,1361665772800,2087134316,2087152300,17984
1361665780,2087159576,4,753,188.25,1361665754103,1361665754231,2087133679,2087133807,128
1361665796,2087175332,1306,1849757,1416.352986,1361665752616,1361665788008,2087131948,2087167340,35392
1361665796,2087175460,2587,3660564,1414.984152,1361665752488,1361665790376,2087131948,2087169836,37888
1361665800,2087179504,1,52,52,1361665773565,1361665773565,2087153069,2087153069,0
1361665800,2087179556,1,1015,1015,1361665772681,1361665772681,2087152237,2087152237,0
1361665800,2087179584,2,104,52,1361665773484,1361665773484,2087153068,2087153068,0
1361665800,2087179584,1,52,52,1361665773484,1361665773484,2087153068,2087153068,0
1361665812,2087191572,1,52,52,1361665787451,1361665787451,2087167023,2087167023,0
1361665812,2087191608,6,1136,189.3333333,1361665784853,1361665794453,2087164461,2087174061,9600
1361665824,2087203520,1,46,46,1361665796974,1361665796974,2087176494,2087176494,0
1361665836,2087215572,10,13053,1305.3,1361665810554,1361665810554,2087190126,2087190126,0
1361665836,2087215572,7,6008,858.2857143,1361665810873,1361665810873,2087190445,2087190445,0
1361665836,2087215572,16,21322,1332.625,1361665810872,1361665828664,2087190444,2087208236,17792
1361665836,2087215572,11,15529,1411.727273,1361665810872,1361665810872,2087190444,2087190444,0
1361665836,2087215624,9,12437,1381.888889,1361665810501,1361665810501,2087190125,2087190125,0
1361665836,2087215624,9,12300,1366.666667,1361665810820,1361665810820,2087190444,2087190444,0
1361665836,2087215624,8,10654,1331.75,1361665810820,1361665810820,2087190444,2087190444,0
1361665836,2087215624,15,17208,1147.2,1361665810884,1361665828612,2087190508,2087208236,17728
1361665836,2087215624,15,16835,1122.333333,1361665810884,1361665828612,2087190508,2087208236,17728
1361665836,2087215624,11,13347,1213.363636,1361665810819,1361665810819,2087190443,2087190443,0
1361665844,2087223640,9,1704,189.3333333,1361665817843,1361665840819,2087197483,2087220459,22976
1361665852,2087231440,15,9646,643.0666667,1361665845563,1361665851451,2087225003,2087230891,5888
1361665856,2087235612,5,1935,387,1361665828623,1361665829007,2087208235,2087208619,384
1361665856,2087235652,3,636,212,1361665830119,1361665830183,2087209771,2087209835,64
1361665876,2087255652,1,46,46,1361665848360,1361665848360,2087228012,2087228012,0
1361665876,2087255732,1,46,46,1361665848282,1361665848282,2087228014,2087228014,0
1361665896,2087275776,1,52,52,1361665868204,1361665868204,2087247980,2087247980,0
1361665896,2087275776,1,52,52,1361665868204,1361665868204,2087247980,2087247980,0
1361665896,2087275784,1,52,52,1361665869157,1361665869157,2087248941,2087248941,0
1361665896,2087275784,1,52,52,1361665869157,1361665869157,2087248941,2087248941,0
1361665896,2087275856,1,52,52,1361665869147,1361665869147,2087249003,2087249003,0
1361665896,2087275856,1,52,52,1361665869082,1361665869082,2087248938,2087248938,0
1361665936,2087315812,25,28776,1151.04,1361665908232,1361665910600,2087288044,2087290412,2368
1361665936,2087315816,6,7344,1224,1361665908610,1361665909698,2087288426,2087289514,1088
1361665936,2087315816,4,1653,413.25,1361665908801,1361665908865,2087288617,2087288681,64
1361665936,2087315824,4,536,134,1361665909627,1361665910203,2087289451,2087290027,576
1361665936,2087315828,4,5069,1267.25,1361665909749,1361665909749,2087289577,2087289577,0
1361665936,2087315844,3,304,101.3333333,1361665910120,1361665910120,2087289964,2087289964,0
1361665936,2087315844,5,1786,357.2,1361665910120,1361665910504,2087289964,2087290348,384
1361665936,2087315848,9,1704,189.3333333,1361665910626,1361665930786,2087290474,2087310634,20160
1361665936,2087315900,4,4559,1139.75,1361665909678,1361665909678,2087289578,2087289578,0
1361665936,2087315904,5,5280,1056,1361665909675,1361665909675,2087289579,2087289579,0
1361665936,2087315928,3,379,126.3333333,1361665910162,1361665910226,2087290090,2087290154,64
1361665944,2087323880,3,526,175.3333333,1361665919105,1361665919169,2087298985,2087299049,64
1361665945,2087323952,3,526,175.3333333,1361665920035,1361665920035,2087298987,2087298987,0
1361665948,2087327928,1,76,76,1361665922387,1361665922387,2087302315,2087302315,0
1361665952,2087331792,1,52,52,1361665925146,1361665925146,2087304938,2087304938,0
1361665952,2087331796,1,52,52,1361665925144,1361665925144,2087304940,2087304940,0
1361665952,2087331868,1,52,52,1361665925070,1361665925070,2087304938,2087304938,0
1361665952,2087331868,1,52,52,1361665925070,1361665925070,2087304938,2087304938,0
1361665952,2087331872,1,52,52,1361665925068,1361665925068,2087304940,2087304940,0
1361665956,2087335392,3890,5519630,1418.928021,1361665909163,1361665953067,2087288555,2087332459,43904
1361665964,2087343416,3295,4679077,1420.053718,1361665909137,1361665961873,2087288553,2087341289,52736
1361665968,2087347804,3,568,189.3333333,1361665940815,1361665940815,2087320619,2087320619,0
1361665968,2087347844,1,52,52,1361665943077,1361665943077,2087322921,2087322921,0
1361665968,2087347920,1,52,52,1361665943001,1361665943001,2087322921,2087322921,0
1361665976,2087355904,3,362,120.6666667,1361665949098,1361665949098,2087329002,2087329002,0
1361665996,2087375856,9,10139,1126.555556,1361665970138,1361665970202,2087349994,2087350058,64
1361665996,2087375856,10,11082,1108.2,1361665970138,1361665970202,2087349994,2087350058,64
1361665996,2087375856,7,6292,898.8571429,1361665970138,1361665970202,2087349994,2087350058,64
1361665996,2087375856,9,8741,971.2222222,1361665970137,1361665970201,2087349993,2087350057,64
1361665996,2087375856,9,10102,1122.444444,1361665970201,1361665970201,2087350057,2087350057,0
1361665997,2087375936,9,8931,992.3333333,1361665971059,1361665971123,2087349995,2087350059,64
1361665997,2087375936,11,15453,1404.818182,1361665971059,1361665971059,2087349995,2087349995,0
1361665997,2087375936,7,6005,857.8571429,1361665971058,1361665971186,2087349994,2087350122,128
1361665997,2087375936,11,13854,1259.454545,1361665971122,1361665971122,2087350058,2087350058,0
1361666008,2087387860,3,568,189.3333333,1361665980695,1361665980759,2087360555,2087360619,64
1361666008,2087387892,3,1566,522,1361665982263,1361665986999,2087362155,2087366891,4736
1361666040,2087419848,4,4530,1132.5,1361666012193,1361666012193,2087392041,2087392041,0
1361666040,2087419848,6,5284,880.6666667,1361666012193,1361666012257,2087392041,2087392105,64
1361666040,2087419848,8,8633,1079.125,1361666012193,1361666017633,2087392041,2087397481,5440
1361666040,2087419848,3,568,189.3333333,1361666012256,1361666012256,2087392104,2087392104,0
1361666040,2087419848,8,7353,919.125,1361666012256,1361666017632,2087392104,2087397480,5376
1361666040,2087419848,10,10944,1094.4,1361666012256,1361666017888,2087392104,2087397736,5632
1361666040,2087419848,3,3513,1171,1361666012256,1361666012256,2087392104,2087392104,0
1361666041,2087420232,6,5230,871.6666667,1361666012808,1361666012872,2087392040,2087392104,64
1361666041,2087420232,7,7545,1077.857143,1361666012808,1361666018248,2087392040,2087397480,5440
1361666041,2087420232,6,5336,889.3333333,1361666012808,1361666012872,2087392040,2087392104,64
1361666041,2087420232,5,3499,699.8,1361666012810,1361666012874,2087392042,2087392106,64
1361666041,2087420232,3,3750,1250,1361666012810,1361666012810,2087392042,2087392042,0
1361666041,2087420232,3,2345,781.6666667,1361666012873,1361666012873,2087392105,2087392105,0
1361666045,2087423972,5,1924,384.8,1361666018510,1361666018702,2087397482,2087397674,192
1361666045,2087423972,5,5360,1072,1361666018510,1361666018510,2087397482,2087397482,0
1361666045,2087423972,5,1924,384.8,1361666018510,1361666018702,2087397482,2087397674,192
1361666052,2087431888,1,46,46,1361666023994,1361666023994,2087403882,2087403882,0
1361666052,2087431888,1,52,52,1361666023994,1361666023994,2087403882,2087403882,0
1361666052,2087431900,1,52,52,1361666024942,1361666024942,2087404842,2087404842,0
1361666052,2087431900,1,52,52,1361666025005,1361666025005,2087404905,2087404905,0
1361666052,2087431936,1,46,46,1361666023944,1361666023944,2087403880,2087403880,0
1361666053,2087431976,1,52,52,1361666025865,1361666025865,2087404841,2087404841,0
1361666053,2087431976,1,52,52,1361666025865,1361666025865,2087404841,2087404841,0
1361666060,2087439892,1,52,52,1361666033974,1361666033974,2087413866,2087413866,0
1361666060,2087439892,1,52,52,1361666033973,1361666033973,2087413865,2087413865,0
1361666088,2087467956,1,52,52,1361666063862,1361666063862,2087443818,2087443818,0
1361666128,2087507928,1,52,52,1361666101840,1361666101840,2087481768,2087481768,0
1361666132,2087511512,53,57686,1088.415094,1361666122096,1361666127600,2087501608,2087507112,5504
1361666132,2087511516,5,680,136,1361666127595,1361666127723,2087507111,2087507239,128
1361666132,2087511560,6,1318,219.6666667,1361666123582,1361666126526,2087503142,2087506086,2944
1361666132,2087511920,4,3931,982.75,1361666123354,1361666127258,2087503274,2087507178,3904
1361666149,2087527940,3,297,99,1361666124587,1361666124587,2087503527,2087503527,0
1361666149,2087527992,3,325,108.3333333,1361666124150,1361666124150,2087503142,2087503142,0
1361666149,2087527992,3,3552,1184,1361666124281,1361666124281,2087503273,2087503273,0
1361666149,2087527992,4,4754,1188.5,1361666124281,1361666124281,2087503273,2087503273,0
1361666149,2087527992,8,6980,872.5,1361666124152,1361666124216,2087503144,2087503208,64
1361666149,2087527992,5,4680,936,1361666124344,1361666124344,2087503336,2087503336,0
1361666149,2087528024,16,7339,458.6875,1361666124633,1361666134745,2087503657,2087513769,10112
1361666149,2087528024,3,304,101.3333333,1361666124696,1361666124696,2087503720,2087503720,0
1361666149,2087528064,3,680,226.6666667,1361666122862,1361666122926,2087501926,2087501990,64
1361666149,2087528072,4,4661,1165.25,1361666124198,1361666124198,2087503270,2087503270,0
1361666149,2087528076,4,4738,1184.5,1361666124197,1361666124197,2087503273,2087503273,0
1361666149,2087528076,4,4058,1014.5,1361666124197,1361666124197,2087503273,2087503273,0
1361666149,2087528076,3,3756,1252,1361666124197,1361666124197,2087503273,2087503273,0
1361666153,2087531952,12,11817,984.75,1361666125024,1361666125408,2087503976,2087504360,384
1361666153,2087531964,6,2696,449.3333333,1361666126166,1361666126422,2087505130,2087505386,256
1361666153,2087531996,1,52,52,1361666127730,1361666127730,2087506726,2087506726,0
1361666153,2087531996,1,52,52,1361666127730,1361666127730,2087506726,2087506726,0
1361666153,2087532000,3,652,217.3333333,1361666127790,1361666127854,2087506790,2087506854,64
1361666153,2087532000,4,1040,260,1361666128175,1361666136623,2087507175,2087515623,8448
1361666153,2087532032,3,524,174.6666667,1361666125328,1361666125328,2087504360,2087504360,0
1361666153,2087532040,1,52,52,1361666126087,1361666126087,2087505127,2087505127,0
1361666153,2087532076,1,52,52,1361666127650,1361666127650,2087506726,2087506726,0
1361666153,2087532080,3,652,217.3333333,1361666127714,1361666127778,2087506794,2087506858,64
1361666153,2087532080,3,353,117.6666667,1361666127840,1361666128096,2087506920,2087507176,256
1361666157,2087535944,1,52,52,1361666132713,1361666132713,2087511657,2087511657,0
1361666157,2087536016,1,52,52,1361666132638,1361666132638,2087511654,2087511654,0
1361666161,2087539984,1,52,52,1361666133631,1361666133631,2087512615,2087512615,0
1361666161,2087540024,4,753,188.25,1361666135256,1361666135320,2087514280,2087514344,64
1361666161,2087540024,3,688,229.3333333,1361666135319,1361666135319,2087514343,2087514343,0
1361666161,2087540060,2,104,52,1361666133554,1361666133554,2087512614,2087512614,0
1361666161,2087540108,4,628,157,1361666136515,1361666136515,2087515623,2087515623,0
1361666164,2087543572,2588,3668272,1417.415765,1361666126514,1361666163634,2087506086,2087543206,37120
1361666180,2087559556,2597,3689036,1420.499037,1361666122370,1361666174338,2087501926,2087553894,51968
1361666180,2087559600,2596,3678845,1417.12057,1361666122327,1361666172823,2087501927,2087552423,50496
1361666201,2087580024,4,2279,569.75,1361666175000,1361666175064,2087554024,2087554088,64
1361666201,2087580024,5,4324,864.8,1361666175000,1361666175000,2087554024,2087554024,0
1361666201,2087580024,6,4752,792,1361666175000,1361666175000,2087554024,2087554024,0
1361666201,2087580024,1,52,52,1361666175000,1361666175000,2087554024,2087554024,0
1361666201,2087580024,4,5374,1343.5,1361666175000,1361666175000,2087554024,2087554024,0
1361666201,2087580024,2,2167,1083.5,1361666175000,1361666175000,2087554024,2087554024,0
1361666201,2087580096,3,3226,1075.333333,1361666174928,1361666174928,2087554024,2087554024,0
1361666201,2087580096,3,3724,1241.333333,1361666174928,1361666174928,2087554024,2087554024,0
1361666201,2087580096,6,5355,892.5,1361666174927,1361666174927,2087554023,2087554023,0
1361666201,2087580096,1,46,46,1361666174927,1361666174927,2087554023,2087554023,0
1361666201,2087580096,2,2167,1083.5,1361666174927,1361666174927,2087554023,2087554023,0
1361666217,2087596048,2,928,464,1361666191679,1361666201535,2087570727,2087580583,9856
1361666225,2087604044,1,46,46,1361666200833,1361666200833,2087579877,2087579877,0
1361666226,2087605792,1,46,46,1361666200085,1361666200085,2087579877,2087579877,0
1361666233,2087612092,4,628,157,1361666206740,1361666206804,2087585832,2087585896,64
1361666265,2087644036,1,52,52,1361666237515,1361666237515,2087616551,2087616551,0
1361666265,2087644044,1,52,52,1361666238530,1361666238530,2087617574,2087617574,0
1361666265,2087644044,1,46,46,1361666238529,1361666238529,2087617573,2087617573,0
1361666265,2087644072,1,52,52,1361666239463,1361666239463,2087618535,2087618535,0
1361666265,2087644072,1,52,52,1361666239463,1361666239463,2087618535,2087618535,0
1361666265,2087644116,1,52,52,1361666238458,1361666238458,2087617574,2087617574,0
1361666265,2087644116,1,52,52,1361666238458,1361666238458,2087617574,2087617574,0
1361666265,2087644124,1,52,52,1361666239411,1361666239411,2087618535,2087618535,0
1361666265,2087644124,1,52,52,1361666239410,1361666239410,2087618534,2087618534,0
1361666265,2087644148,1,52,52,1361666240345,1361666240345,2087619493,2087619493,0
1361666268,2087647604,2629,3735908,1421.037657,1361666200274,1361666260050,2087579878,2087639654,59776
1361666269,2087648056,1,52,52,1361666242421,1361666242421,2087621477,2087621477,0
1361666269,2087648128,1,52,52,1361666242351,1361666242351,2087621479,2087621479,0
1361666269,2087648128,1,46,46,1361666242541,1361666242541,2087621669,2087621669,0
1361666273,2087652076,3,568,189.3333333,1361666246818,1361666246882,2087625894,2087625958,64
1361666277,2087656076,1,52,52,1361666249379,1361666249379,2087628455,2087628455,0
1361666277,2087656076,1,52,52,1361666249379,1361666249379,2087628455,2087628455,0
1361666277,2087656216,1,52,52,1361666249236,1361666249236,2087628452,2087628452,0
1361666292,2087671640,455,609920,1340.483516,1361665772143,1361666289775,2087151783,2087669415,517632
1361666301,2087680080,1,46,46,1361666272927,1361666272927,2087652007,2087652007,0
1361666313,2087692192,3,568,189.3333333,1361666286764,1361666286828,2087665956,2087666020,64
1361666317,2087696100,1,52,52,1361666290314,1361666290314,2087669414,2087669414,0
1361666317,2087696100,1,52,52,1361666290314,1361666290314,2087669414,2087669414,0
1361666317,2087696100,1,52,52,1361666290314,1361666290314,2087669414,2087669414,0
1361666317,2087696100,1,52,52,1361666290314,1361666290314,2087669414,2087669414,0
1361666317,2087696176,1,52,52,1361666290238,1361666290238,2087669414,2087669414,0
1361666317,2087696176,1,52,52,1361666290238,1361666290238,2087669414,2087669414,0
1361666317,2087696176,1,52,52,1361666290238,1361666290238,2087669414,2087669414,0
1361666317,2087696176,1,52,52,1361666290238,1361666290238,2087669414,2087669414,0
1361666317,2087696176,1,52,52,1361666290238,1361666290238,2087669414,2087669414,0
1361666324,2087703692,13,8905,685,1361666312187,1361666317755,2087691879,2087697447,5568
1361666333,2087712208,8,7848,981,1361666307036,1361666307100,2087686244,2087686308,64
1361666345,2087724176,1,52,52,1361666317247,1361666317247,2087696423,2087696423,0
1361666353,2087732140,3,568,189.3333333,1361666326882,1361666326882,2087706022,2087706022,0
1361666356,2087735684,5192,7381846,1421.773112,1361666272322,1361666352706,2087652006,2087732390,80384
1361666393,2087772628,3,568,189.3333333,1361666366394,1361666366458,2087746022,2087746086,64
1361666397,2087776648,3,636,212,1361666371748,1361666371812,2087751396,2087751460,64
1361666433,2087812544,3,568,189.3333333,1361666406475,1361666406539,2087786019,2087786083,64
1361666436,2087815656,2204,3134640,1422.250454,1361666127580,1361666134108,2087507236,2087513764,6528
1361666461,2087840572,1,76,76,1361666436718,1361666436718,2087816290,2087816290,0
1361666473,2087852676,3,568,189.3333333,1361666446341,1361666446341,2087826017,2087826017,0
1361666513,2087892728,3,568,189.3333333,1361666486354,1361666486354,2087866082,2087866082,0
1361666513,2087892760,1,52,52,1361666487539,1361666487539,2087867299,2087867299,0
1361666553,2087932908,3,568,189.3333333,1361666526236,1361666526300,2087906144,2087906208,64
1361666594,2087972968,3,568,189.3333333,1361666567113,1361666567113,2087946081,2087946081,0
1361666596,2087975776,13,8065,620.3846154,1361666585631,1361666592479,2087965407,2087972255,6848
1361666634,2088013200,3,568,189.3333333,1361666606880,1361666606944,2087986080,2087986144,64
1361666660,2088039784,2582,3668892,1420.949651,1361666620313,1361666658009,2088000097,2088037793,37696
1361666674,2088053132,3,568,189.3333333,1361666646949,1361666647013,2088026081,2088026145,64
1361666678,2088057348,2,104,52,1361666653005,1361666656013,2088032353,2088035361,3008
1361666714,2088093392,3,568,189.3333333,1361666686687,1361666686751,2088066079,2088066143,64
1361666740,2088119856,129,174651,1353.883721,1361666615952,1361666732304,2087995808,2088112160,116352
1361666754,2088133572,3,568,189.3333333,1361666726569,1361666726569,2088106141,2088106141,0
1361666794,2088173640,3,568,189.3333333,1361666766567,1361666766567,2088146207,2088146207,0
1361666812,2088191908,13,9203,707.9230769,1361666805273,1361666810777,2088185181,2088190685,5504
1361666834,2088213644,3,568,189.3333333,1361666806626,1361666806626,2088186270,2088186270,0
1361666844,2088223896,17,11052,650.1176471,1361666835495,1361666843879,2088215391,2088223775,8384
1361666862,2088241860,1,52,52,1361666835465,1361666835465,2088215325,2088215325,0
1361666874,2088253812,3,568,189.3333333,1361666846521,1361666846585,2088226333,2088226397,64
1361666914,2088293828,3,568,189.3333333,1361666886503,1361666886567,2088266331,2088266395,64
1361666920,2088299256,22719,32315016,1422.37845,1361666309669,1361666616549,2087688925,2087995805,306880
1361666922,2088301796,694,984453,1418.520173,1361666617801,1361666619017,2087997597,2087998813,1216
1361666940,2088319912,3197,4542617,1420.899906,1361666888275,1361666936787,2088268187,2088316699,48512
1361666941,2088319940,26682,37949004,1422.269845,1361666617248,1361666937952,2087996188,2088316892,320704
1361666949,2088327956,5,2522,504.4,1361666938000,1361666943376,2088316956,2088322332,5376
1361666954,2088333852,3,568,189.3333333,1361666926544,1361666926608,2088306396,2088306460,64
1361666965,2088343988,37,44981,1215.702703,1361666942320,1361666959792,2088321308,2088338780,17472
1361666966,2088345900,28,35410,1264.642857,1361666941280,1361666960800,2088321180,2088340700,19520
1361666970,2088349924,12,13083,1090.25,1361666945352,1361666945416,2088325276,2088325340,64
1361666970,2088349924,25,32023,1280.92,1361666945416,1361666945480,2088325340,2088325404,64
1361666970,2088349924,13,15497,1192.076923,1361666945416,1361666945480,2088325340,2088325404,64
1361666971,2088349928,13,15438,1187.538462,1361666946348,1361666946412,2088325276,2088325340,64
1361666971,2088349928,10,11424,1142.4,1361666946412,1361666946476,2088325340,2088325404,64
1361666971,2088350020,10,10291,1029.1,1361666946254,1361666946318,2088325274,2088325338,64
1361666971,2088350020,13,15780,1213.846154,1361666946255,1361666946319,2088325275,2088325339,64
1361666971,2088350020,10,11293,1129.3,1361666946319,1361666946383,2088325339,2088325403,64
1361666971,2088350020,10,10358,1035.8,1361666946319,1361666946383,2088325339,2088325403,64
1361666971,2088350020,11,11774,1070.363636,1361666946319,1361666946383,2088325339,2088325403,64
1361666974,2088353880,1,76,76,1361666947443,1361666947443,2088327323,2088327323,0
1361666987,2088366016,2,323,161.5,1361666961747,1361666961747,2088340763,2088340763,0
1361666995,2088373936,3,568,189.3333333,1361666967458,1361666967522,2088346394,2088346458,64
1361666999,2088378040,41,52900,1290.243902,1361666973819,1361666997435,2088352859,2088376475,23616
1361667012,2088391924,152,206623,1359.361842,1361666886534,1361667011014,2088266458,2088390938,124480
1361667030,2088409872,1,46,46,1361667002105,1361667002105,2088381977,2088381977,0
1361667031,2088409956,1,46,46,1361667003023,1361667003023,2088381979,2088381979,0
1361667071,2088450020,3,1250,416.6666667,1361667045645,1361667045645,2088424665,2088424665,0
1361667071,2088450024,11,11102,1009.272727,1361667045706,1361667045962,2088424730,2088424986,256
1361667087,2088466104,1,52,52,1361667061819,1361667061819,2088440923,2088440923,0
1361667087,2088466104,1,52,52,1361667061819,1361667061819,2088440923,2088440923,0
1361667087,2088466104,1,52,52,1361667061819,1361667061819,2088440923,2088440923,0
1361667087,2088466104,1,52,52,1361667061819,1361667061819,2088440923,2088440923,0
1361667087,2088466104,1,52,52,1361667061818,1361667061818,2088440922,2088440922,0
1361667087,2088466104,1,52,52,1361667061817,1361667061817,2088440921,2088440921,0
1361667087,2088466200,1,52,52,1361667061722,1361667061722,2088440922,2088440922,0
1361667087,2088466200,1,52,52,1361667061722,1361667061722,2088440922,2088440922,0
1361667087,2088466200,1,52,52,1361667061721,1361667061721,2088440921,2088440921,0
1361667087,2088466200,1,52,52,1361667061720,1361667061720,2088440920,2088440920,0
1361667091,2088470132,29,40106,1382.965517,1361667066205,1361667072413,2088445337,2088451545,6208
1361667103,2088482084,1,52,52,1361667076943,1361667076943,2088456027,2088456027,0
1361667107,2088486292,1,52,52,1361667082621,1361667082621,2088461913,2088461913,0
1361667187,2088566188,1,52,52,1361667160678,1361667160678,2088539866,2088539866,0
1361667187,2088566272,1,52,52,1361667160592,1361667160592,2088539864,2088539864,0
1361667215,2088594276,1,52,52,1361667187595,1361667187595,2088566871,2088566871,0
1361667379,2088758648,6,2348,391.3333333,1361667352211,1361667370259,2088731859,2088749907,18048
1361667467,2088846608,1,52,52,1361667440829,1361667440829,2088820437,2088820437,0
1361667467,2088846632,3,580,193.3333333,1361667441251,1361667441315,2088820883,2088820947,64
1361667467,2088846644,18,22731,1262.833333,1361667442329,1361667442457,2088821973,2088822101,128
1361667467,2088846712,61,78051,1279.52459,1361667441556,1361667442452,2088821268,2088822164,896
1361667467,2088846716,3,874,291.3333333,1361667441937,1361667442065,2088821653,2088821781,128
1361667487,2088866676,9,684,76,1361667461626,1361667477626,2088841302,2088857302,16000
1361667512,2088890984,1,52,52,1361667485867,1361667485867,2088864851,2088864851,0
1361667541,2088920248,6,1280,213.3333333,1361667533985,1361667534049,2088913233,2088913297,64
1361667541,2088920252,988,1388636,1405.502024,1361667534240,1361667535584,2088913492,2088914836,1344
1361667549,2088928320,2,284,142,1361667546588,1361667546588,2088925908,2088925908,0
1361667556,2088934984,39,42588,1092,1361667531051,1361667547115,2088910035,2088926099,16064
1361667556,2088934988,18,20064,1114.666667,1361667531558,1361667547302,2088910546,2088926290,15744
1361667556,2088935056,34,43342,1274.764706,1361667531492,1361667548836,2088910548,2088927892,17344
1361667557,2088936304,3,330,110,1361667556330,1361667556330,2088935634,2088935634,0
1361667559,2088938932,6,5590,931.6666667,1361667530933,1361667530997,2088910865,2088910929,64
1361667560,2088938940,13,13702,1054,1361667532501,1361667547349,2088911441,2088926289,14848
1361667560,2088938944,27,33099,1225.888889,1361667532564,1361667558484,2088911508,2088937428,25920
1361667560,2088938944,16,17899,1118.6875,1361667532499,1361667556947,2088911443,2088935891,24448
1361667560,2088938944,45,56431,1254.022222,1361667532563,1361667558547,2088911507,2088937491,25984
1361667560,2088938948,3,688,229.3333333,1361667533967,1361667534031,2088912915,2088912979,64
1361667560,2088938992,4,2471,617.75,1361667531873,1361667531937,2088910865,2088910929,64
1361667560,2088938992,3,956,318.6666667,1361667532003,1361667532067,2088910995,2088911059,64
1361667560,2088938996,3,413,137.6666667,1361667532128,1361667532192,2088911124,2088911188,64
1361667560,2088939016,3,652,217.3333333,1361667533578,1361667533578,2088912594,2088912594,0
1361667560,2088939016,5,913,182.6,1361667532490,1361667557194,2088911506,2088936210,24704
1361667560,2088939016,9,9774,1086,1361667532489,1361667532553,2088911505,2088911569,64
1361667560,2088939020,22,27001,1227.318182,1361667532424,1361667556872,2088911444,2088935892,24448
1361667560,2088939020,31,38930,1255.806452,1361667532487,1361667557191,2088911507,2088936211,24704
1361667560,2088939024,5,1526,305.2,1361667532801,1361667544897,2088911825,2088923921,12096
1361667560,2088939024,3,586,195.3333333,1361667533892,1361667533956,2088912916,2088912980,64
1361667571,2088950908,7,6883,983.2857143,1361667546894,1361667546958,2088926802,2088926866,64
1361667572,2088950992,13,5411,416.2307692,1361667544931,1361667562787,2088923923,2088941779,17856
1361667584,2088962960,1,52,52,1361667557827,1361667557827,2088936787,2088936787,0
1361667584,2088962960,37,41653,1125.756757,1361667556611,1361667563203,2088935571,2088942163,6592
1361667584,2088963032,1,46,46,1361667557819,1361667557819,2088936851,2088936851,0
1361667584,2088963032,13,17923,1378.692308,1361667556857,1361667562361,2088935889,2088941393,5504
1361667588,2088966992,8,10500,1312.5,1361667562402,1361667563234,2088941394,2088942226,832
1361667588,2088966992,4,5212,1303,1361667562402,1361667562402,2088941394,2088941394,0
1361667588,2088966992,4,5334,1333.5,1361667562402,1361667562402,2088941394,2088941394,0
1361667588,2088966996,4,1763,440.75,1361667562782,1361667563038,2088941778,2088942034,256
1361667588,2088967000,1,267,267,1361667563033,1361667563033,2088942033,2088942033,0
1361667588,2088967000,7,1196,170.8571429,1361667563161,1361667573273,2088942161,2088952273,10112
1361667588,2088967048,3,4083,1361,1361667562348,1361667562348,2088941396,2088941396,0
1361667605,2088984276,2582,3667646,1420.46708,1361667560775,1361667598919,2088940051,2088978195,38144
1361667605,2088984316,3879,5502570,1418.553751,1361667560735,1361667604255,2088940051,2088983571,43520
1361667672,2089051372,1,52,52,1361667647397,1361667647397,2089026769,2089026769,0
1361667672,2089051372,1,52,52,1361667647397,1361667647397,2089026769,2089026769,0
1361667672,2089051372,1,52,52,1361667647396,1361667647396,2089026768,2089026768,0
1361667672,2089051444,1,52,52,1361667647324,1361667647324,2089026768,2089026768,0
1361667672,2089051444,1,52,52,1361667647324,1361667647324,2089026768,2089026768,0
1361667672,2089051444,1,46,46,1361667647324,1361667647324,2089026768,2089026768,0
1361667672,2089051448,1,46,46,1361667647322,1361667647322,2089026770,2089026770,0
1361667676,2089055380,1,52,52,1361667649373,1361667649373,2089028753,2089028753,0
1361667676,2089055456,1,52,52,1361667649295,1361667649295,2089028751,2089028751,0
1361667680,2089059372,32,31852,995.375,1361667655715,1361667660323,2089035087,2089039695,4608
1361667684,2089063380,4,1653,413.25,1361667656284,1361667656284,2089035664,2089035664,0
1361667684,2089063392,2,2022,1011,1361667657552,1361667657552,2089036944,2089036944,0
1361667684,2089063392,2,1669,834.5,1361667657552,1361667657552,2089036944,2089036944,0
1361667684,2089063416,3,297,99,1361667657913,1361667657913,2089037329,2089037329,0
1361667684,2089063420,14,12545,896.0714286,1361667658230,1361667658742,2089037650,2089038162,512
1361667684,2089063424,3,652,217.3333333,1361667658671,1361667658671,2089038095,2089038095,0
1361667684,2089063432,4,5123,1280.75,1361667656039,1361667657511,2089035471,2089036943,1472
1361667684,2089063456,3,687,229,1361667656018,1361667656082,2089035474,2089035538,64
1361667684,2089063464,4,3558,889.5,1361667657479,1361667657479,2089036943,2089036943,0
1361667684,2089063464,6,4716,786,1361667657479,1361667657479,2089036943,2089036943,0
1361667684,2089063464,8,10591,1323.875,1361667657479,1361667657991,2089036943,2089037455,512
1361667684,2089063464,3,3063,1021,1361667657479,1361667657479,2089036943,2089036943,0
1361667684,2089063468,4,1759,439.75,1361667657542,1361667657862,2089037010,2089037330,320
1361667684,2089063468,1,192,192,1361667657797,1361667657797,2089037265,2089037265,0
1361667684,2089063468,4,1065,266.25,1361667658180,1361667658372,2089037648,2089037840,192
1361667684,2089063496,3,524,174.6666667,1361667658601,1361667658601,2089038097,2089038097,0
1361667684,2089063496,3,652,217.3333333,1361667658601,1361667658601,2089038097,2089038097,0
1361667684,2089063496,1,267,267,1361667659113,1361667659113,2089038609,2089038609,0
1361667688,2089067384,9,1704,189.3333333,1361667660313,1361667680345,2089039697,2089059729,20032
1361667688,2089067384,4,1040,260,1361667660313,1361667679193,2089039697,2089058577,18880
1361667688,2089067420,1,52,52,1361667663283,1361667663283,2089042703,2089042703,0
1361667688,2089067456,1,52,52,1361667660306,1361667660306,2089039762,2089039762,0
1361667692,2089071436,3,526,175.3333333,1361667666790,1361667666854,2089046226,2089046290,64
1361667692,2089071440,3,526,175.3333333,1361667666850,1361667666850,2089046290,2089046290,0
1361667701,2089080364,2621,3719896,1419.265929,1361667656171,1361667696427,2089035535,2089075791,40256
1361667704,2089083384,1,52,52,1361667677335,1361667677335,2089056719,2089056719,0
1361667704,2089083460,1,52,52,1361667677259,1361667677259,2089056719,2089056719,0
1361667716,2089095468,1,464,464,1361667689283,1361667689283,2089068751,2089068751,0
1361667716,2089095476,3,568,189.3333333,1361667690235,1361667690299,2089069711,2089069775,64
1361667724,2089103388,3,362,120.6666667,1361667696852,1361667696852,2089076240,2089076240,0
1361667728,2089107408,1,46,46,1361667701698,1361667701698,2089081106,2089081106,0
1361667756,2089135516,3,568,189.3333333,1361667730261,1361667730325,2089109777,2089109841,64
1361667796,2089175516,3,568,189.3333333,1361667770322,1361667770322,2089149838,2089149838,0
1361667796,2089175524,1,52,52,1361667771148,1361667771148,2089150672,2089150672,0
1361667796,2089175524,1,52,52,1361667771148,1361667771148,2089150672,2089150672,0
1361667800,2089179492,1,52,52,1361667773164,1361667773164,2089152656,2089152656,0
1361667800,2089179492,1,52,52,1361667773163,1361667773163,2089152655,2089152655,0
1361667800,2089179492,1,52,52,1361667773163,1361667773163,2089152655,2089152655,0
1361667800,2089179492,1,52,52,1361667773162,1361667773162,2089152654,2089152654,0
1361667800,2089179492,1,52,52,1361667773162,1361667773162,2089152654,2089152654,0
1361667800,2089179528,1,52,52,1361667774151,1361667774151,2089153679,2089153679,0
1361667800,2089179528,1,52,52,1361667774151,1361667774151,2089153679,2089153679,0
1361667800,2089179528,1,52,52,1361667774151,1361667774151,2089153679,2089153679,0
1361667800,2089179572,1,52,52,1361667773082,1361667773082,2089152654,2089152654,0
1361667800,2089179572,1,52,52,1361667773082,1361667773082,2089152654,2089152654,0
1361667800,2089179572,1,52,52,1361667773082,1361667773082,2089152654,2089152654,0
1361667800,2089179572,1,52,52,1361667773082,1361667773082,2089152654,2089152654,0
1361667800,2089179608,1,52,52,1361667774069,1361667774069,2089153677,2089153677,0
1361667800,2089179608,1,52,52,1361667774073,1361667774073,2089153681,2089153681,0
1361667800,2089179608,1,52,52,1361667774071,1361667774071,2089153679,2089153679,0
1361667800,2089179616,1,52,52,1361667775024,1361667775024,2089154640,2089154640,0
1361667808,2089187548,1,52,52,1361667782065,1361667782065,2089161613,2089161613,0
1361667808,2089187548,1,52,52,1361667782067,1361667782067,2089161615,2089161615,0
1361667828,2089207812,1,52,52,1361667803817,1361667803817,2089183629,2089183629,0
1361667836,2089215788,1,52,52,1361667811843,1361667811843,2089191631,2089191631,0
1361667836,2089215832,3,568,189.3333333,1361667810135,1361667810135,2089189967,2089189967,0
1361667845,2089224476,115,158158,1375.286957,1361667724217,1361667840121,2089103693,2089219597,115904
1361667864,2089243872,3,644,214.6666667,1361667839408,1361667839472,2089219280,2089219344,64
1361667876,2089255864,3,568,189.3333333,1361667849973,1361667850037,2089229837,2089229901,64
1361667917,2089295992,3,568,189.3333333,1361667890846,1361667890846,2089269838,2089269838,0
1361667957,2089336040,3,568,189.3333333,1361667930797,1361667930861,2089309837,2089309901,64
1361667981,2089360308,1,52,52,1361667955169,1361667955169,2089334477,2089334477,0
1361667997,2089376372,3,568,189.3333333,1361667970463,1361667970527,2089349835,2089349899,64
1361668001,2089380312,1,76,76,1361667976030,1361667976030,2089355342,2089355342,0
1361668037,2089416412,3,568,189.3333333,1361668010486,1361668010550,2089389898,2089389962,64
1361668077,2089456508,3,568,189.3333333,1361668050454,1361668050518,2089429962,2089430026,64
1361668117,2089496580,3,568,189.3333333,1361668090448,1361668090448,2089470028,2089470028,0
1361668157,2089536708,3,568,189.3333333,1361668130318,1361668130318,2089510026,2089510026,0
1361668173,2089552916,31611,44939469,1421.64022,1361667655614,1361668170622,2089035530,2089550538,515008
1361668197,2089576772,3,568,189.3333333,1361668170251,1361668170251,2089550023,2089550023,0
1361668201,2089580720,8,8378,1047.25,1361668175297,1361668175297,2089555017,2089555017,0
1361668201,2089580720,16,18352,1147,1361668175297,1361668175553,2089555017,2089555273,256
1361668201,2089580720,11,11808,1073.454545,1361668175296,1361668175360,2089555016,2089555080,64
1361668201,2089580720,9,8805,978.3333333,1361668175296,1361668175360,2089555016,2089555080,64
1361668201,2089580720,8,8091,1011.375,1361668175551,1361668175615,2089555271,2089555335,64
1361668201,2089580724,8,7627,953.375,1361668175550,1361668175550,2089555274,2089555274,0
1361668201,2089580772,9,8912,990.2222222,1361668175244,1361668175308,2089555016,2089555080,64
1361668201,2089580772,8,8570,1071.25,1361668175244,1361668175308,2089555016,2089555080,64
1361668201,2089580772,8,7369,921.125,1361668175244,1361668175308,2089555016,2089555080,64
1361668201,2089580796,7,5973,853.2857143,1361668175219,1361668175219,2089555015,2089555015,0
1361668201,2089580796,7,6026,860.8571429,1361668175477,1361668175477,2089555273,2089555273,0
1361668201,2089580796,7,7143,1020.428571,1361668175477,1361668175477,2089555273,2089555273,0
1361668233,2089612728,3,568,189.3333333,1361668205752,1361668205816,2089585480,2089585544,64
1361668233,2089612784,1,46,46,1361668205057,1361668205057,2089584841,2089584841,0
1361668317,2089696812,1,52,52,1361668290018,1361668290018,2089669830,2089669830,0
1361668317,2089696812,1,52,52,1361668290018,1361668290018,2089669830,2089669830,0
1361668317,2089696812,1,52,52,1361668290018,1361668290018,2089669830,2089669830,0
1361668317,2089696812,1,52,52,1361668290018,1361668290018,2089669830,2089669830,0
1361668317,2089696812,1,52,52,1361668290018,1361668290018,2089669830,2089669830,0
1361668317,2089696884,1,52,52,1361668289948,1361668289948,2089669832,2089669832,0
1361668317,2089696884,1,52,52,1361668289948,1361668289948,2089669832,2089669832,0
1361668317,2089696884,1,52,52,1361668289948,1361668289948,2089669832,2089669832,0
1361668317,2089696884,1,52,52,1361668289948,1361668289948,2089669832,2089669832,0
1361668317,2089696884,1,52,52,1361668289947,1361668289947,2089669831,2089669831,0
1361668317,2089696884,1,52,52,1361668289947,1361668289947,2089669831,2089669831,0
1361668317,2089696884,1,52,52,1361668289947,1361668289947,2089669831,2089669831,0
1361668345,2089724892,1,52,52,1361668319889,1361668319889,2089699781,2089699781,0
1361668357,2089736816,4,628,157,1361668330273,1361668330337,2089710089,2089710153,64
1361668398,2089777032,4,1032,258,1361668371184,1361668371440,2089750216,2089750472,256
1361668438,2089816988,3,568,189.3333333,1361668411160,1361668411224,2089790148,2089790212,64
1361668478,2089857052,3,568,189.3333333,1361668451097,1361668451161,2089830149,2089830213,64
1361668514,2089893132,1,76,76,1361668487177,1361668487177,2089866309,2089866309,0
1361668518,2089897012,3,568,189.3333333,1361668491199,1361668491199,2089870211,2089870211,0
1361668586,2089965072,5,3397,679.4,1361668558852,1361668558916,2089937924,2089937988,64
1361668598,2089977100,3,568,189.3333333,1361668571047,1361668571111,2089950147,2089950211,64
1361668638,2090017408,3,568,189.3333333,1361668610738,1361668610802,2089990146,2089990210,64
1361668658,2090037408,89,112832,1267.775281,1361668633841,1361668641457,2090013249,2090020865,7616
1361668658,2090037420,3,588,196,1361668631333,1361668631397,2090010753,2090010817,64
1361668662,2090041540,7,2405,343.5714286,1361668634542,1361668638574,2090014082,2090018114,4032
1361668666,2090045400,3,336,112,1361668638200,1361668638200,2090017600,2090017600,0
1361668666,2090045408,38,50121,1318.973684,1361668638704,1361668638768,2090018112,2090018176,64
1361668666,2090045480,4,1021,255.25,1361668638123,1361668638123,2090017603,2090017603,0
1361668678,2090057496,3,568,189.3333333,1361668650712,1361668650712,2090030208,2090030208,0
1361668698,2090077584,1,52,52,1361668673538,1361668673538,2090053122,2090053122,0
1361668774,2090153556,3,1113,371,1361668749851,1361668749851,2090129407,2090129407,0
1361668774,2090153644,1,46,46,1361668746499,1361668746499,2090126143,2090126143,0
1361668778,2090157564,9,7006,778.4444444,1361668749910,1361668750102,2090129474,2090129666,192
1361668778,2090157620,1,52,52,1361668753500,1361668753500,2090133120,2090133120,0
1361668778,2090157620,1,46,46,1361668753498,1361668753498,2090133118,2090133118,0
1361668778,2090157620,1,46,46,1361668753498,1361668753498,2090133118,2090133118,0
1361668778,2090157696,1,46,46,1361668753423,1361668753423,2090133119,2090133119,0
1361668782,2090161624,1,46,46,1361668756504,1361668756504,2090136128,2090136128,0
1361668790,2090169708,1,52,52,1361668765381,1361668765381,2090145089,2090145089,0
1361668794,2090173936,1,46,46,1361668767072,1361668767072,2090147008,2090147008,0
1361668879,2090258092,4,628,157,1361668851242,1361668851306,2090230334,2090230398,64
1361668891,2090270036,1,52,52,1361668866020,1361668866020,2090245056,2090245056,0
1361668891,2090270104,1,52,52,1361668865950,1361668865950,2090245054,2090245054,0
1361668919,2090298028,3,568,189.3333333,1361668891369,1361668891433,2090270397,2090270461,64
1361668959,2090338388,3,568,189.3333333,1361668931009,1361668931073,2090310397,2090310461,64
1361668999,2090378376,3,568,189.3333333,1361668971020,1361668971084,2090350396,2090350460,64
1361669023,2090402416,1,76,76,1361668997927,1361668997927,2090377343,2090377343,0
1361669039,2090418468,3,568,189.3333333,1361669010930,1361669010994,2090390398,2090390462,64
1361669079,2090458420,3,568,189.3333333,1361669050977,1361669051041,2090430397,2090430461,64
1361669119,2090498448,3,568,189.3333333,1361669090884,1361669090948,2090470332,2090470396,64
1361669155,2090534612,3,568,189.3333333,1361669130784,1361669130784,2090510396,2090510396,0
1361669195,2090574616,3,568,189.3333333,1361669170776,1361669170840,2090550392,2090550456,64
1361669235,2090614524,3,568,189.3333333,1361669210934,1361669210934,2090590458,2090590458,0
1361669275,2090654672,3,568,189.3333333,1361669250784,1361669250912,2090630456,2090630584,128
1361669315,2090694832,3,568,189.3333333,1361669290624,1361669290688,2090670456,2090670520,64
1361669343,2090722792,89,119558,1343.348315,1361669317032,1361669317288,2090696824,2090697080,256
1361669343,2090722860,6,1136,189.3333333,1361669316516,1361669330660,2090696376,2090710520,14144
1361669395,2090774920,3,568,189.3333333,1361669370601,1361669370665,2090750521,2090750585,64
1361669436,2090815020,3,568,189.3333333,1361669411564,1361669411628,2090790584,2090790648,64
1361669460,2090839184,1,52,52,1361669433223,1361669433223,2090812407,2090812407,0
1361669532,2090911328,45,60644,1347.644444,1361669507635,1361669507699,2090886963,2090887027,64
1361669536,2090915276,1,76,76,1361669510059,1361669510059,2090889335,2090889335,0
1361669552,2090931312,1,52,52,1361669526022,1361669526022,2090905334,2090905334,0
1361669556,2090935332,4,628,157,1361669531311,1361669531311,2090910643,2090910643,0
1361669591,2090970488,5,1594,318.8,1361669579411,1361669585427,2090958899,2090964915,6016
1361669596,2090975372,3,568,189.3333333,1361669571337,1361669571337,2090950709,2090950709,0
1361669607,729300528,9,9630,1070,1361669579785,1361669579849,729273313,729273377,64
1361669607,729300556,3,753,251,1361669579627,1361669579627,729273183,729273183,0
1361669636,2091015724,3,568,189.3333333,1361669610985,1361669610985,2090990709,2090990709,0
1361669648,2091027672,1,46,46,1361669622618,1361669622618,2091002290,2091002290,0
1361669648,2091027752,1,52,52,1361669622541,1361669622541,2091002293,2091002293,0
1361669676,2091055752,9,1609,178.7777778,1361669651020,1361669673164,2091030772,2091052916,22144
1361669687,2091066572,50,50295,1005.9,1361669665149,1361669679613,2091044721,2091059185,14464
1361669692,2091071672,22,26182,1190.090909,1361669667035,1361669669723,2091046707,2091049395,2688
1361669692,2091071672,6,5214,869,1361669667163,1361669667163,2091046835,2091046835,0
1361669692,2091071672,5,3082,616.4,1361669667163,1361669667163,2091046835,2091046835,0
1361669692,2091071672,11,10624,965.8181818,1361669667163,1361669669851,2091046835,2091049523,2688
1361669692,2091071672,5,3738,747.6,1361669667163,1361669667163,2091046835,2091046835,0
1361669692,2091071672,3,325,108.3333333,1361669667034,1361669667098,2091046706,2091046770,64
1361669692,2091071676,3,297,99,1361669667480,1361669667480,2091047156,2091047156,0
1361669692,2091071716,3,689,229.6666667,1361669665325,1361669665389,2091045041,2091045105,64
1361669692,2091071716,3,680,226.6666667,1361669665392,1361669665456,2091045108,2091045172,64
1361669692,2091071716,4,324,81,1361669665327,1361669665391,2091045043,2091045107,64
1361669692,2091071756,6,5403,900.5,1361669667080,1361669667080,2091046836,2091046836,0
1361669692,2091071756,5,3746,749.2,1361669667080,1361669667080,2091046836,2091046836,0
1361669692,2091071756,6,5408,901.3333333,1361669667080,1361669667080,2091046836,2091046836,0
1361669692,2091071756,5,3970,794,1361669667080,1361669667080,2091046836,2091046836,0
1361669692,2091071756,5,1008,201.6,1361669666949,1361669668101,2091046705,2091047857,1152
1361669692,2091071760,5,4201,840.2,1361669667076,1361669667076,2091046836,2091046836,0
1361669692,2091071780,3,304,101.3333333,1361669667312,1361669667312,2091047092,2091047092,0
1361669692,2091071780,12,11797,983.0833333,1361669667631,1361669668079,2091047411,2091047859,448
1361669692,2091071780,16,7905,494.0625,1361669667375,1361669685679,2091047155,2091065459,18304
1361669695,729388760,1,52,52,1361669670624,1361669670624,729364384,729364384,0
1361669696,2091075588,3,353,117.6666667,1361669670829,1361669670957,2091050417,2091050545,128
1361669696,2091075632,1,46,46,1361669668100,1361669668100,2091047732,2091047732,0
1361669696,2091075632,3,524,174.6666667,1361669668227,1361669668227,2091047859,2091047859,0
1361669696,2091075644,6,2715,452.5,1361669669048,1361669669176,2091048692,2091048820,128
1361669696,2091075800,3,652,217.3333333,1361669670554,1361669670618,2091050354,2091050418,64
1361669696,2091075804,3,652,217.3333333,1361669670551,1361669670615,2091050355,2091050419,64
1361669696,2091075804,4,1040,260,1361669670615,1361669690583,2091050419,2091070387,19968
1361669700,2091079644,20,22833,1141.65,1361669673336,1361669673400,2091052980,2091053044,64
1361669703,2091082516,10,1805,180.5,1361669695223,1361669702455,2091074739,2091081971,7232
1361669703,2091082568,9,1534,170.4444444,1361669679620,1361669701764,2091059188,2091081332,22144
1361669711,2091090516,1356,1910355,1408.816372,1361669670325,1361669705461,2091049841,2091084977,35136
1361669719,729412796,1,52,52,1361669694397,1361669694397,729388193,729388193,0
1361669720,2091099824,4,2160,540,1361669693184,1361669700992,2091073008,2091080816,7808
1361669728,2091107740,4,1817,454.25,1361669700566,1361669700694,2091080306,2091080434,128
1361669728,2091107740,3,1392,464,1361669700692,1361669722324,2091080432,2091102064,21632
1361669728,2091107744,1,46,46,1361669703314,1361669703314,2091083058,2091083058,0
1361669728,2091107780,10,1764,176.4,1361669702190,1361669722414,2091081970,2091102194,20224
1361669728,2091107820,1,52,52,1361669700487,1361669700487,2091080307,2091080307,0
1361669728,2091107860,3,688,229.3333333,1361669701469,1361669701533,2091081329,2091081393,64
1361669743,2091122532,1305,1852325,1419.40613,1361669704678,1361669739942,2091084210,2091119474,35264
1361669751,2091130592,2639,3738214,1416.526715,1361669701737,1361669745705,2091081329,2091125297,43968
1361669760,2091139768,1,464,464,1361669732280,1361669732280,2091112048,2091112048,0
1361669760,2091139768,3,568,189.3333333,1361669732408,1361669732408,2091112176,2091112176,0
1361669785,2091164104,1,46,46,1361669757010,1361669757010,2091136114,2091136114,0
1361669785,2091164104,1,46,46,1361669757010,1361669757010,2091136114,2091136114,0
1361669791,2091170580,2,104,52,1361669783606,1361669783798,2091163186,2091163378,192
1361669801,2091180080,3,568,189.3333333,1361669773162,1361669773162,2091152242,2091152242,0
1361669809,2091188128,1,52,52,1361669781048,1361669781048,2091160176,2091160176,0
1361669809,2091188140,1,52,52,1361669784046,1361669784046,2091163186,2091163186,0
1361669809,2091188180,1,52,52,1361669782979,1361669782979,2091162159,2091162159,0
1361669809,2091188180,1,52,52,1361669782979,1361669782979,2091162159,2091162159,0
1361669809,2091188184,1,52,52,1361669782977,1361669782977,2091162161,2091162161,0
1361669809,2091188184,1,52,52,1361669782977,1361669782977,2091162161,2091162161,0
1361669809,2091188184,1,52,52,1361669782977,1361669782977,2091162161,2091162161,0
1361669809,2091188208,1,46,46,1361669780967,1361669780967,2091160175,2091160175,0
1361669809,2091188212,1,46,46,1361669780966,1361669780966,2091160178,2091160178,0
1361669809,2091188248,1,52,52,1361669783935,1361669783935,2091163183,2091163183,0
1361669809,2091188248,1,52,52,1361669781889,1361669781889,2091161137,2091161137,0
1361669809,2091188264,1,52,52,1361669782898,1361669782898,2091162162,2091162162,0
1361669809,2091188264,1,52,52,1361669782898,1361669782898,2091162162,2091162162,0
1361669809,2091188264,1,52,52,1361669782898,1361669782898,2091162162,2091162162,0
1361669809,2091188264,1,52,52,1361669782898,1361669782898,2091162162,2091162162,0
1361669809,2091188264,1,52,52,1361669782898,1361669782898,2091162162,2091162162,0
1361669809,2091188264,1,52,52,1361669782897,1361669782897,2091162161,2091162161,0
1361669813,2091192112,1,46,46,1361669786119,1361669786119,2091165231,2091165231,0
1361669813,2091192160,1,52,52,1361669784985,1361669784985,2091164145,2091164145,0
1361669813,2091192188,1,52,52,1361669785979,1361669785979,2091165167,2091165167,0
1361669813,2091192192,1,52,52,1361669785975,1361669785975,2091165167,2091165167,0
1361669841,2091220200,3,568,189.3333333,1361669813040,1361669813040,2091192240,2091192240,0
1361669841,2091220212,1,52,52,1361669815908,1361669815908,2091195120,2091195120,0
1361669841,2091220212,1,52,52,1361669815908,1361669815908,2091195120,2091195120,0
1361669845,2091224168,1,52,52,1361669816911,1361669816911,2091196079,2091196079,0
1361669873,2091252188,1,52,52,1361669847930,1361669847930,2091227118,2091227118,0
1361669881,2091260188,3,568,189.3333333,1361669853052,1361669853052,2091232240,2091232240,0
1361669903,2091282628,9,3914,434.8888889,1361669901188,1361669901444,2091280816,2091281072,256
1361669903,2091282708,9,3735,415,1361669902261,1361669902581,2091281969,2091282289,320
1361669903,2091282712,9,3737,415.2222222,1361669900079,1361669900591,2091279791,2091280303,512
1361669909,2091288252,4,696,174,1361669882941,1361669883005,2091262193,2091262257,64
1361669911,2091290616,9,3647,405.2222222,1361669903377,1361669904401,2091282993,2091284017,1024
1361669921,2091300572,3,568,189.3333333,1361669892668,1361669892668,2091272240,2091272240,0
1361669957,2091336620,4,1032,258,1361669932619,1361669932875,2091312239,2091312495,256
1361669997,2091376748,3,568,189.3333333,1361669972427,1361669972491,2091352175,2091352239,64
1361670025,2091404628,1,52,52,1361669997377,1361669997377,2091377005,2091377005,0
1361670037,2091416680,3,568,189.3333333,1361670012557,1361670012557,2091392237,2091392237,0
1361670049,2091428680,1,76,76,1361670023693,1361670023693,2091403373,2091403373,0
1361670055,2091434684,13114,18650514,1422.183468,1361669756423,1361670050567,2091136107,2091430251,294144
1361670078,2091457000,3,568,189.3333333,1361670053238,1361670053238,2091432238,2091432238,0
1361670118,2091497064,3,568,189.3333333,1361670093172,1361670093172,2091472236,2091472236,0
1361670119,2091498772,2611,3708854,1420.472616,1361670050479,1361670117487,2091430251,2091497259,67008
1361670154,2091533132,1,46,46,1361670126961,1361670126961,2091506093,2091506093,0
1361670158,2091537152,3,568,189.3333333,1361670133083,1361670133083,2091512235,2091512235,0
1361670167,2091546776,1318,1868109,1417.381639,1361670126377,1361670161129,2091506153,2091540905,34752
1361670198,2091577152,3,568,189.3333333,1361670173081,1361670173081,2091552233,2091552233,0
1361670199,2091578820,1305,1852343,1419.419923,1361670161087,1361670195135,2091540907,2091574955,34048
1361670207,2091586752,163,222806,1366.907975,1361670091011,1361670206403,2091470763,2091586155,115392
1361670234,2091613444,1,46,46,1361670208312,1361670208312,2091587756,2091587756,0
1361670238,2091617516,3,568,189.3333333,1361670212718,1361670212718,2091592234,2091592234,0
1361670255,2091634824,1822,2586353,1419.513172,1361670195130,1361670253498,2091574954,2091633322,58368
1361670278,2091657460,3,568,189.3333333,1361670252776,1361670252840,2091632236,2091632300,64
1361670298,2091677448,12,13569,1130.75,1361670273393,1361670273393,2091652841,2091652841,0
1361670298,2091677448,11,11219,1019.909091,1361670273393,1361670273393,2091652841,2091652841,0
1361670298,2091677448,12,13183,1098.583333,1361670273520,1361670273520,2091652968,2091652968,0
1361670298,2091677448,11,12387,1126.090909,1361670273520,1361670273520,2091652968,2091652968,0
1361670298,2091677452,9,9390,1043.333333,1361670273516,1361670273516,2091652968,2091652968,0
1361670298,2091677524,7,6549,935.5714286,1361670273317,1361670273317,2091652841,2091652841,0
1361670298,2091677524,9,9767,1085.222222,1361670273317,1361670273317,2091652841,2091652841,0
1361670298,2091677524,8,8183,1022.875,1361670273317,1361670273317,2091652841,2091652841,0
1361670298,2091677524,6,5651,941.8333333,1361670273317,1361670273317,2091652841,2091652841,0
1361670298,2091677524,11,10773,979.3636364,1361670273445,1361670273957,2091652969,2091653481,512
1361670298,2091677524,10,11208,1120.8,1361670273445,1361670273445,2091652969,2091652969,0
1361670298,2091677528,11,12242,1112.909091,1361670273440,1361670273440,2091652968,2091652968,0
1361670314,2091693512,1,46,46,1361670287599,1361670287599,2091667111,2091667111,0
1361670318,2091697476,9,1704,189.3333333,1361670292819,1361670315027,2091672295,2091694503,22208
1361670330,2091709508,3,3056,1018.666667,1361670304438,1361670304438,2091683946,2091683946,0
1361670330,2091709508,3,304,101.3333333,1361670304757,1361670304757,2091684265,2091684265,0
1361670330,2091709508,3,379,126.3333333,1361670304884,1361670305076,2091684392,2091684584,192
1361670330,2091709540,24,28362,1181.75,1361670302102,1361670304214,2091681642,2091683754,2112
1361670330,2091709588,3,4106,1368.666667,1361670304359,1361670304359,2091683947,2091683947,0
1361670330,2091709588,4,5065,1266.25,1361670304357,1361670304357,2091683945,2091683945,0
1361670330,2091709588,4,5064,1266,1361670304357,1361670304357,2091683945,2091683945,0
1361670343,2091722800,1310,1856853,1417.445038,1361670303119,1361670338127,2091682919,2091717927,35008
1361670343,2091722800,1317,1855292,1408.725892,1361670303119,1361670335631,2091682919,2091715431,32512
1361670367,2091746808,7,1867,266.7142857,1361670361927,1361670362119,2091741735,2091741927,192
1361670367,2091746812,6,1306,217.6666667,1361670362181,1361670362309,2091741993,2091742121,128
1361670367,2091746812,6,1313,218.8333333,1361670362436,1361670362500,2091742248,2091742312,64
1361670367,2091746812,3,2863,954.3333333,1361670359427,1361670363907,2091739239,2091743719,4480
1361670367,2091746812,8,8676,1084.5,1361670358339,1361670363971,2091738151,2091743783,5632
1361670367,2091746816,5,1104,220.8,1361670360063,1361670363903,2091739879,2091743719,3840
1361670367,2091746820,6,1281,213.5,1361670363899,1361670364027,2091743719,2091743847,128
1361670367,2091746820,5,680,136,1361670363899,1361670364411,2091743719,2091744231,512
1361670375,2091754864,6,1281,213.5,1361670367120,1361670367184,2091746984,2091747048,64
1361670375,2091754880,1301,1848019,1420.460415,1361670364162,1361670371394,2091744042,2091751274,7232
1361670375,2091754908,6,1311,218.5,1361670367204,1361670367332,2091747112,2091747240,128
1361670375,2091754908,6,1318,219.6666667,1361670367331,1361670367395,2091747239,2091747303,64
1361670376,2091754940,4,735,183.75,1361670365291,1361670368043,2091744231,2091746983,2752
1361670386,2091765496,53,56751,1070.773585,1361670358400,1361670371200,2091737896,2091750696,12800
1361670386,2091765500,4,2514,628.5,1361670359739,1361670359803,2091739239,2091739303,64
1361670386,2091765504,1,192,192,1361670360054,1361670360054,2091739558,2091739558,0
1361670386,2091765532,13,12983,998.6923077,1361670360347,1361670360731,2091739879,2091740263,384
1361670386,2091765536,3,524,174.6666667,1361670360665,1361670360729,2091740201,2091740265,64
1361670386,2091765540,1,46,46,1361670361491,1361670361491,2091741031,2091741031,0
1361670386,2091765576,8,6980,872.5,1361670359599,1361670359663,2091739175,2091739239,64
1361670386,2091765580,7,6486,926.5714286,1361670359662,1361670361454,2091739242,2091741034,1792
1361670386,2091765580,2,2472,1236,1361670359662,1361670359662,2091739242,2091739242,0
1361670386,2091765580,3,680,226.6666667,1361670358574,1361670358638,2091738154,2091738218,64
1361670386,2091765580,2,2802,1401,1361670359660,1361670359660,2091739240,2091739240,0
1361670386,2091765580,4,2228,557,1361670359660,1361670359724,2091739240,2091739304,64
1361670386,2091765580,2,2769,1384.5,1361670359723,1361670359723,2091739303,2091739303,0
1361670386,2091765584,15,7107,473.8,1361670359914,1361670370538,2091739498,2091750122,10624
1361670386,2091765584,3,297,99,1361670360040,1361670360040,2091739624,2091739624,0
1361670386,2091765620,7,2621,374.4285714,1361670361413,1361670361989,2091741033,2091741609,576
1361670390,2091769528,1,52,52,1361670362976,1361670362976,2091742504,2091742504,0
1361670390,2091769532,1,267,267,1361670363358,1361670363358,2091742890,2091742890,0
1361670390,2091769876,3,652,217.3333333,1361670363846,1361670363910,2091743722,2091743786,64
1361670390,2091769876,3,652,217.3333333,1361670363846,1361670363910,2091743722,2091743786,64
1361670390,2091769876,4,1040,260,1361670363909,1361670371461,2091743785,2091751337,7552
1361670390,2091769912,1,46,46,1361670361761,1361670361761,2091741673,2091741673,0
1361670390,2091769912,2,2191,1095.5,1361670361824,1361670361824,2091741736,2091741736,0
1361670390,2091769920,3,689,229.6666667,1361670362583,1361670362647,2091742503,2091742567,64
1361670391,2091769956,1,52,52,1361670364765,1361670364765,2091743721,2091743721,0
1361670391,2091769956,1,52,52,1361670364764,1361670364764,2091743720,2091743720,0
1361670398,2091777520,3,688,229.3333333,1361670371111,1361670371175,2091750631,2091750695,64
1361670398,2091777524,3,1006,335.3333333,1361670371109,1361670371173,2091750633,2091750697,64
1361670398,2091777548,10,1764,176.4,1361670371724,1361670391820,2091751272,2091771368,20096
1361670407,2091786868,1315,1855212,1410.807605,1361670358283,1361670406859,2091738151,2091786727,48576
1361670414,2091793540,1,52,52,1361670388501,1361670388501,2091768041,2091768041,0
1361670414,2091793620,1,52,52,1361670388419,1361670388419,2091768039,2091768039,0
1361670414,2091793620,1,52,52,1361670388419,1361670388419,2091768039,2091768039,0
1361670418,2091797508,2,928,464,1361670391796,1361670401716,2091771304,2091781224,9920
1361670426,2091805784,3,568,189.3333333,1361670401567,1361670401631,2091781351,2091781415,64
1361670450,2091829632,1,46,46,1361670422903,1361670422903,2091802535,2091802535,0
1361670466,2091845588,3,568,189.3333333,1361670441828,1361670441828,2091821416,2091821416,0
1361670472,2091851020,5221,7418131,1420.825704,1361670359129,1361670471769,2091738149,2091850789,112640
1361670498,2091877704,1,46,46,1361670473326,1361670473326,2091853030,2091853030,0
1361670498,2091877780,1,52,52,1361670473251,1361670473251,2091853031,2091853031,0
1361670498,2091877780,1,46,46,1361670473249,1361670473249,2091853029,2091853029,0
1361670498,2091877780,1,46,46,1361670473249,1361670473249,2091853029,2091853029,0
1361670502,2091881632,1,52,52,1361670474360,1361670474360,2091853992,2091853992,0
1361670502,2091881632,1,52,52,1361670474360,1361670474360,2091853992,2091853992,0
1361670502,2091881632,1,46,46,1361670474424,1361670474424,2091854056,2091854056,0
1361670502,2091881640,1,52,52,1361670475374,1361670475374,2091855014,2091855014,0
1361670502,2091881640,1,52,52,1361670475374,1361670475374,2091855014,2091855014,0
1361670502,2091881644,1,52,52,1361670475372,1361670475372,2091855016,2091855016,0
1361670502,2091881716,1,52,52,1361670474274,1361670474274,2091853990,2091853990,0
1361670502,2091881716,1,52,52,1361670474274,1361670474274,2091853990,2091853990,0
1361670502,2091881716,1,52,52,1361670474274,1361670474274,2091853990,2091853990,0
1361670502,2091881724,1,52,52,1361670475289,1361670475289,2091855013,2091855013,0
1361670502,2091881756,1,52,52,1361670476220,1361670476220,2091855976,2091855976,0
1361670502,2091881764,1,52,52,1361670477234,1361670477234,2091856998,2091856998,0
1361670502,2091881768,1,52,52,1361670477229,1361670477229,2091856997,2091856997,0
1361670506,2091885620,1,52,52,1361670479298,1361670479298,2091858918,2091858918,0
1361670506,2091885700,1,52,52,1361670479218,1361670479218,2091858918,2091858918,0
1361670506,2091885712,1,52,52,1361670478372,1361670478372,2091858084,2091858084,0
1361670506,2091885784,3,568,189.3333333,1361670481694,1361670481694,2091861478,2091861478,0
1361670510,2091889752,1,52,52,1361670485181,1361670485181,2091864933,2091864933,0
1361670514,2091893628,1,52,52,1361670486331,1361670486331,2091865959,2091865959,0
1361670514,2091893628,1,52,52,1361670486331,1361670486331,2091865959,2091865959,0
1361670514,2091893708,1,52,52,1361670486250,1361670486250,2091865958,2091865958,0
1361670519,2091899072,1307,1852435,1417.318286,1361670476989,1361670515837,2091857061,2091895909,38848
1361670522,2091901700,4,2528,632,1361670495282,1361670495346,2091874982,2091875046,64
1361670542,2091921724,1,52,52,1361670516185,1361670516185,2091895909,2091895909,0
1361670546,2091925680,3,1106,368.6666667,1361670520326,1361670520390,2091900006,2091900070,64
1361670546,2091925692,3,568,189.3333333,1361670521785,1361670521785,2091901477,2091901477,0
1361670546,2091925760,12,11608,967.3333333,1361670520374,1361670521206,2091900134,2091900966,832
1361670562,2091941624,1,76,76,1361670534716,1361670534716,2091914340,2091914340,0
1361670586,2091965732,7,2244,320.5714286,1361670560339,1361670560659,2091940071,2091940391,320
1361670586,2091965788,78,76690,983.2051282,1361670559642,1361670568986,2091939430,2091948774,9344
1361670586,2091965820,23,8348,362.9565217,1361670559162,1361670567290,2091938982,2091947110,8128
1361670586,2091965856,3,568,189.3333333,1361670561686,1361670561686,2091941542,2091941542,0
1361670616,2091995112,145,197010,1358.689655,1361670493885,1361670609725,2091872997,2091988837,115840
1361670626,2092005800,3,568,189.3333333,1361670601806,1361670601806,2091981606,2091981606,0
1361670638,2092017724,1,52,52,1361670610137,1361670610137,2091989861,2091989861,0
1361670662,2092041744,1,52,52,1361670635078,1361670635078,2092014822,2092014822,0
1361670662,2092041828,1,52,52,1361670636016,1361670636016,2092015844,2092015844,0
1361670666,2092045812,3,568,189.3333333,1361670641791,1361670641791,2092021603,2092021603,0
1361670674,2092053768,2552,3617021,1417.327978,1361670362602,1361670370282,2091742370,2091750050,7680
1361670674,2092053768,4,696,174,1361670645932,1361670645996,2092025700,2092025764,64
1361670678,2092057844,64,86305,1348.515625,1361670651935,1361670652447,2092031779,2092032291,512
1361670694,2092073872,1,52,52,1361670666821,1361670666821,2092046693,2092046693,0
1361670696,2092075148,1303,1850871,1420.468918,1361670660120,1361670695448,2092039268,2092074596,35328
1361670703,2092081924,1,46,46,1361670676919,1361670676919,2092055843,2092055843,0
1361670706,2092085840,3,568,189.3333333,1361670681762,1361670681826,2092061602,2092061666,64
1361670710,2092089800,1,46,46,1361670681997,1361670681997,2092061797,2092061797,0
1361670711,2092089920,1,46,46,1361670684922,1361670684922,2092063842,2092063842,0
1361670747,2092126284,3,568,189.3333333,1361670722381,1361670722381,2092101665,2092101665,0
1361670787,2092166212,1,52,52,1361670761557,1361670761557,2092140769,2092140769,0
1361670787,2092166288,1,46,46,1361670761484,1361670761484,2092140772,2092140772,0
1361670795,2092174160,1,52,52,1361670767625,1361670767625,2092146785,2092146785,0
1361670824,2092203244,1295,1838083,1419.369112,1361670791093,1361670823413,2092170337,2092202657,32320
1361670827,2092206276,3,568,189.3333333,1361670802453,1361670802453,2092181729,2092181729,0
1361670857,2092236756,1294,1836651,1419.359351,1361670822900,1361670854516,2092202656,2092234272,31616
1361670867,2092246352,3,568,189.3333333,1361670842377,1361670842377,2092221729,2092221729,0
1361670907,2092286716,3,568,189.3333333,1361670882075,1361670882075,2092261791,2092261791,0
1361670911,2092290592,1,46,46,1361670886616,1361670886616,2092266208,2092266208,0
1361670947,2092326644,3,568,189.3333333,1361670922148,1361670922212,2092301792,2092301856,64
1361670984,2092363268,3755,5336490,1421.169108,1361670887003,1361670983195,2092266271,2092362463,96192
1361670987,2092366652,3,568,189.3333333,1361670962204,1361670962204,2092341856,2092341856,0
1361671027,2092406808,4,1032,258,1361671002175,1361671002431,2092381983,2092382239,256
1361671063,2092442772,1,46,46,1361671037027,1361671037027,2092416799,2092416799,0
1361671068,2092447104,3,568,189.3333333,1361671042812,1361671042876,2092421916,2092421980,64
1361671072,2092451012,1,76,76,1361671047323,1361671047323,2092426335,2092426335,0
1361671104,2092482984,7,6337,905.2857143,1361671078646,1361671078710,2092457630,2092457694,64
1361671104,2092482988,10,10560,1056,1361671078642,1361671078706,2092457630,2092457694,64
1361671104,2092482988,8,7973,996.625,1361671078642,1361671078706,2092457630,2092457694,64
1361671104,2092482988,10,10745,1074.5,1361671078642,1361671078706,2092457630,2092457694,64
1361671104,2092482988,9,8741,971.2222222,1361671078833,1361671078897,2092457821,2092457885,64
1361671104,2092482988,9,9957,1106.333333,1361671078833,1361671078897,2092457821,2092457885,64
1361671104,2092482988,11,11988,1089.818182,1361671078897,1361671078897,2092457885,2092457885,0
1361671104,2092483064,10,10338,1033.8,1361671078565,1361671078629,2092457629,2092457693,64
1361671104,2092483064,8,7677,959.625,1361671078565,1361671078629,2092457629,2092457693,64
1361671104,2092483064,10,10313,1031.3,1361671078565,1361671078629,2092457629,2092457693,64
1361671104,2092483064,11,11039,1003.545455,1361671078756,1361671079076,2092457820,2092458140,320
1361671104,2092483068,9,8823,980.3333333,1361671078815,1361671078815,2092457883,2092457883,0
1361671108,2092487000,3,568,189.3333333,1361671082918,1361671082918,2092461918,2092461918,0
1361671148,2092527112,3,568,189.3333333,1361671122868,1361671122868,2092501980,2092501980,0
1361671188,2092567244,3,568,189.3333333,1361671162735,1361671162799,2092541979,2092542043,64
1361671220,2092599164,1,52,52,1361671193729,1361671193729,2092572893,2092572893,0
1361671220,2092599164,1,52,52,1361671193729,1361671193729,2092572893,2092572893,0
1361671220,2092599164,1,52,52,1361671193729,1361671193729,2092572893,2092572893,0
1361671220,2092599164,1,52,52,1361671193729,1361671193729,2092572893,2092572893,0
1361671220,2092599164,1,52,52,1361671193728,1361671193728,2092572892,2092572892,0
1361671220,2092599164,1,52,52,1361671193728,1361671193728,2092572892,2092572892,0
1361671220,2092599164,1,52,52,1361671193728,1361671193728,2092572892,2092572892,0
1361671220,2092599244,1,52,52,1361671193649,1361671193649,2092572893,2092572893,0
1361671220,2092599244,1,52,52,1361671193649,1361671193649,2092572893,2092572893,0
1361671220,2092599244,1,52,52,1361671193646,1361671193646,2092572890,2092572890,0
1361671220,2092599244,1,52,52,1361671193646,1361671193646,2092572890,2092572890,0
1361671220,2092599244,1,52,52,1361671193646,1361671193646,2092572890,2092572890,0
1361671228,2092607300,3,568,189.3333333,1361671202745,1361671202809,2092582045,2092582109,64
1361671344,2092723284,1,52,52,1361671317764,1361671317764,2092697048,2092697048,0
1361671352,2092731668,987,1388596,1406.885512,1361671346565,1361671348229,2092726233,2092727897,1664
1361671368,2092747344,41,42319,1032.170732,1361671343047,1361671351815,2092722391,2092731159,8768
1361671372,2092751240,6,5589,931.5,1361671344306,1361671344434,2092723546,2092723674,128
1361671372,2092751240,4,2499,624.75,1361671344368,1361671344432,2092723608,2092723672,64
1361671372,2092751244,40,51268,1281.7,1361671344045,1361671352877,2092723289,2092732121,8832
1361671372,2092751248,3,956,318.6666667,1361671344491,1361671344491,2092723739,2092723739,0
1361671372,2092751252,4,2366,591.5,1361671345060,1361671345124,2092724312,2092724376,64
1361671372,2092751252,17,19416,1142.117647,1361671345123,1361671352099,2092724375,2092731351,6976
1361671372,2092751256,5,3394,678.8,1361671345059,1361671345123,2092724315,2092724379,64
1361671372,2092751256,14,15952,1139.428571,1361671345123,1361671352803,2092724379,2092732059,7680
1361671372,2092751256,6,5413,902.1666667,1361671345123,1361671345123,2092724379,2092724379,0
1361671372,2092751256,18,20493,1138.5,1361671345123,1361671352803,2092724379,2092732059,7680
1361671372,2092751296,3,688,229.3333333,1361671346618,1361671346618,2092725914,2092725914,0
1361671372,2092751328,34,43305,1273.676471,1361671343961,1361671353689,2092723289,2092733017,9728
1361671372,2092751336,3,413,137.6666667,1361671344467,1361671344531,2092723803,2092723867,64
1361671372,2092751340,27,33676,1247.259259,1361671345036,1361671352716,2092724376,2092732056,7680
1361671372,2092751340,6,5433,905.5,1361671345036,1361671345036,2092724376,2092724376,0
1361671372,2092751340,5,3541,708.2,1361671345036,1361671345036,2092724376,2092724376,0
1361671372,2092751340,4,608,152,1361671345099,1361671352843,2092724439,2092732183,7744
1361671372,2092751344,13,5993,461,1361671345355,1361671352907,2092724699,2092732251,7552
1361671372,2092751368,3,652,217.3333333,1361671346098,1361671346098,2092725466,2092725466,0
1361671372,2092751372,3,586,195.3333333,1361671346543,1361671346607,2092725915,2092725979,64
1361671376,2092755328,3,725,241.6666667,1361671349080,1361671349144,2092728408,2092728472,64
1361671376,2092755372,1,52,52,1361671351663,1361671351663,2092731035,2092731035,0
1361671380,2092759288,17,20236,1190.352941,1361671352067,1361671353731,2092731355,2092733019,1664
1361671404,2092783312,15,18894,1259.6,1361671377064,1361671380648,2092756376,2092759960,3584
1361671404,2092783392,12,15221,1268.416667,1361671376983,1361671380567,2092756375,2092759959,3584
1361671404,2092783392,12,16534,1377.833333,1361671376983,1361671380567,2092756375,2092759959,3584
1361671460,2092839428,22,29854,1357,1361671431988,1361671435892,2092811416,2092815320,3904
1361671460,2092839512,13,17159,1319.923077,1361671431905,1361671435809,2092811417,2092815321,3904
1361671460,2092839512,8,9604,1200.5,1361671431905,1361671431969,2092811417,2092811481,64
1361671460,2092839512,7,8806,1258,1361671431904,1361671431904,2092811416,2092811416,0
1361671460,2092839512,5,4186,837.2,1361671432608,1361671432672,2092812120,2092812184,64
1361671460,2092839512,10,13640,1364,1361671432607,1361671435807,2092812119,2092815319,3200
1361671460,2092839516,4,2030,507.5,1361671432602,1361671432666,2092812118,2092812182,64
1361671460,2092839588,2,2813,1406.5,1361671435666,1361671435666,2092815254,2092815254,0
1361671484,2092863520,1,52,52,1361671459353,1361671459353,2092838873,2092838873,0
1361671484,2092863520,1,52,52,1361671459350,1361671459350,2092838870,2092838870,0
1361671484,2092863600,1,52,52,1361671459273,1361671459273,2092838873,2092838873,0
1361671484,2092863600,1,52,52,1361671459272,1361671459272,2092838872,2092838872,0
1361671488,2092867464,1,52,52,1361671460432,1361671460432,2092839896,2092839896,0
1361671488,2092867464,1,52,52,1361671460432,1361671460432,2092839896,2092839896,0
1361671488,2092867476,1,52,52,1361671461381,1361671461381,2092840857,2092840857,0
1361671488,2092867584,1,52,52,1361671460312,1361671460312,2092839896,2092839896,0
1361671488,2092867584,1,52,52,1361671460312,1361671460312,2092839896,2092839896,0
1361671488,2092867592,1,52,52,1361671461263,1361671461263,2092840855,2092840855,0
1361671488,2092867592,1,52,52,1361671461263,1361671461263,2092840855,2092840855,0
1361671492,2092871480,1,52,52,1361671464382,1361671464382,2092843862,2092843862,0
1361671492,2092871528,1,52,52,1361671467342,1361671467342,2092846870,2092846870,0
1361671496,2092875492,1,52,52,1361671468338,1361671468338,2092847830,2092847830,0
1361671496,2092875496,1,52,52,1361671468337,1361671468337,2092847833,2092847833,0
1361671496,2092875496,1,46,46,1361671468527,1361671468527,2092848023,2092848023,0
1361671496,2092875564,1,52,52,1361671468266,1361671468266,2092847830,2092847830,0
1361671572,2092951836,1,52,52,1361671546969,1361671546969,2092926805,2092926805,0
1361671572,2092951912,1,52,52,1361671546895,1361671546895,2092926807,2092926807,0
1361671576,2092955824,1,52,52,1361671548006,1361671548006,2092927830,2092927830,0
1361671576,2092955872,1,52,52,1361671550965,1361671550965,2092930837,2092930837,0
1361671576,2092955872,1,52,52,1361671550965,1361671550965,2092930837,2092930837,0
1361671576,2092955904,1,52,52,1361671547926,1361671547926,2092927830,2092927830,0
1361671577,2092955952,1,52,52,1361671551887,1361671551887,2092930839,2092930839,0
1361671577,2092955952,1,52,52,1361671551887,1361671551887,2092930839,2092930839,0
1361671584,2092963888,4,2545,636.25,1361671559398,1361671559398,2092939286,2092939286,0
1361671584,2092963888,5,4213,842.6,1361671559398,1361671559398,2092939286,2092939286,0
1361671584,2092963888,5,3779,755.8,1361671559397,1361671559397,2092939285,2092939285,0
1361671584,2092963888,3,304,101.3333333,1361671559653,1361671559653,2092939541,2092939541,0
1361671585,2092963932,25,28866,1154.64,1361671558691,1361671560419,2092937623,2092939351,1728
1361671585,2092963952,3,680,226.6666667,1361671559118,1361671559182,2092938070,2092938134,64
1361671585,2092963960,6,5438,906.3333333,1361671560325,1361671560325,2092939285,2092939285,0
1361671585,2092963964,6,5455,909.1666667,1361671560321,1361671560321,2092939285,2092939285,0
1361671585,2092963964,5,4155,831,1361671560320,1361671560320,2092939284,2092939284,0
1361671588,2092967852,7,1196,170.8571429,1361671560203,1361671570251,2092940055,2092950103,10048
1361671588,2092967856,1,76,76,1361671560517,1361671560517,2092940373,2092940373,0
1361671589,2092967924,3,576,192,1361671561193,1361671561193,2092940117,2092940117,0
1361671589,2092967932,3,379,126.3333333,1361671561060,1361671561124,2092939992,2092940056,64
1361671601,2092980176,1314,1862551,1417.466514,1361671558832,1361671595056,2092938008,2092974232,36224
1361671601,2092980240,2642,3738305,1414.952687,1361671558766,1361671597358,2092938006,2092976598,38592
1361671612,2092991904,26,13650,525,1361671584983,1361671602391,2092964887,2092982295,17408
1361671628,2093007840,1,52,52,1361671601494,1361671601494,2092981334,2092981334,0
1361671628,2093007864,11,12752,1159.272727,1361671601854,1361671601918,2092981718,2092981782,64
1361671628,2093007864,8,7335,916.875,1361671601854,1361671601918,2092981718,2092981782,64
1361671628,2093007864,18,23037,1279.833333,1361671601854,1361671623550,2092981718,2093003414,21696
1361671629,2093007936,28,33093,1181.892857,1361671602461,1361671614749,2092981397,2092993685,12288
1361671629,2093007936,7,9302,1328.857143,1361671602780,1361671602780,2092981716,2092981716,0
1361671629,2093007936,35,44497,1271.342857,1361671602780,1361671624476,2092981716,2093003412,21696
1361671629,2093007936,35,44871,1282.028571,1361671602780,1361671627228,2092981716,2093006164,24448
1361671629,2093007944,2,534,267,1361671603158,1361671615190,2092982102,2092994134,12032
1361671632,2093011884,46,60475,1314.673913,1361671605931,1361671626347,2092985815,2093006231,20416
1361671641,2093019968,2,384,192,1361671615295,1361671639359,2092994263,2093018327,24064
1361671641,2093020200,8,2487,310.875,1361671637847,1361671639191,2093017047,2093018391,1344
1361671644,2093023884,47,60185,1280.531915,1361671617514,1361671638122,2092997398,2093018006,20608
1361671649,2093028152,9,1582,175.7777778,1361671637893,1361671644549,2093017045,2093023701,6656
1361671649,2093028224,6,1310,218.3333333,1361671647996,1361671648124,2093027220,2093027348,128
1361671653,2093031952,9,12612,1401.333333,1361671627212,1361671627212,2093006164,2093006164,0
1361671657,2093036036,26,33736,1297.538462,1361671631416,1361671639992,2093010452,2093019028,8576
1361671657,2093036036,11,14830,1348.181818,1361671631416,1361671638968,2093010452,2093018004,7552
1361671657,2093036200,6,1310,218.3333333,1361671651157,1361671652117,2093030357,2093031317,960
1361671665,2093043928,4,4307,1076.75,1361671639076,1361671639140,2093018004,2093018068,64
1361671665,2093043928,6,5270,878.3333333,1361671639076,1361671639076,2093018004,2093018004,0
1361671665,2093043936,5,1832,366.4,1361671639390,1361671639774,2093018326,2093018710,384
1361671665,2093044004,23,25527,1109.869565,1361671637339,1361671639771,2093016343,2093018775,2432
1361671665,2093044012,5,2468,493.6,1361671637969,1361671638161,2093016981,2093017173,192
1361671665,2093044040,4,4805,1201.25,1361671638965,1361671638965,2093018005,2093018005,0
1361671665,2093044156,7,1362,194.5714286,1361671656898,1361671657538,2093036054,2093036694,640
1361671669,2093047976,1,267,267,1361671642484,1361671642484,2093021460,2093021460,0
1361671669,2093048068,9,1704,189.3333333,1361671642583,1361671662679,2093021651,2093041747,20096
1361671681,2093060188,6,1311,218.5,1361671678368,1361671678496,2093057556,2093057684,128
1361671697,2093076040,3,568,189.3333333,1361671672693,1361671672757,2093051733,2093051797,64
1361671697,2093076196,6,1312,218.6666667,1361671692954,1361671693082,2093072150,2093072278,128
1361671697,2093076208,6,1312,218.6666667,1361671691982,1361671692174,2093071190,2093071382,192
1361671697,2093076228,3893,5514508,1416.51888,1361671639226,1361671692154,2093018454,2093071382,52928
1361671700,2093079868,1,46,46,1361671672951,1361671672951,2093052819,2093052819,0
1361671701,2093079948,1,46,46,1361671673874,1361671673874,2093052822,2093052822,0
1361671701,2093079984,1,52,52,1361671674861,1361671674861,2093053845,2093053845,0
1361671704,2093083892,1,52,52,1361671675935,1361671675935,2093055827,2093055827,0
1361671705,2093084500,6,1312,218.6666667,1361671700586,1361671700714,2093080086,2093080214,128
1361671713,2093092028,18,19168,1064.888889,1361671687806,1361671704190,2093066834,2093083218,16384
1361671720,2093099900,40,46414,1160.35,1361671692825,1361671710297,2093072725,2093090197,17472
1361671720,2093099900,40,48314,1207.85,1361671692888,1361671716248,2093072788,2093096148,23360
1361671720,2093099900,16,19415,1213.4375,1361671692887,1361671715479,2093072787,2093095379,22592
1361671721,2093099988,16,19242,1202.625,1361671693801,1361671704361,2093072789,2093083349,10560
1361671721,2093100324,9,1583,175.8888889,1361671714585,1361671717977,2093093909,2093097301,3392
1361671721,2093100364,13,12186,937.3846154,1361671716658,1361671718706,2093096022,2093098070,2048
1361671725,2093104000,16,7467,466.6875,1361671699741,1361671716701,2093078741,2093095701,16960
1361671729,2093108100,1,52,52,1361671703864,1361671703864,2093082964,2093082964,0
1361671729,2093108104,9,11929,1325.444444,1361671704245,1361671716277,2093083349,2093095381,12032
1361671729,2093108108,15,16997,1133.133333,1361671704305,1361671716209,2093083413,2093095317,11904
1361671729,2093108432,7,1188,169.7142857,1361671717163,1361671727851,2093096595,2093107283,10688
1361671729,2093108440,9,1217,135.2222222,1361671718627,1361671723747,2093098067,2093103187,5120
1361671733,2093111972,2,534,267,1361671704825,1361671717433,2093083797,2093096405,12608
1361671737,2093116160,10,11763,1176.3,1361671711038,1361671711038,2093090198,2093090198,0
1361671737,2093116384,1295,1836691,1418.294208,1361671693276,1361671729308,2093072660,2093108692,36032
1361671737,2093116384,6113,8569004,1401.767381,1361671641882,1361671733594,2093021266,2093112978,91712
1361671741,2093119912,46,35286,767.0869565,1361671714676,1361671737652,2093093588,2093116564,22976
1361671741,2093119932,3,687,229,1361671714910,1361671714974,2093093842,2093093906,64
1361671741,2093120028,6,4814,802.3333333,1361671716289,1361671716353,2093095317,2093095381,64
1361671741,2093120028,32,38343,1198.21875,1361671716545,1361671719041,2093095573,2093098069,2496
1361671741,2093120028,15,7308,487.2,1361671716671,1361671728191,2093095699,2093107219,11520
1361671745,2093123924,38,47238,1243.105263,1361671717031,1361671718695,2093095955,2093097619,1664
1361671745,2093123936,1,52,52,1361671717852,1361671717852,2093096788,2093096788,0
1361671745,2093123936,1,52,52,1361671717850,1361671717850,2093096786,2093096786,0
1361671745,2093123968,4,1038,259.5,1361671718653,1361671718717,2093097621,2093097685,64
1361671745,2093124008,3,524,174.6666667,1361671717394,1361671717458,2093096402,2093096466,64
1361671745,2093124012,7,1196,170.8571429,1361671717584,1361671737488,2093096596,2093116500,19904
1361671745,2093124016,1,52,52,1361671717772,1361671717772,2093096788,2093096788,0
1361671745,2093124044,4,1312,328,1361671718574,1361671718702,2093097618,2093097746,128
1361671745,2093124044,5,1676,335.2,1361671718574,1361671718638,2093097618,2093097682,64
1361671745,2093124048,11,7453,677.5454545,1361671718892,1361671738924,2093097940,2093117972,20032
1361671745,2093124048,3,689,229.6666667,1361671718891,1361671718955,2093097939,2093098003,64
1361671753,2093131948,13,2832,217.8461538,1361671728335,1361671746447,2093107283,2093125395,18112
1361671753,2093132348,5,680,136,1361671737214,1361671745982,2093116562,2093125330,8768
1361671753,2093132356,1299,1843781,1419.384911,1361671718073,1361671752377,2093097429,2093131733,34304
1361671773,2093152096,53,51333,968.5471698,1361671746235,1361671766715,2093125331,2093145811,20480
1361671773,2093152124,11,2220,201.8181818,1361671746592,1361671769632,2093125716,2093148756,23040
1361671773,2093152132,10,1764,176.4,1361671747414,1361671771798,2093126546,2093150930,24384
1361671777,2093156400,297,414987,1397.262626,1361671767946,1361671769034,2093147346,2093148434,1088
1361671781,2093159924,7,2930,418.5714286,1361671753831,1361671761383,2093132755,2093140307,7552
1361671781,2093159928,1,46,46,1361671753829,1361671753829,2093132757,2093132757,0
1361671781,2093159964,9,1217,135.2222222,1361671755520,1361671764672,2093134484,2093143636,9152
1361671781,2093159996,1,52,52,1361671753758,1361671753758,2093132754,2093132754,0
1361671781,2093159996,1,46,46,1361671753822,1361671753822,2093132818,2093132818,0
1361671781,2093159996,1,46,46,1361671753758,1361671753758,2093132754,2093132754,0
1361671781,2093159996,1,46,46,1361671753822,1361671753822,2093132818,2093132818,0
1361671781,2093160012,1,52,52,1361671755149,1361671755149,2093134161,2093134161,0
1361671781,2093160036,2,534,267,1361671755766,1361671761590,2093134802,2093140626,5824
1361671785,2093163996,2,1157,578.5,1361671759713,1361671759841,2093138709,2093138837,128
1361671785,2093164076,12,14712,1226,1361671759629,1361671773069,2093138705,2093152145,13440
1361671785,2093164376,5,680,136,1361671781475,1361671783139,2093160851,2093162515,1664
1361671785,2093164420,3,1481,493.6666667,1361671766329,1361671781433,2093145749,2093160853,15104
1361671785,2093164420,2840,4033791,1420.348944,1361671723510,1361671784054,2093102930,2093163474,60544
1361671789,2093167956,15,7318,487.8666667,1361671761352,1361671767560,2093140308,2093146516,6208
1361671789,2093167964,34,44947,1321.970588,1361671761793,1361671763969,2093140757,2093142933,2176
1361671789,2093167964,13,12225,940.3846154,1361671761857,1361671763137,2093140821,2093142101,1280
1361671789,2093167996,1,412,412,1361671763040,1361671763040,2093142036,2093142036,0
1361671789,2093168032,10,10499,1049.9,1361671760955,1361671773115,2093139987,2093152147,12160
1361671789,2093168032,6,7696,1282.666667,1361671760955,1361671772987,2093139987,2093152019,12032
1361671789,2093168128,3,1244,414.6666667,1361671764121,1361671764185,2093143249,2093143313,64
1361671793,2093172476,112,145960,1303.214286,1361671745281,1361671789249,2093124757,2093168725,43968
1361671793,2093172516,4,4106,1026.5,1361671772504,1361671789592,2093152020,2093169108,17088
1361671793,2093172520,17,18510,1088.823529,1361671789204,1361671789588,2093168724,2093169108,384
1361671801,2093179964,13,14541,1118.538462,1361671772989,1361671790205,2093151953,2093169169,17216
1361671801,2093179964,16,18404,1150.25,1361671773183,1361671795583,2093152147,2093174547,22400
1361671801,2093180032,1,52,52,1361671772924,1361671772924,2093151956,2093151956,0
1361671801,2093180036,1,52,52,1361671773112,1361671773112,2093152148,2093152148,0
1361671801,2093180036,4,3921,980.25,1361671773112,1361671773112,2093152148,2093152148,0
1361671805,2093184100,1,46,46,1361671778933,1361671778933,2093158033,2093158033,0
1361671809,2093187988,18,9424,523.5555556,1361671782950,1361671791270,2093161938,2093170258,8320
1361671809,2093188020,3,649,216.3333333,1361671783622,1361671783622,2093162642,2093162642,0
1361671809,2093188020,1,52,52,1361671783622,1361671783622,2093162642,2093162642,0
1361671809,2093188096,3,661,220.3333333,1361671783483,1361671783547,2093162579,2093162643,64
1361671817,2093195984,1,52,52,1361671789804,1361671789804,2093168788,2093168788,0
1361671817,2093195988,13,17204,1323.384615,1361671790119,1361671790183,2093169107,2093169171,64
1361671817,2093196060,4,463,115.75,1361671790046,1361671790110,2093169106,2093169170,64
1361671817,2093196060,24,28981,1207.541667,1361671790046,1361671790878,2093169106,2093169938,832
1361671817,2093196060,34,46749,1374.970588,1361671790046,1361671795486,2093169106,2093174546,5440
1361671817,2093196060,14,19212,1372.285714,1361671790046,1361671793886,2093169106,2093172946,3840
1361671817,2093196068,1,267,267,1361671790935,1361671790935,2093170003,2093170003,0
1361671817,2093196576,2464,3502062,1421.291396,1361671771739,1361671810395,2093151315,2093189971,38656
1361671821,2093200028,32,38597,1206.15625,1361671793920,1361671795520,2093172948,2093174548,1600
1361671825,2093204508,2894,4101093,1417.101935,1361671771678,1361671819230,2093151186,2093198738,47552
1361671845,2093224044,1,46,46,1361671819692,1361671819692,2093198736,2093198736,0
1361671845,2093224044,1,46,46,1361671819696,1361671819696,2093198740,2093198740,0
1361671845,2093224120,1,46,46,1361671819617,1361671819617,2093198737,2093198737,0
1361671853,2093232144,6,1136,189.3333333,1361671827148,1361671837388,2093206292,2093216532,10240
1361671857,2093236144,4,628,157,1361671831049,1361671831049,2093210193,2093210193,0
1361671861,2093240024,1,52,52,1361671834691,1361671834691,2093213715,2093213715,0
1361671861,2093240068,1,52,52,1361671833685,1361671833685,2093212753,2093212753,0
1361671861,2093240068,1,52,52,1361671833685,1361671833685,2093212753,2093212753,0
1361671877,2093256024,2,104,52,1361671849219,1361671874691,2093228243,2093253715,25472
1361671897,2093276120,3,568,189.3333333,1361671871071,1361671871135,2093250191,2093250255,64
1361671901,2093280188,1,52,52,1361671874526,1361671874526,2093253714,2093253714,0
1361671905,2093284096,1,52,52,1361671878586,1361671878586,2093257682,2093257682,0
1361671905,2093284120,1,52,52,1361671879584,1361671879584,2093258704,2093258704,0
1361671905,2093284124,1,52,52,1361671879583,1361671879583,2093258707,2093258707,0
1361671905,2093284172,1,52,52,1361671878508,1361671878508,2093257680,2093257680,0
1361671909,2093288104,1,52,52,1361671882609,1361671882609,2093261713,2093261713,0
1361671913,2093292104,1,52,52,1361671888562,1361671888562,2093267666,2093267666,0
1361671913,2093292180,1,52,52,1361671888486,1361671888486,2093267666,2093267666,0
1361671913,2093292680,167,225113,1347.982036,1361671764528,1361671909936,2093144208,2093289616,145408
1361671925,2093304116,1,52,52,1361671898535,1361671898535,2093277651,2093277651,0
1361671925,2093304188,1,52,52,1361671898460,1361671898460,2093277648,2093277648,0
1361671929,2093308704,1294,1836663,1419.368624,1361671891739,1361671924763,2093271443,2093304467,33024
1361671933,2093312084,1,52,52,1361671906630,1361671906630,2093285714,2093285714,0
1361671933,2093312084,2,104,52,1361671906566,1361671906566,2093285650,2093285650,0
1361671933,2093312148,1,52,52,1361671905541,1361671905541,2093284689,2093284689,0
1361671933,2093312148,1,52,52,1361671905541,1361671905541,2093284689,2093284689,0
1361671933,2093312164,1,52,52,1361671906485,1361671906485,2093285649,2093285649,0
1361671937,2093316120,1,52,52,1361671910496,1361671910496,2093289616,2093289616,0
1361671937,2093316120,1,52,52,1361671910496,1361671910496,2093289616,2093289616,0
1361671937,2093316192,1,52,52,1361671909529,1361671909529,2093288721,2093288721,0
1361671937,2093316200,1,52,52,1361671910416,1361671910416,2093289616,2093289616,0
1361671937,2093316228,3,568,189.3333333,1361671911028,1361671911028,2093290256,2093290256,0
1361671941,2093320096,5,3390,678,1361671913657,1361671913721,2093292753,2093292817,64
1361671957,2093336156,1,46,46,1361671931390,1361671931390,2093310546,2093310546,0
1361671969,2093348696,1296,1836737,1417.23534,1361671930848,1361671967968,2093310544,2093347664,37120
1361671977,2093356252,1,52,52,1361671952347,1361671952347,2093331599,2093331599,0
1361671977,2093356320,3,568,189.3333333,1361671950935,1361671950935,2093330255,2093330255,0
1361672001,2093380796,1294,1836651,1419.359351,1361671967867,1361672000187,2093347663,2093379983,32320
1361672017,2093396400,3,568,189.3333333,1361671990855,1361671990855,2093370255,2093370255,0
1361672033,2093412724,125,171363,1370.904,1361671910594,1361672025858,2093290318,2093405582,115264
1361672046,2093425916,3686,5225212,1417.583288,1361671713985,1361671745409,2093093901,2093125325,31424
1361672053,2093432588,1,46,46,1361672025994,1361672025994,2093405582,2093405582,0
1361672057,2093436552,1,52,52,1361672029037,1361672029037,2093408589,2093408589,0
1361672069,2093448568,1856,2622855,1413.176185,1361671759264,1361671766176,2093138832,2093145744,6912
1361672069,2093448568,1159,1643333,1417.888697,1361671759264,1361671766112,2093138832,2093145680,6848
1361672073,2093452592,639,903270,1413.568075,1361671766407,1361671767623,2093145999,2093147215,1216
1361672073,2093452592,153,212987,1392.071895,1361671768007,1361671768839,2093147599,2093148431,832
1361672077,2093456608,886,1254891,1416.35553,1361671768885,1361671771573,2093148493,2093151181,2688
1361672077,2093456608,142,197301,1389.443662,1361671771317,1361671771573,2093150925,2093151181,256
1361672101,2093480644,1,76,76,1361672074705,1361672074705,2093454349,2093454349,0
1361672133,2093512640,1,52,52,1361672105877,1361672105877,2093485517,2093485517,0
1361672199,2093578352,1,46,46,1361672173236,1361672173236,2093552588,2093552588,0
1361672218,2093597152,4,628,157,1361672191102,1361672191166,2093570254,2093570318,64
1361672262,2093641136,3,1252,417.3333333,1361672235211,1361672235275,2093614347,2093614411,64
1361672262,2093641164,31,35773,1153.967742,1361672235697,1361672237105,2093614861,2093616269,1408
1361672322,2093701300,53,72095,1360.283019,1361672295976,1361672296040,2093675276,2093675340,64
1361672334,2093713256,1,52,52,1361672306002,1361672306002,2093685258,2093685258,0
1361672338,2093717284,4,628,157,1361672310966,1361672311030,2093690250,2093690314,64
1361672346,2093725268,4,696,174,1361672318918,1361672318982,2093698186,2093698250,64
1361672374,2093753424,1,52,52,1361672349804,1361672349804,2093729228,2093729228,0
1361672378,2093757652,3,568,189.3333333,1361672350661,1361672350661,2093730313,2093730313,0
1361672378,2093757784,1,52,52,1361672351426,1361672351426,2093731210,2093731210,0
1361672386,2093765496,2582,3667506,1420.412858,1361672315043,1361672378339,2093694539,2093757835,63296
1361672418,2093797464,1294,1835271,1418.29289,1361672378369,1361672415681,2093757833,2093795145,37312
1361672418,2093797640,3,568,189.3333333,1361672390673,1361672390673,2093770313,2093770313,0
1361672438,2093817732,1,52,52,1361672410485,1361672410485,2093790217,2093790217,0
1361672458,2093837768,1,52,52,1361672433424,1361672433424,2093813192,2093813192,0
1361672458,2093837796,3,568,189.3333333,1361672430515,1361672430515,2093810311,2093810311,0
1361672482,2093861440,2584,3671738,1420.951238,1361672415705,1361672479321,2093795145,2093858761,63616
1361672498,2093877720,3,568,189.3333333,1361672470593,1361672470593,2093850313,2093850313,0
1361672498,2093877788,50,66282,1325.64,1361672473659,1361672473787,2093853447,2093853575,128
1361672514,2093893760,1,46,46,1361672487319,1361672487319,2093867079,2093867079,0
1361672522,2093901520,1296,1838117,1418.300154,1361672487562,1361672520714,2093867082,2093900234,33152
1361672539,2093918016,3,568,189.3333333,1361672511297,1361672511297,2093890313,2093890313,0
1361672551,2093930104,1,46,46,1361672526566,1361672526566,2093905670,2093905670,0
1361672562,2093941540,1294,1835271,1418.29289,1361672526132,1361672561588,2093905672,2093941128,35456
1361672579,2093958024,3,568,189.3333333,1361672551352,1361672551352,2093930376,2093930376,0
1361672602,2093981556,1311,1858127,1417.335622,1361672561571,1361672598883,2093941127,2093978439,37312
1361672615,2093994076,1,76,76,1361672588292,1361672588292,2093967368,2093967368,0
1361672615,2093994112,1,52,52,1361672589984,1361672589984,2093969096,2093969096,0
1361672619,2093998064,3,568,189.3333333,1361672591247,1361672591311,2093970311,2093970375,64
1361672634,2094013524,1298,1842355,1419.379815,1361672598976,1361672631424,2093978500,2094010948,32448
1361672659,2094038052,3,568,189.3333333,1361672631257,1361672631321,2094010309,2094010373,64
1361672691,2094070408,1,46,46,1361672665654,1361672665654,2094045062,2094045062,0
1361672699,2094078376,3,568,189.3333333,1361672670998,1361672670998,2094050374,2094050374,0
1361672739,2094118404,3,568,189.3333333,1361672710969,1361672711033,2094090373,2094090437,64
1361672755,2094134584,1,60,60,1361672729606,1361672729606,2094109190,2094109190,0
1361672779,2094158552,3,568,189.3333333,1361672750885,1361672750885,2094130437,2094130437,0
1361672892,2094270976,1,52,52,1361672866468,1361672866468,2094245444,2094245444,0
1361672936,2094315032,4,628,157,1361672911528,1361672911592,2094290560,2094290624,64
1361672976,2094355284,4,632,158,1361672951342,1361672952302,2094330626,2094331586,960
1361673016,2094395312,3,568,189.3333333,1361672991374,1361672991374,2094370686,2094370686,0
1361673056,2094435392,3,568,189.3333333,1361673031296,1361673031296,2094410688,2094410688,0
1361673097,2094476060,3,568,189.3333333,1361673071626,1361673071690,2094450686,2094450750,64
1361673097,2094476180,1,46,46,1361673069074,1361673069074,2094448254,2094448254,0
1361673108,2094487764,47,63552,1352.170213,1361673079946,1361673080010,2094459710,2094459774,64
1361673128,2094507584,1,76,76,1361673101758,1361673101758,2094481342,2094481342,0
1361673136,2094515728,3,568,189.3333333,1361673111086,1361673111086,2094490814,2094490814,0
1361673176,2094555612,3,568,189.3333333,1361673151139,1361673151203,2094530751,2094530815,64
1361673216,2094595700,3,568,189.3333333,1361673191115,1361673191115,2094570815,2094570815,0
1361673220,2094599772,1,52,52,1361673194944,1361673194944,2094574716,2094574716,0
1361673243,2094622156,2369,3362488,1419.370198,1361673180711,1361673240423,2094559867,2094619579,59712
1361673256,2094635756,3,568,189.3333333,1361673231057,1361673231057,2094610813,2094610813,0
1361673280,2094659724,38,50163,1320.078947,1361673252658,1361673254578,2094632382,2094634302,1920
1361673280,2094659724,9,9200,1022.222222,1361673252658,1361673252722,2094632382,2094632446,64
1361673280,2094659724,9,8762,973.5555556,1361673252722,1361673252722,2094632446,2094632446,0
1361673280,2094659724,8,7367,920.875,1361673252785,1361673252785,2094632509,2094632509,0
1361673280,2094659804,10,9678,967.8,1361673252639,1361673252767,2094632443,2094632571,128
1361673280,2094659804,9,9636,1070.666667,1361673252639,1361673252639,2094632443,2094632443,0
1361673280,2094659804,10,10691,1069.1,1361673252703,1361673252703,2094632507,2094632507,0
1361673280,2094659804,11,11894,1081.272727,1361673252703,1361673252703,2094632507,2094632507,0
1361673280,2094659808,10,11426,1142.6,1361673252702,1361673252702,2094632510,2094632510,0
1361673280,2094659808,9,9606,1067.333333,1361673252765,1361673252765,2094632573,2094632573,0
1361673296,2094675800,3,568,189.3333333,1361673271010,1361673271074,2094650810,2094650874,64
1361673324,2094703788,1,46,46,1361673296878,1361673296878,2094676666,2094676666,0
1361673336,2094715908,3,568,189.3333333,1361673310903,1361673310967,2094690811,2094690875,64
1361673393,2094771948,1,52,52,1361673368631,1361673368631,2094747579,2094747579,0
1361673393,2094771952,1,52,52,1361673368628,1361673368628,2094747580,2094747580,0
1361673393,2094771952,1,52,52,1361673368628,1361673368628,2094747580,2094747580,0
1361673393,2094771952,1,52,52,1361673368628,1361673368628,2094747580,2094747580,0
1361673393,2094772040,1,52,52,1361673368539,1361673368539,2094747579,2094747579,0
1361673393,2094772040,1,52,52,1361673368539,1361673368539,2094747579,2094747579,0
1361673393,2094772040,1,52,52,1361673368537,1361673368537,2094747577,2094747577,0
1361673393,2094772040,1,52,52,1361673368537,1361673368537,2094747577,2094747577,0
1361673393,2094772040,1,52,52,1361673368537,1361673368537,2094747577,2094747577,0
1361673393,2094772040,1,52,52,1361673368537,1361673368537,2094747577,2094747577,0
1361673397,2094776044,1,52,52,1361673370517,1361673370517,2094749561,2094749561,0
1361673417,2094796032,3,568,189.3333333,1361673391841,1361673391841,2094770873,2094770873,0
1361673457,2094836016,3,568,189.3333333,1361673431856,1361673431856,2094810872,2094810872,0
1361673497,2094876228,3,568,189.3333333,1361673471707,1361673471707,2094850935,2094850935,0
1361673537,2094916284,3,568,189.3333333,1361673511652,1361673511652,2094890936,2094890936,0
1361673577,2094956324,3,568,189.3333333,1361673551676,1361673551676,2094931000,2094931000,0
1361673641,2095020396,1,76,76,1361673615986,1361673615986,2094995382,2094995382,0
1361673657,2095036408,3,568,189.3333333,1361673631653,1361673631653,2095011061,2095011061,0
1361673697,2095076452,3,568,189.3333333,1361673671676,1361673671676,2095051128,2095051128,0
1361673761,2095140528,1,46,46,1361673733548,1361673733548,2095113076,2095113076,0
1361673781,2095160640,3,297,99,1361673756028,1361673756028,2095135668,2095135668,0
1361673785,2095164480,12,2177,181.4166667,1361673757085,1361673780893,2095136565,2095160373,23808
1361673785,2095164480,13,4087,314.3846154,1361673757212,1361673761308,2095136692,2095140788,4096
1361673785,2095164524,3,325,108.3333333,1361673758898,1361673758898,2095138422,2095138422,0
1361673785,2095164532,14,12545,896.0714286,1361673759656,1361673760232,2095139188,2095139764,576
1361673785,2095164560,3,652,217.3333333,1361673760143,1361673760207,2095139703,2095139767,64
1361673785,2095164560,3,524,174.6666667,1361673760143,1361673760207,2095139703,2095139767,64
1361673785,2095164564,7,1196,170.8571429,1361673760650,1361673780682,2095140214,2095160246,20032
1361673785,2095164600,5,1009,201.8,1361673758820,1361673759588,2095138420,2095139188,768
1361673785,2095164608,5,1787,357.4,1361673759199,1361673759519,2095138807,2095139127,320
1361673785,2095164608,3,325,108.3333333,1361673759198,1361673759262,2095138806,2095138870,64
1361673785,2095164612,6,5373,895.5,1361673759707,1361673759771,2095139319,2095139383,64
1361673785,2095164640,3,652,217.3333333,1361673760060,1361673760124,2095139700,2095139764,64
1361673785,2095164644,3,379,126.3333333,1361673760631,1361673760759,2095140275,2095140403,128
1361673793,2095172596,3,526,175.3333333,1361673768359,1361673768359,2095147955,2095147955,0
1361673793,2095172600,3,526,175.3333333,1361673768356,1361673768356,2095147956,2095147956,0
1361673803,2095182796,2585,3673170,1420.955513,1361673761249,1361673802849,2095141045,2095182645,41600
1361673817,2095196548,3,568,189.3333333,1361673790746,1361673790810,2095170294,2095170358,64
1361673817,2095196624,3,568,189.3333333,1361673790731,1361673790731,2095170355,2095170355,0
1361673825,2095204524,3,362,120.6666667,1361673798447,1361673798447,2095177971,2095177971,0
1361673841,2095220660,4,3337,834.25,1361673816297,1361673816297,2095195957,2095195957,0
1361673857,2095236640,3,568,189.3333333,1361673830717,1361673830717,2095210357,2095210357,0
1361673897,2095276624,1,52,52,1361673870413,1361673870413,2095250037,2095250037,0
1361673897,2095276624,3,568,189.3333333,1361673870730,1361673870794,2095250354,2095250418,64
1361673901,2095280660,1,52,52,1361673874409,1361673874409,2095254069,2095254069,0
1361673901,2095280660,1,52,52,1361673874409,1361673874409,2095254069,2095254069,0
1361673901,2095280660,1,52,52,1361673874409,1361673874409,2095254069,2095254069,0
1361673901,2095280700,1,52,52,1361673873344,1361673873344,2095253044,2095253044,0
1361673901,2095280700,1,52,52,1361673873344,1361673873344,2095253044,2095253044,0
1361673901,2095280700,1,52,52,1361673875454,1361673875454,2095255154,2095255154,0
1361673901,2095280736,1,52,52,1361673874332,1361673874332,2095254068,2095254068,0
1361673901,2095280736,1,52,52,1361673874332,1361673874332,2095254068,2095254068,0
1361673901,2095280736,1,52,52,1361673874331,1361673874331,2095254067,2095254067,0
1361673901,2095280736,1,52,52,1361673874331,1361673874331,2095254067,2095254067,0
1361673909,2095288664,1,52,52,1361673883362,1361673883362,2095263026,2095263026,0
1361673909,2095288668,1,52,52,1361673883359,1361673883359,2095263027,2095263027,0
1361673933,2095312652,1,52,52,1361673905325,1361673905325,2095284977,2095284977,0
1361673937,2095316764,3,568,189.3333333,1361673910656,1361673910656,2095290420,2095290420,0
1361673941,2095320740,1,52,52,1361673913238,1361673913238,2095292978,2095292978,0
1361673957,2095336708,1,52,52,1361673931253,1361673931253,2095310961,2095310961,0
1361673957,2095336824,22,28124,1278.363636,1361673931843,1361673931907,2095311667,2095311731,64
1361673961,2095340688,11,11051,1004.636364,1361673934027,1361673958283,2095313715,2095337971,24256
1361673961,2095340688,12,13663,1138.583333,1361673934025,1361673958281,2095313713,2095337969,24256
1361673961,2095340688,7,5961,851.5714286,1361673934025,1361673934089,2095313713,2095313777,64
1361673961,2095340764,9,8911,990.1111111,1361673933949,1361673934013,2095313713,2095313777,64
1361673961,2095340764,14,15850,1132.142857,1361673933949,1361673958205,2095313713,2095337969,24256
1361673973,2095352800,4,696,174,1361673945114,1361673945178,2095324914,2095324978,64
1361673977,2095356772,3,568,189.3333333,1361673950645,1361673950709,2095330417,2095330481,64
1361673981,2095360716,3,1085,361.6666667,1361673955120,1361673955184,2095334836,2095334900,64
1361673981,2095360796,15,15775,1051.666667,1361673955167,1361673955807,2095334963,2095335603,640
1361673985,2095364756,4,2279,569.75,1361673958215,1361673958279,2095337971,2095338035,64
1361673985,2095364756,5,3446,689.2,1361673958214,1361673958278,2095337970,2095338034,64
1361673985,2095364836,5,3094,618.8,1361673958133,1361673958133,2095337969,2095337969,0
1361673985,2095364836,2,2167,1083.5,1361673958132,1361673958132,2095337968,2095337968,0
1361673985,2095364840,6,5482,913.6666667,1361673958132,1361673958196,2095337972,2095338036,64
1361673987,2095366828,2582,3670266,1421.481797,1361673948734,1361673985534,2095328562,2095365362,36800
1361673995,2095374872,3228,4587072,1421.026022,1361673947987,1361673993939,2095327859,2095373811,45952
1361674018,2095397076,3,568,189.3333333,1361673991405,1361673991469,2095370481,2095370545,64
1361674050,2095429068,1,46,46,1361674025845,1361674025845,2095404913,2095404913,0
1361674054,2095433004,1,46,46,1361674025910,1361674025910,2095404914,2095404914,0
1361674058,2095437032,3,568,189.3333333,1361674031512,1361674031576,2095410544,2095410608,64
1361674059,2095438844,486,674719,1388.3107,1361673756845,1361673757485,2095136689,2095137329,640
1361674074,2095453060,1,52,52,1361674048828,1361674048828,2095427888,2095427888,0
1361674074,2095453136,1,52,52,1361674048752,1361674048752,2095427888,2095427888,0
1361674083,2095462868,5,1594,318.8,1361674076821,1361674082005,2095456689,2095461873,5184
1361674086,2095465156,1,52,52,1361674060766,1361674060766,2095439922,2095439922,0
1361674098,2095477076,1,52,52,1361674070830,1361674070830,2095449906,2095449906,0
1361674098,2095477080,3,568,189.3333333,1361674071463,1361674071527,2095450543,2095450607,64
1361674098,2095477124,1,52,52,1361674073722,1361674073722,2095452846,2095452846,0
1361674098,2095477124,1,52,52,1361674073722,1361674073722,2095452846,2095452846,0
1361674098,2095477140,1,52,52,1361674073709,1361674073709,2095452849,2095452849,0
1361674098,2095477140,1,52,52,1361674073709,1361674073709,2095452849,2095452849,0
1361674098,2095477148,1,52,52,1361674070755,1361674070755,2095449903,2095449903,0
1361674098,2095477200,1,52,52,1361674073649,1361674073649,2095452849,2095452849,0
1361674098,2095477200,1,52,52,1361674073649,1361674073649,2095452849,2095452849,0
1361674098,2095477224,1,52,52,1361674073626,1361674073626,2095452850,2095452850,0
1361674098,2095477224,1,52,52,1361674073626,1361674073626,2095452850,2095452850,0
1361674101,733794904,3,753,251,1361674076910,1361674076910,733770814,733770814,0
1361674105,733798840,9,9539,1059.888889,1361674077038,1361674077038,733770878,733770878,0
1361674138,2095517116,3,568,189.3333333,1361674111493,1361674111493,2095490609,2095490609,0
1361674142,2095521044,3477,4944085,1421.939891,1361673817034,1361673839370,2095196078,2095218414,22336
1361674150,2095529408,9682,13748584,1420.014873,1361673760352,1361673845280,2095139760,2095224688,84928
1361674150,2095529496,3,540,180,1361674125830,1361674125830,2095505326,2095505326,0
1361674154,2095533380,3,540,180,1361674125948,1361674125948,2095505328,2095505328,0
1361674154,2095533380,3,540,180,1361674125948,1361674125948,2095505328,2095505328,0
1361674154,2095533380,3,540,180,1361674125948,1361674125948,2095505328,2095505328,0
1361674154,2095533420,1,76,76,1361674127954,1361674127954,2095507374,2095507374,0
1361674154,2095533460,3,540,180,1361674125868,1361674125868,2095505328,2095505328,0
1361674210,2095589624,1,46,46,1361674185157,1361674185157,2095564781,2095564781,0
1361674218,733911096,1,52,52,1361674192727,1361674192727,733885823,733885823,0
1361674218,733911132,1,52,52,1361674192691,1361674192691,733885823,733885823,0
1361674250,2095629756,1,52,52,1361674225024,1361674225024,2095604780,2095604780,0
1361674254,2095633580,8239,11705433,1420.734677,1361673840308,1361673948212,2095219888,2095327792,107904
1361674254,2095633580,1255,1784439,1421.863745,1361673944244,1361673948404,2095323824,2095327984,4160
1361674266,2095645644,1,52,52,1361674240114,1361674240114,2095619758,2095619758,0
1361674266,2095645644,1,52,52,1361674240178,1361674240178,2095619822,2095619822,0
1361674266,2095645644,1,52,52,1361674240176,1361674240176,2095619820,2095619820,0
1361674266,2095645720,1,52,52,1361674240101,1361674240101,2095619821,2095619821,0
1361674266,2095645720,1,52,52,1361674240101,1361674240101,2095619821,2095619821,0
1361674293,733986468,12,5260,438.3333333,1361674292707,1361674292771,733986175,733986239,64
1361674293,733986468,5,947,189.4,1361674292643,1361674292643,733986111,733986111,0
1361674293,733986472,10,8714,871.4,1361674292766,1361674292830,733986238,733986302,64
1361674301,733994464,7,1518,216.8571429,1361674298664,1361674298664,733992128,733992128,0
1361674301,733994464,12,7938,661.5,1361674298920,1361674299048,733992384,733992512,128
1361674301,733994464,7,1604,229.1428571,1361674299112,1361674299816,733992576,733993280,704
1361674301,733994464,7,1604,229.1428571,1361674299814,1361674300070,733993278,733993534,256
1361674301,733994464,9,2550,283.3333333,1361674300070,1361674300262,733993534,733993726,192
1361674301,733994464,8,1714,214.25,1361674300070,1361674300326,733993534,733993790,256
1361674301,733994464,9,1558,173.1111111,1361674297893,1361674298661,733991357,733992125,768
1361674301,733994468,10,7098,709.8,1361674298660,1361674298788,733992128,733992256,128
1361674301,733994468,15,12035,802.3333333,1361674298915,1361674299043,733992383,733992511,128
1361674301,733994468,7,1604,229.1428571,1361674299107,1361674299939,733992575,733993407,832
1361674301,733994468,8,2312,289,1361674299554,1361674300002,733993022,733993470,448
1361674301,733994468,7,1604,229.1428571,1361674299809,1361674300001,733993277,733993469,192
1361674301,733994468,10,2634,263.4,1361674300065,1361674300321,733993533,733993789,256
1361674301,733994468,8,1490,186.25,1361674300065,1361674300129,733993533,733993597,64
1361674301,733994468,9,1814,201.5555556,1361674300065,1361674300641,733993533,733994109,576
1361674306,733999264,8,1442,180.25,1361674306032,1361674306160,733999296,733999424,128
1361674306,733999264,7,1524,217.7142857,1361674305968,1361674306032,733999232,733999296,64
1361674306,733999264,7,1524,217.7142857,1361674305968,1361674306032,733999232,733999296,64
1361674306,733999264,13,8726,671.2307692,1361674306032,1361674306288,733999296,733999552,256
1361674306,733999264,8,1506,188.25,1361674306032,1361674306160,733999296,733999424,128
1361674309,734002472,8,1730,216.25,1361674306144,1361674306464,733999616,733999936,320
1361674309,734002472,10,1547,154.7,1361674306143,1361674306655,733999615,734000127,512
1361674309,734002472,11,7086,644.1818182,1361674304477,1361674304541,733997949,733998013,64
1361674309,734002472,9,1350,150,1361674307933,1361674308125,734001405,734001597,192
1361674309,734002476,12,7938,661.5,1361674304732,1361674304924,733998208,733998400,192
1361674309,734002476,8,2232,279,1361674305052,1361674305116,733998528,733998592,64
1361674309,734002476,7,1502,214.5714286,1361674305180,1361674305180,733998656,733998656,0
1361674309,734002476,7,1188,169.7142857,1361674305436,1361674305756,733998912,733999232,320
1361674309,734002476,9,1350,150,1361674305755,1361674305883,733999231,733999359,128
1361674309,734002476,7,1524,217.7142857,1361674305755,1361674305819,733999231,733999295,64
1361674309,734002476,7,1524,217.7142857,1361674305755,1361674305819,733999231,733999295,64
1361674309,734002476,8,1458,182.25,1361674305819,1361674306011,733999295,733999487,192
1361674309,734002476,9,1794,199.3333333,1361674303066,1361674305050,733996542,733998526,1984
1361674309,734002476,9,1350,150,1361674303066,1361674303322,733996542,733996798,256
1361674309,734002480,8,1554,194.25,1361674304792,1361674305112,733998272,733998592,320
1361674309,734002480,7,1486,212.2857143,1361674304727,1361674304791,733998207,733998271,64
1361674309,734002480,16,14455,903.4375,1361674305239,1361674305431,733998719,733998911,192
1361674309,734002480,7,1294,184.8571429,1361674305623,1361674305815,733999103,733999295,192
1361674309,734002480,15,11651,776.7333333,1361674300055,1361674302999,733993535,733996479,2944
1361674317,734010476,14,10943,781.6428571,1361674310683,1361674311195,734004159,734004671,512
1361674317,734010476,9,1350,150,1361674311577,1361674311641,734005053,734005117,64
1361674317,734010484,7,1188,169.7142857,1361674311508,1361674311572,734004992,734005056,64
1361674324,2095702936,30,35440,1181.333333,1361674300980,1361674316212,2095679916,2095695148,15232
1361674349,734042472,9,1175,130.5555556,1361674343966,1361674344158,734037438,734037630,192
1361674349,734042472,1474,2093572,1420.333786,1361674344158,1361674346270,734037630,734039742,2112
1361674487,2095866052,3,540,180,1361674462143,1361674462207,2095841195,2095841259,64
1361674487,2095866052,3,540,180,1361674462206,1361674462206,2095841258,2095841258,0
1361674487,2095866072,3,540,180,1361674462121,1361674462185,2095841193,2095841257,64
1361674487,2095866072,3,540,180,1361674462185,1361674462185,2095841257,2095841257,0
1361674487,2095866164,3,540,180,1361674462096,1361674462096,2095841260,2095841260,0
1361674491,2095870016,18,15985,888.0555556,1361674464483,1361674471843,2095843499,2095850859,7360
1361674491,2095870016,5,2078,415.6,1361674464481,1361674471265,2095843497,2095850281,6784
1361674491,2095870056,11,6724,611.2727273,1361674466041,1361674466361,2095845097,2095845417,320
1361674491,2095870120,34,25315,744.5588235,1361674464187,1361674472571,2095843307,2095851691,8384
1361674492,2095871052,594,771829,1299.375421,1361674469246,1361674489470,2095848298,2095868522,20224
1361674495,2095874132,98,92395,942.8061224,1361674469167,1361674489007,2095848299,2095868139,19840
1361674499,2095878032,4,813,203.25,1361674471249,1361674471761,2095850281,2095850793,512
1361674499,2095878032,88,99299,1128.397727,1361674471249,1361674488209,2095850281,2095867241,16960
1361674499,2095878036,24,25690,1070.416667,1361674471244,1361674484108,2095850280,2095863144,12864
1361674499,2095878036,6,3354,559,1361674471312,1361674471824,2095850348,2095850860,512
1361674499,2095878112,7,4014,573.4285714,1361674471108,1361674484292,2095850220,2095863404,13184
1361674499,2095878112,5,2539,507.8,1361674471172,1361674472580,2095850284,2095851692,1408
1361674499,2095878112,15,14973,998.2,1361674471171,1361674472579,2095850283,2095851691,1408
1361674499,2095878112,5,818,163.6,1361674471171,1361674472643,2095850283,2095851755,1472
1361674499,2095878112,9,4412,490.2222222,1361674471298,1361674471938,2095850410,2095851050,640
1361674499,2095878120,41,52901,1290.268293,1361674471994,1361674474618,2095851114,2095853738,2624
1361674500,2095879108,249,245205,984.7590361,1361674466311,1361674498439,2095845419,2095877547,32128
1361674511,2095890084,12,11303,941.9166667,1361674484573,1361674485853,2095863657,2095864937,1280
1361674511,2095890196,8,3148,393.5,1361674484462,1361674485806,2095863658,2095865002,1344
1361674532,2095911144,817,46186,56.53121175,1361674521376,1361674531744,2095900520,2095910888,10368
1361674543,2095922076,10,2072,207.2,1361674515686,1361674540518,2095894762,2095919594,24832
1361674563,2095942120,5,1651,330.2,1361674536184,1361674538296,2095915304,2095917416,2112
1361674570,734263828,1,46,46,1361674545147,1361674545147,734238975,734238975,0
1361674571,2095950168,27,32144,1190.518519,1361674546121,1361674546313,2095925289,2095925481,192
1361674571,2095950172,67,84082,1254.955224,1361674546115,1361674546627,2095925287,2095925799,512
1361674571,2095950248,20,12910,645.5,1361674545786,1361674546042,2095925034,2095925290,256
1361674575,2095954108,1,638,638,1361674548036,1361674548036,2095927144,2095927144,0
1361674587,2095966236,7,3257,465.2857143,1361674559814,1361674560134,2095939050,2095939370,320
1361674595,2095974260,1,104,104,1361674570092,1361674570092,2095949352,2095949352,0
1361674596,2095975124,3,144,48,1361674588085,1361674588085,2095967209,2095967209,0
1361674603,2095982192,1,52,52,1361674577010,1361674577010,2095956202,2095956202,0
1361674603,2095982192,1,52,52,1361674577008,1361674577008,2095956200,2095956200,0
1361674603,2095982272,1,52,52,1361674576929,1361674576929,2095956201,2095956201,0
1361674603,2095982276,1,52,52,1361674576926,1361674576926,2095956202,2095956202,0
1361674603,2095982276,1,52,52,1361674576926,1361674576926,2095956202,2095956202,0
1361674607,2095986268,2,92,46,1361674580902,1361674580902,2095960170,2095960170,0
1361674615,2095994160,2,92,46,1361674587026,1361674587026,2095966186,2095966186,0
1361674615,2095994160,2,104,52,1361674588048,1361674588048,2095967208,2095967208,0
1361674615,2095994160,1,52,52,1361674588048,1361674588048,2095967208,2095967208,0
1361674615,2095994160,1,52,52,1361674588048,1361674588048,2095967208,2095967208,0
1361674615,2095994236,1,52,52,1361674587971,1361674587971,2095967207,2095967207,0
1361674615,2095994236,1,52,52,1361674587971,1361674587971,2095967207,2095967207,0
1361674615,2095994236,1,52,52,1361674587971,1361674587971,2095967207,2095967207,0
1361674615,2095994236,1,46,46,1361674587971,1361674587971,2095967207,2095967207,0
1361674623,2096002228,5,807,161.4,1361674597709,1361674603725,2095976937,2095982953,6016
1361674627,2096006196,2,104,52,1361674599018,1361674599018,2095978214,2095978214,0
1361674627,2096006236,1,52,52,1361674600901,1361674600901,2095980137,2095980137,0
1361674627,2096006312,2,104,52,1361674600824,1361674600824,2095980136,2095980136,0
1361674659,2096038244,1,104,104,1361674632251,1361674632251,2096011495,2096011495,0
1361674660,2096039224,4,220,55,1361674652944,1361674652944,2096032168,2096032168,0
1361674667,2096046264,1,76,76,1361674641128,1361674641128,2096020392,2096020392,0
1361674668,2096047152,218,298377,1368.701835,1361674471125,1361674662997,2095850277,2096042149,191872
1361674676,2096055148,4,220,55,1361674675035,1361674675099,2096054183,2096054247,64
1361674687,2096066276,5,829,165.8,1361674660188,1361674667676,2096039464,2096046952,7488
1361674687,2096066312,1,52,52,1361674660856,1361674660856,2096040168,2096040168,0
1361674687,2096066400,2,104,52,1361674660768,1361674660768,2096040168,2096040168,0
1361674687,2096066412,2,104,52,1361674661717,1361674661717,2096041129,2096041129,0
1361674687,2096066436,2,104,52,1361674662713,1361674662713,2096042149,2096042149,0
1361674700,2096079216,6,406,67.66666667,1361674692695,1361674692759,2096071911,2096071975,64
1361674731,2096110412,28,13780,492.1428571,1361674705492,1361674719124,2096084904,2096098536,13632
1361674739,2096118308,9,2472,274.6666667,1361674711740,1361674714684,2096091048,2096093992,2944
1361674739,2096118312,6,990,165,1361674712502,1361674713270,2096091814,2096092582,768
1361674739,2096118312,4,783,195.75,1361674712502,1361674712950,2096091814,2096092262,448
1361674739,2096118312,6,1089,181.5,1361674712502,1361674712950,2096091814,2096092262,448
1361674739,2096118312,11,3214,292.1818182,1361674712565,1361674714677,2096091877,2096093989,2112
1361674739,2096118396,4,860,215,1361674712418,1361674712866,2096091814,2096092262,448
1361674739,2096118396,4,908,227,1361674712418,1361674712866,2096091814,2096092262,448
1361674739,2096118396,16,16100,1006.25,1361674712418,1361674723682,2096091814,2096103078,11264
1361674743,2096122324,9,4227,469.6666667,1361674715563,1361674715819,2096094887,2096095143,256
1361674767,2096146448,1,525,525,1361674742382,1361674742382,2096121830,2096121830,0
1361674804,2096183312,379,415102,1095.255937,1361674470964,1361674803572,2095850276,2096182884,332608
1361674811,2096190672,5,731,146.2,1361674786700,1361674786892,2096166372,2096166564,192
1361674813,734506552,12,8674,722.8333333,1361674808338,1361674808466,734501890,734502018,128
1361674813,734506556,11,5224,474.9090909,1361674808206,1361674808270,734501762,734501826,64
1361674813,734506556,7,1710,244.2857143,1361674808269,1361674808333,734501825,734501889,64
1361674831,2096210648,31,28601,922.6129032,1361674804132,1361674804708,2096183780,2096184356,576
1361674831,2096210676,1,1258,1258,1361674804808,1361674804808,2096184484,2096184484,0
1361674831,2096210680,8,9339,1167.375,1361674804806,1361674806086,2096184486,2096185766,1280
1361674831,2096210680,2,1924,962,1361674804806,1361674804806,2096184486,2096184486,0
1361674831,2096210688,5,961,192.2,1361674805758,1361674806142,2096185446,2096185830,384
1361674831,2096210756,6,3708,618,1361674804728,1361674805944,2096184484,2096185700,1216
1361674831,2096210756,4,895,223.75,1361674804792,1361674806008,2096184548,2096185764,1216
1361674831,2096210760,1,1194,1194,1361674804726,1361674804726,2096184486,2096184486,0
1361674831,2096210768,8,4870,608.75,1361674805614,1361674806062,2096185382,2096185830,448
1361674836,2096215316,4,220,55,1361674828531,1361674828595,2096207847,2096207911,64
1361674836,2096215324,4,220,55,1361674830504,1361674830568,2096209828,2096209892,64
1361674855,2096234648,2,104,52,1361674827238,1361674827238,2096206886,2096206886,0
1361674855,2096234756,2,104,52,1361674829112,1361674829112,2096208868,2096208868,0
1361674908,2096287436,4,220,55,1361674902392,1361674902392,2096281828,2096281828,0
1361674924,2096303348,222,189193,852.2207207,1361674739471,1361674921487,2096118819,2096300835,182016
1361674947,2096326768,1,52,52,1361674920042,1361674920042,2096299810,2096299810,0
1361674947,2096326768,1,52,52,1361674920042,1361674920042,2096299810,2096299810,0
1361674947,2096326804,1,52,52,1361674921030,1361674921030,2096300834,2096300834,0
1361674947,2096326804,1,52,52,1361674921030,1361674921030,2096300834,2096300834,0
1361674947,2096326840,2,92,46,1361674919013,1361674919013,2096298853,2096298853,0
1361674947,2096326876,2,104,52,1361674919936,1361674919936,2096299812,2096299812,0
1361674947,2096326884,1,52,52,1361674920950,1361674920950,2096300834,2096300834,0
1361674947,2096326884,1,52,52,1361674920950,1361674920950,2096300834,2096300834,0
1361674947,2096326888,1,52,52,1361674920946,1361674920946,2096300834,2096300834,0
1361675176,2096555724,1,76,76,1361675151699,1361675151699,2096531423,2096531423,0
1361675229,734922700,12,7938,661.5,1361675221185,1361675221441,734914885,734915141,256
1361675229,734922700,13,5887,452.8461538,1361675220160,1361675220992,734913860,734914692,832
1361675229,734922700,7,1604,229.1428571,1361675221440,1361675222272,734915140,734915972,832
1361675229,734922700,7,1604,229.1428571,1361675221440,1361675222272,734915140,734915972,832
1361675229,734922700,7,1604,229.1428571,1361675222271,1361675222463,734915971,734916163,192
1361675229,734922700,10,2926,292.6,1361675222463,1361675222975,734916163,734916675,512
1361675229,734922700,10,2634,263.4,1361675222463,1361675222911,734916163,734916611,448
1361675229,734922700,10,1834,183.4,1361675225599,1361675227455,734919299,734921155,1856
1361675229,734922704,7,1438,205.4285714,1361675220990,1361675221054,734914694,734914758,64
1361675229,734922704,11,7150,650,1361675221054,1361675221118,734914758,734914822,64
1361675229,734922704,15,12019,801.2666667,1361675221181,1361675221373,734914885,734915077,192
1361675229,734922704,8,1490,186.25,1361675222459,1361675222587,734916163,734916291,128
1361675229,734922704,15,11651,776.7333333,1361675222459,1361675225531,734916163,734919235,3072
1361675229,734922704,8,2312,289,1361675222267,1361675222459,734915971,734916163,192
1361675229,734922704,7,1604,229.1428571,1361675222267,1361675222459,734915971,734916163,192
1361675229,734922704,9,1814,201.5555556,1361675222462,1361675223166,734916166,734916870,704
1361675229,734922704,9,2550,283.3333333,1361675222462,1361675222718,734916166,734916422,256
1361675229,734922704,9,1350,150,1361675225598,1361675225854,734919302,734919558,256
1361675245,2096623904,29,34095,1175.689655,1361675224264,1361675239496,2096603168,2096618400,15232
1361675325,735018704,8,2232,279,1361675323007,1361675323007,735016711,735016711,0
1361675325,735018704,7,1188,169.7142857,1361675323518,1361675323710,735017222,735017414,192
1361675325,735018704,8,1346,168.25,1361675323710,1361675323838,735017414,735017542,128
1361675325,735018704,9,1350,150,1361675323838,1361675323902,735017542,735017606,64
1361675325,735018704,7,1524,217.7142857,1361675323837,1361675323901,735017541,735017605,64
1361675325,735018704,7,1524,217.7142857,1361675323837,1361675323901,735017541,735017605,64
1361675325,735018704,8,1618,202.25,1361675323965,1361675324157,735017669,735017861,192
1361675325,735018704,8,1458,182.25,1361675324029,1361675324093,735017733,735017797,64
1361675325,735018704,9,1350,150,1361675324285,1361675324477,735017989,735018181,192
1361675325,735018708,11,7886,716.9090909,1361675322617,1361675322809,735016325,735016517,192
1361675325,735018708,16,14503,906.4375,1361675323193,1361675323449,735016901,735017157,256
1361675325,735018708,7,1502,214.5714286,1361675323129,1361675323193,735016837,735016901,64
1361675325,735018708,7,1524,217.7142857,1361675323832,1361675323896,735017540,735017604,64
1361675325,735018708,7,1524,217.7142857,1361675323832,1361675323896,735017540,735017604,64
1361675325,735018708,9,1494,166,1361675324023,1361675324087,735017731,735017795,64
1361675325,735018708,15,9182,612.1333333,1361675324023,1361675324215,735017731,735017923,192
1361675325,735018708,9,1782,198,1361675324279,1361675324471,735017987,735018179,192
1361675325,735018712,11,7086,644.1818182,1361675322228,1361675322420,735015940,735016132,192
1361675325,735018712,9,1606,178.4444444,1361675322740,1361675323124,735016452,735016836,384
1361675325,735018712,9,1590,176.6666667,1361675322612,1361675322740,735016324,735016452,128
1361675333,735026700,9,1350,150,1361675329599,1361675329791,735023299,735023491,192
1361675333,735026700,9,1350,150,1361675330435,1361675330691,735024135,735024391,256
1361675333,735026704,9,1350,150,1361675332285,1361675332477,735025989,735026181,192
1361675333,735026704,9,1350,150,1361675328828,1361675329084,735022532,735022788,256
1361675341,735034716,9,1350,150,1361675334962,1361675335090,735028678,735028806,128
1361675341,735034716,7,1188,169.7142857,1361675334898,1361675335026,735028614,735028742,128
1361675341,735034720,14,10943,781.6428571,1361675334062,1361675334638,735027782,735028358,576
1361675373,2096752072,91,77380,850.3296703,1361675356638,1361675365854,2096735710,2096744926,9216
1361675377,2096756192,3,540,180,1361675350630,1361675350694,2096729822,2096729886,64
1361675377,2096756196,3,540,180,1361675350623,1361675350687,2096729819,2096729883,64
1361675377,2096756196,3,540,180,1361675350627,1361675350691,2096729823,2096729887,64
1361675377,2096756272,3,540,180,1361675350612,1361675350612,2096729884,2096729884,0
1361675377,2096756272,3,540,180,1361675350547,1361675350611,2096729819,2096729883,64
1361675381,2096760276,14,8488,606.2857143,1361675354127,1361675359695,2096733403,2096738971,5568
1361675381,2096760316,10,4618,461.8,1361675356074,1361675356394,2096735390,2096735710,320
1361675385,2096764196,4,882,220.5,1361675359776,1361675361440,2096738972,2096740636,1664
1361675385,2096764196,4,534,133.5,1361675359840,1361675361696,2096739036,2096740892,1856
1361675385,2096764280,5,1503,300.6,1361675359629,1361675363021,2096738909,2096742301,3392
1361675385,2096764280,6,3354,559,1361675359756,1361675361676,2096739036,2096740956,1920
1361675385,2096764288,37,10466,282.8648649,1361675360644,1361675377540,2096739932,2096756828,16896
1361675389,2096768276,29,16044,553.2413793,1361675362706,1361675365202,2096741982,2096744478,2496
1361675389,2096768280,4,594,148.5,1361675363340,1361675363404,2096742620,2096742684,64
1361675389,2096768288,19,7404,389.6842105,1361675364294,1361675365318,2096743582,2096744606,1024
1361675389,2096768360,5,845,169,1361675363259,1361675363323,2096742619,2096742683,64
1361675389,2096768376,10,2616,261.6,1361675364267,1361675368299,2096743643,2096747675,4032
1361675405,2096784252,7,2768,395.4285714,1361675377897,1361675378857,2096757149,2096758109,960
1361675421,2096800352,2,208,104,1361675392837,1361675416965,2096772189,2096796317,24128
1361675421,735114736,14,10655,761.0714286,1361675420062,1361675420382,735113798,735114118,320
1361675421,735114736,7,1188,169.7142857,1361675420509,1361675420637,735114245,735114373,128
1361675421,735114740,8,2680,335,1361675414491,1361675414747,735108231,735108487,256
1361675421,735114740,9,1350,150,1361675414683,1361675414747,735108423,735108487,64
1361675421,735114740,9,1350,150,1361675420568,1361675420696,735114308,735114436,128
1361675421,735114744,14,10671,762.2142857,1361675413847,1361675414423,735107591,735108167,576
1361675421,735114744,7,1188,169.7142857,1361675414486,1361675414678,735108230,735108422,192
1361675437,735130740,7,1358,194,1361675435099,1361675435291,735128839,735129031,192
1361675437,735130740,7,1390,198.5714286,1361675435099,1361675435291,735128839,735129031,192
1361675437,735130740,7,1444,206.2857143,1361675435099,1361675435291,735128839,735129031,192
1361675437,735130740,7,1188,169.7142857,1361675435291,1361675435483,735129031,735129223,192
1361675437,735130740,9,1350,150,1361675435419,1361675435483,735129159,735129223,64
1361675437,735130740,7,1524,217.7142857,1361675435418,1361675435482,735129158,735129222,64
1361675437,735130740,7,1524,217.7142857,1361675435418,1361675435482,735129158,735129222,64
1361675437,735130744,16,13575,848.4375,1361675434838,1361675435094,735128582,735128838,256
1361675437,735130744,7,1374,196.2857143,1361675435093,1361675435285,735128837,735129029,192
1361675437,735130744,8,2952,369,1361675435093,1361675435285,735128837,735129029,192
1361675437,735130744,7,1524,217.7142857,1361675435412,1361675435476,735129156,735129220,64
1361675437,735130744,7,1524,217.7142857,1361675435412,1361675435476,735129156,735129220,64
1361675437,735130752,7,1550,221.4285714,1361675434767,1361675434831,735128519,735128583,64
1361675443,735136656,14,10943,781.6428571,1361675437100,1361675437548,735130756,735131204,448
1361675445,735138728,7,1188,169.7142857,1361675437669,1361675437797,735131397,735131525,128
1361675445,735138728,9,1350,150,1361675437733,1361675437861,735131461,735131589,128
1361675449,2096828452,5,731,146.2,1361675422112,1361675422304,2096801564,2096801756,192
1361675469,2096848552,3,285,95,1361675441212,1361675467388,2096820764,2096846940,26176
1361675469,735162732,14,10943,781.6428571,1361675465569,1361675466209,735159301,735159941,640
1361675469,735162752,9,1350,150,1361675466447,1361675466639,735160199,735160391,192
1361675469,735162752,7,1188,169.7142857,1361675466191,1361675466447,735159943,735160199,256
1361675483,735176904,8,2232,279,1361675482870,1361675482934,735176774,735176838,64
1361675483,735176904,10,2634,263.4,1361675482934,1361675483254,735176838,735177158,320
1361675483,735176904,9,1766,196.2222222,1361675482934,1361675483254,735176838,735177158,320
1361675485,735178736,11,7886,716.9090909,1361675481056,1361675481184,735174792,735174920,128
1361675485,735178736,9,6950,772.2222222,1361675482142,1361675482206,735175878,735175942,64
1361675485,735178736,15,12019,801.2666667,1361675482333,1361675482461,735176069,735176197,128
1361675485,735178740,7,1524,217.7142857,1361675482460,1361675483036,735176200,735176776,576
1361675485,735178740,7,1524,217.7142857,1361675483035,1361675483099,735176775,735176839,64
1361675485,735178740,9,1814,201.5555556,1361675483099,1361675483867,735176839,735177607,768
1361675485,735178740,10,2602,260.2,1361675483099,1361675483419,735176839,735177159,320
1361675485,735178740,9,1542,171.3333333,1361675483099,1361675483291,735176839,735177031,192
1361675485,735178740,9,6966,774,1361675480793,1361675480857,735174533,735174597,64
1361675485,735178740,9,1510,167.7777778,1361675481049,1361675481177,735174789,735174917,128
1361675485,735178740,8,2232,279,1361675481436,1361675481436,735175176,735175176,0
1361675485,735178744,11,7886,716.9090909,1361675482326,1361675482454,735176070,735176198,128
1361675485,735178744,7,1524,217.7142857,1361675483029,1361675483093,735176773,735176837,64
1361675485,735178744,7,1524,217.7142857,1361675482453,1361675483093,735176197,735176837,640
1361675493,2096872504,1,52,52,1361675465321,1361675465321,2096844825,2096844825,0
1361675493,2096872504,1,52,52,1361675465321,1361675465321,2096844825,2096844825,0
1361675493,2096872580,1,52,52,1361675465246,1361675465246,2096844826,2096844826,0
1361675493,2096872580,1,52,52,1361675465246,1361675465246,2096844826,2096844826,0
1361675493,2096872580,1,52,52,1361675465246,1361675465246,2096844826,2096844826,0
1361675492,735184908,8,2232,279,1361675491929,1361675491993,735184837,735184901,64
1361675493,735186728,16,14471,904.4375,1361675491173,1361675491429,735184901,735185157,256
1361675493,735186732,8,1346,168.25,1361675491620,1361675491812,735185352,735185544,192
1361675493,735186732,8,1442,180.25,1361675491875,1361675492003,735185607,735185735,128
1361675493,735186732,14,8442,603,1361675491875,1361675492067,735185607,735185799,192
1361675493,735186732,7,1524,217.7142857,1361675491747,1361675491811,735185479,735185543,64
1361675493,735186732,7,1524,217.7142857,1361675491747,1361675491811,735185479,735185543,64
1361675493,735186732,9,1350,150,1361675492195,1361675492451,735185927,735186183,256
1361675493,735186732,11,7086,644.1818182,1361675490529,1361675490593,735184261,735184325,64
1361675493,735186736,12,7938,661.5,1361675490784,1361675490976,735184520,735184712,192
1361675493,735186736,15,11683,778.8666667,1361675483103,1361675485855,735176839,735179591,2752
1361675493,735186736,7,1502,214.5714286,1361675491103,1361675491167,735184839,735184903,64
1361675493,735186736,7,1188,169.7142857,1361675491423,1361675491615,735185159,735185351,192
1361675493,735186736,9,1350,150,1361675491742,1361675491870,735185478,735185606,128
1361675493,735186736,7,1524,217.7142857,1361675491742,1361675491806,735185478,735185542,64
1361675493,735186736,7,1524,217.7142857,1361675491742,1361675491806,735185478,735185542,64
1361675493,735186736,8,1506,188.25,1361675491870,1361675492062,735185606,735185798,192
1361675493,735186736,9,1510,167.7777778,1361675491870,1361675492062,735185606,735185798,192
1361675493,735186736,8,1730,216.25,1361675492189,1361675492445,735185925,735186181,256
1361675493,735186740,8,1730,216.25,1361675485916,1361675487644,735179656,735181384,1728
1361675493,735186740,9,1350,150,1361675485916,1361675486172,735179656,735179912,256
1361675493,735186740,7,1486,212.2857143,1361675490779,1361675490843,735184519,735184583,64
1361675493,735186740,8,1554,194.25,1361675490843,1361675491099,735184583,735184839,256
1361675497,2096876548,2,92,46,1361675471294,1361675471294,2096850842,2096850842,0
1361675501,2096880096,27,30974,1147.185185,1361675484228,1361675499652,2096863324,2096878748,15424
1361675501,2096880104,4,220,55,1361675493947,1361675494203,2096873051,2096873307,256
1361675501,2096880644,1,52,52,1361675476193,1361675476193,2096855837,2096855837,0
1361675501,2096880644,2,92,46,1361675476192,1361675476192,2096855836,2096855836,0
1361675501,2096880644,1,46,46,1361675476192,1361675476192,2096855836,2096855836,0
1361675501,2096880644,1,46,46,1361675476192,1361675476192,2096855836,2096855836,0
1361675501,735194748,9,1350,150,1361675493715,1361675493907,735187463,735187655,192
1361675505,2096884500,2,104,52,1361675478317,1361675478317,2096857817,2096857817,0
1361675505,2096884500,1,52,52,1361675478317,1361675478317,2096857817,2096857817,0
1361675505,2096884528,8,2653,331.625,1361675479124,1361675482196,2096858652,2096861724,3072
1361675505,2096884536,2,104,52,1361675480266,1361675480266,2096859802,2096859802,0
1361675505,2096884572,2,104,52,1361675478245,1361675478245,2096857817,2096857817,0
1361675509,2096888612,3,540,180,1361675481917,1361675481917,2096861529,2096861529,0
1361675509,2096888616,3,540,180,1361675481917,1361675481917,2096861533,2096861533,0
1361675509,2096888692,3,540,180,1361675481838,1361675481838,2096861530,2096861530,0
1361675509,2096888692,3,540,180,1361675481838,1361675481838,2096861530,2096861530,0
1361675509,2096888696,3,540,180,1361675481833,1361675481833,2096861529,2096861529,0
1361675509,735202744,11,7886,716.9090909,1361675504214,1361675504406,735197958,735198150,192
1361675509,735202744,16,12071,754.4375,1361675504214,1361675505302,735197958,735199046,1088
1361675509,735202744,7,1524,217.7142857,1361675504661,1361675505173,735198405,735198917,512
1361675509,735202744,7,1524,217.7142857,1361675505112,1361675505240,735198856,735198984,128
1361675509,735202744,10,1402,140.2,1361675507032,1361675507288,735200776,735201032,256
1361675509,735202748,9,1542,171.3333333,1361675505236,1361675505364,735198984,735199112,128
1361675509,735202748,15,11683,778.8666667,1361675505236,1361675507028,735198984,735200776,1792
1361675509,735202748,9,1814,201.5555556,1361675505236,1361675505684,735198984,735199432,448
1361675509,735202748,10,2602,260.2,1361675505236,1361675505492,735198984,735199240,256
1361675509,735202752,9,6950,772.2222222,1361675504016,1361675504080,735197768,735197832,64
1361675509,735202752,8,1576,197,1361675504655,1361675506191,735198407,735199943,1536
1361675509,735202752,7,1524,217.7142857,1361675505102,1361675505230,735198854,735198982,128
1361675509,735202752,8,2232,279,1361675505102,1361675505230,735198854,735198982,128
1361675509,735202752,9,2582,286.8888889,1361675505230,1361675505486,735198982,735199238,256
1361675509,735202752,7,1662,237.4285714,1361675505229,1361675506381,735198981,735200133,1152
1361675509,2096888720,2,104,52,1361675483090,1361675483090,2096862810,2096862810,0
1361675509,735202756,8,1730,216.25,1361675507019,1361675508811,735200775,735202567,1792
1361675517,2096896600,1,104,104,1361675492683,1361675492683,2096872283,2096872283,0
1361675517,735210736,9,1350,150,1361675511328,1361675511584,735205064,735205320,256
1361675517,735210736,8,1730,216.25,1361675511328,1361675511584,735205064,735205320,256
1361675517,735210736,9,1606,178.4444444,1361675509597,1361675510045,735203333,735203781,448
1361675517,735210736,8,1538,192.25,1361675509533,1361675509597,735203269,735203333,64
1361675517,735210740,8,2232,279,1361675509915,1361675509979,735203655,735203719,64
1361675517,735210740,7,1188,169.7142857,1361675510619,1361675511003,735204359,735204743,384
1361675517,735210740,8,1442,180.25,1361675511002,1361675511130,735204742,735204870,128
1361675517,735210740,13,8486,652.7692308,1361675511002,1361675511194,735204742,735204934,192
1361675517,735210740,8,1346,168.25,1361675510554,1361675510938,735204294,735204678,384
1361675517,735210740,9,1350,150,1361675510682,1361675511002,735204422,735204742,320
1361675517,735210740,7,1524,217.7142857,1361675510746,1361675511002,735204486,735204742,256
1361675517,735210740,7,1524,217.7142857,1361675510746,1361675510938,735204486,735204678,192
1361675517,735210740,9,1350,150,1361675514458,1361675514650,735208198,735208390,192
1361675517,735210740,2,92,46,1361675509081,1361675509081,735202821,735202821,0
1361675517,735210744,10,7034,703.4,1361675509208,1361675509272,735202952,735203016,64
1361675517,735210744,12,7938,661.5,1361675509526,1361675509718,735203270,735203462,192
1361675517,735210744,9,1350,150,1361675513109,1361675513301,735206853,735207045,192
1361675517,735210748,7,1502,214.5714286,1361675510036,1361675510100,735203784,735203848,64
1361675517,735210748,15,14403,960.2,1361675510100,1361675510356,735203848,735204104,256
1361675517,735210748,7,1524,217.7142857,1361675510740,1361675510996,735204488,735204744,256
1361675517,735210748,7,1524,217.7142857,1361675510931,1361675510995,735204679,735204743,64
1361675517,735210748,9,1638,182,1361675510995,1361675511123,735204743,735204871,128
1361675517,735210748,9,1510,167.7777778,1361675510995,1361675511123,735204743,735204871,128
1361675525,735218744,14,11967,854.7857143,1361675519767,1361675519895,735213511,735213639,128
1361675525,735218744,7,1524,217.7142857,1361675520022,1361675520598,735213766,735214342,576
1361675525,735218744,11,5949,540.8181818,1361675520278,1361675520662,735214022,735214406,384
1361675525,735218744,8,1762,220.25,1361675520726,1361675521238,735214470,735214982,512
1361675525,735218744,9,2550,283.3333333,1361675520726,1361675520918,735214470,735214662,192
1361675525,735218744,8,1698,212.25,1361675520726,1361675520918,735214470,735214662,192
1361675525,735218748,9,1350,150,1361675522642,1361675522898,735216390,735216646,256
1361675525,735218748,11,7054,641.2727273,1361675519569,1361675519633,735213317,735213381,64
1361675525,735218748,11,7886,716.9090909,1361675519761,1361675519953,735213509,735213701,192
1361675525,735218748,7,1524,217.7142857,1361675520017,1361675520657,735213765,735214405,640
1361675525,735218752,11,5949,540.8181818,1361675520272,1361675520720,735214024,735214472,448
1361675525,735218752,12,6657,554.75,1361675520592,1361675520656,735214344,735214408,64
1361675525,735218752,9,2582,286.8888889,1361675520720,1361675520976,735214472,735214728,256
1361675525,735218752,9,1542,171.3333333,1361675520720,1361675520848,735214472,735214600,128
1361675525,735218752,15,11683,778.8666667,1361675520720,1361675522640,735214472,735216392,1920
1361675525,735218752,8,1730,216.25,1361675522637,1361675524301,735216389,735218053,1664
1361675541,2096920100,13,11291,868.5384615,1361675521790,1361675538174,2096900890,2096917274,16384
1361675545,2096924568,2,181,90.5,1361675519849,1361675519849,2096899417,2096899417,0
1361675569,2096948680,4,654,163.5,1361675542843,1361675543355,2096922523,2096923035,512
1361675577,2096956580,3,285,95,1361675549854,1361675576798,2096929434,2096956378,26944
1361675613,2096992176,6,406,67.66666667,1361675606771,1361675606835,2096985947,2096986011,64
1361675621,2097000892,1,52,52,1361675596389,1361675596389,2096976281,2096976281,0
1361675621,2097000892,1,52,52,1361675596388,1361675596388,2096976280,2096976280,0
1361675622,2097000976,1,52,52,1361675597306,1361675597306,2096976282,2096976282,0
1361675622,2097000976,1,52,52,1361675597306,1361675597306,2096976282,2096976282,0
1361675622,2097000980,1,52,52,1361675597302,1361675597302,2096976282,2096976282,0
1361675630,2097009020,7,1187,169.5714286,1361675603468,1361675607436,2096982488,2096986456,3968
1361675662,2097040940,2,208,104,1361675634140,1361675660124,2097013080,2097039064,25984
1361675678,2097057076,4,1242,310.5,1361675651925,1361675651989,2097031001,2097031065,64
1361675678,2097057076,16,16489,1030.5625,1361675651987,1361675652691,2097031063,2097031767,704
1361675690,2097069000,7,951,135.8571429,1361675663457,1361675663777,2097042457,2097042777,320
1361675690,2097069148,1,76,76,1361675665229,1361675665229,2097044377,2097044377,0
1361675714,2097093028,2,181,90.5,1361675687746,1361675687746,2097066774,2097066774,0
1361675742,2097121308,4,337,84.25,1361675717292,1361675717420,2097096600,2097096728,128
1361675749,735442808,8,1698,212.25,1361675746074,1361675746138,735439882,735439946,64
1361675749,735442808,11,8622,783.8181818,1361675746137,1361675748313,735439945,735442121,2176
1361675749,735442812,7,799,114.1428571,1361675746004,1361675746068,735439816,735439880,64
1361675750,2097129316,9,1417,157.4444444,1361675723105,1361675748961,2097102421,2097128277,25856
1361675757,2097136260,10,2458,245.8,1361675751453,1361675752285,2097130713,2097131545,832
1361675757,2097136260,9,1074,119.3333333,1361675751452,1361675752156,2097130712,2097131416,704
1361675774,2097153608,7,609,87,1361675746816,1361675773888,2097126424,2097153496,27072
1361675778,2097157660,8,4872,609,1361675752332,1361675752460,2097131992,2097132120,128
1361675778,2097157660,5,805,161,1361675752651,1361675752907,2097132311,2097132567,256
1361675778,2097157732,31,28607,922.8064516,1361675751683,1361675752067,2097131415,2097131799,384
1361675778,2097157740,6,3011,501.8333333,1361675752315,1361675752379,2097132055,2097132119,64
1361675802,2097181696,5,520,104,1361675774950,1361675801254,2097154646,2097180950,26304
1361675821,2097200232,2,238,119,1361675811702,1361675819062,2097190934,2097198294,7360
1361675893,2097272312,3,156,52,1361675891750,1361675892390,2097271062,2097271702,640
1361675893,2097272336,2,104,52,1361675892430,1361675892686,2097271766,2097272022,256
1361675901,2097280264,3,156,52,1361675893206,1361675895830,2097272470,2097275094,2624
1361675901,2097280312,2,104,52,1361675893351,1361675895143,2097272663,2097274455,1792
1361675997,2097376364,5,260,52,1361675992816,1361675996208,2097372180,2097375572,3392
1361675997,2097376384,5,260,52,1361675993179,1361675996443,2097372563,2097375827,3264
1361675997,2097376424,5,230,46,1361675992371,1361675995955,2097371795,2097375379,3584
1361675997,2097376428,5,260,52,1361675992689,1361675996017,2097372117,2097375445,3328
1361676013,2097392356,2,92,46,1361675999799,1361676007351,2097379155,2097386707,7552
1361676029,2097408408,2,92,46,1361676017347,1361676027331,2097396755,2097406739,9984
1361676043,2097422348,1,48,48,1361676016064,1361676016064,2097395412,2097395412,0
1361677013,2098392504,1,60,60,1361676987477,1361676987477,2098366981,2098366981,0
1361677218,2098597280,2,120,60,1361677190515,1361677191475,2098569795,2098570755,960
1361680280,2101659440,1,60,60,1361680254819,1361680254819,2101634259,2101634259,0
1361680284,2101663352,1,60,60,1361680256892,1361680256892,2101636244,2101636244,0
1361682761,2104140432,1,46,46,1361682735301,1361682735301,2104114733,2104114733,0
1361683823,2105202124,1,46,46,1361683795307,1361683795307,2105174431,2105174431,0
1361685993,2107372596,1,46,46,1361685968367,1361685968367,2107347963,2107347963,0
1361686478,2107857584,1,46,46,1361686449972,1361686449972,2107829556,2107829556,0
1361689153,2110531984,1,58,58,1361689125989,1361689125989,2110504973,2110504973,0
1361692986,2114365040,1,60,60,1361692960756,1361692960756,2114339796,2114339796,0
1361693743,2115122296,1,46,46,1361693716006,1361693716006,2115095302,2115095302,0
1361694778,2116157132,1,46,46,1361694750396,1361694750396,2116129528,2116129528,0
1361695724,2117102912,1,46,46,1361695698570,1361695698570,2117077482,2117077482,0
1361696526,2117905532,1,48,48,1361696498129,1361696498129,2117877661,2117877661,0
1361698417,2119796156,1,46,46,1361698389613,1361698389613,2119768769,2119768769,0
1361699095,2120474176,1,46,46,1361699066513,1361699066513,2120445689,2120445689,0
1361699526,2120905696,1,445,445,1361699498050,1361699498050,2120877746,2120877746,0
1361700079,2121458808,1,46,46,1361700053450,1361700053450,2121433258,2121433258,0
1361700360,2121739640,1,46,46,1361700333229,1361700333229,2121712869,2121712869,0
1361700384,2121763672,1,48,48,1361700357708,1361700357708,2121737380,2121737380,0
1361700500,2121879800,5,320,64,1361700474889,1361700477321,2121854689,2121857121,2432
1361702642,2124020900,1,60,60,1361702617070,1361702617070,2123995970,2123995970,0
1361702870,2124249396,1,46,46,1361702844539,1361702844539,2124223935,2124223935,0
1361702870,2124249412,1,46,46,1361702844204,1361702844204,2124223616,2124223616,0
1361703678,2125057448,1,46,46,1361703649978,1361703649978,2125029426,2125029426,0
1361709599,2130978168,2,122,61,1361709571576,1361709573752,2130950744,2130952920,2176
1361710914,2132293228,1,46,46,1361710887786,1361710887786,2132267014,2132267014,0
1361711475,2132854544,1,60,60,1361711447780,1361711447780,2132827324,2132827324,0
1361714490,2135869036,1,48,48,1361714462196,1361714462196,2135841232,2135841232,0
1361714609,2135988188,1,46,46,1361714582170,1361714582170,2135961358,2135961358,0
1361716069,2137448372,1,60,60,1361716044172,1361716044172,2137423544,2137423544,0
1361717917,2139296680,1,46,46,1361717890557,1361717890557,2139270237,2139270237,0
1361721673,2143051804,1,60,60,1361721645231,1361721645231,2143024035,2143024035,0
1361721797,2143176148,1,60,60,1361721769365,1361721769365,2143148513,2143148513,0
1361721809,2143188160,1,60,60,1361721781899,1361721781899,2143161059,2143161059,0
1361721849,2143228200,1,60,60,1361721822433,1361721822433,2143201633,2143201633,0
1361721885,2143264360,1,60,60,1361721858882,1361721858882,2143238242,2143238242,0
1361722057,2143436432,1,60,60,1361722031221,1361722031221,2143410653,2143410653,0
1361722116,2143494908,1,46,46,1361722086849,1361722086849,2143465757,2143465757,0
1361725211,2146589820,2,122,61,1361725184616,1361725184872,2146563436,2146563692,256
1361725459,2146837984,1,46,46,1361725432900,1361725432900,2146811884,2146811884,0
1361727558,2148937088,1,48,48,1361727531643,1361727531643,2148910731,2148910731,0
1361884769,2305555520,1,46,46,1361884743700,1361884743700,2305530220,2305530220,0
1361886101,2307479600,1,46,46,1361886073937,1361886073937,2307452537,2307452537,0
1361886289,2307667788,2,122,61,1361886262548,1361886264660,2307641336,2307643448,2112
1361886690,2308068796,1,56,56,1361886665669,1361886665669,2308044465,2308044465,0
1361887363,2308741844,1,46,46,1361887336585,1361887336585,2308715429,2308715429,0
1361887528,2308906296,4,2749,687.25,1361887527021,1361887527085,2308905317,2308905381,64
1361887528,2308906296,1,52,52,1361887527469,1361887527469,2308905765,2308905765,0
1361887532,2308910780,12,1086,90.5,1361887527496,1361887527816,2308906276,2308906596,320
1361887532,2308910784,12,1234,102.8333333,1361887527814,1361887528134,2308906598,2308906918,320
1361887532,2308910788,13,1372,105.5384615,1361887528258,1361887528642,2308907046,2308907430,384
1361887532,2308910844,14,6946,496.1428571,1361887526983,1361887527495,2308905827,2308906339,512
1361887552,2308930392,11,939,85.36363636,1361887527626,1361887528458,2308906018,2308906850,832
1361887556,2308934372,8,608,76,1361887529378,1361887543330,2308907750,2308921702,13952
1361887588,2308966836,8,6584,823,1361887585424,1361887586576,2308964260,2308965412,1152
1361887596,2308974840,7,2896,413.7142857,1361887592010,1361887592074,2308970850,2308970914,64
1361887596,2308974848,75,104666,1395.546667,1361887593667,1361887593795,2308972515,2308972643,128
1361887596,2308974880,121,170122,1405.966942,1361887592292,1361887592676,2308971172,2308971556,384
1361887596,2308974884,147,211000,1435.37415,1361887592928,1361887593120,2308971812,2308972004,192
1361887596,2308974888,91,128768,1415.032967,1361887593309,1361887593437,2308972197,2308972325,128
1361887596,2308974892,152,216052,1421.394737,1361887594008,1361887594456,2308972900,2308973348,448
1361887596,2308974892,122,174808,1432.852459,1361887594647,1361887594775,2308973539,2308973667,128
1361887612,2308990516,38,52958,1393.631579,1361887585744,1361887585808,2308964260,2308964324,64
1361887612,2308398340,3,586,195.3333333,1361887585409,1361887585409,2308371749,2308371749,0
1361887640,2309018748,1,52,52,1361887615461,1361887615461,2308994209,2308994209,0
1361887640,2308426464,1,52,52,1361887615235,1361887615235,2308401699,2308401699,0
1361887693,2308479116,7,1495,213.5714286,1361887692832,1361887692832,2308478948,2308478948,0
1361887693,2308479116,11,4687,426.0909091,1361887692704,1361887692832,2308478820,2308478948,128
1361887701,2308487104,13,9103,700.2307692,1361887692974,1361887693102,2308479078,2308479206,128
1361887717,2308503108,8,1483,185.375,1361887713195,1361887713259,2308499303,2308499367,64
1361887717,2308503108,15,12028,801.8666667,1361887713449,1361887713641,2308499557,2308499749,192
1361887717,2308503112,8,1649,206.125,1361887713831,1361887713831,2308499943,2308499943,0
1361887717,2308503112,11,2679,243.5454545,1361887713958,1361887714278,2308500070,2308500390,320
1361887717,2308503112,9,1535,170.5555556,1361887713957,1361887714085,2308500069,2308500197,128
1361887717,2308503112,9,2277,253,1361887713957,1361887714021,2308500069,2308500133,64
1361887717,2308503112,8,1569,196.125,1361887714148,1361887714148,2308500260,2308500260,0
1361887717,2308503112,8,1569,196.125,1361887714212,1361887714276,2308500324,2308500388,64
1361887717,2308503136,10,1507,150.7,1361887712715,1361887714123,2308498851,2308500259,1408
1361887717,2308503144,11,7143,649.3636364,1361887713223,1361887713351,2308499367,2308499495,128
1361887717,2308503156,12,7931,660.9166667,1361887713402,1361887713594,2308499558,2308499750,192
1361887717,2308503160,8,1649,206.125,1361887713779,1361887713779,2308499939,2308499939,0
1361887717,2308503160,11,2775,252.2727273,1361887713911,1361887714167,2308500071,2308500327,256
1361887717,2308503160,8,1707,213.375,1361887713911,1361887714167,2308500071,2308500327,256
1361887717,2308503160,8,1883,235.375,1361887713910,1361887714614,2308500070,2308500774,704
1361887717,2308503160,8,1569,196.125,1361887714101,1361887714165,2308500261,2308500325,64
1361887717,2308503160,8,1569,196.125,1361887714164,1361887714228,2308500324,2308500388,64
1361887720,2308506596,2,104,52,1361887692419,1361887692483,2308479015,2308479079,64
1361887725,2308511172,8,1723,215.375,1361887717160,1361887719080,2308503332,2308505252,1920
1361887725,2308511180,11,7079,643.5454545,1361887718177,1361887718305,2308504357,2308504485,128
1361887725,2308511184,22,16880,767.2727273,1361887713947,1361887717083,2308500131,2308503267,3136
1361887725,2308511184,9,2277,253,1361887718685,1361887718749,2308504869,2308504933,64
1361887725,2308511184,8,1547,193.375,1361887718876,1361887718940,2308505060,2308505124,64
1361887725,2308511200,8,1233,154.125,1361887719310,1361887719374,2308505510,2308505574,64
1361887725,2308511200,8,1339,167.375,1361887719374,1361887719374,2308505574,2308505574,0
1361887725,2308511200,9,1551,172.3333333,1361887719374,1361887719566,2308505574,2308505766,192
1361887725,2308511200,11,1591,144.6363636,1361887719374,1361887719566,2308505574,2308505766,192
1361887725,2308511200,9,1343,149.2222222,1361887719437,1361887719437,2308505637,2308505637,0
1361887725,2308511200,8,1569,196.125,1361887719437,1361887719501,2308505637,2308505701,64
1361887725,2308511200,8,1569,196.125,1361887719437,1361887719501,2308505637,2308505701,64
1361887725,2308511200,9,1343,149.2222222,1361887719628,1361887719628,2308505828,2308505828,0
1361887725,2308511200,9,1775,197.2222222,1361887719628,1361887719756,2308505828,2308505956,128
1361887725,2308511208,8,1291,161.375,1361887717124,1361887717124,2308503332,2308503332,0
1361887725,2308511228,11,7879,716.2727273,1361887718385,1361887718577,2308504613,2308504805,192
1361887725,2308511228,8,1531,191.375,1361887718385,1361887718449,2308504613,2308504677,64
1361887725,2308511228,8,1291,161.375,1361887722096,1361887722160,2308508324,2308508388,64
1361887725,2308511228,8,1547,193.375,1361887718448,1361887718832,2308504676,2308505060,384
1361887725,2308511232,17,14500,852.9411765,1361887718894,1361887719150,2308505126,2308505382,256
1361887725,2308511236,13,8095,622.6923077,1361887719335,1361887719527,2308505571,2308505763,192
1361887725,2308511236,9,1503,167,1361887719339,1361887719531,2308505575,2308505767,192
1361887725,2308511236,8,1569,196.125,1361887719403,1361887719403,2308505639,2308505639,0
1361887725,2308511236,8,1569,196.125,1361887719466,1361887719530,2308505702,2308505766,64
1361887732,2309111064,25,27298,1091.92,1361887713832,1361887728936,2309092896,2309108000,15104
1361887733,2308519096,8,1233,154.125,1361887725172,1361887725236,2308511268,2308511332,64
1361887733,2308519096,9,1343,149.2222222,1361887725236,1361887725300,2308511332,2308511396,64
1361887733,2308519100,14,10360,740,1361887724656,1361887725040,2308510756,2308511140,384
1361887733,2308519100,11,7095,645,1361887729458,1361887729522,2308515558,2308515622,64
1361887733,2308519100,8,1643,205.375,1361887729394,1361887729458,2308515494,2308515558,64
1361887733,2308519100,11,7095,645,1361887729712,1361887729776,2308515812,2308515876,64
1361887733,2308519100,12,7931,660.9166667,1361887729904,1361887730096,2308516004,2308516196,192
1361887733,2308519100,14,10648,760.5714286,1361887729904,1361887730160,2308516004,2308516260,256
1361887733,2308519104,9,6159,684.3333333,1361887730286,1361887730286,2308516390,2308516390,0
1361887733,2308519104,8,1233,154.125,1361887730285,1361887730285,2308516389,2308516389,0
1361887733,2308519104,8,1132,141.5,1361887730412,1361887730476,2308516516,2308516580,64
1361887733,2308519124,8,1233,154.125,1361887727514,1361887727514,2308513638,2308513638,0
1361887733,2308519136,13,8007,615.9230769,1361887729551,1361887729743,2308515687,2308515879,192
1361887733,2308519136,15,10708,713.8666667,1361887729550,1361887729806,2308515686,2308515942,256
1361887733,2308519136,9,2277,253,1361887730188,1361887730252,2308516324,2308516388,64
1361887733,2308519152,9,1343,149.2222222,1361887730367,1361887730431,2308516519,2308516583,64
1361887733,2308519152,1709,2552376,1493.49093,1361887730430,1361887732478,2308516582,2308518630,2048
1361887733,2308519156,14,10408,743.4285714,1361887726907,1361887727291,2308513063,2308513447,384
1361887733,2308519156,9,2725,302.7777778,1361887727480,1361887727544,2308513636,2308513700,64
1361887733,2308519156,10,1395,139.5,1361887727544,1361887728568,2308513700,2308514724,1024
1361887741,2308527100,8,1643,205.375,1361887740466,1361887740530,2308526566,2308526630,64
1361887741,2308527128,14,10408,743.4285714,1361887738646,1361887739030,2308524774,2308525158,384
1361887741,2308527132,8,1233,154.125,1361887739154,1361887739218,2308525286,2308525350,64
1361887741,2308527132,9,1343,149.2222222,1361887739218,1361887739282,2308525350,2308525414,64
1361887741,2308527136,12,7147,595.5833333,1361887740493,1361887740557,2308526629,2308526693,64
1361887741,2308527136,12,7147,595.5833333,1361887740684,1361887740812,2308526820,2308526948,128
1361887741,2308527156,9,1343,149.2222222,1361887737721,1361887737721,2308523877,2308523877,0
1361887741,2308527156,8,1233,154.125,1361887737657,1361887737657,2308523813,2308523813,0
1361887741,2308527168,14,10360,740,1361887736303,1361887736559,2308522471,2308522727,256
1361887749,2308535100,13,10580,813.8461538,1361887740978,1361887741170,2308527078,2308527270,192
1361887749,2308535100,8,1233,154.125,1361887741296,1361887741296,2308527396,2308527396,0
1361887749,2308535104,9,2277,253,1361887741359,1361887741423,2308527463,2308527527,64
1361887749,2308535104,8,1052,131.5,1361887741548,1361887741612,2308527652,2308527716,64
1361887749,2308535112,8,1515,189.375,1361887743013,1361887743141,2308529125,2308529253,128
1361887749,2308535128,8,1052,131.5,1361887743191,1361887743255,2308529319,2308529383,64
1361887749,2308535136,12,7931,660.9166667,1361887740942,1361887741134,2308527078,2308527270,192
1361887749,2308535140,9,6159,684.3333333,1361887741321,1361887741385,2308527461,2308527525,64
1361887749,2308535144,9,1343,149.2222222,1361887741508,1361887741572,2308527652,2308527716,64
1361887757,2308543152,5995,8982110,1498.266889,1361887741565,1361887749693,2308527717,2308535845,8128
1361887765,2309143268,38,50849,1338.131579,1361887749827,1361887762499,2309128095,2309140767,12672
1361887772,2309150840,37,50805,1373.108108,1361887745352,1361887746056,2309124192,2309124896,704
1361887781,2309159252,15,7125,475,1361887777621,1361887777877,2309155873,2309156129,256
1361887781,2308567160,15,16924,1128.266667,1361887777078,1361887777078,2308563238,2308563238,0
1361887789,2309167288,5,309,61.8,1361887783215,1361887783279,2309161503,2309161567,64
1361887801,2309179272,1,52,52,1361887773696,1361887773696,2309151968,2309151968,0
1361887833,2309211296,1,76,76,1361887807465,1361887807465,2309185761,2309185761,0
1361887961,2309339648,2,92,46,1361887933253,1361887956997,2309311901,2309335645,23744
1361888048,2308834852,3155,4725406,1497.751506,1361887742599,1361887747463,2308529451,2308534315,4864
1361888245,2309031296,11,4687,426.0909091,1361888237112,1361888237176,2309023408,2309023472,64
1361888245,2309031296,13,8719,670.6923077,1361888237430,1361888237494,2309023726,2309023790,64
1361888245,2309031336,10,1795,179.5,1361888237133,1361888237389,2309023469,2309023725,256
1361888346,2309724728,1,76,76,1361888319983,1361888319983,2309698711,2309698711,0
1361888429,2309807908,6,1640,273.3333333,1361888416763,1361888422267,2309795671,2309801175,5504
1361888442,2309227904,3,753,251,1361888417477,1361888417477,2309203381,2309203381,0
1361888558,2309343764,1,52,52,1361888533585,1361888533585,2309319349,2309319349,0
1361888558,2309936936,1,46,46,1361888531995,1361888531995,2309910931,2309910931,0
1361888767,2310145304,4,1446,361.5,1361888739858,1361888739858,2310118162,2310118162,0
1361888779,2310157312,34,43412,1276.823529,1361888752586,1361888755402,2310130898,2310133714,2816
1361888811,2310189384,1,52,52,1361888785280,1361888785280,2310163664,2310163664,0
1361888811,2310189388,1,52,52,1361888785275,1361888785275,2310163663,2310163663,0
1361888823,2310201384,1,78,78,1361888797953,1361888797953,2310176337,2310176337,0
1361888859,2310237500,1,76,76,1361888833229,1361888833229,2310211729,2310211729,0
1361889220,2310598428,1,84,84,1361889192911,1361889192911,2310571339,2310571339,0
1361889360,2310738656,62,85283,1375.532258,1361889334183,1361889337255,2310712839,2310715911,3072
1361889360,2310738752,3,1179,393,1361889332935,1361889332999,2310711687,2310711751,64
1361889372,2310750672,1,76,76,1361889345048,1361889345048,2310723720,2310723720,0
1361889390,2310768744,8,6579,822.375,1361889387856,1361889389008,2310766600,2310767752,1152
1361889412,2310790780,40,54752,1368.8,1361889387822,1361889387950,2310766602,2310766730,128
1361889415,2310201112,3,586,195.3333333,1361889387908,1361889387972,2310174020,2310174084,64
1361889443,2310229076,1,52,52,1361889417961,1361889417961,2310204037,2310204037,0
1361889444,2310822808,1,52,52,1361889417745,1361889417745,2310796553,2310796553,0
1361889476,2310854980,1,52,52,1361889447777,1361889447777,2310826757,2310826757,0
1361889480,2310858844,1,52,52,1361889452908,1361889452908,2310831752,2310831752,0
1361889708,2311087200,1,46,46,1361889681091,1361889681091,2311060291,2311060291,0
1361889754,2311132376,1,46,46,1361889726459,1361889726459,2311104835,2311104835,0
1361889885,2311263616,1,76,76,1361889859147,1361889859147,2311237763,2311237763,0
1361890815,2312193772,2,96,48,1361890788127,1361890791071,2312166899,2312169843,2944
1361890891,2312270128,2,120,60,1361890863672,1361890866616,2312242800,2312245744,2944
1361890923,2312302096,3,180,60,1361890898267,1361890907227,2312277363,2312286323,8960
1361890936,2312314284,3,180,60,1361890909060,1361890918148,2312287344,2312296432,9088
1361891264,2312642308,9,3735,415,1361891260966,1361891261222,2312639274,2312639530,256
1361891264,2312642352,9,3914,434.8888889,1361891259835,1361891259963,2312638187,2312638315,128
1361891264,2312642388,9,3737,415.2222222,1361891258457,1361891258777,2312636845,2312637165,320
1361891264,2312642388,9,3646,405.1111111,1361891261847,1361891262487,2312640235,2312640875,640
1361891305,2312683216,4,1121,280.25,1361891278978,1361891278978,2312657194,2312657194,0
1361891308,2312687116,20,22357,1117.85,1361891281341,1361891283645,2312660457,2312662761,2304
1361891341,2312719404,1,52,52,1361891314375,1361891314375,2312692779,2312692779,0
1361891341,2312719480,1,52,52,1361891314300,1361891314300,2312692780,2312692780,0
1361891538,2312916308,1,46,46,1361891512996,1361891512996,2312891304,2312891304,0
1361891625,2313003716,1,76,76,1361891597450,1361891597450,2312976166,2312976166,0
1361891896,2313274684,8,6576,822,1361891889191,1361891889447,2313267875,2313268131,256
1361891914,2313292276,40,55195,1379.875,1361891888575,1361891888639,2313266851,2313266915,64
1361891915,2312700708,3,586,195.3333333,1361891889547,1361891889547,2312675255,2312675255,0
1361891943,2312728668,1,52,52,1361891918513,1361891918513,2312704181,2312704181,0
1361891946,2313324376,1,52,52,1361891918427,1361891918427,2313296803,2313296803,0
1361892134,2313512712,9,684,76,1361892108425,1361892124425,2313487137,2313503137,16000
1361892380,2313758228,1,46,46,1361892353126,1361892353126,2313731354,2313731354,0
1361893707,2315085716,1,46,46,1361893681644,1361893681644,2315060360,2315060360,0
1361894573,2315951536,1,46,46,1361894547024,1361894547024,2315925560,2315925560,0
1361895330,2316708704,1,46,46,1361895302686,1361895302686,2316681390,2316681390,0
1361900839,2322217880,6,427,71.16666667,1361900831707,1361900837851,2322210587,2322216731,6144
1361900870,2322248976,2,150,75,1361900844346,1361900857466,2322223322,2322236442,13120
1361900910,2322289028,1,75,75,1361900883782,1361900883782,2322262810,2322262810,0
1361900919,2322297920,2,131,65.5,1361900913652,1361900913652,2322292572,2322292572,0
1361901051,2322429360,1,46,46,1361901025890,1361901025890,2322404250,2322404250,0
1361901484,2322862552,34,5437,159.9117647,1361901457177,1361901459673,2322835729,2322838225,2496
1361901488,2322866524,4,396,99,1361901459960,1361901460664,2322838484,2322839188,704
1361901608,2322986872,8,3576,447,1361901580056,1361901604504,2322958928,2322983376,24448
1361901641,2323019216,3,1341,447,1361901615144,1361901635112,2322993360,2323013328,19968
1361901789,2323167628,1,46,46,1361901763847,1361901763847,2323142475,2323142475,0
1361901841,2323219720,4,216,54,1361901814124,1361901817260,2323192844,2323195980,3136
1361903891,2325269876,1,95,95,1361903865779,1361903865779,2325244655,2325244655,0
1361903895,2325273784,6,456,76,1361903868940,1361903878924,2325247724,2325257708,9984
1361904001,2325379972,10,8807,880.7,1361903989777,1361903999889,2325368749,2325378861,10112
1361904004,2325382428,41,56065,1367.439024,1361903979313,1361903990321,2325357741,2325368749,11008
1361904009,2325387912,7,5336,762.2857143,1361903989835,1361904007947,2325368747,2325386859,18112
1361904009,2325387912,10,9811,981.1,1361903989835,1361904007947,2325368747,2325386859,18112
1361904009,2325387912,7,4536,648,1361903989899,1361904008203,2325368811,2325387115,18304
1361904009,2325387912,9,8449,938.7777778,1361903989899,1361904003979,2325368811,2325382891,14080
1361904009,2325387912,12,12326,1027.166667,1361903989899,1361904007947,2325368811,2325386859,18048
1361904009,2325387912,7,5823,831.8571429,1361903989835,1361904007947,2325368747,2325386859,18112
1361904009,2325387912,10,8297,829.7,1361903989835,1361904008011,2325368747,2325386923,18176
1361904009,2325387912,6,3749,624.8333333,1361903989899,1361904007947,2325368811,2325386859,18048
1361904009,2325387912,7,4435,633.5714286,1361903989899,1361904008843,2325368811,2325387755,18944
1361904009,2325387912,7,4761,680.1428571,1361903989899,1361904003979,2325368811,2325382891,14080
1361904009,2325387912,8,5262,657.75,1361903989899,1361904008843,2325368811,2325387755,18944
1361904009,2325387996,21,25263,1203,1361903988726,1361904003894,2325367722,2325382890,15168
1361904009,2325387996,9,8670,963.3333333,1361903989753,1361904007929,2325368749,2325386925,18176
1361904009,2325387996,6,4232,705.3333333,1361903989817,1361904003897,2325368813,2325382893,14080
1361904009,2325387996,10,9516,951.6,1361903989817,1361904003897,2325368813,2325382893,14080
1361904009,2325387996,6,4520,753.3333333,1361903989753,1361904007801,2325368749,2325386797,18048
1361904009,2325387996,10,9444,944.4,1361903989817,1361904003897,2325368813,2325382893,14080
1361904009,2325387996,7,4181,597.2857143,1361903989817,1361904008761,2325368813,2325387757,18944
1361904009,2325387996,8,5605,700.625,1361903989817,1361904008761,2325368813,2325387757,18944
1361904009,2325387996,10,9384,938.4,1361903989817,1361904003897,2325368813,2325382893,14080
1361904016,2325394376,67,95284,1422.149254,1361903990371,1361903999651,2325368747,2325378027,9280
1361904036,2325414368,80,114438,1430.475,1361904009453,1361904029677,2325387821,2325408045,20224
1361904036,2325414404,1,52,52,1361904008327,1361904008327,2325386731,2325386731,0
1361904044,2325422320,2,104,52,1361904017498,1361904039450,2325395818,2325417770,21952
1361904057,2325435892,32,29158,911.1875,1361904037789,1361904055517,2325416681,2325434409,17728
1361904064,2325442400,2,92,46,1361904038282,1361904039242,2325416682,2325417642,960
1361904064,2325442432,1,52,52,1361904039338,1361904039338,2325417770,2325417770,0
1361904064,2325442432,1,52,52,1361904039338,1361904039338,2325417770,2325417770,0
1361904064,2325442436,1,46,46,1361904039271,1361904039271,2325417707,2325417707,0
1361904064,2325442436,1,52,52,1361904039335,1361904039335,2325417771,2325417771,0
1361904064,2325442520,1,52,52,1361904039252,1361904039252,2325417772,2325417772,0
1361904064,2325442520,45,62170,1381.555556,1361904039252,1361904061268,2325417772,2325439788,22016
1361904065,2325444080,16,18712,1169.5,1361904042787,1361904061027,2325421867,2325440107,18240
1361904065,2325444080,11,11232,1021.090909,1361904042787,1361904058723,2325421867,2325437803,15936
1361904065,2325444080,10,12212,1221.2,1361904042722,1361904060706,2325421802,2325439786,17984
1361904065,2325444084,12,12258,1021.5,1361904042849,1361904061025,2325421933,2325440109,18176
1361904065,2325444156,12,12531,1044.25,1361904042646,1361904058582,2325421802,2325437738,15936
1361904065,2325444160,13,15127,1163.615385,1361904042769,1361904060945,2325421929,2325440105,18176
1361904065,2325444160,20,24513,1225.65,1361904042708,1361904060884,2325421868,2325440044,18176
1361904068,2325446452,1,52,52,1361904043286,1361904043286,2325421738,2325421738,0
1361904068,2325446452,1,52,52,1361904043285,1361904043285,2325421737,2325421737,0
1361904068,2325446456,1,52,52,1361904043349,1361904043349,2325421805,2325421805,0
1361904068,2325446456,1,52,52,1361904043347,1361904043347,2325421803,2325421803,0
1361904068,2325446456,1,52,52,1361904043346,1361904043346,2325421802,2325421802,0
1361904068,2325446456,35,47061,1344.6,1361904043346,1361904067346,2325421802,2325445802,24000
1361904068,2325446540,1,52,52,1361904043262,1361904043262,2325421802,2325421802,0
1361904068,2325446540,1,52,52,1361904043262,1361904043262,2325421802,2325421802,0
1361904068,2325446540,1,52,52,1361904043262,1361904043262,2325421802,2325421802,0
1361904068,2325446544,1,52,52,1361904043260,1361904043260,2325421804,2325421804,0
1361904068,2325446544,1,52,52,1361904043260,1361904043260,2325421804,2325421804,0
1361904068,2325446544,1,52,52,1361904043260,1361904043260,2325421804,2325421804,0
1361904072,2325450516,1,52,52,1361904046166,1361904046166,2325424682,2325424682,0
1361904084,2325462480,85,122050,1435.882353,1361904059324,1361904080444,2325437804,2325458924,21120
1361904096,2325474444,1,52,52,1361904068125,1361904068125,2325446569,2325446569,0
1361904113,2325492076,40,55748,1393.7,1361904088744,1361904106728,2325467820,2325485804,17984
1361904121,2325500088,32,42333,1322.90625,1361904098649,1361904116697,2325477737,2325495785,18048
1361904124,2325502468,1,52,52,1361904099271,1361904099271,2325477739,2325477739,0
1361904124,2325502556,1,52,52,1361904099183,1361904099183,2325477739,2325477739,0
1361904129,2325508160,37,50826,1373.675676,1361904108692,1361904126740,2325487852,2325505900,18048
1361904133,2324919224,6,1011,168.5,1361904129521,1361904131377,2324915745,2324917601,1856
1361904136,2325514720,1,52,52,1361904110283,1361904110283,2325489003,2325489003,0
1361904136,2325514780,1,52,52,1361904109004,1361904109004,2325487784,2325487784,0
1361904141,2324927100,11,4671,424.6363636,1361904131502,1361904134766,2324917602,2324920866,3264
1361904141,2324927220,12,8971,747.5833333,1361904134648,1361904136504,2324920868,2324922724,1856
1361904148,2325526684,4,600,150,1361904123885,1361904124397,2325502569,2325503081,512
1361904148,2325526684,7,1520,217.1428571,1361904123885,1361904126317,2325502569,2325505001,2432
1361904148,2325526760,5,1154,230.8,1361904123107,1361904124003,2325501867,2325502763,896
1361904148,2325526768,4,600,150,1361904123738,1361904124314,2325502506,2325503082,576
1361904148,2325526768,4,600,150,1361904123801,1361904124313,2325502569,2325503081,512
1361904157,2324943104,8,1499,187.375,1361904149098,1361904150314,2324935202,2324936418,1216
1361904157,2324943108,11,7879,716.2727273,1361904152102,1361904154982,2324938210,2324941090,2880
1361904157,2324943172,14,11976,855.4285714,1361904152040,1361904154472,2324938212,2324940644,2432
1361904157,2324943200,8,1563,195.375,1361904150218,1361904150730,2324936418,2324936930,512
1361904157,2324943216,10,7091,709.1,1361904150716,1361904151932,2324936932,2324938148,1216
1361904157,2324943220,9,1709,189.8888889,1361904154487,1361904156343,2324940707,2324942563,1856
1361904157,2324943220,9,1709,189.8888889,1361904154487,1361904156343,2324940707,2324942563,1856
1361904165,2324951112,10,1689,168.9,1361904159586,1361904162338,2324945698,2324948450,2752
1361904165,2324951112,12,1793,149.4166667,1361904159650,1361904164066,2324945762,2324950178,4416
1361904165,2324951140,10,2627,262.7,1361904156423,1361904161543,2324942563,2324947683,5120
1361904165,2324951140,9,1535,170.5555556,1361904156423,1361904157447,2324942563,2324943587,1024
1361904165,2324951140,10,2723,272.3,1361904156423,1361904161543,2324942563,2324947683,5120
1361904165,2324951176,10,1689,168.9,1361904159523,1361904162403,2324945699,2324948579,2880
1361904165,2324951196,8,1569,196.125,1361904157453,1361904160909,2324943649,2324947105,3456
1361904165,2324951204,8,1707,213.375,1361904156360,1361904157384,2324942564,2324943588,1024
1361904165,2324951204,8,1915,239.375,1361904156360,1361904159560,2324942564,2324945764,3200
1361904165,2324951228,10,2417,241.7,1361904154479,1361904163951,2324940707,2324950179,9472
1361904173,2324959136,8,1291,161.375,1361904167817,1361904168137,2324953953,2324954273,320
1361904173,2324959140,15,12416,827.7333333,1361904157446,1361904167686,2324943586,2324953826,10240
1361904173,2324959212,8,1723,215.375,1361904167742,1361904171966,2324953954,2324958178,4224
1361904177,2325556116,42,49290,1173.571429,1361904157181,1361904176829,2325536297,2325555945,19648
1361904184,2324969788,1,89,89,1361904157801,1361904157801,2324943589,2324943589,0
1361904193,2325572152,2,98,49,1361904181659,1361904186523,2325560811,2325565675,4864
1361904200,2324985912,2,178,89,1361904173162,1361904182890,2324959074,2324968802,9728
1361904204,2324989772,2,2352,1176,1361904177334,1361904187318,2324963106,2324973090,9984
1361904272,2325650848,1,52,52,1361904247302,1361904247302,2325626150,2325626150,0
1361904272,2325650852,1,52,52,1361904247365,1361904247365,2325626217,2325626217,0
1361904272,2325650940,1,52,52,1361904247278,1361904247278,2325626218,2325626218,0
1361904280,2325658828,1,52,52,1361904253596,1361904253596,2325632424,2325632424,0
1361904288,2325667104,1,46,46,1361904260550,1361904260550,2325639654,2325639654,0
1361904288,2325667104,1,46,46,1361904260550,1361904260550,2325639654,2325639654,0
1361904288,2325667108,1,46,46,1361904260549,1361904260549,2325639657,2325639657,0
1361904288,2325667108,1,46,46,1361904260549,1361904260549,2325639657,2325639657,0
1361904289,2325667220,1,46,46,1361904261437,1361904261437,2325639657,2325639657,0
1361904289,2325667220,1,46,46,1361904261437,1361904261437,2325639657,2325639657,0
1361904320,2325699132,1,76,76,1361904293549,1361904293549,2325672681,2325672681,0
1361904325,2325111212,11,7879,716.2727273,1361904317698,1361904317954,2325103910,2325104166,256
1361904325,2325111212,10,1651,165.1,1361904317825,1361904318209,2325104037,2325104421,384
1361904325,2325111212,9,1583,175.8888889,1361904317697,1361904317825,2325103909,2325104037,128
1361904325,2325111220,16,14464,904,1361904318331,1361904318651,2325104551,2325104871,320
1361904325,2325111224,9,1343,149.2222222,1361904318839,1361904318903,2325105063,2325105127,64
1361904325,2325111224,9,1551,172.3333333,1361904318839,1361904319031,2325105063,2325105255,192
1361904325,2325111224,9,1487,165.2222222,1361904318839,1361904319031,2325105063,2325105255,192
1361904325,2325111224,9,1391,154.5555556,1361904318775,1361904318839,2325104999,2325105063,64
1361904325,2325111224,8,1569,196.125,1361904318838,1361904318902,2325105062,2325105126,64
1361904325,2325111224,8,1569,196.125,1361904318966,1361904319030,2325105190,2325105254,64
1361904325,2325111224,9,1775,197.2222222,1361904319157,1361904319285,2325105381,2325105509,128
1361904325,2325111268,11,7079,643.5454545,1361904317322,1361904317450,2325103590,2325103718,128
1361904325,2325111276,9,2277,253,1361904317953,1361904317953,2325104229,2325104229,0
1361904325,2325111280,8,1547,193.375,1361904318143,1361904318271,2325104423,2325104551,128
1361904325,2325111296,8,1233,154.125,1361904318702,1361904318766,2325104998,2325105062,64
1361904325,2325111296,15,8487,565.8,1361904318765,1361904319021,2325105061,2325105317,256
1361904325,2325111296,9,1503,167,1361904318765,1361904318957,2325105061,2325105253,192
1361904325,2325111296,8,1569,196.125,1361904318829,1361904318893,2325105125,2325105189,64
1361904325,2325111296,8,1569,196.125,1361904318893,1361904318893,2325105189,2325105189,0
1361904325,2325111300,8,1291,161.375,1361904319083,1361904319147,2325105383,2325105447,64
1361904333,2325119276,8,1291,161.375,1361904328451,1361904328515,2325114727,2325114791,64
1361904341,2325127200,9,1343,149.2222222,1361904333520,1361904333584,2325119720,2325119784,64
1361904341,2325127200,14,10376,741.1428571,1361904336784,1361904337168,2325122984,2325123368,384
1361904341,2325127252,13,10516,808.9230769,1361904332313,1361904333273,2325118565,2325119525,960
1361904341,2325127268,8,1233,154.125,1361904333387,1361904333451,2325119655,2325119719,64
1361904341,2325127276,8,1233,154.125,1361904337347,1361904337347,2325123623,2325123623,0
1361904341,2325127276,9,1343,149.2222222,1361904337410,1361904337410,2325123686,2325123686,0
1361904349,2325135240,13,10516,808.9230769,1361904346663,1361904347367,2325132903,2325133607,704
1361904349,2325135244,8,1233,154.125,1361904347681,1361904347681,2325133925,2325133925,0
1361904349,2325135248,9,1343,149.2222222,1361904347744,1361904347744,2325133992,2325133992,0
1361904353,2325731168,1,46,46,1361904325614,1361904325614,2325703782,2325703782,0
1361904353,2325731168,1,46,46,1361904325614,1361904325614,2325703782,2325703782,0
1361904353,2325731260,1,46,46,1361904325523,1361904325523,2325703783,2325703783,0
1361904389,2325767416,1,52,52,1361904364084,1361904364084,2325742500,2325742500,0
1361904397,2325183300,13,8431,648.5384615,1361904390060,1361904390188,2325176360,2325176488,128
1361904397,2325183300,8,1233,154.125,1361904389932,1361904389996,2325176232,2325176296,64
1361904397,2325183300,8,1499,187.375,1361904390059,1361904390187,2325176359,2325176487,128
1361904397,2325183300,8,1435,179.375,1361904390059,1361904390187,2325176359,2325176487,128
1361904397,2325183300,9,1775,197.2222222,1361904390249,1361904390377,2325176549,2325176677,128
1361904397,2325183308,8,1233,154.125,1361904393892,1361904393892,2325180200,2325180200,0
1361904397,2325183352,17,14516,853.8823529,1361904389240,1361904389688,2325175592,2325176040,448
1361904397,2325183360,12,10480,873.3333333,1361904392816,1361904393648,2325179176,2325180008,832
1361904397,2325183364,8,1339,167.375,1361904389868,1361904389932,2325176232,2325176296,64
1361904397,2325183364,11,1607,146.0909091,1361904389995,1361904390123,2325176359,2325176487,128
1361904397,2325183364,8,1569,196.125,1361904389995,1361904389995,2325176359,2325176359,0
1361904397,2325183364,8,1291,161.375,1361904389995,1361904389995,2325176359,2325176359,0
1361904397,2325183364,8,1569,196.125,1361904389995,1361904390059,2325176359,2325176423,64
1361904397,2325183364,8,1569,196.125,1361904389994,1361904390058,2325176358,2325176422,64
1361904397,2325183364,8,1569,196.125,1361904390058,1361904390122,2325176422,2325176486,64
1361904397,2325183368,9,1343,149.2222222,1361904390181,1361904390245,2325176549,2325176613,64
1361904397,2325183384,9,1343,149.2222222,1361904393879,1361904393879,2325180263,2325180263,0
1361904417,2325795260,1,46,46,1361904389585,1361904389585,2325767845,2325767845,0
1361904417,2325795344,1,46,46,1361904389501,1361904389501,2325767845,2325767845,0
1361904461,2325247272,11,4687,426.0909091,1361904453126,1361904453190,2325239398,2325239462,64
1361904461,2325247276,12,8667,722.25,1361904453315,1361904453443,2325239591,2325239719,128
1361904461,2325247332,10,1859,185.9,1361904453131,1361904453259,2325239463,2325239591,128
1361904481,2325859640,1,46,46,1361904453270,1361904453270,2325831910,2325831910,0
1361904493,2325279332,8,1649,206.125,1361904491724,1361904491724,2325278056,2325278056,0
1361904493,2325279336,11,2679,243.5454545,1361904491849,1361904492425,2325278185,2325278761,576
1361904493,2325279344,8,1569,196.125,1361904492095,1361904492159,2325278439,2325278503,64
1361904493,2325279344,8,1569,196.125,1361904492099,1361904492163,2325278443,2325278507,64
1361904493,2325279344,8,1569,196.125,1361904492162,1361904492226,2325278506,2325278570,64
1361904493,2325279392,8,1483,185.375,1361904491026,1361904491090,2325277418,2325277482,64
1361904493,2325279392,10,7827,782.7,1361904491217,1361904491665,2325277609,2325278057,448
1361904493,2325279396,9,2277,253,1361904491725,1361904491789,2325278121,2325278185,64
1361904493,2325279396,9,2671,296.7777778,1361904491789,1361904492237,2325278185,2325278633,448
1361904493,2325279396,11,1863,169.3636364,1361904491789,1361904492045,2325278185,2325278441,256
1361904493,2325279396,9,1535,170.5555556,1361904491788,1361904492044,2325278184,2325278440,256
1361904493,2325279416,8,1569,196.125,1361904492090,1361904492154,2325278506,2325278570,64
1361904493,2325279452,10,1507,150.7,1361904490389,1361904490965,2325276841,2325277417,576
1361904493,2325279456,13,11924,917.2307692,1361904491216,1361904491472,2325277672,2325277928,256
1361904493,2325279456,11,7143,649.3636364,1361904491024,1361904491152,2325277480,2325277608,128
1361904496,2325282028,8,1649,206.125,1361904492031,1361904492095,2325278059,2325278123,64
1361904501,2325287340,8,1915,239.375,1361904491844,1361904493124,2325278184,2325279464,1280
1361904501,2325287408,15,12428,828.5333333,1361904491776,1361904498944,2325278184,2325285352,7168
1361904501,2325287480,8,1291,161.375,1361904498939,1361904499003,2325285419,2325285483,64
1361904509,2325295352,8,844,105.5,1361904501240,1361904501304,2325287592,2325287656,64
1361904509,2325295352,8,1691,211.375,1361904501307,1361904501371,2325287659,2325287723,64
1361904509,2325295400,9,1775,197.2222222,1361904499017,1361904503241,2325285417,2325289641,4224
1361904509,2325295428,13,8719,670.6923077,1361904501295,1361904501423,2325287723,2325287851,128
1361904514,2325892456,30,34173,1139.1,1361904492683,1361904507787,2325871139,2325886243,15104
1361904538,2325916444,3,608,202.6666667,1361904533978,1361904534490,2325912422,2325912934,512
1361904538,2325916516,4,569,142.25,1361904530192,1361904535312,2325908708,2325913828,5120
1361904545,2325923692,1,46,46,1361904517343,1361904517343,2325896035,2325896035,0
1361904546,2325924432,5,3607,721.4,1361904537890,1361904538146,2325916322,2325916578,256
1361904546,2325924432,5,1941,388.2,1361904537894,1361904538022,2325916326,2325916454,128
1361904546,2325924432,5,2086,417.2,1361904537957,1361904538085,2325916389,2325916517,128
1361904546,2325924436,7,6623,946.1428571,1361904538207,1361904538719,2325916643,2325917155,512
1361904546,2325924436,5,1941,388.2,1361904538270,1361904538398,2325916706,2325916834,128
1361904546,2325924440,6,1909,318.1666667,1361904538266,1361904538394,2325916706,2325916834,128
1361904546,2325924440,6,1936,322.6666667,1361904537693,1361904537949,2325916133,2325916389,256
1361904546,2325924440,5,1480,296,1361904538524,1361904538652,2325916964,2325917092,128
1361904546,2325924440,4,1205,301.25,1361904538523,1361904538651,2325916963,2325917091,128
1361904546,2325924444,4,1205,301.25,1361904538646,1361904538774,2325917090,2325917218,128
1361904546,2325924444,5,455,91,1361904539224,1361904539736,2325917668,2325918180,512
1361904546,2325924444,5,455,91,1361904539222,1361904539670,2325917666,2325918114,448
1361904546,2325924444,4,1205,301.25,1361904539222,1361904539478,2325917666,2325917922,256
1361904546,2325924444,5,455,91,1361904539222,1361904539734,2325917666,2325918178,512
1361904546,2325924444,5,3613,722.6,1361904539478,1361904539734,2325917922,2325918178,256
1361904546,2325924444,4,1205,301.25,1361904539478,1361904539606,2325917922,2325918050,128
1361904546,2325924476,4,1428,357,1361904540728,1361904540856,2325919204,2325919332,128
1361904546,2325924480,4,1205,301.25,1361904540662,1361904540790,2325919142,2325919270,128
1361904546,2325924480,5,1677,335.4,1361904540725,1361904540917,2325919205,2325919397,192
1361904546,2325924480,4,375,93.75,1361904532725,1361904542773,2325911205,2325921253,10048
1361904546,2325924480,13,13435,1033.461538,1361904532725,1361904538677,2325911205,2325917157,5952
1361904546,2325924480,40,50478,1261.95,1361904532725,1361904542773,2325911205,2325921253,10048
1361904546,2325924480,50,61857,1237.14,1361904532725,1361904544885,2325911205,2325923365,12160
1361904546,2325924480,6,650,108.3333333,1361904532725,1361904542773,2325911205,2325921253,10048
1361904546,2325924480,4,579,144.75,1361904540917,1361904540917,2325919397,2325919397,0
1361904546,2325924480,39,47677,1222.487179,1361904532980,1361904543924,2325911460,2325922404,10944
1361904546,2325924480,5,455,91,1361904541044,1361904541428,2325919524,2325919908,384
1361904546,2325924504,5,2086,417.2,1361904537882,1361904538010,2325916386,2325916514,128
1361904546,2325924508,4,995,248.75,1361904533145,1361904538393,2325911653,2325916901,5248
1361904546,2325924508,4,1008,252,1361904533145,1361904538393,2325911653,2325916901,5248
1361904546,2325924512,5,3615,723,1361904538132,1361904538452,2325916644,2325916964,320
1361904546,2325924512,5,1941,388.2,1361904538195,1361904538323,2325916707,2325916835,128
1361904546,2325924512,5,2086,417.2,1361904538194,1361904538386,2325916706,2325916898,192
1361904546,2325924512,19,18761,987.4210526,1361904530258,1361904538962,2325908770,2325917474,8704
1361904546,2325924516,5,2086,417.2,1361904538194,1361904539474,2325916710,2325917990,1280
1361904546,2325924516,5,3606,721.2,1361904537742,1361904537998,2325916258,2325916514,256
1361904546,2325924520,5,1941,388.2,1361904537805,1361904537933,2325916325,2325916453,128
1361904546,2325924524,5,455,91,1361904539335,1361904539719,2325917859,2325918243,384
1361904546,2325924544,5,2065,413,1361904539379,1361904539571,2325917923,2325918115,192
1361904546,2325924544,5,1941,388.2,1361904539379,1361904539571,2325917923,2325918115,192
1361904546,2325924552,4,1205,301.25,1361904540203,1361904540523,2325918755,2325919075,320
1361904546,2325924556,4,1205,301.25,1361904540966,1361904541094,2325919522,2325919650,128
1361904546,2325924560,18,20802,1155.666667,1361904532646,1361904538598,2325911206,2325917158,5952
1361904546,2325924560,27,33667,1246.925926,1361904532645,1361904538597,2325911205,2325917157,5952
1361904546,2325924560,35,43686,1248.171429,1361904532645,1361904542693,2325911205,2325921253,10048
1361904546,2325924560,151,209316,1386.198675,1361904532645,1361904543845,2325911205,2325922405,11200
1361904546,2325924560,90,112322,1248.022222,1361904532645,1361904544869,2325911205,2325923429,12224
1361904553,2325931752,4,713,178.25,1361904527781,1361904528485,2325906533,2325907237,704
1361904553,2325931832,75,101387,1351.826667,1361904527253,1361904529749,2325906085,2325908581,2496
1361904554,2325932464,72,100617,1397.458333,1361904537347,1361904547523,2325915811,2325925987,10176
1361904554,2325932512,225,309376,1375.004444,1361904532691,1361904549331,2325911203,2325927843,16640
1361904554,2325932512,204,276590,1355.833333,1361904532691,1361904549203,2325911203,2325927715,16512
1361904554,2325932516,103,133506,1296.174757,1361904533008,1361904547856,2325911524,2325926372,14848
1361904554,2325932548,4,658,164.5,1361904537265,1361904547377,2325915813,2325925925,10112
1361904554,2325932592,191,254523,1332.581152,1361904532610,1361904549314,2325911202,2325927906,16704
1361904557,2325935784,67,91707,1368.761194,1361904532419,1361904535939,2325911203,2325914723,3520
1361904557,2325935784,6,1469,244.8333333,1361904532419,1361904532611,2325911203,2325911395,192
1361904557,2325935784,97,135663,1398.587629,1361904532419,1361904535747,2325911203,2325914531,3328
1361904557,2325935784,4,538,134.5,1361904532419,1361904532739,2325911203,2325911523,320
1361904557,2325935876,4,968,242,1361904532326,1361904532646,2325911202,2325911522,320
1361904561,2325939732,3,326,108.6666667,1361904533689,1361904533945,2325912421,2325912677,256
1361904561,2325939764,6,3440,573.3333333,1361904534871,1361904535063,2325913635,2325913827,192
1361904562,2325940504,367,493781,1345.452316,1361904532699,1361904554843,2325911203,2325933347,22144
1361904562,2325940584,672,912174,1357.401786,1361904532491,1361904555019,2325911075,2325933603,22528
1361904564,2325350216,5,3599,719.8,1361904536962,1361904537218,2325323178,2325323434,256
1361904564,2325350272,12,12892,1074.333333,1361904538956,1361904544396,2325325228,2325330668,5440
1361904564,2325350276,6,6043,1007.166667,1361904539205,1361904539205,2325325481,2325325481,0
1361904564,2325350316,5,3847,769.4,1361904536864,1361904537312,2325323180,2325323628,448
1361904564,2325350328,5,3744,748.8,1361904536852,1361904537236,2325323180,2325323564,384
1361904564,2325350328,6,3920,653.3333333,1361904536852,1361904537428,2325323180,2325323756,576
1361904564,2325350368,31,41720,1345.806452,1361904538601,1361904538793,2325324969,2325325161,192
1361904564,2325350388,4,1506,376.5,1361904539096,1361904539672,2325325484,2325326060,576
1361904565,2325943732,3,325,108.3333333,1361904537081,1361904537145,2325915813,2325915877,64
1361904565,2325943732,6,5113,852.1666667,1361904537974,1361904537974,2325916706,2325916706,0
1361904565,2325943736,3,765,255,1361904537972,1361904538036,2325916708,2325916772,64
1361904565,2325943736,12,9605,800.4166667,1361904537971,1361904538291,2325916707,2325917027,320
1361904565,2325943804,8,5325,665.625,1361904540592,1361904544560,2325919396,2325923364,3968
1361904565,2325943808,6,3838,639.6666667,1361904540589,1361904544557,2325919397,2325923365,3968
1361904565,2325943808,11,11636,1057.818182,1361904540589,1361904544621,2325919397,2325923429,4032
1361904565,2325943816,6,5113,852.1666667,1361904537891,1361904537891,2325916707,2325916707,0
1361904565,2325943816,6,1234,205.6666667,1361904537890,1361904539938,2325916706,2325918754,2048
1361904565,2325943820,8,4030,503.75,1361904537886,1361904540574,2325916706,2325919394,2688
1361904565,2325943820,18,17426,968.1111111,1361904537889,1361904539873,2325916709,2325918693,1984
1361904565,2325943840,12,14621,1218.416667,1361904538124,1361904538188,2325916964,2325917028,64
1361904565,2325943848,6,4650,775,1361904538693,1361904539013,2325917541,2325917861,320
1361904565,2325943892,15,17313,1154.2,1361904540505,1361904540569,2325919397,2325919461,64
1361904569,2325947712,88,127986,1454.386364,1361904541133,1361904545357,2325919845,2325924069,4224
1361904569,2325947784,5,4018,803.6,1361904544386,1361904544386,2325923170,2325923170,0
1361904569,2325947792,88,127986,1454.386364,1361904541051,1361904544955,2325919843,2325923747,3904
1361904569,2325947792,88,127986,1454.386364,1361904541051,1361904545211,2325919843,2325924003,4160
1361904578,2325956500,2,141,70.5,1361904575264,1361904575264,2325953764,2325953764,0
1361904578,2325956500,2,104,52,1361904575264,1361904575264,2325953764,2325953764,0
1361904578,2325956500,110,151277,1375.245455,1361904532702,1361904575262,2325911202,2325953762,42560
1361904578,2325956500,129,180370,1398.217054,1361904532702,1361904575262,2325911202,2325953762,42560
1361904578,2325956500,334,478623,1433.002994,1361904532702,1361904575262,2325911202,2325953762,42560
1361904578,2325956536,165,238086,1442.945455,1361904545212,1361904575228,2325923748,2325953764,30016
1361904578,2325956580,3,193,64.33333333,1361904575183,1361904575183,2325953763,2325953763,0
1361904578,2325956584,101,138594,1372.217822,1361904532618,1361904575178,2325911202,2325953762,42560
1361904581,2325959812,4,1544,386,1361904552936,1361904552936,2325931748,2325931748,0
1361904581,2325367444,2,104,52,1361904574688,1361904574752,2325361132,2325361196,64
1361904581,2325367452,133,183208,1377.503759,1361904538392,1361904574616,2325324844,2325361068,36224
1361904589,2325967820,46,59104,1284.869565,1361904563423,1361904566943,2325942243,2325945763,3520
1361904600,2325386248,1,52,52,1361904574819,1361904574819,2325361067,2325361067,0
1361904600,2325386248,1,52,52,1361904574819,1361904574819,2325361067,2325361067,0
1361904600,2325386264,1,52,52,1361904574805,1361904574805,2325361069,2325361069,0
1361904600,2325386264,1,52,52,1361904574805,1361904574805,2325361069,2325361069,0
1361904600,2325386356,1,52,52,1361904574711,1361904574711,2325361067,2325361067,0
1361904600,2325386356,1,52,52,1361904574711,1361904574711,2325361067,2325361067,0
1361904600,2325386356,1,52,52,1361904574711,1361904574711,2325361067,2325361067,0
1361904601,2325980092,1,52,52,1361904574670,1361904574670,2325953762,2325953762,0
1361904601,2325980092,1,46,46,1361904574670,1361904574670,2325953762,2325953762,0
1361904601,2325980092,1,52,52,1361904574670,1361904574670,2325953762,2325953762,0
1361904601,2325980092,1,52,52,1361904574670,1361904574670,2325953762,2325953762,0
1361904601,2325980092,1,46,46,1361904574670,1361904574670,2325953762,2325953762,0
1361904601,2325980092,1,46,46,1361904574670,1361904574670,2325953762,2325953762,0
1361904601,2325980092,1,46,46,1361904574670,1361904574670,2325953762,2325953762,0
1361904601,2325980092,1,46,46,1361904574670,1361904574670,2325953762,2325953762,0
1361904601,2325980092,1,46,46,1361904574670,1361904574670,2325953762,2325953762,0
1361904601,2325980092,1,46,46,1361904574670,1361904574670,2325953762,2325953762,0
1361904601,2325980092,1,46,46,1361904574670,1361904574670,2325953762,2325953762,0
1361904601,2325980092,1,52,52,1361904574670,1361904574670,2325953762,2325953762,0
1361904601,2325980096,1,52,52,1361904574665,1361904574665,2325953761,2325953761,0
1361904601,2325980096,1,52,52,1361904574665,1361904574665,2325953761,2325953761,0
1361904601,2325980096,1,52,52,1361904574665,1361904574665,2325953761,2325953761,0
1361904601,2325980096,1,52,52,1361904574669,1361904574669,2325953765,2325953765,0
1361904601,2325980096,1,52,52,1361904574669,1361904574669,2325953765,2325953765,0
1361904601,2325980096,1,46,46,1361904574669,1361904574669,2325953765,2325953765,0
1361904601,2325980096,1,46,46,1361904574669,1361904574669,2325953765,2325953765,0
1361904601,2325980096,1,52,52,1361904574669,1361904574669,2325953765,2325953765,0
1361904601,2325980096,1,52,52,1361904574668,1361904574668,2325953764,2325953764,0
1361904601,2325980096,1,46,46,1361904574668,1361904574668,2325953764,2325953764,0
1361904601,2325980096,1,46,46,1361904574668,1361904574668,2325953764,2325953764,0
1361904601,2325980096,1,46,46,1361904574668,1361904574668,2325953764,2325953764,0
1361904602,2325980176,1,46,46,1361904575585,1361904575585,2325953761,2325953761,0
1361904602,2325980176,1,52,52,1361904575585,1361904575585,2325953761,2325953761,0
1361904602,2325980176,1,52,52,1361904575589,1361904575589,2325953765,2325953765,0
1361904602,2325980176,1,52,52,1361904575589,1361904575589,2325953765,2325953765,0
1361904602,2325980176,1,52,52,1361904575589,1361904575589,2325953765,2325953765,0
1361904602,2325980176,1,52,52,1361904575589,1361904575589,2325953765,2325953765,0
1361904602,2325980176,1,52,52,1361904575589,1361904575589,2325953765,2325953765,0
1361904602,2325980176,1,46,46,1361904575589,1361904575589,2325953765,2325953765,0
1361904602,2325980176,1,46,46,1361904575589,1361904575589,2325953765,2325953765,0
1361904602,2325980176,1,46,46,1361904575589,1361904575589,2325953765,2325953765,0
1361904602,2325980176,1,46,46,1361904575589,1361904575589,2325953765,2325953765,0
1361904602,2325980176,1,46,46,1361904575589,1361904575589,2325953765,2325953765,0
1361904602,2325980176,1,46,46,1361904575588,1361904575588,2325953764,2325953764,0
1361904602,2325980204,1,52,52,1361904575560,1361904575560,2325953764,2325953764,0
1361904602,2325980204,1,46,46,1361904575560,1361904575560,2325953764,2325953764,0
1361904602,2325980204,1,52,52,1361904575560,1361904575560,2325953764,2325953764,0
1361904602,2325980204,1,52,52,1361904575560,1361904575560,2325953764,2325953764,0
1361904602,2325980204,1,46,46,1361904575560,1361904575560,2325953764,2325953764,0
1361904602,2325980204,1,52,52,1361904575560,1361904575560,2325953764,2325953764,0
1361904602,2325980204,1,46,46,1361904575560,1361904575560,2325953764,2325953764,0
1361904602,2325980204,1,46,46,1361904575560,1361904575560,2325953764,2325953764,0
1361904602,2325980204,1,46,46,1361904575560,1361904575560,2325953764,2325953764,0
1361904602,2325980204,1,52,52,1361904575560,1361904575560,2325953764,2325953764,0
1361904602,2325980204,1,46,46,1361904575559,1361904575559,2325953763,2325953763,0
1361904609,2325988092,1,46,46,1361904581007,1361904581007,2325960099,2325960099,0
1361904621,2326000152,1,52,52,1361904596628,1361904596628,2325975780,2325975780,0
1361904621,2326000152,1,52,52,1361904596628,1361904596628,2325975780,2325975780,0
1361904746,2326124540,5,578,115.6,1361904741941,1361904742133,2326120481,2326120673,192
1361904746,2326124540,3,608,202.6666667,1361904742131,1361904742259,2326120671,2326120799,128
1361904746,2326124544,11,11439,1039.909091,1361904734256,1361904739312,2326112800,2326117856,5056
1361904746,2326124552,5,2032,406.4,1361904743015,1361904743143,2326121567,2326121695,128
1361904746,2326124552,6,1936,322.6666667,1361904743015,1361904743143,2326121567,2326121695,128
1361904746,2326124576,5,1941,388.2,1361904743250,1361904743506,2326121826,2326122082,256
1361904746,2326124576,5,2032,406.4,1361904743313,1361904743505,2326121889,2326122081,192
1361904746,2326124584,5,455,91,1361904744136,1361904744520,2326122720,2326123104,384
1361904746,2326124588,6,1907,317.8333333,1361904744135,1361904744199,2326122723,2326122787,64
1361904746,2326124588,4,1428,357,1361904744134,1361904744262,2326122722,2326122850,128
1361904746,2326124592,5,1257,251.4,1361904744319,1361904744447,2326122911,2326123039,128
1361904746,2326124592,4,1205,301.25,1361904744514,1361904744578,2326123106,2326123170,64
1361904746,2326124592,4,317,79.25,1361904744514,1361904745282,2326123106,2326123874,768
1361904746,2326124592,5,2065,413,1361904744514,1361904744642,2326123106,2326123234,128
1361904746,2326124592,4,1205,301.25,1361904744705,1361904744833,2326123297,2326123425,128
1361904746,2326124592,4,579,144.75,1361904745087,1361904745087,2326123679,2326123679,0
1361904746,2326124620,10,9798,979.8,1361904742051,1361904742243,2326120671,2326120863,192
1361904746,2326124624,5,3596,719.2,1361904742242,1361904742498,2326120866,2326121122,256
1361904746,2326124628,5,3624,724.8,1361904742876,1361904743068,2326121504,2326121696,192
1361904746,2326124632,5,1941,388.2,1361904742747,1361904742875,2326121379,2326121507,128
1361904746,2326124664,4,1205,301.25,1361904744057,1361904744185,2326122721,2326122849,128
1361904746,2326124668,5,3592,718.4,1361904744372,1361904744628,2326123040,2326123296,256
1361904746,2326124676,5,455,91,1361904744235,1361904744619,2326122911,2326123295,384
1361904746,2326124676,5,455,91,1361904744814,1361904745198,2326123490,2326123874,384
1361904746,2326124676,4,428,107,1361904744622,1361904744750,2326123298,2326123426,128
1361904746,2326124676,4,578,144.5,1361904745133,1361904745133,2326123809,2326123809,0
1361904754,2326132784,4,375,93.75,1361904741696,1361904751744,2326120480,2326130528,10048
1361904754,2326132828,6,652,108.6666667,1361904740246,1361904751638,2326119074,2326130466,11392
1361904754,2326132868,4,376,94,1361904741612,1361904751660,2326120480,2326130528,10048
1361904754,2326132868,4,375,93.75,1361904741612,1361904751660,2326120480,2326130528,10048
1361904754,2326132868,4,375,93.75,1361904741612,1361904751660,2326120480,2326130528,10048
1361904754,2326132872,4,657,164.25,1361904741991,1361904752039,2326120863,2326130911,10048
1361904762,2326140776,5,1682,336.4,1361904758536,1361904758600,2326137312,2326137376,64
1361904762,2326140852,864,1289330,1492.280093,1361904745917,1361904756477,2326124769,2326135329,10560
1361904762,2326140892,83,111867,1347.795181,1361904740182,1361904753750,2326119074,2326132642,13568
1361904766,2326144488,3,540,180,1361904741735,1361904741735,2326120223,2326120223,0
1361904766,2326144656,38,43528,1145.473684,1361904740415,1361904741823,2326119071,2326120479,1408
1361904769,2325554520,9,3907,434.1111111,1361904743168,1361904745088,2325528688,2325530608,1920
1361904769,2325554520,20,24075,1203.75,1361904743165,1361904744893,2325528685,2325530413,1728
1361904769,2325554524,20,22307,1115.35,1361904743354,1361904744506,2325528878,2325530030,1152
1361904769,2325554524,7,6240,891.4285714,1361904743353,1361904743417,2325528877,2325528941,64
1361904769,2325554552,50,65136,1302.72,1361904744413,1361904768477,2325529965,2325554029,24064
1361904769,2325554568,94,134600,1431.914894,1361904744461,1361904745357,2325530029,2325530925,896
1361904769,2325554636,15,17067,1137.8,1361904743241,1361904744329,2325528877,2325529965,1088
1361904769,2325554636,6,5399,899.8333333,1361904743305,1361904743305,2325528941,2325528941,0
1361904769,2325554652,9,9046,1005.111111,1361904743227,1361904744315,2325528879,2325529967,1088
1361904770,2326148484,5,4054,810.8,1361904741997,1361904742061,2326120481,2326120545,64
1361904770,2326148484,9,5354,594.8888889,1361904741997,1361904742189,2326120481,2326120673,192
1361904770,2326148484,20,24795,1239.75,1361904741996,1361904742956,2326120480,2326121440,960
1361904770,2326148484,14,15353,1096.642857,1361904741996,1361904742444,2326120480,2326120928,448
1361904770,2326148492,22,25300,1150,1361904742884,1361904743524,2326121376,2326122016,640
1361904770,2326148492,21,23794,1133.047619,1361904743075,1361904743139,2326121567,2326121631,64
1361904770,2326148520,3,580,193.3333333,1361904743432,1361904743496,2326121952,2326122016,64
1361904770,2326148560,8,5691,711.375,1361904745377,1361904746081,2326123937,2326124641,704
1361904770,2326148560,11,9871,897.3636364,1361904745503,1361904745567,2326124063,2326124127,64
1361904770,2326148628,48,56517,1177.4375,1361904741853,1361904742941,2326120481,2326121569,1088
1361904770,2326148628,11,9764,887.6363636,1361904741852,1361904744412,2326120480,2326123040,2560
1361904770,2326148628,6,1469,244.8333333,1361904741852,1361904741980,2326120480,2326120608,128
1361904770,2326148632,8,7972,996.5,1361904742168,1361904742360,2326120800,2326120992,192
1361904770,2326148660,17,14552,856,1361904742908,1361904744700,2326121568,2326123360,1792
1361904770,2326148664,3,644,214.6666667,1361904743161,1361904743289,2326121825,2326121953,128
1361904770,2326148664,8,4592,574,1361904743352,1361904744056,2326122016,2326122720,704
1361904770,2326148668,3,615,205,1361904743222,1361904743350,2326121890,2326122018,128
1361904770,2326148668,6,2724,454,1361904743859,1361904744563,2326122527,2326123231,704
1361904770,2326148704,23,25579,1112.130435,1361904745232,1361904745936,2326123936,2326124640,704
1361904770,2326148764,5,1565,313,1361904758998,1361904764118,2326137762,2326142882,5120
1361904773,2325558796,3,1206,402,1361904744748,1361904744748,2325530544,2325530544,0
1361904778,2326156788,2,131,65.5,1361904773950,1361904773950,2326152738,2326152738,0
1361904778,2326156792,2,104,52,1361904774262,1361904774262,2326153054,2326153054,0
1361904778,2326156792,2,104,52,1361904774262,1361904774262,2326153054,2326153054,0
1361904778,2326156792,3,608,202.6666667,1361904774391,1361904774455,2326153183,2326153247,64
1361904778,2326156800,5,3592,718.4,1361904775215,1361904775407,2326154015,2326154207,192
1361904778,2326156824,6,1930,321.6666667,1361904775064,1361904775192,2326153888,2326154016,128
1361904778,2326156828,5,3583,716.6,1361904775446,1361904775510,2326154274,2326154338,64
1361904778,2326156828,5,1941,388.2,1361904775317,1361904775381,2326154145,2326154209,64
1361904778,2326156828,5,1938,387.6,1361904775317,1361904775445,2326154145,2326154273,128
1361904778,2326156828,5,1257,251.4,1361904775573,1361904775701,2326154401,2326154529,128
1361904778,2326156828,3,193,64.33333333,1361904775317,1361904775317,2326154145,2326154145,0
1361904778,2326156828,5,1941,388.2,1361904775444,1361904775572,2326154272,2326154400,128
1361904778,2326156828,4,1205,301.25,1361904775763,1361904775891,2326154591,2326154719,128
1361904778,2326156832,5,3625,725,1361904775697,1361904775953,2326154529,2326154785,256
1361904778,2326156832,5,1014,202.8,1361904775761,1361904775825,2326154593,2326154657,64
1361904778,2326156836,4,1205,301.25,1361904776396,1361904776524,2326155232,2326155360,128
1361904778,2326156868,2,104,52,1361904774187,1361904774187,2326153055,2326153055,0
1361904778,2326156880,5,1941,388.2,1361904775136,1361904775200,2326154016,2326154080,64
1361904778,2326156880,6,1903,317.1666667,1361904775136,1361904775264,2326154016,2326154144,128
1361904778,2326156880,5,1954,390.8,1361904775136,1361904776288,2326154016,2326155168,1152
1361904778,2326156904,6,2150,358.3333333,1361904775178,1361904775498,2326154082,2326154402,320
1361904778,2326156904,5,3621,724.2,1361904775242,1361904775498,2326154146,2326154402,256
1361904778,2326156904,5,3690,738,1361904775431,1361904775623,2326154335,2326154527,192
1361904778,2326156904,5,1954,390.8,1361904775366,1361904775558,2326154270,2326154462,192
1361904778,2326156908,5,2065,413,1361904775494,1361904775622,2326154402,2326154530,128
1361904778,2326156908,5,455,91,1361904775494,1361904775878,2326154402,2326154786,384
1361904778,2326156908,6,1993,332.1666667,1361904775494,1361904775558,2326154402,2326154466,64
1361904778,2326156908,5,455,91,1361904775620,1361904775940,2326154528,2326154848,320
1361904778,2326156908,5,455,91,1361904775811,1361904776195,2326154719,2326155103,384
1361904778,2326156908,5,455,91,1361904775746,1361904776130,2326154654,2326155038,384
1361904778,2326156912,5,455,91,1361904775938,1361904776386,2326154850,2326155298,448
1361904778,2326156912,4,1205,301.25,1361904775810,1361904775938,2326154722,2326154850,128
1361904778,2326156916,5,553,110.6,1361904773435,1361904773563,2326152351,2326152479,128
1361904786,2326164512,15,18869,1257.933333,1361904759440,1361904759440,2326137952,2326137952,0
1361904786,2326164684,15,17905,1193.666667,1361904759268,1361904759332,2326137952,2326138016,64
1361904786,2326164780,6,1086,181,1361904774787,1361904785091,2326153567,2326163871,10304
1361904786,2326164784,6,1054,175.6666667,1361904774785,1361904785089,2326153569,2326163873,10304
1361904786,2326164784,4,656,164,1361904774977,1361904785025,2326153761,2326163809,10048
1361904786,2326164864,6,1098,183,1361904774513,1361904785009,2326153377,2326163873,10496
1361904786,2326164864,6,1085,180.8333333,1361904774703,1361904785007,2326153567,2326163871,10304
1361904789,2325574880,7,4034,576.2857143,1361904763735,1361904788183,2325549615,2325574063,24448
1361904789,2325575416,3,2827,942.3333333,1361904768190,1361904787646,2325554606,2325574062,19456
1361904794,2326172816,4,1205,301.25,1361904789921,1361904790049,2326168737,2326168865,128
1361904794,2326172824,4,1205,301.25,1361904790486,1361904790998,2326169310,2326169822,512
1361904794,2326172824,5,2032,406.4,1361904786970,1361904787802,2326165794,2326166626,832
1361904794,2326172824,3,608,202.6666667,1361904787223,1361904787287,2326166047,2326166111,64
1361904794,2326172828,4,409,102.25,1361904790805,1361904791125,2326169633,2326169953,320
1361904794,2326172828,4,409,102.25,1361904787605,1361904787733,2326166433,2326166561,128
1361904794,2326172828,4,1205,301.25,1361904787859,1361904787987,2326166687,2326166815,128
1361904794,2326172856,7,796,113.7142857,1361904788790,1361904789558,2326167646,2326168414,768
1361904794,2326172860,4,1205,301.25,1361904788850,1361904789298,2326167710,2326168158,448
1361904794,2326172860,5,2065,413,1361904788982,1361904789558,2326167842,2326168418,576
1361904794,2326172892,5,455,91,1361904789908,1361904790420,2326168800,2326169312,512
1361904794,2326172900,5,578,115.6,1361904786765,1361904786893,2326165665,2326165793,128
1361904794,2326172900,5,3594,718.8,1361904786891,1361904787083,2326165791,2326165983,192
1361904794,2326172900,6,1993,332.1666667,1361904786891,1361904787019,2326165791,2326165919,128
1361904794,2326172904,17,15734,925.5294118,1361904787209,1361904787401,2326166113,2326166305,192
1361904794,2326172904,5,1480,296,1361904787401,1361904787529,2326166305,2326166433,128
1361904794,2326172904,2,92,46,1361904787400,1361904787400,2326166304,2326166304,0
1361904794,2326172908,2,92,46,1361904787778,1361904787778,2326166686,2326166686,0
1361904794,2326172908,6,1975,329.1666667,1361904787909,1361904788037,2326166817,2326166945,128
1361904794,2326172932,4,1205,301.25,1361904788397,1361904788589,2326167329,2326167521,192
1361904794,2326172932,6,1922,320.3333333,1361904788460,1361904788524,2326167392,2326167456,64
1361904794,2326172932,5,3623,724.6,1361904788396,1361904788780,2326167328,2326167712,384
1361904794,2326172932,5,1941,388.2,1361904788396,1361904788652,2326167328,2326167584,256
1361904794,2326172932,5,2032,406.4,1361904788396,1361904788652,2326167328,2326167584,256
1361904794,2326172936,5,3594,718.8,1361904788905,1361904790313,2326167841,2326169249,1408
1361904794,2326172936,5,1941,388.2,1361904788905,1361904789481,2326167841,2326168417,576
1361904794,2326172936,4,1428,357,1361904788905,1361904790249,2326167841,2326169185,1344
1361904794,2326172948,8,7608,951,1361904784926,1361904790942,2326163874,2326169890,6016
1361904801,2325586748,6,3697,616.1666667,1361904775325,1361904775773,2325561073,2325561521,448
1361904801,2325586748,3,1298,432.6666667,1361904775324,1361904775644,2325561072,2325561392,320
1361904801,2325586748,5,3521,704.2,1361904775322,1361904775514,2325561070,2325561262,192
1361904801,2325586748,5,3650,730,1361904775322,1361904775642,2325561070,2325561390,320
1361904801,2325586768,1,52,52,1361904775879,1361904775879,2325561647,2325561647,0
1361904801,2325586768,11,5547,504.2727273,1361904775942,1361904789382,2325561710,2325575150,13440
1361904801,2325586772,1,52,52,1361904775876,1361904775876,2325561648,2325561648,0
1361904801,2325586776,30,41655,1388.5,1361904776255,1361904776319,2325562031,2325562095,64
1361904801,2325586884,1,52,52,1361904776146,1361904776146,2325562030,2325562030,0
1361904802,2326180548,4,968,242,1361904774638,1361904787502,2326153186,2326166050,12864
1361904802,2326180548,1,46,46,1361904774826,1361904774826,2326153374,2326153374,0
1361904802,2326180552,1,52,52,1361904774952,1361904774952,2326153504,2326153504,0
1361904802,2326180556,1,52,52,1361904775205,1361904775205,2326153761,2326153761,0
1361904802,2326180576,23,20679,899.0869565,1361904775569,1361904789073,2326154145,2326167649,13504
1361904802,2326180576,5,4016,803.2,1361904775759,1361904775823,2326154335,2326154399,64
1361904802,2326180576,1,46,46,1361904775567,1361904775567,2326154143,2326154143,0
1361904802,2326180576,32,33869,1058.40625,1361904775630,1361904790734,2326154206,2326169310,15104
1361904802,2326180580,1,52,52,1361904775694,1361904775694,2326154274,2326154274,0
1361904802,2326180580,12,6642,553.5,1361904775694,1361904790606,2326154274,2326169186,14912
1361904802,2326180588,1,52,52,1361904776901,1361904776901,2326155489,2326155489,0
1361904802,2326180588,1,52,52,1361904776901,1361904776901,2326155489,2326155489,0
1361904802,2326180588,28,28846,1030.214286,1361904777028,1361904792132,2326155616,2326170720,15104
1361904802,2326180588,4,1985,496.25,1361904777028,1361904777092,2326155616,2326155680,64
1361904802,2326180588,38,44081,1160.026316,1361904777027,1361904792707,2326155615,2326171295,15680
1361904802,2326180628,19,16795,883.9473684,1361904774428,1361904787164,2326153056,2326165792,12736
1361904802,2326180628,1,52,52,1361904774555,1361904774555,2326153183,2326153183,0
1361904802,2326180656,11,8568,778.9090909,1361904774849,1361904787777,2326153505,2326166433,12928
1361904802,2326180732,1,46,46,1361904775410,1361904775410,2326154142,2326154142,0
1361904802,2326180732,3,783,261,1361904775730,1361904775794,2326154462,2326154526,64
1361904802,2326180760,1,52,52,1361904776726,1361904776726,2326155486,2326155486,0
1361904802,2326180856,63,87127,1382.968254,1361904788537,1361904798585,2326167393,2326177441,10048
1361904802,2326180936,4,657,164.25,1361904787754,1361904797802,2326166690,2326176738,10048
1361904810,2326188892,5,553,110.6,1361904802901,1361904803221,2326181793,2326182113,320
1361904813,2325598760,11,12438,1130.727273,1361904788305,1361904788369,2325574065,2325574129,64
1361904813,2325598856,11,12997,1181.545455,1361904788273,1361904788273,2325574129,2325574129,0
1361904814,2326192532,2,104,52,1361904787066,1361904787066,2326165598,2326165598,0
1361904814,2326192532,6,1468,244.6666667,1361904787130,1361904787258,2326165662,2326165790,128
1361904814,2326192536,2,104,52,1361904787064,1361904787064,2326165600,2326165600,0
1361904814,2326192564,1,52,52,1361904787482,1361904787482,2326166046,2326166046,0
1361904814,2326192568,19,24361,1282.157895,1361904787478,1361904787606,2326166046,2326166174,128
1361904814,2326192568,1,46,46,1361904787478,1361904787478,2326166046,2326166046,0
1361904814,2326192568,1,52,52,1361904787673,1361904787673,2326166241,2326166241,0
1361904814,2326192568,8,4592,574,1361904787734,1361904788182,2326166302,2326166750,448
1361904814,2326192580,1,46,46,1361904788812,1361904788812,2326167392,2326167392,0
1361904814,2326192644,19,11298,594.6315789,1361904786956,1361904787084,2326165600,2326165728,128
1361904814,2326192644,9,5354,594.8888889,1361904787019,1361904787147,2326165663,2326165791,128
1361904814,2326192648,6,1230,205,1361904787398,1361904789062,2326166046,2326167710,1664
1361904814,2326192648,3,580,193.3333333,1361904787590,1361904787654,2326166238,2326166302,64
1361904814,2326192652,1,52,52,1361904787589,1361904787589,2326166241,2326166241,0
1361904814,2326192652,3,644,214.6666667,1361904787589,1361904787717,2326166241,2326166369,128
1361904814,2326192692,1,46,46,1361904788955,1361904788955,2326167647,2326167647,0
1361904817,2325602680,4,1020,255,1361904789086,1361904789214,2325574766,2325574894,128
1361904826,2326204948,2,131,65.5,1361904817819,1361904817819,2326196767,2326196767,0
1361904826,2326205032,5,553,110.6,1361904817865,1361904817929,2326196897,2326196961,64
1361904834,2326212612,1,76,76,1361904808107,1361904808107,2326186719,2326186719,0
1361904834,2326212908,6,1844,307.3333333,1361904832900,1361904832964,2326211808,2326211872,64
1361904850,2326228904,5,553,110.6,1361904847943,1361904848199,2326226847,2326227103,256
1361904854,2326232644,1,52,52,1361904829516,1361904829516,2326208160,2326208160,0
1361904858,2326236976,2,141,70.5,1361904849984,1361904855040,2326228960,2326234016,5056
1361904862,2326240700,1,52,52,1361904836500,1361904836500,2326215200,2326215200,0
1361904866,2326245016,5,1700,340,1361904864661,1361904864853,2326243677,2326243869,192
1361904874,2326252760,1,52,52,1361904848405,1361904848405,2326227165,2326227165,0
1361904878,2326256648,1,52,52,1361904851528,1361904851528,2326230176,2326230176,0
1361904878,2326256736,1,52,52,1361904851440,1361904851440,2326230176,2326230176,0
1361904882,2326261064,5,553,110.6,1361904877733,1361904877861,2326256797,2326256925,128
1361904898,2326276960,6,1850,308.3333333,1361904892877,1361904892941,2326271837,2326271901,64
1361904914,2326293024,5,1667,333.4,1361904907792,1361904908240,2326286816,2326287264,448
1361904918,2326296672,1,52,52,1361904891439,1361904891439,2326270111,2326270111,0
1361904930,2326309048,5,553,110.6,1361904922740,1361904922868,2326301788,2326301916,128
1361904934,2326312676,1,52,52,1361904906986,1361904906986,2326285662,2326285662,0
1361904934,2326312784,1,52,52,1361904906940,1361904906940,2326285724,2326285724,0
1361904934,2326312788,1,52,52,1361904906936,1361904906936,2326285724,2326285724,0
1361904946,2326324772,1,46,46,1361904919945,1361904919945,2326298717,2326298717,0
1361904946,2326325160,5,553,110.6,1361904937668,1361904938052,2326316828,2326317212,384
1361904955,2326333176,5,1789,357.8,1361904953694,1361904954590,2326331870,2326332766,896
1361904966,2326344768,1,46,46,1361904939791,1361904939791,2326318559,2326318559,0
1361904970,2326349088,6,613,102.1666667,1361904968013,1361904969421,2326347101,2326348509,1408
1361904982,2326360876,1,52,52,1361904956511,1361904956511,2326335387,2326335387,0
1361904986,2326365068,8,994,124.25,1361904982752,1361904985376,2326361820,2326364444,2624
1361904986,2326365092,2,104,52,1361904982922,1361904983114,2326362014,2326362206,192
1361904987,2326365212,3,156,52,1361904982264,1361904982968,2326360476,2326361180,704
1361905002,2326381164,6,613,102.1666667,1361904997890,1361905000194,2326377054,2326379358,2304
1361905003,2326381176,3,156,52,1361904999773,1361905000477,2326377949,2326378653,704
1361905003,2326381200,3,156,52,1361904999749,1361905000453,2326377949,2326378653,704
1361905018,2326397132,3,156,52,1361905015264,1361905015968,2326394396,2326395100,704
1361905018,2326397132,3,156,52,1361905015391,1361905016031,2326394523,2326395163,640
1361905019,2326397232,6,613,102.1666667,1361905013606,1361905017190,2326391838,2326395422,3584
1361905019,2326397232,168,238242,1418.107143,1361904776741,1361905018789,2326154973,2326397021,242048
1361905034,2326413116,4,208,52,1361905026609,1361905028209,2326405725,2326407325,1600
1361905034,2326413124,9,4865,540.5555556,1361905027752,1361905031144,2326406876,2326410268,3392
1361905035,2326413196,2,104,52,1361905030985,1361905031433,2326409181,2326409629,448
1361905035,2326413200,4,208,52,1361905027844,1361905029380,2326406044,2326407580,1536
1361905035,2326413204,4,208,52,1361905028160,1361905029888,2326406364,2326408092,1728
1361905042,2326420828,1,46,46,1361905013905,1361905013905,2326392733,2326392733,0
1361905051,2326429216,5,553,110.6,1361905043636,1361905043892,2326421852,2326422108,256
1361905059,2326437196,8,6389,798.625,1361905050697,1361905052489,2326428893,2326430685,1792
1361905067,2326445504,7,673,96.14285714,1361905058324,1361905060692,2326436828,2326439196,2368
1361905075,2326453260,6,3162,527,1361905073864,1361905074184,2326452124,2326452444,320
1361905077,2325862960,3,586,195.3333333,1361905050254,1361905050318,2325836214,2325836278,64
1361905078,2326456912,38,51987,1368.078947,1361905049979,1361905050235,2326428891,2326429147,256
1361905091,2326469216,7,4737,676.7142857,1361905088626,1361905089074,2326466842,2326467290,448
1361905093,2325878944,151,212735,1408.84106,1361904776095,1361904790943,2325562039,2325576887,14848
1361905105,2325891224,1,52,52,1361905080006,1361905080006,2325866230,2325866230,0
1361905106,2326485164,1,52,52,1361905079677,1361905079677,2326458841,2326458841,0
1361905107,2326485336,5,553,110.6,1361905103484,1361905103612,2326481820,2326481948,128
1361905107,2326485372,78591,117880916,1499.928949,1361904789270,1361905104086,2326167642,2326482458,314816
1361905122,2326500988,1,46,46,1361905097520,1361905097520,2326476508,2326476508,0
1361905123,2326501284,5,553,110.6,1361905118576,1361905118640,2326496860,2326496924,64
1361905139,2326517272,5,553,110.6,1361905133564,1361905133692,2326511836,2326511964,128
1361905155,2326533240,5,553,110.6,1361905148633,1361905148697,2326526873,2326526937,64
1361905171,2326549860,5,553,110.6,1361905162990,1361905163182,2326541850,2326542042,192
1361905179,2326557384,5,553,110.6,1361905178506,1361905178698,2326556890,2326557082,192
1361905195,2326573356,5,553,110.6,1361905193509,1361905193637,2326571865,2326571993,128
1361905211,2326589340,5,553,110.6,1361905208502,1361905208630,2326586842,2326586970,128
1361905227,2326605364,6,2062,343.6666667,1361905223519,1361905223583,2326601883,2326601947,64
1361905238,2326617040,1,46,46,1361905211321,1361905211321,2326590361,2326590361,0
1361905243,2326621512,5,553,110.6,1361905238345,1361905238409,2326616857,2326616921,64
1361905259,2326637484,5,553,110.6,1361905253348,1361905253476,2326631832,2326631960,128
1361905269,2326055240,1,52,52,1361905242682,1361905242682,2326028922,2326028922,0
1361905269,2326055284,1,52,52,1361905243661,1361905243661,2326029945,2326029945,0
1361905269,2326055284,1,52,52,1361905243724,1361905243724,2326030008,2326030008,0
1361905269,2326055292,1,52,52,1361905244101,1361905244101,2326030393,2326030393,0
1361905269,2326055356,1,52,52,1361905242566,1361905242566,2326028922,2326028922,0
1361905269,2326055396,1,52,52,1361905243548,1361905243548,2326029944,2326029944,0
1361905275,2326653408,6,1789,298.1666667,1361905268467,1361905268531,2326646875,2326646939,64
1361905291,2326669368,6,1789,298.1666667,1361905283482,1361905283610,2326661850,2326661978,128
1361905299,2326677444,7,2131,304.4285714,1361905298382,1361905298574,2326676826,2326677018,192
1361905301,2326087328,1,52,52,1361905275105,1361905275105,2326061433,2326061433,0
1361905301,2326087328,1,52,52,1361905275104,1361905275104,2326061432,2326061432,0
1361905301,2326087352,1,52,52,1361905275658,1361905275658,2326062010,2326062010,0
1361905301,2326087440,1,52,52,1361905274799,1361905274799,2326061239,2326061239,0
1361905301,2326087444,1,52,52,1361905275118,1361905275118,2326061562,2326061562,0
1361905313,2326099348,1,52,52,1361905287757,1361905287757,2326074105,2326074105,0
1361905313,2326099464,1,52,52,1361905287643,1361905287643,2326074107,2326074107,0
1361905313,2326099484,1,52,52,1361905288389,1361905288389,2326074873,2326074873,0
1361905315,2326693496,5,553,110.6,1361905313367,1361905313559,2326691863,2326692055,192
1361905317,2326103248,1,52,52,1361905288947,1361905288947,2326075195,2326075195,0
1361905317,2326103392,1,52,52,1361905290274,1361905290274,2326076666,2326076666,0
1361905331,2326709516,5,553,110.6,1361905328323,1361905328451,2326706839,2326706967,128
1361905346,2326725104,1,76,76,1361905320631,1361905320631,2326699735,2326699735,0
1361905347,2326725564,7,3304,472,1361905343317,1361905343381,2326721881,2326721945,64
1361905363,2326741560,7,3304,472,1361905358295,1361905358359,2326736855,2326736919,64
1361905380,2326758584,1,48,48,1361905350912,1361905350912,2326729496,2326729496,0
1361905381,2326759268,5,553,110.6,1361905373563,1361905373691,2326751831,2326751959,128
1361905395,2326773764,5,1677,335.4,1361905388109,1361905388685,2326766873,2326767449,576
1361905411,2326789860,6,3008,501.3333333,1361905402985,1361905404521,2326781845,2326783381,1536
1361905427,2326806016,5,553,110.6,1361905417873,1361905420753,2326796889,2326799769,2880
1361905443,2326821960,6,1836,306,1361905432904,1361905437704,2326811864,2326816664,4800
1361905459,2326837960,5,553,110.6,1361905447879,1361905453575,2326826839,2326832535,5696
1361905475,2326853932,5,553,110.6,1361905462947,1361905468067,2326841879,2326846999,5120
1361905483,2326862016,7,3980,568.5714286,1361905477836,1361905481100,2326856852,2326860116,3264
1361905499,2326878092,7,3635,519.2857143,1361905492736,1361905493120,2326871828,2326872212,384
1361905515,2326894132,7,3731,533,1361905507738,1361905507802,2326886870,2326886934,64
1361905523,2326902032,4,501,125.25,1361905522812,1361905522876,2326901844,2326901908,64
1361905540,2326918244,6,3213,535.5,1361905538643,1361905538707,2326916887,2326916951,64
1361905551,2326929432,1,52,52,1361905523542,1361905523542,2326901974,2326901974,0
1361905555,2326934096,6,1807,301.1666667,1361905554427,1361905554555,2326933523,2326933651,128
1361905572,2326950272,6,2351,391.8333333,1361905570290,1361905570354,2326948562,2326948626,64
1361905587,2326966168,6,3157,526.1666667,1361905584374,1361905584502,2326963542,2326963670,128
1361905603,2326982152,5,553,110.6,1361905599429,1361905599493,2326978581,2326978645,64
1361905620,2326998292,5,553,110.6,1361905615263,1361905615391,2326993555,2326993683,128
1361905636,2327014296,5,553,110.6,1361905630234,1361905630362,2327008530,2327008658,128
1361905652,2327030308,6,1916,319.3333333,1361905645264,1361905645328,2327023572,2327023636,64
1361905668,2327046256,5,553,110.6,1361905660292,1361905660420,2327038548,2327038676,128
1361905676,2327054408,5,553,110.6,1361905675178,1361905675242,2327053586,2327053650,64
1361905692,2327070372,5,553,110.6,1361905690191,1361905690255,2327068563,2327068627,64
1361905708,2327086292,6,1835,305.8333333,1361905705246,1361905705374,2327083538,2327083666,128
1361905724,2327102304,5,553,110.6,1361905720276,1361905720340,2327098580,2327098644,64
1361905740,2327118348,5,553,110.6,1361905735204,1361905735332,2327113552,2327113680,128
1361905756,2327134464,5,553,110.6,1361905750065,1361905750193,2327128529,2327128657,128
1361905772,2327150416,5,553,110.6,1361905765154,1361905765218,2327143570,2327143634,64
1361905788,2327166440,6,1877,312.8333333,1361905780105,1361905780233,2327158545,2327158673,128
1361905797,2327175524,1,46,46,1361905768692,1361905768692,2327147216,2327147216,0
1361905798,2327176268,4,1794,448.5,1361905770423,1361905770487,2327148691,2327148755,64
1361905798,2327176268,47,61081,1299.595745,1361905770803,1361905771891,2327149071,2327150159,1088
1361905799,2327177660,7,3551,507.2857143,1361905794925,1361905794989,2327173585,2327173649,64
1361905813,2327191364,7,4392,627.4285714,1361905810198,1361905810326,2327188562,2327188690,128
1361905829,2327207384,5,553,110.6,1361905825154,1361905825282,2327203538,2327203666,128
1361905845,2327223396,5,553,110.6,1361905840180,1361905840244,2327218576,2327218640,64
1361906044,2327422812,1,68,68,1361906018962,1361906018962,2327397774,2327397774,0
1361906128,2327507004,7,2473,353.2857143,1361906100176,1361906100496,2327479180,2327479500,320
1361906141,2327519936,4,208,52,1361906134100,1361906139540,2327513036,2327518476,5440
1361906141,2327519968,5,306,61.2,1361906135668,1361906138868,2327514636,2327517836,3200
1361906168,2327547168,9,2302,255.7777778,1361906140972,1361906143148,2327520140,2327522316,2176
1361906168,2327547172,21,5891,280.5238095,1361906141159,1361906162151,2327520331,2327541323,20992
1361906209,2327587296,2,114,57,1361906182417,1361906182417,2327560713,2327560713,0
1361906213,2327591880,15,3755,250.3333333,1361906208714,1361906210698,2327587594,2327589578,1984
1361906213,2327592004,19,4783,251.7368421,1361906210829,1361906212557,2327589833,2327591561,1728
1361906241,2327619596,9,3465,385,1361906213671,1361906214695,2327592267,2327593291,1024
1361906245,2327623552,1,68,68,1361906220307,1361906220307,2327598859,2327598859,0
1361906313,2327691564,2,114,57,1361906285255,1361906285383,2327663819,2327663947,128
1361906341,2327720120,2,131,65.5,1361906334106,1361906334106,2327713226,2327713226,0
1361906342,2327720168,2,92,46,1361906341328,1361906341584,2327719496,2327719752,256
1361906461,2327840004,2,114,57,1361906435340,1361906435340,2327814344,2327814344,0
1361906943,2328321516,1,68,68,1361906916075,1361906916075,2328294591,2328294591,0
1361907031,2328409796,7,2473,353.2857143,1361907003923,1361907004243,2328382719,2328383039,320
1361907046,2328425012,5,306,61.2,1361907038971,1361907042299,2328417983,2328421311,3328
1361907046,2328425092,3,156,52,1361907038058,1361907041706,2328417150,2328420798,3648
1361907071,2328449860,22,5959,270.8636364,1361907043219,1361907063699,2328422079,2328442559,20480
1361907071,2328449860,9,2302,255.7777778,1361907043218,1361907044946,2328422078,2328423806,1728
1361907111,2328489840,2,114,57,1361907083558,1361907083558,2328462398,2328462398,0
1361907147,2328525844,1,68,68,1361907120546,1361907120546,2328499390,2328499390,0
1361907211,2328589952,1,68,68,1361907186291,1361907186291,2328565243,2328565243,0
1361907247,2328625232,2,92,46,1361907244804,1361907245060,2328623036,2328623292,256
1361907294,2328673136,4,964,241,1361907282812,1361907289148,2328661948,2328668284,6336
1361907294,2328673144,4,1317,329.25,1361907283060,1361907289140,2328662204,2328668284,6080
1361907295,2328673172,11,6036,548.7272727,1361907281086,1361907288382,2328659258,2328666554,7296
1361907295,2328673232,27,33012,1222.666667,1361907279873,1361907290049,2328658105,2328668281,10176
1361907295,2328673264,4,399,99.75,1361907284515,1361907290211,2328662779,2328668475,5696
1361907295,2328673308,18,19913,1106.277778,1361907283637,1361907289973,2328661945,2328668281,6336
1361907299,2328678072,1,52,52,1361907272505,1361907272505,2328651577,2328651577,0
1361907307,2328686132,5,4282,856.4,1361907281662,1361907282110,2328660794,2328661242,448
1361907339,2328718124,9,3563,395.8888889,1361907313221,1361907314117,2328692345,2328693241,896
1361907339,2328718152,1,184,184,1361907314217,1361907314217,2328693369,2328693369,0
1361907348,2328726228,2,114,57,1361907321733,1361907321733,2328699961,2328699961,0
1361907367,2328745244,5,1670,334,1361907360821,1361907361973,2328739065,2328740217,1152
1361907387,2328766124,9,3465,385,1361907359942,1361907361542,2328739066,2328740666,1600
1361907399,2328777360,3,176,58.66666667,1361907397955,1361907398339,2328776315,2328776699,384
1361907399,2328777452,2,104,52,1361907397539,1361907398115,2328775991,2328776567,576
1361907407,2328785324,3,156,52,1361907399269,1361907405605,2328777593,2328783929,6336
1361907424,2328802232,4,260,65,1361907399360,1361907411584,2328777592,2328789816,12224
1361907431,2328809464,2,104,52,1361907413911,1361907423895,2328792375,2328802359,9984
1361907447,2328825368,2,104,52,1361907433977,1361907443961,2328812345,2328822329,9984
1361907452,2328830284,1,65,65,1361907425549,1361907425549,2328803833,2328803833,0
1361907480,2328858640,1,52,52,1361907453737,1361907453737,2328832377,2328832377,0
1361907484,2328863108,1,46,46,1361907455571,1361907455571,2328834679,2328834679,0
1361907487,2328865424,4,289,72.25,1361907482177,1361907484673,2328860601,2328863097,2496
1361907495,2328873404,2,158,79,1361907488018,1361907494674,2328866422,2328873078,6656
1361907524,2328902580,22,5959,270.8636364,1361907499362,1361907521378,2328877942,2328899958,22016
1361907524,2328902584,10,2482,248.2,1361907499423,1361907501151,2328878007,2328879735,1728
1361907527,2328905584,2,104,52,1361907522592,1361907522848,2328901176,2328901432,256
1361907528,2328906636,8,3223,402.875,1361907501227,1361907503339,2328879863,2328881975,2112
1361907536,2328914480,1,79,79,1361907507974,1361907507974,2328886454,2328886454,0
1361907564,2328942732,2,114,57,1361907539337,1361907539401,2328918069,2328918133,64
1361907580,2328958668,1,52,52,1361907554505,1361907554505,2328933173,2328933173,0
1361907604,2328982864,2,114,57,1361907579333,1361907579461,2328958197,2328958325,128
1361907668,2329046676,1,74,74,1361907640065,1361907640065,2329018741,2329018741,0
1361907684,2329063004,3,138,46,1361907659194,1361907667258,2329038198,2329046262,8064
1361907696,2329074848,19,5777,304.0526316,1361907668755,1361907693203,2329047603,2329072051,24448
1361907716,2329094808,1,46,46,1361907690428,1361907690428,2329069236,2329069236,0
1361907724,2329102932,3,182,60.66666667,1361907697601,1361907707521,2329076533,2329086453,9920
1361907752,2329130896,1,68,68,1361907727652,1361907727652,2329106548,2329106548,0
1361907768,2329146804,1,52,52,1361907743166,1361907743166,2329121970,2329121970,0
1361907788,2329166828,1,68,68,1361907762405,1361907762405,2329141233,2329141233,0
1361908093,2329471428,1,68,68,1361908066738,1361908066738,2329445166,2329445166,0
1361908093,2329471556,1,52,52,1361908067572,1361908067572,2329446128,2329446128,0
1361908159,2329537924,4,241,60.25,1361908156931,1361908158083,2329535855,2329537007,1152
1361908159,2329538044,2,104,52,1361908157834,1361908158602,2329536878,2329537646,768
1361908167,2329546044,2,104,52,1361908160073,1361908163017,2329539117,2329542061,2944
1361908183,2329561992,2,104,52,1361908168956,1361908178940,2329547948,2329557932,9984
1361908185,2329563872,4,260,65,1361908159606,1361908180470,2329538478,2329559342,20864
1361908207,2329585984,2,104,52,1361908188933,1361908198917,2329567917,2329577901,9984
1361908229,2329607972,1,65,65,1361908204242,1361908204242,2329583214,2329583214,0
1361908237,2329615916,1,52,52,1361908209032,1361908209032,2329587948,2329587948,0
1361909633,2331011836,20,3840,192,1361909621315,1361909626563,2331000151,2331005399,5248
1361909641,2331019864,9,10791,1199,1361909640229,1361909640485,2331019093,2331019349,256
1361909641,2331019936,4,803,200.75,1361909639839,1361909640159,2331018775,2331019095,320
1361909649,2331027752,6,3195,532.5,1361909640536,1361909646360,2331019288,2331025112,5824
1361909649,2331027752,38,45234,1190.368421,1361909640535,1361909647447,2331019287,2331026199,6912
1361909649,2331027752,19,19332,1017.473684,1361909640535,1361909646423,2331019287,2331025175,5888
1361909649,2331027756,29,21209,731.3448276,1361909640916,1361909646804,2331019672,2331025560,5888
1361909649,2331027760,4,1336,334,1361909641232,1361909641360,2331019992,2331020120,128
1361909649,2331027768,7,2401,343,1361909642311,1361909647367,2331021079,2331026135,5056
1361909649,2331027768,20,12643,632.15,1361909642375,1361909646599,2331021143,2331025367,4224
1361909649,2331027768,25,20479,819.16,1361909642311,1361909646599,2331021079,2331025367,4288
1361909649,2331027832,38,36538,961.5263158,1361909640840,1361909646728,2331019672,2331025560,5888
1361909649,2331027844,14,7488,534.8571429,1361909642233,1361909646457,2331021077,2331025301,4224
1361909649,2331027880,18,16837,935.3888889,1361909640406,1361909646230,2331019286,2331025110,5824
1361909649,2331027880,14,13042,931.5714286,1361909640406,1361909646230,2331019286,2331025110,5824
1361909649,2331027884,11,5851,531.9090909,1361909640405,1361909646293,2331019289,2331025177,5888
1361909657,2331035860,6,2078,346.3333333,1361909649131,1361909649643,2331027991,2331028503,512
1361909657,2331035860,16,15823,988.9375,1361909649131,1361909650027,2331027991,2331028887,896
1361909657,2331035864,6,3309,551.5,1361909649448,1361909655272,2331028312,2331034136,5824
1361909657,2331035864,8,4900,612.5,1361909649575,1361909650023,2331028439,2331028887,448
1361909657,2331035900,5,2509,501.8,1361909643268,1361909649220,2331022168,2331028120,5952
1361909657,2331035940,6,3008,501.3333333,1361909649052,1361909649564,2331027992,2331028504,512
1361909657,2331036012,13,12152,934.7692308,1361909647764,1361909649428,2331026776,2331028440,1664
1361909665,2331043672,51,69259,1358.019608,1361909640553,1361909640873,2331019225,2331019545,320
1361909665,2331043672,7,6527,932.4285714,1361909640553,1361909640617,2331019225,2331019289,64
1361909665,2331043816,17,20472,1204.235294,1361909640405,1361909641173,2331019221,2331019989,768
1361909665,2331043824,37,48492,1310.594595,1361909640399,1361909641039,2331019223,2331019863,640
1361909665,2331043864,6,1405,234.1666667,1361909660646,1361909661158,2331039510,2331040022,512
1361909665,2331043864,6,1515,252.5,1361909660710,1361909661222,2331039574,2331040086,512
1361909665,2331043864,6,1741,290.1666667,1361909660773,1361909661477,2331039637,2331040341,704
1361909665,2331043868,6,1445,240.8333333,1361909660769,1361909661473,2331039637,2331040341,704
1361909665,2331043872,6,1519,253.1666667,1361909661216,1361909661728,2331040088,2331040600,512
1361909665,2331043876,6,1565,260.8333333,1361909661467,1361909661915,2331040343,2331040791,448
1361909665,2331043880,20,21516,1075.8,1361909661720,1361909663512,2331040600,2331042392,1792
1361909665,2331043880,13,11312,870.1538462,1361909661910,1361909663062,2331040790,2331041942,1152
1361909665,2331043880,11,9828,893.4545455,1361909661910,1361909663062,2331040790,2331041942,1152
1361909665,2331043908,8,5227,653.375,1361909659259,1361909659771,2331038167,2331038679,512
1361909665,2331043912,6,1381,230.1666667,1361909659256,1361909659768,2331038168,2331038680,512
1361909665,2331043912,6,1525,254.1666667,1361909659256,1361909659768,2331038168,2331038680,512
1361909665,2331043912,6,1289,214.8333333,1361909659766,1361909660278,2331038678,2331039190,512
1361909665,2331043912,6,1727,287.8333333,1361909659766,1361909660278,2331038678,2331039190,512
1361909665,2331043916,15,14970,998,1361909663283,1361909664115,2331042199,2331043031,832
1361909665,2331043916,6,1485,247.5,1361909660273,1361909660657,2331039189,2331039573,384
1361909665,2331043916,6,1725,287.5,1361909660273,1361909660721,2331039189,2331039637,448
1361909665,2331043916,6,1381,230.1666667,1361909660273,1361909660721,2331039189,2331039637,448
1361909665,2331043920,6,1381,230.1666667,1361909660272,1361909660720,2331039192,2331039640,448
1361909665,2331043944,6,1519,253.1666667,1361909660694,1361909661398,2331039638,2331040342,704
1361909665,2331043944,6,1471,245.1666667,1361909660694,1361909661398,2331039638,2331040342,704
1361909665,2331043948,136,179686,1321.220588,1361909649043,1361909658003,2331027991,2331036951,8960
1361909665,2331043948,6,1567,261.1666667,1361909661138,1361909661650,2331040086,2331040598,512
1361909665,2331043952,10,6566,656.6,1361909661392,1361909661840,2331040344,2331040792,448
1361909665,2331043952,6,1413,235.5,1361909661391,1361909661839,2331040343,2331040791,448
1361909665,2331043952,18,19091,1060.611111,1361909661645,1361909663245,2331040597,2331042197,1600
1361909665,2331043956,19,20002,1052.736842,1361909657994,1361909659210,2331036950,2331038166,1216
1361909665,2331043988,6,1631,271.8333333,1361909659177,1361909659689,2331038165,2331038677,512
1361909665,2331043988,24,27578,1149.083333,1361909659180,1361909660524,2331038168,2331039512,1344
1361909665,2331043988,6,1479,246.5,1361909659180,1361909659692,2331038168,2331038680,512
1361909665,2331043988,4,2446,611.5,1361909662890,1361909663018,2331041878,2331042006,128
1361909665,2331043992,6,1649,274.8333333,1361909659687,1361909660199,2331038679,2331039191,512
1361909665,2331043992,6,1447,241.1666667,1361909659687,1361909660199,2331038679,2331039191,512
1361909665,2331043992,6,1631,271.8333333,1361909659687,1361909660199,2331038679,2331039191,512
1361909665,2331043992,8,3546,443.25,1361909659941,1361909661733,2331038933,2331040725,1792
1361909665,2331043996,6,1543,257.1666667,1361909660196,1361909660644,2331039192,2331039640,448
1361909665,2331043996,4,414,103.5,1361909644323,1361909660131,2331023319,2331039127,15808
1361909665,2331043996,3,703,234.3333333,1361909663458,1361909663522,2331042454,2331042518,64
1361909669,2331047444,19,21028,1106.736842,1361909641098,1361909660618,2331019542,2331039062,19520
1361909669,2331047528,17,21413,1259.588235,1361909643064,1361909643064,2331021592,2331021592,0
1361909669,2331047528,3,872,290.6666667,1361909643064,1361909643064,2331021592,2331021592,0
1361909669,2331047532,41,51769,1262.658537,1361909643378,1361909643954,2331021910,2331022486,576
1361909669,2331047540,9,4535,503.8888889,1361909643817,1361909645097,2331022357,2331023637,1280
1361909669,2331047560,3,624,208,1361909644118,1361909644310,2331022678,2331022870,192
1361909669,2331047572,1,52,52,1361909640972,1361909640972,2331019544,2331019544,0
1361909669,2331047648,15,13335,889,1361909642431,1361909643455,2331021079,2331022103,1024
1361909669,2331047656,7,4671,667.2857143,1361909642935,1361909643511,2331021591,2331022167,576
1361909669,2331047656,37,48538,1311.837838,1361909642935,1361909643703,2331021591,2331022359,768
1361909669,2331047656,10,9733,973.3,1361909642935,1361909643511,2331021591,2331022167,576
1361909669,2331047692,3,580,193.3333333,1361909643603,1361909643603,2331022295,2331022295,0
1361909669,2331047696,15,16528,1101.866667,1361909643536,1361909643664,2331022232,2331022360,128
1361909669,2331047728,6,1561,260.1666667,1361909644527,1361909659375,2331023255,2331038103,14848
1361909673,2331051832,4,795,198.75,1361909665415,1361909666439,2331044247,2331045271,1024
1361909673,2331051836,35,42624,1217.828571,1361909661508,1361909665348,2331040344,2331044184,3840
1361909673,2331051840,43,52754,1226.837209,1361909661951,1361909666495,2331040791,2331045335,4544
1361909673,2331051840,10,7520,752,1361909666365,1361909667965,2331045205,2331046805,1600
1361909673,2331051876,17,18143,1067.235294,1361909663068,1361909665308,2331041944,2331044184,2240
1361909673,2331051876,3,716,238.6666667,1361909667803,1361909667931,2331046679,2331046807,128
1361909673,2331051876,7,3422,488.8571429,1361909667931,1361909668315,2331046807,2331047191,384
1361909673,2331051876,16,15836,989.75,1361909668122,1361909669146,2331046998,2331048022,1024
1361909673,2331051880,7,429,61.28571429,1361909663831,1361909665367,2331042711,2331044247,1536
1361909673,2331051912,20,20854,1042.7,1361909665270,1361909666294,2331044182,2331045206,1024
1361909673,2331051912,4,709,177.25,1361909665334,1361909666294,2331044246,2331045206,960
1361909673,2331051912,30,35769,1192.3,1361909665397,1361909668533,2331044309,2331047445,3136
1361909673,2331051916,44,54060,1228.636364,1361909665393,1361909670257,2331044309,2331049173,4864
1361909673,2331051924,6,1514,252.3333333,1361909666412,1361909667820,2331045336,2331046744,1408
1361909673,2331051924,9,6200,688.8888889,1361909666412,1361909668076,2331045336,2331047000,1664
1361909673,2331051948,60,79425,1323.75,1361909659155,1361909669395,2331038103,2331048343,10240
1361909673,2331051952,18,19503,1083.5,1361909662992,1361909665232,2331041944,2331044184,2240
1361909673,2331051956,5,594,118.8,1361909668235,1361909668555,2331047191,2331047511,320
1361909673,2331051956,4,686,171.5,1361909659851,1361909669963,2331038807,2331048919,10112
1361909673,2331051960,4,876,219,1361909660168,1361909666184,2331039128,2331045144,6016
1361909673,2331051960,10,8624,862.4,1361909663430,1361909665222,2331042390,2331044182,1792
1361909673,2331051960,21,25369,1208.047619,1361909663686,1361909665286,2331042646,2331044246,1600
1361909676,2330461756,8,7604,950.5,1361909649905,1361909649969,2330435661,2330435725,64
1361909677,2331055620,9,8222,913.5555556,1361909649753,1361909662105,2331028373,2331040725,12352
1361909680,2330466020,5,1227,245.4,1361909676971,1361909677483,2330462991,2330463503,512
1361909680,2330466024,9,3818,424.2222222,1361909674087,1361909677479,2330460111,2330463503,3392
1361909680,2330466040,4,1159,289.75,1361909677463,1361909677463,2330463503,2330463503,0
1361909680,2330466108,31,39044,1259.483871,1361909677329,1361909677457,2330463437,2330463565,128
1361909680,2330466108,31,39044,1259.483871,1361909677393,1361909677457,2330463501,2330463565,64
1361909681,2331059844,3,502,167.3333333,1361909676796,1361909676796,2331055640,2331055640,0
1361909681,2331059844,3,580,193.3333333,1361909676859,1361909676859,2331055703,2331055703,0
1361909681,2331059844,3,634,211.3333333,1361909676922,1361909676986,2331055766,2331055830,64
1361909681,2331059844,4,592,148,1361909676921,1361909677369,2331055765,2331056213,448
1361909681,2331059844,18,21404,1189.111111,1361909676921,1361909677369,2331055765,2331056213,448
1361909681,2331059844,3,642,214,1361909676985,1361909677049,2331055829,2331055893,64
1361909681,2331059848,3,633,211,1361909677045,1361909677109,2331055893,2331055957,64
1361909681,2331059848,6,2772,462,1361909677112,1361909677368,2331055960,2331056216,256
1361909681,2331059852,6,2439,406.5,1361909677364,1361909677684,2331056216,2331056536,320
1361909681,2331059856,2,92,46,1361909674159,1361909674159,2331053015,2331053015,0
1361909681,2331059884,4,728,182,1361909674771,1361909675795,2331053655,2331054679,1024
1361909681,2331059888,8,2566,320.75,1361909662989,1361909678093,2331041877,2331056981,15104
1361909681,2331059892,3,768,256,1361909675785,1361909675849,2331054677,2331054741,64
1361909681,2331059896,3,776,258.6666667,1361909675845,1361909675909,2331054741,2331054805,64
1361909681,2331059896,62,79156,1276.709677,1361909667912,1361909674568,2331046808,2331053464,6656
1361909681,2331059928,12,8966,747.1666667,1361909668776,1361909677352,2331047704,2331056280,8576
1361909681,2331059928,11,5904,536.7272727,1361909676904,1361909677352,2331055832,2331056280,448
1361909681,2331059928,16,16400,1025,1361909676904,1361909677480,2331055832,2331056408,576
1361909681,2331059928,11,5905,536.8181818,1361909676904,1361909677352,2331055832,2331056280,448
1361909681,2331059928,3,279,93,1361909676967,1361909677031,2331055895,2331055959,64
1361909681,2331059932,3,502,167.3333333,1361909677283,1361909677347,2331056215,2331056279,64
1361909681,2331059932,5,623,124.6,1361909677346,1361909677410,2331056278,2331056342,64
1361909681,2331059960,5,2085,417,1361909662021,1361909673029,2331040981,2331051989,11008
1361909681,2331059964,6,2069,344.8333333,1361909674177,1361909674305,2331053141,2331053269,128
1361909681,2331059964,12,3772,314.3333333,1361909662147,1361909678467,2331041111,2331057431,16320
1361909681,2331059964,21,25407,1209.857143,1361909674496,1361909674688,2331053460,2331053652,192
1361909681,2331059968,2,131,65.5,1361909674687,1361909674687,2331053655,2331053655,0
1361909681,2331059972,47,61946,1318,1361909659132,1361909676156,2331038104,2331055128,17024
1361909681,2331059976,3,735,245,1361909675830,1361909675894,2331054806,2331054870,64
1361909681,2331059976,7,4018,574,1361909675894,1361909676662,2331054870,2331055638,768
1361909685,2331063580,1,46,46,1361909659587,1361909659587,2331038167,2331038167,0
1361909685,2331063580,13,6600,507.6923077,1361909659650,1361909674562,2331038230,2331053142,14912
1361909685,2331063624,33,39035,1182.878788,1361909660184,1361909660632,2331038808,2331039256,448
1361909685,2331063720,36,43703,1213.972222,1361909659384,1361909659704,2331038104,2331038424,320
1361909685,2331063740,39,38986,999.6410256,1361909659684,1361909660132,2331038424,2331038872,448
1361909685,2331063744,23,25352,1102.26087,1361909659871,1361909660127,2331038615,2331038871,256
1361909685,2331063744,14,12457,889.7857143,1361909659871,1361909660127,2331038615,2331038871,256
1361909685,2331063752,2,310,155,1361909660375,1361909660503,2331039127,2331039255,128
1361909688,2330473580,11,11780,1070.909091,1361909660321,1361909660385,2330445901,2330445965,64
1361909688,2330474004,59,75331,1276.79661,1361909663288,1361909665400,2330449292,2330451404,2112
1361909689,2331067524,3,1862,620.6666667,1361909662268,1361909662460,2331040792,2331040984,192
1361909689,2331067524,22,11234,510.6363636,1361909662331,1361909674235,2331040855,2331052759,11904
1361909689,2331067568,4,575,143.75,1361909663631,1361909683599,2331042199,2331062167,19968
1361909689,2331067780,10,2992,299.2,1361909663097,1361909663545,2331041877,2331042325,448
1361909689,2331067780,4,466,116.5,1361909663227,1361909683003,2331042007,2331061783,19776
1361909689,2331067780,6,3306,551,1361909663097,1361909664569,2331041877,2331043349,1472
1361909689,2331067800,2,397,198.5,1361909663336,1361909663400,2331042136,2331042200,64
1361909689,2331067800,15,15572,1038.133333,1361909663526,1361909666214,2331042326,2331045014,2688
1361909689,2331067804,11,4065,369.5454545,1361909663587,1361909664867,2331042391,2331043671,1280
1361909689,2331067892,10,3824,382.4,1361909677385,1361909685129,2331056277,2331064021,7744
1361909689,2331067900,4,685,171.25,1361909674116,1361909684164,2331053016,2331063064,10048
1361909689,2331067968,9,3107,345.2222222,1361909673085,1361909688509,2331052053,2331067477,15424
1361909689,2331068004,12,10948,912.3333333,1361909678105,1361909688409,2331057109,2331067413,10304
1361909689,2331068004,11,4094,372.1818182,1361909678169,1361909682777,2331057173,2331061781,4608
1361909692,2330477584,38,49186,1294.368421,1361909663903,1361909674463,2330449487,2330460047,10560
1361909692,2330477648,5,2771,554.2,1361909665757,1361909665757,2330451405,2330451405,0
1361909693,2331071680,1,46,46,1361909665504,1361909665504,2331044184,2331044184,0
1361909693,2331071716,3,1082,360.6666667,1361909666297,1361909666361,2331045013,2331045077,64
1361909693,2331071764,5,4352,870.4,1361909668425,1361909668553,2331047189,2331047317,128
1361909700,2330485776,7,6095,870.7142857,1361909674334,1361909674334,2330460110,2330460110,0
1361909705,2331083500,1,52,52,1361909677264,1361909677264,2331055764,2331055764,0
1361909705,2331083716,1,52,52,1361909677049,1361909677049,2331055765,2331055765,0
1361909705,2331083780,5,593,118.6,1361909678331,1361909699451,2331057111,2331078231,21120
1361909709,2331087604,29,36480,1257.931034,1361909683756,1361909684268,2331062360,2331062872,512
1361909709,2331087808,4,916,229,1361909683040,1361909683296,2331061848,2331062104,256
1361909713,2331091920,4,572,143,1361909709548,1361909709868,2331088468,2331088788,320
1361909713,2331091944,13,13547,1042.076923,1361909709845,1361909709973,2331088789,2331088917,128
1361909713,2331091944,17,17842,1049.529412,1361909709845,1361909710037,2331088789,2331088981,192
1361909713,2331091944,19,21977,1156.684211,1361909709845,1361909710485,2331088789,2331089429,640
1361909713,2331091944,40,52738,1318.45,1361909709845,1361909710805,2331088789,2331089749,960
1361909713,2331091944,32,40172,1255.375,1361909709845,1361909711061,2331088789,2331090005,1216
1361909713,2331091944,27,33233,1230.851852,1361909709845,1361909710677,2331088789,2331089621,832
1361909713,2331091944,4,2902,725.5,1361909709845,1361909710869,2331088789,2331089813,1024
1361909713,2331091948,17,18932,1113.647059,1361909709971,1361909710547,2331088919,2331089495,576
1361909713,2331091952,47,60034,1277.319149,1361909710477,1361909711565,2331089429,2331090517,1088
1361909713,2331091956,18,21199,1177.722222,1361909710539,1361909711179,2331089495,2331090135,640
1361909713,2331091956,10,9770,977,1361909707466,1361909708042,2331086422,2331086998,576
1361909713,2331091956,36,45618,1267.166667,1361909710666,1361909711306,2331089622,2331090262,640
1361909713,2331091960,33,42040,1273.939394,1361909707716,1361909708100,2331086676,2331087060,384
1361909713,2331091960,8,4794,599.25,1361909707716,1361909707908,2331086676,2331086868,192
1361909713,2331091960,8,6991,873.875,1361909707716,1361909707908,2331086676,2331086868,192
1361909713,2331091960,6,4107,684.5,1361909710855,1361909711175,2331089815,2331090135,320
1361909713,2331091960,14,13512,965.1428571,1361909710919,1361909711495,2331089879,2331090455,576
1361909713,2331091960,45,58631,1302.911111,1361909710919,1361909711303,2331089879,2331090263,384
1361909713,2331091960,6,1728,288,1361909708101,1361909708293,2331087061,2331087253,192
1361909713,2331091964,67,90038,1343.850746,1361909711170,1361909712322,2331090134,2331091286,1152
1361909713,2331091964,8,5238,654.75,1361909711234,1361909712066,2331090198,2331091030,832
1361909713,2331091964,12,9002,750.1666667,1361909711553,1361909712321,2331090517,2331091285,768
1361909713,2331091988,14,10404,743.1428571,1361909711658,1361909712298,2331090646,2331091286,640
1361909713,2331091988,4,1889,472.25,1361909711721,1361909712297,2331090709,2331091285,576
1361909713,2331092028,16,17584,1099,1361909709507,1361909709763,2331088535,2331088791,256
1361909713,2331092028,107,142509,1331.859813,1361909709569,1361909710849,2331088597,2331089877,1280
1361909713,2331092032,25,29207,1168.28,1361909709758,1361909709950,2331088790,2331088982,192
1361909713,2331092032,26,32287,1241.807692,1361909709758,1361909710590,2331088790,2331089622,832
1361909713,2331092032,26,29612,1138.923077,1361909709758,1361909711102,2331088790,2331090134,1344
1361909713,2331092032,6,1681,280.1666667,1361909709758,1361909710398,2331088790,2331089430,640
1361909713,2331092032,9,1634,181.5555556,1361909709821,1361909710781,2331088853,2331089813,960
1361909713,2331092032,35,42006,1200.171429,1361909709757,1361909710717,2331088789,2331089749,960
1361909713,2331092032,62,83741,1350.66129,1361909709757,1361909710781,2331088789,2331089813,1024
1361909713,2331092032,19,22352,1176.421053,1361909709757,1361909710461,2331088789,2331089493,704
1361909713,2331092032,41,52238,1274.097561,1361909709757,1361909711613,2331088789,2331090645,1856
1361909713,2331092032,37,45608,1232.648649,1361909709757,1361909711101,2331088789,2331090133,1344
1361909713,2331092032,4,592,148,1361909709821,1361909709949,2331088853,2331088981,128
1361909713,2331092040,38,47281,1244.236842,1361909710454,1361909711286,2331089494,2331090326,832
1361909713,2331092040,64,80936,1264.625,1361909710581,1361909712245,2331089621,2331091285,1664
1361909713,2331092044,7,3509,501.2857143,1361909707632,1361909707760,2331086676,2331086804,128
1361909713,2331092044,6,2358,393,1361909707632,1361909707824,2331086676,2331086868,192
1361909713,2331092044,5,796,159.2,1361909707632,1361909707824,2331086676,2331086868,192
1361909713,2331092044,26,31919,1227.653846,1361909710707,1361909711091,2331089751,2331090135,384
1361909713,2331092044,45,54942,1220.933333,1361909710707,1361909712307,2331089751,2331091351,1600
1361909713,2331092072,88,119047,1352.806818,1361909710936,1361909711384,2331090008,2331090456,448
1361909713,2331092072,29,36837,1270.241379,1361909711063,1361909711447,2331090135,2331090519,384
1361909713,2331092072,23,26889,1169.086957,1361909711063,1361909712215,2331090135,2331091287,1152
1361909713,2331092072,13,13155,1011.923077,1361909711190,1361909711574,2331090262,2331090646,384
1361909713,2331092072,14,15442,1103,1361909711253,1361909711573,2331090325,2331090645,320
1361909713,2331092076,28,31421,1122.178571,1361909711376,1361909712208,2331090452,2331091284,832
1361909713,2331092076,14,12902,921.5714286,1361909711442,1361909712210,2331090518,2331091286,768
1361909713,2331092076,4,2009,502.25,1361909711634,1361909712210,2331090710,2331091286,576
1361909713,2331092076,15,16666,1111.066667,1361909711570,1361909712530,2331090646,2331091606,960
1361909713,2331092076,15,14610,974,1361909711697,1361909712529,2331090773,2331091605,832
1361909713,2331092076,18,21052,1169.555556,1361909711761,1361909712529,2331090837,2331091605,768
1361909713,2331092076,15,17154,1143.6,1361909711761,1361909712529,2331090837,2331091605,768
1361909713,2331092076,5,2144,428.8,1361909712208,1361909712400,2331091284,2331091476,192
1361909717,2331095660,2,104,52,1361909689074,1361909713010,2331067734,2331091670,23936
1361909720,2330505808,5,1822,364.4,1361909711679,1361909711935,2330497487,2330497743,256
1361909720,2330505808,26,31905,1227.115385,1361909715967,1361909717439,2330501775,2330503247,1472
1361909720,2330505808,10,5816,581.6,1361909711805,1361909712829,2330497613,2330498637,1024
1361909720,2330505996,27,33015,1222.777778,1361909714050,1361909714370,2330500046,2330500366,320
1361909720,2330505996,26,32499,1249.961538,1361909714050,1361909714370,2330500046,2330500366,320
1361909720,2330506020,5,1556,311.2,1361909715372,1361909717228,2330501392,2330503248,1856
1361909720,2330506040,6,2352,392,1361909711574,1361909712534,2330497614,2330498574,960
1361909720,2330506040,8,5394,674.25,1361909711574,1361909712534,2330497614,2330498574,960
1361909720,2330506044,4,925,231.25,1361909712017,1361909712593,2330498061,2330498637,576
1361909720,2330506044,9,6711,745.6666667,1361909712017,1361909712849,2330498061,2330498893,832
1361909720,2330506048,8,6457,807.125,1361909716496,1361909717200,2330502544,2330503248,704
1361909720,2330506052,4,464,116,1361909712586,1361909712906,2330498638,2330498958,320
1361909720,2330506068,8,6147,768.375,1361909712892,1361909712956,2330498960,2330499024,64
1361909720,2330506068,4,1230,307.5,1361909713082,1361909713210,2330499150,2330499278,128
1361909720,2330506080,28,33852,1209,1361909713968,1361909714416,2330500048,2330500496,448
1361909720,2330506096,5,1167,233.4,1361909714654,1361909715230,2330500750,2330501326,576
1361909720,2330506096,5,1383,276.6,1361909714654,1361909715230,2330500750,2330501326,576
1361909720,2330506104,8,6651,831.375,1361909715288,1361909715352,2330501392,2330501456,64
1361909721,2331099880,23,26895,1169.347826,1361909712470,1361909712918,2331091350,2331091798,448
1361909721,2331099880,5,3615,723,1361909712533,1361909713301,2331091413,2331092181,768
1361909721,2331099880,30,37454,1248.466667,1361909712725,1361909715157,2331091605,2331094037,2432
1361909721,2331099880,6,2138,356.3333333,1361909712533,1361909712917,2331091413,2331091797,384
1361909721,2331099884,5,1501,300.2,1361909712784,1361909712976,2331091668,2331091860,192
1361909721,2331099884,7,861,123,1361909712788,1361909713044,2331091672,2331091928,256
1361909721,2331099884,6,2046,341,1361909712852,1361909713236,2331091736,2331092120,384
1361909721,2331099884,15,9798,653.2,1361909712850,1361909713234,2331091734,2331092118,384
1361909721,2331099884,4,817,204.25,1361909712850,1361909713042,2331091734,2331091926,192
1361909721,2331099884,15,9798,653.2,1361909712850,1361909713170,2331091734,2331092054,320
1361909721,2331099884,21,24319,1158.047619,1361909712914,1361909713170,2331091798,2331092054,256
1361909721,2331099884,17,18157,1068.058824,1361909712978,1361909713106,2331091862,2331091990,128
1361909721,2331099884,4,817,204.25,1361909712849,1361909713041,2331091733,2331091925,192
1361909721,2331099884,4,1205,301.25,1361909713041,1361909713425,2331091925,2331092309,384
1361909721,2331099884,21,24451,1164.333333,1361909712977,1361909713041,2331091861,2331091925,64
1361909721,2331099884,3,608,202.6666667,1361909717009,1361909717073,2331095893,2331095957,64
1361909721,2331099884,4,1205,301.25,1361909712977,1361909713233,2331091861,2331092117,256
1361909721,2331099884,3,2854,951.3333333,1361909712977,1361909713297,2331091861,2331092181,320
1361909721,2331099884,4,901,225.25,1361909717072,1361909717072,2331095956,2331095956,0
1361909721,2331099888,4,1205,301.25,1361909713036,1361909713420,2331091924,2331092308,384
1361909721,2331099888,5,990,198,1361909713036,1361909713292,2331091924,2331092180,256
1361909721,2331099888,5,869,173.8,1361909713232,1361909714192,2331092120,2331093080,960
1361909721,2331099888,77,93837,1218.662338,1361909713103,1361909713999,2331091991,2331092887,896
1361909721,2331099888,4,2155,538.75,1361909713231,1361909713999,2331092119,2331092887,768
1361909721,2331099888,7,5165,737.8571429,1361909713295,1361909713935,2331092183,2331092823,640
1361909721,2331099888,3,539,179.6666667,1361909717262,1361909717390,2331096150,2331096278,128
1361909721,2331099888,3,608,202.6666667,1361909713421,1361909713869,2331092309,2331092757,448
1361909721,2331099888,4,1205,301.25,1361909713420,1361909713996,2331092308,2331092884,576
1361909721,2331099888,6,996,166,1361909717388,1361909717516,2331096276,2331096404,128
1361909721,2331099892,12,9923,826.9166667,1361909713866,1361909714058,2331092758,2331092950,192
1361909721,2331099892,111,148968,1342.054054,1361909713993,1361909715529,2331092885,2331094421,1536
1361909721,2331099892,7,5656,808,1361909713865,1361909714313,2331092757,2331093205,448
1361909721,2331099892,6,2077,346.1666667,1361909713865,1361909715145,2331092757,2331094037,1280
1361909721,2331099892,2,104,52,1361909713865,1361909713993,2331092757,2331092885,128
1361909721,2331099896,117,152084,1299.863248,1361909714056,1361909715272,2331092952,2331094168,1216
1361909721,2331099896,69,91639,1328.101449,1361909709895,1361909712967,2331088791,2331091863,3072
1361909721,2331099896,13,10084,775.6923077,1361909709895,1361909713927,2331088791,2331092823,4032
1361909721,2331099896,91,123731,1359.681319,1361909709895,1361909712967,2331088791,2331091863,3072
1361909721,2331099920,4,854,213.5,1361909714543,1361909715119,2331093463,2331094039,576
1361909721,2331099920,16,16215,1013.4375,1361909714478,1361909714926,2331093398,2331093846,448
1361909721,2331099920,4,654,163.5,1361909714540,1361909715564,2331093460,2331094484,1024
1361909721,2331099924,4,569,142.25,1361909714600,1361909715176,2331093524,2331094100,576
1361909721,2331099924,5,2016,403.2,1361909715114,1361909715242,2331094038,2331094166,128
1361909721,2331099924,5,2039,407.8,1361909715114,1361909715242,2331094038,2331094166,128
1361909721,2331099924,5,1470,294,1361909715305,1361909716969,2331094229,2331095893,1664
1361909721,2331099928,4,1205,301.25,1361909715432,1361909715560,2331094360,2331094488,128
1361909721,2331099928,11,5368,488,1361909715559,1361909717031,2331094487,2331095959,1472
1361909721,2331099928,5,1941,388.2,1361909715174,1361909715302,2331094102,2331094230,128
1361909721,2331099928,208,265760,1277.692308,1361909715174,1361909716966,2331094102,2331095894,1792
1361909721,2331099928,4,653,163.25,1361909715237,1361909717029,2331094165,2331095957,1792
1361909721,2331099932,5,1480,296,1361909715492,1361909715620,2331094424,2331094552,128
1361909721,2331099932,5,1257,251.4,1361909715682,1361909715810,2331094614,2331094742,128
1361909721,2331099932,5,455,91,1361909715682,1361909716066,2331094614,2331094998,384
1361909721,2331099932,6,2637,439.5,1361909715681,1361909717025,2331094613,2331095957,1344
1361909721,2331099936,25,28050,1122,1361909711518,1361909715166,2331090454,2331094102,3648
1361909721,2331099936,88,119940,1362.954545,1361909711325,1361909713437,2331090261,2331092373,2112
1361909721,2331099956,24,27577,1149.041667,1361909711688,1361909713800,2331090644,2331092756,2112
1361909721,2331099956,5,3624,724.8,1361909712331,1361909712715,2331091287,2331091671,384
1361909721,2331099956,15,16476,1098.4,1361909712266,1361909712714,2331091222,2331091670,448
1361909721,2331099956,11,11555,1050.454545,1361909712330,1361909712650,2331091286,2331091606,320
1361909721,2331099956,15,11856,790.4,1361909716490,1361909717002,2331095446,2331095958,512
1361909721,2331099956,184,257515,1399.538043,1361909712649,1361909715081,2331091605,2331094037,2432
1361909721,2331099956,24,29893,1245.541667,1361909712649,1361909713993,2331091605,2331092949,1344
1361909721,2331099956,17,17800,1047.058824,1361909712649,1361909713801,2331091605,2331092757,1152
1361909721,2331099956,29,36159,1246.862069,1361909712649,1361909714889,2331091605,2331093845,2240
1361909721,2331099956,4,817,204.25,1361909712649,1361909712777,2331091605,2331091733,128
1361909721,2331099960,13,11457,881.3076923,1361909712708,1361909714436,2331091668,2331093396,1728
1361909721,2331099960,4,682,170.5,1361909712708,1361909712900,2331091668,2331091860,192
1361909721,2331099960,11,8800,800,1361909712774,1361909715270,2331091734,2331094230,2496
1361909721,2331099960,7,5165,737.8571429,1361909712774,1361909712966,2331091734,2331091926,192
1361909721,2331099960,11,9865,896.8181818,1361909716805,1361909716997,2331095765,2331095957,192
1361909721,2331099960,5,1720,344,1361909716869,1361909716933,2331095829,2331095893,64
1361909721,2331099964,55,72962,1326.581818,1361909712900,1361909713348,2331091864,2331092312,448
1361909721,2331099964,4,1428,357,1361909712899,1361909713155,2331091863,2331092119,256
1361909721,2331099964,6,1594,265.6666667,1361909716995,1361909717123,2331095959,2331096087,128
1361909721,2331099964,93,123288,1325.677419,1361909712963,1361909713859,2331091927,2331092823,896
1361909721,2331099964,6,1939,323.1666667,1361909713153,1361909713473,2331092117,2331092437,320
1361909721,2331099968,5,455,91,1361909713216,1361909713920,2331092184,2331092888,704
1361909721,2331099968,11,6758,614.3636364,1361909713216,1361909713856,2331092184,2331092824,640
1361909721,2331099968,5,921,184.2,1361909717183,1361909717311,2331096151,2331096279,128
1361909721,2331099968,56,70166,1252.964286,1361909713343,1361909716991,2331092311,2331095959,3648
1361909721,2331099968,6,438,73,1361909717310,1361909717438,2331096278,2331096406,128
1361909721,2331099968,19,21420,1127.368421,1361909713405,1361909713981,2331092373,2331092949,576
1361909721,2331099972,5,455,91,1361909713851,1361909714363,2331092823,2331093335,512
1361909721,2331099972,11,10336,939.6363636,1361909713851,1361909714043,2331092823,2331093015,192
1361909721,2331099972,43,52404,1218.697674,1361909713914,1361909717562,2331092886,2331096534,3648
1361909721,2331099972,12,12190,1015.833333,1361909713786,1361909714426,2331092758,2331093398,640
1361909721,2331099972,2,104,52,1361909713785,1361909713977,2331092757,2331092949,192
1361909721,2331099996,158,204852,1296.531646,1361909714018,1361909715106,2331093014,2331094102,1088
1361909721,2331099996,7,3452,493.1428571,1361909714336,1361909715104,2331093332,2331094100,768
1361909721,2331100000,77,102361,1329.363636,1361909709788,1361909712860,2331088788,2331091860,3072
1361909721,2331100000,13,10282,790.9230769,1361909709788,1361909713820,2331088788,2331092820,4032
1361909721,2331100000,43,53468,1243.44186,1361909709788,1361909714076,2331088788,2331093076,4288
1361909721,2331100000,5,1446,289.2,1361909714463,1361909715039,2331093463,2331094039,576
1361909721,2331100000,34,41632,1224.470588,1361909709791,1361909713311,2331088791,2331092311,3520
1361909721,2331100000,7,2538,362.5714286,1361909709791,1361909713311,2331088791,2331092311,3520
1361909721,2331100000,8,4732,591.5,1361909714844,1361909715164,2331093844,2331094164,320
1361909721,2331100004,6,1939,323.1666667,1361909714907,1361909715163,2331093911,2331094167,256
1361909721,2331100004,3,556,185.3333333,1361909714843,1361909715099,2331093847,2331094103,256
1361909721,2331100004,13,9982,767.8461538,1361909715034,1361909715162,2331094038,2331094166,128
1361909721,2331100004,5,3587,717.4,1361909715033,1361909715417,2331094037,2331094421,384
1361909721,2331100004,3,505,168.3333333,1361909715161,1361909716953,2331094165,2331095957,1792
1361909721,2331100004,5,2065,413,1361909715097,1361909715225,2331094101,2331094229,128
1361909721,2331100004,220,285131,1296.05,1361909715160,1361909716888,2331094164,2331095892,1728
1361909721,2331100008,4,665,166.25,1361909715224,1361909716952,2331094232,2331095960,1728
1361909721,2331100008,6,2204,367.3333333,1361909715287,1361909715607,2331094295,2331094615,320
1361909721,2331100008,5,899,179.8,1361909715287,1361909715415,2331094295,2331094423,128
1361909721,2331100008,5,455,91,1361909715287,1361909715671,2331094295,2331094679,384
1361909721,2331100008,7,5165,737.8571429,1361909715415,1361909716887,2331094423,2331095895,1472
1361909721,2331100008,95,118046,1242.589474,1361909715478,1361909716886,2331094486,2331095894,1408
1361909721,2331100008,4,510,127.5,1361909715669,1361909716949,2331094677,2331095957,1280
1361909721,2331100040,5,718,143.6,1361909711158,1361909712694,2331090198,2331091734,1536
1361909721,2331100044,5,3620,724,1361909711601,1361909712689,2331090645,2331091733,1088
1361909721,2331100048,25,30218,1208.72,1361909712302,1361909713838,2331091350,2331092886,1536
1361909721,2331100048,5,1941,388.2,1361909712238,1361909712750,2331091286,2331091798,512
1361909721,2331100048,5,1941,388.2,1361909712366,1361909712750,2331091414,2331091798,384
1361909721,2331100048,5,2086,417.2,1361909712366,1361909712750,2331091414,2331091798,384
1361909729,2331107916,2,104,52,1361909722801,1361909723057,2331101717,2331101973,256
1361909737,2331115620,1,52,52,1361909711195,1361909711195,2331089815,2331089815,0
1361909737,2331115812,1,52,52,1361909710680,1361909710680,2331089492,2331089492,0
1361909740,2330526040,1,52,52,1361909712855,1361909712855,2330498895,2330498895,0
1361909741,2331119536,1,46,46,1361909713133,1361909713133,2331091669,2331091669,0
1361909741,2331119536,2,104,52,1361909713132,1361909713900,2331091668,2331092436,768
1361909741,2331119552,1,52,52,1361909713821,1361909713821,2331092373,2331092373,0
1361909741,2331119580,27,32440,1201.481481,1361909714243,1361909738499,2331092823,2331117079,24256
1361909741,2331119664,1,52,52,1361909713007,1361909713007,2331091671,2331091671,0
1361909741,2331119664,2,104,52,1361909713007,1361909713647,2331091671,2331092311,640
1361909741,2331119664,1,46,46,1361909713007,1361909713007,2331091671,2331091671,0
1361909745,2331123536,2,1412,706,1361909717551,1361909717615,2331096087,2331096151,64
1361909745,2331123536,5,2292,458.4,1361909717551,1361909718063,2331096087,2331096599,512
1361909745,2331123648,1,52,52,1361909720382,1361909720382,2331099030,2331099030,0
1361909745,2331123648,1,52,52,1361909720508,1361909720508,2331099156,2331099156,0
1361909745,2331123756,3,387,129,1361909717393,1361909717457,2331096149,2331096213,64
1361909745,2331123764,4,1058,264.5,1361909717576,1361909717704,2331096340,2331096468,128
1361909745,2331123800,1,52,52,1361909718631,1361909718631,2331097431,2331097431,0
1361909745,2331123996,2,104,52,1361909738081,1361909738465,2331117077,2331117461,384
1361909745,2331124032,6,288,48,1361909739518,1361909741950,2331118550,2331120982,2432
1361909745,2331124032,7,334,47.71428571,1361909739518,1361909743230,2331118550,2331122262,3712
1361909745,2331124116,6,288,48,1361909739435,1361909743019,2331118551,2331122135,3584
1361909749,2331127756,1,52,52,1361909724370,1361909724370,2331103126,2331103126,0
1361909753,2331131984,4,267,66.75,1361909748783,1361909749039,2331127767,2331128023,256
1361909753,2331131984,4,981,245.25,1361909748782,1361909748974,2331127766,2331127958,192
1361909753,2331131984,6,2028,338,1361909748782,1361909749038,2331127766,2331128022,256
1361909753,2331131984,9,6910,767.7777778,1361909748845,1361909749677,2331127829,2331128661,832
1361909753,2331131984,4,1232,308,1361909748908,1361909748972,2331127892,2331127956,64
1361909753,2331131984,3,741,247,1361909749036,1361909749228,2331128020,2331128212,192
1361909753,2331131988,6,3142,523.6666667,1361909749161,1361909749673,2331128149,2331128661,512
1361909753,2331131988,6,810,135,1361909749161,1361909749417,2331128149,2331128405,256
1361909753,2331131992,2,98,49,1361909746084,1361909747172,2331125076,2331126164,1088
1361909753,2331132024,3,183,61,1361909750278,1361909750278,2331129302,2331129302,0
1361909753,2331132032,365,487838,1336.542466,1361909739519,1361909750527,2331118551,2331129559,11008
1361909753,2331132032,3,620,206.6666667,1361909747771,1361909748987,2331126803,2331128019,1216
1361909753,2331132068,4,1079,269.75,1361909748698,1361909748954,2331127766,2331128022,256
1361909753,2331132068,6,2563,427.1666667,1361909748761,1361909748953,2331127829,2331128021,192
1361909753,2331132072,4,869,217.25,1361909748951,1361909749463,2331128023,2331128535,512
1361909753,2331132076,2,98,49,1361909746000,1361909747152,2331125076,2331126228,1152
1361909753,2331132096,8,6141,767.625,1361909749759,1361909750399,2331128855,2331129495,640
1361909753,2331132096,5,662,132.4,1361909749758,1361909750334,2331128854,2331129430,576
1361909753,2331132096,4,619,154.75,1361909749949,1361909750013,2331129045,2331129109,64
1361909753,2331132100,93,122684,1319.182796,1361909738299,1361909748859,2331117399,2331127959,10560
1361909753,2331132108,166,209260,1260.60241,1361909739378,1361909748850,2331118486,2331127958,9472
1361909753,2331132108,110,131560,1196,1361909739442,1361909750514,2331118550,2331129622,11072
1361909761,2331140068,1,52,52,1361909733723,1361909733723,2331112791,2331112791,0
1361909762,2331140240,6,318,53,1361909759382,1361909761494,2331137622,2331139734,2112
1361909762,2331140288,3,166,55.33333333,1361909758375,1361909761511,2331136663,2331139799,3136
1361909765,2331143856,62,62746,1012.032258,1361909739694,1361909761262,2331118550,2331140118,21568
1361909765,2331143856,14,5009,357.7857143,1361909739693,1361909744237,2331118549,2331123093,4544
1361909765,2331143964,3,418,139.3333333,1361909738178,1361909738370,2331117142,2331117334,192
1361909765,2331144004,35,35092,1002.628571,1361909739546,1361909744154,2331118550,2331123158,4608
1361909770,2331148152,2,106,53,1361909763375,1361909763375,2331141527,2331141527,0
1361909770,2331148232,7,1452,207.4285714,1361909750557,1361909765661,2331128789,2331143893,15104
1361909773,2331151784,1,46,46,1361909744947,1361909744947,2331123731,2331123731,0
1361909776,2330561820,6,3125,520.8333333,1361909773045,1361909773109,2330558865,2330558929,64
1361909776,2330561996,26,31841,1224.653846,1361909772865,1361909773121,2330558861,2330559117,256
1361909776,2330561996,32,41328,1291.5,1361909772929,1361909773249,2330558925,2330559245,320
1361909776,2330561996,13,14201,1092.384615,1361909772995,1361909773187,2330558991,2330559183,192
1361909776,2330562000,9,8699,966.5555556,1361909773184,1361909773312,2330559184,2330559312,128
1361909776,2330562000,51,68596,1345.019608,1361909773184,1361909773504,2330559184,2330559504,320
1361909776,2330562000,14,14516,1036.857143,1361909773248,1361909773376,2330559248,2330559376,128
1361909776,2330562000,15,16507,1100.466667,1361909773247,1361909773375,2330559247,2330559375,128
1361909776,2330562028,38,49633,1306.131579,1361909771236,1361909772772,2330557264,2330558800,1536
1361909776,2330562028,6,4248,708,1361909771236,1361909771300,2330557264,2330557328,64
1361909776,2330562028,9,8375,930.5555556,1361909771236,1361909771428,2330557264,2330557456,192
1361909776,2330562028,8,7257,907.125,1361909771236,1361909771428,2330557264,2330557456,192
1361909776,2330562028,24,29824,1242.666667,1361909771235,1361909771619,2330557263,2330557647,384
1361909776,2330562064,51,67117,1316.019608,1361909772863,1361909773247,2330558927,2330559311,384
1361909776,2330562064,14,15296,1092.571429,1361909772863,1361909773119,2330558927,2330559183,256
1361909776,2330562080,11,11451,1041,1361909773041,1361909773169,2330559121,2330559249,128
1361909776,2330562080,15,16210,1080.666667,1361909773040,1361909773232,2330559120,2330559312,192
1361909776,2330562080,12,12264,1022,1361909773230,1361909773486,2330559310,2330559566,256
1361909776,2330562080,10,9293,929.3,1361909773229,1361909773933,2330559309,2330560013,704
1361909776,2330562084,7,5097,728.1428571,1361909773293,1361909773485,2330559377,2330559569,192
1361909776,2330562084,31,39044,1259.483871,1361909773293,1361909773997,2330559377,2330560081,704
1361909776,2330562084,12,12727,1060.583333,1361909773229,1361909773357,2330559313,2330559441,128
1361909776,2330562084,6,3678,613,1361909773292,1361909773484,2330559376,2330559568,192
1361909776,2330562084,4,1159,289.75,1361909773292,1361909773484,2330559376,2330559568,192
1361909776,2330562108,6,3120,520,1361909771154,1361909771218,2330557262,2330557326,64
1361909776,2330562112,15,16499,1099.933333,1361909771213,1361909772813,2330557325,2330558925,1600
1361909776,2330562112,61,80924,1326.622951,1361909771217,1361909772945,2330557329,2330559057,1728
1361909776,2330562112,12,11408,950.6666667,1361909771344,1361909772816,2330557456,2330558928,1472
1361909776,2330562112,20,23070,1153.5,1361909771344,1361909772880,2330557456,2330558992,1536
1361909776,2330562260,10,10354,1035.4,1361909750332,1361909750396,2330536592,2330536656,64
1361909776,2330562400,1,52,52,1361909750190,1361909750190,2330536590,2330536590,0
1361909777,2331155816,46,61898,1345.608696,1361909750037,1361909750293,2331128853,2331129109,256
1361909777,2331155816,42,48140,1146.190476,1361909750037,1361909750485,2331128853,2331129301,448
1361909777,2331155816,2,104,52,1361909750037,1361909750933,2331128853,2331129749,896
1361909777,2331155816,17,11254,662,1361909750037,1361909750485,2331128853,2331129301,448
1361909777,2331155820,13,9091,699.3076923,1361909750226,1361909750482,2331129046,2331129302,256
1361909777,2331155996,3,889,296.3333333,1361909749026,1361909749090,2331128022,2331128086,64
1361909777,2331156028,7,5286,755.1428571,1361909749826,1361909750466,2331128854,2331129494,640
1361909777,2331156028,22,27409,1245.863636,1361909749826,1361909750018,2331128854,2331129046,192
1361909777,2331156028,1,52,52,1361909749826,1361909749826,2331128854,2331128854,0
1361909777,2331156028,1,52,52,1361909749826,1361909749826,2331128854,2331128854,0
1361909777,2331156032,16,12618,788.625,1361909750079,1361909750143,2331129111,2331129175,64
1361909777,2331156056,14,12457,889.7857143,1361909750244,1361909750372,2331129300,2331129428,128
1361909777,2331156060,2,104,52,1361909750307,1361909750307,2331129367,2331129367,0
1361909777,2331156064,21,23384,1113.52381,1361909750620,1361909750684,2331129684,2331129748,64
1361909777,2331156140,11,5394,490.3636364,1361909772752,1361909773008,2331151892,2331152148,256
1361909777,2331156140,4,925,231.25,1361909772751,1361909772879,2331151891,2331152019,128
1361909777,2331156144,4,1488,372,1361909772811,1361909772939,2331151955,2331152083,128
1361909777,2331156144,16,15883,992.6875,1361909772811,1361909773579,2331151955,2331152723,768
1361909777,2331156144,14,14566,1040.428571,1361909772878,1361909773646,2331152022,2331152790,768
1361909778,2331156180,10,8351,835.1,1361909771729,1361909771985,2331149909,2331150165,256
1361909778,2331156180,11,11197,1017.909091,1361909771793,1361909772049,2331149973,2331150229,256
1361909778,2331156192,8,6125,765.625,1361909775815,1361909776903,2331154007,2331155095,1088
1361909778,2331156216,2,1478,739,1361909768940,1361909771628,2331147156,2331149844,2688
1361909778,2331156216,16,17461,1091.3125,1361909773355,1361909773611,2331151571,2331151827,256
1361909778,2331156220,25,31341,1253.64,1361909773355,1361909773675,2331151575,2331151895,320
1361909778,2331156220,6,3931,655.1666667,1361909773480,1361909773672,2331151700,2331151892,192
1361909778,2331156224,6,3817,636.1666667,1361909773607,1361909773735,2331151831,2331151959,128
1361909778,2331156224,6,4160,693.3333333,1361909773670,1361909773798,2331151894,2331152022,128
1361909778,2331156224,11,5397,490.6363636,1361909773670,1361909773926,2331151894,2331152150,256
1361909778,2331156224,15,16023,1068.2,1361909773669,1361909773925,2331151893,2331152149,256
1361909778,2331156224,16,17660,1103.75,1361909773796,1361909774244,2331152020,2331152468,448
1361909778,2331156228,13,13248,1019.076923,1361909773859,1361909774499,2331152087,2331152727,640
1361909778,2331156264,41,51850,1264.634146,1361909771709,1361909772733,2331149973,2331150997,1024
1361909778,2331156264,271,380970,1405.793358,1361909771708,1361909775676,2331149972,2331153940,3968
1361909778,2331156272,8,1820,227.5,1361909775733,1361909777077,2331154005,2331155349,1344
1361909778,2331156300,7,5000,714.2857143,1361909773275,1361909773403,2331151575,2331151703,128
1361909778,2331156300,24,30060,1252.5,1361909773275,1361909773595,2331151575,2331151895,320
1361909778,2331156300,17,20120,1183.529412,1361909773275,1361909773595,2331151575,2331151895,320
1361909781,2331159976,1,46,46,1361909754997,1361909754997,2331133973,2331133973,0
1361909784,2330570004,50,64621,1292.42,1361909773435,1361909776379,2330559439,2330562383,2944
1361909784,2330570056,33,42637,1292.030303,1361909776326,1361909776454,2330562382,2330562510,128
1361909784,2330570092,6,3764,627.3333333,1361909773477,1361909776293,2330559569,2330562385,2816
1361909785,2331163996,4,240,60,1361909757728,1361909783904,2331136724,2331162900,26176
1361909785,2331164124,89,87499,983.1348315,1361909780641,1361909782625,2331159765,2331161749,1984
1361909785,2331164128,19,19094,1004.947368,1361909776990,1361909778078,2331156118,2331157206,1088
1361909785,2331164128,4,906,226.5,1361909780957,1361909781149,2331160085,2331160277,192
1361909785,2331164128,4,906,226.5,1361909780957,1361909781149,2331160085,2331160277,192
1361909785,2331164128,4,906,226.5,1361909780957,1361909781149,2331160085,2331160277,192
1361909785,2331164128,4,906,226.5,1361909780956,1361909781212,2331160084,2331160340,256
1361909785,2331164128,4,906,226.5,1361909780956,1361909781148,2331160084,2331160276,192
1361909785,2331164128,4,906,226.5,1361909780956,1361909781148,2331160084,2331160276,192
1361909785,2331164128,4,906,226.5,1361909780956,1361909781148,2331160084,2331160276,192
1361909785,2331164128,4,906,226.5,1361909780956,1361909781148,2331160084,2331160276,192
1361909785,2331164128,8,4532,566.5,1361909781083,1361909782235,2331160211,2331161363,1152
1361909785,2331164132,20,23214,1160.7,1361909781082,1361909782234,2331160214,2331161366,1152
1361909786,2331164164,22,27066,1230.272727,1361909779551,1361909779679,2331157715,2331157843,128
1361909786,2331164164,66,88869,1346.5,1361909779554,1361909779810,2331157718,2331157974,256
1361909786,2331164164,34,43000,1264.705882,1361909783138,1361909783586,2331161302,2331161750,448
1361909786,2331164164,5,2846,569.2,1361909783137,1361909783521,2331161301,2331161685,384
1361909786,2331164164,2,106,53,1361909783137,1361909783265,2331161301,2331161429,128
1361909786,2331164164,7,5013,716.1428571,1361909783137,1361909783521,2331161301,2331161685,384
1361909786,2331164164,8,6713,839.125,1361909783136,1361909783520,2331161300,2331161684,384
1361909786,2331164164,19,22609,1189.947368,1361909783136,1361909783584,2331161300,2331161748,448
1361909786,2331164164,9,7640,848.8888889,1361909779808,1361909779936,2331157972,2331158100,128
1361909786,2331164164,21,25044,1192.571429,1361909779808,1361909780576,2331157972,2331158740,768
1361909786,2331164164,7,4937,705.2857143,1361909779808,1361909779936,2331157972,2331158100,128
1361909786,2331164168,6,4345,724.1666667,1361909780125,1361909780573,2331158293,2331158741,448
1361909786,2331164168,5,2404,480.8,1361909780125,1361909780573,2331158293,2331158741,448
1361909786,2331164168,13,14149,1088.384615,1361909780253,1361909780573,2331158421,2331158741,320
1361909786,2331164168,4,704,176,1361909780444,1361909780572,2331158612,2331158740,128
1361909786,2331164168,3,865,288.3333333,1361909780443,1361909780571,2331158611,2331158739,128
1361909786,2331164172,5,2713,542.6,1361909780571,1361909780635,2331158743,2331158807,64
1361909786,2331164172,5,2882,576.4,1361909780571,1361909780635,2331158743,2331158807,64
1361909786,2331164172,11,10968,997.0909091,1361909780571,1361909780699,2331158743,2331158871,128
1361909786,2331164172,6,3781,630.1666667,1361909780571,1361909780635,2331158743,2331158807,64
1361909786,2331164172,6,3517,586.1666667,1361909780571,1361909780635,2331158743,2331158807,64
1361909786,2331164172,5,2228,445.6,1361909780570,1361909780698,2331158742,2331158870,128
1361909786,2331164172,13,13540,1041.538462,1361909780570,1361909780762,2331158742,2331158934,192
1361909786,2331164172,9,5584,620.4444444,1361909780570,1361909780762,2331158742,2331158934,192
1361909786,2331164172,9,7914,879.3333333,1361909780570,1361909780826,2331158742,2331158998,256
1361909786,2331164172,19,21454,1129.157895,1361909780570,1361909781914,2331158742,2331160086,1344
1361909786,2331164172,18,20804,1155.777778,1361909780634,1361909781850,2331158806,2331160022,1216
1361909786,2331164172,6,654,109,1361909783642,1361909783834,2331161814,2331162006,192
1361909786,2331164172,11,10361,941.9090909,1361909780569,1361909780761,2331158741,2331158933,192
1361909786,2331164172,6,3607,601.1666667,1361909780569,1361909780633,2331158741,2331158805,64
1361909786,2331164172,10,9862,986.2,1361909780569,1361909780633,2331158741,2331158805,64
1361909786,2331164172,5,2146,429.2,1361909780569,1361909780697,2331158741,2331158869,128
1361909786,2331164172,5,445,89,1361909780633,1361909781529,2331158805,2331159701,896
1361909786,2331164172,7,5391,770.1428571,1361909780632,1361909781848,2331158804,2331160020,1216
1361909786,2331164172,4,690,172.5,1361909780824,1361909781848,2331158996,2331160020,1024
1361909786,2331164208,4,906,226.5,1361909781875,1361909782067,2331160083,2331160275,192
1361909786,2331164212,4,906,226.5,1361909781875,1361909782067,2331160087,2331160279,192
1361909786,2331164212,8,6017,752.125,1361909781872,1361909783088,2331160084,2331161300,1216
1361909786,2331164212,4,906,226.5,1361909781872,1361909782064,2331160084,2331160276,192
1361909786,2331164212,4,906,226.5,1361909781872,1361909782064,2331160084,2331160276,192
1361909786,2331164212,4,906,226.5,1361909781872,1361909782064,2331160084,2331160276,192
1361909786,2331164212,4,906,226.5,1361909781872,1361909782064,2331160084,2331160276,192
1361909786,2331164216,32,38947,1217.09375,1361909781998,1361909783214,2331160214,2331161430,1216
1361909786,2331164216,4,1166,291.5,1361909782061,1361909783149,2331160277,2331161365,1088
1361909786,2331164236,12,12368,1030.666667,1361909779480,1361909779544,2331157716,2331157780,64
1361909786,2331164240,37,47437,1282.081081,1361909779477,1361909779733,2331157717,2331157973,256
1361909786,2331164240,6,3579,596.5,1361909779733,1361909779861,2331157973,2331158101,128
1361909786,2331164240,62,82451,1329.854839,1361909779733,1361909780565,2331157973,2331158805,832
1361909786,2331164240,7,4884,697.7142857,1361909783060,1361909783444,2331161300,2331161684,384
1361909786,2331164240,4,1011,252.75,1361909783123,1361909783443,2331161363,2331161683,320
1361909786,2331164244,4,580,145,1361909779730,1361909779858,2331157974,2331158102,128
1361909786,2331164248,57,74928,1314.526316,1361909780239,1361909780495,2331158487,2331158743,256
1361909786,2331164248,7,832,118.8571429,1361909783565,1361909784845,2331161813,2331163093,1280
1361909786,2331164248,5,2062,412.4,1361909780492,1361909780620,2331158740,2331158868,128
1361909786,2331164248,13,13612,1047.076923,1361909780556,1361909781772,2331158804,2331160020,1216
1361909786,2331164248,11,10940,994.5454545,1361909780492,1361909780620,2331158740,2331158868,128
1361909786,2331164248,25,27934,1117.36,1361909780492,1361909781260,2331158740,2331159508,768
1361909786,2331164248,15,16620,1108,1361909780492,1361909781836,2331158740,2331160084,1344
1361909786,2331164248,10,9374,937.4,1361909780492,1361909781836,2331158740,2331160084,1344
1361909786,2331164252,4,1054,263.5,1361909780747,1361909781771,2331158999,2331160023,1024
1361909786,2331164252,4,356,89,1361909780746,1361909781770,2331158998,2331160022,1024
1361909786,2331164252,4,256,64,1361909784007,1361909784391,2331162259,2331162643,384
1361909800,2330586228,14,14904,1064.571429,1361909773342,1361909773982,2330559570,2330560210,640
1361909800,2330586364,31,40418,1303.806452,1361909773077,1361909773845,2330559441,2330560209,768
1361909800,2330586368,10,7131,713.1,1361909773201,1361909773777,2330559569,2330560145,576
1361909800,2330586368,8,5091,636.375,1361909773201,1361909773841,2330559569,2330560209,640
1361909800,2330586384,8,6385,798.125,1361909773630,1361909773758,2330560014,2330560142,128
1361909802,2331180172,1,52,52,1361909777241,1361909777241,2331155413,2331155413,0
1361909802,2331180176,1,52,52,1361909777300,1361909777300,2331155476,2331155476,0
1361909802,2331180252,4,1168,292,1361909783176,1361909801288,2331161428,2331179540,18112
1361909802,2331180340,55,70668,1284.872727,1361909783347,1361909801459,2331161687,2331179799,18112
1361909802,2331180340,4,1523,380.75,1361909783347,1361909801395,2331161687,2331179735,18048
1361909805,2331183820,4,208,52,1361909777041,1361909804753,2331155861,2331183573,27712
1361909805,2331183900,14,10427,744.7857143,1361909779135,1361909779775,2331158035,2331158675,640
1361909805,2331183908,1,52,52,1361909779512,1361909779512,2331158420,2331158420,0
1361909805,2331183912,1,52,52,1361909779507,1361909779507,2331158419,2331158419,0
1361909805,2331183988,10,1990,199,1361909778088,1361909792680,2331157076,2331171668,14592
1361909805,2331184044,1,52,52,1361909779378,1361909779378,2331158422,2331158422,0
1361909805,2331184044,1,52,52,1361909779441,1361909779441,2331158485,2331158485,0
1361909805,2331184044,1,52,52,1361909779376,1361909779376,2331158420,2331158420,0
1361909805,2331184044,1,52,52,1361909779376,1361909779376,2331158420,2331158420,0
1361909805,2331184044,1,52,52,1361909779567,1361909779567,2331158611,2331158611,0
1361909808,2330594000,5,266,53.2,1361909801919,1361909806335,2330587919,2330592335,4416
1361909808,2330594000,6,336,56,1361909801918,1361909804862,2330587918,2330590862,2944
1361909808,2330594000,5,266,53.2,1361909801918,1361909804862,2330587918,2330590862,2944
1361909808,2330594004,5,284,56.8,1361909801914,1361909804858,2330587918,2330590862,2944
1361909808,2330594032,9,1442,160.2222222,1361909783073,1361909804833,2330569105,2330590865,21760
1361909808,2330594084,5,284,56.8,1361909801835,1361909804779,2330587919,2330590863,2944
1361909808,2330594084,5,266,53.2,1361909801835,1361909804779,2330587919,2330590863,2944
1361909808,2330594084,5,284,56.8,1361909801835,1361909804779,2330587919,2330590863,2944
1361909808,2330594084,5,266,53.2,1361909801835,1361909804779,2330587919,2330590863,2944
1361909809,2331187844,35,32626,932.1714286,1361909782840,1361909808696,2331161684,2331187540,25856
1361909809,2331187960,3,180,60,1361909781955,1361909786563,2331160915,2331165523,4608
1361909809,2331187996,3,180,60,1361909782816,1361909784736,2331161812,2331163732,1920
1361909809,2331188156,7,382,54.57142857,1361909801408,1361909808384,2331180564,2331187540,6976
1361909809,2331188156,7,382,54.57142857,1361909801408,1361909808384,2331180564,2331187540,6976
1361909809,2331188156,8,452,56.5,1361909801408,1361909808384,2331180564,2331187540,6976
1361909809,2331188156,8,452,56.5,1361909801408,1361909808384,2331180564,2331187540,6976
1361909809,2331188156,7,382,54.57142857,1361909801472,1361909808384,2331180628,2331187540,6912
1361909809,2331188156,4,184,46,1361909801472,1361909808384,2331180628,2331187540,6912
1361909809,2331188156,2,92,46,1361909801472,1361909804800,2331180628,2331183956,3328
1361909809,2331188156,8,386,48.25,1361909801472,1361909808384,2331180628,2331187540,6912
1361909809,2331188156,4,184,46,1361909801472,1361909808384,2331180628,2331187540,6912
1361909809,2331188156,4,184,46,1361909801472,1361909808384,2331180628,2331187540,6912
1361909809,2331188156,6,276,46,1361909801472,1361909804672,2331180628,2331183828,3200
1361909809,2331188156,7,382,54.57142857,1361909801408,1361909808384,2331180564,2331187540,6976
1361909809,2331188156,4,184,46,1361909801408,1361909808384,2331180564,2331187540,6976
1361909809,2331188156,4,184,46,1361909801471,1361909808383,2331180627,2331187539,6912
1361909809,2331188156,8,386,48.25,1361909801471,1361909808383,2331180627,2331187539,6912
1361909809,2331188156,4,184,46,1361909801471,1361909808383,2331180627,2331187539,6912
1361909809,2331188156,4,184,46,1361909801471,1361909808383,2331180627,2331187539,6912
1361909809,2331188156,7,322,46,1361909801471,1361909808511,2331180627,2331187667,7040
1361909809,2331188156,4,184,46,1361909801471,1361909808383,2331180627,2331187539,6912
1361909809,2331188156,2,92,46,1361909801471,1361909802367,2331180627,2331181523,896
1361909809,2331188156,7,322,46,1361909801471,1361909808511,2331180627,2331187667,7040
1361909810,2331188236,8,452,56.5,1361909802330,1361909809306,2331180566,2331187542,6976
1361909810,2331188236,4,184,46,1361909802330,1361909809306,2331180566,2331187542,6976
1361909810,2331188236,4,184,46,1361909802393,1361909809305,2331180629,2331187541,6912
1361909810,2331188236,4,184,46,1361909802393,1361909809305,2331180629,2331187541,6912
1361909810,2331188236,4,184,46,1361909802393,1361909809305,2331180629,2331187541,6912
1361909810,2331188236,6,318,53,1361909802329,1361909807705,2331180565,2331185941,5376
1361909810,2331188236,10,718,71.8,1361909802329,1361909809305,2331180565,2331187541,6976
1361909810,2331188236,4,184,46,1361909802329,1361909809305,2331180565,2331187541,6976
1361909810,2331188236,7,388,55.42857143,1361909802329,1361909805913,2331180565,2331184149,3584
1361909810,2331188236,8,452,56.5,1361909802329,1361909809305,2331180565,2331187541,6976
1361909810,2331188236,4,184,46,1361909802329,1361909809305,2331180565,2331187541,6976
1361909810,2331188236,8,452,56.5,1361909802329,1361909809305,2331180565,2331187541,6976
1361909810,2331188236,6,312,52,1361909802393,1361909809305,2331180629,2331187541,6912
1361909810,2331188236,4,184,46,1361909802393,1361909809305,2331180629,2331187541,6912
1361909810,2331188236,4,184,46,1361909802393,1361909809305,2331180629,2331187541,6912
1361909810,2331188236,4,184,46,1361909802393,1361909809305,2331180629,2331187541,6912
1361909810,2331188236,7,322,46,1361909802393,1361909809433,2331180629,2331187669,7040
1361909810,2331188236,7,322,46,1361909802393,1361909809433,2331180629,2331187669,7040
1361909813,2331191840,1,60,60,1361909785662,1361909785662,2331164502,2331164502,0
1361909818,2331196168,5,254,50.8,1361909802461,1361909817437,2331180629,2331195605,14976
1361909818,2331196168,5,254,50.8,1361909802461,1361909817437,2331180629,2331195605,14976
1361909818,2331196244,5,254,50.8,1361909802383,1361909817359,2331180627,2331195603,14976
1361909818,2331196292,2,92,46,1361909817249,1361909817377,2331195541,2331195669,128
1361909818,2331196292,2,92,46,1361909817312,1361909817376,2331195604,2331195668,64
1361909818,2331196292,2,92,46,1361909817312,1361909817376,2331195604,2331195668,64
1361909818,2331196292,2,92,46,1361909817312,1361909817376,2331195604,2331195668,64
1361909821,2331199876,2,120,60,1361909794457,1361909818649,2331173333,2331197525,24192
1361909824,2330609816,2,92,46,1361909809014,1361909817014,2330594830,2330602830,8000
1361909824,2330609816,2,92,46,1361909809014,1361909817014,2330594830,2330602830,8000
1361909824,2330609816,2,92,46,1361909809014,1361909817014,2330594830,2330602830,8000
1361909824,2330609816,2,92,46,1361909809018,1361909817018,2330594834,2330602834,8000
1361909824,2330609816,2,92,46,1361909809018,1361909817018,2330594834,2330602834,8000
1361909824,2330610052,2,92,46,1361909808782,1361909816782,2330594834,2330602834,8000
1361909824,2330610052,2,92,46,1361909808782,1361909816782,2330594834,2330602834,8000
1361909824,2330610052,2,92,46,1361909808781,1361909816781,2330594833,2330602833,8000
1361909826,2331204200,2,92,46,1361909810046,1361909818878,2331188246,2331197078,8832
1361909826,2331204200,3,144,48,1361909810236,1361909818364,2331188436,2331196564,8128
1361909826,2331204204,3,144,48,1361909810618,1361909819066,2331188822,2331197270,8448
1361909826,2331204204,2,92,46,1361909811064,1361909822776,2331189268,2331200980,11712
1361909828,2330614088,1,52,52,1361909801834,1361909801834,2330587922,2330587922,0
1361909828,2330614088,1,52,52,1361909801834,1361909801834,2330587922,2330587922,0
1361909829,2331207828,5,260,52,1361909801799,1361909816711,2331180627,2331195539,14912
1361909829,2331207828,5,260,52,1361909801799,1361909816711,2331180627,2331195539,14912
1361909829,2331207976,5,260,52,1361909801654,1361909816566,2331180630,2331195542,14912
1361909829,2331207976,5,260,52,1361909801590,1361909816566,2331180566,2331195542,14976
1361909829,2331207976,5,260,52,1361909801653,1361909816565,2331180629,2331195541,14912
1361909829,2331207976,5,260,52,1361909801653,1361909816565,2331180629,2331195541,14912
1361909829,2331207976,4,208,52,1361909801653,1361909826165,2331180629,2331205141,24512
1361909829,2331207976,5,260,52,1361909801653,1361909816629,2331180629,2331195605,14976
1361909829,2331207976,5,260,52,1361909801716,1361909816692,2331180692,2331195668,14976
1361909832,2330617812,2,92,46,1361909812540,1361909824508,2330598352,2330610320,11968
1361909833,2331211908,2,104,52,1361909808698,1361909816698,2331187606,2331195606,8000
1361909834,2331212180,2,92,46,1361909814930,1361909829394,2331193110,2331207574,14464
1361909834,2331212208,2,92,46,1361909812531,1361909826163,2331190739,2331204371,13632
1361909834,2331212220,2,92,46,1361909817321,1361909833641,2331195541,2331211861,16320
1361909834,2331212220,2,92,46,1361909817321,1361909833641,2331195541,2331211861,16320
1361909834,2331212220,2,92,46,1361909817321,1361909833641,2331195541,2331211861,16320
1361909834,2331212220,2,92,46,1361909817321,1361909833641,2331195541,2331211861,16320
1361909834,2331212220,2,92,46,1361909817321,1361909833705,2331195541,2331211925,16384
1361909834,2331212220,2,92,46,1361909817321,1361909833705,2331195541,2331211925,16384
1361909834,2331212220,2,92,46,1361909817321,1361909833705,2331195541,2331211925,16384
1361909834,2331212220,2,92,46,1361909817321,1361909833705,2331195541,2331211925,16384
1361909834,2331212220,2,92,46,1361909817321,1361909833705,2331195541,2331211925,16384
1361909834,2331212220,2,92,46,1361909817321,1361909833641,2331195541,2331211861,16320
1361909834,2331212220,2,92,46,1361909817321,1361909833641,2331195541,2331211861,16320
1361909834,2331212220,2,92,46,1361909817321,1361909833705,2331195541,2331211925,16384
1361909834,2331212220,2,92,46,1361909817321,1361909833705,2331195541,2331211925,16384
1361909834,2331212220,2,92,46,1361909817385,1361909833705,2331195605,2331211925,16320
1361909834,2331212284,2,104,52,1361909816040,1361909830184,2331194324,2331208468,14144
1361909834,2331212292,2,92,46,1361909817250,1361909833570,2331195542,2331211862,16320
1361909834,2331212292,2,92,46,1361909817250,1361909833570,2331195542,2331211862,16320
1361909834,2331212292,2,92,46,1361909817250,1361909833634,2331195542,2331211926,16384
1361909834,2331212292,2,92,46,1361909817250,1361909833634,2331195542,2331211926,16384
1361909834,2331212292,2,92,46,1361909817250,1361909833634,2331195542,2331211926,16384
1361909834,2331212292,2,92,46,1361909817250,1361909833570,2331195542,2331211862,16320
1361909834,2331212292,2,92,46,1361909817250,1361909833570,2331195542,2331211862,16320
1361909834,2331212292,2,92,46,1361909817250,1361909833570,2331195542,2331211862,16320
1361909834,2331212292,2,92,46,1361909817250,1361909833634,2331195542,2331211926,16384
1361909837,2331215732,2,92,46,1361909816810,1361909833130,2331195542,2331211862,16320
1361909837,2331215732,2,92,46,1361909816810,1361909833130,2331195542,2331211862,16320
1361909837,2331215732,2,92,46,1361909816810,1361909833130,2331195542,2331211862,16320
1361909837,2331215732,2,92,46,1361909816810,1361909833194,2331195542,2331211926,16384
1361909841,2331220024,3,222,74,1361909815685,1361909830085,2331194709,2331209109,14400
1361909849,2331227840,9,1926,214,1361909822205,1361909835901,2331201045,2331214741,13696
1361909853,2331231940,1,46,46,1361909828311,1361909828311,2331207251,2331207251,0
1361909853,2331232032,1,46,46,1361909827516,1361909827516,2331206548,2331206548,0
1361909857,2331235828,1,46,46,1361909829638,1361909829638,2331208466,2331208466,0
1361909857,2331236000,1,60,60,1361909831005,1361909831005,2331210005,2331210005,0
1361909860,2330645904,1,46,46,1361909833247,1361909833247,2330619151,2330619151,0
1361909860,2330645904,1,46,46,1361909833251,1361909833251,2330619155,2330619155,0
1361909860,2330645904,1,46,46,1361909833251,1361909833251,2330619155,2330619155,0
1361909860,2330645904,1,46,46,1361909833249,1361909833249,2330619153,2330619153,0
1361909860,2330645904,1,46,46,1361909833249,1361909833249,2330619153,2330619153,0
1361909860,2330645904,1,46,46,1361909833249,1361909833249,2330619153,2330619153,0
1361909860,2330646032,1,46,46,1361909833120,1361909833120,2330619152,2330619152,0
1361909860,2330646032,1,46,46,1361909833120,1361909833120,2330619152,2330619152,0
1361909861,2331239812,1,52,52,1361909833111,1361909833111,2331211923,2331211923,0
1361909861,2331239812,1,52,52,1361909833111,1361909833111,2331211923,2331211923,0
1361909861,2331239812,1,52,52,1361909833111,1361909833111,2331211923,2331211923,0
1361909861,2331239812,1,52,52,1361909833110,1361909833110,2331211922,2331211922,0
1361909861,2331239812,1,46,46,1361909833110,1361909833110,2331211922,2331211922,0
1361909861,2331239812,1,46,46,1361909833110,1361909833110,2331211922,2331211922,0
1361909861,2331239816,1,52,52,1361909833109,1361909833109,2331211925,2331211925,0
1361909861,2331239816,1,52,52,1361909833172,1361909833172,2331211988,2331211988,0
1361909861,2331239940,1,46,46,1361909832983,1361909832983,2331211923,2331211923,0
1361909861,2331239940,1,52,52,1361909832982,1361909832982,2331211922,2331211922,0
1361909861,2331239940,1,52,52,1361909832918,1361909832918,2331211858,2331211858,0
1361909861,2331239944,1,52,52,1361909832981,1361909832981,2331211925,2331211925,0
1361909861,2331239944,1,46,46,1361909832981,1361909832981,2331211925,2331211925,0
1361909861,2331239944,1,46,46,1361909832981,1361909832981,2331211925,2331211925,0
1361909861,2331239968,1,60,60,1361909833723,1361909833723,2331212691,2331212691,0
1361909861,2331239988,1,60,60,1361909834793,1361909834793,2331213781,2331213781,0
1361909861,2331240024,1,46,46,1361909835653,1361909835653,2331214677,2331214677,0
1361909873,2331251940,1,46,46,1361909845142,1361909845142,2331224082,2331224082,0
1361909881,2331259968,1,52,52,1361909854140,1361909854140,2331233108,2331233108,0
1361909882,2331260396,383,480054,1253.4047,1361909740150,1361909878646,2331118546,2331257042,138496
1361909885,2331263804,1,52,52,1361909857949,1361909857949,2331236753,2331236753,0
1361909889,2331267952,1,46,46,1361909864653,1361909864653,2331243605,2331243605,0
1361909889,2331267952,1,46,46,1361909864714,1361909864714,2331243666,2331243666,0
1361909892,2330678012,1,46,46,1361909864884,1361909864884,2330650896,2330650896,0
1361909892,2330678016,1,46,46,1361909864880,1361909864880,2330650896,2330650896,0
1361909892,2330678016,1,46,46,1361909864880,1361909864880,2330650896,2330650896,0
1361909892,2330678152,1,46,46,1361909864746,1361909864746,2330650898,2330650898,0
1361909892,2330678152,1,46,46,1361909864746,1361909864746,2330650898,2330650898,0
1361909893,2331271948,1,60,60,1361909866830,1361909866830,2331245778,2331245778,0
1361909905,2331284148,1,64,64,1361909880262,1361909880262,2331259410,2331259410,0
1361909937,2331315912,1,52,52,1361909910322,1361909910322,2331289234,2331289234,0
1361909949,2331328048,4,1200,300,1361909922154,1361909922218,2331301202,2331301266,64
1361909949,2331328052,17,17294,1017.294118,1361909922469,1361909924581,2331301521,2331303633,2112
1361909970,2331348176,1,46,46,1361909945425,1361909945425,2331323601,2331323601,0
1361909981,2331359960,1,52,52,1361909954628,1361909954628,2331333588,2331333588,0
1361909981,2331360108,1,52,52,1361909954478,1361909954478,2331333586,2331333586,0
1361910306,2331684408,1,76,76,1361910278565,1361910278565,2331656973,2331656973,0
1361910416,2331202092,15,8967,597.8,1361910412912,1361910413040,2331199004,2331199132,128
1361910416,2331202176,5,947,189.4,1361910412573,1361910412701,2331198749,2331198877,128
1361910416,2331202176,11,4671,424.6363636,1361910412763,1361910412827,2331198939,2331199003,64
1361910424,2331210068,8,1649,206.125,1361910420552,1361910420616,2331206620,2331206684,64
1361910424,2331210068,10,2723,272.3,1361910420678,1361910420998,2331206746,2331207066,320
1361910424,2331210072,9,1535,170.5555556,1361910420677,1361910420805,2331206749,2331206877,128
1361910424,2331210072,9,1759,195.4444444,1361910420867,1361910421187,2331206939,2331207259,320
1361910424,2331210076,8,1569,196.125,1361910421056,1361910421184,2331207132,2331207260,128
1361910424,2331210108,10,1603,160.3,1361910419038,1361910419550,2331205146,2331205658,512
1361910424,2331210124,10,7091,709.1,1361910419600,1361910419856,2331205724,2331205980,256
1361910424,2331210128,14,11960,854.2857143,1361910419915,1361910420363,2331206043,2331206491,448
1361910424,2331210148,8,1649,206.125,1361910420470,1361910420534,2331206618,2331206682,64
1361910424,2331210152,10,2627,262.7,1361910420596,1361910421108,2331206748,2331207260,512
1361910424,2331210152,10,2019,201.9,1361910420596,1361910421620,2331206748,2331207772,1024
1361910424,2331210156,8,1569,196.125,1361910420785,1361910420913,2331206941,2331207069,128
1361910424,2331210156,8,1569,196.125,1361910420911,1361910420975,2331207067,2331207131,64
1361910424,2331210160,8,1569,196.125,1361910420973,1361910421421,2331207133,2331207581,448
1361910424,2331210176,9,2277,253,1361910421085,1361910421533,2331207261,2331207709,448
1361910424,2331210208,8,1563,195.375,1361910419453,1361910419517,2331205661,2331205725,64
1361910424,2331210212,13,7983,614.0769231,1361910419831,1361910420535,2331206043,2331206747,704
1361910425,2331210464,12,7131,594.25,1361910424357,1361910424549,2331209821,2331210013,192
1361910432,2331218072,13,7983,614.0769231,1361910424004,1361910424260,2331210076,2331210332,256
1361910432,2331218072,10,1635,163.5,1361910424003,1361910424067,2331210075,2331210139,64
1361910432,2331218076,19,12648,665.6842105,1361910420863,1361910425663,2331206939,2331211739,4800
1361910432,2331218108,10,1551,155.1,1361910426209,1361910426465,2331212317,2331212573,256
1361910432,2331218108,8,1569,196.125,1361910426400,1361910426464,2331212508,2331212572,64
1361910432,2331218108,8,1291,161.375,1361910426272,1361910426400,2331212380,2331212508,128
1361910432,2331218108,8,1569,196.125,1361910426398,1361910426462,2331212506,2331212570,64
1361910432,2331218108,8,1291,161.375,1361910426526,1361910426654,2331212634,2331212762,128
1361910432,2331218112,9,1343,149.2222222,1361910430426,1361910430554,2331216538,2331216666,128
1361910432,2331218156,8,1547,193.375,1361910424046,1361910424686,2331210202,2331210842,640
1361910432,2331218160,9,1599,177.6666667,1361910424812,1361910425068,2331210972,2331211228,256
1361910432,2331218160,9,1343,149.2222222,1361910428780,1361910428908,2331214940,2331215068,128
1361910432,2331218164,17,14548,855.7647059,1361910425065,1361910426025,2331211229,2331212189,960
1361910432,2331218164,9,2277,253,1361910424232,1361910424296,2331210396,2331210460,64
1361910432,2331218184,9,1343,149.2222222,1361910429587,1361910429651,2331215771,2331215835,64
1361910432,2331218188,8,1339,167.375,1361910426001,1361910426129,2331212189,2331212317,128
1361910432,2331218188,8,1233,154.125,1361910426000,1361910426064,2331212188,2331212252,64
1361910432,2331218188,10,1567,156.7,1361910426127,1361910426383,2331212315,2331212571,256
1361910432,2331218188,10,1715,171.5,1361910426127,1361910426447,2331212315,2331212635,320
1361910432,2331218188,13,9167,705.1538462,1361910426127,1361910426447,2331212315,2331212635,320
1361910432,2331218192,8,1569,196.125,1361910426254,1361910426318,2331212446,2331212510,64
1361910432,2331218192,8,1569,196.125,1361910426381,1361910426445,2331212573,2331212637,64
1361910432,2331218192,9,1775,197.2222222,1361910426443,1361910426635,2331212635,2331212827,192
1361910440,2331226084,9,1343,149.2222222,1361910432375,1361910432759,2331218459,2331218843,384
1361910442,2331821104,30,35491,1183.033333,1361910421034,1361910436330,2331800138,2331815434,15296
1361910448,2331234180,10,1395,139.5,1361910447450,1361910447578,2331233630,2331233758,128
1361910448,2331234196,9,1343,149.2222222,1361910439814,1361910439878,2331226010,2331226074,64
1361910448,2331234200,9,1343,149.2222222,1361910441027,1361910441091,2331227227,2331227291,64
1361910448,2331234204,16,11040,690,1361910444991,1361910447423,2331231195,2331233627,2432
1361910448,2331234228,9,1343,149.2222222,1361910442024,1361910442472,2331228252,2331228700,448
1361910448,2331234248,8,1291,161.375,1361910442772,1361910442772,2331229020,2331229020,0
1361910448,2331234256,8,1233,154.125,1361910447179,1361910447307,2331233435,2331233563,128
1361910488,2331274256,20,14280,714,1361910478414,1361910484942,2331264670,2331271198,6528
1361910496,2331282132,11,1548,140.7272727,1361910490443,1361910495819,2331276575,2331281951,5376
1361910496,2331282136,11,1459,132.6363636,1361910490886,1361910491142,2331277022,2331277278,256
1361910496,2331282192,15,11276,751.7333333,1361910485007,1361910489103,2331271199,2331275295,4096
1361910502,2331880744,1,52,52,1361910477522,1361910477522,2331856266,2331856266,0
1361910504,2331290272,10,1248,124.8,1361910500286,1361910500734,2331286558,2331287006,448
1361910515,2331893180,7,6304,900.5714286,1361910513734,1361910513990,2331891914,2331892170,256
1361910520,2331306108,4724,6723196,1423.199831,1361910500640,1361910512288,2331286748,2331298396,11648
1361910521,2331306696,1,52,52,1361910496575,1361910496575,2331282271,2331282271,0
1361910529,2331314744,1,101,101,1361910502223,1361910502223,2331287967,2331287967,0
1361910538,2331916740,40,54277,1356.925,1361910513173,1361910513301,2331891913,2331892041,128
1361910541,2331326692,3,586,195.3333333,1361910513537,1361910513537,2331299229,2331299229,0
1361910542,2331920700,1,46,46,1361910516734,1361910516734,2331895434,2331895434,0
1361910569,2331355016,1,52,52,1361910543167,1361910543167,2331329183,2331329183,0
1361910570,2331948708,1,52,52,1361910544116,1361910544116,2331922824,2331922824,0
1361910818,2332197084,1,76,76,1361910789883,1361910789883,2332168967,2332168967,0
1361910880,2331666188,22,17795,808.8636364,1361910875930,1361910879834,2331662118,2331666022,3904
1361910888,2331674200,8,1233,154.125,1361910883214,1361910883662,2331669414,2331669862,448
1361910888,2331674288,8,1291,161.375,1361910883635,1361910883699,2331669923,2331669987,64
1361911163,2332542036,3,1406,468.6666667,1361911138276,1361911138340,2332517312,2332517376,64
1361911164,2332542156,23,26317,1144.217391,1361911139284,1361911141140,2332517440,2332519296,1856
1361911280,2332658328,1,52,52,1361911254119,1361911254119,2332632447,2332632447,0
1361911286,2332664804,1,52,52,1361911255626,1361911255626,2332634430,2332634430,0
1361911286,2332665092,1,48,48,1361911256425,1361911256425,2332635517,2332635517,0
1361911328,2332706460,1,76,76,1361911303520,1361911303520,2332681980,2332681980,0
1361911441,2332819640,1,46,46,1361911419886,1361911419886,2332798526,2332798526,0
1361911445,2332823436,9,3737,415.2222222,1361911443065,1361911443577,2332821501,2332822013,512
1361911453,2332831448,10,4801,480.1,1361911444266,1361911444842,2332822714,2332823290,576
1361911453,2332831524,9,3735,415,1361911445344,1361911445664,2332823868,2332824188,320
1361911453,2332831528,9,3647,405.2222222,1361911446300,1361911447580,2332824828,2332826108,1280
1361911805,2333184040,1,56,56,1361911779287,1361911779287,2333158327,2333158327,0
1361911809,2333187904,4,1066,266.5,1361911780766,1361911780830,2333159670,2333159734,64
1361911809,2333187904,16,16515,1032.1875,1361911780893,1361911789021,2333159797,2333167925,8128
1361911829,2333207948,1,46,46,1361911804593,1361911804593,2333183541,2333183541,0
1361911841,2333220024,1,76,76,1361911813992,1361911813992,2333193016,2333193016,0
1361911845,2333223860,1,52,52,1361911819083,1361911819083,2333197943,2333197943,0
1361911845,2333223980,1,52,52,1361911818963,1361911818963,2333197943,2333197943,0
1361912318,2333696772,8,6353,794.125,1361912315225,1361912316697,2333693997,2333695469,1472
1361912343,2333721272,38,50733,1335.078947,1361912315663,1361912315727,2333693935,2333693999,64
1361912343,2333129340,3,586,195.3333333,1361912314909,1361912314909,2333101249,2333101249,0
1361912350,2333728836,2,104,52,1361912345113,1361912345305,2333723949,2333724141,192
1361912351,2333729472,1,76,76,1361912325508,1361912325508,2333703980,2333703980,0
1361912353,2333138980,2,104,52,1361912345222,1361912345414,2333131202,2333131394,192
1361912841,2334219956,1,76,76,1361912836058,1361912836058,2334215014,2334215014,0
1361912893,2334271496,3,1099,366.3333333,1361912864360,1361912864424,2334242856,2334242920,64
1361912895,2334273720,10,8688,868.8,1361912864262,1361912864774,2334242982,2334243494,512
1361912984,2334362592,5,272,54.4,1361912980421,1361912982149,2334359013,2334360741,1728
1361913005,2334383404,1,52,52,1361912979712,1361912979712,2334358116,2334358116,0
1361913009,2334387228,1,52,52,1361912984495,1361912984495,2334362723,2334362723,0
