unix_secs,sysuptime,dpkts,doctets,doctets/dpkts,Real First Packet,Real End Packet,first,last,Duration
1359702856,124241416,2,120,60,1359702829697,1359702832641,124215113,124218057,2944
1359703688,125074060,1,48,48,1359703658097,1359703658097,125044157,125044157,0
1359705840,3060504716,4,478,119.5,1359705839746,1359705839810,3060504462,3060504526,64
1359705842,127227928,8,3305,413.125,1359705840724,1359705841172,127226652,127227100,448
1359705840,3060504808,3,919,306.3333333,1359705839655,1359705839719,3060504463,3060504527,64
1359705848,3060512704,4,971,242.75,1359705846668,1359705847116,3060511372,3060511820,448
1359705849,127234404,10,2770,277,1359705847903,1359705848095,127233307,127233499,192
1359705849,127234404,8,2634,329.25,1359705848159,1359705848287,127233563,127233691,128
1359705849,127234404,8,2378,297.25,1359705848095,1359705848159,127233499,127233563,64
1359705849,127234408,8,1890,236.25,1359705848282,1359705848346,127233690,127233754,64
1359705849,127234408,7,2662,380.2857143,1359705848413,1359705848541,127233821,127233949,128
1359705849,127234408,9,2430,270,1359705848669,1359705848861,127234077,127234269,192
1359705849,127234408,8,1424,178,1359705846172,1359705846556,127231580,127231964,384
1359705849,127234416,8,2698,337.25,1359705848341,1359705848405,127233757,127233821,64
1359705849,127234416,10,2490,249,1359705848532,1359705848660,127233948,127234076,128
1359705857,127242400,8,1890,236.25,1359705848994,1359705849122,127234394,127234522,128
1359705857,127242400,10,4818,481.8,1359705850658,1359705850722,127236058,127236122,64
1359705857,127242400,8,2394,299.25,1359705850722,1359705850786,127236122,127236186,64
1359705857,127242404,8,1890,236.25,1359705849120,1359705849184,127234524,127234588,64
1359705857,127242404,8,1890,236.25,1359705850976,1359705851040,127236380,127236444,64
1359705857,127242404,8,3442,430.25,1359705851104,1359705851232,127236508,127236636,128
1359705857,127242404,8,1890,236.25,1359705849311,1359705849439,127234715,127234843,128
1359705857,127242404,9,1942,215.7777778,1359705851295,1359705851423,127236699,127236827,128
1359705857,127242404,10,2490,249,1359705849438,1359705849566,127234842,127234970,128
1359705857,127242408,8,2506,313.25,1359705849565,1359705849629,127234973,127235037,64
1359705857,127242408,8,2746,343.25,1359705850011,1359705850075,127235419,127235483,64
1359705857,127242412,8,2021,252.625,1359705853206,1359705853334,127238618,127238746,128
1359705857,127242412,7,1401,200.1428571,1359705854487,1359705855063,127239899,127240475,576
1359705857,127242412,11,3405,309.5454545,1359705842583,1359705855959,127227995,127241371,13376
1359705857,127242412,8,2922,365.25,1359705850775,1359705850839,127236187,127236251,64
1359705857,127242412,8,1890,236.25,1359705849174,1359705849238,127234586,127234650,64
1359705857,127242412,9,3246,360.6666667,1359705850838,1359705850966,127236250,127236378,128
1359705857,127242416,8,1890,236.25,1359705851029,1359705851093,127236445,127236509,64
1359705857,127242416,8,1890,236.25,1359705849237,1359705849301,127234653,127234717,64
1359705857,127242416,8,1890,236.25,1359705851221,1359705851285,127236637,127236701,64
1359705857,127242416,15,3751,250.0666667,1359705843604,1359705856084,127229020,127241500,12480
1359705857,127242416,12,3622,301.8333333,1359705851795,1359705855955,127237211,127241371,4160
1359705857,127242420,10,1994,199.4,1359705849613,1359705849805,127235033,127235225,192
1359705857,127242420,6,1811,301.8333333,1359705844429,1359705855949,127229849,127241369,11520
1359705857,127242420,8,2386,298.25,1359705849809,1359705849873,127235229,127235293,64
1359705857,127242420,8,2378,297.25,1359705849872,1359705850000,127235292,127235420,128
1359705857,127242420,10,2482,248.2,1359705850063,1359705850191,127235483,127235611,128
1359705857,127242420,10,1994,199.4,1359705850190,1359705850382,127235610,127235802,192
1359705857,127242420,8,1977,247.125,1359705853646,1359705855950,127239066,127241370,2304
1359705857,127242440,10,1994,199.4,1359705848826,1359705848954,127234266,127234394,128
1359705857,127242440,10,1994,199.4,1359705850363,1359705850619,127235803,127236059,256
1359705864,3060528704,4,478,119.5,1359705856780,1359705856780,3060521484,3060521484,0
1359705878,127263976,1,108,108,1359705852068,1359705852068,127238044,127238044,0
1359705878,127263976,1,108,108,1359705852004,1359705852004,127237980,127237980,0
1359705878,127264036,1,108,108,1359705852069,1359705852069,127238105,127238105,0
1359705880,3060544776,2,104,52,1359705854727,1359705855175,3060519503,3060519951,448
1359708165,129550260,1,46,46,1359708139019,1359708139019,129524279,129524279,0
1359709401,130786524,1,48,48,1359709373807,1359709373807,130759331,130759331,0
1359710530,131915592,1,46,46,1359710502363,1359710502363,131887955,131887955,0
1359712298,3066961896,1,404,404,1359712273119,1359712273119,3066937015,3066937015,0
1359712596,133981644,1,48,48,1359712568647,1359712568647,133954291,133954291,0
1359714033,135418724,2,104,52,1359714024737,1359714027745,135410461,135413469,3008
1359715232,136617808,1,46,46,1359715206076,1359715206076,136591884,136591884,0
1359715825,137210628,1,60,60,1359715799079,1359715799079,137184707,137184707,0
1359715845,137230700,1,60,60,1359715819933,1359715819933,137205633,137205633,0
1359716254,137639416,1,46,46,1359716250611,1359716250611,137636027,137636027,0
1359717196,138581196,1,46,46,1359717171459,1359717171459,138556655,138556655,0
1359717452,138837672,1,46,46,1359717427041,1359717427041,138812713,138812713,0
1359717452,138837676,1,46,46,1359717427423,1359717427423,138813099,138813099,0
1359717724,139109996,1,46,46,1359717699483,1359717699483,139085479,139085479,0
1359718097,139482476,1,46,46,1359718072286,1359718072286,139457762,139457762,0
1359718101,139486524,1,46,46,1359718074155,1359718074155,139459679,139459679,0
1359718542,139927944,1,48,48,1359718516739,1359718516739,139902683,139902683,0
1359718542,139927980,1,48,48,1359718516830,1359718516830,139902810,139902810,0
1359718605,139991116,1,108,108,1359718603350,1359718603350,139989466,139989466,0
1359718605,139991116,3,2365,788.3333333,1359718603414,1359718603542,139989530,139989658,128
1359718605,139991116,2,216,108,1359718603222,1359718603350,139989338,139989466,128
1359718605,139991116,2,216,108,1359718603414,1359718603542,139989530,139989658,128
1359718610,139995740,9,3009,334.3333333,1359718607308,1359718607500,139993048,139993240,192
1359718610,139995744,11,3294,299.4545455,1359718609033,1359718609865,139994777,139995609,832
1359718610,139995748,7,1966,280.8571429,1359718607364,1359718607684,139993112,139993432,320
1359718610,139995748,8,3492,436.5,1359718607747,1359718608707,139993495,139994455,960
1359718610,139995748,5,1263,252.6,1359718607683,1359718607747,139993431,139993495,64
1359718610,139995752,7,1952,278.8571429,1359718604674,1359718604930,139990426,139990682,256
1359718610,139995752,5,772,154.4,1359718604738,1359718604994,139990490,139990746,256
1359718610,139995752,9,2647,294.1111111,1359718604930,1359718606210,139990682,139991962,1280
1359718611,3073274880,5,451,90.2,1359718607002,1359718607578,3073270882,3073271458,576
1359718612,3073275940,5,451,90.2,1359718610975,1359718611423,3073274915,3073275363,448
1359718612,3073275940,4,1448,362,1359718607775,1359718607839,3073271715,3073271779,64
1359718618,140003752,4,724,181,1359718613441,1359718613505,139999193,139999257,64
1359718618,140003752,6,798,133,1359718610049,1359718610305,139995801,139996057,256
1359718618,140003752,8,1929,241.125,1359718613633,1359718614209,139999385,139999961,576
1359718618,140003752,10,3381,338.1,1359718613696,1359718613952,139999448,139999704,256
1359718618,140003752,6,983,163.8333333,1359718609856,1359718610048,139995608,139995800,192
1359718618,140003756,12,4735,394.5833333,1359718614654,1359718614910,140000410,140000666,256
1359718618,140003756,5,609,121.8,1359718614974,1359718615230,140000730,140000986,256
1359718618,140003756,9,3009,334.3333333,1359718614974,1359718615166,140000730,140000922,192
1359718618,140003756,12,4967,413.9166667,1359718615165,1359718615421,140000921,140001177,256
1359718618,140003756,8,2983,372.875,1359718611965,1359718612733,139997721,139998489,768
1359718618,140003756,9,1913,212.5555556,1359718615421,1359718615869,140001177,140001625,448
1359718618,140003756,5,609,121.8,1359718612221,1359718612669,139997977,139998425,448
1359718618,140003756,5,609,121.8,1359718613115,1359718613499,139998871,139999255,384
1359718618,140003756,10,3181,318.1,1359718616379,1359718617083,140002135,140002839,704
1359718618,140003760,10,3381,338.1,1359718617274,1359718617658,140003034,140003418,384
1359718618,140003760,7,1460,208.5714286,1359718609913,1359718610489,139995673,139996249,576
1359718618,140003760,5,609,121.8,1359718614009,1359718614393,139999769,140000153,384
1359718618,140003760,10,3632,363.2,1359718610679,1359718611895,139996439,139997655,1216
1359718618,140003760,12,4967,413.9166667,1359718611063,1359718611319,139996823,139997079,256
1359718618,140003760,11,5273,479.3636364,1359718614711,1359718614967,140000471,140000727,256
1359718618,140003764,5,609,121.8,1359718611382,1359718611766,139997146,139997530,384
1359718618,140003764,9,1913,212.5555556,1359718611958,1359718612150,139997722,139997914,192
1359718618,140003764,12,4727,393.9166667,1359718612853,1359718613109,139998617,139998873,256
1359718619,3073282888,4,445,111.25,1359718614932,1359718615060,3073278820,3073278948,128
1359718620,3073283936,235,347341,1478.046809,1359718615715,1359718616227,3073279651,3073280163,512
1359718620,3073283936,5,2109,421.8,1359718613219,1359718613219,3073277155,3073277155,0
1359718620,3073283936,5,451,90.2,1359718612194,1359718612386,3073276130,3073276322,192
1359718620,3073283936,4,445,111.25,1359718613153,1359718613281,3073277089,3073277217,128
1359718620,3073283936,5,451,90.2,1359718613921,1359718614113,3073277857,3073278049,192
1359718626,140011728,10,1877,187.7,1359718618457,1359718619481,140004185,140005209,1024
1359718626,140011728,8,3258,407.25,1359718623895,1359718625879,140009623,140011607,1984
1359718626,140011732,10,3189,318.9,1359718617812,1359718618388,140003544,140004120,576
1359718626,140011732,9,2849,316.5555556,1359718622931,1359718623379,140008663,140009111,448
1359718626,140011736,9,1913,212.5555556,1359718620369,1359718621009,140006105,140006745,640
1359718626,140011736,9,1913,212.5555556,1359718621136,1359718622608,140006872,140008344,1472
1359718628,3073291936,4,1448,362,1359718623970,1359718624034,3073287906,3073287970,64
1359718628,3073291940,4,445,111.25,1359718625631,1359718625759,3073289571,3073289699,128
1359718628,3073291940,86,123737,1438.802326,1359718621535,1359718621919,3073285475,3073285859,384
1359718633,140019148,1,46,46,1359718605940,1359718605940,139992088,139992088,0
1359718634,140019752,9,3345,371.6666667,1359718625986,1359718626946,140011738,140012698,960
1359718634,140019752,4,715,178.75,1359718628095,1359718628159,140013847,140013911,64
1359718634,140019752,11,3096,281.4545455,1359718628351,1359718629055,140014103,140014807,704
1359718634,140019756,14,7501,535.7857143,1359718629118,1359718629886,140014874,140015642,768
1359718654,140039188,1,52,52,1359718626549,1359718626549,140011737,140011737,0
1359719066,140452124,1,46,46,1359719041350,1359719041350,140427474,140427474,0
1359719208,140593952,1,48,48,1359719179758,1359719179758,140565710,140565710,0
1359719209,140595160,1,48,48,1359719179678,1359719179678,140565838,140565838,0
1359720830,142215904,1,46,46,1359720802373,1359720802373,142188277,142188277,0
1359722095,143480940,1,46,46,1359722067152,1359722067152,143453092,143453092,0
1359722095,143480972,1,46,46,1359722067119,1359722067119,143453091,143453091,0
1359722482,143867780,1,127,127,1359722455659,1359722455659,143841439,143841439,0
1359722554,143939932,1,127,127,1359722526610,1359722526610,143912542,143912542,0
1359722919,144304848,3,1058,352.6666667,1359722893793,1359722918817,144279641,144304665,25024
1359722947,144332856,4,3808,952,1359722922071,1359722944343,144307927,144330199,22272
1359722995,144380868,1,952,952,1359722968331,1359722968331,144354199,144354199,0
1359723023,144408868,1,48,48,1359722997386,1359722997386,144383254,144383254,0
1359723196,144581192,1,46,46,1359723171113,1359723171113,144556305,144556305,0
1359723668,145053848,1,46,46,1359723641749,1359723641749,145027597,145027597,0
1359724157,145543116,1,46,46,1359724132481,1359724132481,145518597,145518597,0
1359725333,146718636,1,46,46,1359725308494,1359725308494,146694130,146694130,0
1359725541,146926896,1,48,48,1359725516230,1359725516230,146902126,146902126,0
1359726855,148241020,1,46,46,1359726828663,1359726828663,148214683,148214683,0
1359727076,148461188,1,46,46,1359727050997,1359727050997,148436185,148436185,0
1359728676,150062012,1,48,48,1359728651042,1359728651042,150037054,150037054,0
1359729008,150393712,3,162,54,1359728982475,1359728988491,150368187,150374203,6016
1359731327,152712560,3,162,54,1359731301501,1359731307453,152687061,152693013,5952
1359732470,153855388,1,46,46,1359732442522,1359732442522,153827910,153827910,0
1359733472,154857504,1,95,95,1359733446680,1359733446680,154832184,154832184,0
1359733918,155303972,1,48,48,1359733891068,1359733891068,155277040,155277040,0
1359734426,155811832,3,162,54,1359734401409,1359734407425,155787241,155793257,6016
1359734578,155964120,1,46,46,1359734552223,1359734552223,155938343,155938343,0
1359735683,157068380,1,46,46,1359735656305,1359735656305,157041685,157041685,0
1359735715,157100144,1,48,48,1359735687067,1359735687067,157072211,157072211,0
1359735789,157174896,1,48,48,1359735762601,1359735762601,157148497,157148497,0
1359737350,158735132,1,52,52,1359737322512,1359737322512,158707644,158707644,0
1359738003,159388380,1,48,48,1359737978766,1359737978766,159364146,159364146,0
1359738003,159388468,1,48,48,1359737975671,1359737975671,159361139,159361139,0
1359738031,159416544,1,48,48,1359738005351,1359738005351,159390895,159390895,0
1359738035,159420492,1,48,48,1359738008283,1359738008283,159393775,159393775,0
1359738994,160379492,1,46,46,1359738966990,1359738966990,160352482,160352482,0
1359739904,161289756,1,46,46,1359739876920,1359739876920,161262676,161262676,0
1359741463,162848904,2,122,61,1359741438221,1359741440461,162824125,162826365,2240
1359741753,163138972,1,46,46,1359741723780,1359741723780,163109752,163109752,0
1359741864,163249472,3,144,48,1359741837623,1359741846775,163223095,163232247,9152
1359742321,3096985648,1,46,46,1359742293686,1359742293686,3096958334,3096958334,0
1359742574,163959496,1,48,48,1359742548498,1359742548498,163933994,163933994,0
1359744836,166221212,1,60,60,1359744811276,1359744811276,166196488,166196488,0
1359745076,166461752,1,58,58,1359745050605,1359745050605,166436357,166436357,0
1359745108,166493636,5,240,48,1359745080223,1359745102559,166465859,166488195,22336
1359745482,166867204,1,46,46,1359745456266,1359745456266,166841470,166841470,0
1359746673,168058304,1,46,46,1359746645972,1359746645972,168031276,168031276,0
1359747434,168819384,1,60,60,1359747406713,1359747406713,168792097,168792097,0
1359747955,169340604,1,46,46,1359747929174,1359747929174,169314778,169314778,0
1359748198,169583568,1,46,46,1359748168371,1359748168371,169553939,169553939,0
1359751358,172743324,1,46,46,1359751331448,1359751331448,172716772,172716772,0
1359751966,173351144,1,48,48,1359751938532,1359751938532,173323676,173323676,0
1359752088,173473208,1,95,95,1359752061217,1359752061217,173446425,173446425,0
1359752471,173856644,1,46,46,1359752442856,1359752442856,173828500,173828500,0
1359752890,174275180,1,46,46,1359752863856,1359752863856,174249036,174249036,0
1359753015,174400556,1,64,64,1359752988343,1359752988343,174373899,174373899,0
1359753055,3107718848,1,48,48,1359753025884,1359753025884,3107689732,3107689732,0
1359753355,174740544,1,46,46,1359753326848,1359753326848,174712392,174712392,0
1359753580,174965140,3,152,50.66666667,1359753555536,1359753564496,174940676,174949636,8960
1359754751,176136260,1,48,48,1359754723077,1359754723077,176108337,176108337,0
1359754775,3109439136,1,46,46,1359754748363,1359754748363,3109412499,3109412499,0
1359756552,177937056,1,46,46,1359756525750,1359756525750,177910806,177910806,0
1359757827,179212220,1,60,60,1359757802175,1359757802175,179187395,179187395,0
1359758621,180006796,1,46,46,1359758593649,1359758593649,179979445,179979445,0
1359758963,3113627096,1,46,46,1359758933967,1359758933967,3113598063,3113598063,0
1359759356,180741992,1,48,48,1359759327524,1359759327524,180713516,180713516,0
1359759612,180997580,1,84,84,1359759586748,1359759586748,180972328,180972328,0
1359760381,181766560,1,64,64,1359760354690,1359760354690,181740250,181740250,0
1359761753,183139024,1,46,46,1359761727517,1359761727517,183113541,183113541,0
1359762980,184365076,1,52,52,1359762952767,1359762952767,184337843,184337843,0
1359764762,186147804,1,46,46,1359764735309,1359764735309,186121113,186121113,0
1359766189,187574284,1,78,78,1359766164287,1359766164287,187549571,187549571,0
1359767187,188572212,1,60,60,1359767161721,1359767161721,188546933,188546933,0
1359767215,188600024,1,60,60,1359767186997,1359767186997,188572021,188572021,0
1359767231,188616172,1,60,60,1359767204641,1359767204641,188589813,188589813,0
1359767283,188668232,1,60,60,1359767255458,1359767255458,188640690,188640690,0
1359767327,188712308,1,60,60,1359767302103,1359767302103,188687411,188687411,0
1359767331,188716308,1,60,60,1359767304340,1359767304340,188689648,188689648,0
1359767343,188728276,1,60,60,1359767318580,1359767318580,188703856,188703856,0
1359767367,188752396,1,60,60,1359767341951,1359767341951,188727347,188727347,0
1359769868,191253704,1,58,58,1359769842916,1359769842916,191228620,191228620,0
1359769900,191285744,5,240,48,1359769872185,1359769894265,191257929,191280009,22080
1359769944,191329980,1,48,48,1359769918286,1359769918286,191304266,191304266,0
1359769972,191357948,1,48,48,1359769947695,1359769947695,191333643,191333643,0
1359771147,192532076,1,95,95,1359771121925,1359771121925,192507001,192507001,0
1359772384,193769724,1,60,60,1359772356713,1359772356713,193742437,193742437,0
1359775140,3129804196,1,48,48,1359775112339,1359775112339,3129776535,3129776535,0
1359775541,196926312,1,64,64,1359775513812,1359775513812,196899124,196899124,0
1359777017,198402480,1,46,46,1359776987414,1359776987414,198372894,198372894,0
1359777908,199293940,1,46,46,1359777880699,1359777880699,199266639,199266639,0
1359782079,203464884,1,48,48,1359782052086,1359782052086,203437970,203437970,0
1359782292,203677300,1,95,95,1359782265785,1359782265785,203651085,203651085,0
1359782779,3137442784,1,404,404,1359782751459,1359782751459,3137415243,3137415243,0
1359788258,209643332,1,60,60,1359788232575,1359788232575,209617907,209617907,0
1359790247,211632344,1,68,68,1359790219411,1359790219411,211604755,211604755,0
1359790644,212029748,1,60,60,1359790618236,1359790618236,212003984,212003984,0
1359792468,213853352,1,60,60,1359792442219,1359792442219,213827571,213827571,0
1359794577,215962852,1,48,48,1359794548503,1359794548503,215934355,215934355,0
1359794736,216121340,1,46,46,1359794711762,1359794711762,216097102,216097102,0
1359795675,217059996,5,250,50,1359795649567,1359795671391,217034563,217056387,21824
1359795723,217108412,2,96,48,1359795695485,1359795695485,217080897,217080897,0
1359798498,219883452,1,48,48,1359798472489,1359798472489,219857941,219857941,0
1359801929,223313956,1,46,46,1359801903206,1359801903206,223288162,223288162,0
1359803176,224561408,1,48,48,1359803147856,1359803147856,224533264,224533264,0
1359803499,224884384,1,46,46,1359803474530,1359803474530,224859914,224859914,0
1359804035,225420284,1,48,48,1359804006205,1359804006205,225391489,225391489,0
1359805003,3159666712,6,511,85.16666667,1359805000061,1359805000253,3159663773,3159663965,192
1359805003,3159666712,4,1448,362,1359805000573,1359805000637,3159664285,3159664349,64
1359805004,226389372,7,1460,208.5714286,1359805002199,1359805002711,226387571,226388083,512
1359805004,226389372,11,3139,285.3636364,1359805002327,1359805003095,226387699,226388467,768
1359805004,226389372,8,3137,392.125,1359804998551,1359804999255,226383923,226384627,704
1359805004,226389376,5,609,121.8,1359805003284,1359805003668,226388660,226389044,384
1359805004,226389376,4,724,181,1359805003795,1359805003859,226389171,226389235,64
1359805004,226389376,9,3009,334.3333333,1359804999955,1359805000147,226385331,226385523,192
1359805004,226389376,5,1263,252.6,1359805000338,1359805000402,226385714,226385778,64
1359805004,226389376,8,3492,436.5,1359805000402,1359805001106,226385778,226386482,704
1359805004,226389380,11,3294,299.4545455,1359805001424,1359805002128,226386804,226387508,704
1359805004,226389380,9,2647,294.1111111,1359804998287,1359804998799,226383667,226384179,512
1359805004,226389380,6,983,163.8333333,1359805002127,1359805002319,226387507,226387699,192
1359805004,226389380,6,798,133,1359805002319,1359805002575,226387699,226387955,256
1359805004,226389380,10,9936,993.6,1359805002511,1359805002639,226387891,226388019,128
1359805004,226389380,12,4967,413.9166667,1359805002958,1359805003150,226388338,226388530,192
1359805010,3159674448,5,451,90.2,1359805002396,1359805002588,3159666844,3159667036,192
1359805011,3159674708,4,445,111.25,1359805007871,1359805007999,3159671579,3159671707,128
1359805011,3159674708,4,1448,362,1359805008831,1359805008895,3159672539,3159672603,64
1359805011,3159674708,237,348893,1472.122363,1359805008639,1359805009279,3159672347,3159672987,640
1359805011,3159674712,5,2109,421.8,1359805003517,1359805003581,3159667229,3159667293,64
1359805011,3159674712,5,451,90.2,1359805004093,1359805004221,3159667805,3159667933,128
1359805011,3159674712,4,445,111.25,1359805005245,1359805005437,3159668957,3159669149,192
1359805011,3159674712,5,451,90.2,1359805006140,1359805007164,3159669852,3159670876,1024
1359805012,226397408,10,3181,318.1,1359805006067,1359805006259,226391475,226391667,192
1359805012,226397408,10,3397,339.7,1359805010291,1359805011699,226395699,226397107,1408
1359805012,226397408,10,3381,338.1,1359805006259,1359805006515,226391667,226391923,256
1359805012,226397412,10,3381,338.1,1359805006829,1359805007021,226392241,226392433,192
1359805012,226397412,11,2017,183.3636364,1359805007472,1359805007856,226392884,226393268,384
1359805012,226397412,10,3189,318.9,1359805007600,1359805007792,226393012,226393204,192
1359805012,226397412,9,2861,317.8888889,1359805007855,1359805008175,226393267,226393587,320
1359805012,226397412,12,4727,393.9166667,1359805005103,1359805005295,226390515,226390707,192
1359805012,226397412,15,8365,557.6666667,1359805005166,1359805005422,226390578,226390834,256
1359805012,226397412,12,4967,413.9166667,1359805005614,1359805005870,226391026,226391282,256
1359805012,226397416,9,1913,212.5555556,1359805005869,1359805006061,226391285,226391477,192
1359805012,226397416,5,609,121.8,1359805004139,1359805004651,226389555,226390067,512
1359805012,226397416,10,1877,187.7,1359805006698,1359805007210,226392114,226392626,512
1359805012,226397416,10,3189,318.9,1359805006506,1359805006698,226391922,226392114,192
1359805012,226397416,5,609,121.8,1359805007081,1359805007401,226392497,226392817,320
1359805012,226397416,9,1913,212.5555556,1359805007209,1359805007401,226392625,226392817,192
1359805012,226397420,5,609,121.8,1359805007849,1359805008169,226393269,226393589,320
1359805012,226397420,10,1959,195.9,1359805003817,1359805004073,226389237,226389493,256
1359805012,226397420,5,609,121.8,1359805005352,1359805005672,226390772,226391092,320
1359805012,226397420,9,3009,334.3333333,1359805005416,1359805005608,226390836,226391028,192
1359805012,226397420,9,3310,367.7777778,1359805008424,1359805010280,226393844,226395700,1856
1359805019,3159682708,87,123789,1422.862069,1359805014720,1359805015296,3159678428,3159679004,576
1359805020,226405404,4,715,178.75,1359805018936,1359805019000,226404340,226404404,64
1359805020,226405408,11,3096,281.4545455,1359805019122,1359805019826,226404530,226405234,704
1359805027,3159690712,4,445,111.25,1359805018750,1359805018942,3159682462,3159682654,192
1359805028,226413416,14,7501,535.7857143,1359805019818,1359805020522,226405234,226405938,704
1359805030,226415532,7,1877,268.1428571,1359805003829,1359805004533,226389361,226390065,704
1359808068,229453152,1,46,46,1359808038213,1359808038213,229423365,229423365,0
1359808606,229991084,1,64,64,1359808578049,1359808578049,229963133,229963133,0
1359808733,230117904,1,48,48,1359808703601,1359808703601,230088505,230088505,0
1359809900,231285656,1,74,74,1359809872113,1359809872113,231257769,231257769,0
1359810390,231775596,1,46,46,1359810363876,1359810363876,231749472,231749472,0
1359811645,233030248,1,48,48,1359811618990,1359811618990,233004238,233004238,0
1359812583,233968104,1,46,46,1359812557039,1359812557039,233942143,233942143,0
1359812583,233968148,1,46,46,1359812556678,1359812556678,233941826,233941826,0
1359813385,234770072,1,60,60,1359813360517,1359813360517,234745589,234745589,0
1359814354,235739848,1,60,60,1359814328685,1359814328685,235714533,235714533,0
1359814366,235751776,1,60,60,1359814339894,1359814339894,235725670,235725670,0
1359815479,236864448,1,48,48,1359815453357,1359815453357,236838805,236838805,0
1359816263,237648716,1,46,46,1359816237268,1359816237268,237622984,237622984,0
1359819374,240759492,1,46,46,1359819347652,1359819347652,240733144,240733144,0
1359819707,241092360,1,46,46,1359819681733,1359819681733,241067093,241067093,0
1359821066,242451668,2,122,61,1359821037947,1359821040251,242423615,242425919,2304
1359821298,242683828,3,144,48,1359821272920,1359821281880,242658748,242667708,8960
1359821326,242711828,1,48,48,1359821298457,1359821298457,242684285,242684285,0
1359821527,242912520,1,48,48,1359821501958,1359821501958,242887478,242887478,0
1359823210,244595748,1,60,60,1359823182156,1359823182156,244567904,244567904,0
1359823343,244728200,1,52,52,1359823316267,1359823316267,244701467,244701467,0
1359825269,246654428,1,46,46,1359825242090,1359825242090,246627518,246627518,0
1359825753,247138060,4,202,50.5,1359825727507,1359825749331,247112567,247134391,21824
1359826286,247671172,2,122,61,1359826260701,1359826262941,247645873,247648113,2240
1359826783,248167948,5,250,50,1359826757302,1359826778678,248142250,248163626,21376
1359826831,248215884,1,48,48,1359826803250,1359826803250,248188134,248188134,0
1359826859,248244004,1,48,48,1359826832633,1359826832633,248217637,248217637,0
1359829144,250529104,1,60,60,1359829116533,1359829116533,250501637,250501637,0
1359829172,250557164,1,56,56,1359829147574,1359829147574,250532738,250532738,0
1359831076,252461684,1,56,56,1359831050323,1359831050323,252436007,252436007,0
1359834861,256246784,1,48,48,1359834831221,1359834831221,256217005,256217005,0
1359835661,257046456,1,60,60,1359835658672,1359835658672,257044128,257044128,0
1359836864,258249788,1,48,48,1359836838289,1359836838289,258224077,258224077,0
1359837379,258764252,1,48,48,1359837350436,1359837350436,258735688,258735688,0
1359837390,258774848,1,60,60,1359837362103,1359837362103,258746951,258746951,0
1359837510,258895336,1,60,60,1359837484046,1359837484046,258869382,258869382,0
1359837514,258899468,1,60,60,1359837488008,1359837488008,258873476,258873476,0
1359837538,258923512,1,60,60,1359837512988,1359837512988,258898500,258898500,0
1359837638,259023460,1,60,60,1359837613263,1359837613263,258998723,258998723,0
1359837650,259035348,1,46,46,1359837622272,1359837622272,259007620,259007620,0
1359837650,259035364,1,46,46,1359837622576,1359837622576,259007940,259007940,0
1359838434,3193097828,2,96,48,1359838406178,1359838409186,3193070006,3193073014,3008
1359838688,260073352,1,439,439,1359838660905,1359838660905,260046257,260046257,0
1359840628,262013540,2,122,61,1359840600849,1359840603025,261986389,261988565,2176
1359843023,264407840,1,60,60,1359842998058,1359842998058,264382898,264382898,0
1359843027,264411816,1,60,60,1359843001344,1359843001344,264386160,264386160,0
1359843115,264499852,1,60,60,1359843087517,1359843087517,264472369,264472369,0
1359843139,264524228,1,60,60,1359843110818,1359843110818,264496046,264496046,0
1359843207,264592444,1,60,60,1359843181320,1359843181320,264566764,264566764,0
1359843271,264656240,1,60,60,1359843242836,1359843242836,264628076,264628076,0
1359844436,265821444,1,48,48,1359844407736,1359844407736,265793180,265793180,0
1359844651,266036172,1,64,64,1359844622467,1359844622467,266007639,266007639,0
1359847011,268396588,1,60,60,1359846984192,1359846984192,268369780,268369780,0
1359847257,268642044,1,52,52,1359847230875,1359847230875,268615919,268615919,0
1359847318,268702792,1,52,52,1359847291669,1359847291669,268676461,268676461,0
1359875653,297038060,1,60,60,1359875626328,1359875626328,297011388,297011388,0
1359878023,299407672,1,46,46,1359877995831,1359877995831,299380503,299380503,0
1359878106,3232769628,4,478,119.5,1359878108851,1359878108915,3232772479,3232772543,64
1359878106,3232769628,2,112,56,1359878108851,1359878108915,3232772479,3232772543,64
1359878115,299500144,7,2662,380.2857143,1359878114464,1359878114592,299499608,299499736,128
1359878115,299500144,8,2386,298.25,1359878114591,1359878114655,299499735,299499799,64
1359878115,299500144,9,2430,270,1359878114655,1359878114847,299499799,299499991,192
1359878115,299500152,9,3357,373,1359878109270,1359878110230,299494422,299495382,960
1359878115,299500156,10,2770,277,1359878113874,1359878114002,299499030,299499158,128
1359878115,299500156,8,2634,329.25,1359878114130,1359878114194,299499286,299499350,64
1359878115,299500156,10,1994,199.4,1359878114194,1359878114386,299499350,299499542,192
1359878115,299500180,8,1424,178,1359878112187,1359878112571,299497367,299497751,384
1359878115,299500188,8,2378,297.25,1359878113969,1359878114097,299499157,299499285,128
1359878119,299503724,7,2646,378,1359878114821,1359878114885,299499545,299499609,64
1359878119,3232782968,4,971,242.75,1359878113437,1359878113821,3232777405,3232777789,384
1359878123,299508144,11,3307,300.6363636,1359878110813,1359878117917,299495957,299503061,7104
1359878123,299508148,7,1838,262.5714286,1359878114844,1359878114908,299499992,299500056,64
1359878123,299508148,8,2386,298.25,1359878115482,1359878115610,299500630,299500758,128
1359878123,299508152,7,2454,350.5714286,1359878115605,1359878115669,299500757,299500821,64
1359878123,299508152,9,1942,215.7777778,1359878115673,1359878115865,299500825,299501017,192
1359878123,299508152,7,1401,200.1428571,1359878119768,1359878120344,299504920,299505496,576
1359878123,299508152,10,2482,248.2,1359878116119,1359878116311,299501271,299501463,192
1359878123,299508152,10,1994,199.4,1359878116438,1359878116566,299501590,299501718,128
1359878123,299508152,10,1994,199.4,1359878116310,1359878116438,299501462,299501590,128
1359878123,299508156,8,2394,299.25,1359878116693,1359878116757,299501849,299501913,64
1359878123,299508156,10,4818,481.8,1359878116564,1359878116692,299501720,299501848,128
1359878123,299508156,9,3246,360.6666667,1359878116884,1359878117012,299502040,299502168,128
1359878123,299508156,7,2870,410,1359878116755,1359878116883,299501911,299502039,128
1359878123,299508156,10,1994,199.4,1359878117011,1359878117139,299502167,299502295,128
1359878123,299508156,9,3494,388.2222222,1359878117266,1359878117394,299502422,299502550,128
1359878123,299508156,8,2021,252.625,1359878121297,1359878121425,299506453,299506581,128
1359878123,299508160,10,1994,199.4,1359878117517,1359878117645,299502677,299502805,128
1359878123,299508160,12,3732,311,1359878118286,1359878121550,299503446,299506710,3264
1359878123,299508164,10,1994,199.4,1359878115021,1359878115149,299500185,299500313,128
1359878123,299508164,8,1890,236.25,1359878114891,1359878115019,299500055,299500183,128
1359878123,299508164,8,1890,236.25,1359878115147,1359878115275,299500311,299500439,128
1359878123,299508188,8,1890,236.25,1359878115253,1359878115317,299500441,299500505,64
1359878123,299508188,8,1890,236.25,1359878115316,1359878115444,299500504,299500632,128
1359878123,299508188,8,2386,298.25,1359878115827,1359878115891,299501015,299501079,64
1359878123,299508188,8,2378,297.25,1359878115890,1359878116018,299501078,299501206,128
1359878123,299508188,8,2746,343.25,1359878116018,1359878116082,299501206,299501270,64
1359878123,299508192,9,1942,215.7777778,1359878117102,1359878117230,299502294,299502422,128
1359878123,299508192,9,1942,215.7777778,1359878117357,1359878117485,299502549,299502677,128
1359878123,299508196,5,1275,255,1359878117932,1359878121516,299503128,299506712,3584
1359878127,3232790976,4,478,119.5,1359878123094,1359878123158,3232787070,3232787134,64
1359878127,3232790976,2,859,429.5,1359878108693,1359878121557,3232772669,3232785533,12864
1359878147,299531816,1,108,108,1359878121128,1359878121128,299505944,299505944,0
1359878147,299531928,1,108,108,1359878120952,1359878120952,299505880,299505880,0
1359878147,299531928,1,108,108,1359878121077,1359878121077,299506005,299506005,0
1359879925,3234588552,1,48,48,1359879897095,1359879897095,3234560647,3234560647,0
1359880112,301496700,1,48,48,1359880085947,1359880085947,301470647,301470647,0
1359880637,302021748,1,60,60,1359880612483,1359880612483,301997231,301997231,0
1359880813,302197796,1,48,48,1359880788113,1359880788113,302172909,302172909,0
1359881266,302651140,1,60,60,1359881239476,1359881239476,302624616,302624616,0
1359882076,303460776,2,96,48,1359882048915,1359882051731,303433691,303436507,2816
1359883728,305112720,1,48,48,1359883700978,1359883700978,305085698,305085698,0
1359884552,305936716,1,48,48,1359884523752,1359884523752,305908468,305908468,0
1359884750,306135160,1,48,48,1359884722347,1359884722347,306107507,306107507,0
1359885596,306981532,1,46,46,1359885569383,1359885569383,306954915,306954915,0
1359885705,307089696,1,46,46,1359885679850,1359885679850,307064546,307064546,0
1359886169,307554012,1,60,60,1359886143145,1359886143145,307528157,307528157,0
1359886229,307613996,3,138,46,1359886201527,1359886210615,307586523,307595611,9088
1359887971,309356548,1,60,60,1359887945076,1359887945076,309330624,309330624,0
1359887971,309356600,1,60,60,1359887944066,1359887944066,309329666,309329666,0
1359888132,309516656,3,402,134,1359888105902,1359888111918,309490558,309496574,6016
1359888742,310127364,1,46,46,1359888715550,1359888715550,310100914,310100914,0
1359888742,310127368,1,46,46,1359888715613,1359888715613,310100981,310100981,0
1359889085,310470576,7,372,53.14285714,1359889057094,1359889078982,310442670,310464558,21888
1359889085,310470612,7,372,53.14285714,1359889058017,1359889079969,310443629,310465581,21952
1359889117,310502580,2,96,48,1359889091268,1359889115396,310476848,310500976,24128
1359889117,310502612,2,96,48,1359889092193,1359889116385,310477805,310501997,24192
1359889968,311352964,2,122,61,1359889943452,1359889945564,311328416,311330528,2112
1359890731,312116316,1,48,48,1359890704563,1359890704563,312089879,312089879,0
1359890733,312117636,1,48,48,1359890705240,1359890705240,312089876,312089876,0
1359891036,312421272,1,48,48,1359891007895,1359891007895,312393167,312393167,0
1359891036,312421280,1,48,48,1359891007891,1359891007891,312393171,312393171,0
1359891405,312789784,3,144,48,1359891391996,1359891401084,312776780,312785868,9088
1359891405,312789784,3,2365,788.3333333,1359891404348,1359891404476,312789132,312789260,128
1359891405,312789784,2,216,108,1359891404348,1359891404476,312789132,312789260,128
1359891405,312789784,2,216,108,1359891404476,1359891404540,312789260,312789324,64
1359891405,312789784,6,2158,359.6666667,1359891404091,1359891404603,312788875,312789387,512
1359891408,312792720,1,108,108,1359891404667,1359891404667,312789387,312789387,0
1359891409,312793744,5,1257,251.4,1359891408229,1359891408293,312792973,312793037,64
1359891409,312793744,7,1952,278.8571429,1359891405410,1359891405602,312790154,312790346,192
1359891409,312793748,32,41637,1301.15625,1359891406432,1359891406944,312791180,312791692,512
1359891409,312793748,9,3009,334.3333333,1359891407838,1359891408030,312792586,312792778,192
1359891409,312793752,8,2018,252.25,1359891408157,1359891408349,312792909,312793101,192
1359891409,312793752,5,772,154.4,1359891405403,1359891405659,312790155,312790411,256
1359891410,3246074408,5,451,90.2,1359891406204,1359891406844,3246070612,3246071252,640
1359891410,3246074408,4,1448,362,1359891406588,1359891406652,3246070996,3246071060,64
1359891417,312801772,5,609,121.8,1359891416008,1359891416264,312800780,312801036,256
1359891417,312801772,9,1913,212.5555556,1359891416263,1359891416455,312801035,312801227,192
1359891417,312801772,4,724,181,1359891412167,1359891412231,312796939,312797003,64
1359891417,312801772,5,609,121.8,1359891412231,1359891412551,312797003,312797323,320
1359891417,312801776,5,609,121.8,1359891413189,1359891413637,312797965,312798413,448
1359891417,312801776,11,3294,299.4545455,1359891409796,1359891410628,312794572,312795404,832
1359891417,312801776,15,8365,557.6666667,1359891413444,1359891413636,312798220,312798412,192
1359891417,312801776,9,3009,334.3333333,1359891413699,1359891413955,312798475,312798731,256
1359891417,312801776,9,1913,212.5555556,1359891414210,1359891414402,312798986,312799178,192
1359891417,312801776,5,609,121.8,1359891414210,1359891414530,312798986,312799306,320
1359891417,312801776,6,983,163.8333333,1359891410626,1359891410882,312795402,312795658,256
1359891417,312801780,10,3381,338.1,1359891414657,1359891414849,312799437,312799629,192
1359891417,312801780,10,3189,318.9,1359891414848,1359891415040,312799628,312799820,192
1359891417,312801780,10,1877,187.7,1359891415040,1359891416000,312799820,312800780,960
1359891417,312801780,8,3492,436.5,1359891407679,1359891409471,312792459,312794251,1792
1359891417,312801780,11,3433,312.0909091,1359891415615,1359891415871,312800395,312800651,256
1359891417,312801780,10,3421,342.1,1359891411967,1359891412159,312796747,312796939,192
1359891417,312801780,9,1913,212.5555556,1359891415999,1359891416255,312800779,312801035,256
1359891417,312801780,9,2849,316.5555556,1359891416446,1359891416702,312801226,312801482,256
1359891417,312801780,12,4735,394.5833333,1359891416446,1359891416638,312801226,312801418,192
1359891417,312801784,9,1913,212.5555556,1359891412857,1359891413049,312797641,312797833,192
1359891417,312801784,10,3181,318.1,1359891413884,1359891414140,312798668,312798924,256
1359891417,312801784,10,3421,342.1,1359891413948,1359891414204,312798732,312798988,256
1359891417,312801784,7,1460,208.5714286,1359891410811,1359891411323,312795595,312796107,512
1359891417,312801784,9,3035,337.2222222,1359891410747,1359891411387,312795531,312796171,640
1359891417,312801784,12,4727,393.9166667,1359891414395,1359891414651,312799179,312799435,256
1359891417,312801784,6,798,133,1359891410875,1359891411259,312795659,312796043,384
1359891418,3246082420,4,445,111.25,1359891412913,1359891413105,3246077333,3246077525,192
1359891418,3246082420,5,2109,421.8,1359891410608,1359891410672,3246075028,3246075092,64
1359891418,3246082420,5,451,90.2,1359891411823,1359891412015,3246076243,3246076435,192
1359891418,3246082420,4,1448,362,1359891416047,1359891416047,3246080467,3246080467,0
1359891418,3246082420,4,445,111.25,1359891416303,1359891416431,3246080723,3246080851,128
1359891418,3246082420,4,445,111.25,1359891416495,1359891416623,3246080915,3246081043,128
1359891418,3246082420,4,445,111.25,1359891416687,1359891416879,3246081107,3246081299,192
1359891418,3246082420,5,451,90.2,1359891413678,1359891414830,3246078098,3246079250,1152
1359891418,3246082424,5,451,90.2,1359891410542,1359891411118,3246074966,3246075542,576
1359891418,3246082424,4,445,111.25,1359891415469,1359891415597,3246079893,3246080021,128
1359891425,312809744,5,609,121.8,1359891416738,1359891417122,312801482,312801866,384
1359891425,312809744,9,3310,367.7777778,1359891417313,1359891419041,312802057,312803785,1728
1359891425,312809748,14,7501,535.7857143,1359891422175,1359891422943,312806923,312807691,768
1359891425,312809748,10,3397,339.7,1359891419038,1359891420254,312803786,312805002,1216
1359891425,312809756,4,715,178.75,1359891421209,1359891421273,312805965,312806029,64
1359891425,312809756,10,3050,305,1359891421337,1359891422105,312806093,312806861,768
1359891440,312824740,7,1877,268.1428571,1359891412389,1359891412965,312797129,312797705,576
1359891764,313149348,3,402,134,1359891736514,1359891742530,313121862,313127878,6016
1359892634,314019480,1,46,46,1359892605873,1359892605873,313991353,313991353,0
1359892635,314020072,1,46,46,1359892606282,1359892606282,313991354,313991354,0
1359893593,314978080,3,402,134,1359893567409,1359893573489,314952489,314958569,6080
1359894210,315595532,1,64,64,1359894184035,1359894184035,315569567,315569567,0
1359894210,315595536,1,64,64,1359894184031,1359894184031,315569567,315569567,0
1359894210,315595536,1,64,64,1359894184034,1359894184034,315569570,315569570,0
1359894210,315595580,2,128,64,1359894182838,1359894183926,315568418,315569506,1088
1359894652,316037116,3,150,50,1359894646719,1359894649791,316031835,316034907,3072
1359894672,316056892,3,152,50.66666667,1359894644703,1359894645983,316029595,316030875,1280
1359894672,316056924,3,152,50.66666667,1359894645822,1359894647102,316030746,316032026,1280
1359894672,316056932,3,152,50.66666667,1359894646901,1359894648181,316031833,316033113,1280
1359894680,316064940,1,46,46,1359894653998,1359894653998,316038938,316038938,0
1359894684,316068848,1,48,48,1359894656007,1359894656007,316040855,316040855,0
1359894816,316201360,3,402,134,1359894788103,1359894794119,316173463,316179479,6016
1359894953,316337824,1,46,46,1359894928285,1359894928285,316313109,316313109,0
1359895281,316666108,1,46,46,1359895255548,1359895255548,316640656,316640656,0
1359896034,317418912,3,402,134,1359896009269,1359896015285,317394181,317400197,6016
1359896647,318032432,3,402,134,1359896622500,1359896628580,318007932,318014012,6080
1359897346,318730852,1,71,71,1359897321243,1359897321243,318706095,318706095,0
1359897374,318758828,1,71,71,1359897347187,1359897347187,318732015,318732015,0
1359897562,318947324,3,381,127,1359897534210,1359897540482,318919534,318925806,6272
1359897602,318987372,3,384,128,1359897577232,1359897583248,318962604,318968620,6016
1359898449,319833952,3,384,128,1359898424166,1359898430246,319809118,319815198,6080
1359899082,320467176,3,402,134,1359899056768,1359899062784,320441944,320447960,6016
1359899699,321084140,3,402,134,1359899674522,1359899680538,321059662,321065678,6016
1359899940,321324932,2,256,128,1359899912612,1359899920676,321297544,321305608,8064
1359900280,321665108,3,144,48,1359900254446,1359900255918,321639554,321641026,1472
1359900280,321665164,2,96,48,1359900253239,1359900256247,321638403,321641411,3008
1359900280,321665176,3,144,48,1359900254317,1359900255853,321639493,321641029,1536
1359900280,321665176,3,144,48,1359900254317,1359900255853,321639493,321641029,1536
1359900420,321805288,1,60,60,1359900392186,1359900392186,321777474,321777474,0
1359900420,321805360,1,60,60,1359900395250,1359900395250,321780610,321780610,0
1359900444,321829272,1,60,60,1359900417930,1359900417930,321803202,321803202,0
1359900448,321833232,1,60,60,1359900419890,1359900419890,321805122,321805122,0
1359900520,321905256,1,60,60,1359900492566,1359900492566,321877822,321877822,0
1359900524,321909268,1,60,60,1359900497293,1359900497293,321882561,321882561,0
1359900528,321913336,1,60,60,1359900502985,1359900502985,321888321,321888321,0
1359900536,321921252,1,60,60,1359900507932,1359900507932,321893184,321893184,0
1359900548,321933364,1,60,60,1359900521580,1359900521580,321906944,321906944,0
1359900552,321937320,1,60,60,1359900526873,1359900526873,321912193,321912193,0
1359900560,321945384,3,384,128,1359900532696,1359900540824,321918080,321926208,8128
1359900593,321977776,1,48,48,1359900566582,1359900566582,321951358,321951358,0
1359900649,322033592,3,152,50.66666667,1359900623728,1359900624944,322008320,322009536,1216
1359900652,322037400,3,152,50.66666667,1359900625159,1359900626375,322010559,322011775,1216
1359900652,322037468,3,152,50.66666667,1359900624001,1359900625217,322009469,322010685,1216
1359900652,322037500,3,152,50.66666667,1359900625060,1359900634020,322010560,322019520,8960
1359900808,322193504,1,46,46,1359900780571,1359900780571,322166075,322166075,0
1359900906,322290924,1,48,48,1359900879134,1359900879134,322264058,322264058,0
1359900906,322290924,1,48,48,1359900879132,1359900879132,322264056,322264056,0
1359901181,322566152,3,384,128,1359901154678,1359901162422,322539830,322547574,7744
1359901883,323268352,1,48,48,1359901856227,1359901856227,323241579,323241579,0
1359902056,323440832,1,60,60,1359902031850,1359902031850,323416682,323416682,0
1359902064,323448852,1,60,60,1359902036117,1359902036117,323420969,323420969,0
1359902140,323525028,3,402,134,1359902112101,1359902118181,323497129,323503209,6080
1359902409,323793744,3,384,128,1359902383549,1359902392637,323768293,323777381,9088
1359902753,324138172,3,402,134,1359902727562,1359902733578,324112734,324118750,6016
1359903042,324426948,3,384,128,1359903014437,1359903022501,324399385,324407449,8064
1359903591,324976484,1,48,48,1359903566727,1359903566727,324952211,324952211,0
1359903591,324976532,1,48,48,1359903566741,1359903566741,324952273,324952273,0
1359903684,325068772,1,46,46,1359903659402,1359903659402,325044174,325044174,0
1359903684,325068780,1,46,46,1359903659588,1359903659588,325044368,325044368,0
1359903700,325084848,1,48,48,1359903674686,1359903674686,325059534,325059534,0
1359903700,325084940,1,48,48,1359903674532,1359903674532,325059472,325059472,0
1359903788,325173272,1,46,46,1359903761878,1359903761878,325147150,325147150,0
1359903788,325173344,1,46,46,1359903762508,1359903762508,325147852,325147852,0
1359904209,325594372,1,46,46,1359904181932,1359904181932,325567304,325567304,0
1359904210,325594696,1,46,46,1359904182609,1359904182609,325567305,325567305,0
1359904852,326236852,1,46,46,1359904824490,1359904824490,326209342,326209342,0
1359904853,326237964,1,46,46,1359904824379,1359904824379,326209343,326209343,0
1359906534,327918708,1,95,95,1359906506655,1359906506655,327891363,327891363,0
1359907416,328800980,1,46,46,1359907388163,1359907388163,328773143,328773143,0
1359907777,329162020,1,60,60,1359907751894,1359907751894,329136914,329136914,0
1359907785,329170012,1,60,60,1359907758108,1359907758108,329143120,329143120,0
1359907857,329242288,3,399,133,1359907829961,1359907835977,329215249,329221265,6016
1359908094,329478912,1,46,46,1359908068859,1359908068859,329453771,329453771,0
1359908647,330032544,3,399,133,1359908619579,1359908625595,330005123,330011139,6016
1359908968,330353448,1,60,60,1359908941783,1359908941783,330327231,330327231,0
1359908972,330357452,1,60,60,1359908946644,1359908946644,330332096,330332096,0
1359909059,330444292,1,46,46,1359909031795,1359909031795,330417087,330417087,0
1359909059,330444320,1,46,46,1359909031765,1359909031765,330417085,330417085,0
1359910359,331744248,2,122,61,1359910332169,1359910332233,331717417,331717481,64
1359910479,331864340,3,399,133,1359910452779,1359910458859,331838119,331844199,6080
1359911101,332485736,3,399,133,1359911073599,1359911079679,332458335,332464415,6080
1359911562,332946836,1,46,46,1359911535378,1359911535378,332920214,332920214,0
1359913323,334707740,6,384,64,1359913298841,1359913304345,334683581,334689085,5504
1359913323,334707784,1,64,64,1359913298412,1359913298412,334683196,334683196,0
1359913323,334707832,1,64,64,1359913298555,1359913298555,334683387,334683387,0
1359913323,334707832,1,64,64,1359913298746,1359913298746,334683578,334683578,0
1359913543,334927908,3,399,133,1359913515244,1359913521260,334900152,334906168,6016
1359913816,335201460,1,46,46,1359913789377,1359913789377,335174837,335174837,0
1359913848,335232608,1,60,60,1359913820692,1359913820692,335205300,335205300,0
1359913848,335232612,1,60,60,1359913820882,1359913820882,335205494,335205494,0
1359913872,335256576,1,60,60,1359913846708,1359913846708,335231284,335231284,0
1359913880,335264780,1,60,60,1359913851878,1359913851878,335236658,335236658,0
1359913928,335313016,1,60,60,1359913900732,1359913900732,335285748,335285748,0
1359913988,335373096,1,60,60,1359913963177,1359913963177,335348273,335348273,0
1359913999,335383820,1,48,48,1359913970557,1359913970557,335355377,335355377,0
1359914164,335549472,3,399,133,1359914137454,1359914143534,335522926,335529006,6080
1359914453,335838356,1,60,60,1359914427998,1359914427998,335813354,335813354,0
1359915415,336799948,3,152,50.66666667,1359915388522,1359915389866,336773470,336774814,1344
1359915415,336799964,3,152,50.66666667,1359915389977,1359915391321,336774941,336776285,1344
1359915419,336803924,3,570,190,1359915392320,1359915398336,336777244,336783260,6016
1359915843,337228524,1,435,435,1359915815712,1359915815712,337201236,337201236,0
1359917634,339018856,1,48,48,1359917607074,1359917607074,338991930,338991930,0
1359917852,339237484,2,128,64,1359917823980,1359917825004,339209464,339210488,1024
1359917868,339253484,1,60,60,1359917842153,1359917842153,339227637,339227637,0
1359920237,341622448,1,60,60,1359920212011,1359920212011,341597459,341597459,0
1359920382,341766872,1,60,60,1359920357801,1359920357801,341742673,341742673,0
1359920446,341830976,1,60,60,1359920420542,1359920420542,341805518,341805518,0
1359920801,342186404,1,48,48,1359920773453,1359920773453,342158857,342158857,0
1359920855,342239888,1,46,46,1359920829714,1359920829714,342214602,342214602,0
1359920968,342352752,1,48,48,1359920942807,1359920942807,342327559,342327559,0
1359921576,342960972,1,48,48,1359921550832,1359921550832,342935804,342935804,0
1359922289,343674120,3,396,132,1359922262740,1359922268820,343647860,343653940,6080
1359922762,344146824,1,60,60,1359922735473,1359922735473,344120297,344120297,0
1359923392,344776976,2,122,61,1359923367570,1359923369810,344752546,344754786,2240
1359924744,346129020,1,48,48,1359924717968,1359924717968,346102988,346102988,0
1359929298,350683296,1,60,60,1359929271416,1359929271416,350656712,350656712,0
1359929322,350707272,1,60,60,1359929295245,1359929295245,350680517,350680517,0
1359929491,350875944,3,411,137,1359929465620,1359929471700,350850564,350856644,6080
1359930190,351574820,1,52,52,1359930163652,1359930163652,351548472,351548472,0
1359930250,351634604,1,52,52,1359930223450,1359930223450,351608054,351608054,0
1359931842,353226808,1,48,48,1359931815413,1359931815413,353200221,353200221,0
1359932326,353710816,1,48,48,1359932298985,1359932298985,353683801,353683801,0
1359932326,353710848,1,48,48,1359932300105,1359932300105,353684953,353684953,0
1359932326,353710904,1,48,48,1359932300113,1359932300113,353685017,353685017,0
1359933484,354868684,3,390,130,1359933456410,1359933462426,354841094,354847110,6016
1359933756,355141172,1,48,48,1359933730863,1359933730863,355116035,355116035,0
1359933768,355153124,1,46,46,1359933741919,1359933741919,355127043,355127043,0
1359933820,355205468,1,52,52,1359933795268,1359933795268,355180736,355180736,0
1359933997,355381568,1,46,46,1359933971652,1359933971652,355356220,355356220,0
1359934073,355457948,2,122,61,1359934045511,1359934047879,355430459,355432827,2368
1359934504,355888796,1,46,46,1359934477147,1359934477147,355861943,355861943,0
1359934682,356067284,1,52,52,1359934655599,1359934655599,356040883,356040883,0
1359935908,357293168,3,390,130,1359935880081,1359935886161,357265249,357271329,6080
1359936871,358255764,2,96,48,1359936843732,1359936846740,358228496,358231504,3008
1359937665,359050004,1,60,60,1359937638808,1359937638808,359023812,359023812,0
1359937685,359070176,2,120,60,1359937660651,1359937661675,359045827,359046851,1024
1359937766,359150524,1,60,60,1359937739960,1359937739960,359124484,359124484,0
1359937766,359150528,1,60,60,1359937740278,1359937740278,359124806,359124806,0
1359937982,359366592,1,46,46,1359937956273,1359937956273,359340865,359340865,0
1359938652,3293315788,1,46,46,1359938624736,1359938624736,3293288524,3293288524,0
1359938719,360103468,5,250,50,1359938690978,1359938713250,360075446,360097718,22272
1359938763,360147816,1,48,48,1359938736966,1359938736966,360121782,360121782,0
1359938791,360175940,1,48,48,1359938765832,1359938765832,360150772,360150772,0
1359939376,360761376,1,60,60,1359939349965,1359939349965,360735341,360735341,0
1359941081,362465512,1,58,58,1359941055696,1359941055696,362440208,362440208,0
1359941356,362740604,1,48,48,1359941327026,1359941327026,362711630,362711630,0
1359941910,363294504,1,46,46,1359941883534,1359941883534,363268038,363268038,0
1359941910,363294504,1,46,46,1359941883853,1359941883853,363268357,363268357,0
1359942565,363950180,1,64,64,1359942536860,1359942536860,363922040,363922040,0
1359942643,364027588,1,60,60,1359942618157,1359942618157,364002745,364002745,0
1359943160,364545168,1,60,60,1359943133664,1359943133664,364518832,364518832,0
1359943345,364729764,2,92,46,1359943319795,1359943320243,364704559,364705007,448
1359944007,365392280,1,48,48,1359943981730,1359943981730,365367010,365367010,0
1359945085,366470224,1,52,52,1359945060425,1359945060425,366445649,366445649,0
1359945951,367336384,1,52,52,1359945925728,1359945925728,367311112,367311112,0
1359945955,367340180,1,52,52,1359945926889,1359945926889,367312069,367312069,0
1359946148,367532772,1,48,48,1359946119552,1359946119552,367504324,367504324,0
1359947097,368482080,2,96,48,1359947069756,1359947072764,368454836,368457844,3008
1359948068,369452668,3,393,131,1359948042379,1359948048395,369427047,369433063,6016
1359948686,370070500,3,393,131,1359948658920,1359948664936,370043420,370049436,6016
1359948982,370367392,1,48,48,1359948956327,1359948956327,370341719,370341719,0
1359949063,370447628,1,60,60,1359949052644,1359949052644,370437272,370437272,0
1359949099,370483736,1,60,60,1359949074356,1359949074356,370459092,370459092,0
1359949115,370499828,1,60,60,1359949088151,1359949088151,370472979,370472979,0
1359949115,370499868,1,60,60,1359949089137,1359949089137,370474005,370474005,0
1359949115,370499912,1,60,60,1359949089863,1359949089863,370474775,370474775,0
1359949749,3304412772,1,48,48,1359949720441,1359949720441,3304384213,3304384213,0
1359950610,371994744,2,96,48,1359950583574,1359950586966,371968318,371971710,3392
1359950610,371994756,2,96,48,1359950584907,1359950588107,371969663,371972863,3200
1359950610,371994796,2,96,48,1359950582306,1359950585762,371967102,371970558,3456
1359950610,371994868,1,48,48,1359950584857,1359950584857,371969725,371969725,0
1359950915,372299740,1,46,46,1359950889046,1359950889046,372273786,372273786,0
1359950915,372299780,1,46,46,1359950886894,1359950886894,372271674,372271674,0
1359950915,372299780,1,46,46,1359950886893,1359950886893,372271673,372271673,0
1359950915,372299824,1,46,46,1359950888899,1359950888899,372273723,372273723,0
1359951268,372652576,3,393,131,1359951241142,1359951247158,372625718,372631734,6016
1359952645,374030380,1,48,48,1359952616317,1359952616317,374001697,374001697,0
1359953137,374521452,3,393,131,1359953112020,1359953118036,374496472,374502488,6016
1359953775,375159484,3,393,131,1359953749163,1359953755179,375133647,375139663,6016
1359954068,375452452,1,48,48,1359954042180,1359954042180,375426632,375426632,0
1359954970,376355204,1,131,131,1359954968967,1359954968967,376354171,376354171,0
1359954998,376382672,2,262,131,1359954971482,1359954975514,376356154,376360186,4032
1359956131,377516420,1,48,48,1359956112412,1359956112412,377497832,377497832,0
1359956168,377553368,1,46,46,1359956141456,1359956141456,377526824,377526824,0
1359957423,378808200,3,393,131,1359957398693,1359957404773,378783893,378789973,6080
1359958062,379446664,1,46,46,1359958034165,1359958034165,379418829,379418829,0
1359959251,380635744,3,393,131,1359959226127,1359959232143,380610871,380616887,6016
1359959868,381253316,3,393,131,1359959842765,1359959848845,381228081,381234161,6080
1359961087,382471944,3,393,131,1359961062572,1359961068588,382447516,382453532,6016
1359961658,383042848,1,46,46,1359961632260,1359961632260,383017108,383017108,0
1359962575,383959948,1,60,60,1359962550480,1359962550480,383935428,383935428,0
1359962575,383960060,1,60,60,1359962550049,1359962550049,383935109,383935109,0
1359962575,383960060,1,60,60,1359962550112,1359962550112,383935172,383935172,0
1359962579,383963856,1,60,60,1359962551023,1359962551023,383935879,383935879,0
1359962579,383964048,1,60,60,1359962550765,1359962550765,383935813,383935813,0
1359962619,384004000,1,60,60,1359962594012,1359962594012,383979012,383979012,0
1359962623,384008004,1,60,60,1359962594839,1359962594839,383979843,383979843,0
1359962623,384008036,1,60,60,1359962595768,1359962595768,383980804,383980804,0
1359962631,384016044,1,60,60,1359962603378,1359962603378,383988422,383988422,0
1359962651,384036100,1,60,60,1359962625974,1359962625974,384011074,384011074,0
1359963317,384701688,1,48,48,1359963292875,1359963292875,384677563,384677563,0
1359963806,385191300,1,60,60,1359963780576,1359963780576,385165876,385165876,0
1359964885,386269536,1,46,46,1359964858955,1359964858955,386243491,386243491,0
1359965305,386689600,1,46,46,1359965277637,1359965277637,386662237,386662237,0
1359966557,387941768,3,393,131,1359966529865,1359966535945,387914633,387920713,6080
1359967174,388559188,3,393,131,1359967146075,1359967152091,388531263,388537279,6016
1359967788,389172608,3,393,131,1359967761685,1359967767701,389146293,389152309,6016
1359968318,389702472,1,46,46,1359968289429,1359968289429,389673901,389673901,0
1359969002,390386604,7,416,59.42857143,1359968976070,1359968997062,390360674,390381666,20992
1359969006,390390572,8,464,58,1359968978341,1359969004709,390362913,390389281,26368
1359969030,390414600,2,96,48,1359969003145,1359969024137,390387745,390408737,20992
1359969050,390434652,1,48,48,1359969025622,1359969025622,390410274,390410274,0
1359969094,390478692,1,48,48,1359969069037,1359969069037,390453729,390453729,0
1359969098,390482700,1,48,48,1359969070566,1359969070566,390455266,390455266,0
1359970472,391857096,2,92,46,1359970443972,1359970444804,391829068,391829900,832
1359971207,392592084,1,46,46,1359971179974,1359971179974,392565058,392565058,0
1359971430,392814480,3,393,131,1359971402011,1359971408027,392786491,392792507,6016
1359972043,393427616,3,393,131,1359972018828,1359972024908,393403444,393409524,6080
1359973337,394722232,1,46,46,1359973309967,1359973309967,394695199,394695199,0
1359973563,394948164,1,46,46,1359973538128,1359973538128,394923292,394923292,0
1359974465,395849752,1,46,46,1359974439711,1359974439711,395824463,395824463,0
1359974473,395857732,3,393,131,1359974447601,1359974453681,395832333,395838413,6080
1359974677,396061948,1,46,46,1359974650455,1359974650455,396035403,396035403,0
1359975142,396526900,2,122,61,1359975115518,1359975117822,396500418,396502722,2304
1359975856,397240528,1,46,46,1359975829095,1359975829095,397213623,397213623,0
1359976305,397689524,1,46,46,1359976279462,1359976279462,397663986,397663986,0
1359976910,398294716,3,393,131,1359976882266,1359976888282,398266982,398272998,6016
1359977523,398907764,3,393,131,1359977497443,1359977503395,398882207,398888159,5952
1359977775,399160264,1,46,46,1359977749740,1359977749740,399135004,399135004,0
1359977807,399192080,1,108,108,1359977805281,1359977805281,399190361,399190361,0
1359977807,399192080,1,108,108,1359977805089,1359977805089,399190169,399190169,0
1359977807,399192080,4,2054,513.5,1359977805025,1359977805025,399190105,399190105,0
1359977807,399192080,3,2365,788.3333333,1359977805089,1359977805153,399190169,399190233,64
1359977807,399192080,2,216,108,1359977805153,1359977805217,399190233,399190297,64
1359977807,399192088,7,1952,278.8571429,1359977806170,1359977806426,399191258,399191514,256
1359977807,399192088,5,772,154.4,1359977806169,1359977806425,399191257,399191513,256
1359977809,3332473204,4,1448,362,1359977808510,1359977808574,3332472714,3332472778,64
1359977809,3332473208,5,451,90.2,1359977807356,1359977807996,3332471564,3332472204,640
1359977815,399200096,5,609,121.8,1359977811729,1359977812113,399196825,399197209,384
1359977815,399200096,4,724,181,1359977811985,1359977812049,399197081,399197145,64
1359977815,399200096,9,3009,334.3333333,1359977808400,1359977808656,399193496,399193752,256
1359977815,399200100,5,1257,251.4,1359977808848,1359977808912,399193948,399194012,64
1359977815,399200100,11,3294,299.4545455,1359977809806,1359977810510,399194906,399195610,704
1359977815,399200100,9,1913,212.5555556,1359977813454,1359977813646,399198554,399198746,192
1359977815,399200100,5,609,121.8,1359977813710,1359977814030,399198810,399199130,320
1359977815,399200100,9,3009,334.3333333,1359977813838,1359977814030,399198938,399199130,192
1359977815,399200100,10,3421,342.1,1359977814093,1359977814349,399199193,399199449,256
1359977815,399200100,6,983,163.8333333,1359977810509,1359977810765,399195609,399195865,256
1359977815,399200100,7,1460,208.5714286,1359977810701,1359977811277,399195801,399196377,576
1359977815,399200100,12,4727,393.9166667,1359977814221,1359977814413,399199321,399199513,192
1359977815,399200100,9,1913,212.5555556,1359977814349,1359977814605,399199449,399199705,256
1359977815,399200104,12,4727,393.9166667,1359977814600,1359977814792,399199704,399199896,192
1359977815,399200104,10,3421,342.1,1359977811467,1359977811659,399196571,399196763,192
1359977815,399200104,8,3492,436.5,1359977808777,1359977809481,399193881,399194585,704
1359977815,399200108,11,5273,479.3636364,1359977813575,1359977813831,399198683,399198939,256
1359977815,399200108,9,3035,337.2222222,1359977810694,1359977811270,399195802,399196378,576
1359977815,399200108,6,798,133,1359977810758,1359977811078,399195866,399196186,320
1359977815,399200108,5,609,121.8,1359977814470,1359977814726,399199578,399199834,256
1359977817,3332481208,5,451,90.2,1359977811964,1359977813180,3332476172,3332477388,1216
1359977817,3332481208,4,1448,362,1359977816700,1359977816700,3332480908,3332480908,0
1359977817,3332481208,5,451,90.2,1359977811130,1359977811258,3332475338,3332475466,128
1359977817,3332481212,4,445,111.25,1359977816377,1359977816441,3332480589,3332480653,64
1359977817,3332481212,4,445,111.25,1359977813880,1359977814008,3332478092,3332478220,128
1359977817,3332481212,5,2109,421.8,1359977811191,1359977811255,3332475403,3332475467,64
1359977817,3332481212,5,451,90.2,1359977814583,1359977815735,3332478795,3332479947,1152
1359977823,399208092,10,3381,338.1,1359977815957,1359977816149,399201049,399201241,192
1359977823,399208092,4,715,178.75,1359977820181,1359977820181,399205273,399205273,0
1359977823,399208092,9,1913,212.5555556,1359977816213,1359977816405,399201305,399201497,192
1359977823,399208092,9,2849,316.5555556,1359977816468,1359977816660,399201560,399201752,192
1359977823,399208092,10,3050,305,1359977820436,1359977821268,399205528,399206360,832
1359977823,399208096,10,3189,318.9,1359977816656,1359977816848,399201752,399201944,192
1359977823,399208096,5,609,121.8,1359977817043,1359977817491,399202139,399202587,448
1359977823,399208096,13,7455,573.4615385,1359977821267,1359977822163,399206363,399207259,896
1359977823,399208096,10,3381,338.1,1359977814800,1359977814992,399199896,399200088,192
1359977823,399208096,11,3235,294.0909091,1359977814992,1359977815248,399200088,399200344,256
1359977823,399208100,10,1877,187.7,1359977815376,1359977815888,399200476,399200988,512
1359977823,399208100,9,1913,212.5555556,1359977815951,1359977816207,399201051,399201307,256
1359977823,399208100,5,609,121.8,1359977816206,1359977816526,399201306,399201626,320
1359977823,399208100,9,3310,367.7777778,1359977816910,1359977818254,399202010,399203354,1344
1359977823,399208104,9,3345,371.6666667,1359977818315,1359977819211,399203419,399204315,896
1359977825,3332489212,4,445,111.25,1359977817337,1359977817465,3332481549,3332481677,128
1359977825,3332489212,4,445,111.25,1359977817528,1359977817720,3332481740,3332481932,192
1359977825,3332489212,4,445,111.25,1359977817720,1359977817912,3332481932,3332482124,192
1359977831,399216268,2,104,52,1359977805223,1359977805223,399190491,399190491,0
1359977831,399216304,1,108,108,1359977805123,1359977805123,399190427,399190427,0
1359977839,399224340,7,1877,268.1428571,1359977812126,1359977812830,399197466,399198170,704
1359978136,399521140,3,393,131,1359978111779,1359978117795,399496919,399502935,6016
1359978365,399749900,2,92,46,1359978337356,1359978340364,399722256,399725264,3008
1359978442,399827152,1,46,46,1359978414480,1359978414480,399799632,399799632,0
1359978443,399828068,1,46,46,1359978414501,1359978414501,399799569,399799569,0
1359979267,400651596,1,46,46,1359979241583,1359979241583,400626179,400626179,0
1359979820,401204800,1,46,46,1359979794075,1359979794075,401178875,401178875,0
1359980165,401549464,4,202,50.5,1359980137830,1359980158886,401522294,401543350,21056
1359980201,401585448,5,250,50,1359980173172,1359980195444,401557620,401579892,22272
1359980565,401950120,1,445,445,1359980537552,1359980537552,401922672,401922672,0
1359980565,401950132,1,444,444,1359980539908,1359980539908,401925040,401925040,0
1359980589,401974184,1,48,48,1359980561231,1359980561231,401946415,401946415,0
1359981035,402419376,1,48,48,1359981007087,1359981007087,402391463,402391463,0
1359981304,402689132,1,48,48,1359981278266,1359981278266,402663398,402663398,0
1359981304,402689132,1,48,48,1359981278264,1359981278264,402663396,402663396,0
1359981439,402824096,1,56,56,1359981413592,1359981413592,402798688,402798688,0
1359981439,402824172,1,56,56,1359981414222,1359981414222,402799394,402799394,0
1359983599,404984004,3,393,131,1359983572565,1359983578581,404957569,404963585,6016
1359983836,405220496,1,56,56,1359983809548,1359983809548,405194044,405194044,0
1359983836,405220524,1,56,56,1359983810159,1359983810159,405194683,405194683,0
1359983956,405340928,1,46,46,1359983929306,1359983929306,405314234,405314234,0
1359984081,405465380,2,96,48,1359984056830,1359984059838,405441210,405444218,3008
1359984085,405469360,3,144,48,1359984057936,1359984059088,405442296,405443448,1152
1359984085,405469360,3,144,48,1359984057936,1359984059088,405442296,405443448,1152
1359984085,405469400,3,144,48,1359984057895,1359984059047,405442295,405443447,1152
1359984754,406138748,1,78,78,1359984726849,1359984726849,406111597,406111597,0
1359984790,406174848,1,78,78,1359984763548,1359984763548,406148396,406148396,0
1359984850,406235068,1,48,48,1359984822915,1359984822915,406207983,406207983,0
1359987029,408413704,1,46,46,1359987002378,1359987002378,408387082,408387082,0
1359990903,412288152,2,180,90,1359990876432,1359990877328,412261584,412262480,896
1359991661,413046308,1,78,78,1359991634153,1359991634153,413019461,413019461,0
1359995411,416795372,1,48,48,1359995386006,1359995386006,416770378,416770378,0
1359995587,416971828,1,46,46,1359995560139,1359995560139,416944967,416944967,0
1359998934,420319212,1,46,46,1359998906519,1359998906519,420291731,420291731,0
1359999644,421029108,1,46,46,1359999617073,1359999617073,421002181,421002181,0
1359999760,421145284,1,46,46,1359999734402,1359999734402,421119686,421119686,0
1360004009,425393572,1,48,48,1360003979781,1360003979781,425364353,425364353,0
1360005292,426676460,1,46,46,1360005262561,1360005262561,426647021,426647021,0
1360005420,3360083840,1,46,46,1360005391649,1360005391649,3360055489,3360055489,0
1360006153,427537748,1,46,46,1360006125623,1360006125623,427510371,427510371,0
1360008661,430045388,1,60,60,1360008632888,1360008632888,430017276,430017276,0
1360009991,431376240,2,122,61,1360009964493,1360009965261,431349733,431350501,768
1360010400,431784972,1,46,46,1360010374099,1360010374099,431759071,431759071,0
1360011961,433345736,1,46,46,1360011933477,1360011933477,433318213,433318213,0
1360011985,3366648872,1,46,46,1360011958954,1360011958954,3366622826,3366622826,0
1360012197,433581692,1,46,46,1360012168399,1360012168399,433553091,433553091,0
1360012866,434250700,1,48,48,1360012839931,1360012839931,434224631,434224631,0
1360016888,438272820,1,440,440,1360016863109,1360016863109,438247929,438247929,0
1360016908,438293064,1,46,46,1360016881234,1360016881234,438266298,438266298,0
1360016908,438293068,1,46,46,1360016881551,1360016881551,438266619,438266619,0
1360016940,438325168,1,60,60,1360016914856,1360016914856,438300024,438300024,0
1360017329,438713956,1,46,46,1360017304502,1360017304502,438689458,438689458,0
1360019507,440891424,1,46,46,1360019480167,1360019480167,440864591,440864591,0
1360020036,441420824,1,46,46,1360020008400,1360020008400,441393224,441393224,0
1360020143,441527916,1,60,60,1360020117492,1360020117492,441502408,441502408,0
1360021218,442602804,1,46,46,1360021190929,1360021190929,442575733,442575733,0
1360021977,443361836,1,46,46,1360021949350,1360021949350,443334186,443334186,0
1360025595,446979804,1,443,443,1360025566737,1360025566737,446951541,446951541,0
1360026450,447834356,1,148,148,1360026422336,1360026422336,447806692,447806692,0
1360026966,448351156,1,46,46,1360026939673,1360026939673,448324829,448324829,0
1360028462,449846212,1,92,92,1360028435572,1360028435572,449819784,449819784,0
1360030261,451645968,1,48,48,1360030235298,1360030235298,451620266,451620266,0
1360030741,452125380,1,46,46,1360030711142,1360030711142,452095522,452095522,0
1360031232,452616228,1,46,46,1360031206262,1360031206262,452590490,452590490,0
1360034341,455725816,1,46,46,1360034314747,1360034314747,455699563,455699563,0
1360039156,460540548,1,48,48,1360039126079,1360039126079,460510627,460510627,0
1360044997,466381496,1,46,46,1360044972184,1360044972184,466356680,466356680,0
1360044997,466381576,1,46,46,1360044972423,1360044972423,466356999,466356999,0
1360045113,466497788,1,46,46,1360045086707,1360045086707,466471495,466471495,0
1360045113,466497792,1,46,46,1360045086959,1360045086959,466471751,466471751,0
1360047835,469219548,1,46,46,1360047807606,1360047807606,469192154,469192154,0
1360048048,469432356,1,46,46,1360048021875,1360048021875,469406231,469406231,0
1360048537,469921544,2,122,61,1360048511728,1360048513968,469896272,469898512,2240
1360049046,470430652,1,46,46,1360049020222,1360049020222,470404874,470404874,0
1360049398,3404061356,5,538,107.6,1360049394467,1360049394531,3404057823,3404057887,64
1360049400,470784376,8,3305,413.125,1360049395213,1360049395725,470779589,470780101,512
1360049400,470784392,8,1424,178,1360049399035,1360049399483,470783427,470783875,448
1360049406,3404069368,4,971,242.75,1360049400344,1360049400728,3404063712,3404064096,384
1360049408,470792336,10,2482,248.2,1360049403379,1360049403571,470787715,470787907,192
1360049408,470792336,8,2746,343.25,1360049403570,1360049403698,470787906,470788034,128
1360049408,470792340,8,2378,297.25,1360049403697,1360049403825,470788037,470788165,128
1360049408,470792340,10,1994,199.4,1360049404015,1360049404207,470788355,470788547,192
1360049408,470792340,9,4766,529.5555556,1360049404206,1360049404334,470788546,470788674,128
1360049408,470792344,8,2666,333.25,1360049400813,1360049401005,470785157,470785349,192
1360049408,470792344,8,1890,236.25,1360049401261,1360049401389,470785605,470785733,128
1360049408,470792344,8,3194,399.25,1360049404588,1360049404780,470788932,470789124,192
1360049408,470792344,8,2634,329.25,1360049401132,1360049401260,470785476,470785604,128
1360049408,470792344,7,2662,380.2857143,1360049401516,1360049401644,470785860,470785988,128
1360049408,470792344,7,1838,262.5714286,1360049404780,1360049404844,470789124,470789188,64
1360049408,470792344,8,2698,337.25,1360049401387,1360049401515,470785731,470785859,128
1360049408,470792344,7,2326,332.2857143,1360049401771,1360049401899,470786115,470786243,128
1360049408,470792344,8,1890,236.25,1360049402026,1360049402154,470786370,470786498,128
1360049408,470792348,8,1890,236.25,1360049402345,1360049402473,470786693,470786821,128
1360049408,470792348,9,1942,215.7777778,1360049405288,1360049405480,470789636,470789828,192
1360049408,470792348,10,1994,199.4,1360049402983,1360049403175,470787331,470787523,192
1360049408,470792352,8,2386,298.25,1360049403235,1360049403363,470787587,470787715,128
1360049408,470792380,9,1942,215.7777778,1360049403782,1360049403974,470788162,470788354,192
1360049408,470792384,8,2394,299.25,1360049404291,1360049404419,470788675,470788803,128
1360049408,470792384,8,2378,297.25,1360049400962,1360049401090,470785346,470785474,128
1360049408,470792388,7,2870,410,1360049404413,1360049404605,470788801,470788993,192
1360049408,470792388,12,4008,334,1360049396224,1360049405760,470780612,470790148,9536
1360049408,470792388,8,1890,236.25,1360049404800,1360049404928,470789188,470789316,128
1360049408,470792388,9,3494,388.2222222,1360049404927,1360049405055,470789315,470789443,128
1360049408,470792388,8,2386,298.25,1360049401598,1360049401726,470785986,470786114,128
1360049408,470792392,10,1994,199.4,1360049405053,1360049405245,470789445,470789637,192
1360049408,470792392,8,1890,236.25,1360049401853,1360049401981,470786245,470786373,128
1360049408,470792392,7,1838,262.5714286,1360049402108,1360049402300,470786500,470786692,192
1360049408,470792392,11,2959,269,1360049397370,1360049405882,470781762,470790274,8512
1360049408,470792392,7,2334,333.4285714,1360049402682,1360049402810,470787074,470787202,128
1360049408,470792392,7,1838,262.5714286,1360049402426,1360049402554,470786818,470786946,128
1360049408,470792392,8,1890,236.25,1360049402554,1360049402682,470786946,470787074,128
1360049408,470792396,8,2506,313.25,1360049402809,1360049402937,470787205,470787333,128
1360049408,470792396,4,700,175,1360049398326,1360049405750,470782722,470790146,7424
1360049411,470795592,8,2021,252.625,1360049406897,1360049407025,470791489,470791617,128
1360049414,3404077364,4,478,119.5,1360049410395,1360049410459,3404073759,3404073823,64
1360049414,3404077364,4,971,242.75,1360049394458,1360049408986,3404057822,3404072350,14528
1360049416,470800356,7,1401,200.1428571,1360049407390,1360049407966,470791746,470792322,576
1360049416,470800392,5,1275,255,1360049405756,1360049408892,470790148,470793284,3136
1360049416,470800392,12,3160,263.3333333,1360049405948,1360049408892,470790340,470793284,2944
1360049431,470815656,1,108,108,1360049406452,1360049406452,470791108,470791108,0
1360049431,470815656,1,108,108,1360049406259,1360049406259,470790915,470790915,0
1360049431,470815704,1,108,108,1360049406275,1360049406275,470790979,470790979,0
1360049629,3404292720,1,46,46,1360049601720,1360049601720,3404265440,3404265440,0
1360050808,472192420,1,48,48,1360050779595,1360050779595,472164015,472164015,0
1360050808,472192448,1,48,48,1360050779566,1360050779566,472164014,472164014,0
1360052610,473994564,1,46,46,1360052584284,1360052584284,473968848,473968848,0
1360053686,475070688,1,48,48,1360053659665,1360053659665,475044353,475044353,0
1360053686,475070700,1,48,48,1360053659718,1360053659718,475044418,475044418,0
1360053717,475101452,1,46,46,1360053691003,1360053691003,475075455,475075455,0
1360055297,476681988,1,46,46,1360055270221,1360055270221,476655209,476655209,0
1360055299,476683156,1,46,46,1360055271117,1360055271117,476655273,476655273,0
1360055645,477029544,1,78,78,1360055617410,1360055617410,477001954,477001954,0
1360055894,477278116,1,46,46,1360055868972,1360055868972,477253088,477253088,0
1360056744,478128720,1,46,46,1360056718401,1360056718401,478103121,478103121,0
1360056745,478129400,1,46,46,1360056718657,1360056718657,478103057,478103057,0
1360057376,478761048,1,46,46,1360057348657,1360057348657,478733705,478733705,0
1360058534,479918672,1,46,46,1360058507864,1360058507864,479892536,479892536,0
1360059111,480495800,1,404,404,1360059086351,1360059086351,480471151,480471151,0
1360061745,483129624,1,46,46,1360061718741,1360061718741,483103365,483103365,0
1360062901,484285428,1,46,46,1360062874759,1360062874759,484259187,484259187,0
1360062902,484286104,1,46,46,1360062874954,1360062874954,484259058,484259058,0
1360063096,484480524,1,95,95,1360063068774,1360063068774,484453298,484453298,0
1360064055,485439364,1,46,46,1360064026868,1360064026868,485411232,485411232,0
1360064056,485440528,1,46,46,1360064026706,1360064026706,485411234,485411234,0
1360064174,485558336,1,46,46,1360064148303,1360064148303,485532639,485532639,0
1360064202,3418865292,4,1448,362,1360064200837,1360064200901,3418864129,3418864193,64
1360064202,3418865296,5,451,90.2,1360064200323,1360064200515,3418863619,3418863811,192
1360064207,485591080,12,4727,393.9166667,1360064206288,1360064206480,485590368,485590560,192
1360064207,485591080,12,4967,413.9166667,1360064206352,1360064206608,485590432,485590688,256
1360064207,485591080,8,3089,386.125,1360064206799,1360064206927,485590879,485591007,128
1360064207,485591080,9,1913,212.5555556,1360064206607,1360064206799,485590687,485590879,192
1360064207,485591080,6,983,163.8333333,1360064203022,1360064203278,485587102,485587358,256
1360064207,485591084,4,724,181,1360064204491,1360064204555,485588575,485588639,64
1360064207,485591084,5,609,121.8,1360064204683,1360064205067,485588767,485589151,384
1360064207,485591084,5,1257,251.4,1360064201099,1360064201163,485585183,485585247,64
1360064207,485591084,8,3492,436.5,1360064201162,1360064201930,485585246,485586014,768
1360064207,485591084,9,1913,212.5555556,1360064205450,1360064205642,485589534,485589726,192
1360064207,485591088,9,3009,334.3333333,1360064206089,1360064206281,485590177,485590369,192
1360064207,485591088,11,3294,299.4545455,1360064202312,1360064203016,485586400,485587104,704
1360064207,485591088,5,609,121.8,1360064206535,1360064206855,485590623,485590943,320
1360064207,485591088,8,3137,392.125,1360064199111,1360064199943,485583199,485584031,832
1360064207,485591088,7,1460,208.5714286,1360064203143,1360064203783,485587231,485587871,640
1360064207,485591088,10,2699,269.9,1360064198791,1360064199431,485582879,485583519,640
1360064207,485591088,9,3035,337.2222222,1360064203206,1360064203782,485587294,485587870,576
1360064207,485591088,6,798,133,1360064203270,1360064203654,485587358,485587742,384
1360064207,485591092,12,4967,413.9166667,1360064204420,1360064204676,485588512,485588768,256
1360064207,485591092,9,3009,334.3333333,1360064200708,1360064200900,485584800,485584992,192
1360064207,485591092,7,1877,268.1428571,1360064204676,1360064205188,485588768,485589280,512
1360064207,485591092,16,8417,526.0625,1360064205762,1360064206082,485589854,485590174,320
1360064210,3418873288,5,451,90.2,1360064206728,1360064207112,3418870016,3418870400,384
1360064210,3418873288,5,451,90.2,1360064203656,1360064204232,3418866944,3418867520,576
1360064210,3418873292,5,451,90.2,1360064204999,1360064205127,3418868291,3418868419,128
1360064210,3418873292,4,445,111.25,1360064208774,1360064208902,3418872066,3418872194,128
1360064210,3418873292,5,2109,421.8,1360064203653,1360064203717,3418866945,3418867009,64
1360064210,3418873292,4,445,111.25,1360064207684,1360064207812,3418870976,3418871104,128
1360064210,3418873292,4,445,111.25,1360064205956,1360064206148,3418869248,3418869440,192
1360064210,3418873292,4,445,111.25,1360064208579,1360064208707,3418871871,3418871999,128
1360064210,3418873292,4,445,111.25,1360064208451,1360064208579,3418871743,3418871871,128
1360064210,3418873292,4,1448,362,1360064208647,1360064208711,3418871939,3418872003,64
1360064210,485594260,5,609,121.8,1360064205530,1360064205914,485589790,485590174,384
1360064215,485599344,4,1638,409.5,1360064206726,1360064206726,485591070,485591070,0
1360064215,485599344,12,4927,410.5833333,1360064206726,1360064206982,485591070,485591326,256
1360064215,485599348,10,3397,339.7,1360064210177,1360064211393,485594525,485595741,1216
1360064215,485599348,12,4735,394.5833333,1360064206917,1360064207237,485591265,485591585,320
1360064215,485599348,5,609,121.8,1360064207235,1360064207555,485591583,485591903,320
1360064215,485599348,10,1877,187.7,1360064207235,1360064207683,485591583,485592031,448
1360064215,485599348,10,3189,318.9,1360064207746,1360064207938,485592094,485592286,192
1360064215,485599348,5,609,121.8,1360064208002,1360064208322,485592350,485592670,320
1360064215,485599352,9,2849,316.5555556,1360064208189,1360064208381,485592541,485592733,192
1360064215,485599352,9,3310,367.7777778,1360064208640,1360064210112,485592992,485594464,1472
1360064215,485599352,4,715,178.75,1360064212288,1360064212352,485596640,485596704,64
1360064215,485599352,14,7501,535.7857143,1360064213246,1360064214014,485597598,485598366,768
1360064215,485599356,10,3381,338.1,1360064206971,1360064207163,485591327,485591519,192
1360064215,485599356,9,1913,212.5555556,1360064207674,1360064207930,485592030,485592286,256
1360064215,485599356,10,1959,195.9,1360064207929,1360064208121,485592285,485592477,192
1360064215,485599360,11,3096,281.4545455,1360064212470,1360064213174,485596830,485597534,704
1360064346,485730368,1,60,60,1360064318381,1360064318381,485702749,485702749,0
1360064940,486324756,1,48,48,1360064911265,1360064911265,486296021,486296021,0
1360064940,486324780,1,48,48,1360064911305,1360064911305,486296085,486296085,0
1360065892,487276984,5,250,50,1360065866478,1360065888430,487251462,487273414,21952
1360065917,487302000,1,48,48,1360065912924,1360065912924,487297924,487297924,0
1360065969,487353340,1,48,48,1360065943151,1360065943151,487327491,487327491,0
1360067902,489286584,1,46,46,1360067877150,1360067877150,489261734,489261734,0
1360067902,489287020,1,46,46,1360067876650,1360067876650,489261670,489261670,0
1360067985,489369748,2,120,60,1360067957496,1360067957496,489342244,489342244,0
1360068578,489962836,1,48,48,1360068550552,1360068550552,489935388,489935388,0
1360068791,490175196,1,46,46,1360068764308,1360068764308,490148504,490148504,0
1360069083,490467552,2,122,61,1360069055594,1360069057642,490440146,490442194,2048
1360069099,490483608,1,46,46,1360069072818,1360069072818,490457426,490457426,0
1360070078,491462304,1,433,433,1360070051350,1360070051350,491435654,491435654,0
1360070086,491470352,1,434,434,1360070058853,1360070058853,491443205,491443205,0
1360071421,492805516,5,250,50,1360071396205,1360071417709,492780721,492802225,21504
1360071765,3426428764,1,46,46,1360071738656,1360071738656,3426402420,3426402420,0
1360071853,493237868,1,46,46,1360071825028,1360071825028,493209896,493209896,0
1360072158,493542804,1,127,127,1360072132863,1360072132863,493517667,493517667,0
1360072170,493554856,1,127,127,1360072143116,1360072143116,493527972,493527972,0
1360072596,493980808,1,48,48,1360072568439,1360072568439,493953247,493953247,0
1360072597,493982044,1,48,48,1360072568200,1360072568200,493953244,493953244,0
1360073306,494690764,1,48,48,1360073279446,1360073279446,494664210,494664210,0
1360073306,494690800,1,48,48,1360073279410,1360073279410,494664210,494664210,0
1360083163,504547132,1,46,46,1360083135159,1360083135159,504519291,504519291,0
1360084571,505955028,3,144,48,1360084545097,1360084553993,505929125,505938021,8896
1360085379,506763552,1,46,46,1360085350385,1360085350385,506734937,506734937,0
1360086663,508047436,1,46,46,1360086637520,1360086637520,508021956,508021956,0
1360086855,508239620,1,442,442,1360086829973,1360086829973,508214593,508214593,0
1360086855,508239620,1,440,440,1360086829973,1360086829973,508214593,508214593,0
1360086855,508239620,1,440,440,1360086829972,1360086829972,508214592,508214592,0
1360086855,508239620,1,439,439,1360086829972,1360086829972,508214592,508214592,0
1360086855,508239620,1,440,440,1360086829972,1360086829972,508214592,508214592,0
1360086855,508239620,1,441,441,1360086829972,1360086829972,508214592,508214592,0
1360086855,508239620,1,441,441,1360086830036,1360086830036,508214656,508214656,0
1360086855,508239620,1,440,440,1360086830036,1360086830036,508214656,508214656,0
1360086855,508239620,1,441,441,1360086830036,1360086830036,508214656,508214656,0
1360086855,508239620,1,439,439,1360086830036,1360086830036,508214656,508214656,0
1360086855,508239620,1,441,441,1360086830099,1360086830099,508214719,508214719,0
1360086855,508239620,1,441,441,1360086830099,1360086830099,508214719,508214719,0
1360086855,508239620,1,440,440,1360086830035,1360086830035,508214655,508214655,0
1360086855,508239620,1,439,439,1360086830099,1360086830099,508214719,508214719,0
1360086855,508239620,1,440,440,1360086830099,1360086830099,508214719,508214719,0
1360086855,508239620,1,441,441,1360086830099,1360086830099,508214719,508214719,0
1360086855,508239700,1,440,440,1360086829892,1360086829892,508214592,508214592,0
1360086855,508239700,1,441,441,1360086829892,1360086829892,508214592,508214592,0
1360086855,508239700,1,441,441,1360086829956,1360086829956,508214656,508214656,0
1360086855,508239700,1,442,442,1360086829956,1360086829956,508214656,508214656,0
1360086855,508239700,1,440,440,1360086829956,1360086829956,508214656,508214656,0
1360086855,508239700,1,440,440,1360086829955,1360086829955,508214655,508214655,0
1360086855,508239700,1,440,440,1360086829955,1360086829955,508214655,508214655,0
1360086855,508239700,1,439,439,1360086830019,1360086830019,508214719,508214719,0
1360086855,508239700,1,442,442,1360086830019,1360086830019,508214719,508214719,0
1360086855,508239700,1,441,441,1360086829891,1360086829891,508214591,508214591,0
1360086855,508239700,1,441,441,1360086829891,1360086829891,508214591,508214591,0
1360086855,508239704,1,441,441,1360086829951,1360086829951,508214655,508214655,0
1360086855,508239704,1,441,441,1360086829951,1360086829951,508214655,508214655,0
1360086855,508239704,1,437,437,1360086830014,1360086830014,508214718,508214718,0
1360089511,510895880,1,52,52,1360089485544,1360089485544,510870424,510870424,0
1360089628,511012428,1,60,60,1360089600361,1360089600361,510984789,510984789,0
1360090185,511569980,1,48,48,1360090159673,1360090159673,511544653,511544653,0
1360091395,512779992,1,60,60,1360091368730,1360091368730,512753722,512753722,0
1360093223,514607472,1,60,60,1360093195332,1360093195332,514579804,514579804,0
1360094916,516300464,1,46,46,1360094888369,1360094888369,516272833,516272833,0
1360096504,517888116,1,48,48,1360096477237,1360096477237,517861353,517861353,0
1360098439,519823312,1,48,48,1360098413907,1360098413907,519798219,519798219,0
1360098642,520026436,1,46,46,1360098613139,1360098613139,519997575,519997575,0
1360098726,520110272,1,48,48,1360098696565,1360098696565,520080837,520080837,0
1360101120,3455783416,1,46,46,1360101090425,1360101090425,3455753841,3455753841,0
1360102392,523776636,1,46,46,1360102365779,1360102365779,523750415,523750415,0
1360102447,523831360,1,46,46,1360102417511,1360102417511,523801871,523801871,0
1360103066,524449960,2,122,61,1360103041450,1360103048490,524425410,524432450,7040
1360105791,527175148,1,52,52,1360105765061,1360105765061,527149209,527149209,0
1360105869,527252984,1,46,46,1360105842666,1360105842666,527226650,527226650,0
1360106529,527913400,1,46,46,1360106502907,1360106502907,527887307,527887307,0
1360106819,528203036,3,138,46,1360106813157,1360106816165,528197193,528200201,3008
1360106835,528219064,2,92,46,1360106820168,1360106828168,528204232,528212232,8000
1360107006,3461669824,4,208,52,1360106999432,1360107000968,3461663256,3461664792,1536
1360107014,3461677812,4,208,52,1360107009428,1360107011028,3461673240,3461674840,1600
1360107014,3461677812,3,156,52,1360107009428,1360107010132,3461673240,3461673944,704
1360107014,3461677812,4,208,52,1360107009684,1360107011220,3461673496,3461675032,1536
1360107070,3461733824,3,156,52,1360107068938,1360107069642,3461732762,3461733466,704
1360107070,3461733824,2,104,52,1360107069514,1360107069706,3461733338,3461733530,192
1360107075,528459420,3,156,52,1360107069730,1360107070434,528454150,528454854,704
1360107078,3461741816,2,104,52,1360107070163,1360107071059,3461733979,3461734875,896
1360107480,528864256,1,46,46,1360107453952,1360107453952,528838208,528838208,0
1360107487,3462150600,1,46,46,1360107461931,1360107461931,3462125531,3462125531,0
1360108250,529634500,1,48,48,1360108225152,1360108225152,529609652,529609652,0
1360108250,529634528,1,48,48,1360108225184,1360108225184,529609712,529609712,0
1360109244,530628180,1,60,60,1360109216303,1360109216303,530600483,530600483,0
1360109256,530640068,1,60,60,1360109228063,1360109228063,530612131,530612131,0
1360109268,530652128,1,46,46,1360109242337,1360109242337,530626465,530626465,0
1360109424,530808420,1,46,46,1360109396542,1360109396542,530780962,530780962,0
1360110297,531681704,1,46,46,1360110271251,1360110271251,531655955,531655955,0
1360110398,531782236,4,720,180,1360110393190,1360110393254,531777426,531777490,64
1360110398,531782240,9,3310,367.7777778,1360110389154,1360110390562,531773394,531774802,1408
1360110398,531782280,10,4451,445.1,1360110395834,1360110396538,531780114,531780818,704
1360110407,3465070788,5,792,158.4,1360110386115,1360110402243,3465049903,3465066031,16128
1360110414,531797948,18,15485,860.2777778,1360110387911,1360110409159,531771859,531793107,21248
1360110414,531798552,8,2021,252.625,1360110409769,1360110409897,531794321,531794449,128
1360110414,531798596,29,29915,1031.551724,1360110396350,1360110411390,531780946,531795986,15040
1360110414,531798596,7,3285,469.2857143,1360110393022,1360110408510,531777618,531793106,15488
1360110414,531798664,115,128233,1115.069565,1360110388023,1360110408823,531772687,531793487,20800
1360110415,3465078780,8,7029,878.625,1360110414861,1360110414925,3465078641,3465078705,64
1360110422,531806508,9,3398,377.5555556,1360110413973,1360110414997,531798481,531799505,1024
1360110422,531806552,10,3605,360.5,1360110419562,1360110421098,531804114,531805650,1536
1360110422,531806556,14,9954,711,1360110419877,1360110420837,531804433,531805393,960
1360110422,531806636,9,3357,373,1360110416915,1360110417747,531801551,531802383,832
1360110423,3465086544,6,1368,228,1360110396473,1360110420473,3465060017,3465084017,24000
1360110423,3465086772,5,552,110.4,1360110416278,1360110417494,3465080050,3465081266,1216
1360110423,3465086776,295,403564,1368.013559,1360110398159,1360110416079,3465061935,3465079855,17920
1360110430,531814528,4,479,119.75,1360110425918,1360110425982,531810446,531810510,64
1360110430,531814572,9,3398,377.5555556,1360110428821,1360110429589,531813393,531814161,768
1360110430,531814576,10,1877,187.7,1360110421457,1360110422161,531806033,531806737,704
1360110430,531814576,9,2664,296,1360110421520,1360110421968,531806096,531806544,448
1360110430,531814608,17,15931,937.1176471,1360110427184,1360110428208,531811792,531812816,1024
1360110430,531814636,38,51915,1366.184211,1360110424341,1360110425429,531808977,531810065,1088
1360110431,3465094788,71,101862,1434.676056,1360110430018,1360110430274,3465093806,3465094062,256
1360110431,3465094792,4,478,119.5,1360110428286,1360110428350,3465092078,3465092142,64
1360110431,3465094796,17,20838,1225.764706,1360110429564,1360110429692,3465093360,3465093488,128
1360110431,3465094796,4,500,125,1360110429691,1360110430267,3465093487,3465094063,576
1360110438,531821956,1,108,108,1360110409914,1360110409914,531793870,531793870,0
1360110438,531821960,1,108,108,1360110410040,1360110410040,531794000,531794000,0
1360110438,531822044,1,108,108,1360110409893,1360110409893,531793937,531793937,0
1360110438,531822092,15,4409,293.9333333,1360110411956,1360110437556,531796048,531821648,25600
1360110438,531822512,11,10745,976.8181818,1360110431505,1360110431697,531816017,531816209,192
1360110438,531822512,31,42071,1357.129032,1360110431697,1360110432337,531816209,531816849,640
1360110438,531822540,51,70793,1388.098039,1360110432756,1360110433076,531817296,531817616,320
1360110438,531822876,20,5745,287.25,1360110421795,1360110432867,531806671,531817743,11072
1360110438,531822880,83,118684,1429.927711,1360110429472,1360110431008,531814352,531815888,1536
1360110438,531822896,10,3261,326.1,1360110418961,1360110434257,531803857,531819153,15296
1360110439,3465102792,4,971,242.75,1360110415998,1360110431038,3465079790,3465094830,15040
1360110446,531829992,1,46,46,1360110420249,1360110420249,531804241,531804241,0
1360110446,531830516,10,1877,187.7,1360110438285,1360110439181,531822801,531823697,896
1360110446,531830516,7,1925,275,1360110426252,1360110441804,531810768,531826320,15552
1360110446,531830560,10,3605,360.5,1360110436769,1360110438113,531821329,531822673,1344
1360110446,531830560,9,3398,377.5555556,1360110444511,1360110445343,531829071,531829903,832
1360110447,3465110832,17,20781,1222.411765,1360110445207,1360110445335,3465109039,3465109167,128
1360110447,3465110852,4,501,125.25,1360110445507,1360110446147,3465109359,3465109999,640
1360110450,531834028,16,5924,370.25,1360110422834,1360110424754,531806862,531808782,1920
1360110451,3465114728,5,1570,314,1360110423360,1360110443904,3465087088,3465107632,20544
1360110454,531837980,11,2206,200.5454545,1360110429411,1360110448995,531813391,531832975,19584
1360110454,531838016,20,4410,220.5,1360110427393,1360110448321,531811409,531832337,20928
1360110454,531838520,9,3553,394.7777778,1360110450568,1360110451848,531835088,531836368,1280
1360110454,531838552,10,3041,304.1,1360110452137,1360110452585,531836689,531837137,448
1360110455,3465118804,4,478,119.5,1360110451700,1360110451700,3465115504,3465115504,0
1360110455,3465118808,4,478,119.5,1360110454574,1360110454638,3465118382,3465118446,64
1360110455,3465118812,4,478,119.5,1360110451628,1360110451692,3465115440,3465115504,64
1360110458,531842036,1,60,60,1360110433325,1360110433325,531817361,531817361,0
1360110458,531842036,1,60,60,1360110433325,1360110433325,531817361,531817361,0
1360110458,531842036,1,60,60,1360110433197,1360110433197,531817233,531817233,0
1360110458,531842036,1,60,60,1360110433260,1360110433260,531817296,531817296,0
1360110458,531842036,1,60,60,1360110433260,1360110433260,531817296,531817296,0
1360110458,531842036,1,60,60,1360110433515,1360110433515,531817551,531817551,0
1360110458,531842036,1,60,60,1360110433515,1360110433515,531817551,531817551,0
1360110458,531842056,1,60,60,1360110433367,1360110433367,531817423,531817423,0
1360110458,531842056,1,60,60,1360110433559,1360110433559,531817615,531817615,0
1360110458,531842056,1,60,60,1360110433625,1360110433625,531817681,531817681,0
1360110458,531842056,1,60,60,1360110433497,1360110433497,531817553,531817553,0
1360110458,531842056,1,60,60,1360110433497,1360110433497,531817553,531817553,0
1360110458,531842056,1,60,60,1360110433560,1360110433560,531817616,531817616,0
1360110458,531842056,1,60,60,1360110433560,1360110433560,531817616,531817616,0
1360110458,531842056,1,60,60,1360110433624,1360110433624,531817680,531817680,0
1360110458,531842108,6,1241,206.8333333,1360110431844,1360110433060,531815952,531817168,1216
1360110458,531842116,1,60,60,1360110433242,1360110433242,531817358,531817358,0
1360110458,531842140,1,60,60,1360110433282,1360110433282,531817422,531817422,0
1360110458,531842140,1,60,60,1360110433284,1360110433284,531817424,531817424,0
1360110458,531842140,1,60,60,1360110433348,1360110433348,531817488,531817488,0
1360110458,531842140,1,60,60,1360110433347,1360110433347,531817487,531817487,0
1360110458,531842140,1,60,60,1360110433091,1360110433091,531817231,531817231,0
1360110458,531842140,1,60,60,1360110433154,1360110433154,531817294,531817294,0
1360110458,531842140,1,60,60,1360110433154,1360110433154,531817294,531817294,0
1360110458,531842144,1,60,60,1360110433281,1360110433281,531817425,531817425,0
1360110458,531842144,1,60,60,1360110433345,1360110433345,531817489,531817489,0
1360110458,531842144,1,60,60,1360110433345,1360110433345,531817489,531817489,0
1360110458,531842144,1,60,60,1360110433537,1360110433537,531817681,531817681,0
1360110458,531842144,1,60,60,1360110433472,1360110433472,531817616,531817616,0
1360110458,531842144,1,60,60,1360110433536,1360110433536,531817680,531817680,0
1360110462,531846512,45,39659,881.3111111,1360110453393,1360110457425,531837905,531841937,4032
1360110462,531846512,33,25452,771.2727273,1360110457424,1360110458192,531841936,531842704,768
1360110462,531846516,4,479,119.75,1360110453836,1360110453900,531838352,531838416,64
1360110462,531846520,23,17063,741.8695652,1360110458120,1360110458632,531842640,531843152,512
1360110462,531846524,20,13880,694,1360110439429,1360110455813,531823953,531840337,16384
1360110462,531846556,4,479,119.75,1360110453987,1360110454051,531838543,531838607,64
1360110462,531846592,30,26539,884.6333333,1360110458562,1360110459010,531843154,531843602,448
1360110470,531854512,5,1012,202.4,1360110444112,1360110465680,531828624,531850192,21568
1360110470,531854644,9,3415,379.4444444,1360110463628,1360110464396,531848272,531849040,768
1360110470,531854712,5,696,139.2,1360110454665,1360110469705,531839377,531854417,15040
1360110470,531854720,12,2935,244.5833333,1360110467646,1360110468606,531852366,531853326,960
1360110471,3465134792,75,109298,1457.306667,1360110445888,1360110446208,3465109680,3465110000,320
1360110471,3465134796,4,478,119.5,1360110462908,1360110462972,3465126704,3465126768,64
1360110471,3465134872,77,110867,1439.831169,1360110463088,1360110463344,3465126960,3465127216,256
1360110471,3465134872,3,680,226.6666667,1360110451311,1360110469423,3465115183,3465133295,18112
1360110471,3465134876,5,543,108.6,1360110464557,1360110464877,3465128433,3465128753,320
1360110478,531861972,1,46,46,1360110451180,1360110451180,531835152,531835152,0
1360110478,531862008,48,41340,861.25,1360110452808,1360110464072,531836816,531848080,11264
1360110478,531862720,2,104,52,1360110477441,1360110477441,531862161,531862161,0
1360110479,3465142824,156,227016,1455.230769,1360110456160,1360110471968,3465119984,3465135792,15808
1360110479,3465142828,6,600,100,1360110478427,1360110478875,3465142255,3465142703,448
1360110479,3465142836,4,478,119.5,1360110477590,1360110477590,3465141426,3465141426,0
1360110479,3465142836,78,111903,1434.653846,1360110477717,1360110477909,3465141553,3465141745,192
1360110487,3465150816,5,542,108.4,1360110479399,1360110479463,3465143215,3465143279,64
1360110487,3465150816,4,478,119.5,1360110479527,1360110479591,3465143343,3465143407,64
1360110487,3465150816,3,164,54.66666667,1360110479591,1360110480295,3465143407,3465144111,704
1360110487,3465150824,4,501,125.25,1360110479518,1360110479582,3465143342,3465143406,64
1360110487,3465150824,242,354735,1465.847107,1360110456162,1360110482850,3465119986,3465146674,26688
1360110490,531874124,2,130,65,1360110464661,1360110465045,531848785,531849169,384
1360110491,3465154708,93,136293,1465.516129,1360110465108,1360110465428,3465128816,3465129136,320
1360110494,531878708,9,3415,379.4444444,1360110491917,1360110492685,531876625,531877393,768
1360110494,531878716,9,2935,326.1111111,1360110477442,1360110491522,531862158,531876238,14080
1360110494,531878740,10,3622,362.2,1360110489899,1360110490539,531874639,531875279,640
1360110495,3465158824,13,11382,875.5384615,1360110493406,1360110493598,3465157230,3465157422,192
1360110495,3465158828,4,478,119.5,1360110493981,1360110494045,3465157809,3465157873,64
1360110495,3465158828,8,6778,847.25,1360110493981,1360110494045,3465157809,3465157873,64
1360110495,3465158828,4,478,119.5,1360110491548,1360110491548,3465155376,3465155376,0
1360110495,3465158828,78,111903,1434.653846,1360110491612,1360110491804,3465155440,3465155632,192
1360110495,3465158832,5,542,108.4,1360110493145,1360110493337,3465156977,3465157169,192
1360110495,3465158832,5,536,107.2,1360110493911,1360110493975,3465157743,3465157807,64
1360110502,531886748,9,3570,396.6666667,1360110495589,1360110496101,531880337,531880849,512
1360110503,3465166796,95,136464,1436.463158,1360110478780,1360110479356,3465142576,3465143152,576
1360110503,3465166836,4,478,119.5,1360110496085,1360110496149,3465159921,3465159985,64
1360110510,531894716,8,2883,360.375,1360110491522,1360110505794,531876238,531890510,14272
1360110510,531894732,8,2883,360.375,1360110505780,1360110506356,531890512,531891088,576
1360110518,531902764,9,3447,383,1360110511954,1360110513746,531896718,531898510,1792
1360110523,3465186712,1,52,52,1360110495761,1360110495761,3465159473,3465159473,0
1360110530,531914180,2,130,65,1360110504605,1360110505373,531888785,531889553,768
1360110534,531918164,1,52,52,1360110507372,1360110507372,531891536,531891536,0
1360110535,3465198840,1,52,52,1360110506831,1360110506831,3465170671,3465170671,0
1360110535,3465198840,1,52,52,1360110506831,1360110506831,3465170671,3465170671,0
1360110538,531922204,1,52,52,1360110512516,1360110512516,531896720,531896720,0
1360110543,3465206900,64808,97175283,1499.43345,1360110452435,1360110540627,3465116335,3465204527,88192
1360110570,531954232,2,130,65,1360110544548,1360110545700,531928780,531929932,1152
1360110610,531994268,2,130,65,1360110584513,1360110586049,531968781,531970317,1536
1360110631,532015276,1,46,46,1360110602297,1360110602297,531986573,531986573,0
1360110632,532016284,1,46,46,1360110602289,1360110602289,531986573,531986573,0
1360110650,532034312,2,130,65,1360110624468,1360110626452,532008780,532010764,1984
1360110690,532074416,2,130,65,1360110664363,1360110667051,532048779,532051467,2688
1360110695,3465358948,4,478,119.5,1360110693092,1360110693156,3465357040,3465357104,64
1360110695,3465358948,4,478,119.5,1360110693223,1360110693287,3465357171,3465357235,64
1360110703,532087220,28,26640,951.4285714,1360110698225,1360110698609,532082445,532082829,384
1360110703,532087224,26,26331,1012.730769,1360110698859,1360110699179,532083083,532083403,320
1360110703,532087272,19,16855,887.1052632,1360110698555,1360110698811,532082827,532083083,256
1360110703,532087276,39,39422,1010.820513,1360110695352,1360110698168,532079628,532082444,2816
1360110703,532087300,4,479,119.75,1360110696417,1360110696481,532080717,532080781,64
1360110703,532087300,4,479,119.75,1360110696544,1360110696608,532080844,532080908,64
1360110703,532087308,9,3415,379.4444444,1360110700632,1360110701336,532084940,532085644,704
1360110703,3465366944,82,116919,1425.841463,1360110699690,1360110699946,3465363634,3465363890,256
1360110703,3465366948,4,478,119.5,1360110699428,1360110699492,3465363376,3465363440,64
1360110703,3465366952,4,478,119.5,1360110696162,1360110696226,3465360114,3465360178,64
1360110703,3465366952,5,543,108.6,1360110701153,1360110701409,3465365105,3465365361,256
1360110711,532095252,51,41871,821,1360110694161,1360110704209,532078413,532088461,10048
1360110711,532095256,8,2990,373.75,1360110707082,1360110707658,532091338,532091914,576
1360110711,532095264,19,13827,727.7368421,1360110688260,1360110707076,532072524,532091340,18816
1360110711,532095264,4,430,107.5,1360110696835,1360110704835,532081099,532089099,8000
1360110711,3465374948,6,962,160.3333333,1360110696869,1360110704293,3465360817,3465368241,7424
1360110711,3465374948,4,430,107.5,1360110696868,1360110704292,3465360816,3465368240,7424
1360110719,3465382964,100,146811,1468.11,1360110416407,1360110416727,3465080371,3465080691,320
1360110728,3465391232,93,136293,1465.516129,1360110702195,1360110702387,3465365427,3465365619,192
1360110730,532114480,2,130,65,1360110704300,1360110707500,532088780,532091980,3200
1360110736,3465399292,3352,4999760,1491.575179,1360110421943,1360110437687,3465085235,3465100979,15744
1360110742,532126436,1,46,46,1360110714649,1360110714649,532099085,532099085,0
1360110751,3465414972,7588,11364703,1497.72048,1360110438224,1360110450768,3465102196,3465114740,12544
1360110770,532154588,2,130,65,1360110744190,1360110748030,532128778,532132618,3840
1360110783,3465447008,131,193612,1477.954198,1360110479404,1360110480108,3465143412,3465144116,704
1360110783,3465447008,143,210508,1472.083916,1360110479404,1360110480044,3465143412,3465144052,640
1360110783,3465447008,226,334664,1480.814159,1360110479404,1360110480108,3465143412,3465144116,704
1360110790,532174556,1,46,46,1360110765342,1360110765342,532149898,532149898,0
1360110810,532194592,2,130,65,1360110784187,1360110788603,532168779,532173195,4416
1360110850,532234832,2,130,65,1360110823945,1360110828873,532208777,532213705,4928
1360110890,532274796,2,130,65,1360110863981,1360110869421,532248777,532254217,5440
1360110930,532314832,2,130,65,1360110903945,1360110909769,532288777,532294601,5824
1360110943,3465607000,4,478,119.5,1360110942770,1360110942770,3465606770,3465606770,0
1360110943,3465607008,4,478,119.5,1360110942762,1360110942826,3465606770,3465606834,64
1360110951,532335612,42,43847,1043.97619,1360110944678,1360110948646,532329290,532333258,3968
1360110951,532335616,4,479,119.75,1360110944994,1360110945058,532329610,532329674,64
1360110951,532335620,20,16907,845.35,1360110949083,1360110949403,532333703,532334023,320
1360110951,532335624,27,26383,977.1481481,1360110949401,1360110949721,532334025,532334345,320
1360110951,532335664,4,479,119.75,1360110944815,1360110944879,532329479,532329543,64
1360110951,532335696,27,25140,931.1111111,1360110948625,1360110949009,532333321,532333705,384
1360110951,3465615040,4,478,119.5,1360110946635,1360110946699,3465610675,3465610739,64
1360110959,532343588,18,13775,765.2777778,1360110939198,1360110955454,532323786,532340042,16256
1360110959,532343616,9,3415,379.4444444,1360110953695,1360110954335,532338311,532338951,640
1360110959,3465622996,4,478,119.5,1360110951544,1360110951544,3465615540,3465615540,0
1360110959,3465622996,78,110919,1422.038462,1360110951800,1360110951992,3465615796,3465615988,192
1360110959,3465622996,4,502,125.5,1360110955639,1360110955767,3465619635,3465619763,128
1360110959,3465622996,4,478,119.5,1360110955575,1360110955639,3465619571,3465619635,64
1360110959,3465623000,5,543,108.6,1360110954546,1360110954802,3465618546,3465618802,256
1360110959,3465623004,5,543,108.6,1360110955439,1360110955567,3465619443,3465619571,128
1360110967,532351684,4,430,107.5,1360110947102,1360110962142,532331786,532346826,15040
1360110967,3465630980,6,962,160.3333333,1360110947849,1360110962953,3465611829,3465626933,15104
1360110967,3465630992,5,696,139.2,1360110948988,1360110964028,3465612980,3465628020,15040
1360110971,532355188,2,130,65,1360110944586,1360110950986,532328774,532335174,6400
1360110971,532355272,48,41933,873.6041667,1360110943865,1360110967353,532328137,532351625,23488
1360110980,3465643512,96,137965,1437.135417,1360110955355,1360110955739,3465618867,3465619251,384
1360110984,3465647464,32,43664,1364.5,1360110956300,1360110957196,3465619764,3465620660,896
1360110984,3465647492,95,137267,1444.915789,1360110956272,1360110957168,3465619764,3465620660,896
1360110984,3465647492,48,69096,1439.5,1360110956272,1360110957104,3465619764,3465620596,832
1360111011,532395304,2,130,65,1360110984472,1360110991256,532368776,532375560,6784
1360111031,532415592,9,3570,396.6666667,1360111025080,1360111025784,532409672,532410376,704
1360111051,532435296,2,130,65,1360111024479,1360111031647,532408775,532415943,7168
1360111087,532471824,9,2704,300.4444444,1360111085519,1360111085711,532470343,532470535,192
1360111091,532475328,2,130,65,1360111064445,1360111071869,532448773,532456197,7424
1360111095,532479624,8,2883,360.375,1360111091990,1360111092502,532476614,532477126,512
1360111095,532479660,17,15264,897.8823529,1360111090484,1360111092916,532475144,532477576,2432
1360111095,532479744,19,11138,586.2105263,1360111085982,1360111089310,532470726,532474054,3328
1360111095,3465759076,153,209433,1368.843137,1360111085415,1360111092647,3465749491,3465756723,7232
1360111103,532487640,8,2990,373.75,1360111095556,1360111096132,532480196,532480772,576
1360111112,3465775568,1,46,46,1360111085926,1360111085926,3465749494,3465749494,0
1360111119,532503324,1,52,52,1360111092225,1360111092225,532476549,532476549,0
1360111119,532503436,1,46,46,1360111093138,1360111093138,532477574,532477574,0
1360111120,3465783544,1,46,46,1360111093180,1360111093180,3465756724,3465756724,0
1360111123,532507472,1,52,52,1360111095724,1360111095724,532480196,532480196,0
1360111131,532515572,2,130,65,1360111104200,1360111112136,532488772,532496708,7936
1360111159,3465823060,550209,825081392,1499.578146,1360110542778,1360111155962,3465206838,3465820022,613184
1360111171,532555776,2,130,65,1360111143995,1360111152379,532528771,532537155,8384
1360111211,532595804,2,130,65,1360111183969,1360111192865,532568773,532577669,8896
1360111251,532635828,2,130,65,1360111223943,1360111233415,532608771,532618243,9472
1360111260,3465923724,339,505612,1491.480826,1360110956043,1360110956939,3465619767,3465620663,896
1360111292,532676036,2,130,65,1360111264736,1360111274656,532648772,532658692,9920
1360111332,532716184,2,130,65,1360111304585,1360111315017,532688769,532699201,10432
1360111372,532756216,2,130,65,1360111344555,1360111355627,532728771,532739843,11072
1360111412,532796288,2,130,65,1360111384483,1360111396451,532768771,532780739,11968
1360111452,532836492,2,130,65,1360111424278,1360111436758,532808770,532821250,12480
1360111492,532876692,2,130,65,1360111464074,1360111477322,532848766,532862014,13248
1360111532,532916828,2,130,65,1360111503938,1360111517826,532888766,532902654,13888
1360111560,3466223096,25677,38457364,1497.735873,1360111159489,1360111257729,3465822585,3465920825,98240
1360111572,532956784,2,130,65,1360111543982,1360111558254,532928766,532943038,14272
1360111609,532992996,2,130,65,1360111584768,1360111599552,532968764,532983548,14784
1360111649,533033048,2,130,65,1360111624719,1360111639951,533008767,533023999,15232
1360111689,533072996,2,130,65,1360111664770,1360111680450,533048766,533064446,15680
1360111721,3466384476,1,46,46,1360111694085,1360111694085,3466357561,3466357561,0
1360111729,533113100,2,130,65,1360111704666,1360111721050,533088766,533105150,16384
1360111733,3466396528,1,46,46,1360111708625,1360111708625,3466372153,3466372153,0
1360111769,533153448,2,130,65,1360111744316,1360111761212,533128764,533145660,16896
1360111809,533193468,2,130,65,1360111784295,1360111801639,533168763,533186107,17344
1360111849,533233484,2,130,65,1360111824276,1360111842068,533208760,533226552,17792
1360111889,533273684,2,130,65,1360111864077,1360111882509,533248761,533267193,18432
1360111929,533313904,2,130,65,1360111903859,1360111922995,533288763,533307899,19136
1360111970,533353952,2,130,65,1360111944808,1360111964328,533328760,533348280,19520
1360112010,533394012,2,130,65,1360111984811,1360112004843,533368823,533388855,20032
1360112050,533434080,2,130,65,1360112024744,1360112045224,533408824,533429304,20480
1360112090,533474444,2,130,65,1360112064378,1360112085306,533448822,533469750,20928
1360112130,533514436,2,130,65,1360112104387,1360112125763,533488823,533510199,21376
1360112170,533554512,2,130,65,1360112144309,1360112166197,533528821,533550709,21888
1360112214,533598368,2,130,65,1360112184453,1360112206853,533568821,533591221,22400
1360112250,533634876,2,130,65,1360112223943,1360112246919,533608819,533631795,22976
1360112291,533674928,4,286,71.5,1360112264893,1360112289853,533648821,533673781,24960
1360112318,533702896,4,312,78,1360112290740,1360112317172,533675636,533702068,26432
1360112375,533758988,1,78,78,1360112348222,1360112348222,533732210,533732210,0
1360112411,533795268,1,104,104,1360112385253,1360112385253,533769521,533769521,0
1360112411,533795312,1,46,46,1360112386297,1360112386297,533770609,533770609,0
1360112411,533795332,1,46,46,1360112386277,1360112386277,533770609,533770609,0
1360112415,533799276,1,46,46,1360112387871,1360112387871,533772147,533772147,0
1360112417,533801220,337709,506381087,1499.459852,1360110491926,1360112416854,531876146,533801074,1924928
1360112425,533809364,432,645993,1495.354167,1360112416774,1360112419270,533801138,533803634,2496
1360112459,533843256,1,46,46,1360112432049,1360112432049,533816305,533816305,0
1360112968,3467631384,341410,511945234,1499.50275,1360112419624,1360112966120,3467083008,3467629504,546496
1360113536,3468199592,341667,512316021,1499.460062,1360112966109,1360113533085,3467629701,3468196677,566976
1360114056,3468719920,5,527,105.4,1360114053913,1360114053913,3468717833,3468717833,0
1360114056,3468719924,342313,513400511,1499.798462,1360113532883,1360114052883,3468196807,3468716807,520000
1360114556,535940612,5,250,50,1360114528171,1360114550187,535912783,535934799,22016
1360114601,535985008,1,48,48,1360114575304,1360114575304,535959312,535959312,0
1360114629,536013048,1,48,48,1360114604383,1360114604383,535988431,535988431,0
1360115695,3470358080,816144,1223916454,1499.632974,1360113769385,1360115697193,3468432465,3470360273,1927808
1360115879,537263636,1,78,78,1360115851584,1360115851584,537236220,537236220,0
1360115967,537351840,1,78,78,1360115940210,1360115940210,537325050,537325050,0
1360115975,3470638344,792695,1188731931,1499.608211,1360114056101,1360115976933,3468719445,3470640277,1920832
1360116284,537668168,2,122,61,1360116259471,1360116261775,537643639,537645943,2304
1360116596,3471259400,103608,155403347,1499.916483,1360115976882,1360116296754,3470640282,3470960154,319872
1360117073,538457340,1,60,60,1360117044885,1360117044885,538429225,538429225,0
1360117073,538457460,1,60,60,1360117045277,1360117045277,538429737,538429737,0
1360117617,3472280912,488891,733327540,1499.981673,1360115696374,1360117616694,3470360286,3472280606,1920320
1360118222,3472885864,494884,742308096,1499.963822,1360116299497,1360118225385,3470963361,3472889249,1925888
1360118328,539712244,1,46,46,1360118300962,1360118300962,539685206,539685206,0
1360118961,540345300,5,250,50,1360118936414,1360118958366,540320714,540342666,21952
1360119009,540393336,1,48,48,1360118982458,1360118982458,540366794,540366794,0
1360119536,3474199744,647172,970740175,1499.972457,1360117617324,1360119537644,3472281068,3474201388,1920320
1360119735,541119540,1,48,48,1360119706790,1360119706790,541091330,541091330,0
1360120145,3474808540,627755,941567009,1499.895674,1360118225722,1360120145914,3472889262,3474809454,1920192
1360120670,3475333252,34416,51624000,1500,1360120146208,1360120370912,3474809460,3475034164,224704
1360120770,3475433668,466416,699591998,1499.931387,1360119537728,1360120767744,3474201396,3475431412,1230016
1360121476,542860004,1,48,48,1360121450978,1360121450978,542834982,542834982,0
1360121476,542860484,1,48,48,1360121450432,1360121450432,542834916,542834916,0
1360121876,543260692,1,48,48,1360121850282,1360121850282,543234974,543234974,0
1360121876,543260728,1,48,48,1360121850311,1360121850311,543235039,543235039,0
1360122120,543504668,3,144,48,1360122095166,1360122104254,543479834,543488922,9088
1360122425,543809016,1,84,84,1360122397381,1360122397381,543781397,543781397,0
1360122595,3477258156,891492,1336806372,1499.515836,1360121201292,1360122589260,3475864448,3477252416,1387968
1360124053,545437132,2,94,47,1360124037305,1360124051641,545421437,545435773,14336
1360124439,3479102668,1417852,2126079092,1499.507066,1360122588950,1360124442838,3477252618,3479106506,1853888
1360124861,3479524132,339800,509564576,1499.60146,1360124443377,1360124860657,3479106509,3479523789,417280
1360124861,3479524344,139,208500,1500,1360124860445,1360124860573,3479523789,3479523917,128
1360125539,546923716,1,46,46,1360125513049,1360125513049,546897765,546897765,0
1360126018,547402004,1,46,46,1360125990362,1360125990362,547374366,547374366,0
1360126019,547403280,1,46,46,1360125990151,1360125990151,547374431,547374431,0
1360126786,3481449976,1059633,1589099799,1499.669979,1360124859956,1360126787252,3479523932,3481451228,1927296
1360126988,3481651348,136432,204602098,1499.663554,1360126787879,1360126981671,3481451227,3481645019,193792
1360127691,549075320,3,152,50.66666667,1360127665156,1360127674180,549049476,549058500,9024
1360128661,550045420,1,64,64,1360128634835,1360128634835,550019255,550019255,0
1360128677,550061340,1,64,64,1360128651489,1360128651489,550035829,550035829,0
1360128905,550289036,268450,402522494,1499.431902,1360126981839,1360128904911,548365875,550288947,1923072
1360129242,550626812,1,46,46,1360129214339,1360129214339,550599151,550599151,0
1360129243,550626884,1,46,46,1360129215714,1360129215714,550599598,550599598,0
1360130827,552211568,346749,520043509,1499.769312,1360128904349,1360130826909,550288917,552211477,1922560
1360131472,552856684,1,60,60,1360131445472,1360131445472,552830156,552830156,0
1360131472,552856752,1,60,60,1360131444956,1360131444956,552829708,552829708,0
1360132749,554133428,753289,1129403107,1499.295897,1360130827019,1360132748939,552211447,554133367,1921920
1360133837,555221580,5,250,50,1360133812258,1360133834722,555196838,555219302,22464
1360133885,555269600,1,48,48,1360133859215,1360133859215,555243815,555243815,0
1360133913,555297724,1,48,48,1360133888528,1360133888528,555273252,555273252,0
1360134670,556054832,791211,1185842981,1498.769584,1360132748505,1360134669913,554133337,556054745,1921408
1360134768,556152840,1,46,46,1360134741519,1360134741519,556126359,556126359,0
1360135229,556613056,1,60,60,1360135201177,1360135201177,556585233,556585233,0
1360135245,556629036,1,60,60,1360135219693,1360135219693,556603729,556603729,0
1360135710,557094796,1,48,48,1360135685036,1360135685036,557069832,557069832,0
1360135711,557095244,1,48,48,1360135685588,1360135685588,557069832,557069832,0
1360136119,557502988,1,48,48,1360136091921,1360136091921,557475909,557475909,0
1360136204,557588544,1,48,48,1360136178019,1360136178019,557562563,557562563,0
1360136204,557588552,1,48,48,1360136178076,1360136178076,557562628,557562628,0
1360136453,3491117028,1,46,46,1360136425087,1360136425087,3491089115,3491089115,0
1360136454,3491117720,1,46,46,1360136425395,1360136425395,3491089115,3491089115,0
1360136592,557976588,716115,1073541694,1499.119128,1360134670127,1360136591919,556054715,557976507,1921792
1360136768,558152820,41448,62170173,1499.955921,1360136591687,1360136766535,557976507,558151355,174848
1360136817,558201392,1,46,46,1360136791536,1360136791536,558175928,558175928,0
1360136817,558201400,1,46,46,1360136791594,1360136791594,558175994,558175994,0
1360136880,558264688,1,46,46,1360136853894,1360136853894,558238582,558238582,0
1360136880,558264688,1,46,46,1360136854280,1360136854280,558238968,558238968,0
1360136920,558304740,2,122,61,1360136893076,1360136895380,558277816,558280120,2304
1360137879,559263320,1,60,60,1360137854122,1360137854122,559238442,559238442,0
1360137891,559275324,1,60,60,1360137865190,1360137865190,559249514,559249514,0
1360138377,559761560,1,46,46,1360138351473,1360138351473,559736033,559736033,0
1360138377,559761584,1,46,46,1360138351451,1360138351451,559736035,559736035,0
1360138691,560075052,971934,1457255302,1499.335657,1360136767398,1360138690918,558151450,560074970,1923520
1360139712,561096380,1,46,46,1360139685775,1360139685775,561070155,561070155,0
1360139860,561244504,290070,435007509,1499.663905,1360138690452,1360139556180,560074956,560940684,865728
1360140338,561722672,1,46,46,1360140311460,1360140311460,561696132,561696132,0
1360140338,561722712,1,46,46,1360140311549,1360140311549,561696261,561696261,0
1360141486,562870816,680487,1020393227,1499.504365,1360139558337,1360141485889,560943153,562870705,1927552
1360143408,564792496,825453,1237765228,1499.498128,1360141486243,1360143407971,562870739,564792467,1921728
1360143992,3498655964,5,527,105.4,1360143991151,1360143991215,3498655115,3498655179,64
1360143993,565376832,148520,222775320,1499.968489,1360143408626,1360143990962,564792458,565374794,582336
1360144084,565468064,1,46,46,1360144057227,1360144057227,565441291,565441291,0
1360144653,566037452,1,46,46,1360144628541,1360144628541,566012993,566012993,0
1360145883,567267776,1,60,60,1360145858790,1360145858790,567243566,567243566,0
1360145887,567271788,1,60,60,1360145859224,1360145859224,567244012,567244012,0
1360146987,3501650456,1,46,46,1360146961025,1360146961025,3501624481,3501624481,0
1360147459,568843420,3,144,48,1360147431217,1360147440945,568815637,568825365,9728
1360148671,570055100,1,48,48,1360148646111,1360148646111,570030211,570030211,0
1360148675,570058876,1,48,48,1360148646273,1360148646273,570030149,570030149,0
1360150602,3505265836,4,1448,362,1360150600026,1360150600090,3505263862,3505263926,64
1360150602,3505265840,22,27806,1263.909091,1360150598487,1360150598615,3505262327,3505262455,128
1360150602,3505265840,21,25920,1234.285714,1360150598679,1360150598807,3505262519,3505262647,128
1360150602,3505265840,17,19812,1165.411765,1360150598615,1360150598679,3505262455,3505262519,64
1360150602,3505265840,20,25132,1256.6,1360150598807,1360150598871,3505262647,3505262711,64
1360150602,3505265840,5,451,90.2,1360150599318,1360150599766,3505263158,3505263606,448
1360150605,571989476,12,7275,606.25,1360150597835,1360150599051,571982311,571983527,1216
1360150605,571989480,9,1913,212.5555556,1360150600135,1360150600263,571984615,571984743,128
1360150605,571989480,6,1037,172.8333333,1360150600326,1360150600390,571984806,571984870,64
1360150605,571989480,5,1257,251.4,1360150600645,1360150600709,571985125,571985189,64
1360150605,571989484,11,3294,299.4545455,1360150601602,1360150602306,571986086,571986790,704
1360150605,571989484,8,3137,392.125,1360150598338,1360150599042,571982822,571983526,704
1360150605,571989484,6,983,163.8333333,1360150602369,1360150602561,571986853,571987045,192
1360150605,571989484,9,3035,337.2222222,1360150602497,1360150603201,571986981,571987685,704
1360150605,571989484,6,798,133,1360150602560,1360150602880,571987044,571987364,320
1360150605,571989488,32,41571,1299.09375,1360150599356,1360150599804,571983844,571984292,448
1360150605,571989488,9,2791,310.1111111,1360150603072,1360150604288,571987560,571988776,1216
1360150605,571989488,8,3492,436.5,1360150600447,1360150601215,571984935,571985703,768
1360150605,571989488,4,724,181,1360150603902,1360150603966,571988390,571988454,64
1360150605,571989488,6,859,143.1666667,1360150603966,1360150604286,571988454,571988774,320
1360150610,3505273828,5,451,90.2,1360150608162,1360150608290,3505271990,3505272118,128
1360150610,3505273828,4,1448,362,1360150608353,1360150608353,3505272181,3505272181,0
1360150610,3505273832,244,361097,1479.905738,1360150608929,1360150609569,3505272761,3505273401,640
1360150610,3505273832,5,451,90.2,1360150604513,1360150604833,3505268345,3505268665,320
1360150610,3505273832,5,2109,421.8,1360150603104,1360150603168,3505266936,3505267000,64
1360150610,3505273832,5,451,90.2,1360150606431,1360150606879,3505270263,3505270711,448
1360150610,3505273832,5,451,90.2,1360150605726,1360150605854,3505269558,3505269686,128
1360150610,3505273832,4,445,111.25,1360150607393,1360150607585,3505271225,3505271417,192
1360150613,571997512,9,1913,212.5555556,1360150605541,1360150605733,571990053,571990245,192
1360150613,571997512,15,8365,557.6666667,1360150605733,1360150605925,571990245,571990437,192
1360150613,571997512,9,3009,334.3333333,1360150605925,1360150606181,571990437,571990693,256
1360150613,571997512,12,4967,413.9166667,1360150605989,1360150606181,571990501,571990693,192
1360150613,571997512,12,4967,413.9166667,1360150606180,1360150606372,571990692,571990884,192
1360150613,571997516,9,1913,212.5555556,1360150606371,1360150606499,571990887,571991015,128
1360150613,571997516,12,4927,410.5833333,1360150606755,1360150606947,571991271,571991463,192
1360150613,571997516,12,4735,394.5833333,1360150606946,1360150607202,571991462,571991718,256
1360150613,571997516,10,1877,187.7,1360150607266,1360150607714,571991782,571992230,448
1360150613,571997516,12,4727,393.9166667,1360150607713,1360150607905,571992229,571992421,192
1360150613,571997516,9,1913,212.5555556,1360150607713,1360150607969,571992229,571992485,256
1360150613,571997520,9,1913,212.5555556,1360150607964,1360150608092,571992484,571992612,128
1360150613,571997520,5,609,121.8,1360150607964,1360150608284,571992484,571992804,320
1360150613,571997520,9,3310,367.7777778,1360150608671,1360150610463,571993191,571994983,1792
1360150613,571997520,12,4927,410.5833333,1360150608415,1360150608607,571992935,571993127,192
1360150613,571997520,9,3009,334.3333333,1360150605149,1360150605277,571989669,571989797,128
1360150613,571997520,5,609,121.8,1360150605405,1360150605789,571989925,571990309,384
1360150613,571997524,5,609,121.8,1360150606235,1360150606555,571990759,571991079,320
1360150613,571997524,9,3345,371.6666667,1360150610458,1360150611610,571994982,571996134,1152
1360150613,571997524,12,4727,393.9166667,1360150606554,1360150606746,571991078,571991270,192
1360150613,571997524,9,1913,212.5555556,1360150607001,1360150607129,571991525,571991653,128
1360150613,571997524,5,609,121.8,1360150607193,1360150607513,571991717,571992037,320
1360150613,571997528,9,2849,316.5555556,1360150608151,1360150608343,571992679,571992871,192
1360150613,571997528,5,609,121.8,1360150608662,1360150609046,571993190,571993574,384
1360150613,571997528,8,1929,241.125,1360150604118,1360150604950,571988646,571989478,832
1360150618,3505281832,99,143869,1453.222222,1360150614814,1360150615262,3505278646,3505279094,448
1360150621,572005524,10,3050,305,1360150619675,1360150620315,572004199,572004839,640
1360150621,572005532,4,715,178.75,1360150619412,1360150619476,572003944,572004008,64
1360150626,3505289840,4,445,111.25,1360150618584,1360150618840,3505282424,3505282680,256
1360150629,572013496,14,7501,535.7857143,1360150620918,1360150621686,572005414,572006182,768
1360150629,572013720,7,2084,297.7142857,1360150602198,1360150602710,571986918,571987430,512
1360150746,572129824,1,46,46,1360150717973,1360150717973,572101797,572101797,0
1360151061,572445788,6,798,133,1360151058445,1360151058765,572443233,572443553,320
1360151061,572445788,11,9991,908.2727273,1360151058700,1360151058828,572443488,572443616,128
1360151062,572445792,6,971,161.8333333,1360151059119,1360151059439,572442911,572443231,320
1360151062,572445796,5,784,156.8,1360151057962,1360151058026,572441758,572441822,64
1360151070,572453808,7,3521,503,1360151064032,1360151064864,572447840,572448672,832
1360151074,3505737972,5,451,90.2,1360151069462,1360151069974,3505733434,3505733946,512
1360151078,572461816,9,1913,212.5555556,1360151070998,1360151071254,572454814,572455070,256
1360151078,572461820,7,1478,211.1428571,1360151069522,1360151070226,572453342,572454046,704
1360151082,572466408,7,2058,294,1360151057608,1360151058440,572442016,572442848,832
1360151082,3505745968,39,41171,1055.666667,1360151060762,1360151076890,3505724730,3505740858,16128
1360151082,3505745968,322,430698,1337.571429,1360151060185,1360151077849,3505724153,3505741817,17664
1360151085,572469788,6,1333,222.1666667,1360151077577,1360151077769,572462365,572462557,192
1360151086,572470476,8,3576,447,1360151059396,1360151060356,572443872,572444832,960
1360151090,3505753968,4,399,99.75,1360151081754,1360151082202,3505745722,3505746170,448
1360151106,572490424,7,2084,297.7142857,1360151078133,1360151078837,572462557,572463261,704
1360151126,572509836,6,983,163.8333333,1360151125121,1360151125441,572508957,572509277,320
1360151126,572509844,9,2380,264.4444444,1360151124218,1360151125754,572508062,572509598,1536
1360151126,572509848,6,859,143.1666667,1360151125431,1360151125751,572509279,572509599,320
1360151134,572517876,6,3938,656.3333333,1360151126296,1360151126360,572510172,572510236,64
1360151134,572517884,4,724,181,1360151128850,1360151128914,572512734,572512798,64
1360151138,3505802000,4,399,99.75,1360151129593,1360151129977,3505793593,3505793977,384
1360151142,572525860,5,627,125.4,1360151141161,1360151141609,572525021,572525469,448
1360151146,3505809992,5,451,90.2,1360151140802,1360151141570,3505804794,3505805562,768
1360151150,572533848,10,1965,196.5,1360151142580,1360151142900,572526428,572526748,320
1360151150,572533856,6,1279,213.1666667,1360151147756,1360151147884,572531612,572531740,128
1360151154,572538504,7,1877,268.1428571,1360151128743,1360151129575,572513247,572514079,832
1360151154,3505817992,6,3769,628.1666667,1360151153089,1360151153345,3505817081,3505817337,256
1360151158,572541892,4,724,181,1360151154443,1360151154507,572538335,572538399,64
1360151174,572558520,7,2084,297.7142857,1360151147284,1360151147860,572531804,572532380,576
1360151182,572566544,7,1861,265.8571429,1360151153981,1360151154749,572538525,572539293,768
1360151198,572581912,7,1877,268.1428571,1360151194165,1360151194997,572578077,572578909,832
1360151198,572581912,4,724,181,1360151197685,1360151197749,572581597,572581661,64
1360151198,572581912,6,859,143.1666667,1360151190196,1360151190516,572574108,572574428,320
1360151198,572581916,7,2027,289.5714286,1360151196785,1360151197425,572580701,572581341,640
1360151198,572581916,9,2403,267,1360151188913,1360151190449,572572829,572574365,1536
1360151198,572581916,4,724,181,1360151197616,1360151197680,572581532,572581596,64
1360151198,572581916,4,724,181,1360151193840,1360151193904,572577756,572577820,64
1360151202,3505866004,4,399,99.75,1360151194360,1360151194808,3505858364,3505858812,448
1360151202,3505866004,6,3769,628.1666667,1360151195831,1360151195831,3505859835,3505859835,0
1360151202,3505866004,4,399,99.75,1360151199351,1360151199415,3505863355,3505863419,64
1360151202,3505866004,6,3769,628.1666667,1360151199734,1360151199798,3505863738,3505863802,64
1360151202,3505866004,6,3769,628.1666667,1360151197558,1360151197622,3505861562,3505861626,64
1360151202,3505866004,6,3769,628.1666667,1360151194997,1360151195061,3505859001,3505859065,64
1360151202,3505866008,6,3769,628.1666667,1360151200500,1360151200564,3505864508,3505864572,64
1360151206,572589936,11,9991,908.2727273,1360151198557,1360151198621,572582493,572582557,64
1360151206,572589940,6,798,133,1360151198362,1360151198618,572582302,572582558,256
1360151206,572589944,7,2058,294,1360151197717,1360151198357,572581661,572582301,640
1360151206,572589944,9,3629,403.2222222,1360151202773,1360151203797,572586717,572587741,1024
1360151206,572589944,8,3577,447.125,1360151198868,1360151200084,572582812,572584028,1216
1360151206,572589944,7,1877,268.1428571,1360151199252,1360151200148,572583196,572584092,896
1360151206,572589952,4,1305,326.25,1360151202126,1360151202446,572586078,572586398,320
1360151219,3505882012,60,76455,1274.25,1360151200215,1360151216215,3505863227,3505879227,16000
1360151222,572606560,7,1980,282.8571429,1360151197100,1360151197740,572581660,572582300,640
1360151222,572606588,7,2027,289.5714286,1360151197905,1360151198481,572582493,572583069,576
1360151222,572606588,7,2027,289.5714286,1360151195279,1360151196047,572579867,572580635,768
1360151225,3505888736,1,46,46,1360151199491,1360151199491,3505863227,3505863227,0
1360151226,572610564,7,2027,289.5714286,1360151200040,1360151200808,572584604,572585372,768
1360151226,572610604,7,2027,289.5714286,1360151200834,1360151201538,572585438,572586142,704
1360151322,572706664,1,46,46,1360151294337,1360151294337,572679001,572679001,0
1360151635,573019440,1,58,58,1360151610527,1360151610527,572994967,572994967,0
1360151667,573051472,5,240,48,1360151639869,1360151661885,573024341,573046357,22016
1360151691,573075712,1,445,445,1360151665935,1360151665935,573050647,573050647,0
1360151695,573079720,1,445,445,1360151669765,1360151669765,573054485,573054485,0
1360151712,573095808,1,48,48,1360151686999,1360151686999,573070807,573070807,0
1360151744,573127864,1,48,48,1360151716445,1360151716445,573100309,573100309,0
1360152430,573814516,5,1257,251.4,1360152423878,1360152423942,573808394,573808458,64
1360152430,573814516,7,2084,297.7142857,1360152424133,1360152424837,573808649,573809353,704
1360152505,573889396,5,250,50,1360152478971,1360152500795,573863367,573885191,21824
1360152549,573933428,1,48,48,1360152524764,1360152524764,573909192,573909192,0
1360152581,573965424,1,48,48,1360152554273,1360152554273,573938697,573938697,0
1360152813,574197588,3,138,46,1360152788792,1360152791800,574173380,574176388,3008
1360154630,576014000,2,120,60,1360154602153,1360154605161,575986153,575989161,3008
1360154638,576021960,2,120,60,1360154612176,1360154615184,575996136,575999144,3008
1360157108,578492252,2,122,61,1360157083525,1360157083717,578467777,578467969,192
1360157192,578576652,2,122,61,1360157164215,1360157164279,578548867,578548931,64
1360157394,578778432,8,2004,250.5,1360157386638,1360157386830,578771070,578771262,192
1360157394,578778440,8,2018,252.25,1360157391941,1360157392133,578776381,578776573,192
1360157394,578778444,8,2018,252.25,1360157388867,1360157389059,578773311,578773503,192
1360157394,578778476,8,2018,252.25,1360157391459,1360157391651,578775935,578776127,192
1360157394,578778476,7,1966,280.8571429,1360157391650,1360157391906,578776126,578776382,256
1360157394,578778476,8,2018,252.25,1360157392097,1360157392289,578776573,578776765,192
1360157409,578793232,1,108,108,1360157384725,1360157384725,578768957,578768957,0
1360157409,578793232,2,216,108,1360157384789,1360157384917,578769021,578769149,128
1360157409,578793280,2,216,108,1360157384548,1360157384676,578768828,578768956,128
1360158436,579820356,1,46,46,1360158410504,1360158410504,579794860,579794860,0
1360159587,580970956,1,74,74,1360159560392,1360159560392,580944348,580944348,0
1360159675,581059372,1,74,74,1360159648873,1360159648873,581033245,581033245,0
1360160273,581656808,3,180,60,1360160245520,1360160254480,581629328,581638288,8960
1360160293,581677016,2,120,60,1360160266304,1360160269312,581650320,581653328,3008
1360162203,583587432,1,46,46,1360162175556,1360162175556,583559988,583559988,0
1360162206,583590612,1,48,48,1360162180496,1360162180496,583565108,583565108,0
1360163662,585046236,1,60,60,1360163636274,1360163636274,585020510,585020510,0
1360165173,586558584,1,46,46,1360165145620,1360165145620,586531204,586531204,0
1360235012,656395548,1,60,60,1360234983937,1360234983937,656367485,656367485,0
1360236050,657433692,1,46,46,1360236022820,1360236022820,657406512,657406512,0
1360237032,658415748,3,1240,413.3333333,1360237031386,1360237031386,658415134,658415134,0
1360237032,658415748,1,108,108,1360237031514,1360237031514,658415262,658415262,0
1360237032,658415748,1,108,108,1360237031450,1360237031450,658415198,658415198,0
1360237033,658417084,6,673,112.1666667,1360237031433,1360237031497,658415517,658415581,64
1360237033,658417084,5,1257,251.4,1360237031689,1360237031689,658415773,658415773,0
1360237031,3591694616,4,2057,514.25,1360237030831,1360237030831,3591694447,3591694447,0
1360237034,3591697200,4,1448,362,1360237032399,1360237032463,3591695599,3591695663,64
1360237034,3591697204,4,1448,362,1360237032779,1360237032843,3591695983,3591696047,64
1360237041,658425080,5,609,121.8,1360237040142,1360237040718,658424222,658424798,576
1360237041,658425080,9,1913,212.5555556,1360237036621,1360237036877,658420701,658420957,256
1360237041,658425084,7,1256,179.4285714,1360237036940,1360237037644,658421024,658421728,704
1360237041,658425084,11,3294,299.4545455,1360237034058,1360237034762,658418142,658418846,704
1360237041,658425084,6,983,163.8333333,1360237034825,1360237035017,658418909,658419101,192
1360237041,658425088,5,609,121.8,1360237039046,1360237039366,658423134,658423454,320
1360237041,658425092,9,1913,212.5555556,1360237039876,1360237040068,658423968,658424160,192
1360237041,658425096,8,3492,436.5,1360237032960,1360237033728,658417056,658417824,768
1360237041,658425096,9,2107,234.1111111,1360237034878,1360237035774,658418974,658419870,896
1360237041,658425096,9,3009,334.3333333,1360237037822,1360237038014,658421918,658422110,192
1360237041,658425096,6,798,133,1360237035006,1360237035198,658419102,658419294,192
1360237041,658425120,5,609,121.8,1360237038119,1360237038567,658422239,658422687,448
1360237041,658425120,12,4967,413.9166667,1360237038758,1360237039014,658422878,658423134,256
1360237042,3591705204,4,445,111.25,1360237040905,1360237041097,3591704109,3591704301,192
1360237042,3591705204,4,445,111.25,1360237041353,1360237041545,3591704557,3591704749,192
1360237042,3591705204,4,445,111.25,1360237041161,1360237041289,3591704365,3591704493,128
1360237042,3591705204,5,451,90.2,1360237038792,1360237038984,3591701996,3591702188,192
1360237042,3591705204,5,451,90.2,1360237039627,1360237040075,3591702831,3591703279,448
1360237042,3591705204,5,451,90.2,1360237036043,1360237036811,3591699247,3591700015,768
1360237042,3591705208,5,451,90.2,1360237037830,1360237038022,3591701038,3591701230,192
1360237056,658439812,1,108,108,1360237031513,1360237031513,658415325,658415325,0
1360237056,658439844,1,108,108,1360237031481,1360237031481,658415325,658415325,0
1360237059,3591722624,1,52,52,1360237031207,1360237031207,3591694831,3591694831,0
1360239052,660436408,2,122,61,1360239024294,1360239026598,660408702,660411006,2304
1360241607,662990956,1,52,52,1360241582149,1360241582149,662966105,662966105,0
1360241607,662991020,1,52,52,1360241582786,1360241582786,662966806,662966806,0
1360241611,662994952,1,52,52,1360241583495,1360241583495,662967447,662967447,0
1360242314,663697672,1,46,46,1360242286867,1360242286867,663670539,663670539,0
1360242505,663888892,3,144,48,1360242477108,1360242486132,663861000,663870024,9024
1360242846,664229952,2,122,61,1360242821621,1360242823733,664205573,664207685,2112
1360243921,665305452,1,52,52,1360243892207,1360243892207,665276659,665276659,0
1360243952,665335976,1,438,438,1360243924812,1360243924812,665308788,665308788,0
1360243981,665364672,1,52,52,1360243952891,1360243952891,665336563,665336563,0
1360244148,665532292,1,444,444,1360244121356,1360244121356,665505648,665505648,0
1360246076,667459888,1,46,46,1360246051651,1360246051651,667435539,667435539,0
1360247066,668450224,1,71,71,1360247039202,1360247039202,668423426,668423426,0
1360247716,669099956,1,46,46,1360247691684,1360247691684,669075640,669075640,0
1360250574,671958032,1,46,46,1360250549611,1360250549611,671933643,671933643,0
1360253509,674893172,1,46,46,1360253484142,1360253484142,674868314,674868314,0
1360254731,676115120,1,46,46,1360254706001,1360254706001,676090121,676090121,0
1360254932,676316060,1,46,46,1360254907593,1360254907593,676291653,676291653,0
1360256162,677546328,1,46,46,1360256135400,1360256135400,677519728,677519728,0
1360256709,678092620,1,48,48,1360256684069,1360256684069,678067689,678067689,0
1360257218,678602224,1,52,52,1360257189374,1360257189374,678573598,678573598,0
1360257282,678666188,1,52,52,1360257252897,1360257252897,678637085,678637085,0
1360257425,678809204,1,46,46,1360257397840,1360257397840,678782044,678782044,0
1360259334,680718172,1,48,48,1360259305360,1360259305360,680689532,680689532,0
1360259752,681136360,1,46,46,1360259722127,1360259722127,681106487,681106487,0
1360261074,682457508,1,165,165,1360261048846,1360261048846,682432354,682432354,0
1360261663,683046464,1,48,48,1360261637617,1360261637617,683021081,683021081,0
1360262609,683993060,1,46,46,1360262581520,1360262581520,683965580,683965580,0
1360262717,684101412,2,96,48,1360262688875,1360262691883,684073287,684076295,3008
1360262718,684101568,3,144,48,1360262689719,1360262691319,684073287,684074887,1600
1360262730,684113600,1,56,56,1360262703959,1360262703959,684087559,684087559,0
1360264013,685397060,2,96,48,1360263987706,1360263990714,685371766,685374774,3008
1360265102,686485976,1,46,46,1360265074683,1360265074683,686458659,686458659,0
1360266972,688355880,1,46,46,1360266947134,1360266947134,688331014,688331014,0
1360267910,689293752,1,46,46,1360267884017,1360267884017,689267769,689267769,0
1360268520,689903488,1,46,46,1360268493870,1360268493870,689877358,689877358,0
1360272060,693443932,1,46,46,1360272032316,1360272032316,693416248,693416248,0
1360272156,693540312,2,92,46,1360272131071,1360272151679,693515383,693535991,20608
1360272217,693600476,2,92,46,1360272192064,1360272194624,693575540,693578100,2560
1360272654,694037636,1,46,46,1360272628893,1360272628893,694012529,694012529,0
1360273733,695116876,2,96,48,1360273708378,1360273711386,695092254,695095262,3008
1360309731,731114756,1,46,46,1360309702767,1360309702767,731086523,731086523,0
1360310603,731986888,2,120,60,1360310578527,1360310581535,731962415,731965423,3008
1360310735,732119224,1,46,46,1360310708237,1360310708237,732092461,732092461,0
1360311317,732700584,1,60,60,1360311289987,1360311289987,732673571,732673571,0
1360313116,734500020,4,2481,620.25,1360313113460,1360313113588,734497480,734497608,128
1360313116,734500024,4,824,206,1360313113777,1360313113905,734497801,734497929,128
1360313119,3667782292,4,478,119.5,1360313113955,1360313114019,3667777247,3667777311,64
1360313124,734508032,7,1838,262.5714286,1360313121192,1360313121320,734505224,734505352,128
1360313124,734508032,8,2746,343.25,1360313121320,1360313121448,734505352,734505480,128
1360313124,734508032,8,1424,178,1360313117160,1360313117608,734501192,734501640,448
1360313124,734508032,10,1994,199.4,1360313121511,1360313121767,734505543,734505799,256
1360313124,734508036,8,2922,365.25,1360313122211,1360313122339,734506247,734506375,128
1360313124,734508036,9,3246,360.6666667,1360313122339,1360313122403,734506375,734506439,64
1360313124,734508040,7,2342,334.5714286,1360313122078,1360313122206,734506118,734506246,128
1360313124,734508040,8,2378,297.25,1360313119072,1360313119200,734503112,734503240,128
1360313124,734508040,9,3494,388.2222222,1360313122719,1360313122847,734506759,734506887,128
1360313124,734508040,8,2666,333.25,1360313118943,1360313119071,734502983,734503111,128
1360313124,734508044,7,2582,368.8571429,1360313119198,1360313119262,734503242,734503306,64
1360313124,734508044,8,2378,297.25,1360313119965,1360313120093,734504009,734504137,128
1360313124,734508044,8,2698,337.25,1360313119453,1360313119581,734503497,734503625,128
1360313124,734508044,7,1838,262.5714286,1360313120220,1360313120348,734504264,734504392,128
1360313124,734508048,8,1890,236.25,1360313120662,1360313120726,734504710,734504774,64
1360313124,734508048,9,1942,215.7777778,1360313120346,1360313120666,734504394,734504714,320
1360313124,734508048,8,1890,236.25,1360313120729,1360313120857,734504777,734504905,128
1360313124,734508048,10,2913,291.3,1360313115609,1360313123673,734499657,734507721,8064
1360313124,734508048,8,1890,236.25,1360313120857,1360313120921,734504905,734504969,64
1360313124,734508048,8,2386,298.25,1360313120921,1360313121049,734504969,734505097,128
1360313124,734508048,8,2506,313.25,1360313121049,1360313121177,734505097,734505225,128
1360313124,734508048,8,2378,297.25,1360313121432,1360313121496,734505480,734505544,64
1360313124,734508052,10,1994,199.4,1360313121746,1360313122002,734505798,734506054,256
1360313124,734508052,4,700,175,1360313116502,1360313123478,734500554,734507530,6976
1360313124,734508076,10,4818,481.8,1360313121980,1360313122044,734506056,734506120,64
1360313124,734508080,8,1890,236.25,1360313122361,1360313122489,734506441,734506569,128
1360313124,734508080,12,4008,334,1360313114489,1360313123513,734498569,734507593,9024
1360313124,734508080,10,1994,199.4,1360313122488,1360313122680,734506568,734506760,192
1360313124,734508080,9,1942,215.7777778,1360313119224,1360313119416,734503304,734503496,192
1360313124,734508080,10,1994,199.4,1360313122807,1360313123063,734506887,734507143,256
1360313124,734508080,10,2490,249,1360313119671,1360313119927,734503751,734504007,256
1360313124,734508080,7,2662,380.2857143,1360313119543,1360313119671,734503623,734503751,128
1360313124,734508080,9,1942,215.7777778,1360313123062,1360313123254,734507142,734507334,192
1360313124,734508084,8,1890,236.25,1360313120054,1360313120182,734504138,734504266,128
1360313127,3667790312,4,971,242.75,1360313118607,1360313118991,3667781919,3667782303,384
1360313132,734516016,7,1401,200.1428571,1360313125175,1360313125751,734509191,734509767,576
1360313132,734516028,5,1275,255,1360313123501,1360313126637,734507529,734510665,3136
1360313132,734516032,8,2021,252.625,1360313124712,1360313124840,734508744,734508872,128
1360313132,734516032,8,1977,247.125,1360313124583,1360313126631,734508615,734510663,2048
1360313132,734516064,10,3068,306.8,1360313123718,1360313126598,734507782,734510662,2880
1360313135,3667798292,4,478,119.5,1360313128290,1360313128354,3667791582,3667791646,64
1360313149,734533208,1,108,108,1360313123895,1360313123895,734508103,734508103,0
1360313149,734533252,1,108,108,1360313123980,1360313123980,734508232,734508232,0
1360313149,734533252,1,108,108,1360313124043,1360313124043,734508295,734508295,0
1360314460,735843512,1,439,439,1360314435100,1360314435100,735818612,735818612,0
1360319145,740528836,2,296,148,1360319118736,1360319131984,740502572,740515820,13248
1360319205,740588896,1,148,148,1360319177683,1360319177683,740561579,740561579,0
1360319281,740664968,1,58,58,1360319256333,1360319256333,740640301,740640301,0
1360319313,740697020,5,240,48,1360319285270,1360319307222,740669290,740691242,21952
1360319373,740757104,1,46,46,1360319348227,1360319348227,740732331,740732331,0
1360319639,741022288,1,48,48,1360319610544,1360319610544,740993832,740993832,0
1360320044,741427448,1,46,46,1360320017993,1360320017993,741401441,741401441,0
1360320044,741427892,1,46,46,1360320017548,1360320017548,741401440,741401440,0
1360320452,741835648,3,152,50.66666667,1360320426683,1360320435707,741810331,741819355,9024
1360322496,743880144,1,52,52,1360322469228,1360322469228,743853372,743853372,0
1360322954,744337416,1,46,46,1360322926013,1360322926013,744309429,744309429,0
1360323405,744788356,5,2106,421.2,1360323403761,1360323404209,744787117,744787565,448
1360323409,3678072280,4,1448,362,1360323405873,1360323405937,3678069153,3678069217,64
1360323409,3678072284,5,2109,421.8,1360323408878,1360323408878,3678072162,3678072162,0
1360323409,3678072284,5,451,90.2,1360323405421,1360323405741,3678068705,3678069025,320
1360323413,744796344,6,983,163.8333333,1360323408382,1360323408638,744791726,744791982,256
1360323413,744796344,6,798,133,1360323408637,1360323408829,744791981,744792173,192
1360323413,744796344,11,3419,310.8181818,1360323408509,1360323410045,744791853,744793389,1536
1360323413,744796348,6,859,143.1666667,1360323409719,1360323410039,744793067,744793387,320
1360323413,744796348,9,1913,212.5555556,1360323406266,1360323406458,744789614,744789806,192
1360323413,744796348,4,724,181,1360323409978,1360323410042,744793326,744793390,64
1360323413,744796348,7,1256,179.4285714,1360323411128,1360323411768,744794476,744795116,640
1360323413,744796352,11,3294,299.4545455,1360323407667,1360323408371,744791019,744791723,704
1360323413,744796352,8,3137,392.125,1360323403957,1360323405429,744787309,744788781,1472
1360323413,744796352,11,3147,286.0909091,1360323408564,1360323409204,744791916,744792556,640
1360323413,744796352,9,1913,212.5555556,1360323412020,1360323412212,744795372,744795564,192
1360323413,744796380,5,1257,251.4,1360323406553,1360323406617,744789933,744789997,64
1360323413,744796380,9,3544,393.7777778,1360323406617,1360323407449,744789997,744790829,832
1360323413,744796384,9,1913,212.5555556,1360323410838,1360323411030,744794222,744794414,192
1360323417,3678080268,6,3769,628.1666667,1360323414526,1360323414590,3678077794,3678077858,64
1360323417,3678080268,5,451,90.2,1360323414846,1360323415038,3678078114,3678078306,192
1360323417,3678080268,5,451,90.2,1360323411325,1360323411453,3678074593,3678074721,128
1360323417,3678080268,4,445,111.25,1360323415997,1360323416125,3678079265,3678079393,128
1360323417,3678080268,4,445,111.25,1360323416125,1360323416253,3678079393,3678079521,128
1360323417,3678080268,5,451,90.2,1360323409788,1360323410364,3678073056,3678073632,576
1360323417,3678080268,5,451,90.2,1360323412544,1360323412672,3678075812,3678075940,128
1360323417,3678080272,5,451,90.2,1360323413307,1360323414203,3678076579,3678077475,896
1360323417,3678080272,6,3769,628.1666667,1360323410618,1360323410746,3678073890,3678074018,128
1360323417,3678080272,4,445,111.25,1360323415866,1360323415994,3678079138,3678079266,128
1360323417,3678080272,5,1893,378.6,1360323412281,1360323412409,3678075553,3678075681,128
1360323417,3678080276,6,3769,628.1666667,1360323413880,1360323413944,3678077156,3678077220,64
1360323417,3678080276,5,1893,378.6,1360323412984,1360323413048,3678076260,3678076324,64
1360323421,744804360,9,3009,334.3333333,1360323417005,1360323417197,744800365,744800557,192
1360323421,744804360,12,4967,413.9166667,1360323417197,1360323417389,744800557,744800749,192
1360323421,744804364,12,4927,410.5833333,1360323417702,1360323417894,744801066,744801258,192
1360323421,744804364,12,4735,394.5833333,1360323417898,1360323418090,744801262,744801454,192
1360323421,744804364,12,4967,413.9166667,1360323414698,1360323414890,744798062,744798254,192
1360323421,744804364,5,609,121.8,1360323414953,1360323415273,744798317,744798637,320
1360323421,744804364,9,1913,212.5555556,1360323419240,1360323419368,744802604,744802732,128
1360323421,744804364,11,2017,183.3636364,1360323418984,1360323419240,744802348,744802604,256
1360323421,744804364,9,1913,212.5555556,1360323415527,1360323415783,744798891,744799147,256
1360323421,744804364,9,2849,316.5555556,1360323419431,1360323419559,744802795,744802923,128
1360323421,744804368,9,3009,334.3333333,1360323413154,1360323413282,744796522,744796650,128
1360323421,744804368,5,609,121.8,1360323415910,1360323416294,744799278,744799662,384
1360323421,744804368,5,609,121.8,1360323413349,1360323413733,744796717,744797101,384
1360323421,744804368,9,1913,212.5555556,1360323416485,1360323416677,744799853,744800045,192
1360323421,744804368,9,1913,212.5555556,1360323416293,1360323416485,744799661,744799853,192
1360323421,744804368,9,1913,212.5555556,1360323416676,1360323416804,744800044,744800172,128
1360323421,744804368,15,8365,557.6666667,1360323416867,1360323416995,744800235,744800363,128
1360323421,744804368,7,1256,179.4285714,1360323412323,1360323412963,744795691,744796331,640
1360323421,744804368,9,1913,212.5555556,1360323417379,1360323417507,744800747,744800875,128
1360323421,744804372,12,4727,393.9166667,1360323417570,1360323417698,744800942,744801070,128
1360323421,744804396,7,2091,298.7142857,1360323415050,1360323415626,744798446,744799022,576
1360323421,744804396,10,1877,187.7,1360323418057,1360323418953,744801453,744802349,896
1360323425,3678088264,4,1448,362,1360323419201,1360323419201,3678082465,3678082465,0
1360323429,744812356,9,3310,367.7777778,1360323419822,1360323422638,744803178,744805994,2816
1360323429,744812360,11,3096,281.4545455,1360323425387,1360323425963,744808747,744809323,576
1360323429,744812364,10,3397,339.7,1360323422633,1360323423849,744805997,744807213,1216
1360323429,744812364,14,7501,535.7857143,1360323426792,1360323427496,744810156,744810860,704
1360323429,744812372,4,715,178.75,1360323425118,1360323425182,744808490,744808554,64
1360323431,744814752,2,216,108,1360323403556,1360323403684,744787308,744787436,128
1360323431,744814752,2,216,108,1360323403683,1360323403811,744787435,744787563,128
1360323431,744814792,2,216,108,1360323403453,1360323403517,744787245,744787309,64
1360323435,744818840,7,1980,282.8571429,1360323409741,1360323410445,744793581,744794285,704
1360323437,744820356,7,2027,289.5714286,1360323411249,1360323411953,744794605,744795309,704
1360323439,744822824,7,2091,298.7142857,1360323413980,1360323414556,744797804,744798380,576
1360323439,744822828,7,2031,290.1428571,1360323412441,1360323413017,744796269,744796845,576
1360323439,744822848,7,2031,290.1428571,1360323413060,1360323413764,744796908,744797612,704
1360323439,744822848,7,1877,268.1428571,1360323411587,1360323412227,744795435,744796075,640
1360328816,750199356,1,48,48,1360328790814,1360328790814,750174170,750174170,0
1360328816,750199388,1,48,48,1360328790782,1360328790782,750174170,750174170,0
1360330434,751818108,1,46,46,1360330409112,1360330409112,751793220,751793220,0
1360331216,752600056,2,96,48,1360331191552,1360331194496,752575608,752578552,2944
1360331340,752724080,1,46,46,1360331312036,1360331312036,752696116,752696116,0
1360332475,753858656,1,46,46,1360332446909,1360332446909,753830565,753830565,0
1360333033,754416392,2,122,61,1360333006395,1360333008507,754389787,754391899,2112
1360333071,754454512,1,46,46,1360333043907,1360333043907,754427419,754427419,0
1360334060,755443324,1,46,46,1360334033070,1360334033070,755416394,755416394,0
1360334381,755764316,1,78,78,1360334354419,1360334354419,755737735,755737735,0
1360334998,756381436,1,46,46,1360334971379,1360334971379,756354815,756354815,0
1360337103,758486776,1,60,60,1360337076991,1360337076991,758460767,758460767,0
1360338214,759597828,1,46,46,1360338187514,1360338187514,759571342,759571342,0
1360338303,759687044,1,46,46,1360338275233,1360338275233,759659277,759659277,0
1360338998,760381720,1,48,48,1360338968090,1360338968090,760351810,760351810,0
1360339368,760751868,1,46,46,1360339340609,1360339340609,760724477,760724477,0
1360339449,760832460,1,46,46,1360339422998,1360339422998,760806458,760806458,0
1360339761,761144964,1,52,52,1360339733594,1360339733594,761117558,761117558,0
1360339825,761208952,1,46,46,1360339797606,1360339797606,761181558,761181558,0
1360340944,762327408,1,46,46,1360340917939,1360340917939,762301347,762301347,0
1360342832,764215580,1,46,46,1360342806250,1360342806250,764189830,764189830,0
1360342980,764363672,1,48,48,1360342952719,1360342952719,764336391,764336391,0
1360343269,764652676,1,46,46,1360343243779,1360343243779,764627455,764627455,0
1360343566,764949496,1,46,46,1360343539190,1360343539190,764922686,764922686,0
1360344631,766014352,1,125,125,1360344601779,1360344601779,765985131,765985131,0
1360347434,768818044,1,48,48,1360347408535,1360347408535,768792579,768792579,0
1360349178,770561604,3,152,50.66666667,1360349153202,1360349162226,770536806,770545830,9024
1360350376,771759796,2,96,48,1360350349535,1360350352543,771733331,771736339,3008
1360350693,772076492,2,96,48,1360350665802,1360350668746,772049294,772052238,2944
1360351990,773373440,1,46,46,1360351961836,1360351961836,773345276,773345276,0
1360352726,774109552,1,60,60,1360352698161,1360352698161,774081713,774081713,0
1360353022,774405928,1,46,46,1360352994418,1360352994418,774378346,774378346,0
1360353500,774883512,1,443,443,1360353472780,1360353472780,774856292,774856292,0
1360354390,775773384,1,56,56,1360354363902,1360354363902,775747286,775747286,0
1360355130,776513212,1,46,46,1360355118498,1360355118498,776501710,776501710,0
1360355991,777374968,1,46,46,1360355962080,1360355962080,777346048,777346048,0
1360356340,777723760,1,48,48,1360356314410,1360356314410,777698170,777698170,0
1360356570,777953960,1,48,48,1360356543135,1360356543135,777927095,777927095,0
1360357457,778840820,1,46,46,1360357430685,1360357430685,778814505,778814505,0
1360357594,778977268,1,46,46,1360357567491,1360357567491,778950759,778950759,0
1360357710,779093320,1,48,48,1360357684941,1360357684941,779068261,779068261,0
1360357734,779117384,1,46,46,1360357705867,1360357705867,779089251,779089251,0
1360358928,780311340,2,96,48,1360358901158,1360358904294,780284498,780287634,3136
1360359998,781381888,1,46,46,1360359972019,1360359972019,781355907,781355907,0
1360360467,781850644,2,96,48,1360360439711,1360360442655,781823355,781826299,2944
1360360840,782223492,1,46,46,1360360815601,1360360815601,782199093,782199093,0
1360362505,783888240,1,60,60,1360362480662,1360362480662,783863902,783863902,0
1360362554,3717216868,1,52,52,1360362529745,1360362529745,3717192613,3717192613,0
1360362554,3717216876,1,46,46,1360362527751,1360362527751,3717190627,3717190627,0
1360362577,783960620,1,46,46,1360362549529,1360362549529,783933149,783933149,0
1360363074,784458076,1,46,46,1360363048135,1360363048135,784432211,784432211,0
1360364959,786342320,1,46,46,1360364928736,1360364928736,786312056,786312056,0
1360366607,787991008,1,96,96,1360366581077,1360366581077,787965085,787965085,0
1360369113,790497008,1,46,46,1360369088114,1360369088114,790472122,790472122,0
1360369402,790785780,1,46,46,1360369375953,1360369375953,790759733,790759733,0
1360372409,793792440,3,144,48,1360372381304,1360372390200,793764744,793773640,8896
1360373848,795232056,1,46,46,1360373821883,1360373821883,795205939,795205939,0
1360373849,795232700,1,46,46,1360373822303,1360373822303,795206003,795206003,0
1360374072,795455848,1,46,46,1360374046596,1360374046596,795430444,795430444,0
1360374272,795655108,1,46,46,1360374241831,1360374241831,795624939,795624939,0
1360374272,795655112,1,46,46,1360374241828,1360374241828,795624940,795624940,0
1360375027,796410664,1,438,438,1360374998895,1360374998895,796382559,796382559,0
1360375031,796414624,1,439,439,1360375003673,1360375003673,796387297,796387297,0
1360375142,796525924,8,2576,322,1360375140330,1360375140842,796524254,796524766,512
1360375142,796525928,10,2668,266.8,1360375140773,1360375141221,796524701,796525149,448
1360375142,796525968,14,3446,246.1428571,1360375135293,1360375135677,796519261,796519645,384
1360375142,796525968,15,3492,232.8,1360375135293,1360375135677,796519261,796519645,384
1360375152,3729815340,19,21944,1154.947368,1360375139596,1360375151564,3729802936,3729814904,11968
1360375158,796541936,22,16720,760,1360375140063,1360375151519,796523999,796535455,11456
1360375214,796597952,15,6289,419.2666667,1360375200843,1360375212811,796584795,796596763,11968
1360375214,796598008,12,999,83.25,1360375201493,1360375212757,796585501,796596765,11264
1360375214,796598008,15,6289,419.2666667,1360375201875,1360375212755,796585883,796596763,10880
1360375214,796598064,13,1382,106.3076923,1360375202398,1360375212702,796586462,796596766,10304
1360375609,3730272336,221522,332251720,1499.858795,1360375435859,1360375608659,3730099195,3730271995,172800
1360375609,3730272400,369659,554396422,1499.750911,1360375148884,1360375436052,3729812284,3730099452,287168
1360375664,3730327540,55058,82536450,1499.081877,1360375608456,1360375661384,3730271996,3730324924,52928
1360375901,797284388,1,46,46,1360375874549,1360375874549,797257937,797257937,0
1360376494,797877580,1,48,48,1360376468078,1360376468078,797851658,797851658,0
1360376653,3731316156,32,43568,1361.5,1360376648336,1360376648784,3731311492,3731311940,448
1360376686,3731348824,1,52,52,1360376660699,1360376660699,3731323523,3731323523,0
1360377036,798419100,12,6151,512.5833333,1360377011334,1360377011782,798394434,798394882,448
1360377039,798423052,9,861,95.66666667,1360377010894,1360377011150,798394946,798395202,256
1360377040,798423136,9,861,95.66666667,1360377012131,1360377012323,798395267,798395459,192
1360377040,798423136,9,861,95.66666667,1360377012448,1360377012576,798395584,798395712,128
1360377256,798640056,4,252,63,1360377248583,1360377255623,798632639,798639679,7040
1360377281,798664076,3,189,63,1360377276056,1360377279128,798659132,798662204,3072
1360377288,798672044,1,63,63,1360377263697,1360377263697,798647741,798647741,0
1360377297,798680112,2,126,63,1360377283127,1360377291127,798666239,798674239,8000
1360377297,798680148,3,189,63,1360377290065,1360377293137,798673213,798676285,3072
1360377313,798696156,2,126,63,1360377297098,1360377305162,798680254,798688318,8064
1360377345,798728228,2,126,63,1360377341953,1360377342977,798725181,798726205,1024
1360377353,798736192,2,126,63,1360377344996,1360377349028,798728188,798732220,4032
1360377361,798744260,11,953,86.63636364,1360377347808,1360377357280,798731068,798740540,9472
1360377361,798744308,17,6755,397.3529412,1360377347311,1360377357231,798730619,798740539,9920
1360377361,798744316,12,999,83.25,1360377348070,1360377357222,798731386,798740538,9152
1360377372,798756052,1,46,46,1360377347527,1360377347527,798731579,798731579,0
1360377617,799000820,12,999,83.25,1360377598125,1360377609965,798981945,798993785,11840
1360377617,799000824,12,999,83.25,1360377598762,1360377609962,798982586,798993786,11200
1360377617,799000864,12,999,83.25,1360377597823,1360377609919,798981687,798993783,12096
1360377617,799000884,12,999,83.25,1360377598379,1360377609899,798982263,798993783,11520
1360377962,799345188,16,6335,395.9375,1360377947297,1360377959393,799330485,799342581,12096
1360377962,799345192,12,999,83.25,1360377948506,1360377959386,799331698,799342578,10880
1360377962,799345196,12,999,83.25,1360377948824,1360377959320,799332020,799342516,10496
1360377962,799345264,16,6372,398.25,1360377947924,1360377959316,799331188,799342580,11392
1360378051,799434084,11,3267,297,1360378023429,1360378024069,799406513,799407153,640
1360378087,799470316,1,92,92,1360378062555,1360378062555,799445871,799445871,0
1360378147,799530344,1,46,46,1360378119938,1360378119938,799503282,799503282,0
1360378162,799545392,3,193,64.33333333,1360378154255,1360378154255,799537647,799537647,0
1360378193,799576664,1,46,46,1360378163841,1360378163841,799547505,799547505,0
1360378193,799576676,1,46,46,1360378163893,1360378163893,799547569,799547569,0
1360378219,799602644,1,92,92,1360378193682,1360378193682,799577326,799577326,0
1360378647,800030288,1,46,46,1360378619375,1360378619375,800002663,800002663,0
1360379073,800456616,1,46,46,1360379045091,1360379045091,800428707,800428707,0
1360379177,800560848,1,48,48,1360379152503,1360379152503,800536351,800536351,0
1360379203,800586800,35,29783,850.9428571,1360379197802,1360379199274,800581602,800583074,1472
1360379297,800680996,1,48,48,1360379270884,1360379270884,800654880,800654880,0
1360379318,800701212,11,3267,297,1360379291508,1360379292212,800674720,800675424,704
1360379604,800987100,2,141,70.5,1360379601950,1360379601950,800985050,800985050,0
1360379626,801009684,11,3267,297,1360379600854,1360379601494,800984538,800985178,640
1360379779,801162232,14,6617,472.6428571,1360379754137,1360379754457,801137369,801137689,320
1360379779,801162296,12,6151,512.5833333,1360379753049,1360379753433,801136345,801136729,384
1360379779,801162300,9,861,95.66666667,1360379753494,1360379753686,801136794,801136986,192
1360379779,801162304,9,861,95.66666667,1360379753810,1360379754002,801137114,801137306,192
1360379807,801190532,1,46,46,1360379782060,1360379782060,801165592,801165592,0
1360379916,801299608,3,138,46,1360379912862,1360379912926,801296470,801296534,64
1360379916,801299608,3,138,46,1360379912861,1360379912925,801296469,801296533,64
1360379916,801299672,3,138,46,1360379912796,1360379912860,801296468,801296532,64
1360379916,801299676,3,138,46,1360379912795,1360379912859,801296471,801296535,64
1360379932,801315668,11,953,86.63636364,1360379914978,1360379926498,801298646,801310166,11520
1360379932,801315672,12,999,83.25,1360379915231,1360379926495,801298903,801310167,11264
1360379932,801315708,12,999,83.25,1360379914361,1360379926457,801298069,801310165,12096
1360379932,801315708,11,953,86.63636364,1360379914616,1360379926456,801298324,801310164,11840
1360380224,801607064,1,89,89,1360380196088,1360380196088,801579152,801579152,0
1360380365,801748172,4,319,79.75,1360380358860,1360380359692,801742032,801742864,832
1360380373,801756172,17,6755,397.3529412,1360380360010,1360380372106,801743182,801755278,12096
1360380373,801756176,12,999,83.25,1360380360392,1360380372040,801743568,801755216,11648
1360380373,801756180,11,953,86.63636364,1360380360900,1360380372036,801744080,801755216,11136
1360380373,801756220,12,999,83.25,1360380360603,1360380371995,801743823,801755215,11392
1360380437,801820288,43,56199,1306.953488,1360380429591,1360380429975,801812879,801813263,384
1360382192,803575132,12,6151,512.5833333,1360382166231,1360382166551,803549363,803549683,320
1360382192,803575140,9,861,95.66666667,1360382166928,1360382167120,803550068,803550260,192
1360382192,803575140,9,861,95.66666667,1360382167183,1360382167375,803550323,803550515,192
1360382192,803575216,8,815,101.875,1360382166530,1360382166722,803549746,803549938,192
1360382247,803630472,3,138,46,1360382242497,1360382242561,803625969,803626033,64
1360382247,803630472,3,138,46,1360382242497,1360382242561,803625969,803626033,64
1360382247,803630540,3,138,46,1360382242431,1360382242495,803625971,803626035,64
1360382247,803630540,3,138,46,1360382242495,1360382242559,803626035,803626099,64
1360382271,803654512,16,7038,439.875,1360382256792,1360382268632,803640304,803652144,11840
1360382274,3736937252,9,7804,867.1111111,1360382256403,1360382268371,3736919655,3736931623,11968
1360382274,3736937256,16,18752,1172,1360382256399,1360382268367,3736919655,3736931623,11968
1360383995,805378608,14,6749,482.0714286,1360383970593,1360383970849,805354201,805354457,256
1360383999,805382584,12,6151,512.5833333,1360383970998,1360383971382,805354582,805354966,384
1360383999,805382588,8,815,101.875,1360383971444,1360383971636,805355032,805355224,192
1360383999,805382588,9,861,95.66666667,1360383971698,1360383971890,805355286,805355478,192
1360383999,805382592,9,861,95.66666667,1360383972016,1360383972208,805355608,805355800,192
1360384143,805527032,1,46,46,1360384117238,1360384117238,805501270,805501270,0
1360384209,805592432,2,126,63,1360384205771,1360384206731,805589203,805590163,960
1360384217,805600336,2,126,63,1360384213994,1360384215018,805597330,805598354,1024
1360384217,805600340,2,126,63,1360384208870,1360384212902,805592210,805596242,4032
1360384217,805600380,2,126,63,1360384214017,1360384215041,805597397,805598421,1024
1360384225,805608316,2,126,63,1360384217088,1360384221120,805600404,805604436,4032
1360384225,805608316,2,126,63,1360384217088,1360384221184,805600404,805604500,4096
1360384247,805630940,1,63,63,1360384220369,1360384220369,805604309,805604309,0
1360384255,805638928,1,63,63,1360384228570,1360384228570,805612498,805612498,0
1360384255,805638932,1,63,63,1360384228566,1360384228566,805612498,805612498,0
1360384257,805640360,3,189,63,1360384250258,1360384253330,805633618,805636690,3072
1360384273,805656348,2,126,63,1360384257310,1360384265374,805640658,805648722,8064
1360384324,805707096,1,46,46,1360384298073,1360384298073,805681169,805681169,0
1360384385,805768428,3,189,63,1360384381199,1360384384271,805764627,805767699,3072
1360384401,805784456,2,126,63,1360384388273,1360384396273,805771729,805779729,8000
1360384452,805835572,1,46,46,1360384425339,1360384425339,805808911,805808911,0
1360384489,805872508,15,6289,419.2666667,1360384476220,1360384488316,805859728,805871824,12096
1360384489,805872640,12,999,83.25,1360384476598,1360384488118,805860238,805871758,11520
1360384489,805872644,12,999,83.25,1360384476854,1360384488118,805860498,805871762,11264
1360384489,805872644,12,999,83.25,1360384477107,1360384488115,805860751,805871759,11008
1360384532,805915844,1,46,46,1360384507437,1360384507437,805891281,805891281,0
1360384741,806124196,3,152,50.66666667,1360384714286,1360384723310,806097482,806106506,9024
1360384793,806176284,1,46,46,1360384766809,1360384766809,806150093,806150093,0
1360384849,806232756,14,3460,247.1428571,1360384832959,1360384843711,806216715,806227467,10752
1360384997,806380372,1,60,60,1360384970810,1360384970810,806354182,806354182,0
1360385235,806618060,1,46,46,1360385209007,1360385209007,806592067,806592067,0
1360385235,806618064,1,46,46,1360385209004,1360385209004,806592068,806592068,0
1360386140,807523540,2,104,52,1360386111876,1360386114820,807495416,807498360,2944
1360386299,807682732,15,6289,419.2666667,1360386281151,1360386293247,807664883,807676979,12096
1360386299,807682764,12,999,83.25,1360386281888,1360386293152,807665652,807676916,11264
1360386299,807682768,11,953,86.63636364,1360386282205,1360386293149,807665973,807676917,10944
1360386299,807682812,12,999,83.25,1360386281586,1360386293106,807665398,807676918,11520
1360386986,808369760,1,148,148,1360386960731,1360386960731,808344491,808344491,0
1360387720,809103192,1,46,46,1360387692103,1360387692103,809075295,809075295,0
1360388100,809483976,12,999,83.25,1360388087023,1360388098159,809470999,809482135,11136
1360388100,809484004,11,953,86.63636364,1360388087252,1360388098132,809471256,809482136,10880
1360388101,809484024,15,6289,419.2666667,1360388087081,1360388099177,809470105,809482201,12096
1360388101,809484048,12,999,83.25,1360388087699,1360388099091,809470747,809482139,11392
1360388393,809776304,1,46,46,1360388366154,1360388366154,809749458,809749458,0
1360388845,810228368,6,3996,666,1360388842629,1360388843205,810225997,810226573,576
1360388845,810228376,6,3996,666,1360388840126,1360388840318,810223502,810223694,192
1360388845,810228444,6,3996,666,1360388840186,1360388842554,810223630,810225998,2368
1360388853,810236436,8,1470,183.75,1360388843137,1360388852033,810226573,810235469,8896
1360388853,810236456,11,4638,421.6363636,1360388840237,1360388852077,810223693,810235533,11840
1360388860,3743522964,19,21947,1155.105263,1360388842273,1360388854241,3743505237,3743517205,11968
1360388861,810244380,21,6086,289.8095238,1360388842618,1360388858106,810225998,810241486,15488
1360388861,810244412,24,16267,677.7916667,1360388843931,1360388854427,810227343,810237839,10496
1360388861,810244412,120,164955,1374.625,1360388848600,1360388858008,810232012,810241420,9408
1360388901,810284396,11,4638,421.6363636,1360388896359,1360388899367,810279755,810282763,3008
1360388901,810284440,6,3996,666,1360388895999,1360388896319,810279439,810279759,320
1360391046,812429588,2,296,148,1360391018825,1360391034313,812402413,812417901,15488
1360391953,813336600,1,46,46,1360391924462,1360391924462,813308062,813308062,0
1360391954,813337700,1,46,46,1360391924300,1360391924300,813308000,813308000,0
1360392272,813655824,1,60,60,1360392247241,1360392247241,813631065,813631065,0
1360392890,814273860,1,1010,1010,1360392863837,1360392863837,814247697,814247697,0
1360392945,814328892,2,122,61,1360392917115,1360392919419,814301007,814303311,2304
1360393222,814605700,1,46,46,1360393195703,1360393195703,814579403,814579403,0
1360393819,815202872,1,60,60,1360393793538,1360393793538,815177410,815177410,0
1360393827,815210880,1,60,60,1360393800826,1360393800826,815184706,815184706,0
1360394585,815968028,1,46,46,1360394560322,1360394560322,815943350,815943350,0
1360395249,816632804,1,46,46,1360395219762,1360395219762,816603566,816603566,0
1360395249,816632808,1,46,46,1360395219755,1360395219755,816603563,816603563,0
1360395559,816942520,1,444,444,1360395531399,1360395531399,816914919,816914919,0
1360395563,816946448,1,445,445,1360395536143,1360395536143,816919591,816919591,0
1360396340,817723640,1,64,64,1360396314115,1360396314115,817697755,817697755,0
1360398183,819566632,1,60,60,1360398156591,1360398156591,819540223,819540223,0
1360398600,819983844,1,56,56,1360398574996,1360398574996,819958840,819958840,0
1360398813,820196596,2,122,61,1360398788812,1360398791116,820172408,820174712,2304
1360399354,820737380,1,60,60,1360399328092,1360399328092,820711472,820711472,0
1360399382,820765460,1,60,60,1360399354443,1360399354443,820737903,820737903,0
1360399570,820953884,1,46,46,1360399545121,1360399545121,820929005,820929005,0
1360399939,821322196,1,46,46,1360399912520,1360399912520,821295716,821295716,0
1360399951,821334272,1,46,46,1360399925308,1360399925308,821308580,821308580,0
1360400305,821688260,1,48,48,1360400276742,1360400276742,821660002,821660002,0
1360400306,821689404,1,48,48,1360400276531,1360400276531,821659935,821659935,0
1360402525,823908184,1,46,46,1360402497518,1360402497518,823880702,823880702,0
1360403635,825018660,1,46,46,1360403607042,1360403607042,824990702,824990702,0
1360404237,825620376,1,60,60,1360404208916,1360404208916,825592292,825592292,0
1360404249,825632420,1,60,60,1360404221927,1360404221927,825605347,825605347,0
1360404337,825720760,1,441,441,1360404312402,1360404312402,825696162,825696162,0
1360404345,825728800,1,443,443,1360404317995,1360404317995,825701795,825701795,0
1360404538,825921296,1,48,48,1360404510303,1360404510303,825893599,825893599,0
1360404618,826001808,1,48,48,1360404592543,1360404592543,825976351,825976351,0
1360404650,826033948,1,46,46,1360404625106,1360404625106,826009054,826009054,0
1360404718,826101776,1,46,46,1360404693051,1360404693051,826076827,826076827,0
1360404724,826107204,1,48,48,1360404695032,1360404695032,826078236,826078236,0
1360404725,826108360,1,48,48,1360404694876,1360404694876,826078236,826078236,0
1360404902,826285932,1,46,46,1360404874908,1360404874908,826258840,826258840,0
1360405395,826778592,12,6151,512.5833333,1360405367210,1360405367850,826750802,826751442,640
1360405395,826778596,9,861,95.66666667,1360405367909,1360405368101,826751505,826751697,192
1360405395,826778644,8,815,101.875,1360405368180,1360405368372,826751824,826752016,192
1360405395,826778648,8,815,101.875,1360405368434,1360405368626,826752082,826752274,192
1360405617,827000920,3,189,63,1360405613021,1360405616029,826996941,826999949,3008
1360405617,827000920,3,189,63,1360405613277,1360405616285,826997197,827000205,3008
1360405633,827016964,2,126,63,1360405620273,1360405628337,827004237,827012301,8064
1360405633,827016972,2,126,63,1360405620009,1360405628073,827003981,827012045,8064
1360405706,827088988,3,189,63,1360405701249,1360405704321,827084237,827087309,3072
1360405722,827104984,2,126,63,1360405708357,1360405716357,827091341,827099341,8000
1360405722,827104992,2,126,63,1360405708348,1360405716412,827091340,827099404,8064
1360405840,827223592,1,46,46,1360405813668,1360405813668,827197260,827197260,0
1360406634,828017092,1,46,46,1360406607372,1360406607372,827990464,827990464,0
1360406826,828209544,9,861,95.66666667,1360406799492,1360406799684,828183036,828183228,192
1360406826,828209544,5,340,68,1360406799746,1360406800962,828183290,828184506,1216
1360406826,828209576,11,4651,422.8181818,1360406798756,1360406799332,828182332,828182908,576
1360407071,828454428,1,46,46,1360407046324,1360407046324,828429752,828429752,0
1360407083,828466404,3,189,63,1360407079180,1360407082188,828462584,828465592,3008
1360407099,828482352,2,126,63,1360407086271,1360407094335,828469623,828477687,8064
1360407139,828522680,3,189,63,1360407132982,1360407136054,828516662,828519734,3072
1360407155,828538604,2,126,63,1360407140164,1360407148164,828523768,828531768,8000
1360408230,829612996,1,46,46,1360408202516,1360408202516,829585512,829585512,0
1360408851,830234000,9,861,95.66666667,1360408825094,1360408826246,830208094,830209246,1152
1360408851,830234116,12,6151,512.5833333,1360408824209,1360408824593,830207325,830207709,384
1360408851,830234120,8,815,101.875,1360408824720,1360408824912,830207840,830208032,192
1360408851,830234124,10,907,90.7,1360408826249,1360408828425,830209373,830211549,2176
1360409084,830467520,4,252,63,1360409076346,1360409083386,830459866,830466906,7040
1360409084,830467528,4,252,63,1360409076338,1360409083378,830459866,830466906,7040
1360409084,830467528,4,252,63,1360409076338,1360409083378,830459866,830466906,7040
1360409119,830502632,1,63,63,1360409091337,1360409091337,830474969,830474969,0
1360409119,830502632,1,63,63,1360409091337,1360409091337,830474969,830474969,0
1360409119,830502672,1,63,63,1360409091297,1360409091297,830474969,830474969,0
1360409212,830595720,3,189,63,1360409207087,1360409210095,830590807,830593815,3008
1360409228,830611712,2,126,63,1360409214137,1360409222201,830597849,830605913,8064
1360409689,831072460,1,46,46,1360409663343,1360409663343,831046803,831046803,0
1360411615,832998552,1,48,48,1360411587636,1360411587636,832971188,832971188,0
1360411615,832998588,1,48,48,1360411587600,1360411587600,832971188,832971188,0
1360412502,833885720,1,46,46,1360412473918,1360412473918,833857638,833857638,0
1360413620,835003116,1,46,46,1360413592458,1360413592458,834975574,834975574,0
1360414442,835825504,1,46,46,1360414417274,1360414417274,835800778,835800778,0
1360414867,836250696,1,46,46,1360414842675,1360414842675,836226371,836226371,0
1360415088,836471148,1,46,46,1360415063572,1360415063572,836446720,836446720,0
1360415152,836535344,1,46,46,1360415125328,1360415125328,836508672,836508672,0
1360415625,837008352,1,46,46,1360415600127,1360415600127,836983479,836983479,0
1360415637,837020232,1,84,84,1360415609208,1360415609208,836992440,836992440,0
1360415741,837124300,1,46,46,1360415714674,1360415714674,837097974,837097974,0
1360415745,837128364,1,46,46,1360415717940,1360415717940,837101304,837101304,0
1360416065,837448784,1,46,46,1360416040842,1360416040842,837424626,837424626,0
1360416219,837602508,1,46,46,1360416190557,1360416190557,837574065,837574065,0
1360416220,837603652,1,46,46,1360416190411,1360416190411,837574063,837574063,0
1360416815,838198864,1,46,46,1360416790509,1360416790509,838174373,838174373,0
1360417116,838499712,3,138,46,1360417091520,1360417091520,838475232,838475232,0
1360417569,838952372,1,46,46,1360417544593,1360417544593,838927965,838927965,0
1360417743,839126220,1,48,48,1360417715619,1360417715619,839098839,839098839,0
1360417744,839127372,1,48,48,1360417715468,1360417715468,839098840,839098840,0
1360417874,839256992,1,148,148,1360417847364,1360417847364,839230356,839230356,0
1360418043,839426544,1,48,48,1360418015325,1360418015325,839398869,839398869,0
1360418044,839427752,1,48,48,1360418015117,1360418015117,839398869,839398869,0
1360418095,839478640,1,46,46,1360418068093,1360418068093,839451733,839451733,0
1360418095,839478648,1,46,46,1360418068148,1360418068148,839451796,839451796,0
1360418156,839539424,1,46,46,1360418126417,1360418126417,839509841,839509841,0
1360418156,839539456,1,46,46,1360418126449,1360418126449,839509905,839509905,0
1360418178,839561300,1,46,46,1360418152463,1360418152463,839535763,839535763,0
1360418223,839606744,1,46,46,1360418194448,1360418194448,839578192,839578192,0
1360418225,839608008,1,46,46,1360418195121,1360418195121,839578129,839578129,0
1360418482,839865748,1,46,46,1360418455819,1360418455819,839839567,839839567,0
1360418792,840175100,2,92,46,1360418765517,1360418767565,840148617,840150665,2048
1360418792,840175108,2,92,46,1360418765635,1360418767683,840148743,840150791,2048
1360418947,840330476,2,122,61,1360418921235,1360418923539,840304711,840307015,2304
1360418959,840342428,2,122,61,1360418934595,1360418937091,840318023,840320519,2496
1360419500,840883112,5,250,50,1360419475124,1360419496884,840858236,840879996,21760
1360419548,840931168,1,48,48,1360419520958,1360419520958,840904126,840904126,0
1360419576,840959228,1,48,48,1360419550274,1360419550274,840933502,840933502,0
1360420409,841792788,1,46,46,1360420381573,1360420381573,841765361,841765361,0
1360420722,842105680,1,46,46,1360420694379,1360420694379,842078059,842078059,0
1360420931,842313964,1,46,46,1360420904435,1360420904435,842287399,842287399,0
1360421171,842554304,1,46,46,1360421143900,1360421143900,842527204,842527204,0
1360421444,842827352,1,46,46,1360421417513,1360421417513,842800865,842800865,0
1360421444,842827536,1,46,46,1360421416880,1360421416880,842800416,842800416,0
1360421500,842883344,1,434,434,1360421471920,1360421471920,842855264,842855264,0
1360421504,842887352,1,434,434,1360421476584,1360421476584,842859936,842859936,0
1360421660,843043744,1,46,46,1360421632095,1360421632095,843015839,843015839,0
1360421797,843180048,1,127,127,1360421771026,1360421771026,843154074,843154074,0
1360421929,843312516,1,127,127,1360421901950,1360421901950,843285466,843285466,0
1360421941,843324452,1,46,46,1360421914621,1360421914621,843298073,843298073,0
1360425149,846532860,1,46,46,1360425120439,1360425120439,846504299,846504299,0
1360425149,846532868,1,46,46,1360425120495,1360425120495,846504363,846504363,0
1360425548,846931268,1,48,48,1360425521344,1360425521344,846904612,846904612,0
1360426101,847484384,1,46,46,1360426074691,1360426074691,847458075,847458075,0
1360426511,847894436,1,46,46,1360426483850,1360426483850,847867286,847867286,0
1360426511,847894444,1,46,46,1360426483904,1360426483904,847867348,847867348,0
1360426558,847941408,5,250,50,1360426530339,1360426552611,847913747,847936019,22272
1360426602,847985592,1,48,48,1360426576877,1360426576877,847960469,847960469,0
1360426634,848017592,1,48,48,1360426606188,1360426606188,847989780,847989780,0
1360427625,849008236,1,60,60,1360427598080,1360427598080,848981316,848981316,0
1360427629,849012452,1,60,60,1360427604455,1360427604455,848987907,848987907,0
1360427637,849020272,1,60,60,1360427609500,1360427609500,848992772,848992772,0
1360427641,849024336,1,60,60,1360427615518,1360427615518,848998854,848998854,0
1360427683,849066444,2,106,53,1360427660783,1360427675375,849044227,849058819,14592
1360427897,849280548,2,120,60,1360427870915,1360427873923,849254463,849257471,3008
1360428114,849497100,2,120,60,1360428087232,1360428090240,849470332,849473340,3008
1360428595,849978448,1,46,46,1360428570653,1360428570653,849954101,849954101,0
1360429381,850764760,1,46,46,1360429353752,1360429353752,850737512,850737512,0
1360429740,851122956,1,46,46,1360429713272,1360429713272,851096228,851096228,0
1360429741,851124208,1,46,46,1360429713084,1360429713084,851096292,851096292,0
1360429995,851377992,2,122,61,1360429968015,1360429970191,851351007,851353183,2176
1360430259,851642776,1,48,48,1360430232124,1360430232124,851615900,851615900,0
1360432137,853519916,1,46,46,1360432110651,1360432110651,853493567,853493567,0
1360432137,853520564,1,46,46,1360432109937,1360432109937,853493501,853493501,0
1360433045,854428696,1,60,60,1360433017825,1360433017825,854401521,854401521,0
1360433057,854440756,1,60,60,1360433030054,1360433030054,854413810,854413810,0
1360433542,854925436,1,46,46,1360433516254,1360433516254,854899690,854899690,0
1360433887,855270348,1,46,46,1360433860786,1360433860786,855244134,855244134,0
1360433939,855322772,2,120,60,1360433910983,1360433913991,855294755,855297763,3008
1360434152,855535268,2,120,60,1360434127422,1360434130430,855510690,855513698,3008
1360434754,856137096,1,46,46,1360434726558,1360434726558,856109654,856109654,0
1360434788,856171448,1,46,46,1360434760189,1360434760189,856143637,856143637,0
1360434788,856171468,1,46,46,1360434760233,1360434760233,856143701,856143701,0
1360435287,856670760,2,122,61,1360435260287,1360435260287,856644047,856644047,0
1360435453,3790116416,1,46,46,1360435425744,1360435425744,3790089160,3790089160,0
1360435964,857347576,1,46,46,1360435937131,1360435937131,857320707,857320707,0
1360436081,857464052,1,56,56,1360436053366,1360436053366,857436418,857436418,0
1360436156,857538892,1,46,46,1360436126615,1360436126615,857509507,857509507,0
1360436156,857538896,1,46,46,1360436126672,1360436126672,857509568,857509568,0
1360437556,858939544,1,46,46,1360437526901,1360437526901,858910445,858910445,0
1360437584,858966928,1,46,46,1360437558428,1360437558428,858941356,858941356,0
1360438420,859803848,1,46,46,1360438393081,1360438393081,859776929,859776929,0
1360439133,860516212,1,46,46,1360439104295,1360439104295,860487507,860487507,0
1360440121,861504248,5,2486,497.2,1360440096568,1360440117752,861479816,861501000,21184
1360441764,863146888,1,46,46,1360441736134,1360441736134,863119022,863119022,0
1360443058,864441068,1,46,46,1360443030204,1360443030204,864413272,864413272,0
1360445491,866873844,1,48,48,1360445462968,1360445462968,866845812,866845812,0
1360446133,867516024,1,46,46,1360446104699,1360446104699,867487723,867487723,0
1360446296,867678972,5,250,50,1360446271661,1360446293741,867654633,867676713,22080
1360446344,867727224,1,48,48,1360446317615,1360446317615,867700839,867700839,0
1360446372,867755188,1,48,48,1360446346707,1360446346707,867729895,867729895,0
1360447769,869152212,1,46,46,1360447741095,1360447741095,869124307,869124307,0
1360449242,870625412,5,250,50,1360449215945,1360449237769,870599357,870621181,21824
1360449358,870741660,1,46,46,1360449331857,1360449331857,870715517,870715517,0
1360458286,879669556,1,48,48,1360458257651,1360458257651,879641207,879641207,0
1360459593,880976012,1,46,46,1360459563324,1360459563324,880946336,880946336,0
1360459681,881064464,1,46,46,1360459653626,1360459653626,881037090,881037090,0
1360460146,881529420,1,46,46,1360460118430,1360460118430,881501850,881501850,0
1360460761,882144156,1,95,95,1360460733980,1360460733980,882117136,882117136,0
1360461002,882384960,4,244,61,1360460977308,1360460987612,882360268,882370572,10304
1360461102,882484956,4,244,61,1360461074208,1360461084640,882457164,882467596,10432
1360461370,882753188,4,244,61,1360461342578,1360461352498,882725766,882735686,9920
1360461871,883253956,31,36943,1191.709677,1360461869907,1360461870355,883252863,883253311,448
1360461871,883253956,2,346,173,1360461869971,1360461870227,883252927,883253183,256
1360461876,883259472,14,18440,1317.142857,1360461869905,1360461870225,883253377,883253697,320
1360461902,883285268,15,6289,419.2666667,1360461874137,1360461895705,883257405,883278973,21568
1360461902,883285352,18,6801,377.8333333,1360461884229,1360461896581,883267581,883279933,12352
1360461902,883285360,12,999,83.25,1360461884607,1360461895551,883267967,883278911,10944
1360461902,883285376,12,999,83.25,1360461884910,1360461895534,883268286,883278910,10624
1360461907,883290004,1,52,52,1360461880611,1360461880611,883263615,883263615,0
1360461916,883299752,15,6571,438.0666667,1360461915192,1360461915640,883298944,883299392,448
1360461924,883307780,15,6184,412.2666667,1360461915868,1360461922588,883299648,883306368,6720
1360461924,883307780,16,8511,531.9375,1360461915932,1360461916316,883299712,883300096,384
1360461932,883315756,15,3624,241.6,1360461916212,1360461927220,883299968,883310976,11008
1360461940,883323740,10,5854,585.4,1360461918916,1360461933124,883302656,883316864,14208
1360461948,883331752,5,1240,248,1360461940599,1360461940855,883324351,883324607,256
1360461948,883331752,15,6184,412.2666667,1360461939125,1360461940917,883322877,883324669,1792
1360461948,883331784,5,1375,275,1360461941397,1360461941589,883325181,883325373,192
1360461949,883331824,20,25257,1262.85,1360461941846,1360461942102,883324670,883324926,256
1360461956,883339744,4,399,99.75,1360461938941,1360461948669,883322685,883332413,9728
1360461956,883339780,5,3096,619.2,1360461937049,1360461948569,883320829,883332349,11520
1360461957,883339820,5,714,142.8,1360461937628,1360461949916,883320448,883332736,12288
1360461957,883339820,16,8327,520.4375,1360461938073,1360461949593,883320893,883332413,11520
1360462069,883451860,14,6484,463.1428571,1360462062961,1360462066993,883445821,883449853,4032
1360462069,883451880,5,1413,282.6,1360462067035,1360462068443,883449915,883451323,1408
1360462069,883451944,17,6670,392.3529412,1360462062877,1360462066973,883445821,883449917,4096
1360462069,883451948,6,3014,502.3333333,1360462067033,1360462067353,883449981,883450301,320
1360462087,883470488,1,64,64,1360462062140,1360462062140,883445628,883445628,0
1360462087,3816750200,6,1556,259.3333333,1360462060505,1360462081177,3816723705,3816744377,20672
1360462087,883470536,1,64,64,1360462062220,1360462062220,883445756,883445756,0
1360463061,884443892,1,46,46,1360463033216,1360463033216,884416108,884416108,0
1360464328,885711312,1,46,46,1360464302796,1360464302796,885686108,885686108,0
1360464736,886118928,1,46,46,1360464708998,1360464708998,886091926,886091926,0
1360465036,886419296,1,46,46,1360465008974,1360465008974,886392270,886392270,0
1360465036,886419452,1,46,46,1360465009971,1360465009971,886393423,886393423,0
1360465326,886709128,1,46,46,1360465298228,1360465298228,886681356,886681356,0
1360465557,886940188,1,78,78,1360465530229,1360465530229,886913417,886913417,0
1360466803,888186448,1,448,448,1360466776797,1360466776797,888160245,888160245,0
1360467150,888532888,1,46,46,1360467124295,1360467124295,888507183,888507183,0
1360467848,889231092,1,46,46,1360467820785,1360467820785,889203877,889203877,0
1360468937,3823600176,1,95,95,1360468910432,1360468910432,3823573608,3823573608,0
1360469238,3823900560,3,174,58,1360469212042,1360469221898,3823874602,3823884458,9856
1360469238,3823900584,3,152,50.66666667,1360469212016,1360469220976,3823874600,3823883560,8960
1360469666,3824329144,3,174,58,1360469641411,1360469650819,3824304555,3824313963,9408
1360469666,3824329168,3,152,50.66666667,1360469641388,1360469650412,3824304556,3824313580,9024
1360469922,891305768,1,440,440,1360469896686,1360469896686,891280454,891280454,0
1360470007,3824669628,3,174,58,1360469979915,1360469989451,3824642543,3824652079,9536
1360470007,3824669652,3,152,50.66666667,1360469979891,1360469988915,3824642543,3824651567,9024
1360471254,892636856,1,46,46,1360471225644,1360471225644,892608500,892608500,0
1360471747,893130440,1,46,46,1360471721562,1360471721562,893105002,893105002,0
1360471888,893270780,1,46,46,1360471859885,1360471859885,893242665,893242665,0
1360471907,893290456,1,443,443,1360471881160,1360471881160,893264616,893264616,0
1360474034,895417224,1,60,60,1360474005969,1360474005969,895389193,895389193,0
1360474160,895543100,1,46,46,1360474131788,1360474131788,895514888,895514888,0
1360475114,896497288,1,46,46,1360475086977,1360475086977,896470265,896470265,0
1360475166,896549476,1,46,46,1360475139460,1360475139460,896522936,896522936,0
1360476100,897483424,1,46,46,1360476073963,1360476073963,897457387,897457387,0
1360476855,898237948,1,46,46,1360476827451,1360476827451,898210399,898210399,0
1360477418,898801840,1,46,46,1360477389751,1360477389751,898773591,898773591,0
1360477934,899317552,1,46,46,1360477907856,1360477907856,899291408,899291408,0
1360479480,900862920,1,46,46,1360479450158,1360479450158,900833078,900833078,0
1360481174,902557344,1,46,46,1360481148078,1360481148078,902531422,902531422,0
1360481526,902909384,1,71,71,1360481499648,1360481499648,902883032,902883032,0
1360482524,903907532,1,447,447,1360482498653,1360482498653,903882185,903882185,0
1360482540,903923548,1,46,46,1360482515534,1360482515534,903899082,903899082,0
1360482871,904253936,1,46,46,1360482842735,1360482842735,904225671,904225671,0
1360482937,904319860,1,60,60,1360482911542,1360482911542,904294402,904294402,0
1360483327,904710036,1,46,46,1360483300353,1360483300353,904683389,904683389,0
1360484349,905732028,1,46,46,1360484320378,1360484320378,905703406,905703406,0
1360484684,906066948,1,46,46,1360484657221,1360484657221,906040169,906040169,0
1360485461,906844292,1,46,46,1360485435937,1360485435937,906819229,906819229,0
1360485889,907272372,1,60,60,1360485861197,1360485861197,907244569,907244569,0
1360486202,907585084,1,46,46,1360486174504,1360486174504,907557588,907557588,0
1360487050,908432884,1,48,48,1360487019939,1360487019939,908402823,908402823,0
1360487898,909280816,1,46,46,1360487871962,1360487871962,909254778,909254778,0
1360488206,909589128,1,46,46,1360488178012,1360488178012,909561140,909561140,0
1360489790,911172968,5,250,50,1360489765733,1360489787173,911148701,911170141,21440
1360489838,911221036,1,48,48,1360489811106,1360489811106,911194142,911194142,0
1360489866,911249276,1,48,48,1360489840814,1360489840814,911224090,911224090,0
1360490903,912285700,1,48,48,1360490876383,1360490876383,912259083,912259083,0
1360492119,913501772,1,447,447,1360492093448,1360492093448,913476220,913476220,0
1360492163,913545928,1,46,46,1360492138220,1360492138220,913521148,913521148,0
1360492949,914332064,2,92,46,1360492923671,1360492928663,914306735,914311727,4992
1360492949,914332064,2,120,60,1360492923671,1360492928663,914306735,914311727,4992
1360492949,914332104,3,144,48,1360492923629,1360492932589,914306733,914315693,8960
1360492949,914332104,2,156,78,1360492923629,1360492928621,914306733,914311725,4992
1360492961,914344044,2,156,78,1360492933673,1360492938729,914316717,914321773,5056
1360492961,914344088,2,92,46,1360492933630,1360492938686,914316718,914321774,5056
1360492961,914344088,2,120,60,1360492933630,1360492938686,914316718,914321774,5056
1360492969,914352076,1,46,46,1360492943627,1360492943627,914326703,914326703,0
1360492969,914352076,1,60,60,1360492943627,1360492943627,914326703,914326703,0
1360492969,914352112,1,78,78,1360492943590,1360492943590,914326702,914326702,0
1360493446,914828752,1,46,46,1360493419464,1360493419464,914802216,914802216,0
1360493899,915282132,1,60,60,1360493874882,1360493874882,915258014,915258014,0
1360494003,915386156,1,46,46,1360493977449,1360493977449,915360605,915360605,0
1360495361,916744316,2,106,53,1360495338295,1360495356215,916721611,916739531,17920
1360495510,916892936,1,439,439,1360495484206,1360495484206,916867142,916867142,0
1360498011,919393928,15,6289,419.2666667,1360497996884,1360498008980,919379812,919391908,12096
1360498011,919393928,12,999,83.25,1360497997585,1360498008913,919380513,919391841,11328
1360498011,919393932,11,953,86.63636364,1360497997839,1360498008911,919380771,919391843,11072
1360498011,919393940,12,999,83.25,1360497997253,1360498008901,919380193,919391841,11648
1360498040,919423184,2,152,76,1360498012880,1360498027920,919396064,919411104,15040
1360498068,919451240,2,152,76,1360498042906,1360498057882,919426146,919441122,14976
1360498100,919483232,1,76,76,1360498072991,1360498072991,919456223,919456223,0
1360498196,919579320,2,152,76,1360498169927,1360498184967,919553247,919568287,15040
1360498228,919611332,2,152,76,1360498200060,1360498215100,919583392,919598432,15040
1360498256,919639600,1,76,76,1360498229871,1360498229871,919613471,919613471,0
1360498747,920130324,6,2581,430.1666667,1360498731131,1360498743035,920114455,920126359,11904
1360499824,921206912,12,6151,512.5833333,1360499799494,1360499799878,921182406,921182790,384
1360499828,921210852,9,861,95.66666667,1360499800003,1360499800195,921182855,921183047,192
1360499828,921210852,9,861,95.66666667,1360499800258,1360499800450,921183110,921183302,192
1360499828,921210868,9,861,95.66666667,1360499800498,1360499800690,921183366,921183558,192
1360499844,921227112,2,92,46,1360499843902,1360499843902,921227014,921227014,0
1360499844,921227124,2,92,46,1360499843890,1360499843890,921227014,921227014,0
1360499852,921235088,3,138,46,1360499843992,1360499844056,921227080,921227144,64
1360499852,921235100,4,184,46,1360499843916,1360499844364,921227016,921227464,448
1360499860,921243128,11,953,86.63636364,1360499846574,1360499857966,921229702,921241094,11392
1360499860,921243140,16,6372,398.25,1360499845920,1360499858016,921229060,921241156,12096
1360499860,921243140,12,999,83.25,1360499846307,1360499858019,921229447,921241159,11712
1360499860,921243140,12,999,83.25,1360499846819,1360499857955,921229959,921241095,11136
1360499872,921254864,1,46,46,1360499844212,1360499844212,921227076,921227076,0
1360499872,921254904,1,46,46,1360499844172,1360499844172,921227076,921227076,0
1360499996,921379188,11,953,86.63636364,1360499977776,1360499989616,921360964,921372804,11840
1360499996,921379188,12,999,83.25,1360499978032,1360499989616,921361220,921372804,11584
1360499996,921379188,11,953,86.63636364,1360499978287,1360499989551,921361475,921372739,11264
1360499996,921379200,11,953,86.63636364,1360499977509,1360499989605,921360709,921372805,12096
1360500156,921539520,11,953,86.63636364,1360500142050,1360500153762,921525570,921537282,11712
1360500156,921539520,12,999,83.25,1360500142561,1360500153697,921526081,921537217,11136
1360500156,921539528,17,6418,377.5294118,1360500141656,1360500153752,921525184,921537280,12096
1360500156,921539532,12,999,83.25,1360500142295,1360500153687,921525827,921537219,11392
1360500180,921563612,12,999,83.25,1360500165126,1360500177222,921548738,921560834,12096
1360500180,921563612,12,999,83.25,1360500165380,1360500177220,921548992,921560832,11840
1360500180,921563616,11,953,86.63636364,1360500165890,1360500177154,921549506,921560770,11264
1360500181,921563672,11,953,86.63636364,1360500166579,1360500178163,921549251,921560835,11584
1360500229,921611800,8,815,101.875,1360500201714,1360500201842,921584514,921584642,128
1360500229,921611800,8,815,101.875,1360500201968,1360500202096,921584768,921584896,128
1360500229,921611800,8,815,101.875,1360500202223,1360500202415,921585023,921585215,192
1360500229,921611840,8,815,101.875,1360500202440,1360500202632,921585280,921585472,192
1360500429,921811872,2,126,63,1360500427239,1360500428263,921810111,921811135,1024
1360500437,921819840,2,126,63,1360500430278,1360500434310,921813118,921817150,4032
1360500437,921819840,2,126,63,1360500434628,1360500435652,921817468,921818492,1024
1360500437,921819844,3,189,63,1360500431874,1360500434882,921814718,921817726,3008
1360500437,921819848,4,252,63,1360500429118,1360500436158,921811966,921819006,7040
1360500445,921827860,2,126,63,1360500437682,1360500441650,921820542,921824510,3968
1360500453,921835880,2,126,63,1360500438876,1360500446940,921821756,921829820,8064
1360500469,921852316,1,63,63,1360500441895,1360500441895,921825211,921825211,0
1360500469,921852328,1,63,63,1360500443739,1360500443739,921827067,921827067,0
1360500477,921860324,1,63,63,1360500449248,1360500449248,921832572,921832572,0
1360500549,921931924,6,3996,666,1360500540078,1360500546222,921923002,921929146,6144
1360500549,921931932,6,3996,666,1360500546218,1360500547370,921929150,921930302,1152
1360500549,921931932,7,2448,349.7142857,1360500543208,1360500543464,921926140,921926396,256
1360500553,3855216008,19,21947,1155.105263,1360500540951,1360500552919,3855203959,3855215927,11968
1360500557,921939924,12,999,83.25,1360500543215,1360500551407,921926139,921934331,8192
1360500557,921939924,12,999,83.25,1360500543726,1360500551406,921926650,921934330,7680
1360500557,921939928,15,6289,419.2666667,1360500539372,1360500551468,921922300,921934396,12096
1360500557,921939936,15,6289,419.2666667,1360500541794,1360500551394,921924730,921934330,9600
1360500557,921939936,23,14767,642.0434783,1360500542181,1360500553445,921925117,921936381,11264
1360500565,921947928,7,1434,204.8571429,1360500547436,1360500557932,921930364,921940860,10496
1360500565,921947928,143,199193,1392.958042,1360500548266,1360500563946,921931194,921946874,15680
1360500565,921947936,19,5817,306.1578947,1360500546212,1360500564004,921929148,921946940,17792
1360500669,922051944,4,377,94.25,1360500664601,1360500664793,922047545,922047737,192
1360500677,922059964,14,5062,361.5714286,1360500664775,1360500676615,922047739,922059579,11840
1360500741,922124096,6,3996,666,1360500735553,1360500735809,922118649,922118905,256
1360500749,922132100,11,4638,421.6363636,1360500735805,1360500741053,922118905,922124153,5248
1360501297,3855960216,8,7208,901,1360501282510,1360501294478,3855945726,3855957694,11968
1360501297,3855960220,9,7809,867.6666667,1360501282506,1360501294474,3855945726,3855957694,11968
1360501301,922684392,14,6021,430.0714286,1360501282640,1360501294736,922666032,922678128,12096
1360501344,922726892,1,46,46,1360501318981,1360501318981,922701873,922701873,0
1360501965,923348660,1,46,46,1360501937467,1360501937467,923321127,923321127,0
1360502363,923745896,1,46,46,1360502335410,1360502335410,923718306,923718306,0
1360502375,923757860,12,6151,512.5833333,1360502348373,1360502348885,923731233,923731745,512
1360502375,923757864,9,861,95.66666667,1360502348944,1360502349136,923731808,923732000,192
1360502375,923757904,9,861,95.66666667,1360502349225,1360502349353,923732129,923732257,128
1360502375,923757904,8,815,101.875,1360502349479,1360502349607,923732383,923732511,128
1360502534,923917084,3,138,46,1360502533684,1360502533748,923916768,923916832,64
1360502534,923917092,3,138,46,1360502533675,1360502533739,923916767,923916831,64
1360502534,923917092,3,138,46,1360502533675,1360502533739,923916767,923916831,64
1360502534,923917092,3,138,46,1360502533611,1360502533675,923916703,923916767,64
1360502550,923933080,12,999,83.25,1360502535287,1360502547127,923918367,923930207,11840
1360502550,923933080,12,999,83.25,1360502535607,1360502547127,923918687,923930207,11520
1360502550,923933080,11,953,86.63636364,1360502535861,1360502547125,923918941,923930205,11264
1360502550,923933108,11,953,86.63636364,1360502535000,1360502547096,923918108,923930204,12096
1360502772,924155028,9,861,95.66666667,1360502747621,1360502747749,924130649,924130777,128
1360502772,924155032,13,6234,479.5384615,1360502747172,1360502747492,924130204,924130524,320
1360502776,924158944,8,815,101.875,1360502747961,1360502748153,924130905,924131097,192
1360502776,924158948,9,861,95.66666667,1360502748213,1360502748405,924131161,924131353,192
1360502958,924341236,4,252,63,1360502949715,1360502956819,924332951,924340055,7104
1360502990,924373264,2,126,63,1360502987385,1360502988409,924370649,924371673,1024
1360502993,924375672,1,63,63,1360502965383,1360502965383,924348055,924348055,0
1360502998,924381280,2,126,63,1360502990373,1360502994405,924373653,924377685,4032
1360503029,924411700,1,63,63,1360503003052,1360503003052,924385752,924385752,0
1360503073,924455776,1,60,60,1360503047261,1360503047261,924430037,924430037,0
1360503077,924459788,1,60,60,1360503052242,1360503052242,924435030,924435030,0
1360503078,924461340,3,189,63,1360503072809,1360503075881,924456149,924459221,3072
1360503078,924461340,3,189,63,1360503072873,1360503075881,924456213,924459221,3008
1360503094,924477336,2,126,63,1360503079917,1360503087981,924463253,924471317,8064
1360503094,924477372,2,126,63,1360503079883,1360503087947,924463255,924471319,8064
1360503762,925145644,2,104,52,1360503737583,1360503740527,925121227,925124171,2944
1360505190,926572948,1,60,60,1360505165202,1360505165202,926548150,926548150,0
1360505467,926849668,2,120,60,1360505442021,1360505445029,926824689,926827697,3008
1360506161,927544488,1,46,46,1360506132328,1360506132328,927515816,927515816,0
1360509266,930648856,1,74,74,1360509238768,1360509238768,930621624,930621624,0
1360512613,933996480,1,46,46,1360512588558,1360512588558,933972038,933972038,0
1360513307,934689684,1,46,46,1360513279264,1360513279264,934661948,934661948,0
1360515338,936721112,42,54179,1289.97619,1360515334673,1360515335697,936717785,936718809,1024
1360516248,937630992,1,46,46,1360516223294,1360516223294,937606286,937606286,0
1360517269,938652376,3,152,50.66666667,1360517242351,1360517251375,938625727,938634751,9024
1360517693,939075712,1,46,46,1360517664576,1360517664576,939047288,939047288,0
1360517839,939221956,1,46,46,1360517812234,1360517812234,939195190,939195190,0
1360517839,939221960,1,46,46,1360517812549,1360517812549,939195509,939195509,0
1360518304,939687072,1,445,445,1360518278669,1360518278669,939661741,939661741,0
1360518969,940352368,2,120,60,1360518943197,1360518946205,940326565,940329573,3008
1360519623,941005656,1,48,48,1360519596952,1360519596952,940979608,940979608,0
1360519731,941113888,2,96,48,1360519705072,1360519707952,941087960,941090840,2880
1360520674,942056648,2,96,48,1360520646865,1360520650065,942029513,942032713,3200
1360520778,942160944,2,96,48,1360520752295,1360520755239,942135239,942138183,2944
1360521013,942396464,1,48,48,1360520984989,1360520984989,942368453,942368453,0
1360521557,942940384,1,46,46,1360521528354,1360521528354,942911738,942911738,0
1360523818,945201212,1,48,48,1360523788976,1360523788976,945172188,945172188,0
1360526564,947946924,1,60,60,1360526535906,1360526535906,947918830,947918830,0
1360527927,949310476,3,138,46,1360527901479,1360527910503,949284955,949293979,9024
1360528072,949454792,2,96,48,1360528045138,1360528048018,949427930,949430810,2880
1360528761,950143996,1,46,46,1360528736634,1360528736634,950119630,950119630,0
1360528932,950315036,2,92,46,1360528926478,1360528931790,950309514,950314826,5312
1360529006,950389064,1,46,46,1360528980465,1360528980465,950363529,950363529,0
1360529113,950496420,2,96,48,1360529084943,1360529087951,950468363,950471371,3008
1360529202,950584852,1,46,46,1360529176965,1360529176965,950559817,950559817,0
1360529202,950584856,1,46,46,1360529177471,1360529177471,950560327,950560327,0
1360529290,950672904,2,96,48,1360529264976,1360529267920,950647880,950650824,2944
1360530056,951438640,1,46,46,1360530029962,1360530029962,951412602,951412602,0
1360530870,952252936,1,46,46,1360530845143,1360530845143,952228079,952228079,0
1360531388,952771008,1,46,46,1360531361221,1360531361221,952744229,952744229,0
1360531411,952794044,1,46,46,1360531384481,1360531384481,952767525,952767525,0
1360532945,954328208,1,46,46,1360532917927,1360532917927,954301135,954301135,0
1360532961,954344204,1,148,148,1360532934122,1360532934122,954317326,954317326,0
1360579994,1001377184,1,95,95,1360579965944,1360579965944,1001349128,1001349128,0
1360581142,1002524580,1,439,439,1360581117825,1360581117825,1002500405,1002500405,0
1360581903,1003285484,1,48,48,1360581875862,1360581875862,1003258346,1003258346,0
1360583496,1004878628,132,189639,1436.659091,1360583488237,1360583494573,1004870865,1004877201,6336
1360583496,1004878632,44,55571,1262.977273,1360583488236,1360583489772,1004870868,1004872404,1536
1360584846,1006229072,9,861,95.66666667,1360584821726,1360584821854,1006204798,1006204926,128
1360584846,1006229124,12,6151,512.5833333,1360584821228,1360584821548,1006204352,1006204672,320
1360584850,1006233056,9,861,95.66666667,1360584821997,1360584822189,1006205053,1006205245,192
1360584850,1006233060,9,861,95.66666667,1360584822251,1360584822443,1006205311,1006205503,192
1360585097,1006479712,4,252,63,1360585088643,1360585095683,1006471355,1006478395,7040
1360585097,1006479712,3,189,63,1360585092867,1360585095875,1006475579,1006478587,3008
1360585113,1006495736,2,126,63,1360585099883,1360585107947,1006482619,1006490683,8064
1360585121,1006503712,4,252,63,1360585111938,1360585118978,1006494650,1006501690,7040
1360585131,1006513764,1,63,63,1360585103696,1360585103696,1006486460,1006486460,0
1360585151,1006534008,1,63,63,1360585126747,1360585126747,1006509755,1006509755,0
1360585241,1006623868,4,252,63,1360585232484,1360585239524,1006615352,1006622392,7040
1360585275,1006658132,1,63,63,1360585247261,1360585247261,1006630393,1006630393,0
1360585680,1007062752,1,46,46,1360585653008,1360585653008,1007035760,1007035760,0
1360586012,1007395304,1,60,60,1360585984997,1360585984997,1007368301,1007368301,0
1360586117,1007499532,1,48,48,1360586092582,1360586092582,1007475114,1007475114,0
1360586466,1007848736,11,953,86.63636364,1360586453654,1360586463894,1007836390,1007846630,10240
1360586466,1007848752,12,999,83.25,1360586453895,1360586463879,1007836647,1007846631,9984
1360586466,1007848752,12,999,83.25,1360586454151,1360586463879,1007836903,1007846631,9728
1360586649,1008032248,1,46,46,1360586623699,1360586623699,1008006947,1008006947,0
1360586927,1008310364,1,46,46,1360586900187,1360586900187,1008283551,1008283551,0
1360587042,1008425336,12,999,83.25,1360587025974,1360587036534,1008409310,1008419870,10560
1360587042,1008425336,12,999,83.25,1360587026357,1360587036469,1008409693,1008419805,10112
1360587042,1008425352,11,953,86.63636364,1360587026724,1360587036452,1008410076,1008419804,9728
1360588289,1009672248,1,46,46,1360588264315,1360588264315,1009647563,1009647563,0
1360588858,1010240844,9,861,95.66666667,1360588832392,1360588832584,1010215236,1010215428,192
1360588858,1010240844,9,861,95.66666667,1360588832645,1360588832837,1010215489,1010215681,192
1360588858,1010240848,9,861,95.66666667,1360588832963,1360588833411,1010215811,1010216259,448
1360588858,1010240892,14,6748,482,1360588831574,1360588831830,1010214466,1010214722,256
1360588858,1010240920,12,6151,512.5833333,1360588831930,1360588832250,1010214850,1010215170,320
1360589014,1010396960,1,46,46,1360588987855,1360588987855,1010370815,1010370815,0
1360589014,1010396968,1,46,46,1360588988103,1360588988103,1010371071,1010371071,0
1360589044,1010427096,2,126,63,1360589041545,1360589042505,1010424641,1010425601,960
1360589052,1010435056,2,126,63,1360589044593,1360589048625,1010427649,1010431681,4032
1360589076,1010459040,2,126,63,1360589074814,1360589075838,1010457854,1010458878,1024
1360589082,1010465228,1,63,63,1360589056513,1360589056513,1010439741,1010439741,0
1360589084,1010467020,2,126,63,1360589077908,1360589081940,1010460928,1010464960,4032
1360589108,1010490992,4,252,63,1360589099438,1360589106478,1010482430,1010489470,7040
1360589114,1010497120,1,63,63,1360589089903,1360589089903,1010473023,1010473023,0
1360589140,1010523052,3,189,63,1360589134899,1360589137907,1010517951,1010520959,3008
1360589142,1010525212,1,63,63,1360589114258,1360589114258,1010497470,1010497470,0
1360589156,1010539048,2,126,63,1360589142006,1360589150006,1010525054,1010533054,8000
1360589164,1010547076,3,189,63,1360589157400,1360589160472,1010540476,1010543548,3072
1360589180,1010563072,2,126,63,1360589164445,1360589172509,1010547517,1010555581,8064
1360589676,1011059360,11,953,86.63636364,1360589663159,1360589673207,1011046519,1011056567,10048
1360589676,1011059376,12,999,83.25,1360589662567,1360589673255,1011045943,1011056631,10688
1360589677,1011059416,12,999,83.25,1360589663846,1360589674214,1011046262,1011056630,10368
1360589776,1011159108,3,152,50.66666667,1360589751537,1360589760625,1011134645,1011143733,9088
1360589788,1011170996,9,861,95.66666667,1360589762783,1360589762911,1011145779,1011145907,128
1360589788,1011171000,8,815,101.875,1360589763292,1360589763420,1011146292,1011146420,128
1360589788,1011171072,14,6617,472.6428571,1360589762260,1360589762580,1011145332,1011145652,320
1360589788,1011171080,9,861,95.66666667,1360589762957,1360589763085,1011146037,1011146165,128
1360589956,1011339376,1,46,46,1360589930914,1360589930914,1011314290,1011314290,0
1360590045,1011427764,3,189,63,1360590039045,1360590042053,1011421809,1011424817,3008
1360590061,1011443640,3,189,63,1360590057790,1360590060862,1011440430,1011443502,3072
1360590061,1011443688,3,189,63,1360590057806,1360590060814,1011440494,1011443502,3008
1360590061,1011443688,2,126,63,1360590046160,1360590054224,1011428848,1011436912,8064
1360590077,1011459680,2,126,63,1360590064790,1360590072854,1011447470,1011455534,8064
1360590077,1011459720,2,126,63,1360590064814,1360590072878,1011447534,1011455598,8064
1360590181,1011563760,3,189,63,1360590177797,1360590180805,1011560557,1011563565,3008
1360590197,1011579796,2,126,63,1360590184804,1360590192868,1011567600,1011575664,8064
1360591214,1012596888,16,6372,398.25,1360591201848,1360591212088,1012584736,1012594976,10240
1360591214,1012596892,12,999,83.25,1360591202546,1360591212082,1012585438,1012594974,9536
1360591214,1012596928,12,999,83.25,1360591202254,1360591212046,1012585182,1012594974,9792
1360591406,1012788984,11,953,86.63636364,1360591388819,1360591400275,1012771803,1012783259,11456
1360591406,1012789012,12,999,83.25,1360591388151,1360591400375,1012771163,1012783387,12224
1360591406,1012789016,12,999,83.25,1360591388467,1360591400371,1012771483,1012783387,11904
1360591406,1012789032,16,6372,398.25,1360591387748,1360591400356,1012770780,1012783388,12608
1360591414,1012797020,15,6104,406.9333333,1360591399665,1360591411697,1012782685,1012794717,12032
1360591419,3946081860,7,4807,686.7142857,1360591399621,1360591411589,3946062481,3946074449,11968
1360591419,3946081860,8,7208,901,1360591399621,1360591411589,3946062481,3946074449,11968
1360591437,1012819976,1,46,46,1360591411484,1360591411484,1012794460,1012794460,0
1360591474,1012857044,1,46,46,1360591444886,1360591444886,1012827930,1012827930,0
1360591702,1013085064,1,46,46,1360591675582,1360591675582,1013058646,1013058646,0
1360591733,1013115980,1,60,60,1360591706964,1360591706964,1013089944,1013089944,0
1360592227,1013609428,1,46,46,1360592200501,1360592200501,1013582929,1013582929,0
1360593089,1014471496,1,60,60,1360593062817,1360593062817,1014445313,1014445313,0
1360593221,1014603748,8,815,101.875,1360593193701,1360593193893,1014576449,1014576641,192
1360593221,1014603832,12,6151,512.5833333,1360593193169,1360593193553,1014576001,1014576385,384
1360593221,1014603864,9,861,95.66666667,1360593193906,1360593194034,1014576770,1014576898,128
1360593221,1014603864,9,861,95.66666667,1360593194162,1360593194290,1014577026,1014577154,128
1360593272,1014655024,3,138,46,1360593271632,1360593271696,1014654656,1014654720,64
1360593272,1014655024,3,138,46,1360593271568,1360593271632,1014654592,1014654656,64
1360593272,1014655024,3,138,46,1360593271632,1360593271696,1014654656,1014654720,64
1360593272,1014655072,3,138,46,1360593271518,1360593271582,1014654590,1014654654,64
1360593288,1014671004,12,999,83.25,1360593274402,1360593286498,1014657406,1014669502,12096
1360593288,1014671008,11,953,86.63636364,1360593274593,1360593286433,1014657601,1014669441,11840
1360593288,1014671008,11,953,86.63636364,1360593274911,1360593286431,1014657919,1014669439,11520
1360593288,1014671084,11,953,86.63636364,1360593275093,1360593286357,1014658177,1014669441,11264
1360593432,1014815036,12,999,83.25,1360593417087,1360593428607,1014800123,1014811643,11520
1360593432,1014815036,11,953,86.63636364,1360593417346,1360593428610,1014800382,1014811646,11264
1360593432,1014815040,11,953,86.63636364,1360593416573,1360593428669,1014799613,1014811709,12096
1360593432,1014815072,12,999,83.25,1360593416796,1360593428636,1014799868,1014811708,11840
1360593792,1015175312,12,999,83.25,1360593778918,1360593790310,1015162230,1015173622,11392
1360593792,1015175352,15,6289,419.2666667,1360593778239,1360593790271,1015161591,1015173623,12032
1360593792,1015175356,12,999,83.25,1360593778620,1360593790268,1015161976,1015173624,11648
1360593793,1015175384,12,999,83.25,1360593780103,1360593791239,1015162487,1015173623,11136
1360593904,1015287368,16,6372,398.25,1360593890476,1360593902444,1015273844,1015285812,11968
1360593905,1015287396,11,953,86.63636364,1360593892410,1360593903418,1015274806,1015285814,11008
1360593905,1015287436,12,999,83.25,1360593891858,1360593903378,1015274294,1015285814,11520
1360593905,1015287440,12,999,83.25,1360593892111,1360593903375,1015274551,1015285815,11264
1360593918,1015301072,1,60,60,1360593892630,1360593892630,1015275702,1015275702,0
1360595397,1016779392,1,443,443,1360595372008,1360595372008,1016754400,1016754400,0
1360595593,1016975960,1,46,46,1360595566252,1360595566252,1016949212,1016949212,0
1360596171,1017553732,2,122,61,1360596143753,1360596143817,1017526485,1017526549,64
1360596776,1018158724,1,71,71,1360596750214,1360596750214,1018132938,1018132938,0
1360597237,1018619784,3,399,133,1360597223045,1360597235013,1018605829,1018617797,11968
1360597261,1018643852,15,6184,412.2666667,1360597253759,1360597254271,1018636611,1018637123,512
1360597269,1018651848,12,695,57.91666667,1360597263493,1360597268229,1018646341,1018651077,4736
1360597269,1018651852,5,716,143.2,1360597251201,1360597263169,1018634053,1018646021,11968
1360597269,1018651856,13,10320,793.8461538,1360597251450,1360597263930,1018634306,1018646786,12480
1360597269,1018651884,15,6184,412.2666667,1360597265377,1360597266209,1018648261,1018649093,832
1360597269,1018651892,15,6196,413.0666667,1360597262807,1360597265367,1018645699,1018648259,2560
1360597277,1018659608,15,11554,770.2666667,1360597251766,1360597269302,1018634374,1018651910,17536
1360597277,1018660168,15,6184,412.2666667,1360597270019,1360597270531,1018653187,1018653699,512
1360597277,1018660172,17,7247,426.2941176,1360597265921,1360597270017,1018649093,1018653189,4096
1360597277,1018660208,32,40902,1278.1875,1360597256284,1360597268700,1018639492,1018651908,12416
1360597285,1018667540,1,60,60,1360597256951,1360597256951,1018639491,1018639491,0
1360597297,1018679604,2,235,117.5,1360597271478,1360597271670,1018654082,1018654274,192
1360597605,1018988220,1,46,46,1360597577611,1360597577611,1018960831,1018960831,0
1360597702,1019084608,10,3717,371.7,1360597686382,1360597698350,1019068990,1019080958,11968
1360597702,1019084612,12,999,83.25,1360597682856,1360597695464,1019065468,1019078076,12608
1360597702,1019084640,11,953,86.63636364,1360597683406,1360597695886,1019066046,1019078526,12480
1360597702,1019084644,12,999,83.25,1360597683656,1360597695432,1019066300,1019078076,11776
1360597702,1019084688,12,999,83.25,1360597683099,1360597695387,1019065787,1019078075,12288
1360597822,1019204848,12,999,83.25,1360597807547,1360597819579,1019190395,1019202427,12032
1360597822,1019204912,14,4789,342.0714286,1360597807099,1360597819515,1019190011,1019202427,12416
1360597822,1019204916,13,1045,80.38461538,1360597807799,1360597819447,1019190715,1019202363,11648
1360597822,1019204916,15,4835,322.3333333,1360597808118,1360597819510,1019191034,1019202426,11392
1360597834,1019216692,1,46,46,1360597809237,1360597809237,1019191929,1019191929,0
1360598278,1019661164,9,861,95.66666667,1360598252855,1360598253175,1019636019,1019636339,320
1360598278,1019661244,12,4697,391.4166667,1360598251688,1360598252008,1019634932,1019635252,320
1360598278,1019661268,8,815,101.875,1360598252114,1360598252306,1019635382,1019635574,192
1360598278,1019661272,9,861,95.66666667,1360598252428,1360598252620,1019635700,1019635892,192
1360598331,1019713444,1,46,46,1360598305482,1360598305482,1019687926,1019687926,0
1360598359,1019741792,3,138,46,1360598358569,1360598358697,1019741361,1019741489,128
1360598359,1019741796,3,138,46,1360598358569,1360598358633,1019741365,1019741429,64
1360598359,1019741796,3,138,46,1360598358569,1360598358697,1019741365,1019741493,128
1360598359,1019741876,3,138,46,1360598358489,1360598358617,1019741365,1019741493,128
1360598386,1019769332,9,861,95.66666667,1360598359696,1360598360016,1019743028,1019743348,320
1360598387,1019769412,8,815,101.875,1360598359656,1360598359848,1019742068,1019742260,192
1360598387,1019769416,10,1023,102.3,1360598359972,1360598360484,1019742388,1019742900,512
1360598387,1019769452,8,815,101.875,1360598361085,1360598361277,1019743537,1019743729,192
1360598591,1019974064,3,189,63,1360598584407,1360598587479,1019967471,1019970543,3072
1360598591,1019974180,4,252,63,1360598582181,1360598589221,1019965361,1019972401,7040
1360598607,1019990172,2,126,63,1360598591341,1360598599405,1019974513,1019982577,8064
1360598615,1019998364,2,126,63,1360598612652,1360598613676,1019996016,1019997040,1024
1360598623,1020006160,1,63,63,1360598597302,1360598597302,1019980462,1019980462,0
1360598624,1020006424,2,126,63,1360598616665,1360598620633,1019999089,1020003057,3968
1360598655,1020038040,1,63,63,1360598628077,1360598628077,1020011117,1020011117,0
1360598704,1020086476,4,252,63,1360598696484,1360598703524,1020078960,1020086000,7040
1360598739,1020122232,1,63,63,1360598710830,1360598710830,1020094062,1020094062,0
1360599474,1020856864,2,92,46,1360599470353,1360599470353,1020853217,1020853217,0
1360599474,1020856864,2,92,46,1360599470353,1360599470353,1020853217,1020853217,0
1360599474,1020856948,2,92,46,1360599470272,1360599470272,1020853220,1020853220,0
1360599474,1020856948,2,92,46,1360599470272,1360599470272,1020853220,1020853220,0
1360599490,1020872936,11,953,86.63636364,1360599472136,1360599482824,1020855072,1020865760,10688
1360599490,1020872944,12,999,83.25,1360599472770,1360599482818,1020855714,1020865762,10048
1360599490,1020872948,12,999,83.25,1360599472448,1360599482816,1020855396,1020865764,10368
1360599490,1020873020,14,4789,342.0714286,1360599471605,1360599482933,1020854625,1020865953,11328
1360600192,1021574768,2,96,48,1360600166057,1360600169001,1021548825,1021551769,2944
1360600371,1021754200,14,4789,342.0714286,1360600355701,1360600367733,1021738901,1021750933,12032
1360600371,1021754204,11,953,86.63636364,1360600357616,1360600367664,1021740820,1021750868,10048
1360600371,1021754288,14,4789,342.0714286,1360600356829,1360600367581,1021740117,1021750869,10752
1360600371,1021754292,12,999,83.25,1360600357273,1360600367577,1021740565,1021750869,10304
1360600384,1021767332,1,46,46,1360600356400,1360600356400,1021739732,1021739732,0
1360600465,1021847412,11,3267,297,1360600437767,1360600438343,1021820179,1021820755,576
1360600465,1021847648,9,861,95.66666667,1360600440476,1360600440668,1021823124,1021823316,192
1360600469,1021851396,13,1045,80.38461538,1360600441048,1360600468760,1021823444,1021851156,27712
1360600469,1021851400,14,1091,77.92857143,1360600441298,1360600468690,1021823698,1021851090,27392
1360600469,1021851428,13,1045,80.38461538,1360600441593,1360600467833,1021824021,1021850261,26240
1360600475,1021858208,10,460,46,1360600466922,1360600473962,1021850130,1021857170,7040
1360600475,1021858212,5,230,46,1360600468069,1360600473957,1021851281,1021857169,5888
1360600475,1021858284,6,276,46,1360600468318,1360600473886,1021851602,1021857170,5568
1360600510,1021892660,1,48,48,1360600502029,1360600502029,1021884689,1021884689,0
1360600516,1021899040,3,193,64.33333333,1360600511249,1360600511249,1021894289,1021894289,0
1360600613,1021995776,7,769,109.8571429,1360600588443,1360600591899,1021971219,1021974675,3456
1360600617,1022000024,12,2347,195.5833333,1360600592291,1360600607779,1021975315,1021990803,15488
1360600649,1022032056,1,383,383,1360600623873,1360600623873,1022006929,1022006929,0
1360600681,1022064152,1,383,383,1360600655904,1360600655904,1022039056,1022039056,0
1360600745,1022128240,1,383,383,1360600720134,1360600720134,1022103374,1022103374,0
1360600885,1022267368,4,235,58.75,1360600880172,1360600884140,1022262540,1022266508,3968
1360600901,1022283532,2,126,63,1360600889227,1360600899659,1022271759,1022282191,10432
1360601295,1022677840,13,6234,479.5384615,1360601270736,1360601270992,1022653576,1022653832,256
1360601299,1022681832,9,861,95.66666667,1360601271637,1360601271829,1022654469,1022654661,192
1360601299,1022681944,9,861,95.66666667,1360601271017,1360601271145,1022653961,1022654089,128
1360601299,1022681948,8,815,101.875,1360601271268,1360601271460,1022654216,1022654408,192
1360601469,1022852000,3,189,63,1360601463723,1360601466731,1022846723,1022849731,3008
1360601477,1022860028,3,189,63,1360601470863,1360601473871,1022853891,1022856899,3008
1360601485,1022868128,2,126,63,1360601470636,1360601478700,1022853764,1022861828,8064
1360601493,1022876044,2,126,63,1360601477887,1360601485951,1022860931,1022868995,8064
1360601556,1022938432,4,202,50.5,1360601531874,1360601552866,1022914306,1022935298,20992
1360601597,1022980236,3,189,63,1360601593661,1360601596669,1022976897,1022979905,3008
1360601597,1022980316,3,189,63,1360601593520,1360601596528,1022976836,1022979844,3008
1360601604,1022986892,1,48,48,1360601576470,1360601576470,1022959362,1022959362,0
1360601613,1022996192,2,126,63,1360601600747,1360601608811,1022983939,1022992003,8064
1360601613,1022996268,2,126,63,1360601600607,1360601608671,1022983875,1022991939,8064
1360601632,1023014812,1,48,48,1360601605732,1360601605732,1022988544,1022988544,0
1360602142,1023524592,11,953,86.63636364,1360602124283,1360602134459,1023506875,1023517051,10176
1360602142,1023524692,11,953,86.63636364,1360602124759,1360602134359,1023507451,1023517051,9600
1360602142,1023524692,11,953,86.63636364,1360602124439,1360602134359,1023507131,1023517051,9920
1360602169,1023551948,13,6234,479.5384615,1360602142487,1360602142743,1023525435,1023525691,256
1360602169,1023551976,8,815,101.875,1360602142843,1360602142971,1023525819,1023525947,128
1360602169,1023551980,9,861,95.66666667,1360602143094,1360602143286,1023526074,1023526266,192
1360602169,1023551984,9,861,95.66666667,1360602143346,1360602143538,1023526330,1023526522,192
1360602358,1023740736,4,252,63,1360602350185,1360602357289,1023732921,1023740025,7104
1360602358,1023740816,4,252,63,1360602350488,1360602357528,1023733304,1023740344,7040
1360602389,1023772344,1,63,63,1360602364680,1360602364680,1023748024,1023748024,0
1360602393,1023776356,1,63,63,1360602365050,1360602365050,1023748406,1023748406,0
1360602470,1023852996,3,189,63,1360602465312,1360602468320,1023848308,1023851316,3008
1360602486,1023869052,3,189,63,1360602481577,1360602484649,1023864629,1023867701,3072
1360602486,1023869100,2,126,63,1360602472250,1360602480314,1023855350,1023863414,8064
1360602502,1023885040,2,126,63,1360602488691,1360602496691,1023871731,1023879731,8000
1360602618,1024001212,1,46,46,1360602593289,1360602593289,1023976501,1023976501,0
1360602927,1024310244,12,999,83.25,1360602915874,1360602926050,1024299118,1024309294,10176
1360602927,1024310268,11,953,86.63636364,1360602916171,1360602926027,1024299439,1024309295,9856
1360602927,1024310268,12,999,83.25,1360602916425,1360602926025,1024299693,1024309293,9600
1360603593,1024975388,12,999,83.25,1360603575538,1360603584946,1024957926,1024967334,9408
1360603593,1024975392,12,999,83.25,1360603575790,1360603584942,1024958182,1024967334,9152
1360603593,1024975496,17,6755,397.3529412,1360603575043,1360603584835,1024957539,1024967331,9792
1360603885,1025268096,1,46,46,1360603860200,1360603860200,1025243296,1025243296,0
1360604534,1025916940,1,46,46,1360604508474,1360604508474,1025891414,1025891414,0
1360604730,1026113328,16,6372,398.25,1360604717684,1360604728820,1026101012,1026112148,11136
1360604730,1026113332,12,999,83.25,1360604718063,1360604728815,1026101395,1026112147,10752
1360604730,1026113336,11,953,86.63636364,1360604718317,1360604728813,1026101653,1026112149,10496
1360604730,1026113336,12,999,83.25,1360604718634,1360604728810,1026101970,1026112146,10176
1360605184,1026566388,1,48,48,1360605157336,1360605157336,1026539724,1026539724,0
1360605332,1026714620,11,953,86.63636364,1360605318512,1360605328752,1026701132,1026711372,10240
1360605332,1026714700,11,953,86.63636364,1360605318943,1360605328671,1026701643,1026711371,9728
1360605332,1026714700,12,999,83.25,1360605319262,1360605328670,1026701962,1026711370,9408
1360605344,1026726460,11,3267,297,1360605319244,1360605319820,1026701704,1026702280,576
1360605372,1026754852,3,193,64.33333333,1360605368580,1360605368580,1026751432,1026751432,0
1360681907,1103290024,1,46,46,1360681880401,1360681880401,1103263425,1103263425,0
1360682364,1103746516,1,46,46,1360682338759,1360682338759,1103721275,1103721275,0
1360682364,1103746636,1,46,46,1360682338703,1360682338703,1103721339,1103721339,0
1360682364,1103746640,1,46,46,1360682338697,1360682338697,1103721337,1103721337,0
1360682364,1103746680,1,46,46,1360682338721,1360682338721,1103721401,1103721401,0
1360682365,1103747296,1,46,46,1360682339043,1360682339043,1103721339,1103721339,0
1360682365,1103747356,1,46,46,1360682338983,1360682338983,1103721339,1103721339,0
1360682756,1104138892,42,53534,1274.619048,1360682750602,1360682750858,1104133494,1104133750,256
1360682780,1104162464,13,6234,479.5384615,1360682755188,1360682755444,1104137652,1104137908,256
1360682780,1104162488,1,46,46,1360682755227,1360682755227,1104137715,1104137715,0
1360682780,1104162492,9,861,95.66666667,1360682755545,1360682755673,1104138037,1104138165,128
1360682784,1104166424,9,861,95.66666667,1360682755868,1360682756060,1104138292,1104138484,192
1360682784,1104166424,9,861,95.66666667,1360682756188,1360682756316,1104138612,1104138740,128
1360683012,1104394936,3,189,63,1360683006873,1360683009881,1104389809,1104392817,3008
1360683020,1104403024,4,252,63,1360683011138,1360683018178,1104394162,1104401202,7040
1360683028,1104410960,2,126,63,1360683013889,1360683021953,1104396849,1104404913,8064
1360683052,1104434744,1,63,63,1360683026520,1360683026520,1104409264,1104409264,0
1360683052,1104435036,3,189,63,1360683047221,1360683050229,1104430257,1104433265,3008
1360683060,1104442992,3,189,63,1360683053665,1360683056673,1104436657,1104439665,3008
1360683068,1104451028,2,126,63,1360683054269,1360683062333,1104437297,1104445361,8064
1360683076,1104459040,2,126,63,1360683060654,1360683068718,1104443694,1104451758,8064
1360683429,1104811852,17,6755,397.3529412,1360683415013,1360683425509,1104797865,1104808361,10496
1360683429,1104811852,12,999,83.25,1360683415397,1360683425509,1104798249,1104808361,10112
1360683429,1104811928,12,999,83.25,1360683415642,1360683425434,1104798570,1104808362,9792
1360683453,1104835840,2,152,76,1360683428466,1360683443570,1104811306,1104826410,15104
1360683485,1104867664,2,152,76,1360683458784,1360683473824,1104841448,1104856488,15040
1360683815,1105197372,1,48,48,1360683788927,1360683788927,1105171299,1105171299,0
1360683870,1105253056,12,999,83.25,1360683859541,1360683869525,1105242597,1105252581,9984
1360683870,1105253060,12,999,83.25,1360683859794,1360683869522,1105242854,1105252582,9728
1360683870,1105253060,12,999,83.25,1360683860047,1360683869519,1105243107,1105252579,9472
1360683871,1105253100,17,6418,377.5294118,1360683860046,1360683870478,1105242146,1105252578,10432
1360683886,1105268508,2,152,76,1360683860089,1360683875129,1105242597,1105257637,15040
1360683918,1105300448,2,152,76,1360683890228,1360683905268,1105272676,1105287716,15040
1360683946,1105328548,1,76,76,1360683920208,1360683920208,1105302756,1105302756,0
1360684198,1105581024,1,78,78,1360684171310,1360684171310,1105554334,1105554334,0
1360684867,1106250056,3,408,136,1360684841412,1360684847428,1106224468,1106230484,6016
1360684940,1106322528,1,48,48,1360684913874,1360684913874,1106296402,1106296402,0
1360685481,1106863244,3,408,136,1360685453093,1360685459109,1106835337,1106841353,6016
1360685509,1106891348,2,152,76,1360685482944,1360685497984,1106865292,1106880332,15040
1360685541,1106923416,2,152,76,1360685512955,1360685527995,1106895371,1106910411,15040
1360685569,1106951572,1,76,76,1360685542878,1360685542878,1106925450,1106925450,0
1360685677,1107059632,2,152,76,1360685650719,1360685665695,1107033351,1107048327,14976
1360685681,1107063908,15,6289,419.2666667,1360685666317,1360685678349,1107049225,1107061257,12032
1360685681,1107063908,12,999,83.25,1360685666700,1360685678348,1107049608,1107061256,11648
1360685681,1107063984,12,999,83.25,1360685666945,1360685678273,1107049929,1107061257,11328
1360685681,1107063988,8,815,101.875,1360685667645,1360685678269,1107050633,1107061257,10624
1360685705,1107087988,2,152,76,1360685680445,1360685695485,1107063433,1107078473,15040
1360685733,1107115968,1,48,48,1360685704976,1360685704976,1107087944,1107087944,0
1360685737,1107119800,1,76,76,1360685710711,1360685710711,1107093511,1107093511,0
1360686010,1107392904,2,96,48,1360685983178,1360685986186,1107366082,1107369090,3008
1360686090,1107473004,3,408,136,1360686064293,1360686070309,1107447297,1107453313,6016
1360686611,1107993204,11,953,86.63636364,1360686596030,1360686607742,1107978234,1107989946,11712
1360686611,1107993216,17,6755,397.3529412,1360686595632,1360686607728,1107977848,1107989944,12096
1360686611,1107993256,12,999,83.25,1360686596234,1360686607626,1107978490,1107989882,11392
1360686611,1107993284,11,953,86.63636364,1360686596461,1360686607597,1107978745,1107989881,11136
1360686688,1108070636,1,148,148,1360686662092,1360686662092,1108044728,1108044728,0
1360686700,1108082524,3,408,136,1360686675774,1360686681854,1108058298,1108064378,6080
1360687213,1108596012,3,402,134,1360687185868,1360687191884,1108568880,1108574896,6016
1360687313,1108695940,1,46,46,1360687285268,1360687285268,1108668208,1108668208,0
1360687338,1108720172,3,152,50.66666667,1360687310993,1360687319953,1108693165,1108702125,8960
1360687419,1108801736,18,9309,517.1666667,1360687410847,1360687411231,1108793583,1108793967,384
1360687419,1108801760,12,999,83.25,1360687404614,1360687416326,1108787374,1108799086,11712
1360687419,1108801812,16,6372,398.25,1360687404179,1360687416275,1108786991,1108799087,12096
1360687419,1108801816,12,999,83.25,1360687404878,1360687416270,1108787694,1108799086,11392
1360687419,1108801816,11,953,86.63636364,1360687405132,1360687416268,1108787948,1108799084,11136
1360687427,1108809800,8,5201,650.125,1360687417886,1360687425566,1108800686,1108808366,7680
1360687427,1108809808,8,4707,588.375,1360687410452,1360687422420,1108793260,1108805228,11968
1360687770,1109152800,1,60,60,1360687742490,1360687742490,1109125290,1109125290,0
1360687964,1109346272,12,999,83.25,1360687948133,1360687957925,1109330405,1109340197,9792
1360687964,1109346280,17,6418,377.5294118,1360687947422,1360687957982,1109329702,1109340262,10560
1360687964,1109346356,12,999,83.25,1360687947793,1360687957841,1109330149,1109340197,10048
1360688075,1109457340,1,60,60,1360688049054,1360688049054,1109431394,1109431394,0
1360688223,1109605696,11,3267,297,1360688197880,1360688198840,1109580576,1109581536,960
1360688653,1110035208,5,408,81.6,1360688647450,1360688650458,1110029658,1110032666,3008
1360688661,1110043180,2,178,89,1360688653815,1360688660471,1110035995,1110042651,6656
1360688701,1110083108,2,178,89,1360688673919,1360688700671,1110056027,1110082779,26752
1360688917,1110299408,14,6617,472.6428571,1360688889360,1360688889616,1110271768,1110272024,256
1360688917,1110299412,9,861,95.66666667,1360688889738,1360688889866,1110272150,1110272278,128
1360688917,1110299420,8,815,101.875,1360688890243,1360688890435,1110272663,1110272855,192
1360688917,1110299532,9,861,95.66666667,1360688889876,1360688890068,1110272408,1110272600,192
1360688949,1110331516,3,408,136,1360688924131,1360688930147,1110306647,1110312663,6016
1360689089,1110471684,1,148,148,1360689062456,1360689062456,1110445140,1110445140,0
1360689134,1110516100,4,184,46,1360689128640,1360689131648,1110510740,1110513748,3008
1360689134,1110516100,4,184,46,1360689128639,1360689131647,1110510739,1110513747,3008
1360689134,1110516148,4,184,46,1360689128591,1360689131599,1110510739,1110513747,3008
1360689149,1110532064,12,999,83.25,1360689133052,1360689144316,1110516116,1110527380,11264
1360689149,1110532068,12,999,83.25,1360689132790,1360689144310,1110515858,1110527378,11520
1360689150,1110532184,12,999,83.25,1360689133100,1360689145196,1110515284,1110527380,12096
1360689153,1110535576,11,953,86.63636364,1360689132963,1360689144803,1110515539,1110527379,11840
1360689173,1110556036,2,152,76,1360689147991,1360689163031,1110531027,1110546067,15040
1360689205,1110587812,2,152,76,1360689178292,1360689193396,1110561104,1110576208,15104
1360689230,1110612224,1,63,63,1360689202371,1360689202371,1110584595,1110584595,0
1360689710,1111092812,3,408,136,1360689682798,1360689688814,1111065610,1111071626,6016
1360689834,1111217040,3,402,134,1360689808905,1360689814985,1111191945,1111198025,6080
1360690007,1111389576,16,6372,398.25,1360689987479,1360689999575,1111370055,1111382151,12096
1360690007,1111389600,12,999,83.25,1360689987837,1360689999549,1111370437,1111382149,11712
1360690007,1111389604,12,999,83.25,1360689988154,1360689999546,1111370758,1111382150,11392
1360690007,1111389604,11,953,86.63636364,1360689988408,1360689999480,1111371012,1111382084,11072
1360690019,1111401176,2,152,76,1360689991142,1360690006182,1111373318,1111388358,15040
1360690047,1111429248,2,152,76,1360690021148,1360690036188,1111403396,1111418436,15040
1360690079,1111461252,1,76,76,1360690051224,1360690051224,1111433476,1111433476,0
1360690889,1112271668,11,953,86.63636364,1360690874925,1360690884973,1112257593,1112267641,10048
1360690889,1112271668,12,999,83.25,1360690875181,1360690884973,1112257849,1112267641,9792
1360690889,1112271740,16,6372,398.25,1360690874403,1360690884899,1112257143,1112267639,10496
1360690901,1112283512,2,152,76,1360690875784,1360690890824,1112258296,1112273336,15040
1360690933,1112315372,2,152,76,1360690906003,1360690920979,1112288375,1112303351,14976
1360690961,1112343456,1,76,76,1360690935934,1360690935934,1112318390,1112318390,0
1360691783,1113165576,1,148,148,1360691755643,1360691755643,1113138219,1113138219,0
1360691783,1113165612,3,408,136,1360691756568,1360691762584,1113139180,1113145196,6016
1360692036,1113418468,11,953,86.63636364,1360692024674,1360692035042,1113407142,1113417510,10368
1360692036,1113418500,12,999,83.25,1360692025155,1360692035011,1113407655,1113417511,9856
1360692036,1113418556,11,953,86.63636364,1360692024843,1360692034955,1113407399,1113417511,10112
1360692052,1113434316,2,152,76,1360692025977,1360692041017,1113408293,1113423333,15040
1360692084,1113466280,2,152,76,1360692056160,1360692071136,1113438440,1113453416,14976
1360692100,1113482504,6,2398,399.6666667,1360692085628,1360692097532,1113468132,1113480036,11904
1360692112,1113494292,1,76,76,1360692086162,1360692086162,1113468454,1113468454,0
1360692160,1113542640,1,48,48,1360692135155,1360692135155,1113517795,1113517795,0
1360692415,1113797096,1,46,46,1360692388368,1360692388368,1113770464,1113770464,0
1360692418,1113800972,1,46,46,1360692390180,1360692390180,1113773152,1113773152,0
1360692545,1113927800,3,408,136,1360692520273,1360692526289,1113903073,1113909089,6016
1360692894,1114276640,15,6289,419.2666667,1360692877803,1360692889323,1114260443,1114271963,11520
1360692894,1114276716,12,999,83.25,1360692878172,1360692889244,1114260888,1114271960,11072
1360692894,1114276720,11,953,86.63636364,1360692878427,1360692889179,1114261147,1114271899,10752
1360692894,1114276764,15,6289,419.2666667,1360692877293,1360692889197,1114260057,1114271961,11904
1360693022,1114404848,12,999,83.25,1360693002007,1360693014103,1114384855,1114396951,12096
1360693022,1114404852,11,953,86.63636364,1360693002514,1360693014034,1114385366,1114396886,11520
1360693022,1114404856,11,953,86.63636364,1360693002768,1360693014032,1114385624,1114396888,11264
1360693022,1114404928,12,999,83.25,1360693002184,1360693014024,1114385112,1114396952,11840
1360693159,1114541188,3,408,136,1360693132075,1360693138155,1114514263,1114520343,6080
1360693408,1114791116,1,46,46,1360693381127,1360693381127,1114764243,1114764243,0
1360693408,1114791144,1,46,46,1360693381096,1360693381096,1114764240,1114764240,0
1360693408,1114791152,1,46,46,1360693381091,1360693381091,1114764243,1114764243,0
1360693408,1114791188,1,46,46,1360693381055,1360693381055,1114764243,1114764243,0
1360693408,1114791220,1,46,46,1360693381084,1360693381084,1114764304,1114764304,0
1360693408,1114791224,1,46,46,1360693381081,1360693381081,1114764305,1114764305,0
1360693409,1114792308,1,46,46,1360693380935,1360693380935,1114764243,1114764243,0
1360693409,1114792376,1,46,46,1360693380930,1360693380930,1114764306,1114764306,0
1360693559,1114942060,1,46,46,1360693531645,1360693531645,1114914705,1114914705,0
1360693768,1115150928,3,408,136,1360693743419,1360693749435,1115126347,1115132363,6016
1360693788,1115170752,13,6234,479.5384615,1360693763437,1360693763757,1115146189,1115146509,320
1360693792,1115174684,9,861,95.66666667,1360693763888,1360693764080,1115146572,1115146764,192
1360693792,1115174688,9,861,95.66666667,1360693764141,1360693764333,1115146829,1115147021,192
1360693792,1115174804,8,815,101.875,1360693764281,1360693764473,1115147085,1115147277,192
1360694009,1115391516,2,126,63,1360694007317,1360694008341,1115389833,1115390857,1024
1360694017,1115399616,2,126,63,1360694010225,1360694014257,1115392841,1115396873,4032
1360694025,1115407592,2,126,63,1360694022472,1360694023496,1115405064,1115406088,1024
1360694025,1115407680,2,126,63,1360694022449,1360694023409,1115405129,1115406089,960
1360694033,1115415552,2,126,63,1360694025519,1360694029551,1115408071,1115412103,4032
1360694033,1115415552,2,126,63,1360694025582,1360694029614,1115408134,1115412166,4032
1360694049,1115431716,1,63,63,1360694022218,1360694022218,1115404934,1115404934,0
1360694065,1115447560,1,63,63,1360694037607,1360694037607,1115420167,1115420167,0
1360694065,1115447764,1,63,63,1360694037467,1360694037467,1115420231,1115420231,0
1360694081,1115463884,3,189,63,1360694073890,1360694076898,1115456774,1115459782,3008
1360694097,1115479916,2,126,63,1360694080899,1360694088899,1115463815,1115471815,8000
1360694382,1115764444,3,408,136,1360694355286,1360694361366,1115737730,1115743810,6080
1360694531,1115913216,2,92,46,1360694527032,1360694527032,1115909248,1115909248,0
1360694531,1115913216,2,92,46,1360694527032,1360694527032,1115909248,1115909248,0
1360694531,1115913296,2,92,46,1360694526889,1360694526889,1115909185,1115909185,0
1360694531,1115913296,2,92,46,1360694526952,1360694526952,1115909248,1115909248,0
1360694547,1115929424,16,6372,398.25,1360694528552,1360694540648,1115910976,1115923072,12096
1360694547,1115929432,12,999,83.25,1360694529248,1360694540576,1115911680,1115923008,11328
1360694547,1115929436,12,999,83.25,1360694529501,1360694540573,1115911937,1115923009,11072
1360694547,1115929528,11,953,86.63636364,1360694528897,1360694540545,1115911425,1115923073,11648
1360694571,1115953344,2,152,76,1360694543672,1360694558712,1115926016,1115941056,15040
1360694599,1115981400,2,152,76,1360694573694,1360694588670,1115956094,1115971070,14976
1360694631,1116013496,1,76,76,1360694603679,1360694603679,1115986175,1115986175,0
1360694659,1116041144,16,6372,398.25,1360694641663,1360694653695,1116023807,1116035839,12032
1360694659,1116041148,12,999,83.25,1360694642297,1360694653689,1116024445,1116035837,11392
1360694659,1116041172,11,953,86.63636364,1360694642595,1360694653667,1116024767,1116035839,11072
1360694659,1116041252,12,999,83.25,1360694641939,1360694653587,1116024191,1116035839,11648
1360694671,1116053600,2,152,76,1360694644598,1360694659638,1116027198,1116042238,15040
1360694699,1116081540,2,152,76,1360694674739,1360694689715,1116057279,1116072255,14976
1360694731,1116113692,2,152,76,1360694704602,1360694720154,1116087294,1116102846,15552
1360694759,1116141888,2,152,76,1360694734484,1360694749524,1116117372,1116132412,15040
1360694791,1116173932,2,152,76,1360694764519,1360694779559,1116147451,1116162491,15040
1360694795,1116177884,11,3267,297,1360694770202,1360694770778,1116153086,1116153662,576
1360694883,1116265688,3,193,64.33333333,1360694877915,1360694877915,1116260603,1116260603,0
1360694899,1116281972,1,76,76,1360694874557,1360694874557,1116257529,1116257529,0
1360694932,1116314072,2,152,76,1360694905540,1360694920580,1116287612,1116302652,15040
1360694960,1116342220,1,76,76,1360694935468,1360694935468,1116317688,1116317688,0
1360695020,1116402420,3,408,136,1360694995172,1360695001252,1116377592,1116383672,6080
1360695633,1117015980,3,408,136,1360695605804,1360695611884,1116988784,1116994864,6080
1360695786,1117168576,1,46,46,1360695760701,1360695760701,1117143277,1117143277,0
1360696027,1117409208,1,148,148,1360696002410,1360696002410,1117384618,1117384618,0
1360696051,1117433140,1,60,60,1360696025710,1360696025710,1117407850,1117407850,0
1360696243,1117625984,3,408,136,1360696216925,1360696222941,1117599909,1117605925,6016
1360696380,1117762160,1,60,60,1360696354836,1360696354836,1117736996,1117736996,0
1360696472,1117854428,12,6151,512.5833333,1360696447687,1360696448007,1117830115,1117830435,320
1360696472,1117854540,14,6749,482.0714286,1360696447126,1360696447446,1117829666,1117829986,320
1360696476,1117858476,9,861,95.66666667,1360696448021,1360696448213,1117830497,1117830689,192
1360696476,1117858484,9,861,95.66666667,1360696448336,1360696448464,1117830820,1117830948,128
1360696476,1117858484,8,815,101.875,1360696448590,1360696448782,1117831074,1117831266,192
1360696509,1117891164,3,138,46,1360696504524,1360696504588,1117886688,1117886752,64
1360696509,1117891164,3,138,46,1360696504524,1360696504588,1117886688,1117886752,64
1360696509,1117891220,3,138,46,1360696504469,1360696504533,1117886689,1117886753,64
1360696509,1117891220,3,138,46,1360696504533,1360696504597,1117886753,1117886817,64
1360696509,1117891220,3,138,46,1360696504468,1360696504532,1117886688,1117886752,64
1360696517,1117899212,35,29627,846.4857143,1360696512413,1360696513629,1117894625,1117895841,1216
1360696525,1117907304,17,6755,397.3529412,1360696506624,1360696520896,1117888928,1117903200,14272
1360696525,1117907304,12,999,83.25,1360696506945,1360696520897,1117889249,1117903201,13952
1360696525,1117907308,12,999,83.25,1360696507198,1360696520702,1117889506,1117903010,13504
1360696525,1117907308,11,953,86.63636364,1360696507454,1360696518974,1117889762,1117901282,11520
1360696540,1117922424,1,52,52,1360696512392,1360696512392,1117894816,1117894816,0
1360696644,1118026744,1,46,46,1360696618567,1360696618567,1118001311,1118001311,0
1360696669,1118051264,11,953,86.63636364,1360696650663,1360696662503,1118032927,1118044767,11840
1360696669,1118051268,12,999,83.25,1360696650916,1360696662436,1118033184,1118044704,11520
1360696669,1118051344,12,999,83.25,1360696650328,1360696662424,1118032672,1118044768,12096
1360696669,1118051348,12,999,83.25,1360696651090,1360696662354,1118033438,1118044702,11264
1360696856,1118238852,3,408,136,1360696828312,1360696834328,1118211164,1118217180,6016
1360696868,1118251012,6,276,46,1360696841400,1360696850744,1118224412,1118233756,9344
1360697009,1118391344,1,148,148,1360696984084,1360696984084,1118366428,1118366428,0
1360697470,1118852668,1,136,136,1360697445321,1360697445321,1118827989,1118827989,0
1360697478,1118860736,1,46,46,1360697452163,1360697452163,1118834899,1118834899,0
1360697880,1119262212,12,999,83.25,1360697865545,1360697875401,1119247757,1119257613,9856
1360697880,1119262236,12,999,83.25,1360697865776,1360697875376,1119248012,1119257612,9600
1360698040,1119422416,1,92,92,1360698015803,1360698015803,1119398219,1119398219,0
1360698076,1119458664,3,408,136,1360698050435,1360698056451,1119433099,1119439115,6016
1360698205,1119587060,1,148,148,1360698179548,1360698179548,1119561608,1119561608,0
1360698293,1119675104,1,148,148,1360698265454,1360698265454,1119647558,1119647558,0
1360698393,1119775752,12,999,83.25,1360698373349,1360698384997,1119756101,1119767749,11648
1360698393,1119775784,11,953,86.63636364,1360698373894,1360698384966,1119756678,1119767750,11072
1360698393,1119775832,17,6418,377.5294118,1360698372886,1360698384982,1119755718,1119767814,12096
1360698393,1119775840,12,999,83.25,1360698373519,1360698384911,1119756359,1119767751,11392
1360698417,1119799536,2,152,76,1360698388924,1360698404028,1119771460,1119786564,15104
1360698445,1119827616,2,152,76,1360698418989,1360698434029,1119801605,1119816645,15040
1360698473,1119856000,1,76,76,1360698448620,1360698448620,1119831620,1119831620,0
1360698610,1119992484,15,6289,419.2666667,1360698593774,1360698605806,1119976258,1119988290,12032
1360698610,1119992488,11,953,86.63636364,1360698594155,1360698605803,1119976643,1119988291,11648
1360698610,1119992488,12,999,83.25,1360698594473,1360698605801,1119976961,1119988289,11328
1360698610,1119992492,12,999,83.25,1360698594727,1360698605799,1119977219,1119988291,11072
1360698622,1120004248,2,152,76,1360698596888,1360698611928,1119979136,1119994176,15040
1360698662,1120044308,2,96,48,1360698635100,1360698638108,1120017408,1120020416,3008
1360698682,1120064504,1,76,76,1360698656794,1360698656794,1120039298,1120039298,0
1360698686,1120068464,3,408,136,1360698661185,1360698667201,1120043649,1120049665,6016
1360698698,1120080476,2,152,76,1360698671926,1360698686966,1120054402,1120069442,15040
1360698730,1120112248,2,152,76,1360698702233,1360698717209,1120084481,1120099457,14976
1360698758,1120140380,1,76,76,1360698732117,1360698732117,1120114497,1120114497,0
1360698846,1120228720,1,48,48,1360698820157,1360698820157,1120202877,1120202877,0
1360699300,1120682052,3,408,136,1360699273173,1360699279189,1120655225,1120661241,6016
1360699432,1120814680,2,96,48,1360699406687,1360699409951,1120789367,1120792631,3264
1360699909,1121291500,3,408,136,1360699884107,1360699890123,1121266607,1121272623,6016
1360699973,1121355388,1,46,46,1360699946106,1360699946106,1121328494,1121328494,0
1360700230,1121612288,1,92,92,1360700204377,1360700204377,1121586665,1121586665,0
1360700430,1121812720,9,861,95.66666667,1360700405606,1360700405798,1121788326,1121788518,192
1360700430,1121812904,12,6151,512.5833333,1360700404848,1360700405296,1121787752,1121788200,448
1360700434,1121816632,9,861,95.66666667,1360700405951,1360700406143,1121788583,1121788775,192
1360700434,1121816632,9,861,95.66666667,1360700406205,1360700406525,1121788837,1121789157,320
1360700506,1121888776,1,46,46,1360700480046,1360700480046,1121862822,1121862822,0
1360700522,1121904796,3,408,136,1360700495833,1360700501913,1121878629,1121884709,6080
1360700631,1122013376,4,252,63,1360700622524,1360700629628,1122004900,1122012004,7104
1360700663,1122045060,1,63,63,1360700637943,1360700637943,1122020003,1122020003,0
1360700727,1122109456,4,252,63,1360700718378,1360700725418,1122100834,1122107874,7040
1360700751,1122133432,14,4789,342.0714286,1360700735555,1360700747587,1122117987,1122130019,12032
1360700751,1122133436,12,999,83.25,1360700736063,1360700747583,1122118499,1122130019,11520
1360700751,1122133440,12,999,83.25,1360700736315,1360700747579,1122118755,1122130019,11264
1360700751,1122133460,11,953,86.63636364,1360700736550,1360700747558,1122119010,1122130018,11008
1360700759,1122141284,1,63,63,1360700733652,1360700733652,1122115936,1122115936,0
1360700823,1122205540,2,126,63,1360700821652,1360700822676,1122204192,1122205216,1024
1360700823,1122205640,2,126,63,1360700821554,1360700822578,1122204194,1122205218,1024
1360700831,1122213536,2,126,63,1360700824665,1360700828697,1122207201,1122211233,4032
1360700831,1122213620,2,126,63,1360700824581,1360700828613,1122207201,1122211233,4032
1360700842,1122224896,1,63,63,1360700836402,1360700836402,1122219298,1122219298,0
1360700842,1122224896,1,63,63,1360700836402,1360700836402,1122219298,1122219298,0
1360701132,1122514380,3,408,136,1360701107121,1360701113201,1122489501,1122495581,6080
1360701341,1122723052,1,46,46,1360701312820,1360701312820,1122694872,1122694872,0
1360701605,1122987844,1,148,148,1360701578713,1360701578713,1122961557,1122961557,0
1360701618,1123000064,16,6372,398.25,1360701605029,1360701615333,1122987093,1122997397,10304
1360701618,1123000096,12,999,83.25,1360701605635,1360701615299,1122987731,1122997395,9664
1360701618,1123000148,12,999,83.25,1360701605330,1360701615250,1122987478,1122997398,9920
1360701746,1123128104,3,408,136,1360701718906,1360701724986,1123101010,1123107090,6080
1360702356,1123738168,3,408,136,1360702330227,1360702336243,1123712395,1123718411,6016
1360702508,1123890752,12,999,83.25,1360702492773,1360702502757,1123875525,1123885509,9984
1360702508,1123890820,17,6755,397.3529412,1360702492067,1360702502691,1123874887,1123885511,10624
1360702508,1123890824,11,953,86.63636364,1360702492446,1360702502686,1123875270,1123885510,10240
1360702969,1124351740,3,408,136,1360702941675,1360702947691,1124324415,1124330431,6016
1360703024,1124406400,1,46,46,1360702996609,1360702996609,1124379009,1124379009,0
1360703025,1124407052,1,46,46,1360702995291,1360702995291,1124377343,1124377343,0
1360703350,1124732632,1,148,148,1360703323858,1360703323858,1124706490,1124706490,0
1360703579,1124961100,3,408,136,1360703553892,1360703559908,1124935992,1124942008,6016
1360703628,1125010208,1,48,48,1360703600757,1360703600757,1124982965,1124982965,0
1360703631,1125013932,1,48,48,1360703603171,1360703603171,1124986103,1124986103,0
1360703719,1125101832,1,46,46,1360703692035,1360703692035,1125074867,1125074867,0
1360703723,1125105264,1,46,46,1360703697598,1360703697598,1125079862,1125079862,0
1360704192,1125574444,3,408,136,1360704165314,1360704171330,1125547758,1125553774,6016
1360704320,1125702772,9,861,95.66666667,1360704292023,1360704292215,1125674795,1125674987,192
1360704320,1125702796,9,861,95.66666667,1360704292319,1360704292447,1125675115,1125675243,128
1360704320,1125702808,8,815,101.875,1360704292562,1360704292754,1125675370,1125675562,192
1360704565,1125947756,1,46,46,1360704537668,1360704537668,1125920424,1125920424,0
1360704566,1125948728,3,189,63,1360704559263,1360704562335,1125941991,1125945063,3072
1360704566,1125948804,3,189,63,1360704559188,1360704562196,1125941992,1125945000,3008
1360704582,1125964576,2,126,63,1360704566458,1360704574522,1125949034,1125957098,8064
1360704582,1125964652,2,126,63,1360704566444,1360704574508,1125949096,1125957160,8064
1360704614,1125996584,2,92,46,1360704606382,1360704606382,1125988966,1125988966,0
1360704614,1125996668,2,92,46,1360704606297,1360704606297,1125988965,1125988965,0
1360704632,1126014972,2,109,54.5,1360704605994,1360704605994,1125988966,1125988966,0
1360704633,1126015076,8,815,101.875,1360704608621,1360704608749,1125990697,1125990825,128
1360704636,1126018952,8,815,101.875,1360704608001,1360704608193,1125990953,1125991145,192
1360704636,1126018964,8,815,101.875,1360704608501,1360704608693,1125991465,1125991657,192
1360704637,1126019076,8,815,101.875,1360704609129,1360704609321,1125991205,1125991397,192
1360704677,1126059172,1,60,60,1360704651148,1360704651148,1126033320,1126033320,0
1360704705,1126087356,1,46,46,1360704680531,1360704680531,1126062887,1126062887,0
1360704801,1126183740,3,429,143,1360704775823,1360704781903,1126158563,1126164643,6080
1360704838,1126220756,3,189,63,1360704833600,1360704836608,1126216356,1126219364,3008
1360704854,1126236656,2,126,63,1360704840739,1360704848803,1126223395,1126231459,8064
1360704862,1126244784,4,252,63,1360704854308,1360704861348,1126237092,1126244132,7040
1360704897,1126279996,1,63,63,1360704869201,1360704869201,1126252197,1126252197,0
1360704926,1126308836,3,189,63,1360704922477,1360704925549,1126305313,1126308385,3072
1360704926,1126308920,3,189,63,1360704922395,1360704925403,1126305315,1126308323,3008
1360704942,1126324808,2,126,63,1360704929545,1360704937609,1126312353,1126320417,8064
1360704942,1126324888,2,126,63,1360704929529,1360704937529,1126312417,1126320417,8000
1360704958,1126340124,1,60,60,1360704932087,1360704932087,1126314211,1126314211,0
1360705162,1126544648,1,60,60,1360705136744,1360705136744,1126519392,1126519392,0
1360705415,1126797188,3,408,136,1360705387824,1360705393840,1126770012,1126776028,6016
1360706025,1127407292,3,408,136,1360705999103,1360706005183,1127381395,1127387475,6080
1360706097,1127479444,17,6755,397.3529412,1360706082406,1360706093030,1127464850,1127475474,10624
1360706097,1127479464,12,999,83.25,1360706082771,1360706093011,1127465235,1127475475,10240
1360706097,1127479552,11,953,86.63636364,1360706082936,1360706092920,1127465488,1127475472,9984
1360706125,1127507148,1,60,60,1360706097294,1360706097294,1127479442,1127479442,0
1360706125,1127507300,9,861,95.66666667,1360706100470,1360706100598,1127482770,1127482898,128
1360706125,1127507304,9,861,95.66666667,1360706100722,1360706100914,1127483026,1127483218,192
1360706129,1127511132,9,861,95.66666667,1360706101403,1360706101595,1127483535,1127483727,192
1360706129,1127511248,9,861,95.66666667,1360706101032,1360706101224,1127483280,1127483472,192
1360706377,1127759976,4,252,63,1360706369166,1360706376206,1127752142,1127759182,7040
1360706393,1127775988,3,189,63,1360706386434,1360706389442,1127769422,1127772430,3008
1360706393,1127776004,2,126,63,1360706391665,1360706392689,1127774669,1127775693,1024
1360706401,1127784048,2,126,63,1360706394694,1360706398726,1127777742,1127781774,4032
1360706409,1127791812,1,63,63,1360706384432,1360706384432,1127767244,1127767244,0
1360706409,1127792032,2,126,63,1360706393427,1360706401491,1127776459,1127784523,8064
1360706433,1127815800,1,63,63,1360706406973,1360706406973,1127789773,1127789773,0
1360706434,1127816452,3,189,63,1360706427866,1360706430938,1127810318,1127813390,3072
1360706449,1127831984,2,126,63,1360706434437,1360706442437,1127817421,1127825421,8000
1360706558,1127940916,1,48,48,1360706532166,1360706532166,1127915082,1127915082,0
1360706638,1128020376,3,408,136,1360706610210,1360706616226,1127992586,1127998602,6016
1360707247,1128629512,3,408,136,1360707221008,1360707227024,1128603520,1128609536,6016
1360707323,1128705924,1,46,46,1360707296434,1360707296434,1128679358,1128679358,0
1360707608,1128990828,1,60,60,1360707582479,1360707582479,1128965307,1128965307,0
1360707640,1129022732,1,60,60,1360707615344,1360707615344,1128998076,1128998076,0
1360707700,1129082876,1,60,60,1360707675549,1360707675549,1129058425,1129058425,0
1360707704,1129086896,1,60,60,1360707677576,1360707677576,1129060472,1129060472,0
1360707785,1129167312,1,148,148,1360707759632,1360707759632,1129141944,1129141944,0
1360707861,1129243300,3,408,136,1360707832988,1360707839004,1129215288,1129221304,6016
1360707908,1129290092,12,999,83.25,1360707892522,1360707903274,1129274614,1129285366,10752
1360707908,1129290144,12,999,83.25,1360707891959,1360707903287,1129274103,1129285431,11328
1360707908,1129290152,12,999,83.25,1360707892204,1360707903212,1129274356,1129285364,11008
1360707908,1129290204,17,6755,397.3529412,1360707891385,1360707903225,1129273589,1129285429,11840
1360707957,1129339716,1,60,60,1360707930554,1360707930554,1129313270,1129313270,0
1360708090,1129472040,1,60,60,1360708063003,1360708063003,1129445043,1129445043,0
1360708214,1129596284,1,60,60,1360708186662,1360708186662,1129568946,1129568946,0
1360708294,1129676228,1,60,60,1360708266717,1360708266717,1129648945,1129648945,0
1360708298,1129680240,1,60,60,1360708270865,1360708270865,1129653105,1129653105,0
1360708470,1129852676,3,408,136,1360708443674,1360708449690,1129826350,1129832366,6016
1360708991,1130373920,2,96,48,1360708962909,1360708965789,1130345829,1130348709,2880
1360709080,1130462388,3,408,136,1360709054830,1360709060846,1130437218,1130443234,6016
1360709304,1130686500,3,405,135,1360709275837,1360709281853,1130658337,1130664353,6016
1360709413,1130795932,1,48,48,1360709384394,1360709384394,1130767326,1130767326,0
1360709416,1130798004,1,48,48,1360709385898,1360709385898,1130767902,1130767902,0
1360709420,1130802620,1,48,48,1360709395139,1360709395139,1130777759,1130777759,0
1360709561,1130943032,1,60,60,1360709533517,1360709533517,1130915549,1130915549,0
1360709721,1131103304,13,6234,479.5384615,1360709692984,1360709693304,1131075288,1131075608,320
1360709721,1131103312,9,861,95.66666667,1360709693360,1360709693552,1131075672,1131075864,192
1360709721,1131103316,9,861,95.66666667,1360709693871,1360709694063,1131076187,1131076379,192
1360709721,1131103428,9,861,95.66666667,1360709693501,1360709693693,1131075929,1131076121,192
1360709862,1131244076,3,138,46,1360709861210,1360709861274,1131243286,1131243350,64
1360709862,1131244076,3,138,46,1360709861210,1360709861274,1131243286,1131243350,64
1360709862,1131244164,3,138,46,1360709861124,1360709861188,1131243288,1131243352,64
1360709862,1131244164,3,138,46,1360709861124,1360709861252,1131243288,1131243416,128
1360709889,1131271928,8,815,101.875,1360709864390,1360709864582,1131247318,1131247510,192
1360709890,1131272048,9,861,95.66666667,1360709864504,1360709864696,1131246552,1131246744,192
1360709890,1131272052,8,815,101.875,1360709864757,1360709864949,1131246809,1131247001,192
1360709890,1131272056,8,815,101.875,1360709865009,1360709865201,1131247065,1131247257,192
1360710118,1131500504,3,189,63,1360710111210,1360710114218,1131493714,1131496722,3008
1360710134,1131516540,2,126,63,1360710118216,1360710126280,1131500756,1131508820,8064
1360710150,1131532636,2,126,63,1360710147751,1360710148775,1131530387,1131531411,1024
1360710158,1131540880,2,126,63,1360710150514,1360710154546,1131533394,1131537426,4032
1360710182,1131564632,4,252,63,1360710173673,1360710180713,1131556305,1131563345,7040
1360710190,1131572432,1,63,63,1360710163060,1360710163060,1131545492,1131545492,0
1360710190,1131572768,2,126,63,1360710188580,1360710189604,1131571348,1131572372,1024
1360710198,1131580660,2,126,63,1360710191693,1360710195725,1131574353,1131578385,4032
1360710214,1131596688,1,63,63,1360710188723,1360710188723,1131571411,1131571411,0
1360710222,1131604420,1,148,148,1360710194751,1360710194751,1131577171,1131577171,0
1360710230,1131612472,1,63,63,1360710203979,1360710203979,1131586451,1131586451,0
1360710591,1131973388,17,6755,397.3529412,1360710577624,1360710588184,1131960012,1131970572,10560
1360710591,1131973480,11,953,86.63636364,1360710577917,1360710588093,1131960397,1131970573,10176
1360710591,1131973484,12,999,83.25,1360710578170,1360710588090,1131960654,1131970574,9920
1360710683,1132065628,3,408,136,1360710656040,1360710662056,1132038668,1132044684,6016
1360710687,1132069576,20,11004,550.2,1360710661916,1360710662748,1132044492,1132045324,832
1360710687,4065349788,6,4755,792.5,1360710659492,1360710659556,4065322280,4065322344,64
1360710687,4065349788,5,3969,793.8,1360710659556,1360710659556,4065322344,4065322344,0
1360710912,1132294256,3,189,63,1360710905368,1360710908376,1132287624,1132290632,3008
1360710928,1132310248,2,126,63,1360710912415,1360710920479,1132294663,1132302727,8064
1360711036,1132418076,1,148,148,1360711010249,1360711010249,1132392325,1132392325,0
1360711145,1132527136,1,46,46,1360711118861,1360711118861,1132500997,1132500997,0
1360711145,1132527944,1,46,46,1360711117926,1360711117926,1132500870,1132500870,0
1360711150,1132532076,1,46,46,1360711122887,1360711122887,1132504963,1132504963,0
1360711161,4065823804,3,156,52,1360711159574,1360711160214,4065822378,4065823018,640
1360711161,4065823824,3,156,52,1360711159488,1360711160192,4065822312,4065823016,704
1360711188,4065850824,1,52,52,1360711161024,1360711161024,4065823848,4065823848,0
1360711188,4065850876,1,52,52,1360711160972,1360711160972,4065823848,4065823848,0
1360711356,1132738656,3,408,136,1360711328001,1360711334081,1132710657,1132716737,6080
1360711601,1132983308,3,411,137,1360711575001,1360711581017,1132957309,1132963325,6016
1360711677,1133059604,1,46,46,1360711650095,1360711650095,1133032699,1133032699,0
1360711802,1133184152,3,152,50.66666667,1360711776370,1360711785394,1133158522,1133167546,9024
1360711802,1133184200,3,152,50.66666667,1360711774084,1360711783108,1133156284,1133165308,9024
1360711802,1133184240,3,152,50.66666667,1360711775193,1360711784153,1133157433,1133166393,8960
1360711802,1133184280,3,152,50.66666667,1360711776241,1360711785265,1133158521,1133167545,9024
1360711966,1133348624,3,408,136,1360711939608,1360711945688,1133322232,1133328312,6080
1360711982,1133364488,6,384,64,1360711954337,1360711959585,1133336825,1133342073,5248
1360711982,1133364528,6,384,64,1360711955578,1360711960762,1133338106,1133343290,5184
1360711982,1133364680,5,320,64,1360711956575,1360711960671,1133339255,1133343351,4096
1360712215,1133597364,3,411,137,1360712190234,1360712196314,1133572598,1133578678,6080
1360712404,1133786004,12,999,83.25,1360712392380,1360712399420,1133774384,1133781424,7040
1360712404,1133786024,11,953,86.63636364,1360712392747,1360712399403,1133774771,1133781427,6656
1360712404,1133786028,11,953,86.63636364,1360712393061,1360712399397,1133775089,1133781425,6336
1360712431,1133813932,9,861,95.66666667,1360712405663,1360712405855,1133788595,1133788787,192
1360712431,1133813936,8,815,101.875,1360712406234,1360712406362,1133789170,1133789298,128
1360712432,1133814048,8,815,101.875,1360712406291,1360712406483,1133788339,1133788531,192
1360712432,1133814056,8,815,101.875,1360712406795,1360712406987,1133788851,1133789043,192
1360712576,1133958040,3,408,136,1360712551190,1360712557206,1133933230,1133939246,6016
1360712636,1134018208,2,326,163,1360712611567,1360712611631,1133993775,1133993839,64
1360712724,1134106760,3,189,63,1360712720262,1360712723270,1134103022,1134106030,3008
1360712724,1134106760,3,189,63,1360712720198,1360712723270,1134102958,1134106030,3072
1360712724,1134106792,2,126,63,1360712721508,1360712722532,1134104300,1134105324,1024
1360712724,1134106832,3,189,63,1360712720125,1360712723197,1134102957,1134106029,3072
1360712732,1134114504,2,126,63,1360712724869,1360712728901,1134107373,1134111405,4032
1360712740,1134122432,2,126,63,1360712727629,1360712735629,1134110061,1134118061,8000
1360712740,1134122432,2,126,63,1360712727629,1360712735693,1134110061,1134118125,8064
1360712740,1134122488,2,126,63,1360712727573,1360712735573,1134110061,1134118061,8000
1360712764,1134146204,1,63,63,1360712737200,1360712737200,1134119404,1134119404,0
1360712828,1134210368,2,104,52,1360712803402,1360712806410,1134185770,1134188778,3008
1360712828,1134210448,2,104,52,1360712802235,1360712805179,1134184683,1134187627,2944
1360712832,1134214284,2,104,52,1360712804574,1360712807582,1134186858,1134189866,3008
1360712832,1134214412,2,104,52,1360712804447,1360712807455,1134186859,1134189867,3008
1360712844,1134226400,3,152,50.66666667,1360712819820,1360712828780,1134202220,1134211180,8960
1360712844,1134226664,3,152,50.66666667,1360712818404,1360712827428,1134201068,1134210092,9024
1360712848,1134230412,3,152,50.66666667,1360712820894,1360712829854,1134203306,1134212266,8960
1360712848,1134230524,3,152,50.66666667,1360712820782,1360712829742,1134203306,1134212266,8960
1360712864,1134246652,3,411,137,1360712838574,1360712844590,1134221226,1134227242,6016
1360712952,1134334872,1,46,46,1360712926800,1360712926800,1134309672,1134309672,0
1360713069,1134451328,3,152,50.66666667,1360713043698,1360713052722,1134426026,1134435050,9024
1360713073,1134455056,3,152,50.66666667,1360713045058,1360713054146,1134427114,1134436202,9088
1360713073,1134455092,3,152,50.66666667,1360713046171,1360713055195,1134428263,1134437287,9024
1360713189,1134571408,3,408,136,1360713162718,1360713168606,1134545126,1134551014,5888
1360713482,1134864080,3,411,137,1360713454369,1360713460385,1134836449,1134842465,6016
1360713699,1135081068,1,46,46,1360713672937,1360713672937,1135055005,1135055005,0
1360713748,4068410196,1,46,46,1360713723592,1360713723592,4068385788,4068385788,0
1360713799,1135181256,3,408,136,1360713774126,1360713780142,1135156382,1135162398,6016
1360714216,1135598184,17,6755,397.3529412,1360714197869,1360714208429,1135580053,1135590613,10560
1360714216,1135598240,12,999,83.25,1360714198198,1360714208374,1135580438,1135590614,10176
1360714216,1135598244,12,999,83.25,1360714198450,1360714208370,1135580694,1135590614,9920
1360714219,1135601876,3,152,50.66666667,1360714193660,1360714202620,1135576536,1135585496,8960
1360714223,1135605796,3,152,50.66666667,1360714194828,1360714203852,1135577624,1135586648,9024
1360714223,1135605808,3,152,50.66666667,1360714195966,1360714204990,1135578774,1135587798,9024
1360714223,1135605808,3,152,50.66666667,1360714195966,1360714204990,1135578774,1135587798,9024
1360714235,1135617876,3,152,50.66666667,1360714208889,1360714217913,1135591765,1135600789,9024
1360714236,1135618040,3,152,50.66666667,1360714210813,1360714219837,1135592853,1135601877,9024
1360714239,1135621808,3,152,50.66666667,1360714211197,1360714220157,1135594005,1135602965,8960
1360714306,1135688048,1,48,48,1360714278708,1360714278708,1135660756,1135660756,0
1360714308,1135690368,1,48,48,1360714280119,1360714280119,1135662487,1135662487,0
1360714412,1135794344,3,408,136,1360714384781,1360714390797,1135767125,1135773141,6016
1360714464,1135846336,3,402,134,1360714436948,1360714443028,1135819284,1135825364,6080
1360714504,1135886420,2,120,60,1360714478464,1360714481472,1135860884,1135863892,3008
1360714504,1135886436,2,120,60,1360714479536,1360714482544,1135861972,1135864980,3008
1360714504,1135886436,2,120,60,1360714479536,1360714482544,1135861972,1135864980,3008
1360714504,1135886500,2,120,60,1360714477232,1360714480240,1135859732,1135862740,3008
1360714682,4069344900,9,7806,867.3333333,1360714669261,1360714681229,4069332161,4069344129,11968
1360714682,4069344900,16,18750,1171.875,1360714669325,1360714681229,4069332225,4069344129,11904
1360714689,1136071428,11,953,86.63636364,1360714671669,1360714682997,1136054097,1136065425,11328
1360714689,1136071436,18,9157,508.7222222,1360714669738,1360714681834,1136052174,1136064270,12096
1360714689,1136071472,17,6418,377.5294118,1360714670854,1360714682950,1136053326,1136065422,12096
1360714689,1136071476,12,999,83.25,1360714671301,1360714682949,1136053777,1136065425,11648
1360714689,1136071480,16,6335,395.9375,1360714671937,1360714682945,1136054417,1136065425,11008
1360714705,1136087640,7,1952,278.8571429,1360714698589,1360714698845,1136081229,1136081485,256
1360714705,1136087664,8,2018,252.25,1360714702918,1360714703174,1136085582,1136085838,256
1360714713,1136095516,8,2018,252.25,1360714706203,1360714706459,1136088719,1136088975,256
1360714713,1136095520,7,1966,280.8571429,1360714706457,1360714706713,1136088977,1136089233,256
1360714713,1136095588,8,2018,252.25,1360714706642,1360714706962,1136089230,1136089550,320
1360714725,1136107228,4,432,108,1360714697851,1360714699003,1136080079,1136081231,1152
1360714725,1136107272,2,216,108,1360714699086,1360714699214,1136081358,1136081486,128
1360714725,1136107468,1,108,108,1360714698828,1360714698828,1136081296,1136081296,0
1360714729,1136111532,4,744,186,1360714728587,1360714728651,1136111119,1136111183,64
1360714729,1136111584,6,983,163.8333333,1360714727896,1360714728216,1136110480,1136110800,320
1360714729,1136111584,6,798,133,1360714728214,1360714728534,1136110798,1136111118,320
1360714729,1136111588,7,5436,776.5714286,1360714728532,1360714728596,1136111120,1136111184,64
1360714729,1136111592,9,3544,393.7777778,1360714725135,1360714726863,1136107727,1136109455,1728
1360714729,1136111620,9,1913,212.5555556,1360714722674,1360714722930,1136105294,1136105550,256
1360714729,1136111628,11,3294,299.4545455,1360714727148,1360714727852,1136109776,1136110480,704
1360714730,4069392908,4,1448,362,1360714723653,1360714723717,4069386561,4069386625,64
1360714737,1136119560,11,2910,264.5454545,1360714730479,1360714731823,1136113039,1136114383,1344
1360714737,1136119560,6,814,135.6666667,1360714734383,1360714734575,1136116943,1136117135,192
1360714737,1136119584,4,725,181.25,1360714735062,1360714735126,1136117646,1136117710,64
1360714737,1136119624,11,3008,273.4545455,1360714733741,1360714734317,1136116365,1136116941,576
1360714737,1136119624,4,662,165.5,1360714729645,1360714729709,1136112269,1136112333,64
1360714737,1136119628,11,3187,289.7272727,1360714729772,1360714730412,1136112400,1136113040,640
1360714737,1136119632,6,3703,617.1666667,1360714734567,1360714734631,1136117199,1136117263,64
1360714737,1136119632,7,856,122.2857143,1360714734758,1360714735334,1136117390,1136117966,576
1360714737,1136119636,7,5613,801.8571429,1360714735076,1360714735204,1136117712,1136117840,128
1360714737,1136119636,9,1949,216.5555556,1360714735202,1360714735970,1136117838,1136118606,768
1360714737,1136119664,6,782,130.3333333,1360714735239,1360714735623,1136117903,1136118287,384
1360714737,1136119668,5,2620,524,1360714735620,1360714735748,1136118288,1136118416,128
1360714737,1136119672,6,797,132.8333333,1360714735808,1360714736128,1136118480,1136118800,320
1360714745,1136127500,6,4190,698.3333333,1360714736746,1360714737322,1136119246,1136119822,576
1360714753,1136135512,5,1257,251.4,1360714746080,1360714746080,1136128592,1136128592,0
1360714753,1136135584,9,2274,252.6666667,1360714746263,1360714747287,1136128847,1136129871,1024
1360714757,1136139224,13,4619,355.3076923,1360714729213,1360714734717,1136111437,1136116941,5504
1360714761,1136143324,19,12746,670.8421053,1360714733212,1360714735004,1136115536,1136117328,1792
1360714761,1136143540,8,1400,175,1360714754052,1360714754884,1136136592,1136137424,832
1360714761,1136143576,5,529,105.8,1360714756191,1360714756831,1136138767,1136139407,640
1360714781,1136163328,14,2828,202,1360714755160,1360714779800,1136137488,1136162128,24640
1360714793,1136175712,10,2001,200.1,1360714789397,1360714790229,1136172109,1136172941,832
1360714797,1136179312,2,130,65,1360714770022,1360714770278,1136152334,1136152590,256
1360714801,1136183724,7,1423,203.2857143,1360714797192,1360714797896,1136179916,1136180620,704
1360714837,1136219700,2,130,65,1360714809634,1360714810210,1136192334,1136192910,576
1360714877,1136259680,2,130,65,1360714849652,1360714850740,1136232332,1136233420,1088
1360714917,1136299760,2,130,65,1360714889570,1360714890978,1136272330,1136273738,1408
1360714925,1136307640,1,64,64,1360714898588,1360714898588,1136281228,1136281228,0
1360714925,1136307644,1,64,64,1360714898840,1360714898840,1136281484,1136281484,0
1360714957,1136339636,4,1217,304.25,1360714929694,1360714954462,1136312330,1136337098,24768
1360714997,1136379956,2,130,65,1360714969373,1360714994205,1136352329,1136377161,24832
1360715038,1136420120,2,130,65,1360715010211,1360715035363,1136392331,1136417483,25152
1360715078,1136460176,2,130,65,1360715050154,1360715075690,1136432330,1136457866,25536
1360715114,1136496184,3,516,172,1360715086370,1360715092386,1136468554,1136474570,6016
1360715118,1136500144,2,130,65,1360715090184,1360715116104,1136472328,1136498248,25920
1360715158,1136540372,2,130,65,1360715129958,1360715156582,1136512330,1136538954,26624
1360715190,1136572448,3,152,50.66666667,1360715164505,1360715168153,1136546953,1136550601,3648
1360715190,1136572620,3,152,50.66666667,1360715165482,1360715169130,1136548102,1136551750,3648
1360715194,1136576380,3,152,50.66666667,1360715166814,1360715170462,1136549194,1136552842,3648
1360715194,1136576548,3,152,50.66666667,1360715166643,1360715175667,1136549191,1136558215,9024
1360715198,1136580480,2,130,65,1360715169848,1360715196920,1136552328,1136579400,27072
1360715238,1136620472,2,130,65,1360715209856,1360715237312,1136592328,1136619784,27456
1360715278,1136660408,1,52,52,1360715249919,1360715249919,1136632327,1136632327,0
1360715302,1136684692,2,130,65,1360715277604,1360715289636,1136660296,1136672328,12032
1360715346,1136728476,2,130,65,1360715318203,1360715329851,1136700679,1136712327,11648
1360715386,1136768520,2,130,65,1360715358605,1360715369805,1136741125,1136752325,11200
1360715426,1136808672,2,130,65,1360715398837,1360715409653,1136781509,1136792325,10816
1360715458,1136840732,2,651,325.5,1360715433718,1360715449590,1136816450,1136832322,15872
1360715502,1136884680,2,130,65,1360715474665,1360715489641,1136857345,1136872321,14976
1360715542,1136924844,2,130,65,1360715515016,1360715529480,1136897860,1136912324,14464
1360715582,1136964812,2,130,65,1360715555495,1360715569511,1136938307,1136952323,14016
1360715622,1137004956,2,130,65,1360715595796,1360715609364,1136978752,1136992320,13568
1360715663,1137045492,2,130,65,1360715636710,1360715649830,1137019202,1137032322,13120
1360715703,1137085640,2,130,65,1360715676945,1360715689681,1137059585,1137072321,12736
1360715743,1137125708,2,130,65,1360715717195,1360715729611,1137099903,1137112319,12416
1360715783,1137165812,2,130,65,1360715757409,1360715769505,1137140221,1137152317,12096
1360715823,1137205840,3,208,69.33333333,1360715797766,1360715809478,1137180606,1137192318,11712
1360715863,1137245904,2,130,65,1360715838213,1360715849413,1137221117,1137232317,11200
1360715903,1137285816,1,148,148,1360715875613,1360715875613,1137258429,1137258429,0
1360715903,1137285928,2,130,65,1360715878510,1360715889390,1137261438,1137272318,10880
1360715948,1137330100,2,130,65,1360715919658,1360715930218,1137301758,1137312318,10560
1360715988,1137370080,2,130,65,1360715959994,1360715970234,1137342074,1137352314,10240
1360716024,1137406396,3,408,136,1360715997630,1360716003646,1137380026,1137386042,6016
1360716028,1137410284,2,130,65,1360716000176,1360716010032,1137382460,1137392316,9856
1360716068,1137450456,2,130,65,1360716040387,1360716049923,1137422843,1137432379,9536
1360716108,1137490724,2,130,65,1360716080504,1360716089656,1137463228,1137472380,9152
1360716148,1137530728,2,130,65,1360716120944,1360716129648,1137503672,1137512376,8704
1360716188,1137570680,2,130,65,1360716161567,1360716169695,1137544247,1137552375,8128
1360716200,1137582736,1,148,148,1360716175466,1360716175466,1137558202,1137558202,0
1360716219,1137601664,12,999,83.25,1360716204464,1360716215280,1137587128,1137597944,10816
1360716219,1137601736,16,6372,398.25,1360716204008,1360716215208,1137586744,1137597944,11200
1360716219,1137601744,12,999,83.25,1360716204641,1360716215137,1137587385,1137597881,10496
1360716219,1137601744,12,999,83.25,1360716204895,1360716215135,1137587639,1137597879,10240
1360716228,1137610752,2,130,65,1360716201943,1360716209623,1137584695,1137592375,7680
1360716269,1137651256,2,130,65,1360716243016,1360716250120,1137625272,1137632376,7104
1360716289,1137671188,1,46,46,1360716262413,1360716262413,1137644601,1137644601,0
1360716309,1137691172,2,130,65,1360716283548,1360716290204,1137665720,1137672376,6656
1360716349,1137731152,2,130,65,1360716323888,1360716330224,1137706040,1137712376,6336
1360716389,1137771288,2,130,65,1360716364136,1360716370088,1137746424,1137752376,5952
1360716429,1137811520,2,130,65,1360716404477,1360716409853,1137786997,1137792373,5376
1360716473,1137855468,2,130,65,1360716445043,1360716449907,1137827511,1137832375,4864
1360716513,1137895520,2,130,65,1360716485374,1360716489854,1137867894,1137872374,4480
1360716553,1137935580,2,130,65,1360716525696,1360716529792,1137908276,1137912372,4096
1360716593,1137975760,2,130,65,1360716566027,1360716569611,1137948787,1137952371,3584
1360716633,1138015660,2,130,65,1360716606701,1360716609709,1137989361,1137992369,3008
1360716673,1138055736,2,130,65,1360716647138,1360716649634,1138029874,1138032370,2496
1360716713,1138095816,2,130,65,1360716687569,1360716689553,1138070385,1138072369,1984
1360716753,1138135872,2,130,65,1360716728023,1360716729495,1138110895,1138112367,1472
1360716782,1138164092,3,408,136,1360716757347,1360716763363,1138139439,1138145455,6016
1360716793,1138175924,2,130,65,1360716768483,1360716769443,1138151407,1138152367,960
1360716810,1138191988,1,46,46,1360716783501,1360716783501,1138165489,1138165489,0
1360716837,1138219960,2,130,65,1360716808832,1360716809408,1138191792,1138192368,576
1360716878,1138260012,2,130,65,1360716850164,1360716850356,1138232176,1138232368,192
1360716917,1138299892,2,130,65,1360716889474,1360716889666,1138272366,1138272558,192
1360716958,1138339996,2,130,65,1360716930371,1360716931139,1138312367,1138313135,768
1360716998,1138380180,2,130,65,1360716970184,1360716971528,1138352364,1138353708,1344
1360717038,1138420132,2,130,65,1360717010234,1360717012282,1138392366,1138394414,2048
1360717038,1138420200,3,152,50.66666667,1360717013235,1360717014643,1138395435,1138396843,1408
1360717038,1138420364,3,152,50.66666667,1360717011986,1360717013394,1138394350,1138395758,1408
1360717042,1138424100,2,104,52,1360717014489,1360717017497,1138396589,1138399597,3008
1360717042,1138424216,3,152,50.66666667,1360717014371,1360717015715,1138396587,1138397931,1344
1360717078,1138460320,2,130,65,1360717050045,1360717052541,1138432365,1138434861,2496
1360717118,1138500304,2,130,65,1360717090060,1360717093068,1138472364,1138475372,3008
1360717138,1138520712,1,46,46,1360717113460,1360717113460,1138496172,1138496172,0
1360717139,1138521260,1,46,46,1360717113846,1360717113846,1138496106,1138496106,0
1360717158,1138540468,2,130,65,1360717129894,1360717133414,1138512362,1138515882,3520
1360717198,1138580432,2,130,65,1360717169929,1360717174345,1138552361,1138556777,4416
1360717234,1138616720,2,130,65,1360717209643,1360717214571,1138592363,1138597291,4928
1360717274,1138656836,2,130,65,1360717249525,1360717254837,1138632361,1138637673,5312
1360717314,1138696836,2,130,65,1360717289523,1360717295347,1138672359,1138678183,5824
1360717354,1138736980,3,561,187,1360717329380,1360717346916,1138712360,1138729896,17536
1360717356,1138738660,15,6289,419.2666667,1360717335973,1360717348005,1138718633,1138730665,12032
1360717356,1138738664,12,999,83.25,1360717336351,1360717347999,1138719015,1138730663,11648
1360717356,1138738668,12,999,83.25,1360717336604,1360717347996,1138719272,1138730664,11392
1360717356,1138738672,12,999,83.25,1360717336855,1360717347991,1138719527,1138730663,11136
1360717394,1138776888,3,408,136,1360717367677,1360717373693,1138750565,1138756581,6016
1360717395,1138777056,2,130,65,1360717370302,1360717388798,1138752358,1138770854,18496
1360717435,1138817376,2,130,65,1360717409981,1360717428989,1138792357,1138811365,19008
1360717475,1138857200,2,130,65,1360717450156,1360717469740,1138832356,1138851940,19584
1360717515,1138897448,2,130,65,1360717489910,1360717509942,1138872358,1138892390,20032
1360717555,1138937472,2,130,65,1360717529886,1360717550558,1138912358,1138933030,20672
1360717595,1138977712,2,130,65,1360717569646,1360717590894,1138952358,1138973606,21248
1360717607,1138989668,3,152,50.66666667,1360717582296,1360717583576,1138964964,1138966244,1280
1360717607,1138989780,3,152,50.66666667,1360717581095,1360717582503,1138963875,1138965283,1408
1360717611,1138993576,2,104,52,1360717583474,1360717586482,1138966050,1138969058,3008
1360717611,1138993696,3,152,50.66666667,1360717583356,1360717584572,1138966052,1138967268,1216
1360717635,1139017820,2,130,65,1360717609536,1360717631168,1138992356,1139013988,21632
1360717675,1139057728,2,130,65,1360717649628,1360717671772,1139032356,1139054500,22144
1360717679,1139061848,1,46,46,1360717652901,1360717652901,1139035749,1139035749,0
1360717715,1139097924,2,130,65,1360717689429,1360717712149,1139072353,1139095073,22720
1360717756,1139138044,2,130,65,1360717730308,1360717753412,1139112352,1139135456,23104
1360717772,1139154852,6,983,163.8333333,1360717769630,1360717769886,1139152482,1139152738,256
1360717772,1139154928,6,782,130.3333333,1360717769810,1360717770130,1139152738,1139153058,320
1360717796,1139178160,2,381,190.5,1360717770067,1360717770195,1139152227,1139152355,128
1360717836,1139218308,2,130,65,1360717810046,1360717810366,1139192354,1139192674,320
1360717876,1139258260,2,130,65,1360717850090,1360717851114,1139232350,1139233374,1024
1360717916,1139298480,2,130,65,1360717889869,1360717891341,1139272349,1139273821,1472
1360717956,1139338496,2,130,65,1360717929855,1360717931839,1139312351,1139314335,1984
1360717996,1139378652,2,130,65,1360717969700,1360717972068,1139352352,1139354720,2368
1360718016,1139398740,3,152,50.66666667,1360717990988,1360717992396,1139373728,1139375136,1408
1360718016,1139398844,3,152,50.66666667,1360717989794,1360717991138,1139372638,1139373982,1344
1360718020,1139402760,3,152,50.66666667,1360717992052,1360717993460,1139374812,1139376220,1408
1360718020,1139402760,2,104,52,1360717992052,1360717995060,1139374812,1139377820,3008
1360718037,1139419048,2,130,65,1360718010302,1360718013310,1139392350,1139395358,3008
1360718060,1139442972,3,408,136,1360718035489,1360718041505,1139418461,1139424477,6016
1360718076,1139458944,2,130,65,1360718049404,1360718052988,1139432348,1139435932,3584
1360718077,1139458980,1,148,148,1360718051457,1360718051457,1139433437,1139433437,0
1360718117,1139499128,2,130,65,1360718090219,1360718094571,1139472347,1139476699,4352
1360718141,1139523136,1,46,46,1360718113828,1360718113828,1139495964,1139495964,0
1360718157,1139539180,2,130,65,1360718130166,1360718135222,1139512346,1139517402,5056
1360718185,1139567724,1,46,46,1360718159833,1360718159833,1139542557,1139542557,0
1360718186,1139568360,1,46,46,1360718160132,1360718160132,1139542492,1139542492,0
1360718197,1139579072,2,130,65,1360718170274,1360718175906,1139552346,1139557978,5632
1360718237,1139619472,2,130,65,1360718209875,1360718216083,1139592347,1139598555,6208
1360718277,1139659508,2,130,65,1360718249837,1360718256493,1139632345,1139639001,6656
1360718309,1139691488,1,60,60,1360718284739,1360718284739,1139667227,1139667227,0
1360718317,1139699512,2,130,65,1360718289833,1360718296937,1139672345,1139679449,7104
1360718357,1139739720,2,130,65,1360718329625,1360718337113,1139712345,1139719833,7488
1360718397,1139779616,2,130,65,1360718369729,1360718377857,1139752345,1139760473,8128
1360718437,1139819744,2,130,65,1360718409599,1360718418175,1139792343,1139800919,8576
1360718477,1139859760,2,130,65,1360718449581,1360718458733,1139832341,1139841493,9152
1360718517,1139899668,2,130,65,1360718489676,1360718499276,1139872344,1139881944,9600
1360718557,1139939828,2,130,65,1360718529514,1360718539562,1139912342,1139922390,10048
1360718597,1139979880,2,130,65,1360718569460,1360718579956,1139952340,1139962836,10496
1360718637,1140019744,2,130,65,1360718609597,1360718620669,1139992341,1140003413,11072
1360718641,1140023908,1,46,46,1360718615129,1360718615129,1139998037,1139998037,0
1360718673,1140055860,3,408,136,1360718645961,1360718652041,1140028821,1140034901,6080
1360718677,1140059836,2,130,65,1360718649503,1360718661151,1140032339,1140043987,11648
1360718718,1140100104,2,130,65,1360718690233,1360718702585,1140072337,1140084689,12352
1360718758,1140140240,2,130,65,1360718730098,1360718743026,1140112338,1140125266,12928
1360718783,4073445376,1,46,46,1360718755956,1360718755956,4073418332,4073418332,0
1360718798,1140180156,2,130,65,1360718770181,1360718783557,1140152337,1140165713,13376
1360718838,1140220184,2,130,65,1360718810151,1360718824295,1140192335,1140206479,14144
1360718878,1140260180,2,130,65,1360718850158,1360718865006,1140232338,1140247186,14848
1360718918,1140300208,2,130,65,1360718890129,1360718905553,1140272337,1140287761,15424
1360718958,1140340252,2,130,65,1360718930084,1360718946020,1140312336,1140328272,15936
1360718998,1140380380,2,130,65,1360718969954,1360718986530,1140352334,1140368910,16576
1360719038,1140420372,2,130,65,1360719009964,1360719027180,1140392336,1140409552,17216
1360719078,1140460560,2,130,65,1360719051311,1360719067567,1140433871,1140450127,16256
1360719099,4073761672,1,52,52,1360719073615,1360719073615,4073736287,4073736287,0
1360719118,1140500556,2,130,65,1360719089778,1360719108146,1140472334,1140490702,18368
1360719154,1140536584,2,130,65,1360719129750,1360719148694,1140512334,1140531278,18944
1360719167,1140549092,12,999,83.25,1360719152064,1360719159168,1140534156,1140541260,7104
1360719167,1140549160,17,6755,397.3529412,1360719151612,1360719159164,1140533772,1140541324,7552
1360719167,1140549168,12,999,83.25,1360719152245,1360719159093,1140534413,1140541261,6848
1360719174,1140556588,1,64,64,1360719148177,1360719148177,1140530765,1140530765,0
1360719174,1140556588,1,64,64,1360719148367,1360719148367,1140530955,1140530955,0
1360719174,1140556708,1,64,64,1360719148250,1360719148250,1140530958,1140530958,0
1360719174,1140556708,1,64,64,1360719148567,1360719148567,1140531275,1140531275,0
1360719194,1140576628,9,861,95.66666667,1360719167206,1360719167398,1140549834,1140550026,192
1360719194,1140576636,9,861,95.66666667,1360719167776,1360719167968,1140550412,1140550604,192
1360719194,1140576640,2,130,65,1360719169690,1360719189210,1140552330,1140571850,19520
1360719194,1140576760,8,815,101.875,1360719167394,1360719167522,1140550154,1140550282,128
1360719194,1140576768,8,815,101.875,1360719167901,1360719168093,1140550669,1140550861,192
1360719235,1140617128,2,130,65,1360719210203,1360719230299,1140592331,1140612427,20096
1360719275,1140657096,2,130,65,1360719250233,1360719270841,1140632329,1140652937,20608
1360719283,1140665232,3,408,136,1360719258227,1360719264243,1140640459,1140646475,6016
1360719315,1140697192,2,130,65,1360719290139,1360719311195,1140672331,1140693387,21056
1360719355,1140737336,2,130,65,1360719329994,1360719351882,1140712330,1140734218,21888
1360719391,1140773312,3,408,136,1360719363041,1360719369057,1140745353,1140751369,6016
1360719395,1140777404,2,130,65,1360719369923,1360719392387,1140752327,1140774791,22464
1360719415,1140797640,4,252,63,1360719406810,1360719413914,1140789450,1140796554,7104
1360719415,1140797644,4,252,63,1360719406807,1360719413847,1140789451,1140796491,7040
1360719435,1140817420,2,130,65,1360719409907,1360719432883,1140792327,1140815303,22976
1360719439,1140821732,4,252,63,1360719430651,1360719437691,1140813383,1140820423,7040
1360719447,1140829652,1,63,63,1360719421901,1360719421901,1140804553,1140804553,0
1360719447,1140829768,1,63,63,1360719421784,1360719421784,1140804552,1140804552,0
1360719471,1140853748,1,63,63,1360719445739,1360719445739,1140828487,1140828487,0
1360719471,1140853828,3,189,63,1360719465371,1360719468443,1140848199,1140851271,3072
1360719475,1140857576,2,130,65,1360719449751,1360719473367,1140832327,1140855943,23616
1360719487,1140869916,2,126,63,1360719472388,1360719480452,1140855304,1140863368,8064
1360719515,1140897764,2,130,65,1360719489562,1360719513562,1140872326,1140896326,24000
1360719555,1140937892,2,130,65,1360719529498,1360719554138,1140912390,1140937030,24640
1360719595,1140977940,1,52,52,1360719569384,1360719569384,1140952324,1140952324,0
1360719623,1141005928,2,130,65,1360719594807,1360719609463,1140977735,1140992391,14656
1360719663,1141045880,2,130,65,1360719635619,1360719649507,1141018499,1141032387,13888
1360719704,1141086476,2,130,65,1360719676664,1360719689912,1141059140,1141072388,13248
1360719736,1141118628,18,6801,377.8333333,1360719717534,1360719728094,1141100162,1141110722,10560
1360719736,1141118632,12,999,83.25,1360719718172,1360719728092,1141100804,1141110724,9920
1360719736,1141118704,11,953,86.63636364,1360719717844,1360719728020,1141100548,1141110724,10176
1360719736,1141118708,12,999,83.25,1360719718351,1360719728015,1141101059,1141110723,9664
1360719740,4074402060,5,573,114.6,1360719732789,1360719732853,4074394849,4074394913,64
1360719744,1141126300,2,130,65,1360719717223,1360719730087,1141099523,1141112387,12864
1360719784,1141166452,2,130,65,1360719757648,1360719769936,1141140100,1141152388,12288
1360719824,1141206492,2,130,65,1360719798183,1360719809895,1141180675,1141192387,11712
1360719852,1141234540,3,417,139,1360719826741,1360719832757,1141209281,1141215297,6016
1360719864,1141246428,2,130,65,1360719839014,1360719849958,1141221442,1141232386,10944
1360719896,1141278380,3,408,136,1360719868439,1360719874519,1141250819,1141256899,6080
1360719904,1141286588,2,130,65,1360719879428,1360719889796,1141262016,1141272384,10368
1360719948,1141330580,2,130,65,1360719920014,1360719929806,1141302594,1141312386,9792
1360719988,1141370700,2,130,65,1360719960532,1360719969684,1141343232,1141352384,9152
1360720028,1141410784,2,130,65,1360720000895,1360720009599,1141383679,1141392383,8704
1360720068,1141450840,2,130,65,1360720041350,1360720049542,1141424190,1141432382,8192
1360720108,1141490760,2,130,65,1360720082262,1360720089622,1141465022,1141472382,7360
1360720148,1141530852,2,130,65,1360720122744,1360720129528,1141505596,1141512380,6784
1360720189,1141571288,2,130,65,1360720163757,1360720170093,1141546045,1141552381,6336
1360720229,1141611272,2,130,65,1360720204284,1360720210108,1141586556,1141592380,5824
1360720273,1141655092,2,130,65,1360720244910,1360720250286,1141627002,1141632378,5376
1360720313,1141695276,2,130,65,1360720285622,1360720290102,1141667898,1141672378,4480
1360720349,1141731612,3,417,139,1360720321512,1360720327592,1141704124,1141710204,6080
1360720353,1141735752,2,130,65,1360720325723,1360720329627,1141708475,1141712379,3904
1360720377,1141759524,2,122,61,1360720349119,1360720351487,1141731643,1141734011,2368
1360720393,1141775796,2,130,65,1360720366189,1360720369581,1141748985,1141752377,3392
1360720433,1141815808,2,130,65,1360720406626,1360720409570,1141789434,1141792378,2944
1360720473,1141855672,2,130,65,1360720447207,1360720449703,1141829879,1141832375,2496
1360720473,1141855692,3,402,134,1360720447124,1360720453140,1141829816,1141835832,6016
1360720514,1141896148,2,130,65,1360720488307,1360720490227,1141870455,1141872375,1920
1360720554,1141935996,2,130,65,1360720528972,1360720530380,1141910968,1141912376,1408
1360720590,1141972616,2,130,65,1360720569119,1360720569759,1141951735,1141952375,640
1360720634,1142016260,1,439,439,1360720609604,1360720609604,1141991864,1141991864,0
1360720637,1142019940,2,130,65,1360720609433,1360720609433,1141992373,1141992373,0
1360720642,1142024344,1,441,441,1360720615405,1360720615405,1141997749,1141997749,0
1360720677,1142059896,2,130,65,1360720649477,1360720650117,1142032373,1142033013,640
1360720718,1142100152,2,130,65,1360720690220,1360720691436,1142072372,1142073588,1216
1360720758,1142140176,2,130,65,1360720730196,1360720732052,1142112372,1142114228,1856
1360720798,1142180200,2,130,65,1360720770172,1360720772604,1142152372,1142154804,2432
1360720838,1142220220,2,130,65,1360720810150,1360720812966,1142192370,1142195186,2816
1360720878,1142260408,2,130,65,1360720849963,1360720853355,1142232371,1142235763,3392
1360720918,1142300428,2,130,65,1360720889942,1360720893782,1142272370,1142276210,3840
1360720958,1142340360,2,130,65,1360720930010,1360720934554,1142312370,1142316914,4544
1360720994,1142376676,2,130,65,1360720969695,1360720974751,1142352371,1142357427,5056
1360721035,1142417004,2,130,65,1360721010366,1360721015870,1142392370,1142397874,5504
1360721075,1142457040,2,130,65,1360721050329,1360721056409,1142432369,1142438449,6080
1360721114,1142496904,2,130,65,1360721089465,1360721096121,1142472369,1142479025,6656
1360721134,1142516840,3,414,138,1360721109816,1360721115832,1142492656,1142498672,6016
1360721155,1142537416,2,130,65,1360721129950,1360721137118,1142512366,1142519534,7168
1360721195,1142577380,2,130,65,1360721169988,1360721177732,1142552368,1142560112,7744
1360721199,1142581268,13,6234,479.5384615,1360721172209,1360721172529,1142554477,1142554797,320
1360721199,1142581276,9,861,95.66666667,1360721172649,1360721172777,1142554925,1142555053,128
1360721199,1142581280,9,861,95.66666667,1360721172903,1360721173031,1142555183,1142555311,128
1360721199,1142581284,8,815,101.875,1360721173152,1360721173344,1142555436,1142555628,192
1360721223,1142605452,3,402,134,1360721197371,1360721203387,1142579823,1142585839,6016
1360721235,1142617292,3,519,173,1360721207835,1360721213787,1142590127,1142596079,5952
1360721235,1142617568,2,130,65,1360721209798,1360721218118,1142592366,1142600686,8320
1360721275,1142657380,2,130,65,1360721249984,1360721259072,1142632364,1142641452,9088
1360721275,1142657500,3,528,176,1360721249608,1360721255560,1142632108,1142638060,5952
1360721315,1142697856,2,130,65,1360721289506,1360721299490,1142672362,1142682346,9984
1360721355,1142737736,2,130,65,1360721329629,1360721340317,1142712365,1142723053,10688
1360721396,1142777964,2,130,65,1360721370397,1360721381533,1142752361,1142763497,11136
1360721404,1142786124,3,189,63,1360721400445,1360721403453,1142782569,1142785577,3008
1360721420,1142802032,2,126,63,1360721407579,1360721415643,1142789611,1142797675,8064
1360721435,1142817960,2,130,65,1360721409401,1360721421049,1142792361,1142804009,11648
1360721452,1142834100,2,126,63,1360721450455,1360721451479,1142832555,1142833579,1024
1360721452,1142834176,2,126,63,1360721450376,1360721451400,1142832552,1142833576,1024
1360721460,1142842428,2,126,63,1360721453135,1360721457167,1142835563,1142839595,4032
1360721460,1142842428,2,126,63,1360721453135,1360721457167,1142835563,1142839595,4032
1360721476,1142858092,2,130,65,1360721450270,1360721462878,1142832362,1142844970,12608
1360721492,1142874320,1,63,63,1360721465336,1360721465336,1142847656,1142847656,0
1360721492,1142874320,1,63,63,1360721465336,1360721465336,1142847656,1142847656,0
1360721492,1142874448,3,189,63,1360721486457,1360721489529,1142868905,1142871977,3072
1360721508,1142890508,2,126,63,1360721493500,1360721501500,1142876008,1142884008,8000
1360721516,1142898188,2,130,65,1360721490172,1360721503356,1142872360,1142885544,13184
1360721556,1142938404,2,130,65,1360721529957,1360721543589,1142912361,1142925993,13632
1360721596,1142978416,2,130,65,1360721569944,1360721584024,1142952360,1142966440,14080
1360721636,1143018516,2,130,65,1360721609841,1360721624497,1142992357,1143007013,14656
1360721664,1143046576,6,384,64,1360721638200,1360721643896,1143020776,1143026472,5696
1360721664,1143046660,6,384,64,1360721636578,1360721642402,1143019238,1143025062,5824
1360721676,1143058692,2,130,65,1360721649665,1360721664769,1143032357,1143047461,15104
1360721716,1143098628,2,130,65,1360721689728,1360721705280,1143072356,1143087908,15552
1360721756,1143138704,2,130,65,1360721729653,1360721745717,1143112357,1143128421,16064
1360721797,1143179156,2,130,65,1360721770203,1360721786715,1143152359,1143168871,16512
1360721837,1143219224,2,130,65,1360721810131,1360721827155,1143192355,1143209379,17024
1360721877,1143259136,2,130,65,1360721850218,1360721867690,1143232354,1143249826,17472
1360721917,1143299184,2,130,65,1360721890172,1360721908156,1143272356,1143290340,17984
1360721957,1143339808,2,130,65,1360721929547,1360721948107,1143312355,1143330915,18560
1360721997,1143379880,2,130,65,1360721969475,1360721988611,1143352355,1143371491,19136
1360722037,1143419788,2,130,65,1360722009565,1360722029405,1143392353,1143412193,19840
1360722077,1143459868,2,130,65,1360722049487,1360722069839,1143432355,1143452707,20352
1360722114,1143495996,1,60,60,1360722088435,1360722088435,1143470431,1143470431,0
1360722114,1143496000,1,60,60,1360722088558,1360722088558,1143470558,1143470558,0
1360722114,1143496024,1,60,60,1360722088662,1360722088662,1143470686,1143470686,0
1360722114,1143496116,1,60,60,1360722088573,1360722088573,1143470689,1143470689,0
1360722118,1143500080,2,130,65,1360722090273,1360722111201,1143472353,1143493281,20928
1360722146,1143528100,1,60,60,1360722118795,1360722118795,1143500895,1143500895,0
1360722153,1143535960,3,405,135,1360722124975,1360722130991,1143507935,1143513951,6016
1360722158,1143540048,2,130,65,1360722130302,1360722151934,1143512350,1143533982,21632
1360722198,1143580088,2,130,65,1360722170261,1360722192341,1143552349,1143574429,22080
1360722238,1143620504,2,130,65,1360722209845,1360722232437,1143592349,1143614941,22592
1360722278,1143660360,2,130,65,1360722249990,1360722273094,1143632350,1143655454,23104
1360722318,1143700380,2,130,65,1360722289969,1360722313585,1143672349,1143695965,23616
1360722358,1143740484,2,130,65,1360722329862,1360722354118,1143712346,1143736602,24256
1360722394,1143776788,1,52,52,1360722369561,1360722369561,1143752349,1143752349,0
1360722394,1143776868,3,152,50.66666667,1360722367816,1360722371464,1143750684,1143754332,3648
1360722394,1143776912,3,152,50.66666667,1360722365595,1360722369243,1143748507,1143752155,3648
1360722394,1143776960,3,152,50.66666667,1360722366635,1360722370219,1143749595,1143753179,3584
1360722395,1143777000,2,104,52,1360722368685,1360722371693,1143750685,1143753693,3008
1360722422,1143804908,2,130,65,1360722394272,1360722409440,1143777180,1143792348,15168
1360722459,1143841284,1,46,46,1360722433424,1360722433424,1143815708,1143815708,0
1360722463,1143845120,2,130,65,1360722435700,1360722450228,1143817820,1143832348,14528
1360722491,1143873120,1,148,148,1360722463024,1360722463024,1143845144,1143845144,0
1360722503,1143885220,4,286,71.5,1360722476173,1360722490125,1143858393,1143872345,13952
1360722543,1143925380,2,130,65,1360722516588,1360722529964,1143898968,1143912344,13376
1360722583,1143965380,2,130,65,1360722557228,1360722569964,1143939608,1143952344,12736
1360722623,1144005436,2,130,65,1360722597618,1360722609906,1143980054,1143992342,12288
1360722663,1144045600,2,130,65,1360722638030,1360722649742,1144020630,1144032342,11712
1360722707,1144089708,2,130,65,1360722678565,1360722689637,1144061273,1144072345,11072
1360722747,1144129544,2,130,65,1360722719239,1360722729799,1144101783,1144112343,10560
1360722787,1144169564,2,130,65,1360722759728,1360722769776,1144142292,1144152340,10048
1360722827,1144209768,2,130,65,1360722800100,1360722809572,1144182868,1144192340,9472
1360722867,1144249760,2,130,65,1360722840558,1360722849582,1144223318,1144232342,9024
1360722907,1144289924,2,130,65,1360722880838,1360722889414,1144263762,1144272338,8576
1360722948,1144330008,2,130,65,1360722922205,1360722930333,1144304213,1144312341,8128
1360722987,1144369920,13,6234,479.5384615,1360722962121,1360722962441,1144345041,1144345361,320
1360722988,1144370044,2,130,65,1360722962616,1360722970296,1144344660,1144352340,7680
1360722988,1144370052,9,861,95.66666667,1360722963374,1360722963566,1144345426,1144345618,192
1360722991,1144373840,9,861,95.66666667,1360722962842,1360722963162,1144345682,1144346002,320
1360722991,1144373852,9,861,95.66666667,1360722963215,1360722963407,1144346067,1144346259,192
1360722991,1144373884,3,402,134,1360722965615,1360722971695,1144348499,1144354579,6080
1360723028,1144410108,2,130,65,1360723003000,1360723010232,1144385108,1144392340,7232
1360723068,1144450236,2,130,65,1360723043380,1360723050100,1144425616,1144432336,6720
1360723112,1144494188,2,130,65,1360723083940,1360723090148,1144466128,1144472336,6208
1360723152,1144534376,2,130,65,1360723124458,1360723129962,1144506834,1144512338,5504
1360723192,1144574304,2,130,65,1360723165104,1360723170032,1144547408,1144552336,4928
1360723198,1144580304,2,126,63,1360723196783,1360723197743,1144579087,1144580047,960
1360723206,1144588296,2,126,63,1360723199801,1360723203833,1144582097,1144586129,4032
1360723222,1144604316,4,252,63,1360723213220,1360723220324,1144595536,1144602640,7104
1360723232,1144614548,2,130,65,1360723205497,1360723209849,1144588045,1144592397,4352
1360723236,1144618696,1,63,63,1360723211496,1360723211496,1144594192,1144594192,0
1360723256,1144638460,1,63,63,1360723228177,1360723228177,1144610637,1144610637,0
1360723272,1144654512,2,130,65,1360723246175,1360723249887,1144628687,1144632399,3712
1360723302,1144684424,3,189,63,1360723296053,1360723299061,1144678477,1144681485,3008
1360723302,1144684632,2,126,63,1360723299367,1360723300327,1144681999,1144682959,960
1360723310,1144692528,2,126,63,1360723302479,1360723306511,1144685007,1144689039,4032
1360723312,1144694688,2,130,65,1360723286508,1360723289708,1144669196,1144672396,3200
1360723318,1144700476,2,126,63,1360723303043,1360723311107,1144685519,1144693583,8064
1360723340,1144722620,1,63,63,1360723314483,1360723314483,1144697103,1144697103,0
1360723352,1144734704,2,130,65,1360723327133,1360723329693,1144709837,1144712397,2560
1360723396,1144778792,2,130,65,1360723367813,1360723369605,1144750605,1144752397,1792
1360723436,1144818768,2,130,65,1360723408538,1360723409626,1144791306,1144792394,1088
1360723477,1144858968,2,130,65,1360723449852,1360723450428,1144831820,1144832396,576
1360723516,1144898872,2,130,65,1360723489458,1360723489522,1144872330,1144872394,64
1360723556,1144938912,2,130,65,1360723529484,1360723529868,1144912396,1144912780,384
1360723597,1144979064,2,130,65,1360723570329,1360723571161,1144952393,1144953225,832
1360723637,1145018968,2,130,65,1360723610424,1360723611768,1144992392,1144993736,1344
1360723677,1145058980,2,130,65,1360723650413,1360723652269,1145032393,1145034249,1856
1360723717,1145099384,2,130,65,1360723690006,1360723692566,1145072390,1145074950,2560
1360723733,1145115348,1,46,46,1360723708346,1360723708346,1145090694,1145090694,0
1360723733,1145115500,1,46,46,1360723708451,1360723708451,1145090951,1145090951,0
1360723757,1145139404,2,130,65,1360723729989,1360723732997,1145112393,1145115401,3008
1360723797,1145179604,2,130,65,1360723769785,1360723773369,1145152389,1145155973,3584
1360723837,1145219432,2,130,65,1360723809957,1360723814245,1145192389,1145196677,4288
1360723877,1145259700,2,130,65,1360723849688,1360723854360,1145232388,1145237060,4672
1360723917,1145299780,2,130,65,1360723889608,1360723894856,1145272388,1145277636,5248
1360723957,1145339928,2,130,65,1360723929461,1360723935221,1145312389,1145318149,5760
1360723998,1145379988,2,130,65,1360723970401,1360723976737,1145352389,1145358725,6336
1360724038,1145420400,2,130,65,1360724009987,1360724016835,1145392387,1145399235,6848
1360724078,1145460388,2,130,65,1360724049999,1360724057295,1145432387,1145439683,7296
1360724118,1145500180,2,130,65,1360724090205,1360724098077,1145472385,1145480257,7872
1360724158,1145540336,2,130,65,1360724130049,1360724138433,1145512385,1145520769,8384
1360724198,1145580464,2,130,65,1360724169921,1360724178945,1145552385,1145561409,9024
1360724238,1145620360,2,130,65,1360724210025,1360724219497,1145592385,1145601857,9472
1360724278,1145660392,2,130,65,1360724249992,1360724259848,1145632384,1145642240,9856
1360724314,1145696792,2,130,65,1360724289589,1360724300021,1145672381,1145682813,10432
1360724354,1145736828,2,130,65,1360724329555,1360724340499,1145712383,1145723327,10944
1360724394,1145776852,2,130,65,1360724369531,1360724381115,1145752383,1145763967,11584
1360724418,1145800692,3,531,177,1360724391513,1360724397465,1145774205,1145780157,5952
1360724434,1145816760,2,130,65,1360724409621,1360724421589,1145792381,1145804349,11968
1360724474,1145856764,2,130,65,1360724449617,1360724462033,1145832381,1145844797,12416
1360724514,1145896760,4,708,177,1360724488404,1360724512724,1145871164,1145895484,24320
1360724514,1145896896,2,130,65,1360724489484,1360724502476,1145872380,1145885372,12992
1360724543,1145925108,2,354,177,1360724515359,1360724519391,1145897467,1145901499,4032
1360724555,1145937200,2,130,65,1360724530178,1360724543682,1145912378,1145925882,13504
1360724595,1145977436,2,130,65,1360724569941,1360724583957,1145952377,1145966393,14016
1360724635,1146017284,3,408,136,1360724607343,1360724613423,1145989627,1145995707,6080
1360724635,1146017364,2,130,65,1360724610016,1360724624800,1145992380,1146007164,14784
1360724675,1146057412,2,130,65,1360724649964,1360724665324,1146032376,1146047736,15360
1360724715,1146097872,2,130,65,1360724689505,1360724705377,1146072377,1146088249,15872
1360724755,1146137800,2,130,65,1360724729578,1360724746090,1146112378,1146128890,16512
1360724779,1146161796,9,861,95.66666667,1360724752622,1360724752814,1146135418,1146135610,192
1360724779,1146161804,8,815,101.875,1360724753189,1360724753317,1146135993,1146136121,128
1360724779,1146161924,9,861,95.66666667,1360724752748,1360724752940,1146135672,1146135864,192
1360724795,1146177844,2,130,65,1360724769531,1360724786555,1146152375,1146169399,17024
1360724828,1146210072,3,152,50.66666667,1360724802752,1360724803968,1146184824,1146186040,1216
1360724831,1146213904,3,152,50.66666667,1360724803006,1360724804286,1146185910,1146187190,1280
1360724831,1146213920,3,152,50.66666667,1360724804078,1360724813102,1146186998,1146196022,9024
1360724831,1146213940,3,152,50.66666667,1360724804059,1360724805403,1146186999,1146188343,1344
1360724836,1146218104,2,130,65,1360724810271,1360724827871,1146192375,1146209975,17600
1360724876,1146258092,2,130,65,1360724850283,1360724868331,1146232375,1146250423,18048
1360724916,1146298152,2,130,65,1360724890221,1360724908845,1146272373,1146290997,18624
1360724956,1146338196,2,130,65,1360724930178,1360724949250,1146312374,1146331446,19072
1360724984,1146366544,2,126,63,1360724981028,1360724982052,1146363572,1146364596,1024
1360724992,1146374936,2,126,63,1360724983646,1360724987678,1146366582,1146370614,4032
1360724996,1146378524,2,130,65,1360724969847,1360724989367,1146352371,1146371891,19520
1360725024,1146406832,1,63,63,1360724995843,1360724995843,1146378675,1146378675,0
1360725032,1146414636,3,138,46,1360725024326,1360725024390,1146406962,1146407026,64
1360725032,1146414712,2,92,46,1360725024315,1360725024315,1146407027,1146407027,0
1360725032,1146414716,3,138,46,1360725024314,1360725024378,1146407030,1146407094,64
1360725036,1146418676,2,130,65,1360725009696,1360725029664,1146392372,1146412340,19968
1360725052,1146434544,8,815,101.875,1360725025509,1360725025701,1146408053,1146408245,192
1360725052,1146434544,8,815,101.875,1360725025763,1360725025955,1146408307,1146408499,192
1360725052,1146434576,8,815,101.875,1360725026245,1360725026437,1146408821,1146409013,192
1360725052,1146434620,3,402,134,1360725023896,1360725029912,1146406516,1146412532,6016
1360725052,1146434696,9,861,95.66666667,1360725025866,1360725026058,1146408562,1146408754,192
1360725076,1146458644,2,130,65,1360725049727,1360725070463,1146432371,1146453107,20736
1360725116,1146498836,2,130,65,1360725089536,1360725110848,1146472372,1146493684,21312
1360725157,1146539088,2,130,65,1360725130284,1360725152172,1146512372,1146534260,21888
1360725197,1146578976,2,130,65,1360725170392,1360725192856,1146552368,1146574832,22464
1360725216,1146598616,2,126,63,1360725213720,1360725214744,1146596336,1146597360,1024
1360725224,1146606624,2,126,63,1360725216787,1360725220819,1146599411,1146603443,4032
1360725237,1146619100,2,130,65,1360725210268,1360725233436,1146592368,1146615536,23168
1360725240,1146622708,3,189,63,1360725233149,1360725236157,1146615857,1146618865,3008
1360725256,1146638600,2,126,63,1360725240296,1360725248360,1146622896,1146630960,8064
1360725257,1146639124,1,63,63,1360725229381,1360725229381,1146611505,1146611505,0
1360725264,1146646676,4,252,63,1360725255709,1360725262749,1146638385,1146645425,7040
1360725277,1146659072,2,130,65,1360725250296,1360725273912,1146632368,1146655984,23616
1360725297,1146679124,1,63,63,1360725271365,1360725271365,1146653489,1146653489,0
1360725317,1146699496,2,130,65,1360725289870,1360725314254,1146672366,1146696750,24384
1360725352,1146734800,2,126,63,1360725350687,1360725351647,1146733487,1146734447,960
1360725357,1146739616,2,130,65,1360725329751,1360725354583,1146712367,1146737199,24832
1360725360,1146742696,2,126,63,1360725353798,1360725357830,1146736494,1146740526,4032
1360725389,1146771496,3,537,179,1360725363341,1360725369357,1146745837,1146751853,6016
1360725393,1146775640,1,63,63,1360725365950,1360725365950,1146748590,1146748590,0
1360725397,1146779592,2,130,65,1360725369774,1360725395310,1146752366,1146777902,25536
1360725437,1146819508,2,130,65,1360725409856,1360725435968,1146792364,1146818476,26112
1360725478,1146860624,1,46,46,1360725449868,1360725449868,1146832492,1146832492,0
1360725478,1146860680,1,46,46,1360725449877,1360725449877,1146832557,1146832557,0
1360725479,1146861564,2,130,65,1360725449800,1360725476488,1146832364,1146859052,26688
1360725517,1146899864,2,130,65,1360725489503,1360725516639,1146872367,1146899503,27136
1360725557,1146939920,1,52,52,1360725529445,1360725529445,1146912365,1146912365,0
1360725585,1146967932,2,130,65,1360725557015,1360725569431,1146939947,1146952363,12416
1360725626,1147008340,2,130,65,1360725598119,1360725610023,1146980459,1146992363,11904
1360725642,1147024456,1,46,46,1360725617651,1360725617651,1147000107,1147000107,0
1360725644,1147026020,1,46,46,1360725618089,1360725618089,1147000109,1147000109,0
1360725666,1147048540,2,130,65,1360725638367,1360725649823,1147020907,1147032363,11456
1360725681,1147063492,1,48,48,1360725651215,1360725651215,1147033707,1147033707,0
1360725681,1147063528,1,48,48,1360725651242,1360725651242,1147033770,1147033770,0
1360725706,1147088492,2,130,65,1360725678863,1360725689871,1147061355,1147072363,11008
1360725746,1147128576,2,130,65,1360725719227,1360725729787,1147101803,1147112363,10560
1360725786,1147168856,2,130,65,1360725759456,1360725769504,1147142312,1147152360,10048
1360725826,1147208944,2,130,65,1360725799816,1360725809416,1147182760,1147192360,9600
1360725866,1147248916,2,130,65,1360725840291,1360725849443,1147223207,1147232359,9152
1360725907,1147289000,2,130,65,1360725881593,1360725890361,1147263593,1147272361,8768
1360725947,1147329408,2,130,65,1360725921567,1360725929951,1147303975,1147312359,8384
1360725959,1147341304,3,402,134,1360725934470,1360725940486,1147316774,1147322790,6016
1360725987,1147369376,2,130,65,1360725962174,1360725969982,1147344550,1147352358,7808
1360726009,1147391012,6,983,163.8333333,1360726007913,1360726008169,1147389925,1147390181,256
1360726009,1147391016,6,782,130.3333333,1360726008165,1360726008485,1147390181,1147390501,320
1360726027,1147409464,4,1552,388,1360726002532,1360726009892,1147384996,1147392356,7360
1360726067,1147449648,2,859,429.5,1360726041965,1360726049709,1147424613,1147432357,7744
1360726107,1147489928,2,130,65,1360726081940,1360726089428,1147464868,1147472356,7488
1360726148,1147530220,3,1679,559.6666667,1360726120921,1360726135897,1147503141,1147518117,14976
1360726171,1147553940,1,148,148,1360726143432,1360726143432,1147526372,1147526372,0
1360726196,1147578004,3,957,319,1360726170352,1360726194416,1147552356,1147576420,24064
1360726236,1147618144,2,130,65,1360726210209,1360726235233,1147592353,1147617377,25024
1360726276,1147658232,1,52,52,1360726250120,1360726250120,1147632352,1147632352,0
1360726304,1147686292,2,130,65,1360726275851,1360726290059,1147658143,1147672351,14208
1360726344,1147726340,2,130,65,1360726316317,1360726330013,1147698657,1147712353,13696
1360726384,1147766296,2,130,65,1360726356745,1360726370057,1147739041,1147752353,13312
1360726424,1147806592,2,130,65,1360726396895,1360726409759,1147779487,1147792351,12864
1360726464,1147846756,2,130,65,1360726437244,1360726449596,1147820000,1147832352,12352
1360726504,1147886672,2,130,65,1360726477900,1360726489676,1147860572,1147872348,11776
1360726545,1147927008,2,130,65,1360726519077,1360726530341,1147901085,1147912349,11264
1360726545,1147927456,43,52141,1212.581395,1360726542118,1360726543910,1147924574,1147926366,1792
1360726569,1147951056,14,6617,472.6428571,1360726542519,1360726542903,1147924575,1147924959,384
1360726569,1147951060,8,815,101.875,1360726543216,1360726543472,1147925276,1147925532,256
1360726569,1147951184,9,861,95.66666667,1360726542835,1360726543027,1147925019,1147925211,192
1360726569,1147951220,14,6617,472.6428571,1360726543376,1360726543696,1147925596,1147925916,320
1360726585,1147967112,3,937,312.3333333,1360726559486,1360726578942,1147941598,1147961054,19456
1360726637,1148019112,2,130,65,1360726610237,1360726619901,1147992349,1148002013,9664
1360726649,1148031120,1,148,148,1360726623286,1360726623286,1148005406,1148005406,0
1360726677,1148059124,2,130,65,1360726650224,1360726660272,1148032348,1148042396,10048
1360726717,1148099324,2,130,65,1360726690024,1360726700520,1148072348,1148082844,10496
1360726745,1148127740,3,189,63,1360726738884,1360726741892,1148121624,1148124632,3008
1360726757,1148139232,2,130,65,1360726730177,1360726741185,1148112409,1148123417,11008
1360726761,1148143740,2,126,63,1360726745926,1360726753990,1148128666,1148136730,8064
1360726777,1148159772,3,189,63,1360726770022,1360726773030,1148152794,1148155802,3008
1360726777,1148159772,3,189,63,1360726770149,1360726773221,1148152921,1148155993,3072
1360726793,1148175740,2,126,63,1360726777092,1360726785156,1148159832,1148167896,8064
1360726793,1148175744,2,126,63,1360726777282,1360726785282,1148160026,1148168026,8000
1360726797,1148179288,2,130,65,1360726770122,1360726781642,1148152410,1148163930,11520
1360726837,1148219352,2,130,65,1360726810057,1360726822089,1148192409,1148204441,12032
1360726877,1148259416,2,130,65,1360726849991,1360726862599,1148232407,1148245015,12608
1360726917,1148299588,2,130,65,1360726889820,1360726903068,1148272408,1148285656,13248
1360726957,1148339520,2,130,65,1360726929889,1360726943649,1148312409,1148326169,13760
1360726962,1148344004,3,189,63,1360726955042,1360726958114,1148337046,1148340118,3072
1360726978,1148360024,2,126,63,1360726962126,1360726970190,1148344150,1148352214,8064
1360726997,1148379680,2,130,65,1360726969728,1360726984064,1148352408,1148366744,14336
1360727037,1148419584,2,130,65,1360727009821,1360727024669,1148392405,1148407253,14848
1360727078,1148460044,2,130,65,1360727050363,1360727065659,1148432407,1148447703,15296
1360727117,1148499960,2,130,65,1360727089443,1360727105187,1148472403,1148488147,15744
1360727158,1148540136,2,130,65,1360727130268,1360727146396,1148512404,1148528532,16128
1360727198,1148580172,2,130,65,1360727170230,1360727186742,1148552402,1148568914,16512
1360727238,1148620336,2,130,65,1360727210067,1360727226963,1148592403,1148609299,16896
1360727278,1148660432,2,130,65,1360727249972,1360727267316,1148632404,1148649748,17344
1360727314,1148696672,2,130,65,1360727289731,1360727307523,1148672403,1148690195,17792
1360727354,1148736816,2,130,65,1360727329585,1360727347761,1148712401,1148730577,18176
1360727395,1148776996,2,130,65,1360727370405,1360727388965,1148752401,1148770961,18560
1360727435,1148817192,2,130,65,1360727410208,1360727429408,1148792400,1148811600,19200
1360727475,1148857052,2,130,65,1360727450349,1360727470381,1148832401,1148852433,20032
1360727515,1148897020,2,130,65,1360727490380,1360727510924,1148872400,1148892944,20544
1360727515,1148897144,2,120,60,1360727489680,1360727489680,1148871824,1148871824,0
1360727555,1148937560,2,130,65,1360727529840,1360727550832,1148912400,1148933392,20992
1360727595,1148977400,2,130,65,1360727569996,1360727591372,1148952396,1148973772,21376
1360727635,1149017440,2,130,65,1360727609956,1360727631652,1148992396,1149014092,21696
1360727675,1149057524,2,130,65,1360727649872,1360727671888,1149032396,1149054412,22016
1360727715,1149097936,2,130,65,1360727689461,1360727711861,1149072397,1149094797,22400
1360727756,1149138084,2,130,65,1360727730311,1360727753287,1149112395,1149135371,22976
1360727795,1149177912,2,130,65,1360727769483,1360727792907,1149152395,1149175819,23424
1360727807,1149189896,1,92,92,1360727780571,1360727780571,1149163467,1149163467,0
1360727811,1149193860,3,408,136,1360727784446,1360727790462,1149167306,1149173322,6016
1360727835,1149217932,2,130,65,1360727809463,1360727833527,1149192395,1149216459,24064
1360727876,1149257988,1,92,92,1360727848803,1360727848803,1149230791,1149230791,0
1360727876,1149258188,2,130,65,1360727850204,1360727874972,1149232392,1149257160,24768
1360727916,1149298280,2,130,65,1360727890111,1360727915391,1149272391,1149297671,25280
1360727956,1149338296,1,52,52,1360727930094,1360727930094,1149312390,1149312390,0
1360727984,1149366192,2,130,65,1360727956058,1360727970202,1149338250,1149352394,14144
1360728024,1149406200,2,130,65,1360727996430,1360728010190,1149378630,1149392390,13760
1360728064,1149446260,2,130,65,1360728036884,1360728050132,1149419144,1149432392,13248
1360728104,1149486196,2,130,65,1360728077458,1360728090194,1149459654,1149472390,12736
1360728144,1149526372,2,130,65,1360728117729,1360728130017,1149500101,1149512389,12288
1360728184,1149566716,2,130,65,1360728157897,1360728169673,1149540613,1149552389,11776
1360728224,1149606780,2,130,65,1360728198472,1360728209608,1149581252,1149592388,11136
1360728264,1149646820,2,130,65,1360728238817,1360728249569,1149621637,1149632389,10752
1360728304,1149686768,2,130,65,1360728279185,1360728289617,1149661953,1149672385,10432
1360728345,1149727136,2,130,65,1360728320331,1360728330251,1149702467,1149712387,9920
1360728356,1149738932,9,861,95.66666667,1360728331821,1360728332013,1149714753,1149714945,192
1360728357,1149739012,16,7741,483.8125,1360728331717,1360728331973,1149713729,1149713985,256
1360728357,1149739080,13,6234,479.5384615,1360728331970,1360728332290,1149714050,1149714370,320
1360728357,1149739196,9,861,95.66666667,1360728332301,1360728332493,1149714497,1149714689,192
1360728361,1149742960,8,815,101.875,1360728333114,1360728333306,1149715074,1149715266,192
1360728389,1149771132,2,130,65,1360728360844,1360728370252,1149742976,1149752384,9408
1360728429,1149811276,2,130,65,1360728401214,1360728410110,1149783490,1149792386,8896
1360728469,1149851132,2,130,65,1360728441868,1360728450252,1149824000,1149832384,8384
1360728509,1149891404,2,130,65,1360728482045,1360728489981,1149864449,1149872385,7936
1360728549,1149931676,2,130,65,1360728522348,1360728529708,1149905024,1149912384,7360
1360728549,1149931880,2,126,63,1360728546080,1360728547040,1149928960,1149929920,960
1360728557,1149939872,2,126,63,1360728549095,1360728553127,1149931967,1149935999,4032
1360728589,1149971688,1,63,63,1360728561376,1360728561376,1149944064,1149944064,0
1360728589,1149971724,2,130,65,1360728562683,1360728569659,1149945407,1149952383,6976
1360728589,1149971840,3,189,63,1360728585032,1360728588104,1149967872,1149970944,3072
1360728605,1149987912,2,126,63,1360728592061,1360728600125,1149974973,1149983037,8064
1360728629,1150011576,2,130,65,1360728603149,1360728609805,1149985725,1149992381,6656
1360728645,1150027564,3,408,136,1360728617305,1360728623321,1149999869,1150005885,6016
1360728646,1150027952,2,126,63,1360728644415,1360728645439,1150026367,1150027391,1024
1360728646,1150027952,2,126,63,1360728644414,1360728645438,1150026366,1150027390,1024
1360728654,1150036344,2,126,63,1360728647094,1360728651126,1150029438,1150033470,4032
1360728654,1150036344,2,126,63,1360728647029,1360728651061,1150029373,1150033405,4032
1360728670,1150052304,2,130,65,1360728643807,1360728650079,1150026111,1150032383,6272
1360728686,1150068228,1,63,63,1360728659240,1360728659240,1150041468,1150041468,0
1360728686,1150068232,1,63,63,1360728659237,1360728659237,1150041469,1150041469,0
1360728710,1150092180,2,130,65,1360728684376,1360728690200,1150066556,1150072380,5824
1360728750,1150132336,2,130,65,1360728724667,1360728730043,1150107003,1150112379,5376
1360728757,1150139920,3,189,63,1360728753142,1360728756150,1150136062,1150139070,3008
1360728774,1150155956,2,126,63,1360728761143,1360728769207,1150143099,1150151163,8064
1360728790,1150172300,2,130,65,1360728765280,1360728770080,1150147580,1150152380,4800
1360728805,1150187932,11,953,86.63636364,1360728792744,1360728804264,1150175676,1150187196,11520
1360728806,1150188012,12,999,83.25,1360728793086,1360728805182,1150175098,1150187194,12096
1360728806,1150188012,11,953,86.63636364,1360728793343,1360728805183,1150175355,1150187195,11840
1360728806,1150188016,11,953,86.63636364,1360728793916,1360728805180,1150175932,1150187196,11264
1360728822,1150204380,11,3267,297,1360728796240,1360728797200,1150178620,1150179580,960
1360728826,1150208352,1,48,48,1360728799403,1360728799403,1150181755,1150181755,0
1360728830,1150212308,2,130,65,1360728805784,1360728810072,1150188092,1150192380,4288
1360728874,1150256336,2,130,65,1360728846138,1360728850042,1150228474,1150232378,3904
1360728885,1150267964,3,193,64.33333333,1360728877572,1360728877572,1150260536,1150260536,0
1360728914,1150296484,2,130,65,1360728886308,1360728889892,1150268792,1150272376,3584
1360728954,1150336544,2,130,65,1360728926697,1360728929833,1150309241,1150312377,3136
1360728994,1150376856,2,130,65,1360728966768,1360728969520,1150349624,1150352376,2752
1360729034,1150416904,2,130,65,1360729007104,1360729009472,1150390008,1150392376,2368
1360729075,1150456940,2,130,65,1360729048642,1360729050434,1150430582,1150432374,1792
1360729114,1150496908,2,130,65,1360729088121,1360729089465,1150471029,1150472373,1344
1360729154,1150536900,2,130,65,1360729128516,1360729129476,1150511416,1150512376,960
1360729175,1150557144,1,64,64,1360729148660,1360729148660,1150530804,1150530804,0
1360729175,1150557172,1,64,64,1360729148827,1360729148827,1150530999,1150530999,0
1360729195,1150577040,2,130,65,1360729169756,1360729170332,1150551796,1150552372,576
1360729235,1150617156,2,130,65,1360729209959,1360729210215,1150592115,1150592371,256
1360729255,1150637000,3,408,136,1360729230212,1360729236228,1150612212,1150618228,6016
1360729255,1150637056,1,52,52,1360729230668,1360729230668,1150612724,1150612724,0
1360729255,1150637228,1,52,52,1360729229794,1360729229794,1150612022,1150612022,0
1360729259,1150641012,1,52,52,1360729231160,1360729231160,1150613172,1150613172,0
1360729259,1150641052,3,152,50.66666667,1360729232210,1360729241234,1150614262,1150623286,9024
1360729259,1150641064,1,52,52,1360729232967,1360729232967,1150615031,1150615031,0
1360729259,1150641092,1,48,48,1360729233642,1360729233642,1150615734,1150615734,0
1360729259,1150641140,1,48,48,1360729231290,1360729231290,1150613430,1150613430,0
1360729259,1150641144,1,52,52,1360729231669,1360729231669,1150613813,1150613813,0
1360729259,1150641168,1,52,52,1360729232091,1360729232091,1150614259,1150614259,0
1360729259,1150641176,1,48,48,1360729232404,1360729232404,1150614580,1150614580,0
1360729275,1150657256,2,130,65,1360729250116,1360729250308,1150632372,1150632564,192
1360729315,1150697168,2,130,65,1360729290203,1360729290779,1150672371,1150672947,576
1360729355,1150737328,2,130,65,1360729330042,1360729331066,1150712370,1150713394,1024
1360729395,1150777428,2,130,65,1360729369944,1360729371416,1150752372,1150753844,1472
1360729435,1150817404,2,130,65,1360729409965,1360729412013,1150792369,1150794417,2048
1360729475,1150857712,2,130,65,1360729449659,1360729451963,1150832371,1150834675,2304
1360729515,1150897644,2,130,65,1360729489726,1360729492414,1150872370,1150875058,2688
1360729555,1150937840,2,130,65,1360729529527,1360729532535,1150912367,1150915375,3008
1360729596,1150977948,2,130,65,1360729570420,1360729574004,1150952368,1150955952,3584
1360729636,1151018004,2,130,65,1360729610362,1360729614330,1150992366,1150996334,3968
1360729676,1151058156,2,130,65,1360729650211,1360729654627,1151032367,1151036783,4416
1360729716,1151098096,2,130,65,1360729690270,1360729695070,1151072366,1151077166,4800
1360729756,1151138160,2,130,65,1360729730207,1360729735327,1151112367,1151117487,5120
1360729796,1151178424,2,130,65,1360729769939,1360729775443,1151152363,1151157867,5504
1360729836,1151218464,2,130,65,1360729809899,1360729815915,1151192363,1151198379,6016
1360729868,1151250488,3,408,136,1360729841428,1360729847444,1151223916,1151229932,6016
1360729876,1151258496,2,130,65,1360729849868,1360729856332,1151232364,1151238828,6464
1360729916,1151298544,2,130,65,1360729889819,1360729896667,1151272363,1151279211,6848
1360729929,1151311064,1,46,46,1360729901177,1360729901177,1151283241,1151283241,0
1360729929,1151311588,1,46,46,1360729900462,1360729900462,1151283050,1151283050,0
1360729956,1151338780,2,130,65,1360729929582,1360729936878,1151312362,1151319658,7296
1360729996,1151378712,2,130,65,1360729969648,1360729977328,1151352360,1151360040,7680
1360730036,1151418628,2,130,65,1360730009734,1360730017862,1151392362,1151400490,8128
1360730076,1151458660,2,130,65,1360730049701,1360730058277,1151432361,1151440937,8576
1360730116,1151498700,2,130,65,1360730089661,1360730098621,1151472361,1151481321,8960
1360730156,1151538892,2,130,65,1360730129467,1360730138747,1151512359,1151521639,9280
1360730196,1151578892,2,130,65,1360730169466,1360730179258,1151552358,1151562150,9792
1360730237,1151619172,2,130,65,1360730210251,1360730220235,1151592423,1151602407,9984
1360730277,1151658964,2,130,65,1360730250459,1360730260699,1151632423,1151642663,10240
1360730309,1151691156,1,60,60,1360730283480,1360730283480,1151665636,1151665636,0
1360730317,1151698988,2,130,65,1360730290367,1360730300991,1151672355,1151682979,10624
1360730321,1151703008,1,60,60,1360730295790,1360730295790,1151677798,1151677798,0
1360730357,1151739144,2,130,65,1360730330275,1360730341155,1151712419,1151723299,10880
1360730397,1151779216,2,130,65,1360730370205,1360730381341,1151752421,1151763557,11136
1360730437,1151819196,2,130,65,1360730410224,1360730421808,1151792420,1151804004,11584
1360730477,1151859368,2,130,65,1360730450051,1360730462083,1151832419,1151844451,12032
1360730481,1151863220,3,408,136,1360730453525,1360730459541,1151835745,1151841761,6016
1360730517,1151899224,2,130,65,1360730490193,1360730502481,1151872417,1151884705,12288
1360730557,1151939384,2,130,65,1360730530035,1360730542707,1151912419,1151925091,12672
1360730597,1151979516,2,130,65,1360730569902,1360730583022,1151952418,1151965538,13120
1360730625,1152007696,9,861,95.66666667,1360730597431,1360730597623,1151980127,1151980319,192
1360730625,1152007780,11,4651,422.8181818,1360730596644,1360730596964,1151979424,1151979744,320
1360730625,1152007820,9,861,95.66666667,1360730597051,1360730597243,1151979871,1151980063,192
1360730625,1152007848,9,861,95.66666667,1360730597535,1360730597727,1151980383,1151980575,192
1360730637,1152019808,2,130,65,1360730609609,1360730623177,1151992417,1152005985,13568
1360730677,1152059816,2,130,65,1360730649599,1360730663551,1152032415,1152046367,13952
1360730717,1152099860,2,130,65,1360730689555,1360730703891,1152072415,1152086751,14336
1360730722,1152104040,1,46,46,1360730694919,1360730694919,1152076959,1152076959,0
1360730757,1152139836,2,130,65,1360730729577,1360730744361,1152112413,1152127197,14784
1360730798,1152180072,2,130,65,1360730770341,1360730785381,1152152413,1152167453,15040
1360730807,1152189528,4,252,63,1360730799068,1360730806108,1152181596,1152188636,7040
1360730838,1152220096,2,130,65,1360730810316,1360730825932,1152192412,1152208028,15616
1360730842,1152224148,1,63,63,1360730814551,1360730814551,1152196699,1152196699,0
1360730878,1152260196,2,130,65,1360730850218,1360730866218,1152232414,1152248414,16000
1360730887,1152269560,3,189,63,1360730881787,1360730884859,1152264347,1152267419,3072
1360730903,1152285600,2,126,63,1360730888853,1360730896853,1152271453,1152279453,8000
1360730911,1152293612,3,189,63,1360730904455,1360730907527,1152287067,1152290139,3072
1360730918,1152300216,2,130,65,1360730890197,1360730906517,1152272413,1152288733,16320
1360730927,1152309572,2,126,63,1360730924592,1360730925616,1152307164,1152308188,1024
1360730927,1152309604,2,126,63,1360730911568,1360730919568,1152294172,1152302172,8000
1360730935,1152317612,2,126,63,1360730927623,1360730931591,1152310235,1152314203,3968
1360730958,1152340548,2,130,65,1360730929864,1360730946632,1152312412,1152329180,16768
1360730966,1152348596,1,63,63,1360730939672,1360730939672,1152322268,1152322268,0
1360730994,1152376668,2,130,65,1360730969742,1360730986894,1152352410,1152369562,17152
1360731034,1152416724,2,130,65,1360731009688,1360731027224,1152392412,1152409948,17536
1360731074,1152456756,2,130,65,1360731049653,1360731067509,1152432409,1152450265,17856
1360731090,1152472864,3,408,136,1360731064843,1360731070923,1152447707,1152453787,6080
1360731115,1152497000,2,130,65,1360731090411,1360731108523,1152472411,1152490523,18112
1360731154,1152536812,2,130,65,1360731129597,1360731148157,1152512409,1152530969,18560
1360731194,1152576884,2,130,65,1360731169523,1360731188403,1152552407,1152571287,18880
1360731234,1152616932,2,130,65,1360731209474,1360731228546,1152592406,1152611478,19072
1360731275,1152657228,2,130,65,1360731250179,1360731269507,1152632407,1152651735,19328
1360731315,1152697168,2,130,65,1360731290238,1360731309886,1152672406,1152692054,19648
1360731355,1152737160,2,130,65,1360731330245,1360731350213,1152712405,1152732373,19968
1360731359,1152741108,1,46,46,1360731330938,1360731330938,1152713046,1152713046,0
1360731395,1152777136,2,130,65,1360731370268,1360731390428,1152752404,1152772564,20160
1360731435,1152817320,2,130,65,1360731410085,1360731430629,1152792405,1152812949,20544
1360731475,1152857616,2,130,65,1360731449789,1360731470589,1152832405,1152853205,20800
1360731515,1152897556,2,130,65,1360731489849,1360731510969,1152872405,1152893525,21120
1360731556,1152938044,2,130,65,1360731530360,1360731551864,1152912404,1152933908,21504
1360731596,1152978056,2,130,65,1360731570344,1360731592168,1152952400,1152974224,21824
1360731636,1153018060,2,130,65,1360731610343,1360731632487,1152992403,1153014547,22144
1360731676,1153058340,2,130,65,1360731650061,1360731672397,1153032401,1153054737,22336
1360731704,1153086288,3,408,136,1360731677953,1360731683969,1153060241,1153066257,6016
1360731716,1153098216,2,130,65,1360731690182,1360731712710,1153072398,1153094926,22528
1360731756,1153138392,2,130,65,1360731730008,1360731752856,1153112400,1153135248,22848
1360731796,1153178504,2,130,65,1360731769896,1360731793064,1153152400,1153175568,23168
1360731836,1153218468,2,130,65,1360731809929,1360731833417,1153192397,1153215885,23488
1360731848,1153230576,1,46,46,1360731821536,1360731821536,1153204112,1153204112,0
1360731876,1153258636,2,130,65,1360731849762,1360731873570,1153232398,1153256206,23808
1360731916,1153298908,2,130,65,1360731889488,1360731913680,1153272396,1153296588,24192
1360731957,1153339028,2,130,65,1360731930369,1360731954945,1153312397,1153336973,24576
1360731997,1153378956,2,130,65,1360731970440,1360731995208,1153352396,1153377164,24768
1360732037,1153419072,2,130,65,1360732010321,1360732035281,1153392393,1153417353,24960
1360732077,1153459236,2,130,65,1360732050158,1360732075246,1153432394,1153457482,25088
1360732117,1153499284,2,130,65,1360732090109,1360732115389,1153472393,1153497673,25280
1360732157,1153539340,2,130,65,1360732130053,1360732155525,1153512393,1153537865,25472
1360732197,1153579524,2,130,65,1360732169870,1360732195534,1153552394,1153578058,25664
1360732233,1153615916,1,46,46,1360732207491,1360732207491,1153590407,1153590407,0
1360732237,1153619808,2,130,65,1360732209585,1360732235505,1153592393,1153618313,25920
1360732277,1153659824,2,130,65,1360732249566,1360732275678,1153632390,1153658502,26112
1360732314,1153696088,3,408,136,1360732289472,1360732295552,1153671560,1153677640,6080
1360732317,1153699888,2,130,65,1360732289501,1360732315869,1153672389,1153698757,26368
1360732357,1153739812,2,130,65,1360732329579,1360732356139,1153712391,1153738951,26560
1360732394,1153776564,12,999,83.25,1360732384417,1360732393185,1153766981,1153775749,8768
1360732398,1153780232,2,130,65,1360732370158,1360732396910,1153752390,1153779142,26752
1360732418,1153800236,1,46,46,1360732392105,1360732392105,1153774341,1153774341,0
1360732438,1153820380,2,130,65,1360732410010,1360732437082,1153792390,1153819462,27072
1360732478,1153860320,2,130,65,1360732450070,1360732477334,1153832390,1153859654,27264
1360732518,1153900304,2,130,65,1360732490083,1360732517603,1153872387,1153899907,27520
1360732554,1153936588,1,52,52,1360732529798,1360732529798,1153912386,1153912386,0
1360732582,1153964772,2,130,65,1360732557261,1360732569613,1153940033,1153952385,12352
1360732602,1153984608,1,46,46,1360732574579,1360732574579,1153957187,1153957187,0
1360732622,1154004700,2,130,65,1360732597592,1360732609688,1153980292,1153992388,12096
1360732666,1154048696,2,130,65,1360732637913,1360732649689,1154020609,1154032385,11776
1360732703,1154085088,2,130,65,1360732678712,1360732690296,1154060800,1154072384,11584
1360732743,1154125348,2,130,65,1360732718581,1360732730037,1154100929,1154112385,11456
1360732783,1154165332,2,130,65,1360732758788,1360732770052,1154141120,1154152384,11264
1360732827,1154209404,2,130,65,1360732798972,1360732809980,1154181376,1154192384,11008
1360732867,1154249468,2,130,65,1360732839097,1360732849913,1154221565,1154232381,10816
1360732907,1154289524,2,130,65,1360732879171,1360732889859,1154261695,1154272383,10688
1360732927,1154309852,3,408,136,1360732900283,1360732906299,1154283135,1154289151,6016
1360732947,1154329580,2,130,65,1360732919240,1360732929800,1154301820,1154312380,10560
1360732987,1154369748,2,130,65,1360732959199,1360732969631,1154341947,1154352379,10432
1360733028,1154410108,2,130,65,1360733000034,1360733010274,1154382142,1154392382,10240
1360733032,1154413928,1,148,148,1360733004885,1360733004885,1154386813,1154386813,0
1360733068,1154450084,2,130,65,1360733040184,1360733050296,1154422268,1154432380,10112
1360733108,1154490124,2,130,65,1360733080399,1360733090255,1154462523,1154472379,9856
1360733148,1154530072,2,130,65,1360733120834,1360733130306,1154502906,1154512378,9472
1360733188,1154570544,2,130,65,1360733160618,1360733169834,1154543162,1154552378,9216
1360733228,1154610388,2,130,65,1360733200966,1360733209990,1154583354,1154592378,9024
1360733268,1154650500,2,104,52,1360733243539,1360733243603,1154626039,1154626103,64
1360733268,1154650500,2,104,52,1360733243605,1360733243669,1154626105,1154626169,64
1360733268,1154650544,2,130,65,1360733240938,1360733249834,1154623482,1154632378,8896
1360733268,1154650620,2,104,52,1360733243486,1360733243550,1154626106,1154626170,64
1360733268,1154650620,2,104,52,1360733243486,1360733243550,1154626106,1154626170,64
1360733308,1154690460,2,130,65,1360733281150,1360733289918,1154663610,1154672378,8768
1360733348,1154730572,2,130,65,1360733321226,1360733329802,1154703798,1154712374,8576
1360733388,1154770596,2,130,65,1360733361331,1360733369779,1154743927,1154752375,8448
1360733428,1154810760,2,130,65,1360733401296,1360733409616,1154784056,1154792376,8320
1360733468,1154850648,2,130,65,1360733441469,1360733449725,1154824117,1154832373,8256
1360733508,1154890748,2,130,65,1360733481496,1360733489624,1154864244,1154872372,8128
1360733536,1154918820,3,408,136,1360733511632,1360733517648,1154894452,1154900468,6016
1360733548,1154930780,2,130,65,1360733521528,1360733529592,1154904308,1154912372,8064
1360733588,1154970916,2,130,65,1360733561521,1360733569457,1154944437,1154952373,7936
1360733628,1155010796,2,130,65,1360733601830,1360733609574,1154984626,1154992370,7744
1360733669,1155051180,2,130,65,1360733642766,1360733650190,1155024946,1155032370,7424
1360733709,1155091320,2,130,65,1360733682692,1360733690052,1155065012,1155072372,7360
1360733749,1155131352,2,130,65,1360733722787,1360733730019,1155105139,1155112371,7232
1360733789,1155171408,2,130,65,1360733763048,1360733770024,1155145456,1155152432,6976
1360733829,1155211676,2,130,65,1360733802908,1360733809756,1155185584,1155192432,6848
1360733869,1155251856,2,130,65,1360733842920,1360733849576,1155225776,1155232432,6656
1360733909,1155291776,2,130,65,1360733883190,1360733889654,1155265966,1155272430,6464
1360733950,1155331960,2,130,65,1360733924261,1360733930469,1155306221,1155312429,6208
1360733990,1155372032,2,130,65,1360733964446,1360733970398,1155346478,1155352430,5952
1360734030,1155412088,2,130,65,1360734004581,1360734010341,1155386669,1155392429,5760
1360734070,1155452220,2,130,65,1360734044705,1360734050209,1155426925,1155432429,5504
1360734110,1155492316,2,130,65,1360734084800,1360734090112,1155467116,1155472428,5312
1360734150,1155532480,3,408,136,1360734124188,1360734130268,1155506668,1155512748,6080
1360734150,1155532656,2,130,65,1360734124714,1360734129770,1155507370,1155512426,5056
1360734190,1155572544,2,130,65,1360734165020,1360734169884,1155547564,1155552428,4864
1360734214,1155596620,8,815,101.875,1360734187983,1360734188175,1155570603,1155570795,192
1360734214,1155596796,9,861,95.66666667,1360734187551,1360734187743,1155570347,1155570539,192
1360734214,1155596804,9,861,95.66666667,1360734188118,1360734188310,1155570922,1155571114,192
1360734230,1155612580,2,130,65,1360734205110,1360734209846,1155587690,1155592426,4736
1360734270,1155652832,2,130,65,1360734244920,1360734249592,1155627752,1155632424,4672
1360734311,1155693116,2,130,65,1360734285702,1360734290310,1155667818,1155672426,4608
1360734351,1155733120,2,130,65,1360734325759,1360734330303,1155707879,1155712423,4544
1360734391,1155773012,2,130,65,1360734365998,1360734370414,1155748010,1155752426,4416
1360734431,1155813164,2,130,65,1360734405906,1360734410258,1155788070,1155792422,4352
1360734431,1155813300,4,184,46,1360734425228,1360734425740,1155807528,1155808040,512
1360734451,1155833364,2,109,54.5,1360734425163,1360734425163,1155807527,1155807527,0
1360734451,1155833476,1,63,63,1360734425053,1360734425053,1155807529,1155807529,0
1360734455,1155837324,8,815,101.875,1360734426865,1360734426993,1155809189,1155809317,128
1360734455,1155837336,8,815,101.875,1360734427367,1360734427559,1155809703,1155809895,192
1360734455,1155837340,8,815,101.875,1360734427619,1360734427811,1155809959,1155810151,192
1360734455,1155837496,9,861,95.66666667,1360734426949,1360734427141,1155809445,1155809637,192
1360734471,1155853580,2,130,65,1360734445553,1360734449841,1155828133,1155832421,4288
1360734491,1155873384,3,144,48,1360734464248,1360734465656,1155846632,1155848040,1408
1360734491,1155873400,3,144,48,1360734465381,1360734466789,1155847781,1155849189,1408
1360734491,1155873520,3,144,48,1360734465261,1360734466669,1155847781,1155849189,1408
1360734491,1155873520,2,96,48,1360734465261,1360734468205,1155847781,1155850725,2944
1360734511,1155893620,2,130,65,1360734485643,1360734489803,1155868263,1155872423,4160
1360734551,1155933836,2,130,65,1360734525488,1360734529584,1155908324,1155912420,4096
1360734591,1155973672,2,130,65,1360734565717,1360734569749,1155948389,1155952421,4032
1360734591,1155973712,1,64,64,1360734566511,1360734566511,1155949223,1155949223,0
1360734595,1155977488,1,64,64,1360734566988,1360734566988,1155949476,1155949476,0
1360734595,1155977492,1,64,64,1360734567177,1360734567177,1155949669,1155949669,0
1360734595,1155977492,6,384,64,1360734567176,1360734572552,1155949668,1155955044,5376
1360734632,1156014064,2,130,65,1360734606390,1360734610358,1155988454,1155992422,3968
1360734664,1156046244,2,126,63,1360734662270,1360734663294,1156044514,1156045538,1024
1360734672,1156054084,2,130,65,1360734646560,1360734650336,1156028644,1156032420,3776
1360734672,1156054164,2,126,63,1360734665423,1360734669455,1156047587,1156051619,4032
1360734680,1156062204,3,189,63,1360734676328,1360734679400,1156058532,1156061604,3072
1360734696,1156078244,2,126,63,1360734683328,1360734691392,1156065572,1156073636,8064
1360734703,1156085904,1,63,63,1360734676715,1360734676715,1156059619,1156059619,0
1360734712,1156094092,2,130,65,1360734686614,1360734690326,1156068706,1156072418,3712
1360734752,1156134012,2,130,65,1360734726757,1360734730405,1156108769,1156112417,3648
1360734752,1156134272,3,189,63,1360734746403,1360734749411,1156128675,1156131683,3008
1360734752,1156134316,3,189,63,1360734746423,1360734749431,1156128739,1156131747,3008
1360734760,1156142312,3,408,136,1360734735612,1360734741692,1156117924,1156124004,6080
1360734768,1156150464,2,126,63,1360734753313,1360734761377,1156135777,1156143841,8064
1360734768,1156150536,2,126,63,1360734753243,1360734761243,1156135779,1156143779,8000
1360734792,1156174244,2,130,65,1360734766654,1360734770174,1156148898,1156152418,3520
1360734832,1156214472,2,130,65,1360734806424,1360734809944,1156188896,1156192416,3520
1360734872,1156254624,2,130,65,1360734846338,1360734849794,1156228962,1156232418,3456
1360734912,1156294816,2,130,65,1360734886144,1360734889600,1156268960,1156272416,3456
1360734952,1156334672,2,130,65,1360734926416,1360734929744,1156309088,1156312416,3328
1360734992,1156374848,2,130,65,1360734966429,1360734969565,1156349277,1156352413,3136
1360735032,1156414852,2,130,65,1360735006554,1360735009562,1156389406,1156392414,3008
1360735072,1156454848,2,130,65,1360735046749,1360735049565,1156429597,1156432413,2816
1360735112,1156494896,2,130,65,1360735086828,1360735089516,1156469724,1156472412,2688
1360735153,1156534936,2,130,65,1360735127852,1360735130476,1156509788,1156512412,2624
1360735192,1156574908,2,130,65,1360735166881,1360735169505,1156549789,1156552413,2624
1360735233,1156614960,2,130,65,1360735207956,1360735210452,1156589916,1156592412,2496
1360735273,1156655228,2,130,65,1360735247752,1360735250184,1156629980,1156632412,2432
1360735313,1156695208,2,130,65,1360735287834,1360735290202,1156670042,1156672410,2368
1360735353,1156735180,2,130,65,1360735327991,1360735330231,1156710171,1156712411,2240
1360735373,1156755392,3,408,136,1360735347299,1360735353315,1156729691,1156735707,6016
1360735393,1156775408,2,130,65,1360735367825,1360735370001,1156750233,1156752409,2176
1360735433,1156815492,2,130,65,1360735407869,1360735409917,1156790361,1156792409,2048
1360735473,1156855652,2,130,65,1360735447837,1360735449757,1156830489,1156832409,1920
1360735513,1156895580,2,130,65,1360735487909,1360735489829,1156870489,1156872409,1920
1360735553,1156935748,2,130,65,1360735527865,1360735529657,1156910613,1156912405,1792
1360735594,1156976212,2,130,65,1360735568467,1360735570195,1156950679,1156952407,1728
1360735634,1157016196,2,130,65,1360735608481,1360735610209,1156990677,1156992405,1728
1360735674,1157056228,2,130,65,1360735648577,1360735650177,1157030805,1157032405,1600
1360735714,1157096324,2,130,65,1360735688672,1360735690080,1157070996,1157072404,1408
1360735726,1157108480,1,46,46,1360735698307,1360735698307,1157080787,1157080787,0
1360735754,1157136544,2,130,65,1360735728451,1360735729859,1157110995,1157112403,1408
1360735794,1157176528,2,130,65,1360735768529,1360735769873,1157151057,1157152401,1344
1360735834,1157216772,2,130,65,1360735808413,1360735809629,1157191185,1157192401,1216
1360735874,1157256788,2,130,65,1360735848524,1360735849612,1157231312,1157232400,1088
1360735911,1157292924,1,46,46,1360735883052,1360735883052,1157264976,1157264976,0
1360735915,1157297072,2,130,65,1360735889495,1360735890327,1157271567,1157272399,832
1360735955,1157337108,2,130,65,1360735929587,1360735930291,1157311695,1157312399,704
1360735987,1157368932,3,408,136,1360735958949,1360735964965,1157340881,1157346897,6016
1360735995,1157377012,2,130,65,1360735969813,1360735970389,1157351825,1157352401,576
1360736007,1157389040,8,815,101.875,1360735982585,1360735982777,1157364625,1157364817,192
1360736007,1157389116,14,6617,472.6428571,1360735981804,1360735982124,1157363920,1157364240,320
1360736007,1157389124,9,861,95.66666667,1360735982178,1360735982370,1157364302,1157364494,192
1360736011,1157393056,9,861,95.66666667,1360735982822,1360735983014,1157364878,1157365070,192
1360736035,1157417176,2,130,65,1360736009968,1360736010224,1157392144,1157392400,256
1360736075,1157457496,2,130,65,1360736049711,1360736049903,1157432207,1157432399,192
1360736115,1157497508,2,130,65,1360736089889,1360736090657,1157472397,1157473165,768
1360736155,1157537692,2,130,65,1360736129705,1360736131497,1157512397,1157514189,1792
1360736196,1157577984,2,130,65,1360736170414,1360736173166,1157552398,1157555150,2752
1360736196,1157578084,2,126,63,1360736193994,1360736195018,1157576078,1157577102,1024
1360736204,1157586184,2,126,63,1360736196963,1360736200931,1157579147,1157583115,3968
1360736235,1157617848,2,130,65,1360736209548,1360736213324,1157592396,1157596172,3776
1360736236,1157617924,1,63,63,1360736209256,1360736209256,1157591180,1157591180,0
1360736252,1157634172,3,189,63,1360736246255,1360736249263,1157628427,1157631435,3008
1360736252,1157634172,3,189,63,1360736246318,1360736249326,1157628490,1157631498,3008
1360736268,1157650168,2,126,63,1360736253299,1360736261363,1157635467,1157643531,8064
1360736268,1157650208,2,126,63,1360736253324,1360736261388,1157635532,1157643596,8064
1360736276,1157658000,2,130,65,1360736250394,1360736255130,1157632394,1157637130,4736
1360736316,1157698276,2,130,65,1360736290119,1360736295879,1157672395,1157678155,5760
1360736324,1157706128,1,46,46,1360736298329,1360736298329,1157680457,1157680457,0
1360736324,1157706336,3,189,63,1360736320394,1360736323402,1157702730,1157705738,3008
1360736340,1157722400,2,126,63,1360736327372,1360736335436,1157709772,1157717836,8064
1360736356,1157738396,2,130,65,1360736329997,1360736335885,1157712393,1157718281,5888
1360736396,1157778468,2,130,65,1360736369925,1360736376773,1157752393,1157759241,6848
1360736436,1157818428,2,130,65,1360736409966,1360736417774,1157792394,1157800202,7808
1360736476,1157858504,2,130,65,1360736449887,1360736458719,1157832391,1157841223,8832
1360736516,1157898808,2,130,65,1360736489585,1360736499377,1157872393,1157882185,9792
1360736556,1157938904,2,130,65,1360736529488,1360736540240,1157912392,1157923144,10752
1360736596,1157978920,2,130,65,1360736569472,1360736580288,1157952392,1157963208,10816
1360736596,1157978924,3,408,136,1360736569978,1360736576058,1157952902,1157958982,6080
1360736637,1158018964,2,130,65,1360736610426,1360736621370,1157992390,1158003334,10944
1360736677,1158058956,2,130,65,1360736650433,1360736661441,1158032389,1158043397,11008
1360736717,1158099004,2,130,65,1360736690383,1360736701455,1158072387,1158083459,11072
1360736757,1158138984,2,130,65,1360736730403,1360736741603,1158112387,1158123587,11200
1360736797,1158179008,2,130,65,1360736770379,1360736781707,1158152387,1158163715,11328
1360736837,1158219092,2,130,65,1360736810294,1360736821686,1158192386,1158203778,11392
1360736877,1158259336,2,130,65,1360736850051,1360736861635,1158232387,1158243971,11584
1360736917,1158299452,2,130,65,1360736889933,1360736902477,1158272385,1158284929,12544
1360736957,1158339372,2,130,65,1360736930013,1360736943517,1158312385,1158325889,13504
1360736997,1158379320,2,130,65,1360736970064,1360736984528,1158352384,1158366848,14464
1360737037,1158419580,2,130,65,1360737009804,1360737025228,1158392384,1158407808,15424
1360737077,1158459672,2,130,65,1360737049712,1360737066096,1158432384,1158448768,16384
1360737117,1158499652,2,130,65,1360737089729,1360737107073,1158472381,1158489725,17344
1360737157,1158539748,2,130,65,1360737129636,1360737148004,1158512384,1158530752,18368
1360737197,1158579768,2,130,65,1360737169613,1360737188941,1158552381,1158571709,19328
1360737209,1158591684,3,408,136,1360737181858,1360737187874,1158564542,1158570558,6016
1360737237,1158619768,2,130,65,1360737209613,1360737229837,1158592381,1158612605,20224
1360737277,1158659812,2,130,65,1360737249567,1360737270751,1158632379,1158653563,21184
1360737317,1158699828,2,130,65,1360737289552,1360737311632,1158672380,1158694460,22080
1360737358,1158739992,2,130,65,1360737330387,1360737353491,1158712379,1158735483,23104
1360737398,1158780012,2,130,65,1360737370365,1360737393533,1158752377,1158775545,23168
1360737438,1158820032,2,130,65,1360737410409,1360737433577,1158792441,1158815609,23168
1360737478,1158860112,2,130,65,1360737450328,1360737473496,1158832440,1158855608,23168
1360737518,1158900540,2,130,65,1360737489899,1360737514091,1158872439,1158896631,24192
1360737558,1158940652,2,130,65,1360737529786,1360737553978,1158912438,1158936630,24192
1360737598,1158980564,2,130,65,1360737569874,1360737594130,1158952438,1158976694,24256
1360737634,1159016764,1,52,52,1360737609674,1360737609674,1158992438,1158992438,0
1360737662,1159044816,2,130,65,1360737634006,1360737649622,1159016822,1159032438,15616
1360737702,1159084848,2,130,65,1360737674037,1360737689589,1159056885,1159072437,15552
1360737742,1159124876,2,130,65,1360737714071,1360737729559,1159096947,1159112435,15488
1360737783,1159165036,2,130,65,1360737754914,1360737770402,1159136950,1159152438,15488
1360737790,1159172476,11,953,86.63636364,1360737772392,1360737783272,1159154868,1159165748,10880
1360737790,1159172480,11,953,86.63636364,1360737772708,1360737783268,1159155188,1159165748,10560
1360737790,1159172520,12,999,83.25,1360737772094,1360737783230,1159154614,1159165750,11136
1360737819,1159201036,3,408,136,1360737794079,1360737800095,1159176115,1159182131,6016
1360737823,1159205256,2,130,65,1360737794758,1360737810182,1159177014,1159192438,15424
1360737859,1159241456,2,130,65,1360737834555,1360737849979,1159217011,1159232435,15424
1360737899,1159281512,2,130,65,1360737874626,1360737889922,1159257138,1159272434,15296
1360737939,1159321672,2,130,65,1360737914468,1360737929764,1159297140,1159312436,15296
1360737979,1159361864,2,130,65,1360737954276,1360737969572,1159337140,1159352436,15296
1360738023,1159405852,2,130,65,1360737995310,1360738009582,1159378162,1159392434,14272
1360738063,1159445844,2,130,65,1360738036277,1360738049589,1159419121,1159432433,13312
1360738104,1159485936,2,130,65,1360738078082,1360738090498,1159460018,1159472434,12416
1360738144,1159526228,2,130,65,1360738118810,1360738130202,1159501038,1159512430,11392
1360738188,1159570224,2,130,65,1360738159840,1360738170208,1159542064,1159552432,10368
1360738200,1159582376,1,46,46,1360738173318,1360738173318,1159555694,1159555694,0
1360738228,1159610384,2,130,65,1360738200701,1360738210045,1159583085,1159592429,9344
1360738232,1159614380,2,120,60,1360738204416,1360738207424,1159586796,1159589804,3008
1360738240,1159622404,2,120,60,1360738212394,1360738215402,1159594798,1159597806,3008
1360738268,1159650460,2,130,65,1360738241649,1360738249969,1159624109,1159632429,8320
1360738308,1159690716,2,130,65,1360738282352,1360738289712,1159665068,1159672428,7360
1360738348,1159730748,2,130,65,1360738323151,1360738329679,1159705899,1159712427,6528
1360738392,1159774752,2,130,65,1360738364172,1360738369676,1159746924,1159752428,5504
1360738433,1159814960,2,130,65,1360738405988,1360738410468,1159787948,1159792428,4480
1360738433,1159814964,3,408,136,1360738406431,1360738412447,1159788395,1159794411,6016
1360738473,1159855160,2,130,65,1360738446809,1360738450265,1159828969,1159832425,3456
1360738513,1159895264,2,130,65,1360738487731,1360738490163,1159869995,1159872427,2432
1360738525,1159907140,1,52,52,1360738498990,1360738498990,1159881130,1159881130,0
1360738525,1159907148,3,152,50.66666667,1360738500134,1360738501350,1159882282,1159883498,1216
1360738525,1159907228,2,100,50,1360738499543,1360738500183,1159881771,1159882411,640
1360738529,1159911120,1,52,52,1360738501250,1360738501250,1159883370,1159883370,0
1360738529,1159911152,2,100,50,1360738501857,1360738502497,1159884009,1159884649,640
1360738529,1159911196,2,104,52,1360738501175,1360738504183,1159883371,1159886379,3008
1360738553,1159935192,2,130,65,1360738527801,1360738530233,1159909993,1159912425,2432
1360738593,1159975376,2,130,65,1360738568575,1360738570047,1159950951,1159952423,1472
1360738637,1160019604,2,130,65,1360738609244,1360738609820,1159991848,1159992424,576
1360738677,1160059716,2,130,65,1360738649706,1360738650026,1160032422,1160032742,320
1360738717,1160099812,2,130,65,1360738689612,1360738690828,1160072424,1160073640,1216
1360738730,1160112256,1,46,46,1360738702967,1360738702967,1160085223,1160085223,0
1360738731,1160112968,1,46,46,1360738703127,1360738703127,1160085095,1160085095,0
1360738757,1160139732,2,130,65,1360738729690,1360738731866,1160112422,1160114598,2176
1360738797,1160179852,2,130,65,1360738769571,1360738772771,1160152423,1160155623,3200
1360738837,1160219868,2,130,65,1360738809555,1360738813715,1160192423,1160196583,4160
1360738871,1160253336,12,999,83.25,1360738853476,1360738863524,1160235812,1160245860,10048
1360738871,1160253372,16,6372,398.25,1360738852993,1360738863489,1160235365,1160245861,10496
1360738871,1160253376,12,999,83.25,1360738853693,1360738863485,1160236069,1160245861,9792
1360738871,1160253376,11,953,86.63636364,1360738853947,1360738863483,1160236323,1160245859,9536
1360738877,1160259916,2,130,65,1360738849506,1360738854690,1160232422,1160237606,5184
1360738913,1160295928,1,148,148,1360738887571,1360738887571,1160270499,1160270499,0
1360738917,1160299888,2,130,65,1360738889533,1360738894717,1160272421,1160277605,5184
1360738942,1160324048,2,296,148,1360738916164,1360738939652,1160298212,1160321700,23488
1360738957,1160339980,2,130,65,1360738929441,1360738934625,1160312421,1160317605,5184
1360738998,1160380104,2,130,65,1360738970314,1360738976394,1160352418,1160358498,6080
1360739038,1160420124,2,130,65,1360739010293,1360739017269,1160392417,1160399393,6976
1360739042,1160424104,3,408,136,1360739017740,1360739023756,1160399844,1160405860,6016
1360739078,1160460144,2,130,65,1360739050273,1360739058081,1160432417,1160440225,7808
1360739118,1160500460,2,130,65,1360739089958,1360739098598,1160472418,1160481058,8640
1360739158,1160540480,2,130,65,1360739129934,1360739139598,1160512414,1160522078,9664
1360739198,1160580468,2,130,65,1360739169947,1360739180571,1160552415,1160563039,10624
1360739234,1160616588,2,130,65,1360739209827,1360739221411,1160592415,1160603999,11584
1360739250,1160632576,1,148,148,1360739224495,1360739224495,1160607071,1160607071,0
1360739275,1160656976,2,130,65,1360739250440,1360739262984,1160632416,1160644960,12544
1360739315,1160697012,2,130,65,1360739290401,1360739303905,1160672413,1160685917,13504
1360739355,1160737060,2,130,65,1360739330355,1360739344819,1160712415,1160726879,14464
1360739395,1160777108,2,130,65,1360739370305,1360739385793,1160752413,1160767901,15488
1360739435,1160817428,2,130,65,1360739409982,1360739426430,1160792410,1160808858,16448
1360739475,1160857380,2,130,65,1360739450033,1360739467441,1160832413,1160849821,17408
1360739515,1160897692,2,130,65,1360739489719,1360739508087,1160872411,1160890779,18368
1360739555,1160937664,2,130,65,1360739529746,1360739549074,1160912410,1160931738,19328
1360739596,1160977972,2,130,65,1360739570436,1360739590660,1160952408,1160972632,20224
1360739636,1161017960,2,130,65,1360739610447,1360739631695,1160992407,1161013655,21248
1360739656,1161038056,3,408,136,1360739629168,1360739635184,1161011224,1161017240,6016
1360739676,1161057984,2,130,65,1360739650426,1360739672634,1161032410,1161054618,22208
1360739716,1161098172,2,130,65,1360739690236,1360739713404,1161072408,1161095576,23168
1360739756,1161138336,2,130,65,1360739730072,1360739754200,1161112408,1161136536,24128
1360739796,1161178304,2,130,65,1360739770101,1360739795125,1161152405,1161177429,25024
1360739836,1161218468,1,52,52,1360739809938,1360739809938,1161192406,1161192406,0
1360739864,1161246388,2,130,65,1360739836003,1360739850019,1161218391,1161232407,14016
1360739904,1161286844,2,130,65,1360739876313,1360739889561,1161259157,1161272405,13248
1360739944,1161326860,2,130,65,1360739917127,1360739929543,1161299987,1161312403,12416
1360739985,1161366980,2,130,65,1360739958905,1360739970425,1161340885,1161352405,11520
1360740025,1161407156,2,130,65,1360739999622,1360740010246,1161381778,1161392402,10624
1360740065,1161447148,2,130,65,1360740040462,1360740050254,1161422610,1161432402,9792
1360740109,1161491208,2,130,65,1360740081235,1360740090195,1161463443,1161472403,8960
1360740120,1161502784,17,6755,397.3529412,1360740101970,1360740112914,1161484754,1161495698,10944
1360740120,1161502788,12,999,83.25,1360740102350,1360740112910,1161485138,1161495698,10560
1360740120,1161502824,12,999,83.25,1360740102569,1360740112873,1161485393,1161495697,10304
1360740149,1161531176,2,130,65,1360740122096,1360740130224,1161504272,1161512400,8128
1360740189,1161571316,2,130,65,1360740162979,1360740170083,1161545295,1161552399,7104
1360740229,1161611348,2,130,65,1360740203909,1360740210053,1161586257,1161592401,6144
1360740265,1161647412,3,408,136,1360740240578,1360740246658,1161622990,1161629070,6080
1360740269,1161651416,2,130,65,1360740244670,1360740249982,1161627086,1161632398,5312
1360740313,1161695528,2,130,65,1360740285325,1360740289869,1161667853,1161672397,4544
1360740353,1161735496,2,130,65,1360740326383,1360740329903,1161708879,1161712399,3520
1360740393,1161775688,2,130,65,1360740367086,1360740369710,1161749774,1161752398,2624
1360740433,1161815620,2,130,65,1360740408114,1360740409778,1161790734,1161792398,1664
1360740477,1161859676,2,130,65,1360740448954,1360740449722,1161831630,1161832398,768
1360740517,1161899656,2,130,65,1360740489741,1360740489869,1161872397,1161872525,128
1360740558,1161939960,2,130,65,1360740530435,1360740531523,1161912395,1161913483,1088
1360740598,1161979924,2,130,65,1360740570472,1360740572456,1161952396,1161954380,1984
1360740638,1162020048,2,130,65,1360740610347,1360740613227,1161992395,1161995275,2880
1360740678,1162060084,2,130,65,1360740650311,1360740654087,1162032395,1162036171,3776
1360740718,1162100364,2,130,65,1360740690029,1360740694765,1162072393,1162077129,4736
1360740758,1162140384,2,130,65,1360740730008,1360740735640,1162112392,1162118024,5632
1360740798,1162180508,2,130,65,1360740769882,1360740776282,1162152390,1162158790,6400
1360740838,1162220468,2,130,65,1360740809922,1360740817154,1162192390,1162199622,7232
1360740874,1162256916,2,130,65,1360740849475,1360740857475,1162232391,1162240391,8000
1360740878,1162260856,3,408,136,1360740852542,1360740858558,1162235398,1162241414,6016
1360740915,1162296924,2,130,65,1360740890467,1360740899235,1162272391,1162281159,8768
1360740955,1162336984,2,130,65,1360740930405,1360740939941,1162312389,1162321925,9536
1360740995,1162376936,2,130,65,1360740970452,1360740980820,1162352388,1162362756,10368
1360741035,1162417308,2,130,65,1360741010078,1360741021214,1162392386,1162403522,11136
1360741075,1162457332,2,130,65,1360741050121,1360741061961,1162432453,1162444293,11840
1360741115,1162497368,2,130,65,1360741090085,1360741102693,1162472453,1162485061,12608
1360741155,1162537388,2,130,65,1360741130061,1360741143565,1162512449,1162525953,13504
1360741195,1162577400,2,130,65,1360741170048,1360741184448,1162552448,1162566848,14400
1360741235,1162617532,2,130,65,1360741209916,1360741225148,1162592448,1162607680,15232
1360741275,1162657480,2,130,65,1360741249969,1360741266097,1162632449,1162648577,16128
1360741315,1162697496,2,130,65,1360741289950,1360741307038,1162672446,1162689534,17088
1360741355,1162737596,2,130,65,1360741329851,1360741347835,1162712447,1162730431,17984
1360741395,1162777576,2,130,65,1360741369870,1360741388686,1162752446,1162771262,18816
1360741435,1162817580,2,130,65,1360741409864,1360741429576,1162792444,1162812156,19712
1360741475,1162857640,2,130,65,1360741449804,1360741470412,1162832444,1162853052,20608
1360741491,1162873676,3,408,136,1360741464233,1360741470313,1162846909,1162852989,6080
1360741516,1162897988,2,130,65,1360741490456,1360741511960,1162872444,1162893948,21504
1360741555,1162937788,2,130,65,1360741529654,1360741551990,1162912442,1162934778,22336
1360741559,1162941772,1,148,148,1360741530953,1360741530953,1162913725,1162913725,0
1360741596,1162977920,2,130,65,1360741570525,1360741593693,1162952445,1162975613,23168
1360741636,1163017952,2,130,65,1360741610493,1360741634429,1162992445,1163016381,23936
1360741676,1163058100,2,130,65,1360741650342,1360741675110,1163032442,1163057210,24768
1360741716,1163098120,1,52,52,1360741690322,1360741690322,1163072442,1163072442,0
1360741744,1163126076,2,130,65,1360741716094,1360741730366,1163098170,1163112442,14272
1360741784,1163166208,2,130,65,1360741756792,1360741770232,1163139000,1163152440,13440
1360741824,1163206136,2,130,65,1360741797824,1360741810304,1163179960,1163192440,12480
1360741864,1163246396,2,130,65,1360741838461,1360741850045,1163220857,1163232441,11584
1360741904,1163286404,2,130,65,1360741879218,1360741890034,1163261622,1163272438,10816
1360741914,1163296464,12,999,83.25,1360741902136,1360741913272,1163284600,1163295736,11136
1360741914,1163296496,16,6372,398.25,1360741901141,1360741913237,1163283637,1163295733,12096
1360741914,1163296496,11,953,86.63636364,1360741901527,1360741913239,1163284023,1163295735,11712
1360741914,1163296496,12,999,83.25,1360741901847,1360741913239,1163284343,1163295735,11392
1360741948,1163330344,2,130,65,1360741920110,1360741930094,1163302454,1163312438,9984
1360741988,1163370468,2,130,65,1360741960753,1360741969969,1163343221,1163352437,9216
1360742028,1163410500,2,130,65,1360742001553,1360742009937,1163384053,1163392437,8384
1360742061,1163443404,1,46,46,1360742035056,1360742035056,1163417460,1163417460,0
1360742062,1163444248,1,46,46,1360742035340,1360742035340,1163417588,1163417588,0
1360742068,1163450540,2,130,65,1360742042343,1360742049895,1163424883,1163432435,7552
1360742100,1163482660,3,408,136,1360742075697,1360742081713,1163458357,1163464373,6016
1360742108,1163490572,2,130,65,1360742083017,1360742089865,1163465589,1163472437,6848
1360742148,1163530604,6,468,78,1360742123751,1360742140007,1163506355,1163522611,16256
1360742184,1163566588,1,78,78,1360742156855,1360742156855,1163539443,1163539443,0
1360742216,1163598728,2,182,91,1360742190316,1360742212588,1163573044,1163595316,22272
1360742541,1163923600,1,46,46,1360742515365,1360742515365,1163897965,1163897965,0
1360742714,1164095988,3,408,136,1360742687558,1360742693574,1164069546,1164075562,6016
1360742803,1164185436,12,999,83.25,1360742787908,1360742798404,1164170344,1164180840,10496
1360742803,1164185476,17,6755,397.3529412,1360742787228,1360742798364,1164169704,1164180840,11136
1360742803,1164185484,11,953,86.63636364,1360742787607,1360742798359,1164170091,1164180843,10752
1360742803,1164185484,12,999,83.25,1360742788116,1360742798356,1164170600,1164180840,10240
1360743150,1164532752,1,52,52,1360743123973,1360743123973,1164506725,1164506725,0
1360743294,1164676836,1,46,46,1360743267568,1360743267568,1164650404,1164650404,0
1360743323,1164704956,3,408,136,1360743298524,1360743304540,1164680480,1164686496,6016
1360743936,1165318788,3,408,136,1360743908436,1360743914452,1165291224,1165297240,6016
1360744134,1165516116,1,64,64,1360744106928,1360744106928,1165489044,1165489044,0
1360744134,1165516544,1,64,64,1360744106308,1360744106308,1165488852,1165488852,0
1360744546,1165928764,3,408,136,1360744519651,1360744525731,1165902415,1165908495,6080
1360744614,1165996788,9,861,95.66666667,1360744587466,1360744587658,1165970254,1165970446,192
1360744614,1165996828,9,861,95.66666667,1360744587682,1360744587874,1165970510,1165970702,192
1360744614,1165996860,14,6617,472.6428571,1360744587011,1360744587331,1165969871,1165970191,320
1360744796,1166178704,3,138,46,1360744790235,1360744790299,1166172939,1166173003,64
1360744796,1166178736,3,138,46,1360744790204,1360744790268,1166172940,1166173004,64
1360744815,1166197568,2,109,54.5,1360744790371,1360744790371,1166172939,1166172939,0
1360744819,1166201444,8,815,101.875,1360744792096,1360744792224,1166174540,1166174668,128
1360744819,1166201448,9,861,95.66666667,1360744792860,1360744793052,1166175308,1166175500,192
1360744819,1166201520,9,861,95.66666667,1360744792276,1360744792404,1166174796,1166174924,128
1360744819,1166201520,8,815,101.875,1360744792530,1360744792722,1166175050,1166175242,192
1360744836,1166218724,3,138,46,1360744830471,1360744830535,1166213195,1166213259,64
1360744836,1166218724,3,138,46,1360744830535,1360744830599,1166213259,1166213323,64
1360744836,1166218724,3,138,46,1360744830470,1360744830534,1166213194,1166213258,64
1360744836,1166218724,3,138,46,1360744830534,1360744830598,1166213258,1166213322,64
1360744844,1166226724,11,953,86.63636364,1360744831176,1360744842696,1166213900,1166225420,11520
1360744844,1166226736,11,953,86.63636364,1360744830652,1360744842748,1166213388,1166225484,12096
1360744844,1166226736,12,999,83.25,1360744830908,1360744842748,1166213644,1166225484,11840
1360744844,1166226740,11,953,86.63636364,1360744831416,1360744842680,1166214156,1166225420,11264
1360745156,1166538384,3,408,136,1360745131542,1360745137558,1166513926,1166519942,6016
1360745629,1167011056,1,78,78,1360745603541,1360745603541,1166985597,1166985597,0
1360745697,1167079172,1,52,52,1360745671587,1360745671587,1167053759,1167053759,0
1360745701,1167083064,1,52,52,1360745673295,1360745673295,1167055359,1167055359,0
1360745769,1167151440,3,408,136,1360745743379,1360745749395,1167125819,1167131835,6016
1360746274,1167656396,3,152,50.66666667,1360746246136,1360746255032,1167628532,1167637428,8896
1360746274,1167656452,3,152,50.66666667,1360746245955,1360746254915,1167628407,1167637367,8960
1360746274,1167656480,3,152,50.66666667,1360746247527,1360746256551,1167630007,1167639031,9024
1360746274,1167656480,3,152,50.66666667,1360746247655,1360746256551,1167630135,1167639031,8896
1360746322,1167704412,1,46,46,1360746295784,1360746295784,1167678196,1167678196,0
1360746330,1167712456,1,46,46,1360746302395,1360746302395,1167684851,1167684851,0
1360746330,1167712508,1,46,46,1360746302344,1360746302344,1167684852,1167684852,0
1360746330,1167712508,1,46,46,1360746302344,1360746302344,1167684852,1167684852,0
1360746350,1167732536,1,46,46,1360746325548,1360746325548,1167708084,1167708084,0
1360746386,1167768528,3,408,136,1360746360179,1360746366195,1167742707,1167748723,6016
1360746662,1168043888,17,6755,397.3529412,1360746646000,1360746654832,1168027888,1168036720,8832
1360746662,1168043892,12,999,83.25,1360746646381,1360746654829,1168028273,1168036721,8448
1360746662,1168043892,11,953,86.63636364,1360746646634,1360746654826,1168028526,1168036718,8192
1360746899,1168281300,1,60,60,1360746873170,1360746873170,1168255470,1168255470,0
1360746915,1168297336,1,60,60,1360746887278,1360746887278,1168269614,1168269614,0
1360746995,1168377480,3,408,136,1360746970779,1360746976795,1168353259,1168359275,6016
1360747400,1168782636,1,56,56,1360747372730,1360747372730,1168755366,1168755366,0
1360747609,1168991128,3,408,136,1360747582963,1360747588979,1168965091,1168971107,6016
1360747861,1169243352,1,46,46,1360747833420,1360747833420,1169215772,1169215772,0
1360748221,1169603624,3,408,136,1360748194169,1360748200121,1169576793,1169582745,5952
1360748455,1169837848,12,999,83.25,1360748440086,1360748451798,1169822934,1169834646,11712
1360748455,1169837856,17,6755,397.3529412,1360748439692,1360748451788,1169822548,1169834644,12096
1360748455,1169837860,12,999,83.25,1360748440394,1360748451786,1169823254,1169834646,11392
1360748455,1169837860,12,999,83.25,1360748440650,1360748451722,1169823510,1169834582,11072
1360748830,1170212448,3,408,136,1360748805536,1360748811552,1170187984,1170194000,6016
1360749355,1170736884,8,815,101.875,1360749328396,1360749328588,1170710280,1170710472,192
1360749355,1170736928,9,861,95.66666667,1360749327839,1360749328031,1170709767,1170709959,192
1360749355,1170736952,9,861,95.66666667,1360749328072,1360749328264,1170710024,1170710216,192
1360749380,1170762440,1,48,48,1360749352287,1360749352287,1170734727,1170734727,0
1360749381,1170763684,1,48,48,1360749352043,1360749352043,1170734727,1170734727,0
1360749443,1170825108,3,408,136,1360749417641,1360749423721,1170799749,1170805829,6080
1360749601,1170982948,2,126,63,1360749593927,1360749594951,1170975875,1170976899,1024
1360749627,1171009432,9,861,95.66666667,1360749599714,1360749599970,1170982146,1170982402,256
1360749627,1171009436,9,861,95.66666667,1360749600031,1360749600223,1170982467,1170982659,192
1360749627,1171009440,9,861,95.66666667,1360749600281,1360749600473,1170982721,1170982913,192
1360749641,1171022932,3,189,63,1360749635928,1360749639000,1171017860,1171020932,3072
1360749657,1171038940,2,126,63,1360749643024,1360749651088,1171024964,1171033028,8064
1360749745,1171126960,3,189,63,1360749740602,1360749743674,1171122562,1171125634,3072
1360749761,1171142984,2,126,63,1360749747619,1360749755683,1171129603,1171137667,8064
1360749817,1171199024,2,126,63,1360749814329,1360749815353,1171196353,1171197377,1024
1360749825,1171206988,2,126,63,1360749817371,1360749821403,1171199359,1171203391,4032
1360749840,1171222248,1,46,46,1360749815514,1360749815514,1171197762,1171197762,0
1360749840,1171222288,1,46,46,1360749815153,1360749815153,1171197441,1171197441,0
1360749841,1171222988,4,184,46,1360749833821,1360749836893,1171215809,1171218881,3072
1360749841,1171222988,4,235,58.75,1360749833821,1360749836893,1171215809,1171218881,3072
1360749856,1171238248,2,109,54.5,1360749829208,1360749833624,1171211456,1171215872,4416
1360749860,1171242244,9,861,95.66666667,1360749835739,1360749835931,1171217983,1171218175,192
1360749864,1171246284,8,815,101.875,1360749835955,1360749836147,1171218239,1171218431,192
1360749864,1171246288,8,815,101.875,1360749836206,1360749836398,1171218494,1171218686,192
1360749864,1171246288,9,861,95.66666667,1360749836463,1360749836655,1171218751,1171218943,192
1360750053,1171434920,1,48,48,1360750024924,1360750024924,1171406844,1171406844,0
1360750056,1171438856,3,408,136,1360750028340,1360750034356,1171411196,1171417212,6016
1360750137,1171519172,3,189,63,1360750130910,1360750133918,1171513082,1171516090,3008
1360750137,1171519180,3,189,63,1360750130841,1360750133849,1171513021,1171516029,3008
1360750137,1171519180,3,189,63,1360750130905,1360750133913,1171513085,1171516093,3008
1360750153,1171535244,2,126,63,1360750137880,1360750145944,1171520124,1171528188,8064
1360750153,1171535252,2,126,63,1360750137806,1360750145870,1171520058,1171528122,8064
1360750153,1171535252,2,126,63,1360750137870,1360750145934,1171520122,1171528186,8064
1360750209,1171591324,3,189,63,1360750203464,1360750206536,1171585788,1171588860,3072
1360750225,1171607352,2,126,63,1360750210540,1360750218540,1171592892,1171600892,8000
1360750509,1171891508,14,6617,472.6428571,1360750484490,1360750484746,1171866998,1171867254,256
1360750513,1171895424,9,861,95.66666667,1360750484894,1360750485086,1171867318,1171867510,192
1360750513,1171895468,9,861,95.66666667,1360750485106,1360750485298,1171867574,1171867766,192
1360750513,1171895472,9,861,95.66666667,1360750485359,1360750485551,1171867831,1171868023,192
1360750666,1172047976,3,408,136,1360750640413,1360750646429,1172022389,1172028405,6016
1360750673,1172055772,3,189,63,1360750667711,1360750670719,1172050483,1172053491,3008
1360750689,1172071800,2,126,63,1360750674723,1360750682787,1172057523,1172065587,8064
1360750761,1172143840,2,126,63,1360750758459,1360750759419,1172141299,1172142259,960
1360750769,1172151864,2,126,63,1360750761441,1360750765473,1172144305,1172148337,4032
1360750802,1172183876,2,126,63,1360750799100,1360750800124,1172180976,1172182000,1024
1360750802,1172184044,1,63,63,1360750774293,1360750774293,1172156337,1172156337,0
1360750810,1172192184,2,126,63,1360750801800,1360750805832,1172183984,1172188016,4032
1360750838,1172220380,1,63,63,1360750813701,1360750813701,1172196081,1172196081,0
1360750842,1172223880,3,189,63,1360750837498,1360750840570,1172219378,1172222450,3072
1360750858,1172239920,2,126,63,1360750844497,1360750852561,1172226417,1172234481,8064
1360750998,1172380780,1,56,56,1360750972145,1360750972145,1172354925,1172354925,0
1360751147,1172529212,1,46,46,1360751119207,1360751119207,1172501419,1172501419,0
1360751279,1172661620,3,408,136,1360751251407,1360751257423,1172634027,1172640043,6016
1360751857,1173239056,1,46,46,1360751829048,1360751829048,1173211104,1173211104,0
1360751857,1173239084,1,46,46,1360751829597,1360751829597,1173211681,1173211681,0
1360751888,1173270364,3,408,136,1360751863175,1360751869191,1173245539,1173251555,6016
1360751996,1173378456,14,6617,472.6428571,1360751971497,1360751971817,1173353953,1173354273,320
1360752000,1173382436,9,861,95.66666667,1360751971898,1360751972026,1173354334,1173354462,128
1360752000,1173382480,9,861,95.66666667,1360751972110,1360751972302,1173354590,1173354782,192
1360752000,1173382484,8,815,101.875,1360751972364,1360751972556,1173354848,1173355040,192
1360752036,1173418524,1,60,60,1360752010020,1360752010020,1173392544,1173392544,0
1360752036,1173418564,1,60,60,1360752011580,1360752011580,1173394144,1173394144,0
1360752200,1173582700,1,64,64,1360752173423,1360752173423,1173556123,1173556123,0
1360752258,1173640640,2,126,63,1360752256106,1360752257130,1173638746,1173639770,1024
1360752258,1173640684,3,189,63,1360752251198,1360752254206,1173633882,1173636890,3008
1360752266,1173648688,2,126,63,1360752259133,1360752263101,1173641821,1173645789,3968
1360752274,1173656664,2,126,63,1360752258260,1360752266324,1173640924,1173648988,8064
1360752297,1173679084,1,63,63,1360752271766,1360752271766,1173653850,1173653850,0
1360752306,1173688688,2,126,63,1360752304700,1360752305660,1173687388,1173688348,960
1360752306,1173688688,2,126,63,1360752304763,1360752305723,1173687451,1173688411,960
1360752314,1173696692,2,126,63,1360752307702,1360752311734,1173690394,1173694426,4032
1360752314,1173696724,2,126,63,1360752307736,1360752311768,1173690460,1173694492,4032
1360752345,1173727080,1,63,63,1360752320412,1360752320412,1173702492,1173702492,0
1360752345,1173727124,1,63,63,1360752320429,1360752320429,1173702553,1173702553,0
1360752501,1173883244,3,408,136,1360752474548,1360752480500,1173856792,1173862744,5952
1360752815,1174197212,1,48,48,1360752786065,1360752786065,1174168277,1174168277,0
1360752815,1174197256,1,48,48,1360752786019,1360752786019,1174168275,1174168275,0
1360752881,1174263752,14,6617,472.6428571,1360752856305,1360752856561,1174239057,1174239313,256
1360752881,1174263756,9,861,95.66666667,1360752856624,1360752856816,1174239380,1174239572,192
1360752885,1174267728,9,861,95.66666667,1360752857226,1360752857418,1174239954,1174240146,192
1360752885,1174267776,8,815,101.875,1360752856921,1360752857049,1174239697,1174239825,128
1360753058,1174439936,1,46,46,1360753030367,1360753030367,1174412303,1174412303,0
1360753114,1174496008,2,272,136,1360753088406,1360753092374,1174470414,1174474382,3968
1360753131,1174513064,3,189,63,1360753125792,1360753128864,1174507856,1174510928,3072
1360753131,1174513088,3,189,63,1360753124294,1360753127366,1174506382,1174509454,3072
1360753131,1174513096,3,189,63,1360753125824,1360753128832,1174507920,1174510928,3008
1360753147,1174529072,2,126,63,1360753131352,1360753139416,1174513424,1174521488,8064
1360753147,1174529076,2,126,63,1360753132882,1360753140882,1174514958,1174522958,8000
1360753147,1174529084,2,126,63,1360753132873,1360753140937,1174514957,1174523021,8064
1360753218,1174600040,1,64,64,1360753189876,1360753189876,1174571916,1174571916,0
1360753259,1174641136,3,189,63,1360753255187,1360753258259,1174637323,1174640395,3072
1360753262,1174644132,1,46,46,1360753236568,1360753236568,1174618700,1174618700,0
1360753275,1174657140,2,126,63,1360753262288,1360753270288,1174644428,1174652428,8000
1360753723,1175105368,3,408,136,1360753697574,1360753703654,1175079942,1175086022,6080
1360753779,1175161420,2,104,52,1360753753969,1360753756913,1175136389,1175139333,2944
1360753783,1175165380,2,104,52,1360753756248,1360753759192,1175138628,1175141572,2944
1360753783,1175165392,2,104,52,1360753755083,1360753758091,1175137475,1175140483,3008
1360753783,1175165412,2,104,52,1360753756153,1360753759161,1175138565,1175141573,3008
1360754336,1175718856,3,408,136,1360754309366,1360754315318,1175692222,1175698174,5952
1360754673,1176055772,14,6617,472.6428571,1360754647365,1360754647685,1176030137,1176030457,320
1360754673,1176055772,9,861,95.66666667,1360754647748,1360754647940,1176030520,1176030712,192
1360754938,1176320596,8,815,101.875,1360754911664,1360754911792,1176294260,1176294388,128
1360754938,1176320596,8,815,101.875,1360754912430,1360754912622,1176295026,1176295218,192
1360754938,1176320636,8,815,101.875,1360754912136,1360754912264,1176294772,1176294900,128
1360754938,1176320636,9,861,95.66666667,1360754911879,1360754912007,1176294515,1176294643,128
1360754941,1176323256,3,189,63,1360754936259,1360754939331,1176318515,1176321587,3072
1360754946,1176328644,3,408,136,1360754921153,1360754927105,1176303797,1176309749,5952
1360754957,1176339264,2,126,63,1360754943354,1360754951354,1176325618,1176333618,8000
1360754989,1176371568,3,189,63,1360754984585,1360754987593,1176367153,1176370161,3008
1360755005,1176387560,2,126,63,1360754991634,1360754999698,1176374194,1176382258,8064
1360755047,1176428928,3,152,50.66666667,1360755022411,1360755031435,1176404339,1176413363,9024
1360755051,1176432872,3,152,50.66666667,1360755023553,1360755032577,1176405425,1176414449,9024
1360755051,1176432876,3,152,50.66666667,1360755024701,1360755033661,1176406577,1176415537,8960
1360755051,1176432876,3,152,50.66666667,1360755024701,1360755033661,1176406577,1176415537,8960
1360755149,1176531576,4,252,63,1360755141632,1360755148736,1176524208,1176531312,7104
1360755149,1176531584,2,126,63,1360755146360,1360755147384,1176528944,1176529968,1024
1360755149,1176531588,4,252,63,1360755141366,1360755148406,1176523954,1176530994,7040
1360755149,1176531588,4,252,63,1360755141556,1360755148660,1176524144,1176531248,7104
1360755157,1176539600,2,126,63,1360755149352,1360755153384,1176531952,1176535984,4032
1360755183,1176565060,1,63,63,1360755157251,1360755157251,1176539311,1176539311,0
1360755183,1176565096,1,63,63,1360755156961,1360755156961,1176539057,1176539057,0
1360755183,1176565096,1,63,63,1360755157152,1360755157152,1176539248,1176539248,0
1360755187,1176569064,1,63,63,1360755161985,1360755161985,1176544049,1176544049,0
1360755406,1176788116,6,2158,359.6666667,1360755404234,1360755404682,1176786350,1176786798,448
1360755406,1176788124,6,983,163.8333333,1360755404418,1360755404738,1176786542,1176786862,320
1360755406,1176788124,8,3137,392.125,1360755404482,1360755405890,1176786606,1176788014,1408
1360755406,1176788124,6,798,133,1360755404737,1360755405057,1176786861,1176787181,320
1360755407,1176789776,1,48,48,1360755379956,1360755379956,1176762732,1176762732,0
1360755414,1176796092,4,724,181,1360755409056,1360755409120,1176791148,1176791212,64
1360755414,1176796092,9,3025,336.1111111,1360755412448,1360755412704,1176794540,1176794796,256
1360755414,1176796092,8,2197,274.625,1360755412704,1360755413280,1176794796,1176795372,576
1360755414,1176796096,10,1965,196.5,1360755410010,1360755410266,1176792106,1176792362,256
1360755414,1176796096,5,609,121.8,1360755412890,1360755413274,1176794986,1176795370,384
1360755414,1176796096,7,2091,298.7142857,1360755410398,1360755410910,1176792494,1176793006,512
1360755414,1176796096,7,1256,179.4285714,1360755410397,1360755410973,1176792493,1176793069,576
1360755414,1176796096,12,4967,413.9166667,1360755413532,1360755413724,1176795628,1176795820,192
1360755414,1176796096,9,1913,212.5555556,1360755407451,1360755407643,1176789547,1176789739,192
1360755414,1176796096,9,1913,212.5555556,1360755411227,1360755411419,1176793323,1176793515,192
1360755414,1176796100,7,1256,179.4285714,1360755411482,1360755412186,1176793582,1176794286,704
1360755414,1176796100,5,1257,251.4,1360755407769,1360755407833,1176789869,1176789933,64
1360755414,1176796100,9,2274,252.6666667,1360755408025,1360755409113,1176790125,1176791213,1088
1360755414,1176796104,11,3139,285.3636364,1360755406867,1360755407571,1176788971,1176789675,704
1360755414,1176796104,7,2145,306.4285714,1360755413330,1360755413842,1176795434,1176795946,512
1360755414,4110076316,5,451,90.2,1360755410851,1360755411043,4110073167,4110073359,192
1360755414,4110076316,5,451,90.2,1360755412066,1360755412258,4110074382,4110074574,192
1360755414,4110076316,6,3769,628.1666667,1360755412385,1360755412449,4110074701,4110074765,64
1360755414,4110076316,5,451,90.2,1360755413089,1360755413281,4110075405,4110075597,192
1360755414,4110076316,6,3769,628.1666667,1360755410080,1360755410144,4110072396,4110072460,64
1360755414,4110076320,5,451,90.2,1360755406111,1360755407199,4110068431,4110069519,1088
1360755414,4110076320,5,1893,378.6,1360755410847,1360755411039,4110073167,4110073359,192
1360755414,4110076320,5,2109,421.8,1360755408222,1360755408222,4110070542,4110070542,0
1360755414,4110076320,5,451,90.2,1360755408925,1360755409757,4110071245,4110072077,832
1360755414,4110076320,6,3769,628.1666667,1360755413085,1360755413085,4110075405,4110075405,0
1360755422,1176804128,9,1913,212.5555556,1360755415230,1360755415358,1176797358,1176797486,128
1360755422,1176804128,9,3025,336.1111111,1360755415166,1360755415358,1176797294,1176797486,192
1360755422,1176804128,5,609,121.8,1360755415485,1360755415933,1176797613,1176798061,448
1360755422,1176804128,12,4967,413.9166667,1360755419451,1360755419963,1176801579,1176802091,512
1360755422,1176804132,9,1913,212.5555556,1360755414455,1360755414647,1176796587,1176796779,192
1360755422,1176804136,9,1913,212.5555556,1360755420598,1360755421110,1176802734,1176803246,512
1360755422,1176804136,9,1913,212.5555556,1360755414646,1360755414774,1176796782,1176796910,128
1360755422,1176804136,9,1913,212.5555556,1360755414837,1360755414965,1176796973,1176797101,128
1360755422,1176804136,15,8365,557.6666667,1360755414965,1360755415157,1176797101,1176797293,192
1360755422,1176804140,5,609,121.8,1360755413742,1360755414062,1176795882,1176796202,320
1360755422,4110084316,225,332925,1479.666667,1360755415779,1360755416355,4110078095,4110078671,576
1360755422,4110084316,5,451,90.2,1360755414048,1360755415008,4110076364,4110077324,960
1360755430,1176812096,12,4927,410.5833333,1360755427614,1360755428190,1176809710,1176810286,576
1360755430,1176812096,11,4705,427.7272727,1360755423902,1360755424286,1176805998,1176806382,384
1360755430,4110092312,86,122953,1429.686047,1360755423973,1360755425765,4110086285,4110088077,1792
1360755431,1176813756,1,108,108,1360755404042,1360755404042,1176786798,1176786798,0
1360755431,1176813756,2,216,108,1360755404106,1360755404234,1176786862,1176786990,128
1360755431,1176813792,1,108,108,1360755403877,1360755403877,1176786669,1176786669,0
1360755435,1176817736,7,2080,297.1428571,1360755408733,1360755409437,1176791469,1176792173,704
1360755435,1176817740,7,2031,290.1428571,1360755410583,1360755411223,1176793323,1176793963,640
1360755438,1176820128,9,2849,316.5555556,1360755434555,1360755434747,1176816683,1176816875,192
1360755438,1176820132,9,1913,212.5555556,1360755432566,1360755432694,1176814698,1176814826,128
1360755438,1176820136,10,1965,196.5,1360755433331,1360755433587,1176815467,1176815723,256
1360755438,1176820156,10,1877,187.7,1360755431264,1360755432352,1176813420,1176814508,1088
1360755438,1176820156,11,4689,426.2727273,1360755429920,1360755430496,1176812076,1176812652,576
1360755438,4110100308,4,445,111.25,1360755430184,1360755430312,4110092492,4110092620,128
1360755438,4110100312,4,1448,362,1360755435557,1360755435621,4110097869,4110097933,64
1360755439,1176821768,9,3310,367.7777778,1360755434810,1360755436346,1176817578,1176819114,1536
1360755439,1176821772,7,1877,268.1428571,1360755411256,1360755411832,1176794028,1176794604,576
1360755446,1176828120,4,715,178.75,1360755441030,1360755441030,1176823150,1176823150,0
1360755446,1176828120,10,3397,339.7,1360755437316,1360755438532,1176819436,1176820652,1216
1360755446,1176828120,14,7501,535.7857143,1360755442114,1360755442626,1176824234,1176824746,512
1360755446,1176828128,10,3050,305,1360755441274,1360755441722,1176823402,1176823850,448
1360755454,1176836116,11,953,86.63636364,1360755443209,1360755452873,1176825325,1176834989,9664
1360755454,1176836144,17,6755,397.3529412,1360755442538,1360755452842,1176824682,1176834986,10304
1360755454,1176836148,12,999,83.25,1360755442920,1360755452840,1176825068,1176834988,9920
1360755516,1176897864,1,95,95,1360755489345,1360755489345,1176871209,1176871209,0
1360755560,1176941984,3,408,136,1360755532170,1360755538186,1176914154,1176920170,6016
1360755796,1177178332,1,46,46,1360755769257,1360755769257,1177151589,1177151589,0
1360756146,1177528420,1,46,46,1360756118542,1360756118542,1177500962,1177500962,0
1360756147,1177529404,1,46,46,1360756118623,1360756118623,1177501027,1177501027,0
1360756165,1177547444,1,46,46,1360756139062,1360756139062,1177521506,1177521506,0
1360756169,1177551420,3,408,136,1360756143055,1360756149071,1177525475,1177531491,6016
1360756214,1177596608,1,48,48,1360756185168,1360756185168,1177567776,1177567776,0
1360756215,1177597612,1,48,48,1360756185099,1360756185099,1177567711,1177567711,0
1360756439,1177820960,598911,898223971,1499.76202,1360755420054,1360756437078,1176802014,1177819038,1017024
1360756639,1178021080,101520,152253223,1499.736239,1360756438618,1360756631002,1177820698,1178013082,192384
1360756706,1178088220,1,46,46,1360756681612,1360756681612,1178063832,1178063832,0
1360756782,1178164228,3,408,136,1360756754438,1360756760454,1178136666,1178142682,6016
1360757275,1178657212,14,6617,472.6428571,1360757248718,1360757248974,1178630930,1178631186,256
1360757275,1178657216,9,861,95.66666667,1360757249608,1360757249800,1178631824,1178632016,192
1360757275,1178657252,9,861,95.66666667,1360757248996,1360757249188,1178631248,1178631440,192
1360757275,1178657252,9,861,95.66666667,1360757249315,1360757249507,1178631567,1178631759,192
1360757391,1178773356,3,408,136,1360757365498,1360757371514,1178747854,1178753870,6016
1360757439,1178821464,1,46,46,1360757414413,1360757414413,1178796877,1178796877,0
1360757455,1178837524,3,189,63,1360757451474,1360757454482,1178833998,1178837006,3008
1360757463,1178845532,3,189,63,1360757456138,1360757459210,1178838670,1178841742,3072
1360757471,1178853532,2,126,63,1360757458505,1360757466569,1178841037,1178849101,8064
1360757479,1178861508,2,126,63,1360757463265,1360757471265,1178845773,1178853773,8000
1360757487,1178869516,3,138,46,1360757481688,1360757481752,1178864204,1178864268,64
1360757487,1178869516,3,138,46,1360757481688,1360757481752,1178864204,1178864268,64
1360757487,1178869528,4,201,50.25,1360757481678,1360757481742,1178864206,1178864270,64
1360757487,1178869528,4,201,50.25,1360757481677,1360757481805,1178864205,1178864333,128
1360757511,1178893672,9,861,95.66666667,1360757483838,1360757484030,1178866510,1178866702,192
1360757511,1178893704,14,6617,472.6428571,1360757483167,1360757483487,1178865871,1178866191,320
1360757511,1178893708,8,815,101.875,1360757483546,1360757483738,1178866254,1178866446,192
1360757511,1178893712,9,861,95.66666667,1360757484051,1360757484243,1178866763,1178866955,192
1360757727,1179109640,4,252,63,1360757719640,1360757726680,1179102280,1179109320,7040
1360757735,1179117652,2,126,63,1360757732685,1360757733645,1179115337,1179116297,960
1360757743,1179125644,2,126,63,1360757735701,1360757739733,1179118345,1179122377,4032
1360757760,1179142272,1,63,63,1360757735113,1360757735113,1179117385,1179117385,0
1360757776,1179158276,1,63,63,1360757748163,1360757748163,1179130439,1179130439,0
1360757815,1179197656,4,252,63,1360757806984,1360757814088,1179189640,1179196744,7104
1360757815,1179197656,4,252,63,1360757807047,1360757814087,1179189703,1179196743,7040
1360757848,1179230600,1,63,63,1360757822143,1360757822143,1179204743,1179204743,0
1360757848,1179230600,1,63,63,1360757822207,1360757822207,1179204807,1179204807,0
1360758001,1179383060,3,408,136,1360757976665,1360757982681,1179358725,1179364741,6016
1360758077,1179459116,1,48,48,1360758049184,1360758049184,1179431300,1179431300,0
1360758209,1179591552,1,56,56,1360758182955,1360758182955,1179565507,1179565507,0
1360758213,1179595600,1,56,56,1360758188668,1360758188668,1179571268,1179571268,0
1360758614,1179996420,3,408,136,1360758588137,1360758594217,1179970557,1179976637,6080
1360759056,1180438448,17,6755,397.3529412,1360759042885,1360759053701,1180425333,1180436149,10816
1360759056,1180438448,12,999,83.25,1360759043268,1360759053700,1180425716,1180436148,10432
1360759056,1180438452,12,999,83.25,1360759043524,1360759053700,1180425976,1180436152,10176
1360759227,1180608928,3,408,136,1360759200010,1360759206026,1180581938,1180587954,6016
1360759343,1180725344,1,46,46,1360759314986,1360759314986,1180697330,1180697330,0
1360759836,1181218172,3,408,136,1360759810256,1360759816336,1181192428,1181198508,6080
1360759897,1181279180,12,999,83.25,1360759881095,1360759890823,1181263275,1181273003,9728
1360759897,1181279180,17,6755,397.3529412,1360759880453,1360759890821,1181262633,1181273001,10368
1360759897,1181279192,12,999,83.25,1360759880824,1360759890808,1181263016,1181273000,9984
1360760417,1181799820,17,6755,397.3529412,1360760403964,1360760414972,1181786784,1181797792,11008
1360760417,1181799824,12,999,83.25,1360760404347,1360760414907,1181787171,1181797731,10560
1360760417,1181799824,11,953,86.63636364,1360760404602,1360760414906,1181787426,1181797730,10304
1360760450,1181831948,3,408,136,1360760421924,1360760427940,1181803872,1181809888,6016
1360760602,1181983892,12,999,83.25,1360760589402,1360760601114,1181971294,1181983006,11712
1360760602,1181983896,12,999,83.25,1360760589910,1360760601110,1181971806,1181983006,11200
1360760602,1181983924,15,6289,419.2666667,1360760588986,1360760601082,1181970910,1181983006,12096
1360760602,1181983928,12,999,83.25,1360760589624,1360760601080,1181971552,1181983008,11456
1360760874,1182256528,1,46,46,1360760849627,1360760849627,1182232155,1182232155,0
1360760966,1182348604,1,46,46,1360760940558,1360760940558,1182323162,1182323162,0
1360761026,1182408240,17,6755,397.3529412,1360761008120,1360761020152,1182390360,1182402392,12032
1360761026,1182408240,12,999,83.25,1360761008503,1360761020151,1182390743,1182402391,11648
1360761026,1182408244,12,999,83.25,1360761009142,1360761020150,1182391386,1182402394,11008
1360761026,1182408284,12,999,83.25,1360761008782,1360761020110,1182391066,1182402394,11328
1360761059,1182441036,3,408,136,1360761033157,1360761039173,1182415193,1182421209,6016
1360761147,1182529120,3,402,134,1360761120749,1360761126829,1182502869,1182508949,6080
1360761925,1183307468,1,46,46,1360761897863,1360761897863,1183280331,1183280331,0
1360761925,1183307472,1,46,46,1360761897923,1360761897923,1183280395,1183280395,0
1360762008,1183390448,1,46,46,1360761982105,1360761982105,1183364553,1183364553,0
1360762060,1183442460,3,402,134,1360762032460,1360762038540,1183414920,1183421000,6080
1360762236,1183618636,1,46,46,1360762209500,1360762209500,1183592136,1183592136,0
1360762396,1183778812,1,46,46,1360762369576,1360762369576,1183752388,1183752388,0
1360762517,1183899068,2,96,48,1360762490126,1360762493134,1183872194,1183875202,3008
1360763092,1184474036,11,953,86.63636364,1360763077991,1360763089895,1184460027,1184471931,11904
1360763092,1184474036,12,999,83.25,1360763078309,1360763089893,1184460345,1184471929,11584
1360763092,1184474060,10,907,90.7,1360763078540,1360763089804,1184460600,1184471864,11264
1360763092,1184474068,11,953,86.63636364,1360763077700,1360763089860,1184459768,1184471928,12160
1360763474,1184856640,1,46,46,1360763449923,1360763449923,1184832563,1184832563,0
1360763474,1184856680,1,46,46,1360763448732,1360763448732,1184831412,1184831412,0
1360763474,1184856680,1,46,46,1360763448602,1360763448602,1184831282,1184831282,0
1360763474,1184856724,1,46,46,1360763448626,1360763448626,1184831350,1184831350,0
1360763474,1184856724,1,46,46,1360763448817,1360763448817,1184831541,1184831541,0
1360763474,1184856724,1,46,46,1360763448881,1360763448881,1184831605,1184831605,0
1360763474,1184856728,1,46,46,1360763449646,1360763449646,1184832374,1184832374,0
1360763476,1184858400,1,46,46,1360763450037,1360763450037,1184832437,1184832437,0
1360763478,1184860644,1,46,46,1360763449984,1360763449984,1184832628,1184832628,0
1360763540,1184922448,15,6289,419.2666667,1360763525059,1360763537155,1184907507,1184919603,12096
1360763540,1184922452,11,953,86.63636364,1360763525759,1360763537151,1184908211,1184919603,11392
1360763540,1184922484,11,953,86.63636364,1360763525407,1360763537119,1184907891,1184919603,11712
1360763540,1184922488,12,999,83.25,1360763525981,1360763537117,1184908469,1184919605,11136
1360763646,1185028820,3,408,136,1360763618766,1360763624782,1185001586,1185007602,6016
1360763795,1185177244,1,46,46,1360763770315,1360763770315,1185152559,1185152559,0
1360763907,1185289656,3,402,134,1360763881004,1360763887020,1185263660,1185269676,6016
1360763963,1185345672,1,46,46,1360763937116,1360763937116,1185319788,1185319788,0
1360764104,1185486280,1,48,48,1360764078433,1360764078433,1185460713,1185460713,0
1360764104,1185486344,1,48,48,1360764078242,1360764078242,1185460586,1185460586,0
1360764104,1185486348,1,48,48,1360764078432,1360764078432,1185460780,1185460780,0
1360764141,1185523252,12,999,83.25,1360764128639,1360764138751,1185510891,1185521003,10112
1360764141,1185523252,12,999,83.25,1360764128894,1360764138750,1185511146,1185521002,9856
1360764141,1185523256,11,953,86.63636364,1360764129212,1360764138684,1185511468,1185520940,9472
1360764421,1185803144,2,120,60,1360764395940,1360764398884,1185778084,1185781028,2944
1360764421,1185803180,2,120,60,1360764394755,1360764397763,1185776935,1185779943,3008
1360764425,1185807164,2,120,60,1360764397009,1360764400017,1185779173,1185782181,3008
1360764425,1185807164,1,60,60,1360764397009,1360764397009,1185779173,1185779173,0
1360764489,1185871484,1,48,48,1360764462991,1360764462991,1185845475,1185845475,0
1360764489,1185871488,1,48,48,1360764463246,1360764463246,1185845734,1185845734,0
1360764489,1185871488,1,48,48,1360764463118,1360764463118,1185845606,1185845606,0
1360764569,1185951768,1,46,46,1360764543090,1360764543090,1185925858,1185925858,0
1360764579,1185961484,1,46,46,1360764550096,1360764550096,1185932580,1185932580,0
1360764579,1185961516,1,46,46,1360764550064,1360764550064,1185932580,1185932580,0
1360764589,1185971496,12,999,83.25,1360764577667,1360764588227,1185960163,1185970723,10560
1360764589,1185971540,12,999,83.25,1360764577879,1360764588183,1185960419,1185970723,10304
1360764589,1185971540,11,953,86.63636364,1360764578134,1360764588182,1185960674,1185970722,10048
1360764661,1186043556,16,6372,398.25,1360764641927,1360764654023,1186024483,1186036579,12096
1360764661,1186043560,12,999,83.25,1360764642306,1360764654018,1186024866,1186036578,11712
1360764661,1186043564,12,999,83.25,1360764642624,1360764654016,1186025188,1186036580,11392
1360764661,1186043564,11,953,86.63636364,1360764642878,1360764654014,1186025442,1186036578,11136
1360764726,1186108084,3,402,134,1360764701598,1360764707678,1186083682,1186089762,6080
1360764962,1186344692,1,64,64,1360764936376,1360764936376,1186319068,1186319068,0
1360765351,1186733236,1,46,46,1360765326012,1360765326012,1186708248,1186708248,0
1360765646,1187028412,5,2431,486.2,1360765637958,1360765638214,1187020370,1187020626,256
1360765654,1187036424,6,2464,410.6666667,1360765637947,1360765648315,1187020371,1187030739,10368
1360765654,1187036476,5,2926,585.2,1360765638408,1360765650888,1187020884,1187033364,12480
1360765662,1187044412,12,999,83.25,1360765643656,1360765655176,1187026068,1187037588,11520
1360765662,1187044412,12,999,83.25,1360765643909,1360765655173,1187026321,1187037585,11264
1360765662,1187044464,12,999,83.25,1360765644115,1360765655123,1187026579,1187037587,11008
1360765664,1187045840,15,6289,419.2666667,1360765643715,1360765655747,1187025555,1187037587,12032
1360765774,1187156668,11,953,86.63636364,1360765758215,1360765770311,1187140883,1187152979,12096
1360765774,1187156668,11,953,86.63636364,1360765758470,1360765770310,1187141138,1187152978,11840
1360765774,1187156720,11,953,86.63636364,1360765758739,1360765770259,1187141459,1187152979,11520
1360765774,1187156720,11,953,86.63636364,1360765758992,1360765770256,1187141712,1187152976,11264
1360765868,1187250228,1,52,52,1360765840700,1360765840700,1187222928,1187222928,0
1360766060,1187442552,1,52,52,1360766033909,1360766033909,1187416461,1187416461,0
1360766060,1187442576,1,52,52,1360766034461,1360766034461,1187417037,1187417037,0
1360766060,1187442580,1,52,52,1360766034970,1360766034970,1187417550,1187417550,0
1360766060,1187442580,1,48,48,1360766035033,1360766035033,1187417613,1187417613,0
1360766060,1187442660,1,52,52,1360766035464,1360766035464,1187418124,1187418124,0
1360766064,1187446544,1,52,52,1360766036092,1360766036092,1187418636,1187418636,0
1360766064,1187446548,1,48,48,1360766036217,1360766036217,1187418765,1187418765,0
1360766064,1187446620,3,152,50.66666667,1360766036018,1360766045042,1187418638,1187427662,9024
1360766064,1187446632,1,52,52,1360766036644,1360766036644,1187419276,1187419276,0
1360766064,1187446664,1,48,48,1360766037254,1360766037254,1187419918,1187419918,0
1360766072,1187454540,3,138,46,1360766046848,1360766055872,1187429388,1187438412,9024
1360766263,1187644996,12,999,83.25,1360766249116,1360766260508,1187631112,1187642504,11392
1360766263,1187645000,12,999,83.25,1360766249433,1360766260441,1187631433,1187642441,11008
1360766263,1187645036,12,999,83.25,1360766248821,1360766260469,1187630857,1187642505,11648
1360766263,1187645076,17,6755,397.3529412,1360766248332,1360766260428,1187630408,1187642504,12096
1360766345,1187727372,3,408,136,1360766318435,1360766324451,1187700807,1187706823,6016
1360766345,1187727412,3,144,48,1360766317245,1360766326141,1187699657,1187708553,8896
1360766447,1187829196,11,953,86.63636364,1360766431826,1360766443666,1187814022,1187825862,11840
1360766447,1187829200,12,999,83.25,1360766432079,1360766443663,1187814279,1187825863,11584
1360766447,1187829240,11,953,86.63636364,1360766431526,1360766443622,1187813766,1187825862,12096
1360766447,1187829268,12,999,83.25,1360766432267,1360766443531,1187814535,1187825799,11264
1360767142,1188524452,1,60,60,1360767115784,1360767115784,1188498236,1188498236,0
1360767150,1188532532,1,60,60,1360767123769,1360767123769,1188506301,1188506301,0
1360767170,1188552588,3,408,136,1360767143359,1360767149375,1188525947,1188531963,6016
1360767210,1188592552,1,46,46,1360767182435,1360767182435,1188564987,1188564987,0
1360767246,1188628556,1,46,46,1360767220577,1360767220577,1188603133,1188603133,0
1360767779,1189161592,3,408,136,1360767754549,1360767760565,1189137141,1189143157,6016
1360768264,1189646788,12,6151,512.5833333,1360768239849,1360768240233,1189622637,1189623021,384
1360768269,1189650820,9,861,95.66666667,1360768241262,1360768241454,1189623082,1189623274,192
1360768269,1189650824,9,861,95.66666667,1360768241516,1360768241708,1189623340,1189623532,192
1360768269,1189650904,9,861,95.66666667,1360768241757,1360768241885,1189623661,1189623789,128
1360768393,1189775116,3,408,136,1360768366471,1360768372487,1189748587,1189754603,6016
1360768489,1189871588,2,126,63,1360768487340,1360768488364,1189869928,1189870952,1024
1360768497,1189879568,2,126,63,1360768490369,1360768494401,1189872937,1189876969,4032
1360768529,1189911468,1,63,63,1360768502565,1360768502565,1189885033,1189885033,0
1360768562,1189943840,4,252,63,1360768553751,1360768560791,1189935591,1189942631,7040
1360768578,1189959848,4,252,63,1360768568976,1360768576016,1189950824,1189957864,7040
1360768594,1189975992,1,63,63,1360768568701,1360768568701,1189950693,1189950693,0
1360768610,1189992056,1,63,63,1360768583872,1360768583872,1189965928,1189965928,0
1360768658,1190039896,4,252,63,1360768649696,1360768656736,1190031592,1190038632,7040
1360768690,1190072076,1,63,63,1360768664618,1360768664618,1190046694,1190046694,0
1360769002,1190384684,3,408,136,1360768977607,1360768983623,1190360291,1190366307,6016
1360769006,1190388716,3,152,50.66666667,1360768979877,1360768981093,1190362593,1190363809,1216
1360769006,1190388748,3,152,50.66666667,1360768980931,1360768982147,1190363679,1190364895,1216
1360769010,1190392736,3,152,50.66666667,1360768982031,1360768983311,1190364767,1190366047,1280
1360769010,1190392736,2,104,52,1360768982095,1360768985039,1190364831,1190367775,2944
1360769503,1190885536,1,46,46,1360769477329,1360769477329,1190859865,1190859865,0
1360769616,1190997980,3,408,136,1360769590141,1360769596157,1190972121,1190978137,6016
1360769736,1191118416,1,46,46,1360769709894,1360769709894,1191092310,1191092310,0
1360769865,1191246856,1,48,48,1360769839286,1360769839286,1191221142,1191221142,0
1360770034,1191416788,43,55063,1280.534884,1360770029517,1360770029773,1191412305,1191412561,256
1360770050,1191432732,12,999,83.25,1360770036934,1360770044166,1191419666,1191426898,7232
1360770050,1191432780,17,6755,397.3529412,1360770036567,1360770044183,1191419347,1191426963,7616
1360770050,1191432804,12,999,83.25,1360770037182,1360770044094,1191419986,1191426898,6912
1360770065,1191447300,1,46,46,1360770037043,1360770037043,1191419343,1191419343,0
1360770213,1191595760,1,48,48,1360770185704,1360770185704,1191568464,1191568464,0
1360770229,1191611680,3,408,136,1360770201655,1360770207671,1191584335,1191590351,6016
1360770307,1191688848,16,6372,398.25,1360770291959,1360770304055,1191673807,1191685903,12096
1360770307,1191688852,11,953,86.63636364,1360770292594,1360770304050,1191674446,1191685902,11456
1360770307,1191688852,12,999,83.25,1360770292848,1360770303984,1191674700,1191685836,11136
1360770307,1191688928,12,999,83.25,1360770292261,1360770303973,1191674189,1191685901,11712
1360770475,1191856952,2,92,46,1360770469385,1360770469577,1191851337,1191851529,192
1360770483,1191865036,13,3408,262.1538462,1360770468791,1360770482231,1191850827,1191864267,13440
1360770483,1191865036,12,999,83.25,1360770468855,1360770480951,1191850891,1191862987,12096
1360770483,1191865040,12,999,83.25,1360770469300,1360770480884,1191851340,1191862924,11584
1360770483,1191865040,11,953,86.63636364,1360770469681,1360770480881,1191851721,1191862921,11200
1360770483,1191865044,13,1045,80.38461538,1360770469999,1360770481327,1191852043,1191863371,11328
1360770803,1192185692,1,46,46,1360770778657,1360770778657,1192161349,1192161349,0
1360770803,1192185756,9,861,95.66666667,1360770778656,1360770778848,1192161412,1192161604,192
1360770804,1192185824,13,6234,479.5384615,1360770779141,1360770779461,1192160965,1192161285,320
1360770807,1192189612,9,861,95.66666667,1360770779376,1360770779504,1192161988,1192162116,128
1360770807,1192189688,8,815,101.875,1360770778982,1360770779174,1192161670,1192161862,192
1360770839,1192221784,3,408,136,1360770813509,1360770819461,1192196293,1192202245,5952
1360771067,1192449668,4,252,63,1360771058615,1360771065655,1192441283,1192448323,7040
1360771067,1192449748,4,252,63,1360771058532,1360771065636,1192441280,1192448384,7104
1360771100,1192482120,1,63,63,1360771074266,1360771074266,1192456386,1192456386,0
1360771100,1192482204,1,63,63,1360771074117,1360771074117,1192456321,1192456321,0
1360771107,1192489700,3,189,63,1360771099926,1360771102934,1192482626,1192485634,3008
1360771107,1192489704,3,189,63,1360771100178,1360771103250,1192482882,1192485954,3072
1360771123,1192505676,2,126,63,1360771106990,1360771114990,1192489666,1192497666,8000
1360771123,1192505700,2,126,63,1360771107287,1360771115287,1192489987,1192497987,8000
1360771380,1192762560,14,6617,472.6428571,1360771352476,1360771352796,1192735036,1192735356,320
1360771380,1192762588,9,861,95.66666667,1360771353154,1360771353282,1192735742,1192735870,128
1360771380,1192762588,8,815,101.875,1360771353408,1360771353600,1192735996,1192736188,192
1360771380,1192762732,8,815,101.875,1360771352753,1360771352881,1192735485,1192735613,128
1360771452,1192834788,3,408,136,1360771425081,1360771431097,1192807869,1192813885,6016
1360771516,1192898788,1,127,127,1360771488886,1360771488886,1192871674,1192871674,0
1360771548,1192929956,2,126,63,1360771545589,1360771546613,1192927545,1192928569,1024
1360771548,1192930000,3,189,63,1360771543947,1360771546955,1192925947,1192928955,3008
1360771556,1192937920,2,126,63,1360771548636,1360771552668,1192930556,1192934588,4032
1360771564,1192945932,2,126,63,1360771551053,1360771559117,1192932985,1192941049,8064
1360771585,1192966852,1,127,127,1360771557276,1360771557276,1192939128,1192939128,0
1360771585,1192967048,1,63,63,1360771560601,1360771560601,1192942649,1192942649,0
1360771620,1193001940,2,126,63,1360771617863,1360771618887,1192999803,1193000827,1024
1360771620,1193002324,2,126,63,1360771617479,1360771618439,1192999803,1193000763,960
1360771628,1193009960,2,126,63,1360771620851,1360771624883,1193002811,1193006843,4032
1360771628,1193010036,2,126,63,1360771620771,1360771624803,1193002807,1193006839,4032
1360771657,1193039252,1,63,63,1360771632653,1360771632653,1193014905,1193014905,0
1360771657,1193039252,1,63,63,1360771632651,1360771632651,1193014903,1193014903,0
1360772062,1193444520,3,408,136,1360772036602,1360772042618,1193419122,1193425138,6016
1360772172,1193554340,12,999,83.25,1360772160044,1360772167916,1193542384,1193550256,7872
1360772172,1193554360,11,953,86.63636364,1360772160280,1360772167896,1193542640,1193550256,7616
1360772172,1193554440,16,6372,398.25,1360772159562,1360772167882,1193542002,1193550322,8320
1360772676,1194058072,3,408,136,1360772648498,1360772654514,1194030570,1194036586,6016
1360772724,1194106364,1,46,46,1360772697676,1360772697676,1194080040,1194080040,0
1360772820,1194202564,1,48,48,1360772794243,1360772794243,1194176807,1194176807,0
1360773101,1194483200,1,48,48,1360773076521,1360773076521,1194458721,1194458721,0
1360773285,1194667432,3,408,136,1360773258880,1360773264896,1194641312,1194647328,6016
1360773688,1195069860,1,46,46,1360773660727,1360773660727,1195042587,1195042587,0
1360773689,1195071080,1,46,46,1360773660572,1360773660572,1195042652,1195042652,0
1360773899,1195281032,3,408,136,1360773871240,1360773877320,1195253272,1195259352,6080
1360773991,1195373008,8,815,101.875,1360773963356,1360773963548,1195345364,1195345556,192
1360773991,1195373076,9,861,95.66666667,1360773963032,1360773963224,1195345108,1195345300,192
1360773991,1195373088,9,861,95.66666667,1360773963534,1360773963726,1195345622,1195345814,192
1360774070,1195452268,12,999,83.25,1360774053273,1360774064665,1195435541,1195446933,11392
1360774070,1195452268,12,999,83.25,1360774053016,1360774064664,1195435284,1195446932,11648
1360774070,1195452316,17,6755,397.3529412,1360774052522,1360774064618,1195434838,1195446934,12096
1360774070,1195452320,12,999,83.25,1360774053476,1360774064612,1195435796,1195446932,11136
1360774182,1195564292,4,252,63,1360774173437,1360774180541,1195555729,1195562833,7104
1360774215,1195597512,1,63,63,1360774188320,1360774188320,1195570832,1195570832,0
1360774246,1195628348,4,252,63,1360774237382,1360774244422,1195619730,1195626770,7040
1360774246,1195628396,4,252,63,1360774237334,1360774244374,1195619730,1195626770,7040
1360774279,1195661580,1,63,63,1360774252252,1360774252252,1195634832,1195634832,0
1360774279,1195661664,1,63,63,1360774252168,1360774252168,1195634832,1195634832,0
1360774496,1195878124,3,144,48,1360774468258,1360774469410,1195850382,1195851534,1152
1360774496,1195878200,3,144,48,1360774470357,1360774471637,1195852557,1195853837,1280
1360774496,1195878200,3,144,48,1360774470421,1360774479253,1195852621,1195861453,8832
1360774496,1195878240,3,144,48,1360774469230,1360774470510,1195851470,1195852750,1280
1360774508,1195890188,3,408,136,1360774482403,1360774488419,1195864591,1195870607,6016
1360774865,1196246852,1,64,64,1360774840556,1360774840556,1196222408,1196222408,0
1360774865,1196246856,6,384,64,1360774840681,1360774845609,1196222537,1196227465,4928
1360774865,1196246936,1,64,64,1360774840282,1360774840282,1196222218,1196222218,0
1360774865,1196246940,1,64,64,1360774840533,1360774840533,1196222473,1196222473,0
1360774945,1196326808,4,202,50.5,1360774916953,1360774938073,1196298761,1196319881,21120
1360775121,1196503068,3,408,136,1360775094544,1360775100560,1196476612,1196482628,6016
1360775167,1196548812,12,999,83.25,1360775153360,1360775163408,1196535172,1196545220,10048
1360775167,1196548816,12,999,83.25,1360775153611,1360775163403,1196535427,1196545219,9792
1360775167,1196548940,17,6755,397.3529412,1360775152848,1360775163280,1196534788,1196545220,10432
1360775730,1197112312,3,408,136,1360775705426,1360775711378,1197087738,1197093690,5952
1360776107,1197489652,1,46,46,1360776080312,1360776080312,1197462964,1197462964,0
1360776108,1197490504,1,46,46,1360776080335,1360776080335,1197462839,1197462839,0
1360776343,1197725600,3,408,136,1360776316329,1360776322345,1197698929,1197704945,6016
1360776495,1197877748,3,152,50.66666667,1360776466963,1360776468435,1197849711,1197851183,1472
1360776495,1197877760,3,152,50.66666667,1360776468102,1360776477126,1197850862,1197859886,9024
1360776495,1197877764,3,152,50.66666667,1360776468101,1360776469509,1197850865,1197852273,1408
1360776592,1197973900,1,46,46,1360776566947,1360776566947,1197948847,1197948847,0
1360776924,1198306372,14,6617,472.6428571,1360776897606,1360776897926,1198279978,1198280298,320
1360776924,1198306396,9,861,95.66666667,1360776898220,1360776898412,1198280616,1198280808,192
1360776924,1198306476,9,861,95.66666667,1360776897886,1360776898078,1198280362,1198280554,192
1360776953,1198334828,3,408,136,1360776928038,1360776934054,1198309866,1198315882,6016
1360776996,1198378780,1,46,46,1360776970093,1360776970093,1198352873,1198352873,0
1360777097,1198479308,3,189,63,1360777093187,1360777096195,1198475495,1198478503,3008
1360777113,1198495136,2,126,63,1360777100400,1360777108464,1198482536,1198490600,8064
1360777129,1198511212,3,189,63,1360777123616,1360777126688,1198505828,1198508900,3072
1360777137,1198519080,4,252,63,1360777129191,1360777136231,1198511271,1198518311,7040
1360777145,1198527112,2,126,63,1360777130822,1360777138822,1198512934,1198520934,8000
1360777153,1198535172,2,92,46,1360777148171,1360777148171,1198530343,1198530343,0
1360777153,1198535176,5,264,52.8,1360777144198,1360777148294,1198526374,1198530470,4096
1360777153,1198535252,4,201,50.25,1360777148089,1360777148153,1198530341,1198530405,64
1360777177,1198559320,8,815,101.875,1360777149876,1360777150068,1198532196,1198532388,192
1360777177,1198559408,9,861,95.66666667,1360777149532,1360777149724,1198531940,1198532132,192
1360777177,1198559432,9,861,95.66666667,1360777150021,1360777150213,1198532453,1198532645,192
1360777177,1198559436,9,861,95.66666667,1360777150339,1360777150467,1198532775,1198532903,128
1360777385,1198767228,2,126,63,1360777382351,1360777383375,1198764579,1198765603,1024
1360777393,1198775240,2,126,63,1360777385411,1360777389443,1198767651,1198771683,4032
1360777409,1198791288,3,189,63,1360777403987,1360777406995,1198786275,1198789283,3008
1360777417,1198799176,3,189,63,1360777413698,1360777416706,1198795874,1198798882,3008
1360777422,1198804104,1,63,63,1360777397578,1360777397578,1198779682,1198779682,0
1360777425,1198807312,2,126,63,1360777411065,1360777419065,1198793377,1198801377,8000
1360777433,1198815240,2,126,63,1360777420674,1360777428738,1198802914,1198810978,8064
1360777497,1198879312,4,252,63,1360777488377,1360777495417,1198870689,1198877729,7040
1360777530,1198912176,1,63,63,1360777503616,1360777503616,1198885792,1198885792,0
1360777566,1198948460,3,408,136,1360777538404,1360777544420,1198920864,1198926880,6016
1360777646,1199028584,1,46,46,1360777618789,1360777618789,1199001373,1199001373,0
1360777751,1199132972,1,46,46,1360777726730,1360777726730,1199108702,1199108702,0
1360777803,1199185264,1,46,46,1360777775717,1360777775717,1199157981,1199157981,0
1360777803,1199185300,1,46,46,1360777775744,1360777775744,1199158044,1199158044,0
1360778176,1199558028,3,408,136,1360778149322,1360778155274,1199531350,1199537302,5952
1360778713,1200095056,12,6151,512.5833333,1360778687720,1360778688232,1200069776,1200070288,512
1360778717,1200099060,9,861,95.66666667,1360778689633,1360778689825,1200071693,1200071885,192
1360778717,1200099068,8,815,101.875,1360778689883,1360778690075,1200071951,1200072143,192
1360778717,1200099136,9,861,95.66666667,1360778689302,1360778689494,1200071438,1200071630,192
1360778789,1200171064,3,408,136,1360778760987,1360778767067,1200143051,1200149131,6080
1360778813,1200195204,1,46,46,1360778787280,1360778787280,1200169484,1200169484,0
1360778834,1200216248,3,150,50,1360778811108,1360778831588,1200193356,1200213836,20480
1360778837,1200219104,3,152,50.66666667,1360778810165,1360778811701,1200192269,1200193805,1536
1360778837,1200219140,3,152,50.66666667,1360778811215,1360778812623,1200193355,1200194763,1408
1360778837,1200219184,3,152,50.66666667,1360778808932,1360778810404,1200191116,1200192588,1472
1360778962,1200344328,3,189,63,1360778955985,1360778958993,1200338313,1200341321,3008
1360778962,1200344332,3,189,63,1360778956173,1360778959181,1200338505,1200341513,3008
1360778978,1200360304,2,126,63,1360778963241,1360778971305,1200345545,1200353609,8064
1360778978,1200360404,2,126,63,1360778962951,1360778971015,1200345355,1200353419,8064
1360778978,1200360416,2,126,63,1360778975418,1360778976442,1200357834,1200358858,1024
1360778986,1200368392,2,126,63,1360778978513,1360778982545,1200360905,1200364937,4032
1360778986,1200368464,2,126,63,1360778984202,1360778985226,1200366666,1200367690,1024
1360778994,1200376424,2,126,63,1360778987250,1360778991282,1200369674,1200373706,4032
1360779017,1200399364,1,63,63,1360778990574,1360778990574,1200372938,1200372938,0
1360779025,1200407376,1,63,63,1360778999393,1360778999393,1200381769,1200381769,0
1360779342,1200724044,1,46,46,1360779315049,1360779315049,1200697093,1200697093,0
1360779398,1200780336,3,408,136,1360779371205,1360779377221,1200753541,1200759557,6016
1360779474,1200856496,3,152,50.66666667,1360779447972,1360779449252,1200830468,1200831748,1280
1360779474,1200856508,3,152,50.66666667,1360779449111,1360779450391,1200831619,1200832899,1280
1360779478,1200860428,3,152,50.66666667,1360779450280,1360779451496,1200832708,1200833924,1216
1360779478,1200860516,3,152,50.66666667,1360779450188,1360779459212,1200832704,1200841728,9024
1360779791,1201173240,2,104,52,1360779765661,1360779768669,1201147901,1201150909,3008
1360779791,1201173244,3,152,50.66666667,1360779765659,1360779766875,1201147903,1201149119,1216
1360779791,1201173292,3,152,50.66666667,1360779763371,1360779764587,1201145663,1201146879,1216
1360779791,1201173324,3,152,50.66666667,1360779764425,1360779765641,1201146749,1201147965,1216
1360779945,4134607596,2,96,48,1360779917292,1360779920172,4134579888,4134582768,2880
1360780007,1201389612,3,408,136,1360779982631,1360779988647,1201365243,1201371259,6016
1360780033,4134695776,2,96,48,1360780007098,1360780009978,4134669874,4134672754,2880
1360780504,1201886468,14,6617,472.6428571,1360780477677,1360780477997,1201860145,1201860465,320
1360780504,1201886476,9,861,95.66666667,1360780478312,1360780478504,1201860788,1201860980,192
1360780504,1201886564,9,861,95.66666667,1360780477967,1360780478159,1201860531,1201860723,192
1360780594,1201975952,1,48,48,1360780564848,1360780564848,1201946800,1201946800,0
1360780595,1201977284,1,48,48,1360780564516,1360780564516,1201946800,1201946800,0
1360780620,1202002548,3,408,136,1360780594589,1360780600541,1201977137,1201983089,5952
1360780677,1202059204,2,126,63,1360780675443,1360780676467,1202057647,1202058671,1024
1360780685,1202067152,2,126,63,1360780678502,1360780682534,1202060654,1202064686,4032
1360780717,1202098940,1,63,63,1360780690812,1360780690812,1202072752,1202072752,0
1360780757,1202139436,4,252,63,1360780748235,1360780755339,1202130671,1202137775,7104
1360780781,1202163324,2,92,46,1360780775033,1360780775033,1202157357,1202157357,0
1360780781,1202163336,5,264,52.8,1360780763439,1360780775087,1202145775,1202157423,11648
1360780801,1202182996,9,861,95.66666667,1360780776707,1360780776899,1202158703,1202158895,192
1360780801,1202183072,2,109,54.5,1360780775288,1360780775288,1202157360,1202157360,0
1360780801,1202183104,8,815,101.875,1360780776342,1360780776470,1202158446,1202158574,128
1360780801,1202183104,9,861,95.66666667,1360780776084,1360780776212,1202158188,1202158316,128
1360780805,1202186984,8,815,101.875,1360780776974,1360780777166,1202158958,1202159150,192
1360781006,1202388068,2,126,63,1360781003640,1360781004600,1202385708,1202386668,960
1360781014,1202396056,2,126,63,1360781006657,1360781010689,1202388713,1202392745,4032
1360781038,1202420044,2,126,63,1360781034767,1360781035791,1202416811,1202417835,1024
1360781045,1202427764,1,63,63,1360781018045,1360781018045,1202400809,1202400809,0
1360781046,1202427928,2,126,63,1360781037954,1360781041986,1202419882,1202423914,4032
1360781077,1202459760,1,63,63,1360781049218,1360781049218,1202431978,1202431978,0
1360781158,1202540232,3,189,63,1360781151377,1360781154385,1202533609,1202536617,3008
1360781158,1202540232,3,189,63,1360781151376,1360781154384,1202533608,1202536616,3008
1360781174,1202556172,2,126,63,1360781158477,1360781166541,1202540649,1202548713,8064
1360781174,1202556172,2,126,63,1360781158477,1360781166541,1202540649,1202548713,8064
1360781234,1202616496,3,408,136,1360781206405,1360781212421,1202588901,1202594917,6016
1360781844,1203226076,3,408,136,1360781817380,1360781823460,1203199456,1203205536,6080
1360782071,1203453120,15,6289,419.2666667,1360782057140,1360782064180,1203439260,1203446300,7040
1360782071,1203453120,12,999,83.25,1360782057522,1360782064178,1203439642,1203446298,6656
1360782071,1203453228,12,999,83.25,1360782057736,1360782070088,1203439964,1203452316,12352
1360782071,1203453228,11,953,86.63636364,1360782058054,1360782070086,1203440282,1203452314,12032
1360782100,1203482224,1,46,46,1360782072584,1360782072584,1203454808,1203454808,0
1360782457,1203838916,3,408,136,1360782430007,1360782435959,1203811923,1203817875,5952
1360783066,1204448048,3,408,136,1360783041132,1360783047212,1204423180,1204429260,6080
1360783679,1205061248,3,408,136,1360783651803,1360783657819,1205034051,1205040067,6016
1360783704,1205086284,1,46,46,1360783675574,1360783675574,1205057858,1205057858,0
1360783743,1205125348,9,861,95.66666667,1360783717939,1360783718131,1205100287,1205100479,192
1360783743,1205125456,14,6617,472.6428571,1360783717450,1360783717770,1205099906,1205100226,320
1360783743,1205125460,9,861,95.66666667,1360783718149,1360783718341,1205100609,1205100801,192
1360783743,1205125464,9,861,95.66666667,1360783718400,1360783718592,1205100864,1205101056,192
1360783952,1205334588,4,252,63,1360783944321,1360783951425,1205326909,1205334013,7104
1360783968,1205350532,4,252,63,1360783960315,1360783967355,1205342847,1205349887,7040
1360783987,1205369676,1,63,63,1360783959337,1360783959337,1205342013,1205342013,0
1360784003,1205385764,1,63,63,1360783975187,1360783975187,1205357951,1205357951,0
1360784064,1205446676,4,252,63,1360784055591,1360784062631,1205438267,1205445307,7040
1360784096,1205477876,1,63,63,1360784071494,1360784071494,1205453370,1205453370,0
1360784136,1205518648,4,252,63,1360784128579,1360784135619,1205511227,1205518267,7040
1360784172,1205553972,1,63,63,1360784144294,1360784144294,1205526266,1205526266,0
1360784292,1205673916,3,408,136,1360784264030,1360784270110,1205645946,1205652026,6080
1360784802,1206184680,1,46,46,1360784774615,1360784774615,1206157295,1206157295,0
1360784902,1206283812,3,408,136,1360784875387,1360784881403,1206257199,1206263215,6016
1360785511,1206893428,3,408,136,1360785485003,1360785491019,1206867431,1206873447,6016
1360785531,1206913728,13,6234,479.5384615,1360785506463,1360785506783,1206889191,1206889511,320
1360785535,1206917572,9,861,95.66666667,1360785507256,1360785507448,1206889828,1206890020,192
1360785535,1206917576,9,861,95.66666667,1360785507508,1360785507700,1206890084,1206890276,192
1360785535,1206917652,9,861,95.66666667,1360785506921,1360785507113,1206889573,1206889765,192
1360785746,1207127940,4,252,63,1360785737710,1360785744814,1207119650,1207126754,7104
1360785778,1207160072,3,189,63,1360785773929,1360785776937,1207156001,1207159009,3008
1360785779,1207161812,1,63,63,1360785751942,1360785751942,1207134754,1207134754,0
1360785794,1207176000,2,126,63,1360785781043,1360785789043,1207163043,1207171043,8000
1360785802,1207183948,2,126,63,1360785800102,1360785801062,1207182050,1207183010,960
1360785810,1207191972,2,126,63,1360785803083,1360785807115,1207185055,1207189087,4032
1360785818,1207200076,2,126,63,1360785816677,1360785817701,1207198753,1207199777,1024
1360785826,1207207948,2,126,63,1360785819876,1360785823844,1207201824,1207205792,3968
1360785840,1207221880,1,63,63,1360785815210,1360785815210,1207197090,1207197090,0
1360785860,1207242008,1,63,63,1360785831847,1360785831847,1207213855,1207213855,0
1360786124,1207506336,3,408,136,1360786097179,1360786103259,1207479515,1207485595,6080
1360786565,1207947552,1,92,92,1360786538939,1360786538939,1207921491,1207921491,0
1360786734,1208115896,3,408,136,1360786708938,1360786714954,1208090834,1208096850,6016
1360786897,1208279272,1,48,48,1360786866575,1360786866575,1208248847,1208248847,0
1360787251,1208633620,17,6755,397.3529412,1360787236592,1360787248368,1208619212,1208630988,11776
1360787251,1208633668,19,7877,414.5789474,1360787236223,1360787248255,1208618891,1208630923,12032
1360787251,1208633708,12,999,83.25,1360787236885,1360787248277,1208619593,1208630985,11392
1360787251,1208633708,11,953,86.63636364,1360787237142,1360787248278,1208619850,1208630986,11136
1360787251,1208633712,12,999,83.25,1360787237460,1360787248212,1208620172,1208630924,10752
1360787321,1208703268,1,46,46,1360787292559,1360787292559,1208674827,1208674827,0
1360787348,1208729912,3,408,136,1360787320369,1360787326385,1208702281,1208708297,6016
1360787428,1208810040,1,46,46,1360787399922,1360787399922,1208781962,1208781962,0
1360787957,1209339468,3,408,136,1360787931901,1360787937917,1209314369,1209320385,6016
1360788086,1209467892,1,48,48,1360788060602,1360788060602,1209442494,1209442494,0
1360788150,1209531912,14,6617,472.6428571,1360788123363,1360788123619,1209505275,1209505531,256
1360788150,1209532028,9,861,95.66666667,1360788123632,1360788123760,1209505660,1209505788,128
1360788150,1209532032,9,861,95.66666667,1360788123887,1360788124079,1209505919,1209506111,192
1360788340,1209722324,2,126,63,1360788338372,1360788339332,1209720696,1209721656,960
1360788348,1209730288,2,126,63,1360788341417,1360788345449,1209723705,1209727737,4032
1360788348,1209730320,2,126,63,1360788345035,1360788345995,1209727355,1209728315,960
1360788356,1209738236,2,126,63,1360788348126,1360788352158,1209730362,1209734394,4032
1360788378,1209760640,1,63,63,1360788353162,1360788353162,1209735802,1209735802,0
1360788386,1209768552,1,63,63,1360788359840,1360788359840,1209742392,1209742392,0
1360788420,1209802316,2,126,63,1360788417039,1360788418063,1209799355,1209800379,1024
1360788428,1209810268,2,126,63,1360788420094,1360788424126,1209802362,1209806394,4032
1360788435,1209816852,8,815,101.875,1360788409563,1360788409755,1209791415,1209791607,192
1360788435,1209816856,9,861,95.66666667,1360788409818,1360788410010,1209791674,1209791866,192
1360788435,1209816936,8,815,101.875,1360788408969,1360788409161,1209790905,1209791097,192
1360788435,1209816936,8,815,101.875,1360788409225,1360788409417,1209791161,1209791353,192
1360788459,1209840896,1,63,63,1360788432561,1360788432561,1209814457,1209814457,0
1360788571,1209953288,3,408,136,1360788543719,1360788549735,1209926007,1209932023,6016
1360788644,1210026432,4,252,63,1360788636757,1360788643797,1210019189,1210026229,7040
1360788644,1210026432,3,189,63,1360788636820,1360788639892,1210019252,1210022324,3072
1360788644,1210026512,3,189,63,1360788636805,1360788639813,1210019317,1210022325,3008
1360788660,1210042504,2,126,63,1360788643854,1360788651918,1210026358,1210034422,8064
1360788660,1210042552,2,126,63,1360788643807,1360788651807,1210026359,1210034359,8000
1360788679,1210061568,1,63,63,1360788651725,1360788651725,1210034293,1210034293,0
1360788724,1210106448,4,252,63,1360788715076,1360788722116,1210097524,1210104564,7040
1360788756,1210137788,1,63,63,1360788730839,1360788730839,1210112627,1210112627,0
1360789180,1210562032,3,408,136,1360789154589,1360789160605,1210536621,1210542637,6016
1360789793,1211175176,3,408,136,1360789765570,1360789771586,1211147746,1211153762,6016
1360789941,1211323664,9,861,95.66666667,1360789913624,1360789913752,1211296288,1211296416,128
1360789942,1211323824,13,6234,479.5384615,1360789914019,1360789914339,1211295843,1211296163,320
1360789942,1211323856,9,861,95.66666667,1360789914691,1360789914819,1211296547,1211296675,128
1360789942,1211323856,8,815,101.875,1360789914945,1360789915137,1211296801,1211296993,192
1360790166,1211548656,3,189,63,1360790160480,1360790163488,1211543136,1211546144,3008
1360790182,1211564560,2,126,63,1360790167677,1360790175677,1211550237,1211558237,8000
1360790214,1211596584,4,252,63,1360790205221,1360790212325,1211587805,1211594909,7104
1360790214,1211596624,2,126,63,1360790211454,1360790212414,1211594078,1211595038,960
1360790222,1211604636,2,126,63,1360790214451,1360790218483,1211597087,1211601119,4032
1360790247,1211628920,1,63,63,1360790220988,1360790220988,1211602908,1211602908,0
1360790255,1211636772,1,63,63,1360790227410,1360790227410,1211609182,1211609182,0
1360790294,1211676608,3,189,63,1360790286798,1360790289806,1211669406,1211672414,3008
1360790310,1211692576,2,126,63,1360790293869,1360790301933,1211676445,1211684509,8064
1360790403,1211785140,3,408,136,1360790376415,1360790382431,1211758555,1211764571,6016
1360791017,1212398988,3,408,136,1360790989100,1360790995116,1212371088,1212377104,6016
1360791495,1212877396,17,6755,397.3529412,1360791480652,1360791492748,1212863048,1212875144,12096
1360791495,1212877432,12,999,83.25,1360791481513,1360791492713,1212863945,1212875145,11200
1360791495,1212877508,12,999,83.25,1360791480927,1360791492639,1212863435,1212875147,11712
1360791495,1212877508,12,999,83.25,1360791481180,1360791492700,1212863688,1212875208,11520
1360791626,1213008236,3,408,136,1360791599725,1360791605741,1212981961,1212987977,6016
1360791690,1213072344,1,404,404,1360791664254,1360791664254,1213046598,1213046598,0
1360792103,1213485732,12,999,83.25,1360792086965,1360792098613,1213469697,1213481345,11648
1360792103,1213485740,12,999,83.25,1360792087214,1360792098606,1213469954,1213481346,11392
1360792103,1213485744,12,999,83.25,1360792087465,1360792098601,1213470209,1213481345,11136
1360792104,1213485812,16,6372,398.25,1360792087499,1360792099531,1213469311,1213481343,12032
1360792235,1213617316,3,408,136,1360792210577,1360792216593,1213592893,1213598909,6016
1360792732,1214114552,1,46,46,1360792706207,1360792706207,1214088759,1214088759,0
1360792849,1214231028,3,408,136,1360792821803,1360792827819,1214203831,1214209847,6016
1360792853,1214234904,6,384,64,1360792825382,1360792830822,1214207286,1214212726,5440
1360792853,1214234940,6,384,64,1360792826431,1360792831871,1214208371,1214213811,5440
1360792853,1214234952,5,320,64,1360792827508,1360792831860,1214209460,1214213812,4352
1360792853,1214235060,5,320,64,1360792827401,1360792831753,1214209461,1214213813,4352
1360792985,1214367712,12,999,83.25,1360792972156,1360792983804,1214354868,1214366516,11648
1360792985,1214367716,11,953,86.63636364,1360792972405,1360792983797,1214355121,1214366513,11392
1360792986,1214367740,11,953,86.63636364,1360792973640,1360792984776,1214355380,1214366516,11136
1360792986,1214367788,17,6755,397.3529412,1360792972696,1360792984792,1214354484,1214366580,12096
1360793458,1214840328,3,408,136,1360793433202,1360793439218,1214815530,1214821546,6016
1360794071,1215453532,3,408,136,1360794044701,1360794050717,1215427233,1215433249,6016
1360794681,1216062932,3,408,136,1360794656302,1360794662254,1216038234,1216044186,5952
1360794770,1216152356,1,46,46,1360794741187,1360794741187,1216123543,1216123543,0
1360794789,1216171284,12,999,83.25,1360794772556,1360794784268,1216154840,1216166552,11712
1360794789,1216171288,12,999,83.25,1360794773128,1360794784264,1216155416,1216166552,11136
1360794789,1216171364,12,999,83.25,1360794772795,1360794784187,1216155159,1216166551,11392
1360794789,1216171404,16,6372,398.25,1360794772052,1360794784148,1216154456,1216166552,12096
1360795173,1216555464,3,405,135,1360795146131,1360795152147,1216528595,1216534611,6016
1360795867,1217249384,1,46,46,1360795841943,1360795841943,1217224327,1217224327,0
1360796151,1217533540,3,408,136,1360796123830,1360796129910,1217506370,1217512450,6080
1360796480,1217862564,16,6372,398.25,1360796461592,1360796473688,1217844156,1217856252,12096
1360796480,1217862644,12,999,83.25,1360796461899,1360796473611,1217844543,1217856255,11712
1360796480,1217862644,12,999,83.25,1360796462153,1360796473609,1217844797,1217856253,11456
1360796480,1217862648,12,999,83.25,1360796462470,1360796473606,1217845118,1217856254,11136
1360796990,1218372400,1,48,48,1360796964149,1360796964149,1218346549,1218346549,0
1360797200,1218581848,1,46,46,1360797171033,1360797171033,1218552881,1218552881,0
1360797363,1218744760,11,953,86.63636364,1360797349617,1360797359729,1218731377,1218741489,10112
1360797363,1218744808,12,999,83.25,1360797349057,1360797359681,1218730865,1218741489,10624
1360797363,1218744808,12,999,83.25,1360797349312,1360797359680,1218731120,1218741488,10368
1360797391,1218773192,8,815,101.875,1360797366658,1360797366850,1218748850,1218749042,192
1360797391,1218773268,13,6234,479.5384615,1360797366197,1360797366517,1218748465,1218748785,320
1360797395,1218777116,9,861,95.66666667,1360797366986,1360797367178,1218749102,1218749294,192
1360797395,1218777204,9,861,95.66666667,1360797367219,1360797367347,1218749423,1218749551,128
1360797447,1218829260,3,402,134,1360797421117,1360797427197,1218803377,1218809457,6080
1360797651,1219033148,2,126,63,1360797648807,1360797649767,1219030955,1219031915,960
1360797651,1219033220,2,126,63,1360797648672,1360797649696,1219030892,1219031916,1024
1360797659,1219041116,2,126,63,1360797651850,1360797655882,1219033966,1219037998,4032
1360797659,1219041116,2,126,63,1360797651786,1360797655818,1219033902,1219037934,4032
1360797675,1219057136,2,126,63,1360797672307,1360797673331,1219054443,1219055467,1024
1360797683,1219065168,2,126,63,1360797675347,1360797679379,1219057515,1219061547,4032
1360797692,1219073812,1,63,63,1360797664248,1360797664248,1219046060,1219046060,0
1360797692,1219073812,1,63,63,1360797664183,1360797664183,1219045995,1219045995,0
1360797707,1219089144,3,189,63,1360797700012,1360797703020,1219082156,1219085164,3008
1360797712,1219093928,1,63,63,1360797687619,1360797687619,1219069547,1219069547,0
1360797723,1219105196,2,126,63,1360797706999,1360797715063,1219089195,1219097259,8064
1360798886,1220268604,1,46,46,1360798860879,1360798860879,1220243483,1220243483,0
1360799130,1220512120,3,408,136,1360799102444,1360799108460,1220484564,1220490580,6016
1360799186,1220568156,9,861,95.66666667,1360799159368,1360799159560,1220541524,1220541716,192
1360799186,1220568192,9,861,95.66666667,1360799159588,1360799159780,1220541780,1220541972,192
1360799186,1220568196,8,815,101.875,1360799159906,1360799160034,1220542102,1220542230,128
1360799186,1220568268,14,6617,472.6428571,1360799158873,1360799159193,1220541141,1220541461,320
1360799388,1220770292,3,189,63,1360799381116,1360799384124,1220763408,1220766416,3008
1360799404,1220786288,2,126,63,1360799388159,1360799396223,1220770447,1220778511,8064
1360799420,1220802380,3,189,63,1360799415460,1360799418532,1220797840,1220800912,3072
1360799436,1220818316,2,126,63,1360799422630,1360799430630,1220804946,1220812946,8000
1360799452,1220834384,4,252,63,1360799443231,1360799450335,1220825615,1220832719,7104
1360799483,1220865056,1,63,63,1360799458666,1360799458666,1220840722,1220840722,0
1360799580,1220962372,4,252,63,1360799572011,1360799579051,1220954383,1220961423,7040
1360799615,1220997464,1,63,63,1360799587022,1360799587022,1220969486,1220969486,0
1360799964,1221346496,3,408,136,1360799939754,1360799945770,1221322250,1221328266,6016
1360800325,1221707308,11,953,86.63636364,1360800311134,1360800321246,1221693442,1221703554,10112
1360800325,1221707368,12,999,83.25,1360800310818,1360800321250,1221693186,1221703618,10432
1360800325,1221707372,12,999,83.25,1360800310558,1360800321246,1221692930,1221703618,10688
1360800357,1221739344,11,953,86.63636364,1360800340604,1360800352124,1221722948,1221734468,11520
1360800357,1221739344,11,953,86.63636364,1360800340858,1360800352122,1221723202,1221734466,11264
1360800357,1221739388,12,999,83.25,1360800340049,1360800352145,1221722437,1221734533,12096
1360800357,1221739428,11,953,86.63636364,1360800340262,1360800352102,1221722690,1221734530,11840
1360800365,1221747144,11,3267,297,1360800337283,1360800337859,1221719427,1221720003,576
1360800529,1221911252,2,141,70.5,1360800524563,1360800524563,1221906815,1221906815,0
1360800541,1221923608,12,999,83.25,1360800528176,1360800539440,1221910784,1221922048,11264
1360800541,1221923660,12,999,83.25,1360800527293,1360800539389,1221909953,1221922049,12096
1360800541,1221923660,11,953,86.63636364,1360800527549,1360800539389,1221910209,1221922049,11840
1360800541,1221923664,12,999,83.25,1360800527802,1360800539386,1221910466,1221922050,11584
1360800577,1221959616,3,408,136,1360800550311,1360800556327,1221932927,1221938943,6016
1360800630,1222011844,1,46,46,1360800601900,1360800601900,1221983744,1221983744,0
1360801111,1222493040,1,46,46,1360801084639,1360801084639,1222466679,1222466679,0
1360801187,1222569492,3,408,136,1360801161562,1360801167578,1222544054,1222550070,6016
1360801251,1222633572,13,6234,479.5384615,1360801226634,1360801226890,1222609206,1222609462,256
1360801255,1222637532,8,815,101.875,1360801227314,1360801227442,1222609846,1222609974,128
1360801255,1222637596,9,861,95.66666667,1360801226994,1360801227122,1222609590,1222609718,128
1360801255,1222637604,9,861,95.66666667,1360801227497,1360801227689,1222610101,1222610293,192
1360801510,1222891860,2,126,63,1360801508428,1360801509452,1222890288,1222891312,1024
1360801518,1222899964,3,189,63,1360801513959,1360801517031,1222895923,1222898995,3072
1360801518,1222899964,3,189,63,1360801513957,1360801517029,1222895921,1222898993,3072
1360801518,1222899968,2,126,63,1360801511330,1360801515362,1222893298,1222897330,4032
1360801534,1222915872,2,126,63,1360801521154,1360801529218,1222903026,1222911090,8064
1360801534,1222915916,2,126,63,1360801521046,1360801529110,1222902962,1222911026,8064
1360801548,1222930376,1,63,63,1360801523018,1360801523018,1222905394,1222905394,0
1360801558,1222939972,2,126,63,1360801555037,1360801556061,1222937009,1222938033,1024
1360801566,1222947944,2,126,63,1360801558139,1360801562171,1222940083,1222944115,4032
1360801596,1222978408,1,63,63,1360801569703,1360801569703,1222952111,1222952111,0
1360801801,1223183364,3,408,136,1360801773267,1360801779283,1223155631,1223161647,6016
1360802118,1223500444,2,92,46,1360802110331,1360802110331,1223492775,1223492775,0
1360802118,1223500488,2,92,46,1360802110290,1360802110290,1223492778,1223492778,0
1360802118,1223500488,2,92,46,1360802110225,1360802110225,1223492713,1223492713,0
1360802118,1223500488,2,92,46,1360802110289,1360802110289,1223492777,1223492777,0
1360802138,1223520264,9,861,95.66666667,1360802112817,1360802113009,1223495081,1223495273,192
1360802138,1223520268,9,861,95.66666667,1360802113134,1360802113326,1223495402,1223495594,192
1360802138,1223520340,14,6749,482.0714286,1360802111714,1360802111970,1223494054,1223494310,256
1360802138,1223520344,14,6617,472.6428571,1360802112094,1360802112350,1223494438,1223494694,256
1360802138,1223520344,8,815,101.875,1360802112418,1360802112610,1223494762,1223494954,192
1360802335,1223716856,3,189,63,1360802330695,1360802333767,1223712551,1223715623,3072
1360802335,1223716856,3,189,63,1360802330949,1360802333957,1223712805,1223715813,3008
1360802351,1223732920,2,126,63,1360802337732,1360802345732,1223719652,1223727652,8000
1360802351,1223732976,2,126,63,1360802337870,1360802345934,1223719846,1223727910,8064
1360802359,1223740964,2,126,63,1360802356503,1360802357463,1223738467,1223739427,960
1360802367,1223749012,2,126,63,1360802359463,1360802363495,1223741475,1223745507,4032
1360802399,1223780832,1,63,63,1360802371675,1360802371675,1223753507,1223753507,0
1360802411,1223792780,3,408,136,1360802385874,1360802391954,1223767654,1223773734,6080
1360802423,1223805088,2,126,63,1360802421149,1360802422173,1223803237,1223804261,1024
1360802431,1223813116,2,126,63,1360802424128,1360802428160,1223806244,1223810276,4032
1360802455,1223837012,3,189,63,1360802449512,1360802452520,1223831524,1223834532,3008
1360802463,1223845252,1,63,63,1360802436087,1360802436087,1223818339,1223818339,0
1360802471,1223853036,2,126,63,1360802456526,1360802464590,1223838562,1223846626,8064
1360802855,1224237380,16,6372,398.25,1360802837104,1360802849200,1224219484,1224231580,12096
1360802855,1224237384,12,999,83.25,1360802837421,1360802849197,1224219805,1224231581,11776
1360802855,1224237392,12,999,83.25,1360802837991,1360802849127,1224220383,1224231519,11136
1360802855,1224237464,12,999,83.25,1360802837663,1360802849055,1224220127,1224231519,11392
1360802868,1224249788,11,3267,297,1360802840960,1360802841600,1224222748,1224223388,640
1360802951,1224333384,3,193,64.33333333,1360802945195,1360802945195,1224327579,1224327579,0
1360803032,1224414052,3,429,143,1360803007736,1360803013752,1224389788,1224395804,6016
1360803645,1225027308,3,429,143,1360803619181,1360803625197,1225001489,1225007505,6016
1360803954,1225335724,3,423,141,1360803927986,1360803934002,1225309710,1225315726,6016
1360803989,1225371612,3,411,137,1360803962618,1360803968698,1225345230,1225351310,6080
1360804667,1226048924,9,861,95.66666667,1360804642717,1360804642845,1226024641,1226024769,128
1360804667,1226049004,12,6151,512.5833333,1360804642191,1360804642511,1226024195,1226024515,320
1360804671,1226052960,9,861,95.66666667,1360804642940,1360804643132,1226024900,1226025092,192
1360804671,1226052960,8,815,101.875,1360804643193,1360804643385,1226025153,1226025345,192
1360804867,1226249252,3,408,136,1360804841427,1360804847507,1226223679,1226229759,6080
1360804873,1226255128,3,189,63,1360804866254,1360804869262,1226248382,1226251390,3008
1360804889,1226271144,2,126,63,1360804873280,1360804881344,1226255424,1226263488,8064
1360804921,1226303452,3,189,63,1360804916681,1360804919689,1226299133,1226302141,3008
1360804921,1226303552,3,189,63,1360804916518,1360804919590,1226299070,1226302142,3072
1360804937,1226319236,2,126,63,1360804923938,1360804931938,1226306174,1226314174,8000
1360804937,1226319236,2,126,63,1360804923937,1360804932001,1226306173,1226314237,8064
1360804961,1226343196,3,189,63,1360804954506,1360804957514,1226336702,1226339710,3008
1360804977,1226359188,2,126,63,1360804961552,1360804969616,1226343740,1226351804,8064
1360805469,1226851120,3,402,134,1360805443022,1360805449422,1226825142,1226831542,6400
1360805837,1227219360,1,46,46,1360805808728,1360805808728,1227191088,1227191088,0
1360806130,1227512492,12,999,83.25,1360806120207,1360806129231,1227502699,1227511723,9024
1360806130,1227512516,12,999,83.25,1360806120442,1360806129210,1227502958,1227511726,8768
1360806130,1227512516,12,999,83.25,1360806120698,1360806129146,1227503214,1227511662,8448
1360806130,1227512560,17,6755,397.3529412,1360806119694,1360806129166,1227502254,1227511726,9472
1360806140,4160802728,5,573,114.6,1360806133334,1360806133398,4160796062,4160796126,64
1360806556,1227938328,3,408,136,1360806531693,1360806537773,1227914021,1227920101,6080
1360807087,1228469204,1,46,46,1360807061728,1360807061728,1228443932,1228443932,0
1360807094,1228476048,3,408,136,1360807067708,1360807074108,1228449756,1228456156,6400
1360807242,1228624476,3,408,136,1360807216654,1360807222734,1228599130,1228605210,6080
1360807668,1229049988,1,48,48,1360807642865,1360807642865,1229024853,1229024853,0
1360807764,1229146184,15,6289,419.2666667,1360807750378,1360807762474,1229132562,1229144658,12096
1360807764,1229146188,12,999,83.25,1360807750760,1360807762472,1229132948,1229144660,11712
1360807764,1229146188,12,999,83.25,1360807751079,1360807762471,1229133267,1229144659,11392
1360807764,1229146192,12,999,83.25,1360807751334,1360807762470,1229133526,1229144662,11136
1360807812,1229194180,12,999,83.25,1360807793777,1360807804849,1229175957,1229187029,11072
1360807812,1229194180,11,953,86.63636364,1360807794032,1360807804848,1229176212,1229187028,10816
1360807812,1229194184,11,953,86.63636364,1360807794284,1360807804844,1229176468,1229187028,10560
1360807812,1229194264,11,953,86.63636364,1360807794460,1360807804764,1229176724,1229187028,10304
1360807860,1229241860,3,408,136,1360807832496,1360807838512,1229214356,1229220372,6016
1360807920,1229301932,3,408,136,1360807893415,1360807899431,1229275347,1229281363,6016
1360807980,1229362332,11,953,86.63636364,1360807967701,1360807978645,1229350033,1229360977,10944
1360807980,1229362336,12,999,83.25,1360807968017,1360807978577,1229350353,1229360913,10560
1360807980,1229362336,12,999,83.25,1360807968271,1360807978575,1229350607,1229360911,10304
1360807980,1229362460,12,999,83.25,1360807967317,1360807978517,1229349777,1229360977,11200
1360808172,1229554388,20,12227,611.35,1360808155547,1360808167643,1229537935,1229550031,12096
1360808172,1229554432,12,999,83.25,1360808154796,1360808165356,1229537228,1229547788,10560
1360808172,1229554432,12,999,83.25,1360808155116,1360808165356,1229537548,1229547788,10240
1360808172,1229554480,12,999,83.25,1360808154237,1360808165309,1229536717,1229547789,11072
1360808172,1229554484,12,999,83.25,1360808154491,1360808165307,1229536975,1229547791,10816
1360808173,4162835652,7,4808,686.8571429,1360808155374,1360808167406,4162818026,4162830058,12032
1360808173,4162835652,9,7267,807.4444444,1360808155374,1360808167342,4162818026,4162829994,11968
1360808232,1229614632,11,3267,297,1360808205860,1360808206500,1229588492,1229589132,640
1360808301,1229682772,5,962,192.4,1360808274496,1360808274688,1229656268,1229656460,192
1360808385,1229767112,7,1066,152.2857143,1360808359465,1360808359657,1229741577,1229741769,192
1360808541,1229922724,3,230,76.66666667,1360808536237,1360808536557,1229917961,1229918281,320
1360808557,1229939104,3,408,136,1360808529457,1360808535473,1229911561,1229917577,6016
1360808561,1229943296,11,3267,297,1360808536497,1360808537009,1229918793,1229919305,512
1360808725,1230107384,13,2080,160,1360808697045,1360808712789,1230079429,1230095173,15744
1360808777,1230159568,3,408,136,1360808750557,1360808756573,1230133125,1230139141,6016
1360808829,1230211516,16,4417,276.0625,1360808804495,1360808816655,1230187011,1230199171,12160
1360808869,1230250932,2,141,70.5,1360808864600,1360808864600,1230246532,1230246532,0
1360808890,1230271940,26,6450,248.0769231,1360808863565,1360808879053,1230245505,1230260993,15488
1360808930,1230312004,7,1775,253.5714286,1360808905104,1360808917328,1230287108,1230299332,12224
1360808971,1230353432,1,46,46,1360808944098,1360808944098,1230326530,1230326530,0
1360808994,1230376064,9,1383,153.6666667,1360808967567,1360808972623,1230349631,1230354687,5056
1360809175,1230556780,5,1240,248,1360809150250,1360809152490,1230532030,1230534270,2240
1360809203,1230584784,3,408,136,1360809174952,1360809180968,1230556736,1230562752,6016
1360809381,1230763500,2,141,70.5,1360809379542,1360809379542,1230762042,1230762042,0
1360809387,1230769460,3,408,136,1360809361598,1360809367614,1230744058,1230750074,6016
1360809985,1231366876,9,861,95.66666667,1360809960636,1360809960828,1231342512,1231342704,192
1360809985,1231366964,12,6151,512.5833333,1360809959974,1360809960422,1231341938,1231342386,448
1360809989,1231370812,9,898,99.77777778,1360809961408,1360809961728,1231343220,1231343540,320
1360809989,1231370888,9,861,95.66666667,1360809960884,1360809961204,1231342772,1231343092,320
1360810021,1231402980,2,96,48,1360809995607,1360809998551,1231377587,1231380531,2944
1360810053,1231435184,3,408,136,1360810027722,1360810033802,1231409906,1231415986,6080
1360810109,1231491160,1,46,46,1360810082722,1360810082722,1231464882,1231464882,0
1360810174,1231556004,3,189,63,1360810170492,1360810173564,1231552496,1231555568,3072
1360810182,1231563888,4,252,63,1360810174831,1360810181871,1231556719,1231563759,7040
1360810190,1231571896,2,126,63,1360810177701,1360810185701,1231559597,1231567597,8000
1360810217,1231599356,1,63,63,1360810189465,1360810189465,1231571821,1231571821,0
1360810246,1231627912,3,189,63,1360810242328,1360810245400,1231624240,1231627312,3072
1360810262,1231643968,2,126,63,1360810249375,1360810257375,1231631343,1231639343,8000
1360810281,1231663468,1,46,46,1360810256363,1360810256363,1231638831,1231638831,0
1360810294,1231676144,3,189,63,1360810286830,1360810289902,1231668974,1231672046,3072
1360810310,1231692076,2,126,63,1360810294002,1360810302002,1231676078,1231684078,8000
1360810594,1231975896,1,46,46,1360810567649,1360810567649,1231949545,1231949545,0
1360810666,1232048068,3,408,136,1360810638898,1360810644978,1232020966,1232027046,6080
1360810806,1232188140,12,6151,512.5833333,1360810778986,1360810779370,1232161126,1232161510,384
1360810806,1232188168,8,815,101.875,1360810779660,1360810779852,1232161828,1232162020,192
1360810806,1232188172,9,861,95.66666667,1360810779977,1360810780105,1232162149,1232162277,128
1360810806,1232188252,8,815,101.875,1360810779322,1360810779514,1232161574,1232161766,192
1360810822,1232204448,10,2776,277.6,1360810818231,1360810818359,1232200679,1232200807,128
1360810822,1232204456,6,3996,666,1360810815663,1360810816815,1232198119,1232199271,1152
1360810822,1232204460,7,2448,349.7142857,1360810819371,1360810819499,1232201831,1232201959,128
1360810822,1232204532,6,3996,666,1360810816544,1360810816800,1232199076,1232199332,256
1360810822,1232204536,6,3996,666,1360810816734,1360810817054,1232199270,1232199590,320
1360810830,4165492064,18,21894,1216.333333,1360810817738,1360810829706,4165479802,4165491770,11968
1360810830,1232212448,23,14768,642.0869565,1360810817973,1360810829301,1232200421,1232211749,11328
1360810830,1232212452,15,6289,419.2666667,1360810818353,1360810829617,1232200805,1232212069,11264
1360810830,1232212460,10,1586,158.6,1360810818919,1360810827623,1232201379,1232210083,8704
1360810830,1232212480,11,953,86.63636364,1360810816725,1360810829781,1232199205,1232212261,13056
1360810830,1232212484,10,4586,458.6,1360810816851,1360810827603,1232199335,1232210087,10752
1360810830,1232212484,12,2607,217.25,1360810817169,1360810827665,1232199653,1232210149,10496
1360810830,1232212532,12,999,83.25,1360810819233,1360810829409,1232201765,1232211941,10176
1360810830,1232212536,11,953,86.63636364,1360810819550,1360810829022,1232202086,1232211558,9472
1360810838,1232220576,21,7062,336.2857143,1360810816756,1360810833524,1232199332,1232216100,16768
1360810943,1232324684,4,377,94.25,1360810937711,1360810937903,1232319395,1232319587,192
1360810950,1232332636,11,4926,447.8181818,1360810936952,1360810948728,1232319588,1232331364,11776
1360811063,1232445044,4,377,94.25,1360811057348,1360811057540,1232439392,1232439584,192
1360811071,1232452756,1,63,63,1360811044196,1360811044196,1232425952,1232425952,0
1360811071,1232452956,11,4938,448.9090909,1360811057631,1360811069855,1232439587,1232451811,12224
1360811078,1232460688,1,63,63,1360811051523,1360811051523,1232434211,1232434211,0
1360811079,1232460800,1,63,63,1360811052281,1360811052281,1232434081,1232434081,0
1360811079,1232460804,1,63,63,1360811052343,1360811052343,1232434147,1232434147,0
1360811207,1232589284,1,434,434,1360811182547,1360811182547,1232564831,1232564831,0
1360811207,1232589368,4,377,94.25,1360811201601,1360811201793,1232583969,1232584161,192
1360811207,1232589444,12,4690,390.8333333,1360811201780,1360811202356,1232584224,1232584800,576
1360811215,1232597364,4,377,94.25,1360811213186,1360811213314,1232595550,1232595678,128
1360811215,1232597440,4,377,94.25,1360811213112,1360811213240,1232595552,1232595680,128
1360811223,1232605456,7,2447,349.5714286,1360811215208,1360811215336,1232597664,1232597792,128
1360811230,4165892308,18,21894,1216.333333,1360811214424,1360811226392,4165876732,4165888700,11968
1360811231,1232613388,11,4926,447.8181818,1360811213291,1360811225131,1232595679,1232607519,11840
1360811231,1232613396,23,14767,642.0434783,1360811214629,1360811226341,1232597025,1232608737,11712
1360811231,1232613464,11,5246,476.9090909,1360811213217,1360811225057,1232595681,1232607521,11840
1360811275,1232657324,3,408,136,1360811249898,1360811255914,1232632222,1232638238,6016
1360811335,1232717676,4,377,94.25,1360811332617,1360811332873,1232715293,1232715549,256
1360811351,1232733688,11,4926,447.8181818,1360811332862,1360811344638,1232715550,1232727326,11776
1360811432,1232813704,6,3996,666,1360811431125,1360811431381,1232812829,1232813085,256
1360811443,1232825132,11,4650,422.7272727,1360811430952,1360811431976,1232813084,1232814108,1024
1360811563,1232945536,3,405,135,1360811538259,1360811544275,1232920795,1232926811,6016
1360812242,1233623820,15,6104,406.9333333,1360812226901,1360812238933,1233608721,1233620753,12032
1360812246,4166908616,9,7807,867.4444444,1360812226221,1360812238189,4166888837,4166900805,11968
1360812246,4166908616,8,7207,900.875,1360812226221,1360812238189,4166888837,4166900805,11968
1360812650,1234032416,12,6151,512.5833333,1360812622907,1360812623291,1234005323,1234005707,384
1360812650,1234032524,9,861,95.66666667,1360812623246,1360812623438,1234005770,1234005962,192
1360812650,1234032528,8,815,101.875,1360812623499,1360812623691,1234006027,1234006219,192
1360812650,1234032532,8,815,101.875,1360812623816,1360812624008,1234006348,1234006540,192
1360812703,1234085308,1,48,48,1360812677350,1360812677350,1234059658,1234059658,0
1360812915,1234297300,3,189,63,1360812909674,1360812912682,1234291974,1234294982,3008
1360812915,1234297300,3,189,63,1360812909673,1360812912745,1234291973,1234295045,3072
1360812931,1234313396,2,126,63,1360812916616,1360812924680,1234299012,1234307076,8064
1360812931,1234313396,2,126,63,1360812916682,1360812924682,1234299078,1234307078,8000
1360812975,1234356776,3,402,134,1360812946868,1360812952948,1234328644,1234334724,6080
1360812979,1234361340,12,999,83.25,1360812963199,1360812973375,1234345539,1234355715,10176
1360812979,1234361360,12,999,83.25,1360812963501,1360812973357,1234345861,1234355717,9856
1360813011,1234393324,2,126,63,1360813008592,1360813009552,1234390916,1234391876,960
1360813011,1234393376,2,126,63,1360813008285,1360813009309,1234390661,1234391685,1024
1360813019,1234401312,2,126,63,1360813011421,1360813015453,1234393733,1234397765,4032
1360813019,1234401316,2,126,63,1360813011610,1360813015642,1234393926,1234397958,4032
1360813027,1234408832,3,492,164,1360812999933,1360813005949,1234381765,1234387781,6016
1360813051,1234432892,1,63,63,1360813023937,1360813023937,1234405829,1234405829,0
1360813051,1234433000,1,63,63,1360813024022,1360813024022,1234406022,1234406022,0
1360813573,1234954712,44,55265,1256.022727,1360813568749,1360813569709,1234950461,1234951421,960
1360813581,1234962788,17,6755,397.3529412,1360813568863,1360813576287,1234950651,1234958075,7424
1360813581,1234962832,15,6289,419.2666667,1360813567732,1360813576244,1234949564,1234958076,8512
1360813581,1234962840,12,999,83.25,1360813568491,1360813576235,1234950331,1234958075,7744
1360813581,1234962872,12,999,83.25,1360813569162,1360813576202,1234951034,1234958074,7040
1360813588,1234970668,6,3996,666,1360813580913,1360813581169,1234963581,1234963837,256
1360813589,1234970740,6,3996,666,1360813581202,1360813581842,1234962942,1234963582,640
1360813596,1234978644,11,4926,447.8181818,1360813580934,1360813592262,1234963578,1234974906,11328
1360813596,1234978684,25,17767,710.68,1360813582495,1360813594079,1234965179,1234976763,11584
1360813597,1234978728,11,5246,476.9090909,1360813582110,1360813593182,1234963838,1234974910,11072
1360813599,4168261016,18,21894,1216.333333,1360813582735,1360813594767,4168244751,4168256783,12032
1360813605,1234986752,6,3996,666,1360813599107,1360813599555,1234980859,1234981307,448
1360813613,1234994712,16,5843,365.1875,1360813599595,1360813611179,1234981307,1234992891,11584
1360813629,1235010688,6,3996,666,1360813625667,1360813625923,1235007355,1235007611,256
1360813629,1235010760,11,4654,423.0909091,1360813625852,1360813626364,1235007612,1235008124,512
1360813629,1235010796,4,377,94.25,1360813627543,1360813627735,1235009339,1235009531,192
1360813629,1235010796,4,377,94.25,1360813627542,1360813627734,1235009338,1235009530,192
1360813637,1235018752,11,4654,423.0909091,1360813629125,1360813632581,1235010877,1235014333,3456
1360813637,1235018796,10,5194,519.4,1360813627799,1360813632535,1235009595,1235014331,4736
1360813637,1235018796,10,4874,487.4,1360813627798,1360813632534,1235009594,1235014330,4736
1360813645,1235026756,24,16266,677.75,1360813628990,1360813640510,1235010746,1235022266,11520
1360813647,4168309008,18,21894,1216.333333,1360813628245,1360813640213,4168290253,4168302221,11968
1360813809,1235190804,3,402,134,1360813784524,1360813790540,1235166328,1235172344,6016
1360813853,1235235492,16,6335,395.9375,1360813835805,1360813847901,1235218297,1235230393,12096
1360813853,1235235496,18,6801,377.8333333,1360813836250,1360813847898,1235218746,1235230394,11648
1360813853,1235235496,11,953,86.63636364,1360813836889,1360813847897,1235219385,1235230393,11008
1360813853,1235235520,12,999,83.25,1360813836609,1360813847873,1235219129,1235230393,11264
1360814129,1235511244,1,46,46,1360814103504,1360814103504,1235485748,1235485748,0
1360814642,1236024212,3,408,136,1360814617129,1360814623209,1235999341,1236005421,6080
1360814827,1236208824,3,408,136,1360814799786,1360814805866,1236181610,1236187690,6080
1360815204,1236585936,3,402,134,1360815176820,1360815182900,1236558756,1236564836,6080
1360815280,1236662048,1,78,78,1360815253573,1360815253573,1236635621,1236635621,0
1360815577,1236959436,1,46,46,1360815551099,1360815551099,1236933535,1236933535,0
1360815669,1237051096,12,6151,512.5833333,1360815640972,1360815641356,1237023068,1237023452,384
1360815669,1237051104,8,815,101.875,1360815641478,1360815641606,1237023582,1237023710,128
1360815669,1237051108,9,861,95.66666667,1360815641730,1360815641922,1237023838,1237024030,192
1360815669,1237051212,9,861,95.66666667,1360815641943,1360815642071,1237024155,1237024283,128
1360815960,1237342148,2,126,63,1360815957973,1360815958997,1237340121,1237341145,1024
1360815968,1237350164,2,126,63,1360815961030,1360815965062,1237343194,1237347226,4032
1360815976,1237358196,3,189,63,1360815971939,1360815974947,1237354135,1237357143,3008
1360815984,1237366504,1,46,46,1360815954225,1360815954225,1237336729,1237336729,0
1360815985,1237367404,4,252,63,1360815975698,1360815982738,1237358102,1237365142,7040
1360815985,1237367460,4,252,63,1360815975646,1360815982686,1237358106,1237365146,7040
1360815992,1237374144,2,126,63,1360815979032,1360815987096,1237361176,1237369240,8064
1360815998,1237380136,1,63,63,1360815973089,1360815973089,1237355225,1237355225,0
1360816018,1237400012,1,63,63,1360815991196,1360815991196,1237373208,1237373208,0
1360816018,1237400016,1,63,63,1360815991193,1360815991193,1237373209,1237373209,0
1360816452,1237834244,1,48,48,1360816425070,1360816425070,1237807314,1237807314,0
1360816728,1238110532,17,6755,397.3529412,1360816715530,1360816726218,1238098062,1238108750,10688
1360816728,1238110604,12,999,83.25,1360816715840,1360816726144,1238098444,1238108748,10304
1360816728,1238110608,12,999,83.25,1360816716094,1360816726142,1238098702,1238108750,10048
1360816728,1238110612,12,999,83.25,1360816716344,1360816726072,1238098956,1238108684,9728
1360816864,1238245732,3,408,136,1360816839592,1360816845672,1238221324,1238227404,6080
1360817168,4171830008,5,1786,357.2,1360817154476,1360817166444,4171816484,4171828452,11968
1360817168,4171830008,6,3363,560.5,1360817154476,1360817166444,4171816484,4171828452,11968
1360817168,4171830016,5,1890,378,1360817154468,1360817166500,4171816484,4171828516,12032
1360817168,4171830016,5,3126,625.2,1360817154468,1360817166436,4171816484,4171828452,11968
1360817168,4171830016,5,2145,429,1360817154471,1360817166503,4171816487,4171828519,12032
1360817169,1238550776,15,6289,419.2666667,1360817152245,1360817164533,1238534021,1238546309,12288
1360817169,1238550780,10,907,90.7,1360817153332,1360817164276,1238535112,1238546056,10944
1360817169,1238550784,10,907,90.7,1360817153774,1360817163822,1238535558,1238545606,10048
1360817169,1238550788,18,5197,288.7222222,1360817154539,1360817166763,1238536327,1238548551,12224
1360817169,1238550812,14,5209,372.0714286,1360817154581,1360817166741,1238536393,1238548553,12160
1360817169,1238550816,17,3657,215.1176471,1360817155277,1360817166733,1238537093,1238548549,11456
1360817169,1238550824,12,999,83.25,1360817152837,1360817164485,1238534661,1238546309,11648
1360817169,1238550896,21,8136,387.4285714,1360817154430,1360817167998,1238536326,1238549894,13568
1360817169,1238550896,34,20972,616.8235294,1360817154429,1360817166653,1238536325,1238548549,12224
1360817169,1238550896,23,9078,394.6956522,1360817154429,1360817166653,1238536325,1238548549,12224
1360817169,1238550900,21,8379,399,1360817154489,1360817167929,1238536389,1238549829,13440
1360817169,1238550900,13,4709,362.2307692,1360817154489,1360817166649,1238536389,1238548549,12160
1360817169,1238550924,14,2182,155.8571429,1360817155682,1360817166626,1238537606,1238548550,10944
1360817176,4171838024,23,22702,987.0434783,1360817161438,1360817172894,4171823462,4171834918,11456
1360817176,4171838024,15,10809,720.6,1360817161438,1360817172894,4171823462,4171834918,11456
1360817176,4171838024,9,2348,260.8888889,1360817161437,1360817172829,4171823461,4171834853,11392
1360817176,4171838032,9,2556,284,1360817161430,1360817172822,4171823462,4171834854,11392
1360817176,4171838032,9,2764,307.1111111,1360817161430,1360817172822,4171823462,4171834854,11392
1360817176,1238558144,15,3323,221.5333333,1360817150151,1360817155527,1238532295,1238537671,5376
1360817177,1238558784,38,29360,772.6315789,1360817157998,1360817173038,1238539782,1238554822,15040
1360817177,1238558860,26,17208,661.8461538,1360817157922,1360817172962,1238539782,1238554822,15040
1360817185,1238566828,11,3715,337.7272727,1360817164545,1360817184577,1238546373,1238566405,20032
1360817192,4171854004,27,25399,940.7037037,1360817166193,1360817184561,4171828197,4171846565,18368
1360817192,4171854004,28,26907,960.9642857,1360817166193,1360817184561,4171828197,4171846565,18368
1360817192,4171854012,12,7379,614.9166667,1360817173292,1360817184556,4171835304,4171846568,11264
1360817192,4171854012,9,2759,306.5555556,1360817173292,1360817184556,4171835304,4171846568,11264
1360817192,4171854012,46,50341,1094.369565,1360817166187,1360817184555,4171828199,4171846567,18368
1360817192,4171854012,29,26511,914.1724138,1360817166187,1360817184555,4171828199,4171846567,18368
1360817192,4171854016,8,1523,190.375,1360817173286,1360817184550,4171835302,4171846566,11264
1360817192,4171854016,18,16368,909.3333333,1360817173285,1360817184549,4171835301,4171846565,11264
1360817192,4171854016,20,19448,972.4,1360817173285,1360817184549,4171835301,4171846565,11264
1360817192,4171854016,9,3372,374.6666667,1360817173349,1360817184549,4171835365,4171846565,11200
1360817192,1238574080,11,7265,660.4545455,1360817166855,1360817177991,1238548935,1238560071,11136
1360817194,4171856260,42,42864,1020.571429,1360817165936,1360817193840,4171828196,4171856100,27904
1360817194,4171856312,33,32167,974.7575758,1360817165887,1360817193791,4171828199,4171856103,27904
1360817196,1238578128,12,7007,583.9166667,1360817168340,1360817193876,1238550468,1238576004,25536
1360817196,1238578136,1,79,79,1360817169486,1360817169486,1238551622,1238551622,0
1360817196,1238578168,18,11123,617.9444444,1360817170734,1360817193838,1238552902,1238576006,23104
1360817200,4171862020,9,6911,767.8888889,1360817184483,1360817196387,4171846503,4171858407,11904
1360817200,4171862020,16,14008,875.5,1360817184483,1360817196451,4171846503,4171858471,11968
1360817200,4171862020,6,2968,494.6666667,1360817184802,1360817196386,4171846822,4171858406,11584
1360817200,1238582104,20,17098,854.9,1360817172527,1360817193903,1238554631,1238576007,21376
1360817201,1238582780,5,325,65,1360817194226,1360817194226,1238576006,1238576006,0
1360817201,1238582812,12,12401,1033.416667,1360817187476,1360817196500,1238569288,1238578312,9024
1360817201,1238582812,7,5674,810.5714286,1360817187476,1360817196500,1238569288,1238578312,9024
1360817204,1238586020,33,35037,1061.727273,1360817176961,1360817200961,1238558981,1238582981,24000
1360817204,1238586024,17,15859,932.8823529,1360817176960,1360817188160,1238558984,1238570184,11200
1360817204,1238586024,37,45106,1219.081081,1360817177023,1360817201983,1238559047,1238584007,24960
1360817204,1238586024,21,23985,1142.142857,1360817176959,1360817188095,1238558983,1238570119,11136
1360817204,1238586100,40,48355,1208.875,1360817176881,1360817188081,1238558981,1238570181,11200
1360817208,1238590204,18,17399,966.6111111,1360817182793,1360817203081,1238564997,1238585285,20288
1360817216,1238598320,34,21356,628.1176471,1360817191511,1360817210775,1238573831,1238593095,19264
1360817217,1238599016,5,325,65,1360817211013,1360817211077,1238593029,1238593093,64
1360817217,1238599020,5,325,65,1360817211012,1360817211076,1238593032,1238593096,64
1360817217,1238599064,3,209,69.66666667,1360817210967,1360817210967,1238593031,1238593031,0
1360817222,4171884240,13,9571,736.2307692,1360817194948,1360817212676,4171857188,4171874916,17728
1360817222,4171884308,17,10565,621.4705882,1360817196930,1360817217730,4171859238,4171880038,20800
1360817224,4171886008,9,2988,332,1360817211117,1360817223853,4171873125,4171885861,12736
1360817224,4171886016,11,4281,389.1818182,1360817211109,1360817223845,4171873125,4171885861,12736
1360817224,4171886016,14,9405,671.7857143,1360817198692,1360817217956,4171860708,4171879972,19264
1360817224,4171886020,3,209,69.66666667,1360817223842,1360817223842,4171885862,4171885862,0
1360817225,1238607016,5,325,65,1360817217797,1360817217861,1238599813,1238599877,64
1360817226,4171888324,16,17923,1120.1875,1360817199219,1360817214067,4171861543,4171876391,14848
1360817232,4171894016,21,20225,963.0952381,1360817219812,1360817229860,4171881828,4171891876,10048
1360817232,4171894024,22,22042,1001.909091,1360817219805,1360817229853,4171881829,4171891877,10048
1360817232,4171894024,22,22330,1015,1360817219805,1360817229853,4171881829,4171891877,10048
1360817232,4171894028,125,163979,1311.832,1360817161435,1360817229915,4171823463,4171891943,68480
1360817232,4171894028,3,209,69.66666667,1360817229850,1360817229850,4171891878,4171891878,0
1360817232,1238614180,16,7654,478.375,1360817204002,1360817229602,1238586182,1238611782,25600
1360817232,1238614212,12,3617,301.4166667,1360817205442,1360817229570,1238587654,1238611782,24128
1360817232,1238614220,10,3981,398.1,1360817206267,1360817229499,1238588487,1238611719,23232
1360817232,1238614220,13,4106,315.8461538,1360817206202,1360817229562,1238588422,1238611782,23360
1360817232,1238614308,16,6486,405.375,1360817206113,1360817229473,1238588421,1238611781,23360
1360817233,1238615008,16,3028,189.25,1360817217357,1360817229453,1238599365,1238611461,12096
1360817233,1238615016,7,5946,849.4285714,1360817218437,1360817229317,1238600453,1238611333,10880
1360817233,1238615016,11,11371,1033.727273,1360817218437,1360817229317,1238600453,1238611333,10880
1360817233,1238615020,8,6274,784.25,1360817218432,1360817229312,1238600452,1238611332,10880
1360817233,1238615020,32,36090,1127.8125,1360817214146,1360817229762,1238596166,1238611782,15616
1360817233,1238615036,13,7689,591.4615385,1360817211120,1360817229744,1238593156,1238611780,18624
1360817233,1238615040,7,6073,867.5714286,1360817219311,1360817229295,1238601351,1238611335,9984
1360817233,1238615040,16,21014,1313.375,1360817230703,1360817230895,1238612743,1238612935,192
1360817233,1238615040,2,112,56,1360817230766,1360817231342,1238612806,1238613382,576
1360817233,1238615044,39,35029,898.1794872,1360817215465,1360817231401,1238597509,1238613445,15936
1360817233,1238615052,14,1975,141.0714286,1360817217312,1360817229408,1238599364,1238611460,12096
1360817233,1238615056,15,1551,103.4,1360817212959,1360817229727,1238595015,1238611783,16768
1360817233,1238615080,7,4863,694.7142857,1360817218373,1360817229317,1238600453,1238611397,10944
1360817233,1238615080,8,6172,771.5,1360817218373,1360817229253,1238600453,1238611333,10880
1360817233,1238615088,10,10386,1038.6,1360817219263,1360817229311,1238601351,1238611399,10048
1360817233,1238615092,18,14580,810,1360817215354,1360817229690,1238597446,1238611782,14336
1360817233,1238615092,18,15092,838.4444444,1360817215354,1360817229690,1238597446,1238611782,14336
1360817241,1238623076,2,158,79,1360817233288,1360817237192,1238615364,1238619268,3904
1360817249,1238631012,14,1915,136.7857143,1360817230154,1360817242314,1238612166,1238624326,12160
1360817249,1238631012,14,1431,102.2142857,1360817230154,1360817242314,1238612166,1238624326,12160
1360817249,1238631012,14,2070,147.8571429,1360817230154,1360817242250,1238612166,1238624262,12096
1360817249,1238631040,32,42045,1313.90625,1360817231405,1360817242157,1238613445,1238624197,10752
1360817249,1238631040,94,134949,1435.62766,1360817231404,1360817242156,1238613444,1238624196,10752
1360817249,1238631084,16,2992,187,1360817230080,1360817242240,1238612164,1238624324,12160
1360817249,1238631092,7,5946,849.4285714,1360817231355,1360817242107,1238613447,1238624199,10752
1360817256,1238638468,13,14428,1109.846154,1360817230211,1360817230467,1238612679,1238612935,256
1360817265,1238647044,2,158,79,1360817244968,1360817260520,1238627012,1238642564,15552
1360817273,1238655268,6,368,61.33333333,1360817267143,1360817267207,1238649411,1238649475,64
1360817276,1238658364,1,46,46,1360817251816,1360817251816,1238634180,1238634180,0
1360817289,1238671056,13,2285,175.7692308,1360817275932,1360817287964,1238657988,1238670020,12032
1360817289,1238671068,20,7017,350.85,1360817277074,1360817287954,1238659142,1238670022,10880
1360817289,1238671104,14,1752,125.1428571,1360817275884,1360817287916,1238657988,1238670020,12032
1360817297,1238679024,18,1606,89.22222222,1360817276349,1360817289341,1238658373,1238671365,12992
1360817297,1238679076,15,2387,159.1333333,1360817280008,1360817289800,1238662084,1238671876,9792
1360817316,1238698560,1,79,79,1360817291046,1360817291046,1238673606,1238673606,0
1360817681,1239063528,3,408,136,1360817656832,1360817662912,1239039360,1239045440,6080
1360818051,1239432824,1,48,48,1360818026363,1360818026363,1239408187,1239408187,0
1360818055,1239436836,1,48,48,1360818029293,1360818029293,1239411129,1239411129,0
1360818295,1239676952,3,408,136,1360818268727,1360818274743,1239650679,1239656695,6016
1360818904,1240286568,3,408,136,1360818879171,1360818885251,1240261739,1240267819,6080
1360818970,1240352376,15,6289,419.2666667,1360818956931,1360818969027,1240339307,1240351403,12096
1360818970,1240352412,12,999,83.25,1360818958430,1360818968926,1240340842,1240351338,10496
1360818970,1240352460,12,999,83.25,1360818957873,1360818968881,1240340333,1240351341,11008
1360818970,1240352460,11,953,86.63636364,1360818958127,1360818968879,1240340587,1240351339,10752
1360819073,1240455064,1,60,60,1360819045561,1360819045561,1240427625,1240427625,0
1360819249,1240631388,1,60,60,1360819223797,1360819223797,1240606185,1240606185,0
1360819403,1240785104,1,46,46,1360819374092,1360819374092,1240756196,1240756196,0
1360819518,1240900216,3,408,136,1360819490781,1360819496861,1240872997,1240879077,6080
1360820128,1241510156,3,408,136,1360820101967,1360820107983,1241484123,1241490139,6016
1360820741,1242123072,3,408,136,1360820713240,1360820719320,1242095312,1242101392,6080
1360820780,1242162188,15,6289,419.2666667,1360820762341,1360820774437,1242144529,1242156625,12096
1360820780,1242162192,11,953,86.63636364,1360820762786,1360820774434,1242144978,1242156626,11648
1360820780,1242162196,12,999,83.25,1360820763293,1360820774365,1242145489,1242156561,11072
1360820780,1242162240,12,999,83.25,1360820762991,1360820774383,1242145231,1242156623,11392
1360820852,1242234188,11,953,86.63636364,1360820834405,1360820846501,1242216593,1242228689,12096
1360820852,1242234188,11,953,86.63636364,1360820834659,1360820846499,1242216847,1242228687,11840
1360820852,1242234192,11,953,86.63636364,1360820834913,1360820846497,1242217105,1242228689,11584
1360820852,1242234256,11,953,86.63636364,1360820835102,1360820846430,1242217358,1242228686,11328
1360821350,1242732244,3,408,136,1360821324134,1360821330214,1242706378,1242712458,6080
1360821699,1243081272,2,122,61,1360821674116,1360821676292,1243056388,1243058564,2176
1360821889,1243271580,1,46,46,1360821861899,1360821861899,1243244479,1243244479,0
1360821963,1243345520,3,408,136,1360821935111,1360821941127,1243317631,1243323647,6016
1360822166,1243547812,15,6289,419.2666667,1360822153545,1360822165641,1243535357,1243547453,12096
1360822166,1243547812,13,1382,106.3076923,1360822154054,1360822165638,1243535866,1243547450,11584
1360822166,1243547816,17,6755,397.3529412,1360822154437,1360822165637,1243536253,1243547453,11200
1360822166,1243547836,12,999,83.25,1360822154798,1360822165614,1243536634,1243547450,10816
1360822573,1243955320,3,408,136,1360822546692,1360822552772,1243929012,1243935092,6080
1360823186,1244568316,3,408,136,1360823158017,1360823164097,1244540333,1244546413,6080
1360823796,1245177900,3,408,136,1360823769496,1360823775512,1245151396,1245157412,6016
1360823975,1245357596,12,999,83.25,1360823958686,1360823969822,1245341282,1245352418,11136
1360823975,1245357612,15,6289,419.2666667,1360823957774,1360823969870,1245340386,1245352482,12096
1360823975,1245357632,12,999,83.25,1360823958200,1360823969848,1245340832,1245352480,11648
1360823975,1245357636,11,953,86.63636364,1360823958455,1360823969847,1245341091,1245352483,11392
1360824333,1245715624,1,46,46,1360824305340,1360824305340,1245687964,1245687964,0
1360824406,1245787800,3,408,136,1360824381362,1360824387378,1245763162,1245769178,6016
1360825019,1246400912,3,408,136,1360824992568,1360824998584,1246374480,1246380496,6016
1360825632,1247013712,3,408,136,1360825604856,1360825610872,1246986568,1246992584,6016
1360825777,1247159248,12,999,83.25,1360825763488,1360825774880,1247145736,1247157128,11392
1360825777,1247159248,12,999,83.25,1360825763742,1360825774814,1247145990,1247157062,11072
1360825777,1247159260,15,6289,419.2666667,1360825762771,1360825774867,1247145031,1247157127,12096
1360825777,1247159260,12,999,83.25,1360825763219,1360825774867,1247145479,1247157127,11648
1360825833,1247215244,12,999,83.25,1360825819807,1360825831519,1247202051,1247213763,11712
1360825833,1247215244,11,953,86.63636364,1360825820320,1360825831456,1247202564,1247213700,11136
1360825833,1247215252,16,6372,398.25,1360825819415,1360825831511,1247201667,1247213763,12096
1360825833,1247215260,11,953,86.63636364,1360825820050,1360825831506,1247202310,1247213766,11456
1360826241,1247623052,3,408,136,1360826215577,1360826221593,1247597629,1247603645,6016
1360826775,1248156740,1,56,56,1360826748491,1360826748491,1248130231,1248130231,0
1360826855,1248236732,3,408,136,1360826826962,1360826832978,1248208694,1248214710,6016
1360826896,1248277884,1,46,46,1360826868474,1360826868474,1248250358,1248250358,0
1360827464,1248846064,3,408,136,1360827437373,1360827443389,1248819437,1248825453,6016
1360827620,1249002412,1,56,56,1360827593822,1360827593822,1248976234,1248976234,0
1360827642,1249024468,12,999,83.25,1360827624356,1360827635876,1249006824,1249018344,11520
1360827642,1249024472,12,999,83.25,1360827624675,1360827635875,1249007147,1249018347,11200
1360827642,1249024492,12,999,83.25,1360827624911,1360827635855,1249007403,1249018347,10944
1360827644,1249026364,15,6289,419.2666667,1360827623885,1360827635981,1249006249,1249018345,12096
1360827706,1249088524,11,953,86.63636364,1360827691822,1360827703150,1249074346,1249085674,11328
1360827706,1249088568,12,999,83.25,1360827691009,1360827703105,1249073577,1249085673,12096
1360827706,1249088572,12,999,83.25,1360827691259,1360827703099,1249073831,1249085671,11840
1360827706,1249088572,11,953,86.63636364,1360827691518,1360827703102,1249074090,1249085674,11584
1360828074,1249455716,3,408,136,1360828048528,1360828054544,1249430244,1249436260,6016
1360828250,1249632084,1,48,48,1360828223005,1360828223005,1249605089,1249605089,0
1360828609,1249991068,1,46,46,1360828581415,1360828581415,1249963483,1249963483,0
1360828609,1249991072,1,46,46,1360828581410,1360828581410,1249963482,1249963482,0
1360828683,1250065476,3,408,136,1360828658832,1360828664784,1250041308,1250047260,5952
1360829297,1250678640,3,408,136,1360829270984,1360829277000,1250652624,1250658640,6016
1360829515,1250897600,15,6289,419.2666667,1360829495429,1360829507525,1250878029,1250890125,12096
1360829515,1250897604,12,999,83.25,1360829496131,1360829507459,1250878735,1250890063,11328
1360829515,1250897604,12,999,83.25,1360829496322,1360829507458,1250878926,1250890062,11136
1360829516,1250897644,12,999,83.25,1360829496835,1360829508483,1250878479,1250890127,11648
1360829580,1250961668,11,953,86.63636364,1360829561386,1360829572266,1250943054,1250953934,10880
1360829580,1250961668,11,953,86.63636364,1360829561640,1360829572264,1250943308,1250953932,10624
1360829580,1250961680,11,953,86.63636364,1360829561117,1360829572253,1250942797,1250953933,11136
1360829580,1250961708,11,953,86.63636364,1360829561855,1360829572223,1250943563,1250953931,10368
1360829906,1251287756,3,408,136,1360829881228,1360829887244,1251262984,1251269000,6016
1360830323,1251704812,2,96,48,1360830298188,1360830301068,1251680000,1251682880,2880
1360830519,1251901436,3,408,136,1360830491803,1360830497819,1251874239,1251880255,6016
1360831008,1252390248,1,48,48,1360830981197,1360830981197,1252363445,1252363445,0
1360831128,1252510376,3,408,136,1360831102605,1360831108685,1252484981,1252491061,6080
1360831142,4185803916,2,112,56,1360831143397,1360831143461,4185805313,4185805377,64
1360831148,4185809820,4,478,119.5,1360831144456,1360831144456,4185806276,4185806276,0
1360831149,1252531028,9,3357,373,1360831143977,1360831145129,1252526005,1252527157,1152
1360831156,4185817832,4,971,242.75,1360831150459,1360831150843,4185812291,4185812675,384
1360831157,1252539048,10,2770,277,1360831150612,1360831150804,1252532660,1252532852,192
1360831157,1252539052,8,2378,297.25,1360831150799,1360831150863,1252532851,1252532915,64
1360831157,1252539060,8,1424,178,1360831148871,1360831149255,1252530931,1252531315,384
1360831157,1252539084,8,2634,329.25,1360831150834,1360831150962,1252532918,1252533046,128
1360831164,4185825828,4,478,119.5,1360831158656,1360831158720,4185820484,4185820548,64
1360831164,4185825828,2,859,429.5,1360831143550,1360831158590,4185805378,4185820418,15040
1360831164,4185825832,4,478,119.5,1360831159803,1360831159867,4185821635,4185821699,64
1360831165,1252547044,8,2386,298.25,1360831160345,1360831160473,1252542389,1252542517,128
1360831165,1252547044,7,2694,384.8571429,1360831160727,1360831160855,1252542771,1252542899,128
1360831165,1252547048,10,1994,199.4,1360831160983,1360831161111,1252543031,1252543159,128
1360831165,1252547048,10,1994,199.4,1360831161110,1360831161302,1252543158,1252543350,192
1360831165,1252547048,10,4818,481.8,1360831161302,1360831161366,1252543350,1252543414,64
1360831165,1252547048,8,2394,299.25,1360831161365,1360831161493,1252543413,1252543541,128
1360831165,1252547048,10,1994,199.4,1360831158292,1360831158420,1252540340,1252540468,128
1360831165,1252547048,11,3405,309.5454545,1360831145748,1360831158804,1252527796,1252540852,13056
1360831165,1252547048,8,1890,236.25,1360831161811,1360831161875,1252543859,1252543923,64
1360831165,1252547052,10,1994,199.4,1360831162131,1360831162323,1252544183,1252544375,192
1360831165,1252547052,9,1942,215.7777778,1360831162002,1360831162130,1252544054,1252544182,128
1360831165,1252547052,8,2021,252.625,1360831158482,1360831158546,1252540534,1252540598,64
1360831165,1252547052,8,2386,298.25,1360831158674,1360831158802,1252540726,1252540854,128
1360831165,1252547052,10,2482,248.2,1360831159440,1360831159632,1252541492,1252541684,192
1360831165,1252547056,9,1942,215.7777778,1360831160078,1360831160270,1252542134,1252542326,192
1360831165,1252547056,8,1890,236.25,1360831160269,1360831160333,1252542325,1252542389,64
1360831165,1252547056,7,2454,350.5714286,1360831160460,1360831160588,1252542516,1252542644,128
1360831165,1252547056,10,1994,199.4,1360831160588,1360831160716,1252542644,1252542772,128
1360831165,1252547056,10,2482,248.2,1360831160843,1360831160971,1252542899,1252543027,128
1360831165,1252547060,8,2922,365.25,1360831161480,1360831161544,1252543540,1252543604,64
1360831165,1252547060,8,3194,399.25,1360831161544,1360831161672,1252543604,1252543732,128
1360831165,1252547060,8,1890,236.25,1360831161671,1360831161799,1252543731,1252543859,128
1360831165,1252547064,9,3494,388.2222222,1360831161863,1360831161927,1252543927,1252543991,64
1360831165,1252547064,10,2802,280.2,1360831158407,1360831158535,1252540471,1252540599,128
1360831165,1252547064,8,2714,339.25,1360831158534,1360831158662,1252540598,1252540726,128
1360831165,1252547112,10,1994,199.4,1360831159572,1360831159700,1252541684,1252541812,128
1360831165,1252547112,8,1890,236.25,1360831159827,1360831159955,1252541939,1252542067,128
1360831165,1252547112,13,3472,267.0769231,1360831146707,1360831158803,1252528819,1252540915,12096
1360831165,1252547116,10,1994,199.4,1360831159695,1360831159823,1252541811,1252541939,128
1360831165,1252547116,8,1890,236.25,1360831159955,1360831160019,1252542071,1252542135,64
1360831168,1252550328,4,700,175,1360831147581,1360831158461,1252529909,1252540789,10880
1360831180,1252562360,1,108,108,1360831154910,1360831154910,1252537270,1252537270,0
1360831180,1252562420,1,108,108,1360831154912,1360831154912,1252537332,1252537332,0
1360831180,1252562424,1,108,108,1360831154780,1360831154780,1252537204,1252537204,0
1360831181,1252563056,8,1958,244.75,1360831164237,1360831180109,1252546293,1252562165,15872
1360831181,1252563064,8,1971,246.375,1360831158853,1360831180549,1252540917,1252562613,21696
1360831181,1252563064,5,1275,255,1360831162564,1360831179076,1252544628,1252561140,16512
1360831181,1252563104,10,3068,306.8,1360831162715,1360831178011,1252544819,1252560115,15296
1360831188,4185849816,8,2319,289.875,1360831184075,1360831184459,4185845891,4185846275,384
1360831188,4185849816,8,3894,486.75,1360831184459,1360831185291,4185846275,4185847107,832
1360831204,4185865824,5,527,105.4,1360831200512,1360831200576,4185862336,4185862400,64
1360831204,4185865828,522,738847,1415.415709,1360831185279,1360831199359,4185847107,4185861187,14080
1360831205,1252587064,8,2100,262.5,1360831182594,1360831199042,1252564658,1252581106,16448
1360831205,1252587092,4,512,128,1360831195624,1360831200168,1252577716,1252582260,4544
1360831220,1252602396,1,46,46,1360831195319,1360831195319,1252577715,1252577715,0
1360831381,1252763264,15,6289,419.2666667,1360831365432,1360831377080,1252747696,1252759344,11648
1360831381,1252763264,11,953,86.63636364,1360831366329,1360831377017,1252748593,1252759281,10688
1360831381,1252763272,17,6887,405.1176471,1360831364979,1360831377011,1252747251,1252759283,12032
1360831381,1252763276,11,953,86.63636364,1360831365807,1360831377071,1252748083,1252759347,11264
1360831381,1252763276,12,999,83.25,1360831366063,1360831377071,1252748339,1252759347,11008
1360831445,1252827292,11,953,86.63636364,1360831431005,1360831441501,1252813297,1252823793,10496
1360831445,1252827300,16,6372,398.25,1360831430358,1360831441494,1252812658,1252823794,11136
1360831445,1252827300,12,999,83.25,1360831430741,1360831441493,1252813041,1252823793,10752
1360831445,1252827300,12,999,83.25,1360831431188,1360831441428,1252813488,1252823728,10240
1360831653,1253035344,1,46,46,1360831626661,1360831626661,1253009005,1253009005,0
1360831741,1253123412,3,408,136,1360831714146,1360831720162,1253096558,1253102574,6016
1360831844,4186506032,5,527,105.4,1360831839158,1360831839158,4186501190,4186501190,0
1360831844,4186506036,5,527,105.4,1360831841140,1360831841204,4186503176,4186503240,64
1360831845,1253227588,398259,596997534,1499.018312,1360831199727,1360831837551,1252582315,1253220139,637824
1360831892,4186554044,5,527,105.4,1360831887913,1360831887913,4186549957,4186549957,0
1360831893,1253275616,22405,33579013,1498.728543,1360831840721,1360831886161,1253223337,1253268777,45440
1360831948,4186610032,4,478,119.5,1360831945014,1360831945014,4186607046,4186607046,0
1360831956,4186618044,4,478,119.5,1360831954858,1360831954858,4186616902,4186616902,0
1360831958,1253339700,2,92,46,1360831956515,1360831956515,1253338215,1253338215,0
1360831964,4186626036,4,478,119.5,1360831957620,1360831957620,4186619656,4186619656,0
1360831982,1253363924,1,46,46,1360831956227,1360831956227,1253338151,1253338151,0
1360831983,4186645064,1,46,46,1360831956249,1360831956249,4186618313,4186618313,0
1360832006,1253388000,6,4313,718.8333333,1360831978104,1360832003000,1253360104,1253385000,24896
1360832054,1253436016,1,851,851,1360832027241,1360832027241,1253409257,1253409257,0
1360832082,1253464020,1,48,48,1360832056740,1360832056740,1253438760,1253438760,0
1360832334,1253716464,1,71,71,1360832307363,1360832307363,1253689827,1253689827,0
1360832346,1253728508,1,71,71,1360832320825,1360832320825,1253703333,1253703333,0
1360832350,1253732564,3,408,136,1360832324927,1360832331007,1253707491,1253713571,6080
1360832447,1253828696,3,414,138,1360832420451,1360832426467,1253802147,1253808163,6016
1360832491,1253872960,1,46,46,1360832464024,1360832464024,1253845984,1253845984,0
1360832760,1254141872,1,48,48,1360832732268,1360832732268,1254114140,1254114140,0
1360832964,1254346284,3,408,136,1360832936654,1360832942670,1254318938,1254324954,6016
1360833254,1254636464,15,6289,419.2666667,1360833234775,1360833246807,1254617239,1254629271,12032
1360833254,1254636492,12,999,83.25,1360833235192,1360833246776,1254617684,1254629268,11584
1360833254,1254636496,12,999,83.25,1360833235444,1360833246772,1254617940,1254629268,11328
1360833254,1254636496,12,999,83.25,1360833235703,1360833246775,1254618199,1254629271,11072
1360833318,1254700500,12,999,83.25,1360833300016,1360833310896,1254682516,1254693396,10880
1360833318,1254700528,11,953,86.63636364,1360833299733,1360833310869,1254682261,1254693397,11136
1360833321,1254703156,12,999,83.25,1360833300808,1360833311240,1254682964,1254693396,10432
1360833321,1254703156,11,953,86.63636364,1360833300615,1360833311239,1254682771,1254693395,10624
1360833570,1254951656,3,411,137,1360833544057,1360833550073,1254925713,1254931729,6016
1360833574,1254955680,3,408,136,1360833548706,1360833554722,1254930386,1254936402,6016
1360834063,1255445584,1,46,46,1360834034323,1360834034323,1255416907,1255416907,0
1360834064,1255446476,1,46,46,1360834034492,1360834034492,1255416968,1255416968,0
1360834187,1255568828,3,408,136,1360834159939,1360834166019,1255541767,1255547847,6080
1360834240,1255621652,14,3446,246.1428571,1360834234290,1360834234674,1255615942,1255616326,384
1360834240,1255621660,14,3446,246.1428571,1360834234283,1360834234603,1255615943,1255616263,320
1360834796,1256178136,3,408,136,1360834770183,1360834776199,1256152319,1256158335,6016
1360834876,1256258352,2,92,46,1360834851500,1360834852524,1256233852,1256234876,1024
1360834892,1256274372,2,92,46,1360834864922,1360834865946,1256247294,1256248318,1024
1360835004,1256386436,1,60,60,1360834977366,1360834977366,1256359802,1256359802,0
1360835004,1256386552,1,60,60,1360834979556,1360834979556,1256362108,1256362108,0
1360835121,1256502984,15,6289,419.2666667,1360835104728,1360835116824,1256486712,1256498808,12096
1360835121,1256502988,12,999,83.25,1360835105430,1360835116822,1256487418,1256498810,11392
1360835121,1256502988,13,1045,80.38461538,1360835105685,1360835117205,1256487673,1256499193,11520
1360835121,1256502996,12,999,83.25,1360835105165,1360835116813,1256487161,1256498809,11648
1360835185,1256566996,11,953,86.63636364,1360835169675,1360835180811,1256551671,1256562807,11136
1360835185,1256567000,11,953,86.63636364,1360835169930,1360835180746,1256551930,1256562746,10816
1360835185,1256567000,11,953,86.63636364,1360835170186,1360835180746,1256552186,1256562746,10560
1360835185,1256567000,11,953,86.63636364,1360835170441,1360835180745,1256552441,1256562745,10304
1360835409,1256791216,3,408,136,1360835381742,1360835387822,1256763958,1256770038,6080
1360835990,1257372408,1,56,56,1360835964515,1360835964515,1257346923,1257346923,0
1360836002,1257384420,1,48,48,1360835974806,1360835974806,1257357226,1257357226,0
1360836018,1257400460,3,408,136,1360835993138,1360835999154,1257375598,1257381614,6016
1360836030,1257412416,1,46,46,1360836003546,1360836003546,1257385962,1257385962,0
1360836078,1257460564,1,95,95,1360836052038,1360836052038,1257434602,1257434602,0
1360836435,1257817116,1,48,48,1360836410498,1360836410498,1257792614,1257792614,0
1360836435,1257817180,1,48,48,1360836409475,1360836409475,1257791655,1257791655,0
1360836435,1257817216,1,48,48,1360836407772,1360836407772,1257789988,1257789988,0
1360836435,1257817232,1,48,48,1360836408782,1360836408782,1257791014,1257791014,0
1360836570,1257952516,15,6289,419.2666667,1360836552751,1360836564783,1257935267,1257947299,12032
1360836570,1257952520,12,999,83.25,1360836553642,1360836564778,1257936162,1257947298,11136
1360836570,1257952524,12,999,83.25,1360836553128,1360836564776,1257935652,1257947300,11648
1360836570,1257952524,12,999,83.25,1360836553382,1360836564774,1257935906,1257947298,11392
1360836631,1258013556,3,408,136,1360836604617,1360836610633,1257987173,1257993189,6016
1360836811,1258192628,5,308,61.6,1360836802276,1360836805732,1258183904,1258187360,3456
1360836811,1258192628,7,436,62.28571429,1360836800035,1360836805731,1258181663,1258187359,5696
1360836811,1258192632,6,372,62,1360836801186,1360836805730,1258182818,1258187362,4544
1360836828,1258209928,3,180,60,1360836802551,1360836811511,1258184479,1258193439,8960
1360836848,1258229960,1,60,60,1360836823513,1360836823513,1258205473,1258205473,0
1360836872,1258254060,1,60,60,1360836847412,1360836847412,1258229472,1258229472,0
1360836920,1258302120,1,60,60,1360836895352,1360836895352,1258277472,1258277472,0
1360837241,1258622684,3,408,136,1360837216550,1360837222566,1258598234,1258604250,6016
1360837854,1259235720,3,408,136,1360837827769,1360837833785,1259209489,1259215505,6016
1360837934,1259315888,4,1252,313,1360837906384,1360837915728,1259288272,1259297616,9344
1360837954,1259335864,1,398,398,1360837927913,1360837927913,1259309777,1259309777,0
1360837978,1259360044,1,398,398,1360837951986,1360837951986,1259334030,1259334030,0
1360838006,1259388108,1,48,48,1360837981043,1360837981043,1259363151,1259363151,0
1360838018,1259400048,1,46,46,1360837991917,1360837991917,1259373965,1259373965,0
1360838371,1259753536,15,6289,419.2666667,1360838357312,1360838369408,1259739848,1259751944,12096
1360838371,1259753540,11,953,86.63636364,1360838358270,1360838369406,1259740810,1259751946,11136
1360838371,1259753544,12,999,83.25,1360838357751,1360838369399,1259740295,1259751943,11648
1360838371,1259753548,12,999,83.25,1360838358006,1360838369398,1259740554,1259751946,11392
1360838467,1259848796,3,408,136,1360838438885,1360838444965,1259820681,1259826761,6080
1360838499,1259880852,1,48,48,1360838471595,1360838471595,1259853447,1259853447,0
1360839075,1260457508,3,408,136,1360839048977,1360839054993,1260431485,1260437501,6016
1360839685,1261066688,3,408,136,1360839660413,1360839666429,1261042101,1261048117,6016
1360839766,1261147836,1,60,60,1360839739623,1360839739623,1261121459,1261121459,0
1360839767,1261148620,1,60,60,1360839739842,1360839739842,1261121462,1261121462,0
1360839767,1261148648,1,60,60,1360839739813,1360839739813,1261121461,1261121461,0
1360839981,1261363436,1,48,48,1360839954380,1360839954380,1261336816,1261336816,0
1360840181,1261562744,15,6289,419.2666667,1360840162748,1360840174844,1261544492,1261556588,12096
1360840181,1261562748,12,999,83.25,1360840163450,1360840174778,1261545198,1261556526,11328
1360840181,1261562752,12,999,83.25,1360840163188,1360840174772,1261544940,1261556524,11584
1360840181,1261562756,11,953,86.63636364,1360840163695,1360840174767,1261545451,1261556523,11072
1360840298,1261680036,3,408,136,1360840271896,1360840277912,1261653932,1261659948,6016
1360840823,1262205068,1,46,46,1360840798128,1360840798128,1262180196,1262180196,0
1360840911,1262293400,3,408,136,1360840883490,1360840889506,1262265890,1262271906,6016
1360840987,1262369496,1,46,46,1360840962818,1360840962818,1262345314,1262345314,0
1360841532,1262914360,3,408,136,1360841505666,1360841511746,1262888026,1262894106,6080
1360841805,1263186768,1,108,108,1360841804046,1360841804046,1263185814,1263185814,0
1360841805,1263186768,4,2054,513.5,1360841803982,1360841803982,1263185750,1263185750,0
1360841806,1263187620,8,2004,250.5,1360841805218,1360841805410,1263186838,1263187030,192
1360841809,1263190768,8,3137,392.125,1360841804239,1360841805647,1263186007,1263187415,1408
1360841814,1263195592,7,1460,208.5714286,1360841809598,1360841810302,1263191190,1263191894,704
1360841814,1263195592,6,798,133,1360841809598,1360841809918,1263191190,1263191510,320
1360841814,1263195592,11,3139,285.3636364,1360841809981,1360841810685,1263191573,1263192277,704
1360841814,1263195596,9,1913,212.5555556,1360841811575,1360841811767,1263193171,1263193363,192
1360841814,1263195596,7,1423,203.2857143,1360841812090,1360841812858,1263193686,1263194454,768
1360841814,1263195596,4,724,181,1360841812346,1360841812346,1263193942,1263193942,0
1360841814,1263195596,6,983,163.8333333,1360841809272,1360841809592,1263190868,1263191188,320
1360841814,1263195600,5,1263,252.6,1360841807158,1360841807222,1263188758,1263188822,64
1360841814,1263195600,8,3492,436.5,1360841807606,1360841808246,1263189206,1263189846,640
1360841814,1263195600,8,2018,252.25,1360841807733,1360841807925,1263189333,1263189525,192
1360841814,1263195600,11,3294,299.4545455,1360841808564,1360841809268,1263190164,1263190868,704
1360841814,4196476528,6,3769,628.1666667,1360841812551,1360841812679,4196475079,4196475207,128
1360841814,4196476532,4,1448,362,1360841806278,1360841806342,4196468810,4196468874,64
1360841814,4196476532,5,451,90.2,1360841809541,1360841810693,4196472073,4196473225,1152
1360841814,4196476532,5,2109,421.8,1360841810821,1360841810885,4196473353,4196473417,64
1360841814,4196476532,5,451,90.2,1360841805828,1360841806212,4196468360,4196468744,384
1360841814,4196476532,5,451,90.2,1360841812036,1360841813380,4196474568,4196475912,1344
1360841822,1263203624,9,1913,212.5555556,1360841817564,1360841817692,1263199188,1263199316,128
1360841822,1263203624,7,1256,179.4285714,1360841817564,1360841818204,1263199188,1263199828,640
1360841822,1263203624,9,1913,212.5555556,1360841814235,1360841814427,1263195859,1263196051,192
1360841822,1263203628,7,1256,179.4285714,1360841814810,1360841815514,1263196438,1263197142,704
1360841822,1263203628,10,3421,342.1,1360841819224,1360841819352,1263200852,1263200980,128
1360841822,1263203628,9,1913,212.5555556,1360841815832,1360841816024,1263197460,1263197652,192
1360841822,1263203632,9,1913,212.5555556,1360841816467,1360841816659,1263198099,1263198291,192
1360841822,1263203632,9,1913,212.5555556,1360841816854,1360841817174,1263198486,1263198806,320
1360841822,1263203632,9,1913,212.5555556,1360841819862,1360841819990,1263201494,1263201622,128
1360841822,1263203632,12,4927,410.5833333,1360841820693,1360841821205,1263202325,1263202837,512
1360841822,1263203632,9,1913,212.5555556,1360841820757,1360841820885,1263202389,1263202517,128
1360841822,1263203632,5,609,121.8,1360841821268,1360841821716,1263202900,1263203348,448
1360841822,1263203636,15,8365,557.6666667,1360841818130,1360841818322,1263199766,1263199958,192
1360841822,1263203636,12,4735,394.5833333,1360841821714,1360841821906,1263203350,1263203542,192
1360841822,1263203636,11,4921,447.3636364,1360841818513,1360841818833,1263200149,1263200469,320
1360841822,1263203636,5,609,121.8,1360841819215,1360841819663,1263200851,1263201299,448
1360841822,4196484528,4,445,111.25,1360841821001,1360841821129,4196483529,4196483657,128
1360841822,4196484528,5,726,145.2,1360841821129,1360841821513,4196483657,4196484041,384
1360841822,4196484528,4,445,111.25,1360841821641,1360841821705,4196484169,4196484233,64
1360841822,4196484528,5,451,90.2,1360841814984,1360841816008,4196477512,4196478536,1024
1360841822,4196484528,5,451,90.2,1360841819016,1360841819976,4196481544,4196482504,960
1360841822,4196484528,5,451,90.2,1360841817482,1360841817674,4196480010,4196480202,192
1360841829,1263210804,1,108,108,1360841804138,1360841804138,1263185942,1263185942,0
1360841829,1263210804,1,108,108,1360841804202,1360841804202,1263186006,1263186006,0
1360841829,1263210804,2,104,52,1360841804330,1360841804330,1263186134,1263186134,0
1360841829,1263210836,1,108,108,1360841804105,1360841804105,1263185941,1263185941,0
1360841830,1263211604,9,1913,212.5555556,1360841823409,1360841823601,1263205013,1263205205,192
1360841830,1263211604,9,3345,371.6666667,1360841827312,1360841828336,1263208916,1263209940,1024
1360841830,1263211604,9,1913,212.5555556,1360841824048,1360841824240,1263205652,1263205844,192
1360841830,1263211608,9,3310,367.7777778,1360841825452,1360841827308,1263207060,1263208916,1856
1360841830,1263211608,4,715,178.75,1360841829484,1360841829548,1263211092,1263211156,64
1360841830,1263211612,10,1877,187.7,1360841822442,1360841823274,1263204054,1263204886,832
1360841830,1263211616,9,2849,316.5555556,1360841824678,1360841824806,1263206294,1263206422,128
1360841830,4196492528,4,1448,362,1360841824455,1360841824519,4196486983,4196487047,64
1360841837,1263218828,7,1980,282.8571429,1360841812239,1360841812943,1263194067,1263194771,704
1360841838,1263219604,11,3096,281.4545455,1360841829744,1360841830448,1263211348,1263212052,704
1360841838,1263219616,14,7501,535.7857143,1360841831270,1360841832102,1263212886,1263213718,832
1360841841,1263222772,7,2145,306.4285714,1360841813322,1360841814026,1263195094,1263195798,704
1360841841,1263222808,7,1877,268.1428571,1360841814053,1360841814693,1263195861,1263196501,640
1360841982,1263363756,16,6672,417,1360841967446,1360841979542,1263349202,1263361298,12096
1360841982,1263363764,17,6755,397.3529412,1360841968077,1360841979533,1263349841,1263361297,11456
1360841982,1263363768,12,999,83.25,1360841968396,1360841979532,1263350164,1263361300,11136
1360841982,1263363768,12,999,83.25,1360841968652,1360841979468,1263350420,1263361236,10816
1360842038,1263419836,10,907,90.7,1360842026116,1360842037892,1263407952,1263419728,11776
1360842038,1263419836,10,907,90.7,1360842026694,1360842037894,1263408530,1263419730,11200
1360842038,1263419840,11,953,86.63636364,1360842025857,1360842037889,1263407697,1263419729,12032
1360842038,1263419844,11,953,86.63636364,1360842026367,1360842037887,1263408211,1263419731,11520
1360842065,1263447004,1,46,46,1360842037791,1360842037791,1263419795,1263419795,0
1360842065,1263447004,1,46,46,1360842037790,1360842037790,1263419794,1263419794,0
1360842065,1263447004,1,46,46,1360842037790,1360842037790,1263419794,1263419794,0
1360842065,1263447020,1,46,46,1360842037771,1360842037771,1263419791,1263419791,0
1360842145,1263527116,3,408,136,1360842116973,1360842122989,1263499089,1263505105,6016
1360842730,1264111800,1,48,48,1360842704160,1360842704160,1264085960,1264085960,0
1360842754,1264135840,3,408,136,1360842729335,1360842735351,1264111175,1264117191,6016
1360843328,1264710560,1,48,48,1360843300190,1360843300190,1264682750,1264682750,0
1360843328,1264710564,1,48,48,1360843300185,1360843300185,1264682749,1264682749,0
1360843330,1264711748,1,48,48,1360843301004,1360843301004,1264682752,1264682752,0
1360843367,1264749376,3,408,136,1360843340502,1360843346582,1264722878,1264728958,6080
1360843392,1264774396,1,48,48,1360843365696,1360843365696,1264748092,1264748092,0
1360843392,1264774400,1,48,48,1360843365693,1360843365693,1264748093,1264748093,0
1360843393,1264774856,1,48,48,1360843366301,1360843366301,1264748157,1264748157,0
1360843847,1265228984,11,953,86.63636364,1360843831125,1360843842261,1265213109,1265224245,11136
1360843847,1265228992,12,999,83.25,1360843830864,1360843842256,1265212856,1265224248,11392
1360843847,1265228996,15,6289,419.2666667,1360843830217,1360843842249,1265212213,1265224245,12032
1360843847,1265228996,12,999,83.25,1360843830601,1360843842249,1265212597,1265224245,11648
1360843911,1265293036,12,999,83.25,1360843896609,1360843908321,1265278645,1265290357,11712
1360843911,1265293036,12,999,83.25,1360843896864,1360843908320,1265278900,1265290356,11456
1360843911,1265293044,16,6372,398.25,1360843896218,1360843908314,1265278262,1265290358,12096
1360843911,1265293048,11,953,86.63636364,1360843897108,1360843908308,1265279156,1265290356,11200
1360843976,1265358404,3,408,136,1360843951474,1360843957554,1265333878,1265339958,6080
1360844590,1265972208,3,408,136,1360844563372,1360844569388,1265945580,1265951596,6016
1360845199,1266581460,3,408,136,1360845174055,1360845180071,1266556515,1266562531,6016
1360845267,1266649476,1,46,46,1360845242326,1360845242326,1266624802,1266624802,0
1360845552,1266933912,2,122,61,1360845526468,1360845526660,1266908380,1266908572,192
1360845720,1267102140,12,999,83.25,1360845701151,1360845712799,1267083291,1267094939,11648
1360845720,1267102148,15,6289,419.2666667,1360845700695,1360845712791,1267082843,1267094939,12096
1360845720,1267102148,12,999,83.25,1360845701398,1360845712790,1267083546,1267094938,11392
1360845720,1267102148,12,999,83.25,1360845701654,1360845712790,1267083802,1267094938,11136
1360845764,1267146120,2,122,61,1360845737138,1360845737330,1267119258,1267119450,192
1360845784,1267166076,1,46,46,1360845757212,1360845757212,1267139288,1267139288,0
1360845784,1267166200,12,999,83.25,1360845766433,1360845777889,1267148633,1267160089,11456
1360845784,1267166200,11,953,86.63636364,1360845766689,1360845777889,1267148889,1267160089,11200
1360845784,1267166208,17,6886,405.0588235,1360845765786,1360845777818,1267147994,1267160026,12032
1360845784,1267166208,11,953,86.63636364,1360845766169,1360845777881,1267148377,1267160089,11712
1360845784,1267166232,11,953,86.63636364,1360845766850,1360845777858,1267149082,1267160090,11008
1360845812,1267194132,3,408,136,1360845785959,1360845791975,1267168091,1267174107,6016
1360845936,1267318552,1,46,46,1360845908737,1360845908737,1267291289,1267291289,0
1360846426,1267807872,3,408,136,1360846398047,1360846404063,1267779919,1267785935,6016
1360846578,1267960436,2,152,76,1360846550120,1360846565160,1267932556,1267947596,15040
1360846607,1267988708,2,152,76,1360846580866,1360846595906,1267962574,1267977614,15040
1360846639,1268020700,2,152,76,1360846610954,1360846625994,1267992654,1268007694,15040
1360846667,1268048732,2,152,76,1360846641002,1360846655978,1268022734,1268037710,14976
1360846699,1268080712,1,76,76,1360846671036,1360846671036,1268052748,1268052748,0
1360846727,1268108776,2,152,76,1360846701115,1360846716091,1268082891,1268097867,14976
1360846759,1268140776,2,152,76,1360846731132,1360846746172,1268112908,1268127948,15040
1360846787,1268168832,1,76,76,1360846761091,1360846761091,1268142923,1268142923,0
1360846803,1268184828,2,152,76,1360846776519,1360846791559,1268158347,1268173387,15040
1360846831,1268212844,2,152,76,1360846806580,1360846821684,1268188424,1268203528,15104
1360846863,1268244908,1,76,76,1360846836599,1360846836599,1268218507,1268218507,0
1360847035,1268417132,3,408,136,1360847008468,1360847014420,1268390600,1268396552,5952
1360847376,1268757920,1,46,46,1360847349088,1360847349088,1268731008,1268731008,0
1360847509,1268891380,1,46,46,1360847481746,1360847481746,1268864126,1268864126,0
1360847510,1268892484,1,46,46,1360847481579,1360847481579,1268864063,1268864063,0
1360847510,1268892488,1,46,46,1360847481575,1360847481575,1268864063,1268864063,0
1360847586,1268968108,15,6289,419.2666667,1360847570723,1360847582819,1268952831,1268964927,12096
1360847586,1268968108,11,953,86.63636364,1360847571169,1360847582753,1268953277,1268964861,11584
1360847586,1268968112,12,999,83.25,1360847571743,1360847582751,1268953855,1268964863,11008
1360847586,1268968144,12,999,83.25,1360847571390,1360847582718,1268953534,1268964862,11328
1360847605,1268986852,2,122,61,1360847580194,1360847582562,1268962046,1268964414,2368
1360847645,1269026880,3,408,136,1360847620103,1360847626119,1269001983,1269007999,6016
1360847650,1269032412,11,953,86.63636364,1360847635760,1360847647152,1269018172,1269029564,11392
1360847650,1269032412,12,999,83.25,1360847635312,1360847647152,1269017724,1269029564,11840
1360847650,1269032448,11,953,86.63636364,1360847635021,1360847647117,1269017469,1269029565,12096
1360847650,1269032452,12,999,83.25,1360847635977,1360847647497,1269018429,1269029949,11520
1360847829,1269211328,1,46,46,1360847803009,1360847803009,1269185337,1269185337,0
1360847941,1269323388,1,46,46,1360847914692,1360847914692,1269297080,1269297080,0
1360848258,1269639888,3,408,136,1360848231860,1360848237876,1269613748,1269619764,6016
1360848851,1270233388,1,46,46,1360848826616,1360848826616,1270209004,1270209004,0
1360848871,1270253364,3,408,136,1360848843021,1360848849101,1270225385,1270231465,6080
1360849073,1270455088,1,48,48,1360849046241,1360849046241,1270428329,1270428329,0
1360849074,1270456284,1,48,48,1360849046044,1360849046044,1270428328,1270428328,0
1360849074,1270456284,1,48,48,1360849046043,1360849046043,1270428327,1270428327,0
1360849452,1270834192,11,953,86.63636364,1360849440626,1360849451890,1270822818,1270834082,11264
1360849452,1270834208,11,953,86.63636364,1360849440356,1360849451876,1270822564,1270834084,11520
1360849452,1270834208,11,953,86.63636364,1360849440866,1360849451874,1270823074,1270834082,11008
1360849452,1270834240,14,6243,445.9285714,1360849439875,1360849451843,1270822115,1270834083,11968
1360849477,1270858708,1,46,46,1360849452438,1360849452438,1270834146,1270834146,0
1360849477,1270858760,1,46,46,1360849452386,1360849452386,1270834146,1270834146,0
1360849477,1270858760,1,46,46,1360849452386,1360849452386,1270834146,1270834146,0
1360849477,1270858760,1,46,46,1360849452386,1360849452386,1270834146,1270834146,0
1360849481,1270862764,3,408,136,1360849455004,1360849461020,1270836768,1270842784,6016
1360849516,1270898236,10,907,90.7,1360849505156,1360849515908,1270887392,1270898144,10752
1360849516,1270898240,10,907,90.7,1360849505665,1360849515905,1270887905,1270898145,10240
1360849516,1270898272,11,953,86.63636364,1360849504930,1360849515874,1270887202,1270898146,10944
1360849516,1270898276,10,907,90.7,1360849505438,1360849515870,1270887714,1270898146,10432
1360849541,1270923052,1,46,46,1360849516158,1360849516158,1270898210,1270898210,0
1360849541,1270923100,1,46,46,1360849516107,1360849516107,1270898207,1270898207,0
1360849541,1270923104,1,46,46,1360849516103,1360849516103,1270898207,1270898207,0
1360849541,1270923104,1,46,46,1360849516107,1360849516107,1270898211,1270898211,0
1360849822,1271203588,1,46,46,1360849795271,1360849795271,1271176859,1271176859,0
1360850090,1271472420,3,408,136,1360850065094,1360850071110,1271447514,1271453530,6016
1360850391,1271773036,2,152,76,1360850363136,1360850378176,1271745172,1271760212,15040
1360850419,1271801120,2,152,76,1360850393067,1360850408171,1271775187,1271790291,15104
1360850451,1271833100,1,76,76,1360850423230,1360850423230,1271805330,1271805330,0
1360850463,1271845112,2,152,76,1360850438261,1360850453301,1271820373,1271835413,15040
1360850495,1271877164,2,152,76,1360850468224,1360850483264,1271850388,1271865428,15040
1360850523,1271905176,1,76,76,1360850498291,1360850498291,1271880467,1271880467,0
1360850539,1271921156,2,152,76,1360850513352,1360850528392,1271895508,1271910548,15040
1360850571,1271953284,2,152,76,1360850543237,1360850558277,1271925521,1271940561,15040
1360850599,1271981352,2,152,76,1360850573184,1360850588288,1271955536,1271970640,15104
1360850605,1271987180,21,15228,725.1428571,1360850593899,1360850604651,1271976079,1271986831,10752
1360850609,4205270952,34,43672,1284.470588,1360850592964,1360850604932,4205254916,4205266884,11968
1360850619,1272001380,1,52,52,1360850593765,1360850593765,1271976145,1271976145,0
1360850631,1272013364,2,152,76,1360850603318,1360850618294,1271985682,1272000658,14976
1360850660,1272041576,2,152,76,1360850634121,1360850649225,1272015697,1272030801,15104
1360850703,1272085504,3,408,136,1360850676455,1360850682535,1272058959,1272065039,6080
1360850860,1272241948,1,46,46,1360850833105,1360850833105,1272215053,1272215053,0
1360850860,1272242020,1,61,61,1360850833097,1360850833097,1272215117,1272215117,0
1360850952,1272334380,1,61,61,1360850925729,1360850925729,1272308109,1272308109,0
1360850965,1272347348,12,999,83.25,1360850953023,1360850964671,1272335371,1272347019,11648
1360850965,1272347380,15,6289,419.2666667,1360850952607,1360850964639,1272334987,1272347019,12032
1360850973,1272355352,11,953,86.63636364,1360850953532,1360850965052,1272335884,1272347404,11520
1360850973,1272355392,12,999,83.25,1360850953236,1360850965012,1272335628,1272347404,11776
1360851077,1272459528,12,999,83.25,1360851063624,1360851073736,1272446152,1272456264,10112
1360851077,1272459548,11,953,86.63636364,1360851063096,1360851073720,1272445644,1272456268,10624
1360851078,1272459596,16,6372,398.25,1360851063661,1360851074733,1272445257,1272456329,11072
1360851078,1272459620,12,999,83.25,1360851064279,1360851074647,1272445899,1272456267,10368
1360851310,1272691680,4,1064,266,1360851309525,1360851309717,1272691205,1272691397,192
1360851313,4205975208,52,73649,1416.326923,1360851309318,1360851309510,4205971526,4205971718,192
1360851317,1272698768,3,408,136,1360851289536,1360851295616,1272671304,1272677384,6080
1360851926,1273307556,3,408,136,1360851901256,1360851907272,1273282812,1273288828,6016
1360852539,1273921008,3,408,136,1360852511293,1360852517309,1273893301,1273899317,6016
1360852896,1274277644,12,6151,512.5833333,1360852871841,1360852872161,1274253485,1274253805,320
1360852900,1274281644,8,815,101.875,1360852872290,1360852872482,1274253934,1274254126,192
1360852900,1274281648,9,861,95.66666667,1360852872542,1360852872734,1274254190,1274254382,192
1360852900,1274281648,9,861,95.66666667,1360852872798,1360852872990,1274254446,1274254638,192
1360853111,1274493068,3,138,46,1360853106104,1360853106168,1274488172,1274488236,64
1360853127,1274509080,12,999,83.25,1360853109290,1360853121066,1274491370,1274503146,11776
1360853127,1274509120,12,999,83.25,1360853108930,1360853121026,1274491050,1274503146,12096
1360853127,1274509128,11,953,86.63636364,1360853109500,1360853121020,1274491628,1274503148,11520
1360853127,1274509152,12,999,83.25,1360853109733,1360853120997,1274491885,1274503149,11264
1360853132,1274514428,2,109,54.5,1360853105743,1360853105807,1274488171,1274488235,64
1360853132,1274514428,2,109,54.5,1360853105807,1360853105807,1274488235,1274488235,0
1360853132,1274514500,2,109,54.5,1360853105670,1360853105670,1274488170,1274488170,0
1360853148,1274530504,3,408,136,1360853121859,1360853127875,1274504363,1274510379,6016
1360853345,1274726992,1,46,46,1360853319616,1360853319616,1274701608,1274701608,0
1360853565,1274947140,1,46,46,1360853537640,1360853537640,1274919780,1274919780,0
1360853761,1275143520,3,408,136,1360853733034,1360853739114,1275115554,1275121634,6080
1360853765,1275147532,8,815,101.875,1360853738719,1360853738911,1275121251,1275121443,192
1360853765,1275147536,9,861,95.66666667,1360853739227,1360853739419,1275121763,1275121955,192
1360853766,1275147596,13,6234,479.5384615,1360853739268,1360853739588,1275120864,1275121184,320
1360853766,1275147604,9,861,95.66666667,1360853739902,1360853740094,1275121506,1275121698,192
1360853928,1275309824,3,189,63,1360853920864,1360853923872,1275302688,1275305696,3008
1360853944,1275325864,2,126,63,1360853927862,1360853935926,1275309726,1275317790,8064
1360854024,1275405884,4,252,63,1360854016224,1360854023328,1275398108,1275405212,7104
1360854024,1275405884,4,252,63,1360854016224,1360854023264,1275398108,1275405148,7040
1360854058,1275440504,1,63,63,1360854030711,1360854030711,1275413215,1275413215,0
1360854058,1275440504,1,63,63,1360854030708,1360854030708,1275413212,1275413212,0
1360854064,1275445944,4,252,63,1360854056741,1360854063845,1275438685,1275445789,7104
1360854098,1275480528,1,63,63,1360854071261,1360854071261,1275453789,1275453789,0
1360854176,1275557928,17,6755,397.3529412,1360854164594,1360854174834,1275546522,1275556762,10240
1360854176,1275557932,12,999,83.25,1360854165229,1360854174765,1275547161,1275556697,9536
1360854176,1275557932,12,999,83.25,1360854164973,1360854174829,1275546905,1275556761,9856
1360854176,1275557956,12,999,83.25,1360854165463,1360854174743,1275547419,1275556699,9280
1360854203,1275584632,2,152,76,1360854176028,1360854191132,1275557660,1275572764,15104
1360854231,1275612708,2,152,76,1360854206092,1360854221132,1275587800,1275602840,15040
1360854263,1275644676,1,76,76,1360854236206,1360854236206,1275617882,1275617882,0
1360854371,1275752712,3,408,136,1360854344903,1360854350983,1275726615,1275732695,6080
1360854912,1276294540,12,999,83.25,1360854894914,1360854904066,1276277454,1276286606,9152
1360854913,1276294608,11,953,86.63636364,1360854895529,1360854905001,1276277137,1276286609,9472
1360854913,1276294656,16,6372,398.25,1360854894841,1360854904953,1276276497,1276286609,10112
1360854913,1276294656,11,953,86.63636364,1360854895225,1360854904953,1276276881,1276286609,9728
1360854920,1276301692,2,152,76,1360854895637,1360854910677,1276277329,1276292369,15040
1360854952,1276333628,2,152,76,1360854925842,1360854940818,1276307470,1276322446,14976
1360854984,1276365600,1,76,76,1360854955888,1360854955888,1276337488,1276337488,0
1360854984,1276365652,3,408,136,1360854956218,1360854962298,1276337870,1276343950,6080
1360854984,1276365688,1,46,46,1360854958358,1360854958358,1276340046,1276340046,0
1360855316,1276698048,1,46,46,1360855291691,1360855291691,1276673739,1276673739,0
1360855465,1276847412,16,6372,398.25,1360855452923,1360855463099,1276835335,1276845511,10176
1360855465,1276847464,12,999,83.25,1360855453576,1360855463048,1276836040,1276845512,9472
1360855465,1276847464,12,999,83.25,1360855453319,1360855463047,1276835783,1276845511,9728
1360855465,1276847488,12,999,83.25,1360855453808,1360855463024,1276836296,1276845512,9216
1360855480,1276862456,2,152,76,1360855453646,1360855468686,1276836102,1276851142,15040
1360855508,1276890524,2,152,76,1360855483659,1360855498699,1276866183,1276881223,15040
1360855540,1276922512,1,76,76,1360855513749,1360855513749,1276896261,1276896261,0
1360855593,1276974936,3,408,136,1360855566422,1360855572438,1276948358,1276954374,6016
1360855657,1277038904,5,250,50,1360855629621,1360855651445,1277011525,1277033349,21824
1360855777,1277159284,1,46,46,1360855749559,1360855749559,1277131843,1277131843,0
1360856203,1277584808,3,408,136,1360856178189,1360856184269,1277559997,1277566077,6080
1360856816,1278198436,3,408,136,1360856789648,1360856795728,1278172084,1278178164,6080
1360857099,1278480624,43,55063,1280.534884,1360857093816,1360857094136,1278475440,1278475760,320
1360857107,1278488632,12,999,83.25,1360857094574,1360857105198,1278476206,1278486830,10624
1360857107,1278488636,17,6755,397.3529412,1360857094891,1360857105195,1278476527,1278486831,10304
1360857107,1278488676,15,6289,419.2666667,1360857093828,1360857105156,1278475504,1278486832,11328
1360857107,1278488680,12,999,83.25,1360857094272,1360857105152,1278475952,1278486832,10880
1360857121,1278502684,2,152,76,1360857095739,1360857110779,1278477423,1278492463,15040
1360857153,1278534808,2,152,76,1360857125696,1360857140736,1278507504,1278522544,15040
1360857181,1278562868,1,76,76,1360857155712,1360857155712,1278537580,1278537580,0
1360857429,1278811420,3,408,136,1360857401046,1360857407062,1278783466,1278789482,6016
1360857894,1279275540,1,46,46,1360857864768,1360857864768,1279246308,1279246308,0
1360857894,1279275572,1,46,46,1360857864736,1360857864736,1279246308,1279246308,0
1360858039,1279421328,3,408,136,1360858012202,1360858018282,1279394530,1279400610,6080
1360858087,1279469520,5,250,50,1360858059880,1360858081704,1279442400,1279464224,21824
1360858132,1279513692,1,48,48,1360858106786,1360858106786,1279488478,1279488478,0
1360858164,1279545756,1,48,48,1360858136035,1360858136035,1279517791,1279517791,0
1360858237,1279618856,1,48,48,1360858209983,1360858209983,1279591839,1279591839,0
1360858238,1279619668,1,48,48,1360858210171,1360858210171,1279591839,1279591839,0
1360858649,1280031084,3,408,136,1360858623701,1360858629717,1280005785,1280011801,6016
1360858706,1280087956,1,46,46,1360858677394,1360858677394,1280059350,1280059350,0
1360858950,1280332084,1,74,74,1360858923279,1360858923279,1280305363,1280305363,0
1360858978,1280360064,1,74,74,1360858949348,1360858949348,1280331412,1280331412,0
1360859010,1280392124,1,48,48,1360858983591,1360858983591,1280365715,1280365715,0
1360859074,1280456344,1,46,46,1360859046154,1360859046154,1280428498,1280428498,0
1360859126,1280507728,12,999,83.25,1360859106672,1360859118768,1280488400,1280500496,12096
1360859126,1280507736,11,953,86.63636364,1360859107177,1360859118761,1280488913,1280500497,11584
1360859126,1280507740,11,953,86.63636364,1360859107430,1360859118758,1280489170,1280500498,11328
1360859126,1280507780,12,999,83.25,1360859106878,1360859118718,1280488658,1280500498,11840
1360859150,1280532460,2,152,76,1360859122646,1360859137686,1280505106,1280520146,15040
1360859179,1280560884,2,152,76,1360859153301,1360859168341,1280535185,1280550225,15040
1360859211,1280592848,1,76,76,1360859183352,1360859183352,1280565200,1280565200,0
1360859263,1280644816,3,408,136,1360859235096,1360859241112,1280616912,1280622928,6016
1360859327,1280708928,1,46,46,1360859299620,1360859299620,1280681548,1280681548,0
1360859563,1280945452,1,48,48,1360859535511,1360859535511,1280917963,1280917963,0
1360859740,1281121812,1,46,46,1360859712213,1360859712213,1281094025,1281094025,0
1360859847,1281228620,11,953,86.63636364,1360859828628,1360859838996,1281210248,1281220616,10368
1360859847,1281228648,12,999,83.25,1360859828854,1360859838966,1281210502,1281220614,10112
1360859856,1281238108,2,152,76,1360859829292,1360859844332,1281211400,1281226440,15040
1360859884,1281266040,3,408,136,1360859856235,1360859862251,1281238275,1281244291,6016
1360859900,1281282136,2,152,76,1360859874380,1360859889420,1281256516,1281271556,15040
1360859999,1281380640,11,953,86.63636364,1360859985531,1360859997051,1281367171,1281378691,11520
1360859999,1281380688,11,953,86.63636364,1360859984907,1360859997003,1281366595,1281378691,12096
1360859999,1281380712,12,999,83.25,1360859985140,1360859996980,1281366852,1281378692,11840
1360859999,1281380716,11,953,86.63636364,1360859985711,1360859996975,1281367427,1281378691,11264
1360860012,1281394500,2,152,76,1360859986913,1360860001953,1281369413,1281384453,15040
1360860044,1281426508,2,152,76,1360860016983,1360860031959,1281399491,1281414467,14976
1360860055,1281436780,6,2826,471,1360860036783,1360860048879,1281418563,1281430659,12096
1360860073,1281454588,2,152,76,1360860047919,1360860063023,1281429507,1281444611,15104
1360860089,1281470616,11,3267,297,1360860061010,1360860061650,1281442626,1281443266,640
1360860105,1281486592,2,152,76,1360860078057,1360860093097,1281459649,1281474689,15040
1360860111,1281492792,2,141,70.5,1360860104802,1360860104802,1281486594,1281486594,0
1360860133,1281514640,2,152,76,1360860108091,1360860123131,1281489731,1281504771,15040
1360860287,1281668812,13,1045,80.38461538,1360860271947,1360860284299,1281653759,1281666111,12352
1360860287,1281668848,13,1045,80.38461538,1360860271145,1360860284201,1281652993,1281666049,13056
1360860287,1281668884,13,1045,80.38461538,1360860272130,1360860284162,1281654014,1281666046,12032
1360860287,1281668888,13,1045,80.38461538,1360860272446,1360860284158,1281654334,1281666046,11712
1360860293,1281675060,2,106,53,1360860268052,1360860268180,1281650112,1281650240,128
1360860325,1281707280,4,1416,354,1360860297143,1360860318135,1281679423,1281700415,20992
1360860357,1281739376,2,912,456,1360860330454,1360860354710,1281712830,1281737086,24256
1360860410,1281791732,1,48,48,1360860384858,1360860384858,1281766590,1281766590,0
1360860418,1281799676,1,48,48,1360860393104,1360860393104,1281774780,1281774780,0
1360860422,1281803584,1,48,48,1360860393902,1360860393902,1281775486,1281775486,0
1360860494,1281875904,3,408,136,1360860467498,1360860473578,1281849402,1281855482,6080
1360860783,1282164820,1,48,48,1360860757565,1360860757565,1282139385,1282139385,0
1360861103,1282485188,3,408,136,1360861078408,1360861084424,1282460596,1282466612,6016
1360861716,1283098036,3,408,136,1360861689623,1360861695703,1283071659,1283077739,6080
1360861825,1283206624,12,999,83.25,1360861809968,1360861822064,1283191592,1283203688,12096
1360861825,1283206628,11,953,86.63636364,1360861810221,1360861821997,1283191849,1283203625,11776
1360861825,1283206632,11,953,86.63636364,1360861810728,1360861821992,1283192360,1283203624,11264
1360861825,1283206700,12,999,83.25,1360861810405,1360861821925,1283192105,1283203625,11520
1360861878,1283259776,1,52,52,1360861851864,1360861851864,1283233640,1283233640,0
1360861878,1283259776,1,52,52,1360861851863,1360861851863,1283233639,1283233639,0
1360861942,1283323796,1,52,52,1360861915776,1360861915776,1283297572,1283297572,0
1360861942,1283323796,1,52,52,1360861915648,1360861915648,1283297444,1283297444,0
1360862325,1283707212,3,408,136,1360862300765,1360862306781,1283682977,1283688993,6016
1360862618,1283999716,1,48,48,1360862590278,1360862590278,1283971994,1283971994,0
1360862938,1284320460,3,408,136,1360862911516,1360862917532,1284293976,1284299992,6016
1360863199,1284581056,1,441,441,1360863173163,1360863173163,1284555219,1284555219,0
1360863199,1284581100,1,443,443,1360863171006,1360863171006,1284553106,1284553106,0
1360863548,1284929980,3,408,136,1360863522354,1360863528434,1284904334,1284910414,6080
1360863576,1284958196,8,815,101.875,1360863550040,1360863550232,1284932236,1284932428,192
1360863576,1284958284,14,6617,472.6428571,1360863549567,1360863549887,1284931851,1284932171,320
1360863576,1284958288,9,861,95.66666667,1360863550207,1360863550399,1284932495,1284932687,192
1360863651,1285033208,12,999,83.25,1360863637067,1360863649163,1285019275,1285031371,12096
1360863651,1285033240,11,953,86.63636364,1360863637804,1360863649068,1285020044,1285031308,11264
1360863651,1285033288,11,953,86.63636364,1360863637245,1360863649085,1285019533,1285031373,11840
1360863651,1285033288,12,999,83.25,1360863637499,1360863649083,1285019787,1285031371,11584
1360863680,1285062356,2,152,76,1360863652727,1360863667767,1285035083,1285050123,15040
1360863708,1285090368,2,152,76,1360863682793,1360863697833,1285065161,1285080201,15040
1360863741,1285122704,1,76,76,1360863713539,1360863713539,1285095243,1285095243,0
1360863843,1285225352,3,189,63,1360863836665,1360863839737,1285219017,1285222089,3072
1360863843,1285225352,3,189,63,1360863836728,1360863839736,1285219080,1285222088,3008
1360863859,1285241372,2,126,63,1360863843750,1360863851814,1285226122,1285234186,8064
1360863859,1285241372,2,126,63,1360863843749,1360863851813,1285226121,1285234185,8064
1360863859,1285241484,2,126,63,1360863857651,1360863858611,1285240135,1285241095,960
1360863867,1285249348,2,126,63,1360863860796,1360863864828,1285243144,1285247176,4032
1360863901,1285283136,1,63,63,1360863873103,1360863873103,1285255239,1285255239,0
1360864158,1285540016,3,408,136,1360864133318,1360864139398,1285515334,1285521414,6080
1360864771,1286153028,3,408,136,1360864744752,1360864750832,1286126780,1286132860,6080
1360865380,1286762220,3,408,136,1360865355686,1360865361702,1286737906,1286743922,6016
1360865424,1286806192,1,46,46,1360865397441,1360865397441,1286779633,1286779633,0
1360865469,1286850740,12,999,83.25,1360865452612,1360865460996,1286834352,1286842736,8384
1360865469,1286850744,12,999,83.25,1360865453121,1360865460929,1286834865,1286842673,7808
1360865469,1286850744,12,999,83.25,1360865452864,1360865460928,1286834608,1286842672,8064
1360865492,1286874464,8,815,101.875,1360865467056,1360865467248,1286849520,1286849712,192
1360865492,1286874500,8,815,101.875,1360865467596,1360865467724,1286850096,1286850224,128
1360865492,1286874500,8,815,101.875,1360865467339,1360865467467,1286849839,1286849967,128
1360865496,1286878276,8,815,101.875,1360865468139,1360865468331,1286850415,1286850607,192
1360865717,1287099176,3,189,63,1360865711818,1360865714890,1287093994,1287097066,3072
1360865733,1287115160,2,126,63,1360865718875,1360865726939,1287101035,1287109099,8064
1360865789,1287171304,2,126,63,1360865785931,1360865786955,1287168235,1287169259,1024
1360865789,1287171308,3,189,63,1360865783685,1360865786693,1287165993,1287169001,3008
1360865797,1287179272,2,126,63,1360865788969,1360865793001,1287171241,1287175273,4032
1360865805,1287187348,2,126,63,1360865790685,1360865798749,1287173033,1287181097,8064
1360865829,1287210972,1,63,63,1360865801367,1360865801367,1287183339,1287183339,0
1360865837,1287219396,3,189,63,1360865831724,1360865834732,1287214120,1287217128,3008
1360865853,1287235388,2,126,63,1360865838774,1360865846838,1287221162,1287229226,8064
1360865993,1287375264,3,408,136,1360865966257,1360865972273,1287348521,1287354537,6016
1360866602,1287984160,3,408,136,1360866577359,1360866583439,1287959519,1287965599,6080
1360866815,1288196948,1,46,46,1360866787423,1360866787423,1288169371,1288169371,0
1360866819,1288200900,1,48,48,1360866790927,1360866790927,1288172827,1288172827,0
1360866819,1288200908,1,48,48,1360866791494,1360866791494,1288173402,1288173402,0
1360866875,1288256956,1,46,46,1360866847703,1360866847703,1288229659,1288229659,0
1360866951,1288333112,1,46,46,1360866926073,1360866926073,1288308185,1288308185,0
1360867215,1288597256,3,408,136,1360867188966,1360867194982,1288571222,1288577238,6016
1360867264,1288645724,12,999,83.25,1360867254713,1360867263801,1288636437,1288645525,9088
1360867264,1288645796,17,6755,397.3529412,1360867253745,1360867263729,1288635541,1288645525,9984
1360867264,1288645796,12,999,83.25,1360867254126,1360867263726,1288635922,1288645522,9600
1360867264,1288645800,11,953,86.63636364,1360867254381,1360867263725,1288636181,1288645525,9344
1360867303,1288685480,1,60,60,1360867275140,1360867275140,1288657620,1288657620,0
1360867307,1288689412,1,60,60,1360867279173,1360867279173,1288661585,1288661585,0
1360867536,1288918280,1,46,46,1360867511432,1360867511432,1288893712,1288893712,0
1360867564,1288946300,1,46,46,1360867538865,1360867538865,1288921165,1288921165,0
1360867729,1289110788,1,56,56,1360867701937,1360867701937,1289083725,1289083725,0
1360867829,1289211036,3,408,136,1360867801013,1360867807093,1289183049,1289189129,6080
1360868315,1289696776,1,60,60,1360868289651,1360868289651,1289671427,1289671427,0
1360868315,1289696804,1,60,60,1360868289624,1360868289624,1289671428,1289671428,0
1360868403,1289784892,1,46,46,1360868376447,1360868376447,1289758339,1289758339,0
1360868439,1289820876,3,408,136,1360868411662,1360868417678,1289793538,1289799554,6016
1360868473,1289855148,10,907,90.7,1360868461375,1360868472831,1289843523,1289854979,11456
1360868481,1289863096,12,999,83.25,1360868461106,1360868472946,1289843202,1289855042,11840
1360868481,1289863104,11,953,86.63636364,1360868461736,1360868472936,1289843840,1289855040,11200
1360868481,1289863144,12,999,83.25,1360868460802,1360868472898,1289842946,1289855042,12096
1360868499,1289880944,1,46,46,1360868473095,1360868473095,1289855039,1289855039,0
1360868507,1289889128,1,60,60,1360868481873,1360868481873,1289864001,1289864001,0
1360868515,1289897108,1,60,60,1360868487588,1360868487588,1289869696,1289869696,0
1360868515,1289897148,1,60,60,1360868488317,1360868488317,1289870465,1289870465,0
1360868515,1289897272,1,60,60,1360868489921,1360868489921,1289872193,1289872193,0
1360868895,1290277368,1,46,46,1360868868570,1360868868570,1290250938,1290250938,0
1360868921,1290303348,1,46,46,1360868894703,1360868894703,1290277051,1290277051,0
1360868924,1290305708,1,46,46,1360868896174,1360868896174,1290277882,1290277882,0
1360868996,1290377776,1,46,46,1360868968936,1360868968936,1290350712,1290350712,0
1360869048,1290429944,3,408,136,1360869022850,1360869028866,1290404794,1290410810,6016
1360869204,1290586480,4,202,50.5,1360869178021,1360869199013,1290560501,1290581493,20992
1360869661,1291043172,3,408,136,1360869633876,1360869639892,1291016048,1291022064,6016
1360869666,1291047908,2,92,46,1360869647386,1360869658714,1291029294,1291040622,11328
1360870186,1291568432,12,999,83.25,1360870176327,1360870184327,1291558759,1291566759,8000
1360870186,1291568432,11,953,86.63636364,1360870176645,1360870184325,1291559077,1291566757,7680
1360870187,1291568508,15,6289,419.2666667,1360870176674,1360870185250,1291558182,1291566758,8576
1360870270,1291652028,3,408,136,1360870244568,1360870250584,1291626596,1291632612,6016
1360870531,1291912996,16,6335,395.9375,1360870516917,1360870529013,1291898913,1291911009,12096
1360870531,1291913000,12,999,83.25,1360870517617,1360870529009,1291899617,1291911009,11392
1360870531,1291913080,12,999,83.25,1360870517280,1360870528928,1291899360,1291911008,11648
1360870531,1291913088,12,999,83.25,1360870517787,1360870528923,1291899875,1291911011,11136
1360870783,1292164864,1,52,52,1360870754806,1360870754806,1292136670,1292136670,0
1360870891,1292273056,1,46,46,1360870864883,1360870864883,1292246939,1292246939,0
1360870899,1292281016,2,92,46,1360870872475,1360870872731,1292254491,1292254747,256
1360870903,1292284972,2,92,46,1360870878473,1360870878793,1292260445,1292260765,320
1360870935,1292316980,3,408,136,1360870909759,1360870915839,1292291739,1292297819,6080
1360871548,1292929724,3,408,136,1360871521079,1360871527159,1292902803,1292908883,6080
1360871620,1293002472,16,6709,419.3125,1360871607752,1360871619784,1292990224,1293002256,12032
1360871620,1293002472,14,3460,247.1428571,1360871603719,1360871612167,1292986191,1292994639,8448
1360871620,1293002476,12,999,83.25,1360871608132,1360871619844,1292990608,1293002320,11712
1360871620,1293002480,12,999,83.25,1360871608385,1360871619841,1292990865,1293002321,11456
1360871621,1293002556,11,953,86.63636364,1360871609628,1360871620764,1292991184,1293002320,11136
1360871648,1293029828,1,46,46,1360871620555,1360871620555,1293002383,1293002383,0
1360871668,1293050044,11,3267,297,1360871642740,1360871643380,1293024784,1293025424,640
1360871917,1293299092,3,230,76.66666667,1360871913986,1360871914242,1293296078,1293296334,256
1360871941,1293322848,14,6617,472.6428571,1360871916723,1360871917043,1293298571,1293298891,320
1360871941,1293322884,11,3267,297,1360871913680,1360871914320,1293295564,1293296204,640
1360871945,1293326768,8,815,101.875,1360871917189,1360871917381,1293298957,1293299149,192
1360871945,1293326776,9,861,95.66666667,1360871917500,1360871917628,1293299276,1293299404,128
1360871945,1293326892,8,815,101.875,1360871917639,1360871917831,1293299531,1293299723,192
1360871973,1293355124,3,138,46,1360871967389,1360871967453,1293349513,1293349577,64
1360871973,1293355128,3,138,46,1360871967389,1360871967453,1293349517,1293349581,64
1360871973,1293355128,3,138,46,1360871967388,1360871967516,1293349516,1293349644,128
1360871973,1293355180,3,138,46,1360871967337,1360871967465,1293349517,1293349645,128
1360871997,1293379188,3,193,64.33333333,1360871989215,1360871989215,1293371403,1293371403,0
1360872085,1293467460,1,48,48,1360872058958,1360872058958,1293441418,1293441418,0
1360872158,1293539748,3,408,136,1360872132373,1360872138389,1293514121,1293520137,6016
1360872771,1294152860,3,408,136,1360872743387,1360872749339,1294125247,1294131199,5952
1360872831,1294212804,8,815,101.875,1360872803603,1360872803795,1294185407,1294185599,192
1360872831,1294212804,9,861,95.66666667,1360872803857,1360872804049,1294185661,1294185853,192
1360872831,1294212828,9,861,95.66666667,1360872804091,1360872804283,1294185919,1294186111,192
1360873031,1294412588,4,252,63,1360873023016,1360873030056,1294404604,1294411644,7040
1360873055,1294437164,8,815,101.875,1360873030824,1360873031016,1294412988,1294413180,192
1360873055,1294437172,8,815,101.875,1360873030560,1360873030752,1294412732,1294412924,192
1360873059,1294441148,8,815,101.875,1360873031157,1360873031285,1294413305,1294413433,128
1360873059,1294441152,9,861,95.66666667,1360873031411,1360873031539,1294413563,1294413691,128
1360873063,1294445336,1,63,63,1360873037371,1360873037371,1294419707,1294419707,0
1360873119,1294500836,3,189,63,1360873112941,1360873116013,1294494777,1294497849,3072
1360873135,1294516856,2,126,63,1360873120026,1360873128026,1294501882,1294509882,8000
1360873143,1294524956,3,189,63,1360873137078,1360873140086,1294519034,1294522042,3008
1360873159,1294540952,2,126,63,1360873144122,1360873152186,1294526074,1294534138,8064
1360873247,1294629140,3,189,63,1360873242746,1360873245754,1294624886,1294627894,3008
1360873263,1294645076,2,126,63,1360873249850,1360873257914,1294631926,1294639990,8064
1360873279,1294661084,4,252,63,1360873270003,1360873277043,1294652087,1294659127,7040
1360873279,1294661084,4,252,63,1360873270067,1360873277171,1294652151,1294659255,7104
1360873312,1294693492,1,63,63,1360873285701,1360873285701,1294667193,1294667193,0
1360873312,1294693492,1,63,63,1360873285764,1360873285764,1294667256,1294667256,0
1360873335,1294717168,3,189,63,1360873330845,1360873333853,1294713013,1294716021,3008
1360873351,1294733112,2,126,63,1360873337943,1360873346007,1294720055,1294728119,8064
1360873428,1294809892,3,408,136,1360873401714,1360873407730,1294783606,1294789622,6016
1360873721,1295102804,1,46,46,1360873694086,1360873694086,1295075890,1295075890,0
1360874037,1295419100,3,408,136,1360874012438,1360874018518,1295394538,1295400618,6080
1360874386,1295767476,1,46,46,1360874358658,1360874358658,1295740134,1295740134,0
1360874490,1295871524,2,122,61,1360874462225,1360874464465,1295843749,1295845989,2240
1360874608,1295990028,12,999,83.25,1360874594839,1360874603863,1295976867,1295985891,9024
1360874608,1295990052,18,6977,387.6111111,1360874593533,1360874603773,1295975585,1295985825,10240
1360874608,1295990096,17,6755,397.3529412,1360874593875,1360874603859,1295975971,1295985955,9984
1360874608,1295990100,12,999,83.25,1360874594255,1360874603791,1295976355,1295985891,9536
1360874608,1295990104,11,953,86.63636364,1360874594508,1360874603788,1295976612,1295985892,9280
1360874650,1296032052,3,408,136,1360874623679,1360874629695,1296005731,1296011747,6016
1360875259,1296641092,3,408,136,1360875234701,1360875240781,1296616793,1296622873,6080
1360875873,1297254864,3,408,136,1360875846312,1360875852328,1297228176,1297234192,6016
1360876185,1297567140,9,861,95.66666667,1360876158095,1360876158287,1297540235,1297540427,192
1360876185,1297567144,8,815,101.875,1360876158412,1360876158540,1297540556,1297540684,128
1360876185,1297567244,9,861,95.66666667,1360876157735,1360876157927,1297539979,1297540171,192
1360876418,1297799952,4,252,63,1360876410376,1360876417416,1297792328,1297799368,7040
1360876450,1297831860,1,63,63,1360876425570,1360876425570,1297807430,1297807430,0
1360876482,1297864076,3,408,136,1360876456585,1360876462601,1297838661,1297844677,6016
1360876482,1297864332,4,252,63,1360876473544,1360876480584,1297855876,1297862916,7040
1360876482,1297864492,4,252,63,1360876473387,1360876480427,1297855879,1297862919,7040
1360876514,1297896268,1,63,63,1360876488711,1360876488711,1297870979,1297870979,0
1360876514,1297896268,1,63,63,1360876488714,1360876488714,1297870982,1297870982,0
1360876538,1297920168,8,815,101.875,1360876512365,1360876512493,1297894533,1297894661,128
1360876538,1297920272,8,815,101.875,1360876512003,1360876512131,1297894275,1297894403,128
1360876538,1297920280,8,815,101.875,1360876512508,1360876512700,1297894788,1297894980,192
1360876550,1297932252,14,6617,472.6428571,1360876524247,1360876524567,1297906499,1297906819,320
1360876550,1297932260,9,861,95.66666667,1360876524625,1360876524817,1297906885,1297907077,192
1360876550,1297932292,9,861,95.66666667,1360876525169,1360876525297,1297907461,1297907589,128
1360876550,1297932376,8,815,101.875,1360876524763,1360876524955,1297907139,1297907331,192
1360876615,1297996652,1,46,46,1360876586737,1360876586737,1297968389,1297968389,0
1360876739,1298121164,3,189,63,1360876732588,1360876735596,1298114752,1298117760,3008
1360876755,1298137168,2,126,63,1360876739625,1360876747689,1298121793,1298129857,8064
1360876755,1298137252,2,126,63,1360876752150,1360876753174,1298134402,1298135426,1024
1360876763,1298145128,2,126,63,1360876759761,1360876760785,1298141889,1298142913,1024
1360876763,1298145196,2,126,63,1360876755278,1360876759246,1298137474,1298141442,3968
1360876763,1298145200,3,189,63,1360876759435,1360876762443,1298141635,1298144643,3008
1360876771,1298153240,2,126,63,1360876762655,1360876766687,1298144895,1298148927,4032
1360876779,1298161268,3,189,63,1360876772422,1360876775430,1298154690,1298157698,3008
1360876779,1298161268,3,189,63,1360876772422,1360876775430,1298154690,1298157698,3008
1360876779,1298161300,2,126,63,1360876766371,1360876774435,1298148671,1298156735,8064
1360876795,1298177068,1,63,63,1360876767438,1360876767438,1298149506,1298149506,0
1360876795,1298177184,2,126,63,1360876779545,1360876787609,1298161729,1298169793,8064
1360876795,1298177184,2,126,63,1360876779545,1360876787609,1298161729,1298169793,8064
1360876803,1298185128,1,63,63,1360876774863,1360876774863,1298156991,1298156991,0
1360876819,1298201360,3,189,63,1360876811946,1360876815018,1298194306,1298197378,3072
1360876835,1298217352,2,126,63,1360876819055,1360876827055,1298201407,1298209407,8000
1360876843,1298225172,1,46,46,1360876816804,1360876816804,1298198976,1298198976,0
1360877096,1298477848,3,408,136,1360877068259,1360877074275,1298450107,1298456123,6016
1360877248,1298630356,1,46,46,1360877222247,1360877222247,1298604603,1298604603,0
1360877381,1298762524,11,3267,297,1360877355940,1360877356516,1298737464,1298738040,576
1360877449,1298830580,1,46,46,1360877423020,1360877423020,1298804600,1298804600,0
1360877449,1298830580,1,46,46,1360877423018,1360877423018,1298804598,1298804598,0
1360877449,1298830580,1,46,46,1360877423018,1360877423018,1298804598,1298804598,0
1360877449,1298830696,1,46,46,1360877422901,1360877422901,1298804597,1298804597,0
1360877449,1298830696,1,46,46,1360877422901,1360877422901,1298804597,1298804597,0
1360877449,1298830696,1,46,46,1360877422901,1360877422901,1298804597,1298804597,0
1360877449,1298830696,1,46,46,1360877422904,1360877422904,1298804600,1298804600,0
1360877449,1298830696,1,46,46,1360877422904,1360877422904,1298804600,1298804600,0
1360877614,1298995888,1,46,46,1360877585717,1360877585717,1298967605,1298967605,0
1360877615,1298996912,1,46,46,1360877585629,1360877585629,1298967541,1298967541,0
1360877705,1299086828,3,408,136,1360877678512,1360877684592,1299060340,1299066420,6080
1360878054,1299435592,1,435,435,1360878029525,1360878029525,1299411117,1299411117,0
1360878058,1299439548,1,434,434,1360878031297,1360878031297,1299412845,1299412845,0
1360878062,1299444160,2,141,70.5,1360878061085,1360878061085,1299443245,1299443245,0
1360878086,1299467636,11,3267,297,1360878061160,1360878061736,1299442796,1299443372,576
1360878318,1299699548,3,408,136,1360878290110,1360878296126,1299671658,1299677674,6016
1360878362,1299743620,1,48,48,1360878334516,1360878334516,1299716136,1299716136,0
1360878370,1299751676,1,46,46,1360878343740,1360878343740,1299725416,1299725416,0
1360878430,1299811784,1,46,46,1360878403214,1360878403214,1299784998,1299784998,0
1360878750,1300132368,3,405,135,1360878724098,1360878730114,1300106466,1300112482,6016
1360878782,1300164380,11,3267,297,1360878756341,1360878756917,1300138721,1300139297,576
1360878782,1300164408,2,141,70.5,1360878756827,1360878756827,1300139235,1300139235,0
1360879080,1300461504,6,497,82.83333333,1360879072156,1360879075932,1300453660,1300457436,3776
1360879103,1300484860,11,3267,297,1360879076921,1360879077561,1300458781,1300459421,640
1360879107,1300488924,1,89,89,1360879079608,1360879079608,1300461532,1300461532,0
1360879183,1300565020,12,6151,512.5833333,1360879158617,1360879159001,1300540637,1300541021,384
1360879187,1300568960,8,815,101.875,1360879159125,1360879159317,1300541085,1300541277,192
1360879187,1300568964,9,861,95.66666667,1360879159376,1360879159568,1300541340,1300541532,192
1360879187,1300569072,8,815,101.875,1360879159524,1360879159780,1300541596,1300541852,256
1360879392,1300773872,2,126,63,1360879384041,1360879385001,1300765913,1300766873,960
1360879392,1300773876,2,126,63,1360879384163,1360879385187,1300766039,1300767063,1024
1360879400,1300782088,17,6755,397.3529412,1360879385615,1360879397775,1300767703,1300779863,12160
1360879400,1300782092,12,999,83.25,1360879385995,1360879397771,1300768087,1300779863,11776
1360879400,1300782116,11,953,86.63636364,1360879386485,1360879397749,1300768601,1300779865,11264
1360879400,1300782120,11,953,86.63636364,1360879386738,1360879397682,1300768858,1300779802,10944
1360879440,1300822008,2,141,70.5,1360879435682,1360879435682,1300817690,1300817690,0
1360879456,1300837672,1,63,63,1360879429616,1360879429616,1300811288,1300811288,0
1360879456,1300837672,1,63,63,1360879429615,1360879429615,1300811287,1300811287,0
1360879460,1300841748,11,3267,297,1360879435491,1360879436003,1300817239,1300817751,512
1360879712,1301094244,11,953,86.63636364,1360879699505,1360879710897,1301081749,1301093141,11392
1360879712,1301094320,11,953,86.63636364,1360879699749,1360879711781,1301082069,1301094101,12032
1360879713,1301094660,17,6418,377.5294118,1360879699449,1360879712505,1301081109,1301094165,13056
1360879713,1301094660,12,999,83.25,1360879699831,1360879712503,1301081491,1301094163,12672
1360879740,1301121932,2,92,46,1360879712615,1360879712615,1301094547,1301094547,0
1360879740,1301121932,2,92,46,1360879712615,1360879712615,1301094547,1301094547,0
1360879740,1301122016,3,138,46,1360879712085,1360879712533,1301094101,1301094549,448
1360879740,1301122040,2,92,46,1360879712505,1360879712505,1301094545,1301094545,0
1360880021,1301403056,3,408,136,1360879996454,1360880002470,1301378510,1301384526,6016
1360880037,1301419044,13,6234,479.5384615,1360880010611,1360880010931,1301392655,1301392975,320
1360880037,1301419136,9,861,95.66666667,1360880010904,1360880011096,1301393040,1301393232,192
1360880037,1301419136,8,815,101.875,1360880011157,1360880011349,1301393293,1301393485,192
1360880037,1301419164,9,861,95.66666667,1360880011389,1360880011581,1301393553,1301393745,192
1360880225,1301607060,4,184,46,1360880222369,1360880222433,1301604429,1301604493,64
1360880225,1301607060,4,184,46,1360880222369,1360880222433,1301604429,1301604493,64
1360880225,1301607060,4,184,46,1360880222368,1360880222432,1301604428,1301604492,64
1360880225,1301607136,4,184,46,1360880222290,1360880222354,1301604426,1301604490,64
1360880233,1301615140,2,141,70.5,1360880227920,1360880227920,1301610060,1301610060,0
1360880246,1301627792,3,402,134,1360880221356,1360880227436,1301603148,1301609228,6080
1360880254,1301635672,11,3267,297,1360880227812,1360880228452,1301609484,1301610124,640
1360880329,1301711284,2,141,70.5,1360880327870,1360880327870,1301710154,1301710154,0
1360880345,1301727152,17,6755,397.3529412,1360880326912,1360880339008,1301709064,1301721160,12096
1360880345,1301727188,12,999,83.25,1360880327838,1360880338974,1301710026,1301721162,11136
1360880345,1301727252,11,953,86.63636364,1360880327196,1360880338908,1301709448,1301721160,11712
1360880345,1301727256,12,999,83.25,1360880327515,1360880338907,1301709771,1301721163,11392
1360880350,1301731812,9,3163,351.4444444,1360880324245,1360880328469,1301706057,1301710281,4224
1360880370,1301751908,1,46,46,1360880345396,1360880345396,1301727304,1301727304,0
1360880642,1302023716,5,408,81.6,1360880638321,1360880640241,1302020037,1302021957,1920
1360880666,1302047684,11,953,86.63636364,1360880650447,1360880659151,1302032131,1302040835,8704
1360880666,1302047688,12,999,83.25,1360880649934,1360880659150,1302031622,1302040838,9216
1360880666,1302047692,12,999,83.25,1360880650185,1360880659145,1302031877,1302040837,8960
1360880666,1302048176,11,3267,297,1360880641702,1360880642342,1302023878,1302024518,640
1360880670,1302052128,1,89,89,1360880642003,1360880642003,1302024131,1302024131,0
1360880983,1302364756,14,6280,448.5714286,1360880955077,1360880955333,1302336833,1302337089,256
1360880983,1302364760,9,861,95.66666667,1360880955456,1360880955648,1302337216,1302337408,192
1360880983,1302364764,9,861,95.66666667,1360880955962,1360880956154,1302337726,1302337918,192
1360880983,1302364852,9,861,95.66666667,1360880955620,1360880955812,1302337472,1302337664,192
1360881179,1302560572,4,218,54.5,1360881175032,1360881177592,1302556604,1302559164,2560
1360881179,1302560616,3,138,46,1360881177548,1360881177612,1302559164,1302559228,64
1360881179,1302560620,3,138,46,1360881177546,1360881177610,1302559166,1302559230,64
1360881187,1302568548,2,141,70.5,1360881181777,1360881181777,1302563325,1302563325,0
1360881204,1302585680,2,109,54.5,1360881177484,1360881177484,1302559164,1302559164,0
1360881208,1302589676,11,3267,297,1360881181138,1360881181714,1302562814,1302563390,576
1360881212,1302593584,9,861,95.66666667,1360881185261,1360881185453,1302566845,1302567037,192
1360881212,1302593588,8,815,101.875,1360881185768,1360881185960,1302567356,1302567548,192
1360881212,1302593588,9,861,95.66666667,1360881185511,1360881185703,1302567099,1302567291,192
1360881212,1302593700,8,815,101.875,1360881185978,1360881186106,1302567678,1302567806,128
1360881267,1302648616,2,141,70.5,1360881265356,1360881265356,1302646972,1302646972,0
1360881292,1302673660,9,861,95.66666667,1360881266782,1360881266974,1302648442,1302648634,192
1360881292,1302673752,9,861,95.66666667,1360881266948,1360881267140,1302648700,1302648892,192
1360881292,1302673784,8,815,101.875,1360881267173,1360881267365,1302648957,1302649149,192
1360881292,1302673832,13,6234,479.5384615,1360881266228,1360881266548,1302648060,1302648380,320
1360881459,1302840728,4,218,54.5,1360881451673,1360881455833,1302833401,1302837561,4160
1360881459,1302840772,3,138,46,1360881455786,1360881455850,1302837558,1302837622,64
1360881480,1302862220,3,155,51.66666667,1360881453933,1360881455405,1302836153,1302837625,1472
1360881480,1302862340,2,109,54.5,1360881455218,1360881455218,1302837558,1302837558,0
1360881488,1302870228,1,63,63,1360881461733,1360881461733,1302843961,1302843961,0
1360881488,1302870312,1,63,63,1360881461648,1360881461648,1302843960,1302843960,0
1360881488,1302870316,1,63,63,1360881462155,1360881462155,1302844471,1302844471,0
1360881523,1302904776,3,189,63,1360881516199,1360881519271,1302897975,1302901047,3072
1360881539,1302920660,2,126,63,1360881523418,1360881531482,1302905078,1302913142,8064
1360881818,1303199520,3,408,136,1360881792100,1360881798180,1303173620,1303179700,6080
1360882179,1303560560,9,861,95.66666667,1360882154612,1360882154740,1303536172,1303536300,128
1360882183,1303564568,9,861,95.66666667,1360882154923,1360882155051,1303536491,1303536619,128
1360882387,1303769312,3,189,63,1360882383361,1360882386369,1303765673,1303768681,3008
1360882403,1303785392,2,126,63,1360882390322,1360882398386,1303772714,1303780778,8064
1360882436,1303817600,2,92,46,1360882433609,1360882433609,1303815209,1303815209,0
1360882459,1303841384,8,815,101.875,1360882434553,1360882434745,1303816937,1303817129,192
1360882459,1303841388,8,815,101.875,1360882434806,1360882434998,1303817194,1303817386,192
1360882459,1303841424,3,155,51.66666667,1360882432336,1360882432784,1303814760,1303815208,448
1360882463,1303845304,8,815,101.875,1360882435142,1360882435334,1303817446,1303817638,192
1360882463,1303845388,8,815,101.875,1360882435318,1360882435510,1303817706,1303817898,192
1360882652,1304033968,3,408,136,1360882626006,1360882632022,1304007974,1304013990,6016
1360882668,1304050028,3,189,63,1360882664664,1360882667672,1304046692,1304049700,3008
1360882676,1304058032,3,189,63,1360882669651,1360882672659,1304051683,1304054691,3008
1360882684,1304066120,2,126,63,1360882671614,1360882679678,1304053734,1304061798,8064
1360882692,1304074064,2,126,63,1360882676660,1360882684724,1304058724,1304066788,8064
1360882756,1304138296,3,189,63,1360882752012,1360882755020,1304134308,1304137316,3008
1360882772,1304154320,2,126,63,1360882759026,1360882767090,1304141346,1304149410,8064
1360882804,1304186324,3,189,63,1360882796911,1360882799919,1304179235,1304182243,3008
1360882820,1304202352,2,126,63,1360882803923,1360882811987,1304186275,1304194339,8064
1360883265,1304646972,3,408,136,1360883237128,1360883243208,1304619100,1304625180,6080
1360883778,1305160396,1,46,46,1360883751385,1360883751385,1305133781,1305133781,0
1360883875,1305256836,3,408,136,1360883848456,1360883854536,1305230292,1305236372,6080
1360883975,1305356876,14,6617,472.6428571,1360883948700,1360883949020,1305330576,1305330896,320
1360883975,1305356884,9,861,95.66666667,1360883949076,1360883949268,1305330960,1305331152,192
1360883975,1305356908,8,815,101.875,1360883949884,1360883950012,1305331792,1305331920,128
1360883975,1305356964,14,6617,472.6428571,1360883949380,1360883949700,1305331344,1305331664,320
1360884262,1305644112,2,126,63,1360884260459,1360884261483,1305642571,1305643595,1024
1360884263,1305645292,3,402,134,1360884236536,1360884242616,1305618828,1305624908,6080
1360884270,1305652084,2,126,63,1360884263561,1360884267593,1305645645,1305649677,4032
1360884303,1305685368,1,63,63,1360884275374,1360884275374,1305657742,1305657742,0
1360884366,1305748104,3,189,63,1360884359089,1360884362097,1305741193,1305744201,3008
1360884374,1305756128,4,252,63,1360884365724,1360884372764,1305747852,1305754892,7040
1360884374,1305756128,4,252,63,1360884365723,1360884372827,1305747851,1305754955,7104
1360884382,1305764112,2,126,63,1360884366124,1360884374188,1305748236,1305756300,8064
1360884408,1305789692,1,63,63,1360884381263,1360884381263,1305762955,1305762955,0
1360884408,1305789700,1,63,63,1360884381255,1360884381255,1305762955,1305762955,0
1360885069,1306451004,1,48,48,1360885044621,1360885044621,1306426625,1306426625,0
1360885370,1306751848,2,230,115,1360885343778,1360885343778,1306725626,1306725626,0
1360885526,1306908428,3,402,134,1360885499549,1360885505565,1306881977,1306887993,6016
1360885534,1306916268,9,861,95.66666667,1360885509118,1360885509310,1306891386,1306891578,192
1360885534,1306916352,8,815,101.875,1360885509290,1360885509482,1306891642,1306891834,192
1360885591,4240253040,1,46,46,1360885564879,1360885564879,4240226919,4240226919,0
1360885763,1307144552,9,861,95.66666667,1360885737860,1360885738052,1307119412,1307119604,192
1360885763,1307144628,14,6617,472.6428571,1360885737147,1360885737467,1307118775,1307119095,320
1360885763,1307144628,8,815,101.875,1360885737528,1360885737720,1307119156,1307119348,192
1360885763,1307144632,8,815,101.875,1360885738100,1360885738228,1307119732,1307119860,128
1360885767,1307149252,3,189,63,1360885763787,1360885766859,1307146039,1307149111,3072
1360885767,1307149252,3,189,63,1360885763723,1360885766795,1307145975,1307149047,3072
1360885783,1307165152,2,126,63,1360885770926,1360885778990,1307153078,1307161142,8064
1360885783,1307165196,2,126,63,1360885770880,1360885778880,1307153076,1307161076,8000
1360886039,1307421312,4,252,63,1360886031048,1360886038088,1307413360,1307420400,7040
1360886039,1307421364,4,252,63,1360886030995,1360886038035,1307413359,1307420399,7040
1360886071,1307453072,1,63,63,1360886046393,1360886046393,1307428465,1307428465,0
1360886071,1307453148,1,63,63,1360886046317,1360886046317,1307428465,1307428465,0
1360886079,1307461344,3,189,63,1360886073767,1360886076839,1307456111,1307459183,3072
1360886079,1307461412,3,189,63,1360886073763,1360886076771,1307456175,1307459183,3008
1360886095,1307477388,2,126,63,1360886080829,1360886088829,1307463217,1307471217,8000
1360886095,1307477388,2,126,63,1360886080828,1360886088892,1307463216,1307471280,8064
1360886404,1307785444,1,48,48,1360886377704,1360886377704,1307759148,1307759148,0
1360886809,1308190560,1,56,56,1360886783598,1360886783598,1308165158,1308165158,0
1360887138,1308519580,3,408,136,1360887110806,1360887116886,1308492386,1308498466,6080
1360887305,1308686960,2,92,46,1360887300438,1360887300438,1308682398,1308682398,0
1360887305,1308687028,2,92,46,1360887300369,1360887300369,1308682397,1308682397,0
1360887305,1308687028,2,92,46,1360887300432,1360887300432,1308682460,1308682460,0
1360887305,1308687028,2,92,46,1360887300432,1360887300432,1308682460,1308682460,0
1360887326,1308708220,13,6234,479.5384615,1360887301203,1360887301523,1308683423,1308683743,320
1360887326,1308708224,9,861,95.66666667,1360887301647,1360887301839,1308683871,1308684063,192
1360887330,1308712172,9,861,95.66666667,1360887301954,1360887302146,1308684126,1308684318,192
1360887330,1308712176,9,861,95.66666667,1360887302206,1360887302398,1308684382,1308684574,192
1360887390,1308772344,3,180,60,1360887365270,1360887374294,1308747614,1308756638,9024
1360887545,1308927156,3,189,63,1360887540943,1360887544015,1308923099,1308926171,3072
1360887561,1308943176,2,126,63,1360887547961,1360887556025,1308930137,1308938201,8064
1360887567,1308948908,1,48,48,1360887542340,1360887542340,1308924248,1308924248,0
1360887617,1308999196,2,126,63,1360887615844,1360887616868,1308998040,1308999064,1024
1360887617,1308999232,2,126,63,1360887614785,1360887615809,1308997017,1308998041,1024
1360887625,1309007176,2,126,63,1360887618875,1360887622907,1309001051,1309005083,4032
1360887625,1309007188,2,126,63,1360887617838,1360887621870,1309000026,1309004058,4032
1360887655,1309037096,1,63,63,1360887630023,1360887630023,1309012119,1309012119,0
1360887659,1309041040,1,63,63,1360887631104,1360887631104,1309013144,1309013144,0
1360887665,1309047208,2,126,63,1360887662232,1360887663256,1309044440,1309045464,1024
1360887673,1309055296,2,126,63,1360887665154,1360887669186,1309047450,1309051482,4032
1360887703,1309085100,1,63,63,1360887677445,1360887677445,1309059545,1309059545,0
1360887872,1309253560,1,48,48,1360887847711,1360887847711,1309229271,1309229271,0
1360887893,1309274892,1,48,48,1360887864529,1360887864529,1309246421,1309246421,0
1360887894,1309276184,1,48,48,1360887864302,1360887864302,1309246486,1309246486,0
1360887900,1309281532,3,408,136,1360887874103,1360887880119,1309255635,1309261651,6016
1360888181,1309562540,1,60,60,1360888154155,1360888154155,1309535695,1309535695,0
1360888185,1309566540,1,60,60,1360888157676,1360888157676,1309539216,1309539216,0
1360888417,1309799040,1,46,46,1360888391093,1360888391093,1309773133,1309773133,0
1360888425,1309806940,3,402,134,1360888399063,1360888405079,1309781003,1309787019,6016
1360888425,1309806952,1,52,52,1360888400461,1360888400461,1309782413,1309782413,0
1360888605,1309987116,1,46,46,1360888579622,1360888579622,1309961738,1309961738,0
1360888605,1309987196,1,46,46,1360888579222,1360888579222,1309961418,1309961418,0
1360888826,1310208096,12,999,83.25,1360888813495,1360888824247,1310195591,1310206343,10752
1360888826,1310208096,12,999,83.25,1360888813749,1360888824245,1310195845,1310206341,10496
1360888826,1310208100,12,999,83.25,1360888814067,1360888824243,1310196167,1310206343,10176
1360888826,1310208136,16,6372,398.25,1360888813071,1360888824207,1310195207,1310206343,11136
1360888850,1310231684,11,3267,297,1360888825232,1360888825808,1310206916,1310207492,576
1360888978,1310360264,3,193,64.33333333,1360888970637,1360888970637,1310352901,1310352901,0
1360889038,1310419744,3,402,134,1360889013329,1360889019345,1310395073,1310401089,6016
1360889438,1310820372,1,56,56,1360889412059,1360889412059,1310794431,1310794431,0
1360889867,1311249112,1,46,46,1360889839448,1360889839448,1311221560,1311221560,0
1360890188,1311570216,1,108,108,1360890162730,1360890162730,1311544946,1311544946,0
1360890397,1311778900,3,408,136,1360890372705,1360890378721,1311754605,1311760621,6016
1360890545,1311927376,6,5023,837.1666667,1360890516870,1360890542086,1311899246,1311924462,25216
1360890594,1311975444,1,993,993,1360890567144,1360890567144,1311948588,1311948588,0
1360890621,1312003420,1,48,48,1360890595224,1360890595224,1311977644,1311977644,0
1360890645,1312027356,14,6756,482.5714286,1360890617560,1360890617880,1311999916,1312000236,320
1360890645,1312027384,12,6151,512.5833333,1360890617979,1360890618299,1312000363,1312000683,320
1360890645,1312027396,9,861,95.66666667,1360890618927,1360890619055,1312001323,1312001451,128
1360890646,1312027468,8,815,101.875,1360890619277,1360890619469,1312000745,1312000937,192
1360890646,1312027476,9,861,95.66666667,1360890619525,1360890619717,1312001001,1312001193,192
1360890775,1312157328,1,46,46,1360890747058,1360890747058,1312129386,1312129386,0
1360890775,1312157328,1,46,46,1360890747055,1360890747055,1312129383,1312129383,0
1360890868,1312250076,2,126,63,1360890866603,1360890867627,1312248679,1312249703,1024
1360890876,1312258068,4,252,63,1360890868017,1360890875057,1312250085,1312257125,7040
1360890876,1312258068,4,252,63,1360890868021,1360890875061,1312250089,1312257129,7040
1360890876,1312258124,4,252,63,1360890868348,1360890875388,1312250472,1312257512,7040
1360890876,1312258156,2,126,63,1360890869594,1360890873562,1312251750,1312255718,3968
1360890876,1312258160,2,126,63,1360890873878,1360890874838,1312256038,1312256998,960
1360890884,1312266084,2,126,63,1360890876962,1360890880994,1312259046,1312263078,4032
1360890906,1312288292,1,63,63,1360890881428,1360890881428,1312263720,1312263720,0
1360890910,1312292292,1,63,63,1360890882897,1360890882897,1312265189,1312265189,0
1360890910,1312292372,1,63,63,1360890882818,1360890882818,1312265190,1312265190,0
1360890910,1312292380,1,63,63,1360890883196,1360890883196,1312265576,1312265576,0
1360890914,1312296304,1,63,63,1360890888838,1360890888838,1312271142,1312271142,0
1360891224,1312606240,1,46,46,1360891196612,1360891196612,1312578852,1312578852,0
1360891225,1312606524,3,408,136,1360891198224,1360891204304,1312579748,1312585828,6080
1360891553,1312934660,1,46,46,1360891528384,1360891528384,1312910044,1312910044,0
1360891553,1312934660,1,46,46,1360891528383,1360891528383,1312910043,1312910043,0
1360891701,1313083360,15,6289,419.2666667,1360891688707,1360891700867,1313071067,1313083227,12160
1360891701,1313083412,12,999,83.25,1360891689551,1360891700751,1313071963,1313083163,11200
1360891701,1313083412,11,953,86.63636364,1360891690127,1360891700751,1313072539,1313083163,10624
1360891701,1313083412,12,999,83.25,1360891691214,1360891700750,1313073626,1313083162,9536
1360891718,1313100016,1,48,48,1360891690075,1360891690075,1313072091,1313072091,0
1360891719,1313101272,1,48,48,1360891689816,1360891689816,1313072088,1313072088,0
1360891725,1313106576,11,3267,297,1360891698321,1360891698961,1313079897,1313080537,640
1360891742,1313123640,3,205,68.33333333,1360891735123,1360891735507,1313116763,1313117147,384
1360891813,1313194896,11,3267,297,1360891785810,1360891786450,1313167706,1313168346,640
1360891837,1313218936,3,408,136,1360891809382,1360891815398,1313191318,1313197334,6016
1360891838,1313219708,3,193,64.33333333,1360891835982,1360891835982,1313217690,1313217690,0
1360891897,1313279060,5,250,50,1360891872363,1360891894251,1313254423,1313276311,21888
1360892255,1313636604,1,48,48,1360892229038,1360892229038,1313610642,1313610642,0
1360892447,1313828980,3,408,136,1360892420467,1360892426483,1313802447,1313808463,6016
1360892541,4247202952,5,573,114.6,1360892538323,1360892538387,4247200275,4247200339,64
1360892647,1314029112,1,56,56,1360892622317,1360892622317,1314004429,1314004429,0
1360892655,1314037104,1,56,56,1360892630838,1360892630838,1314012942,1314012942,0
1360892972,1314353752,5,250,50,1360892947663,1360892969679,1314329415,1314351431,22016
1360893020,1314401848,1,48,48,1360892993646,1360892993646,1314375494,1314375494,0
1360893048,1314429824,1,48,48,1360893022789,1360893022789,1314404613,1314404613,0
1360893060,1314441904,3,408,136,1360893031989,1360893038005,1314413893,1314419909,6016
1360893529,1314910488,9,861,95.66666667,1360893501902,1360893502094,1314883390,1314883582,192
1360893529,1314910568,12,6151,512.5833333,1360893501118,1360893501438,1314882686,1314883006,320
1360893529,1314910596,9,861,95.66666667,1360893501538,1360893501666,1314883134,1314883262,128
1360893529,1314910604,8,815,101.875,1360893502044,1360893502236,1314883648,1314883840,192
1360893573,1314954676,1,60,60,1360893547219,1360893547219,1314928895,1314928895,0
1360893577,1314958684,1,60,60,1360893552075,1360893552075,1314933759,1314933759,0
1360893669,1315050736,3,408,136,1360893643222,1360893649238,1315024958,1315030974,6016
1360893677,1315058780,1,46,46,1360893652134,1360893652134,1315033914,1315033914,0
1360893729,1315111068,3,189,63,1360893723079,1360893726087,1315105147,1315108155,3008
1360893745,1315127136,2,126,63,1360893730053,1360893738117,1315112189,1315120253,8064
1360893761,1315143104,3,189,63,1360893755747,1360893758819,1315137851,1315140923,3072
1360893761,1315143176,3,189,63,1360893755676,1360893758748,1315137852,1315140924,3072
1360893777,1315159108,2,126,63,1360893762846,1360893770846,1315144954,1315152954,8000
1360893777,1315159176,2,126,63,1360893762713,1360893770777,1315144889,1315152953,8064
1360893809,1315191184,4,252,63,1360893799890,1360893806994,1315182074,1315189178,7104
1360893841,1315222948,1,63,63,1360893815293,1360893815293,1315197241,1315197241,0
1360894025,1315407184,1,48,48,1360893997134,1360893997134,1315379318,1315379318,0
1360894065,1315447368,1,48,48,1360894038808,1360894038808,1315421176,1315421176,0
1360894282,1315663696,3,408,136,1360894254963,1360894260979,1315636659,1315642675,6016
1360894482,1315864008,1,46,46,1360894456504,1360894456504,1315838512,1315838512,0
1360894639,1316020528,14,6617,472.6428571,1360894614420,1360894614740,1315995948,1315996268,320
1360894642,1316024352,9,861,95.66666667,1360894614044,1360894614172,1315996396,1315996524,128
1360894642,1316024360,9,861,95.66666667,1360894614549,1360894614677,1315996909,1315997037,128
1360894643,1316024444,9,861,95.66666667,1360894615211,1360894615339,1315996655,1315996783,128
1360894687,1316068592,3,402,134,1360894661845,1360894667925,1316043437,1316049517,6080
1360894723,1316104988,1,46,46,1360894697801,1360894697801,1316079789,1316079789,0
1360894827,1316209200,2,126,63,1360894825074,1360894826098,1316207274,1316208298,1024
1360894835,1316217156,2,126,63,1360894828125,1360894832157,1316210281,1316214313,4032
1360894851,1316233244,3,189,63,1360894845765,1360894848773,1316228009,1316231017,3008
1360894851,1316233248,3,189,63,1360894846080,1360894849088,1316228328,1316231336,3008
1360894868,1316249416,1,63,63,1360894840960,1360894840960,1316222376,1316222376,0
1360894868,1316249544,2,126,63,1360894853504,1360894861568,1316235048,1316243112,8064
1360894868,1316249604,2,126,63,1360894853765,1360894861765,1316235369,1316243369,8000
1360894908,1316289516,4,252,63,1360894900637,1360894907677,1316282153,1316289193,7040
1360894943,1316325212,1,63,63,1360894914981,1360894914981,1316297193,1316297193,0
1360895276,1316657816,1,46,46,1360895248748,1360895248748,1316630564,1316630564,0
1360895350,4250012304,1,46,46,1360895321544,1360895321544,4249983848,4249983848,0
1360895350,4250012304,1,46,46,1360895321606,1360895321606,4249983910,4249983910,0
1360895529,1316910524,8,815,101.875,1360895504395,1360895504523,1316885919,1316886047,128
1360895529,1316910528,9,861,95.66666667,1360895504646,1360895504838,1316886174,1316886366,192
1360895725,1317107228,3,189,63,1360895720331,1360895723339,1317102559,1317105567,3008
1360895733,1317115200,4,201,50.25,1360895726820,1360895726884,1317109020,1317109084,64
1360895733,1317115200,3,138,46,1360895726820,1360895726884,1317109020,1317109084,64
1360895757,1317139016,8,815,101.875,1360895731037,1360895731229,1317113053,1317113245,192
1360895757,1317139016,9,861,95.66666667,1360895731292,1360895731484,1317113308,1317113500,192
1360895757,1317139020,9,861,95.66666667,1360895731543,1360895731735,1317113563,1317113755,192
1360895757,1317139024,8,815,101.875,1360895731797,1360895731989,1317113821,1317114013,192
1360895817,1317199036,3,402,134,1360895790534,1360895796614,1317172570,1317178650,6080
1360895877,1317259048,1,46,46,1360895851067,1360895851067,1317233115,1317233115,0
1360895950,1317331508,4,252,63,1360895942037,1360895949141,1317323545,1317330649,7104
1360895974,1317355536,3,189,63,1360895968695,1360895971767,1317350231,1317353303,3072
1360895974,1317355580,3,189,63,1360895967052,1360895970060,1317348632,1317351640,3008
1360895981,1317363308,1,63,63,1360895956339,1360895956339,1317338647,1317338647,0
1360895989,1317371300,1,46,46,1360895962620,1360895962620,1317344920,1317344920,0
1360895990,1317371528,2,126,63,1360895975809,1360895983809,1317357337,1317365337,8000
1360895990,1317371568,2,126,63,1360895974103,1360895982167,1317355671,1317363735,8064
1360896002,1317383416,1,46,46,1360895976688,1360895976688,1317358104,1317358104,0
1360896030,1317411584,2,126,63,1360896027209,1360896028233,1317408793,1317409817,1024
1360896038,1317419560,2,126,63,1360896030241,1360896034337,1317411801,1317415897,4096
1360896069,1317451380,1,63,63,1360896041516,1360896041516,1317423896,1317423896,0
1360896251,1317633136,1,46,46,1360896225437,1360896225437,1317607573,1317607573,0
1360896251,1317633136,1,46,46,1360896225437,1360896225437,1317607573,1317607573,0
1360896359,1317740488,1,46,46,1360896333665,1360896333665,1317715153,1317715153,0
1360896727,1318109196,1,60,60,1360896698970,1360896698970,1318081166,1318081166,0
1360896735,1318117228,1,60,60,1360896707512,1360896707512,1318089740,1318089740,0
1360896964,1318345828,2,122,61,1360896937414,1360896939526,1318319242,1318321354,2112
1360897324,1318706304,14,6617,472.6428571,1360897298339,1360897298659,1318680643,1318680963,320
1360897324,1318706308,9,861,95.66666667,1360897298658,1360897298850,1318680966,1318681158,192
1360897324,1318706312,8,815,101.875,1360897299229,1360897299357,1318681541,1318681669,128
1360897324,1318706312,9,861,95.66666667,1360897298973,1360897299101,1318681285,1318681413,128
1360897377,1318758452,3,408,136,1360897352503,1360897358519,1318733955,1318739971,6016
1360897509,1318890868,1,46,46,1360897484436,1360897484436,1318866304,1318866304,0
1360897543,1318924924,3,189,63,1360897538653,1360897541661,1318920577,1318923585,3008
1360897559,1318940948,2,126,63,1360897545670,1360897553734,1318927618,1318935682,8064
1360897599,1318980896,3,189,63,1360897595447,1360897598455,1318977343,1318980351,3008
1360897599,1318980900,3,189,63,1360897595378,1360897598386,1318977278,1318980286,3008
1360897615,1318996948,2,126,63,1360897602373,1360897610437,1318984321,1318992385,8064
1360897615,1318996948,2,126,63,1360897602436,1360897610500,1318984384,1318992448,8064
1360897631,1319012884,4,252,63,1360897623812,1360897630852,1319005696,1319012736,7040
1360897665,1319047052,1,63,63,1360897638747,1360897638747,1319020799,1319020799,0
1360897761,1319143024,1,46,46,1360897735796,1360897735796,1319117820,1319117820,0
1360898006,1319387764,1,60,60,1360897980533,1360897980533,1319362297,1319362297,0
1360898010,1319391652,1,60,60,1360897982630,1360897982630,1319364282,1319364282,0
1360898138,1319520160,3,408,136,1360898113832,1360898119848,1319495992,1319502008,6016
1360898507,1319889084,1,46,46,1360898480047,1360898480047,1319862131,1319862131,0
1360898752,1320134104,3,408,136,1360898725336,1360898731352,1320107440,1320113456,6016
1360898772,1320154036,2,96,48,1360898745689,1360898752537,1320127725,1320134573,6848
1360899000,1320381992,12,999,83.25,1360898987011,1360898998723,1320369003,1320380715,11712
1360899000,1320382016,12,999,83.25,1360898987308,1360898998700,1320369324,1320380716,11392
1360899000,1320382060,16,6372,398.25,1360898986559,1360898998655,1320368619,1320380715,12096
1360899000,1320382068,12,999,83.25,1360898987511,1360898998647,1320369579,1320380715,11136
1360899049,1320430704,1,48,48,1360899023138,1360899023138,1320404842,1320404842,0
1360899409,1320791296,3,408,136,1360899383372,1360899389388,1320765668,1320771684,6016
1360899679,4254341424,1,46,46,1360899650729,1360899650729,4254313153,4254313153,0
1360899817,1321198844,12,999,83.25,1360899803913,1360899814473,1321185757,1321196317,10560
1360899817,1321198912,17,6755,397.3529412,1360899803463,1360899814407,1321185375,1321196319,10944
1360899817,1321198916,12,999,83.25,1360899804100,1360899814404,1321186016,1321196320,10304
1360899823,1321204972,1,46,46,1360899795466,1360899795466,1321177438,1321177438,0
1360899824,1321206308,1,46,46,1360899795131,1360899795131,1321177439,1321177439,0
1360900022,1321403800,3,408,136,1360899995509,1360900001525,1321377309,1321383325,6016
1360900096,1321477592,1,46,46,1360900069891,1360900069891,1321451483,1321451483,0
1360900096,1321477596,1,46,46,1360900069886,1360900069886,1321451482,1321451482,0
1360900315,1321696496,1,46,46,1360900289181,1360900289181,1321670677,1321670677,0
1360900631,1322012632,3,408,136,1360900605970,1360900611986,1321987602,1321993618,6016
1360901140,1322522132,2,96,48,1360901112789,1360901115605,1322494921,1322497737,2816
1360901221,1322602448,1,48,48,1360901193920,1360901193920,1322575368,1322575368,0
1360901245,1322626516,3,408,136,1360901217915,1360901223931,1322599431,1322605447,6016
1360901618,1322999732,42,54723,1302.928571,1360901610271,1360901610591,1322992003,1322992323,320
1360901626,1323007732,12,999,83.25,1360901611744,1360901619168,1322993476,1323000900,7424
1360901626,1323007732,11,953,86.63636364,1360901612063,1360901619167,1322993795,1323000899,7104
1360901626,1323007732,17,6755,397.3529412,1360901612318,1360901619166,1322994050,1323000898,6848
1360901626,1323007800,16,6372,398.25,1360901611226,1360901619098,1322993026,1323000898,7872
1360901630,1323011492,3,144,48,1360901603982,1360901613070,1322985474,1322994562,9088
1360901642,1323023400,1,48,48,1360901615080,1360901615080,1322996480,1322996480,0
1360901854,1323236344,3,408,136,1360901828728,1360901834744,1323211072,1323217088,6016
1360901903,1323284544,1,46,46,1360901878357,1360901878357,1323259901,1323259901,0
1360902464,1323846156,3,408,136,1360902439722,1360902445802,1323821878,1323827958,6080
1360902645,1324026692,1,78,78,1360902619893,1360902619893,1324001585,1324001585,0
1360902673,1324054856,1,78,78,1360902645843,1360902645843,1324027699,1324027699,0
1360902814,1324195456,1,48,48,1360902787937,1360902787937,1324169393,1324169393,0
1360903031,1324412572,1,46,46,1360903002474,1360903002474,1324384046,1324384046,0
1360903031,1324412588,1,46,46,1360903002394,1360903002394,1324383982,1324383982,0
1360903078,1324459832,3,408,136,1360903052132,1360903058148,1324433964,1324439980,6016
1360903126,1324508180,1,60,60,1360903100294,1360903100294,1324482474,1324482474,0
1360903134,1324516180,1,60,60,1360903108807,1360903108807,1324490987,1324490987,0
1360903186,1324568144,8,815,101.875,1360903159148,1360903159340,1324541292,1324541484,192
1360903186,1324568160,8,815,101.875,1360903159451,1360903159643,1324541611,1324541803,192
1360903186,1324568248,9,861,95.66666667,1360903158786,1360903158978,1324541034,1324541226,192
1360903443,1324825080,3,189,63,1360903439144,1360903442152,1324821224,1324824232,3008
1360903459,1324841112,2,126,63,1360903446152,1360903454216,1324828264,1324836328,8064
1360903467,1324849084,4,252,63,1360903458659,1360903465699,1324840743,1324847783,7040
1360903467,1324849084,4,252,63,1360903458722,1360903465762,1324840806,1324847846,7040
1360903475,1324856476,14,6617,472.6428571,1360903448387,1360903448899,1324829863,1324830375,512
1360903475,1324856480,8,815,101.875,1360903448959,1360903449215,1324830439,1324830695,256
1360903475,1324856660,9,861,95.66666667,1360903449160,1360903449352,1324830820,1324831012,192
1360903475,1324856660,9,861,95.66666667,1360903449484,1360903449676,1324831144,1324831336,192
1360903495,1324876608,1,46,46,1360903468734,1360903468734,1324850342,1324850342,0
1360903498,1324880560,1,63,63,1360903473287,1360903473287,1324855847,1324855847,0
1360903498,1324880564,1,63,63,1360903473346,1360903473346,1324855910,1324855910,0
1360903691,1325072908,3,408,136,1360903663183,1360903669263,1325045091,1325051171,6080
1360903707,1325089228,4,252,63,1360903699791,1360903706831,1325082019,1325089059,7040
1360903743,1325124956,1,63,63,1360903715165,1360903715165,1325097121,1325097121,0
1360903787,1325169292,3,189,63,1360903779724,1360903786764,1325162016,1325169056,7040
1360903787,1325169324,3,189,63,1360903781998,1360903785006,1325164322,1325167330,3008
1360903787,1325169336,3,189,63,1360903779683,1360903782691,1325162019,1325165027,3008
1360903803,1325185376,2,126,63,1360903788984,1360903797048,1325171360,1325179424,8064
1360904212,1325593820,1,52,52,1360904187808,1360904187808,1325569628,1325569628,0
1360904300,1325682180,3,408,136,1360904274741,1360904280757,1325656921,1325662937,6016
1360904914,1326295512,3,486,162,1360904887754,1360904893770,1326269266,1326275282,6016
1360904970,1326351532,1,56,56,1360904944435,1360904944435,1326325967,1326325967,0
1360904978,1326359552,9,861,95.66666667,1360904952864,1360904953056,1326334416,1326334608,192
1360904978,1326359628,14,6617,472.6428571,1360904952084,1360904952404,1326333712,1326334032,320
1360904978,1326359652,9,861,95.66666667,1360904952441,1360904952633,1326334093,1326334285,192
1360904978,1326359660,9,861,95.66666667,1360904953009,1360904953201,1326334669,1326334861,192
1360905002,1326383656,2,122,61,1360904976951,1360904978999,1326358607,1326360655,2048
1360905176,1326558112,1,48,48,1360905148396,1360905148396,1326530508,1326530508,0
1360905176,1326558184,1,48,48,1360905148323,1360905148323,1326530507,1326530507,0
1360905229,1326610544,3,189,63,1360905223202,1360905226210,1326604746,1326607754,3008
1360905229,1326610572,3,189,63,1360905224137,1360905227145,1326605709,1326608717,3008
1360905237,1326618580,4,252,63,1360905228158,1360905235262,1326609738,1326616842,7104
1360905245,1326626508,2,126,63,1360905231239,1360905239303,1326612747,1326620811,8064
1360905245,1326626548,2,126,63,1360905230240,1360905238240,1326611788,1326619788,8000
1360905271,1326652388,1,63,63,1360905243455,1360905243455,1326624843,1326624843,0
1360905285,1326666588,4,252,63,1360905275894,1360905282934,1326657482,1326664522,7040
1360905319,1326700444,1,63,63,1360905291141,1360905291141,1326672585,1326672585,0
1360905447,1326828856,1,48,48,1360905420648,1360905420648,1326802504,1326802504,0
1360905523,1326904992,3,486,162,1360905498077,1360905504093,1326880069,1326886085,6016
1360905819,1327201296,1,60,60,1360905791337,1360905791337,1327173633,1327173633,0
1360905823,1327205296,1,60,60,1360905795112,1360905795112,1327177408,1327177408,0
1360906136,1327518252,3,408,136,1360906108754,1360906114770,1327491006,1327497022,6016
1360906526,1327907624,16,6372,398.25,1360906514558,1360906524414,1327896182,1327906038,9856
1360906526,1327907680,11,953,86.63636364,1360906514887,1360906524359,1327896567,1327906039,9472
1360906526,1327907712,12,999,83.25,1360906515176,1360906524328,1327896888,1327906040,9152
1360906746,1328128208,3,408,136,1360906720757,1360906726773,1328102965,1328108981,6016
1360907251,1328633368,1,48,48,1360907224459,1360907224459,1328606827,1328606827,0
1360907360,1328741988,3,408,136,1360907332486,1360907338502,1328714474,1328720490,6016
1360907969,1329351336,3,408,136,1360907943200,1360907949216,1329325536,1329331552,6016
1360908138,1329519616,1,46,46,1360908111535,1360908111535,1329493151,1329493151,0
1360908338,1329720020,13,6234,479.5384615,1360908312023,1360908312343,1329694043,1329694363,320
1360908338,1329720048,9,861,95.66666667,1360908312442,1360908312570,1329694490,1329694618,128
1360908338,1329720052,9,861,95.66666667,1360908312696,1360908312824,1329694748,1329694876,128
1360908338,1329720132,8,815,101.875,1360908312871,1360908313063,1329695003,1329695195,192
1360908514,1329896224,1,48,48,1360908488265,1360908488265,1329870489,1329870489,0
1360908568,1329949680,4,252,63,1360908559530,1360908566570,1329941210,1329948250,7040
1360908582,1329964208,3,408,136,1360908554073,1360908560153,1329936281,1329942361,6080
1360908602,1329984296,1,63,63,1360908574016,1360908574016,1329956312,1329956312,0
1360908608,1329989596,2,126,63,1360908606585,1360908607545,1329988181,1329989141,960
1360908608,1329989644,2,126,63,1360908606541,1360908607565,1329988185,1329989209,1024
1360908616,1329997620,2,126,63,1360908609571,1360908613603,1329991191,1329995223,4032
1360908616,1329997680,2,126,63,1360908609509,1360908613541,1329991189,1329995221,4032
1360908646,1330028304,1,63,63,1360908620982,1360908620982,1330003286,1330003286,0
1360908647,1330028388,1,63,63,1360908621898,1360908621898,1330003286,1330003286,0
1360908656,1330037612,3,189,63,1360908651820,1360908654828,1330033432,1330036440,3008
1360908672,1330053652,2,126,63,1360908658820,1360908666884,1330040472,1330048536,8064
1360909192,1330573704,3,408,136,1360909165766,1360909171782,1330547470,1330553486,6016
1360909541,1330922892,1,46,46,1360909512772,1360909512772,1330894664,1330894664,0
1360909542,1330923728,1,46,46,1360909512936,1360909512936,1330894664,1330894664,0
1360909805,1331186592,3,408,136,1360909777711,1360909783727,1331159303,1331165319,6016
1360909881,1331263184,17,6755,397.3529412,1360909868444,1360909879132,1331250628,1331261316,10688
1360909881,1331263188,11,953,86.63636364,1360909869079,1360909879127,1331251267,1331261315,10048
1360909881,1331263232,12,999,83.25,1360909868778,1360909879082,1331251010,1331261314,10304
1360909881,1331263236,13,1045,80.38461538,1360909869350,1360909879078,1331251586,1331261314,9728
1360910414,1331795932,3,408,136,1360910388623,1360910394639,1331770555,1331776571,6016
1360910774,1332156224,1,46,46,1360910746598,1360910746598,1332128822,1332128822,0
1360911026,1332408320,3,408,136,1360910999488,1360911005504,1332381808,1332387824,6016
1360911636,1333017912,3,408,136,1360911611728,1360911617808,1332993640,1332999720,6080
1360911668,1333049504,17,6755,397.3529412,1360911654120,1360911664424,1333035624,1333045928,10304
1360911668,1333049508,11,953,86.63636364,1360911654821,1360911664421,1333036329,1333045929,9600
1360911668,1333049540,12,999,83.25,1360911654533,1360911664389,1333036073,1333045929,9856
1360911668,1333049544,12,999,83.25,1360911655106,1360911664386,1333036650,1333045930,9280
1360912249,1333631240,3,408,136,1360912223809,1360912229825,1333606049,1333612065,6016
1360912862,1334244260,3,408,136,1360912835556,1360912841572,1334217816,1334223832,6016
1360912935,1334316440,2,96,48,1360912910548,1360912913556,1334291988,1334294996,3008
1360912939,1334320444,2,96,48,1360912911312,1360912914320,1334292756,1334295764,3008
1360913119,1334500876,1,48,48,1360913091101,1360913091101,1334472977,1334472977,0
1360913247,1334629144,13,6234,479.5384615,1360913221647,1360913221967,1334603791,1334604111,320
1360913247,1334629200,9,861,95.66666667,1360913222040,1360913222232,1334604240,1334604432,192
1360913247,1334629200,9,861,95.66666667,1360913222359,1360913222487,1334604559,1334604687,128
1360913251,1334633040,9,861,95.66666667,1360913222776,1360913222968,1334604816,1334605008,192
1360913445,1334826460,3,138,46,1360913438649,1360913438713,1334820109,1334820173,64
1360913445,1334826460,3,138,46,1360913438648,1360913438712,1334820108,1334820172,64
1360913445,1334826460,3,138,46,1360913438648,1360913438712,1334820108,1334820172,64
1360913445,1334826500,3,138,46,1360913438607,1360913438671,1334820107,1334820171,64
1360913467,1334849356,13,6234,479.5384615,1360913439417,1360913439737,1334821773,1334822093,320
1360913468,1334849360,9,861,95.66666667,1360913441051,1360913441243,1334822411,1334822603,192
1360913468,1334849364,8,815,101.875,1360913441306,1360913441498,1334822670,1334822862,192
1360913468,1334849408,9,861,95.66666667,1360913440750,1360913440942,1334822158,1334822350,192
1360913476,1334857432,3,408,136,1360913448085,1360913454101,1334829517,1334835533,6016
1360913497,1334879072,1,48,48,1360913470740,1360913470740,1334852812,1334852812,0
1360913497,1334879072,1,48,48,1360913470740,1360913470740,1334852812,1334852812,0
1360913725,1335106608,3,189,63,1360913721631,1360913724639,1335103239,1335106247,3008
1360913725,1335106616,4,252,63,1360913717080,1360913724120,1335098696,1335105736,7040
1360913741,1335122608,2,126,63,1360913728671,1360913736735,1335110279,1335118343,8064
1360913756,1335137992,1,63,63,1360913731809,1360913731809,1335113801,1335113801,0
1360913781,1335162644,3,189,63,1360913774398,1360913777406,1335156042,1335159050,3008
1360913781,1335162672,3,189,63,1360913774241,1360913777249,1335155913,1335158921,3008
1360913797,1335178932,2,126,63,1360913781146,1360913789210,1335163078,1335171142,8064
1360913797,1335178944,2,126,63,1360913781070,1360913789070,1335163014,1335171014,8000
1360914085,1335466972,3,408,136,1360914058670,1360914064750,1335440642,1335446722,6080
1360914125,1335507104,17,6755,397.3529412,1360914107049,1360914119145,1335489153,1335501249,12096
1360914125,1335507104,12,999,83.25,1360914107690,1360914119146,1335489794,1335501250,11456
1360914125,1335507108,12,999,83.25,1360914107944,1360914119144,1335490052,1335501252,11200
1360914125,1335507136,12,999,83.25,1360914107401,1360914119113,1335489537,1335501249,11712
1360914635,1336016432,1,56,56,1360914607425,1360914607425,1335988857,1335988857,0
1360914639,1336020364,1,56,56,1360914610885,1360914610885,1335992249,1335992249,0
1360914699,1336080464,3,408,136,1360914671456,1360914677472,1336052920,1336058936,6016
1360914911,1336292664,1,46,46,1360914884504,1360914884504,1336266168,1336266168,0
1360915019,1336401012,9,861,95.66666667,1360914992826,1360914993018,1336374838,1336375030,192
1360915019,1336401012,9,861,95.66666667,1360914993081,1360914993273,1336375093,1336375285,192
1360915019,1336401076,13,6234,479.5384615,1360914992377,1360914992697,1336374453,1336374773,320
1360915019,1336401084,9,861,95.66666667,1360914993266,1360914993458,1336375350,1336375542,192
1360915214,1336595908,3,189,63,1360915210207,1360915213279,1336592115,1336595187,3072
1360915230,1336611880,2,126,63,1360915217337,1360915225401,1336599217,1336607281,8064
1360915254,1336635900,4,252,63,1360915246822,1360915253926,1336628722,1336635826,7104
1360915288,1336669868,1,63,63,1360915262019,1360915262019,1336643887,1336643887,0
1360915294,1336675956,3,189,63,1360915289643,1360915292651,1336671599,1336674607,3008
1360915294,1336675984,4,252,63,1360915286545,1360915293585,1336668529,1336675569,7040
1360915308,1336689964,3,408,136,1360915283044,1360915289124,1336665008,1336671088,6080
1360915310,1336691976,2,126,63,1360915296663,1360915304727,1336678639,1336686703,8064
1360915328,1336709832,1,63,63,1360915301800,1360915301800,1336683632,1336683632,0
1360915384,1336765916,1,48,48,1360915357330,1360915357330,1336739246,1336739246,0
1360915921,1337302960,3,408,136,1360915894621,1360915900637,1337276581,1337282597,6016
1360916531,1337912496,3,408,136,1360916506534,1360916512550,1337888030,1337894046,6016
1360916799,1338181280,16,6372,398.25,1360916783953,1360916793617,1338166233,1338175897,9664
1360916799,1338181280,12,999,83.25,1360916784336,1360916793616,1338166616,1338175896,9280
1360916799,1338181284,11,953,86.63636364,1360916784847,1360916793615,1338167131,1338175899,8768
1360916799,1338181292,12,999,83.25,1360916784582,1360916793606,1338166874,1338175898,9024
1360916999,1338381152,1,46,46,1360916972624,1360916972624,1338354776,1338354776,0
1360917144,1338525564,3,408,136,1360917118551,1360917124503,1338500115,1338506067,5952
1360917754,1339135376,3,408,136,1360917729805,1360917735821,1339111181,1339117197,6016
1360917950,1339331520,5,250,50,1360917922743,1360917943991,1339304263,1339325511,21248
1360917958,1339339512,1,46,46,1360917930496,1360917930496,1339312008,1339312008,0
1360917994,1339375540,1,48,48,1360917968356,1360917968356,1339349896,1339349896,0
1360918022,1339403632,1,48,48,1360917997190,1360917997190,1339378822,1339378822,0
1360918081,1339462884,1,46,46,1360918051274,1360918051274,1339433158,1339433158,0
1360918081,1339462924,1,46,46,1360918051235,1360918051235,1339433159,1339433159,0
1360918367,1339748508,3,408,136,1360918341821,1360918347837,1339723329,1339729345,6016
1360918375,1339756484,8,815,101.875,1360918348376,1360918348504,1339729860,1339729988,128
1360918375,1339756484,9,861,95.66666667,1360918348630,1360918348822,1339730114,1339730306,192
1360918375,1339756520,13,6534,502.6153846,1360918347634,1360918348978,1339729154,1339730498,1344
1360918375,1339756520,9,861,95.66666667,1360918348081,1360918348209,1339729601,1339729729,128
1360918383,1339764488,1,46,46,1360918358673,1360918358673,1339740161,1339740161,0
1360918601,1339982512,3,189,63,1360918595508,1360918598516,1339977020,1339980028,3008
1360918601,1339982520,3,189,63,1360918595246,1360918598318,1339976766,1339979838,3072
1360918617,1339998564,3,189,63,1360918612098,1360918615106,1339993662,1339996670,3008
1360918617,1339998568,2,126,63,1360918602302,1360918610302,1339983870,1339991870,8000
1360918617,1339998568,2,126,63,1360918602494,1360918610494,1339984062,1339992062,8000
1360918625,1340006528,4,252,63,1360918616679,1360918623719,1339998207,1340005247,7040
1360918633,1340014572,2,126,63,1360918619128,1360918627192,1340000700,1340008764,8064
1360918639,1340021040,1,60,60,1360918611367,1360918611367,1339993407,1339993407,0
1360918639,1340021044,2,120,60,1360918612321,1360918615329,1339994365,1339997373,3008
1360918660,1340041352,1,63,63,1360918632022,1360918632022,1340013374,1340013374,0
1360918980,1340361712,3,408,136,1360918952746,1360918958762,1340334458,1340340474,6016
1360919333,1340714616,3,144,48,1360919307971,1360919316867,1340689587,1340698483,8896
1360919361,1340742592,1,46,46,1360919335258,1360919335258,1340716850,1340716850,0
1360919585,1340967312,1,46,46,1360919556934,1360919556934,1340939246,1340939246,0
1360919589,1340971268,3,408,136,1360919562675,1360919568691,1340944943,1340950959,6016
1360919950,1341332248,5,250,50,1360919922432,1360919944768,1341304680,1341327016,22336
1360919994,1341376280,1,48,48,1360919969184,1360919969184,1341351464,1341351464,0
1360920026,1341408296,1,48,48,1360919998161,1360919998161,1341380457,1341380457,0
1360920154,1341536036,17,6755,397.3529412,1360920138898,1360920149074,1341520934,1341531110,10176
1360920154,1341536036,12,999,83.25,1360920139281,1360920149073,1341521317,1341531109,9792
1360920154,1341536040,11,953,86.63636364,1360920139791,1360920149007,1341521831,1341531047,9216
1360920154,1341536044,12,999,83.25,1360920139529,1360920149001,1341521573,1341531045,9472
1360920199,1341580784,3,408,136,1360920174543,1360920180559,1341556327,1341562343,6016
1360920591,1341973276,1,46,46,1360920566492,1360920566492,1341948768,1341948768,0
1360920591,1341973316,2,92,46,1360920566194,1360920579250,1341948510,1341961566,13056
1360920812,1342193848,3,408,136,1360920785283,1360920791299,1342167131,1342173147,6016
1360920824,1342205868,1,46,46,1360920799537,1360920799537,1342181405,1342181405,0
1360921422,1342803636,3,408,136,1360921397136,1360921403152,1342778772,1342784788,6016
1360921731,1343112556,9,861,95.66666667,1360921704346,1360921704474,1343085902,1343086030,128
1360921731,1343112556,8,815,101.875,1360921704601,1360921704729,1343086157,1343086285,128
1360921731,1343112596,8,815,101.875,1360921704820,1360921705012,1343086416,1343086608,192
1360921979,1343361132,2,109,54.5,1360921952984,1360921952984,1343335116,1343335116,0
1360921979,1343361168,2,109,54.5,1360921953011,1360921953011,1343335179,1343335179,0
1360921979,1343361168,2,109,54.5,1360921952946,1360921953010,1343335114,1343335178,64
1360921983,1343365160,9,861,95.66666667,1360921957307,1360921957563,1343339467,1343339723,256
1360921983,1343365160,8,815,101.875,1360921957881,1360921958073,1343340041,1343340233,192
1360921983,1343365160,8,815,101.875,1360921957625,1360921957817,1343339785,1343339977,192
1360921983,1343365192,9,861,95.66666667,1360921957018,1360921957146,1343339210,1343339338,128
1360922036,1343417420,3,408,136,1360922009437,1360922015517,1343390857,1343396937,6080
1360922187,1343569320,2,126,63,1360922184151,1360922185175,1343566471,1343567495,1024
1360922195,1343577312,2,126,63,1360922187168,1360922191200,1343569480,1343573512,4032
1360922228,1343609676,1,63,63,1360922199898,1360922199898,1343581574,1343581574,0
1360922236,1343617324,3,189,63,1360922231291,1360922234363,1343612615,1343615687,3072
1360922236,1343617332,3,189,63,1360922231283,1360922234291,1343612615,1343615623,3008
1360922252,1343633336,2,126,63,1360922238319,1360922246383,1343619655,1343627719,8064
1360922252,1343633336,2,126,63,1360922238383,1360922246383,1343619719,1343627719,8000
1360922284,1343665404,4,252,63,1360922276008,1360922283048,1343657412,1343664452,7040
1360922316,1343697792,1,63,63,1360922290724,1360922290724,1343672516,1343672516,0
1360922416,1343797876,2,122,61,1360922391246,1360922393678,1343773122,1343775554,2432
1360922644,1344026168,3,408,136,1360922619690,1360922625770,1344001858,1344007938,6080
1360923258,1344639344,3,408,136,1360923231830,1360923237910,1344613174,1344619254,6080
1360923500,1344882144,2,92,46,1360923495475,1360923495475,1344877619,1344877619,0
1360923500,1344882144,2,92,46,1360923495539,1360923495539,1344877683,1344877683,0
1360923500,1344882144,2,92,46,1360923495538,1360923495538,1344877682,1344877682,0
1360923500,1344882156,2,92,46,1360923495592,1360923495592,1344877748,1344877748,0
1360923522,1344903632,9,861,95.66666667,1360923497906,1360923498098,1344879538,1344879730,192
1360923522,1344903648,14,6617,472.6428571,1360923497251,1360923497507,1344878899,1344879155,256
1360923522,1344903648,9,861,95.66666667,1360923497634,1360923497826,1344879282,1344879474,192
1360923526,1344907672,9,861,95.66666667,1360923498186,1360923498378,1344879858,1344880050,192
1360923716,1345098236,2,126,63,1360923713557,1360923714581,1345095793,1345096817,1024
1360923716,1345098240,3,189,63,1360923710929,1360923713937,1345093169,1345096177,3008
1360923724,1345106228,2,126,63,1360923716634,1360923720666,1345098862,1345102894,4032
1360923732,1345114240,2,126,63,1360923717967,1360923726031,1345100207,1345108271,8064
1360923754,1345136124,1,63,63,1360923728772,1360923728772,1345110896,1345110896,0
1360923788,1345170272,3,189,63,1360923782637,1360923785645,1345164909,1345167917,3008
1360923804,1345186288,2,126,63,1360923789663,1360923797727,1345171951,1345180015,8064
1360923804,1345186292,3,189,63,1360923798491,1360923801499,1345180783,1345183791,3008
1360923821,1345202412,2,126,63,1360923806409,1360923814473,1345187821,1345195885,8064
1360923871,1345252448,3,408,136,1360923843046,1360923849062,1345224494,1345230510,6016
1360924375,1345757192,1,48,48,1360924349814,1360924349814,1345732006,1345732006,0
1360924480,1345861348,3,408,136,1360924454015,1360924460095,1345835363,1345841443,6080
1360925069,1346451240,12,999,83.25,1360925059194,1360925068666,1346441434,1346450906,9472
1360925069,1346451240,17,6755,397.3529412,1360925058810,1360925068730,1346441050,1346450970,9920
1360925069,1346451252,11,953,86.63636364,1360925059439,1360925068655,1346441691,1346450907,9216
1360925093,1346474572,3,408,136,1360925065239,1360925071255,1346446811,1346452827,6016
1360925101,1346482584,9,861,95.66666667,1360925076812,1360925077004,1346458396,1346458588,192
1360925105,1346486564,8,815,101.875,1360925077407,1360925077599,1346458971,1346459163,192
1360925105,1346486604,8,815,101.875,1360925077110,1360925077238,1346458714,1346458842,128
1360925105,1346486604,9,861,95.66666667,1360925077621,1360925077813,1346459225,1346459417,192
1360925197,1346579240,1,46,46,1360925169529,1360925169529,1346551769,1346551769,0
1360925374,1346755712,4,252,63,1360925365960,1360925373000,1346747672,1346754712,7040
1360925374,1346755720,4,252,63,1360925366015,1360925373055,1346747735,1346754775,7040
1360925406,1346787684,1,63,63,1360925381027,1360925381027,1346762711,1346762711,0
1360925406,1346787684,1,63,63,1360925381155,1360925381155,1346762839,1346762839,0
1360925422,1346803800,4,252,63,1360925412975,1360925420015,1346794775,1346801815,7040
1360925454,1346835836,1,63,63,1360925428041,1360925428041,1346809877,1346809877,0
1360925478,1346859900,2,126,63,1360925475914,1360925476938,1346857814,1346858838,1024
1360925486,1346867916,2,126,63,1360925478906,1360925482938,1346860822,1346864854,4032
1360925518,1346899892,1,63,63,1360925491025,1360925491025,1346872917,1346872917,0
1360925702,1347084004,3,408,136,1360925676828,1360925682844,1347058832,1347064848,6016
1360926031,1347412620,1,48,48,1360926003287,1360926003287,1347384907,1347384907,0
1360926316,1347697444,3,408,136,1360926290051,1360926296067,1347671495,1347677511,6016
1360926604,1347986036,1,46,46,1360926579311,1360926579311,1347961347,1347961347,0
1360926880,1348261444,16,6372,398.25,1360926869051,1360926879675,1348250495,1348261119,10624
1360926880,1348261448,12,999,83.25,1360926869497,1360926879673,1348250945,1348261121,10176
1360926880,1348261448,12,999,83.25,1360926869752,1360926879672,1348251200,1348261120,9920
1360926880,1348261460,12,999,83.25,1360926869997,1360926879661,1348251457,1348261121,9664
1360926929,1348310592,3,408,136,1360926901157,1360926907173,1348282749,1348288765,6016
1360927539,1348920496,3,408,136,1360927513405,1360927519485,1348894901,1348900981,6080
1360927776,1349157976,12,999,83.25,1360927759256,1360927768856,1349141232,1349150832,9600
1360927776,1349157984,16,6372,398.25,1360927758353,1360927768849,1349140337,1349150833,10496
1360927776,1349157984,11,953,86.63636364,1360927758993,1360927768849,1349140977,1349150833,9856
1360927776,1349157984,12,999,83.25,1360927758737,1360927768849,1349140721,1349150833,10112
1360927835,1349217060,1,48,48,1360927808775,1360927808775,1349190835,1349190835,0
1360928152,1349533604,3,408,136,1360928125382,1360928131334,1349506986,1349512938,5952
1360928208,1349590252,8,3137,392.125,1360928203581,1360928205117,1349585833,1349587369,1536
1360928208,1349590260,31,40405,1303.387097,1360928205624,1360928206008,1349587884,1349588268,384
1360928208,1349590260,5,1257,251.4,1360928206008,1360928206072,1349588268,1349588332,64
1360928208,1349590260,8,3492,436.5,1360928206391,1360928207287,1349588651,1349589547,896
1360928208,1349590260,6,2158,359.6666667,1360928203509,1360928203893,1349585769,1349586153,384
1360928211,4282873512,5,451,90.2,1360928210959,1360928212111,4282873471,4282874623,1152
1360928211,4282873512,5,2109,421.8,1360928211343,1360928211407,4282873855,4282873919,64
1360928214,4282876380,4,1448,362,1360928206415,1360928206479,4282868795,4282868859,64
1360928214,4282876384,5,451,90.2,1360928205838,1360928205966,4282868222,4282868350,128
1360928216,1349598272,6,983,163.8333333,1360928208299,1360928208555,1349590571,1349590827,256
1360928216,1349598272,4,724,181,1360928212011,1360928212075,1349594283,1349594347,64
1360928216,1349598272,9,1913,212.5555556,1360928212138,1360928212394,1349594410,1349594666,256
1360928216,1349598272,6,798,133,1360928208554,1360928208938,1349590826,1349591210,384
1360928216,1349598276,11,3294,299.4545455,1360928209319,1360928210151,1349591595,1349592427,832
1360928216,1349598280,10,3087,308.7,1360928210401,1360928211233,1349592681,1349593513,832
1360928216,1349598280,9,1913,212.5555556,1360928214305,1360928214561,1349596585,1349596841,256
1360928216,1349598280,7,1460,208.5714286,1360928210273,1360928210913,1349592553,1349593193,640
1360928216,1349598280,9,1913,212.5555556,1360928215012,1360928215524,1349597292,1349597804,512
1360928216,1349598280,9,1913,212.5555556,1360928215011,1360928215203,1349597291,1349597483,192
1360928216,1349598280,11,3294,299.4545455,1360928207586,1360928208290,1349589866,1349590570,704
1360928216,1349598284,8,3492,436.5,1360928208417,1360928209121,1349590701,1349591405,704
1360928216,1349598284,7,1423,203.2857143,1360928212767,1360928213727,1349595051,1349596011,960
1360928216,1349598288,9,1913,212.5555556,1360928213657,1360928213849,1349595945,1349596137,192
1360928216,1349598288,6,798,133,1360928210141,1360928210461,1349592429,1349592749,320
1360928222,4282884376,5,451,90.2,1360928219542,1360928221142,4282881918,4282883518,1600
1360928222,4282884376,5,451,90.2,1360928217876,1360928218004,4282880252,4282880380,128
1360928222,4282884380,5,451,90.2,1360928216594,1360928216850,4282878974,4282879230,256
1360928222,4282884380,5,451,90.2,1360928213905,1360928214993,4282876285,4282877373,1088
1360928224,1349606288,15,8365,557.6666667,1360928215963,1360928216219,1349598251,1349598507,256
1360928224,1349606288,10,1877,187.7,1360928220250,1360928221786,1349602538,1349604074,1536
1360928224,1349606288,12,4967,413.9166667,1360928216665,1360928217241,1349598953,1349599529,576
1360928224,1349606292,9,1913,212.5555556,1360928216729,1360928216857,1349599021,1349599149,128
1360928224,1349606292,9,1913,212.5555556,1360928220952,1360928221144,1349603244,1349603436,192
1360928224,1349606292,5,609,121.8,1360928217240,1360928217624,1349599532,1349599916,384
1360928224,1349606292,5,609,121.8,1360928221592,1360928222040,1349603884,1349604332,448
1360928224,1349606292,5,609,121.8,1360928218773,1360928219157,1349601065,1349601449,384
1360928224,1349606292,10,3381,338.1,1360928218901,1360928219093,1349601193,1349601385,192
1360928224,1349606296,9,2849,316.5555556,1360928223188,1360928223316,1349605484,1349605612,128
1360928224,1349606296,10,3189,318.9,1360928219603,1360928219795,1349601899,1349602091,192
1360928224,1349606296,7,1256,179.4285714,1360928215507,1360928216275,1349597803,1349598571,768
1360928225,1349606300,9,1913,212.5555556,1360928218679,1360928218807,1349599979,1349600107,128
1360928225,1349606300,11,4921,447.3636364,1360928218935,1360928219383,1349600235,1349600683,448
1360928225,1349606300,9,1913,212.5555556,1360928222903,1360928223095,1349604203,1349604395,192
1360928225,1349606304,9,1913,212.5555556,1360928223540,1360928223732,1349604844,1349605036,192
1360928230,4282892384,4,1448,362,1360928224078,1360928224142,4282886462,4282886526,64
1360928230,4282892384,4,445,111.25,1360928222222,1360928222350,4282884606,4282884734,128
1360928230,4282892384,4,445,111.25,1360928222477,1360928222669,4282884861,4282885053,192
1360928230,4282892388,4,445,111.25,1360928222666,1360928222858,4282885054,4282885246,192
1360928232,1349613716,1,108,108,1360928204120,1360928204120,1349585836,1349585836,0
1360928232,1349613756,2,216,108,1360928204144,1360928204272,1349585900,1349586028,128
1360928232,1349613756,2,216,108,1360928204272,1360928204400,1349586028,1349586156,128
1360928232,1349614296,9,3310,367.7777778,1360928223955,1360928225811,1349606251,1349608107,1856
1360928233,1349614300,14,7501,535.7857143,1360928230197,1360928230901,1349611497,1349612201,704
1360928233,1349614308,4,715,178.75,1360928229294,1360928229358,1349610602,1349610666,64
1360928233,1349614308,11,3096,281.4545455,1360928229550,1360928230126,1349610858,1349611434,576
1360928233,1349614312,10,3397,339.7,1360928226796,1360928228012,1349608108,1349609324,1216
1360928240,1349621800,7,1877,268.1428571,1360928212676,1360928213252,1349594476,1349595052,576
1360928452,1349834244,2,122,61,1360928427076,1360928427268,1349809320,1349809512,192
1360928661,1350043012,1,46,46,1360928635306,1360928635306,1350017318,1350017318,0
1360928713,1350095092,2,120,60,1360928688790,1360928690646,1350070882,1350072738,1856
1360928733,1350115112,3,180,60,1360928708674,1360928711746,1350090786,1350093858,3072
1360928765,1350147108,3,408,136,1360928736967,1360928743047,1350119075,1350125155,6080
1360929375,1350756536,3,408,136,1360929349115,1360929355131,1350730651,1350736667,6016
1360929577,1350958984,16,6372,398.25,1360929558837,1360929569077,1350940821,1350951061,10240
1360929577,1350958988,11,953,86.63636364,1360929559730,1360929569074,1350941718,1350951062,9344
1360929577,1350958992,12,999,83.25,1360929559213,1360929569069,1350941205,1350951061,9856
1360929577,1350958992,12,999,83.25,1360929559469,1360929569069,1350941461,1350951061,9600
1360929663,1351045152,1,46,46,1360929638349,1360929638349,1351020501,1351020501,0
1360929988,1351370120,3,408,136,1360929960489,1360929966505,1351342609,1351348625,6016
1360930297,1351678996,1,48,48,1360930270177,1360930270177,1351652173,1351652173,0
1360930598,1351979948,3,408,136,1360930572490,1360930578506,1351954438,1351960454,6016
1360931130,1352511968,11,953,86.63636364,1360931114158,1360931124206,1352496126,1352506174,10048
1360931130,1352511972,12,999,83.25,1360931114408,1360931124200,1352496380,1352506172,9792
1360931130,1352511976,12,999,83.25,1360931113831,1360931124199,1352495807,1352506175,10368
1360931159,1352540952,8,815,101.875,1360931131711,1360931131839,1352513663,1352513791,128
1360931159,1352540952,8,815,101.875,1360931131965,1360931132157,1352513917,1352514109,192
1360931159,1352541000,8,815,101.875,1360931132175,1360931132367,1352514175,1352514367,192
1360931159,1352541000,8,815,101.875,1360931132431,1360931132623,1352514431,1352514623,192
1360931211,1352593008,3,408,136,1360931183621,1360931189701,1352565629,1352571709,6080
1360931285,1352666632,1,48,48,1360931256765,1360931256765,1352638397,1352638397,0
1360931286,1352668120,1,48,48,1360931256278,1360931256278,1352638398,1352638398,0
1360931323,1352704328,4,252,63,1360931314347,1360931321387,1352695675,1352702715,7040
1360931355,1352737212,1,63,63,1360931328566,1360931328566,1352710778,1352710778,0
1360931395,1352776356,3,189,63,1360931391503,1360931394575,1352772859,1352775931,3072
1360931411,1352792696,2,126,63,1360931398203,1360931406267,1352779899,1352787963,8064
1360931555,1352936480,3,189,63,1360931551440,1360931554512,1352932920,1352935992,3072
1360931555,1352936480,3,189,63,1360931551440,1360931554512,1352932920,1352935992,3072
1360931560,1352941920,1,46,46,1360931533206,1360931533206,1352915126,1352915126,0
1360931571,1352952464,2,126,63,1360931558560,1360931566624,1352940024,1352948088,8064
1360931571,1352952464,2,126,63,1360931558559,1360931566623,1352940023,1352948087,8064
1360931821,1353202408,3,408,136,1360931795859,1360931801875,1353177267,1353183283,6016
1360932434,1353815520,3,408,136,1360932407066,1360932413082,1353788586,1353794602,6016
1360932941,1354322408,12,999,83.25,1360932925313,1360932934593,1354306721,1354316001,9280
1360932941,1354322412,12,999,83.25,1360932925822,1360932934590,1354307234,1354316002,8768
1360932941,1354322412,12,999,83.25,1360932925566,1360932934590,1354306978,1354316002,9024
1360932941,1354322420,16,6372,398.25,1360932924917,1360932934645,1354306337,1354316065,9728
1360933043,1354425292,3,408,136,1360933017868,1360933023884,1354400160,1354406176,6016
1360933520,1354902212,2,230,115,1360933495639,1360933495639,1354877851,1354877851,0
1360933657,1355038424,3,408,136,1360933630505,1360933636585,1355011929,1355018009,6080
1360934270,1355651332,3,408,136,1360934243258,1360934249274,1355624590,1355630606,6016
1360934498,1355879764,9,861,95.66666667,1360934470472,1360934470664,1355852236,1355852428,192
1360934498,1355879796,9,861,95.66666667,1360934469928,1360934470120,1355851724,1355851916,192
1360934498,1355879796,8,815,101.875,1360934470183,1360934470375,1355851979,1355852171,192
1360934706,1356087980,8,815,101.875,1360934681773,1360934681901,1356063753,1356063881,128
1360934710,1356091944,9,861,95.66666667,1360934682319,1360934682511,1356064263,1356064455,192
1360934710,1356091980,8,815,101.875,1360934682027,1360934682219,1356064007,1356064199,192
1360934710,1356091984,8,815,101.875,1360934682535,1360934682727,1356064519,1356064711,192
1360934711,1356092528,3,189,63,1360934705006,1360934708014,1356086534,1356089542,3008
1360934727,1356108580,2,126,63,1360934711994,1360934720058,1356093574,1356101638,8064
1360934775,1356156552,2,126,63,1360934773205,1360934774229,1356154757,1356155781,1024
1360934775,1356156556,2,126,63,1360934773267,1360934774291,1356154823,1356155847,1024
1360934783,1356164540,2,126,63,1360934776290,1360934780322,1356157830,1356161862,4032
1360934783,1356164580,2,126,63,1360934776252,1360934780284,1356157832,1356161864,4032
1360934814,1356196032,1,63,63,1360934787830,1360934787830,1356169862,1356169862,0
1360934814,1356196068,1,63,63,1360934787858,1360934787858,1356169926,1356169926,0
1360934882,1356264148,3,408,136,1360934854016,1360934860032,1356236164,1356242180,6016
1360934975,1356356676,3,189,63,1360934969238,1360934972310,1356350914,1356353986,3072
1360934991,1356372684,2,126,63,1360934976335,1360934984335,1356358019,1356366019,8000
1360935023,1356404672,3,189,63,1360935016793,1360935019801,1356398465,1356401473,3008
1360935023,1356404676,3,189,63,1360935016792,1360935019800,1356398468,1356401476,3008
1360935039,1356420676,2,126,63,1360935023832,1360935031896,1356405508,1356413572,8064
1360935039,1356420688,2,126,63,1360935023819,1360935031883,1356405507,1356413571,8064
1360935055,1356436688,3,189,63,1360935051209,1360935054217,1356432897,1356435905,3008
1360935071,1356452328,14,6617,472.6428571,1360935044336,1360935044656,1356425664,1356425984,320
1360935071,1356452328,9,861,95.66666667,1360935044721,1360935044913,1356426049,1356426241,192
1360935071,1356452332,9,861,95.66666667,1360935045294,1360935045486,1356426626,1356426818,192
1360935071,1356452392,9,861,95.66666667,1360935044976,1360935045104,1356426368,1356426496,128
1360935071,1356452708,2,126,63,1360935058230,1360935066294,1356439938,1356448002,8064
1360935239,1356620820,4,252,63,1360935230915,1360935237955,1356612735,1356619775,7040
1360935271,1356652696,1,63,63,1360935246143,1360935246143,1356627839,1356627839,0
1360935367,1356748936,2,126,63,1360935364108,1360935365132,1356746044,1356747068,1024
1360935375,1356756936,2,126,63,1360935367116,1360935371148,1356749052,1356753084,4032
1360935383,1356764964,2,126,63,1360935381746,1360935382770,1356763710,1356764734,1024
1360935383,1356764992,2,126,63,1360935380055,1360935381079,1356762047,1356763071,1024
1360935391,1356772968,2,126,63,1360935383086,1360935387118,1356765054,1356769086,4032
1360935391,1356772976,2,126,63,1360935384807,1360935388775,1356766783,1356770751,3968
1360935407,1356789216,1,63,63,1360935378932,1360935378932,1356761148,1356761148,0
1360935419,1356801224,1,63,63,1360935394924,1360935394924,1356777148,1356777148,0
1360935423,1356805256,1,63,63,1360935396558,1360935396558,1356778814,1356778814,0
1360935492,1356873520,3,408,136,1360935466158,1360935472174,1356847678,1356853694,6016
1360935623,1357005036,5,2841,568.2,1360935613160,1360935621544,1356995196,1357003580,8384
1360935631,1357013076,17,6755,397.3529412,1360935613823,1360935625919,1356995899,1357007995,12096
1360935631,1357013076,12,999,83.25,1360935614207,1360935625919,1356996283,1357007995,11712
1360935631,1357013080,12,999,83.25,1360935614460,1360935625852,1356996540,1357007932,11392
1360935632,1357013920,11,953,86.63636364,1360935614938,1360935626010,1356996858,1357007930,11072
1360936105,1357486712,3,408,136,1360936077921,1360936083873,1357459633,1357465585,5952
1360936229,1357610864,1,46,46,1360936201543,1360936201543,1357583407,1357583407,0
1360936352,1357733588,12,999,83.25,1360936334041,1360936345305,1357715629,1357726893,11264
1360936352,1357733592,11,953,86.63636364,1360936334360,1360936345304,1357715952,1357726896,10944
1360936352,1357733592,12,999,83.25,1360936334613,1360936345237,1357716205,1357726829,10624
1360936352,1357733604,17,6888,405.1764706,1360936333194,1360936345226,1357714798,1357726830,12032
1360936352,1357733636,15,6289,419.2666667,1360936333610,1360936345258,1357715246,1357726894,11648
1360936714,1358096168,3,408,136,1360936688530,1360936694546,1358070698,1358076714,6016
1360937327,1358709012,3,408,136,1360937300004,1360937306020,1358682016,1358688032,6016
1360937549,1358930480,1,46,46,1360937520694,1360937520694,1358902174,1358902174,0
1360937549,1358930484,1,46,46,1360937520752,1360937520752,1358902236,1358902236,0
1360937940,1359321940,3,408,136,1360937911906,1360937917922,1359293846,1359299862,6016
1360938165,1359546484,12,6151,512.5833333,1360938138280,1360938138792,1359519764,1359520276,512
1360938165,1359546488,8,815,101.875,1360938138853,1360938139045,1359520341,1359520533,192
1360938165,1359546488,9,861,95.66666667,1360938139108,1360938139300,1359520596,1359520788,192
1360938165,1359546552,9,861,95.66666667,1360938139299,1360938139491,1359520851,1359521043,192
1360938394,1359775352,2,126,63,1360938391847,1360938392807,1359773199,1359774159,960
1360938394,1359775352,2,126,63,1360938391847,1360938392871,1359773199,1359774223,1024
1360938401,1359783240,2,126,63,1360938393967,1360938397999,1359776207,1359780239,4032
1360938401,1359783244,2,126,63,1360938394029,1360938398061,1359776273,1359780305,4032
1360938401,1359783248,3,189,63,1360938395366,1360938398374,1359777614,1359780622,3008
1360938417,1359799244,2,126,63,1360938402410,1360938410474,1359784654,1359792718,8064
1360938434,1359815488,1,63,63,1360938406815,1360938406815,1359788303,1359788303,0
1360938434,1359815488,1,63,63,1360938406814,1360938406814,1359788302,1359788302,0
1360938442,1359823292,3,189,63,1360938435939,1360938438947,1359817231,1359820239,3008
1360938457,1359839280,2,126,63,1360938441991,1360938450055,1359824271,1359832335,8064
1360938550,1359931856,3,408,136,1360938524461,1360938530477,1359906317,1359912333,6016
1360938594,1359976000,1,48,48,1360938568733,1360938568733,1359950733,1359950733,0
1360938624,1360005988,1,46,46,1360938597222,1360938597222,1359979210,1359979210,0
1360938624,1360005992,1,46,46,1360938597220,1360938597220,1359979212,1359979212,0
1360938967,1360348828,2,96,48,1360938940548,1360938950148,1360322376,1360331976,9600
1360939163,1360545240,3,408,136,1360939135011,1360939140963,1360517251,1360523203,5952
1360939167,1360549256,1,48,48,1360939140693,1360939140693,1360522949,1360522949,0
1360939298,1360679612,10,2668,266.8,1360939290645,1360939291093,1360672257,1360672705,448
1360939298,1360679620,10,2668,266.8,1360939291084,1360939291532,1360672704,1360673152,448
1360939305,4293967260,19,21946,1155.052632,1360939289487,1360939300303,4293951747,4293962563,10816
1360939306,1360687636,15,6289,419.2666667,1360939290751,1360939302143,1360672387,1360683779,11392
1360939306,1360687672,11,953,86.63636364,1360939292186,1360939302042,1360673858,1360683714,9856
1360939306,1360687672,21,15633,744.4285714,1360939290264,1360939300696,1360671936,1360682368,10432
1360939306,1360687680,6,2410,401.6666667,1360939290639,1360939301135,1360672319,1360682815,10496
1360939306,1360687680,5,2352,470.4,1360939290643,1360939301139,1360672323,1360682819,10496
1360939306,1360687700,12,999,83.25,1360939291132,1360939302076,1360672832,1360683776,10944
1360939306,1360687704,15,6289,419.2666667,1360939291576,1360939302008,1360673280,1360683712,10432
1360939316,1360697768,1,52,52,1360939290234,1360939290234,1360672002,1360672002,0
1360939432,1360814088,8,815,101.875,1360939406390,1360939406582,1360788478,1360788670,192
1360939432,1360814096,8,815,101.875,1360939407217,1360939407345,1360789313,1360789441,128
1360939432,1360814096,9,861,95.66666667,1360939406896,1360939407088,1360788992,1360789184,192
1360939432,1360814144,9,861,95.66666667,1360939406593,1360939406785,1360788737,1360788929,192
1360939490,1360871808,3,138,46,1360939487439,1360939488463,1360869247,1360870271,1024
1360939490,1360871808,3,138,46,1360939487437,1360939488461,1360869245,1360870269,1024
1360939490,1360871852,3,138,46,1360939487396,1360939488420,1360869248,1360870272,1024
1360939490,1360871852,3,138,46,1360939487395,1360939488419,1360869247,1360870271,1024
1360939506,1360887768,12,999,83.25,1360939492277,1360939504117,1360874045,1360885885,11840
1360939506,1360887772,12,999,83.25,1360939492595,1360939504115,1360874367,1360885887,11520
1360939506,1360887816,11,953,86.63636364,1360939492807,1360939504071,1360874623,1360885887,11264
1360939506,1360887828,11,953,86.63636364,1360939491962,1360939504058,1360873790,1360885886,12096
1360939516,1360898176,1,46,46,1360939490143,1360939490143,1360872319,1360872319,0
1360939516,1360898176,1,46,46,1360939490142,1360939490142,1360872318,1360872318,0
1360939516,1360898176,1,46,46,1360939490142,1360939490142,1360872318,1360872318,0
1360939516,1360898176,11,3267,297,1360939488669,1360939489309,1360870845,1360871485,640
1360939516,1360898228,1,46,46,1360939490088,1360939490088,1360872316,1360872316,0
1360939541,1360922288,3,180,60,1360939514902,1360939523862,1360896190,1360905150,8960
1360939561,1360942284,3,180,60,1360939535896,1360939544856,1360917180,1360926140,8960
1360939581,1360962276,1,60,60,1360939556896,1360939556896,1360938172,1360938172,0
1360939584,1360966272,1,60,60,1360939555967,1360939555967,1360938239,1360938239,0
1360939738,1361119960,5,408,81.6,1360939730420,1360939736052,1361112380,1361118012,5632
1360939745,1361126508,1,46,46,1360939719160,1360939719160,1361100668,1361100668,0
1360939762,1361144172,2,178,89,1360939742173,1360939754973,1361124345,1361137145,12800
1360939773,1361154580,3,408,136,1360939746991,1360939753007,1361128571,1361134587,6016
1360939809,1361190596,1,89,89,1360939781086,1360939781086,1361162682,1361162682,0
1360939857,1361238772,1,89,89,1360939831979,1360939831979,1361213751,1361213751,0
1360939865,1361246764,1,46,46,1360939839093,1360939839093,1361220857,1361220857,0
1360940382,1361764156,3,408,136,1360940357155,1360940363171,1361739311,1361745327,6016
1360940390,1361772132,1,46,46,1360940363643,1360940363643,1361745775,1361745775,0
1360940627,1362008372,2,96,48,1360940601904,1360940605616,1361983276,1361986988,3712
1360940651,1362032444,2,96,48,1360940626280,1360940632744,1362007724,1362014188,6464
1360940780,1362161484,7,2447,349.5714286,1360940777981,1360940778109,1362159465,1362159593,128
1360940780,1362161488,8,5112,639,1360940770107,1360940776059,1362151595,1362157547,5952
1360940780,1362161496,7,4048,578.2857143,1360940776305,1360940776497,1362157801,1362157993,192
1360940786,480328,23,27650,1202.173913,1360940771224,1360940783192,465552,477520,11968
1360940788,1362169468,21,11767,560.3333333,1360940772239,1360940783183,1362153707,1362164651,10944
1360940788,1362169472,14,4789,342.0714286,1360940776329,1360940786057,1362157801,1362167529,9728
1360940788,1362169504,11,953,86.63636364,1360940777514,1360940785962,1362159018,1362167466,8448
1360940788,1362169520,14,4789,342.0714286,1360940772377,1360940779993,1362153897,1362161513,7616
1360940788,1362169544,12,999,83.25,1360940772994,1360940785986,1362154538,1362167530,12992
1360940796,1362177476,11,5422,492.9090909,1360940776519,1360940788039,1362157995,1362169515,11520
1360940803,1362184856,23,6712,291.826087,1360940775946,1360940799818,1362157802,1362181674,23872
1360940804,1362185536,29,27431,945.8965517,1360940791243,1360940800011,1362172779,1362181547,8768
1360940820,1362201504,4,377,94.25,1360940811882,1360940812202,1362193386,1362193706,320
1360940828,1362209468,14,4726,337.5714286,1360940812238,1360940823886,1362193706,1362205354,11648
1360940828,1362209552,10,930,93,1360940813116,1360940823740,1362194668,1362205292,10624
1360940839,1362220804,1,60,60,1360940811645,1360940811645,1362193449,1362193449,0
1360940852,1362233512,7,4048,578.2857143,1360940844384,1360940844704,1362225896,1362226216,320
1360940871,1362252928,18,7407,411.5,1360940844289,1360940869697,1362226217,1362251625,25408
1360940908,1362289564,2,594,297,1360940895726,1360940905198,1362277290,1362286762,9472
1360940919,1362300936,1,46,46,1360940891577,1360940891577,1362273513,1362273513,0
1360940972,1362353316,1,505,505,1360940947302,1360940947302,1362328618,1362328618,0
1360940996,1362377268,3,408,136,1360940969556,1360940975572,1362350824,1362356840,6016
1360941060,1362441344,2,112,56,1360941033094,1360941033094,1362414438,1362414438,0
1360941272,1362653808,1,48,48,1360941245234,1360941245234,1362627042,1362627042,0
1360941528,1362910192,1,46,46,1360941503791,1360941503791,1362885983,1362885983,0
1360941604,1362986220,3,408,136,1360941578963,1360941584979,1362961183,1362967199,6016
1360941894,1363275772,1,46,46,1360941866508,1360941866508,1363248280,1363248280,0
1360941895,1363277228,1,46,46,1360941866054,1360941866054,1363248282,1363248282,0
1360942050,1363431660,1,46,46,1360942025083,1360942025083,1363406743,1363406743,0
1360942050,1363432144,1,46,46,1360942024601,1360942024601,1363406745,1363406745,0
1360942217,1363599020,3,408,136,1360942191442,1360942197458,1363573462,1363579478,6016
1360942754,1364136128,1,48,48,1360942728987,1360942728987,1364111115,1364111115,0
1360942754,1364136168,1,48,48,1360942726388,1360942726388,1364108556,1364108556,0
1360942830,1364212164,3,408,136,1360942802103,1360942808119,1364184267,1364190283,6016
1360942846,1364228196,1,46,46,1360942821719,1360942821719,1364203915,1364203915,0
1360943440,1364821712,3,408,136,1360943414003,1360943419955,1364795715,1364801667,5952
1360943553,3248088,14,16615,1186.785714,1360943528240,1360943542640,3223328,3237728,14400
1360943553,3248124,6,4755,792.5,1360943528206,1360943528270,3223330,3223394,64
1360943584,1364965996,11,953,86.63636364,1360943572626,1360943583826,1364954622,1364965822,11200
1360943584,1364966100,12,999,83.25,1360943571949,1360943583725,1364954049,1364965825,11776
1360943584,1364966100,12,999,83.25,1360943572267,1360943583723,1364954367,1364965823,11456
1360943584,1364966140,12,999,83.25,1360943571586,1360943583682,1364953726,1364965822,12096
1360943585,3280108,1,1339,1339,1360943557023,1360943557023,3252131,3252131,0
1360943613,3308108,1,1339,1339,1360943585885,1360943585885,3280993,3280993,0
1360943657,1365038328,1,46,46,1360943631534,1360943631534,1365012862,1365012862,0
1360943821,1365202664,3,405,135,1360943795675,1360943801755,1365177339,1365183419,6080
1360944035,3729484,4,208,52,1360944028879,1360944030415,3723363,3724899,1536
1360944350,1365731996,1,46,46,1360944321992,1360944321992,1365703988,1365703988,0
1360944425,1365807184,15,4835,322.3333333,1360944410891,1360944422923,1365793075,1365805107,12032
1360944425,1365807196,12,999,83.25,1360944411840,1360944422912,1365794036,1365805108,11072
1360944426,1365807272,12,999,83.25,1360944412443,1360944423835,1365793715,1365805107,11392
1360944426,1365807276,12,999,83.25,1360944413079,1360944423831,1365794355,1365805107,10752
1360944467,1365848480,1,46,46,1360944439691,1360944439691,1365821171,1365821171,0
1360944594,1365975288,14,4789,342.0714286,1360944575494,1360944586630,1365956782,1365967918,11136
1360944594,1365975296,12,999,83.25,1360944575935,1360944586623,1365957231,1365967919,10688
1360944594,1365975300,15,1474,98.26666667,1360944576188,1360944587196,1365957488,1365968496,11008
1360944594,1365975392,11,953,86.63636364,1360944577634,1360944586466,1365959026,1365967858,8832
1360944659,1366040912,3,402,134,1360944634008,1360944640024,1366015920,1366021936,6016
1360944938,1366319744,44,55099,1252.25,1360944937340,1360944937596,1366319084,1366319340,256
1360944954,1366335552,15,4835,322.3333333,1360944940666,1360944952698,1366322218,1366334250,12032
1360944954,1366335560,12,999,83.25,1360944941427,1360944952691,1366322987,1366334251,11264
1360944954,1366335584,12,999,83.25,1360944941722,1360944952602,1366323306,1366334186,10880
1360944954,1366335588,12,999,83.25,1360944942104,1360944952600,1366323692,1366334188,10496
1360944968,1366349404,2,120,60,1360944940685,1360944944717,1366322089,1366326121,4032
1360944968,1366349492,11,3267,297,1360944940472,1360944941432,1366321964,1366322924,960
1360944968,1366349492,1,46,46,1360944940917,1360944940917,1366322409,1366322409,0
1360945136,1366517692,1,46,46,1360945108906,1360945108906,1366490598,1366490598,0
1360945297,1366678996,1,46,46,1360945268152,1360945268152,1366650148,1366650148,0
1360945298,1366679984,1,46,46,1360945268100,1360945268100,1366650084,1366650084,0
1360945344,1366726108,1,89,89,1360945317514,1360945317514,1366699622,1366699622,0
1360945433,1366814272,2,120,60,1360945408395,1360945411403,1366789667,1366792675,3008
1360945436,1366818168,2,120,60,1360945411468,1360945414476,1366793636,1366796644,3008
1360945685,1367066704,1,89,89,1360945657177,1360945657177,1367038881,1367038881,0
1360946030,1367411616,3,408,136,1360946002859,1360946008875,1367384475,1367390491,6016
1360946054,1367435676,1,89,89,1360946028716,1360946028716,1367410392,1367410392,0
1360946343,1367724264,1,71,71,1360946316548,1360946316548,1367697812,1367697812,0
1360946367,1367748340,1,71,71,1360946342586,1360946342586,1367723926,1367723926,0
1360946639,1368020792,1,89,89,1360946613042,1360946613042,1367994834,1367994834,0
1360946772,1368153336,11,4651,422.8181818,1360946745973,1360946746293,1368127309,1368127629,320
1360946772,1368153340,9,861,95.66666667,1360946746419,1360946746611,1368127759,1368127951,192
1360946772,1368153344,9,861,95.66666667,1360946746734,1360946746926,1368128078,1368128270,192
1360946772,1368153432,11,4651,422.8181818,1360946746967,1360946747287,1368128399,1368128719,320
1360946835,1368217100,3,138,46,1360946832442,1360946832506,1368214542,1368214606,64
1360946835,1368217100,3,138,46,1360946832442,1360946832506,1368214542,1368214606,64
1360946835,1368217100,3,138,46,1360946832441,1360946832505,1368214541,1368214605,64
1360946835,1368217168,3,138,46,1360946832375,1360946832439,1368214543,1368214607,64
1360946856,1368237504,3,408,136,1360946828046,1360946834126,1368209550,1368215630,6080
1360947200,1368582024,1,60,60,1360947172543,1360947172543,1368554567,1368554567,0
1360947204,1368586032,1,60,60,1360947178487,1360947178487,1368560519,1368560519,0
1360947452,1368833924,4,319,79.75,1360947445855,1360947446943,1368827779,1368828867,1088
1360947460,1368841884,17,6755,397.3529412,1360947447687,1360947459591,1368829571,1368841475,11904
1360947465,1368846828,3,408,136,1360947439361,1360947445441,1368821189,1368827269,6080
1360947700,1369081996,12,999,83.25,1360947685778,1360947696210,1369067774,1369078206,10432
1360947700,1369082040,16,6335,395.9375,1360947685097,1360947696169,1369067137,1369078209,11072
1360947700,1369082044,11,953,86.63636364,1360947685541,1360947696165,1369067585,1369078209,10624
1360947700,1369082072,12,999,83.25,1360947686025,1360947696137,1369068097,1369078209,10112
1360948075,1369456572,3,408,136,1360948050741,1360948056757,1369432313,1369438329,6016
1360948360,1369741268,9,861,95.66666667,1360948334625,1360948334817,1369715893,1369716085,192
1360948360,1369741272,8,815,101.875,1360948334877,1360948335069,1369716149,1369716341,192
1360948360,1369741348,14,6617,472.6428571,1360948334162,1360948334418,1369715510,1369715766,256
1360948440,1369821624,1,46,46,1360948412860,1360948412860,1369794484,1369794484,0
1360948628,1370010080,9,861,95.66666667,1360948601139,1360948601331,1369983219,1369983411,192
1360948628,1370010080,8,815,101.875,1360948601393,1360948601585,1369983473,1369983665,192
1360948628,1370010148,9,861,95.66666667,1360948600557,1360948600749,1369982705,1369982897,192
1360948628,1370010156,8,815,101.875,1360948600804,1360948600996,1369982960,1369983152,192
1360948632,1370014216,1,63,63,1360948604969,1360948604969,1369987185,1369987185,0
1360948661,1370042512,4,252,63,1360948652523,1360948659563,1370034035,1370041075,7040
1360948661,1370042512,4,252,63,1360948652585,1360948659625,1370034097,1370041137,7040
1360948689,1370070268,3,408,136,1360948662750,1360948668766,1370044018,1370050034,6016
1360948693,1370074340,1,63,63,1360948667799,1360948667799,1370049139,1370049139,0
1360948693,1370074340,1,63,63,1360948667862,1360948667862,1370049202,1370049202,0
1360948881,1370262992,3,402,134,1360948852936,1360948859016,1370234928,1370241008,6080
1360948894,1370275252,3,189,63,1360948887017,1360948890089,1370268269,1370271341,3072
1360948894,1370275332,3,189,63,1360948887001,1360948890009,1370268333,1370271341,3008
1360948894,1370275332,3,189,63,1360948887000,1360948890008,1370268332,1370271340,3008
1360948910,1370291320,2,126,63,1360948894055,1360948902055,1370275375,1370283375,8000
1360948910,1370291320,2,126,63,1360948894055,1360948902119,1370275375,1370283439,8064
1360948910,1370291320,2,126,63,1360948894055,1360948902119,1370275375,1370283439,8064
1360948985,1370367184,1,46,46,1360948960004,1360948960004,1370342188,1370342188,0
1360949014,1370395528,2,126,63,1360949011926,1360949012950,1370393454,1370394478,1024
1360949022,1370403584,2,126,63,1360949014940,1360949018908,1370396524,1370400492,3968
1360949054,1370435456,1,63,63,1360949027098,1360949027098,1370408554,1370408554,0
1360949475,1370856492,2,96,48,1360949447603,1360949450547,1370829095,1370832039,2944
1360949495,1370876532,2,96,48,1360949469063,1360949472007,1370850595,1370853539,2944
1360949551,1370932780,3,402,134,1360949524177,1360949530193,1370905957,1370911973,6016
1360949715,1371096972,1,46,46,1360949686862,1360949686862,1371068834,1371068834,0
1360950028,1371409716,9,861,95.66666667,1360950003592,1360950003784,1371385308,1371385500,192
1360950032,1371413664,9,861,95.66666667,1360950003965,1360950004093,1371385629,1371385757,128
1360950032,1371413672,8,815,101.875,1360950004214,1360950004406,1371385886,1371386078,192
1360950287,1371668448,2,126,63,1360950284880,1360950285904,1371666328,1371667352,1024
1360950295,1371676452,2,126,63,1360950287950,1360950291918,1371669402,1371673370,3968
1360950311,1371692480,3,189,63,1360950305905,1360950308977,1371687385,1371690457,3072
1360950311,1371692480,3,189,63,1360950305968,1360950309040,1371687448,1371690520,3072
1360950325,1371706636,1,63,63,1360950299797,1360950299797,1371681433,1371681433,0
1360950341,1371722588,8,815,101.875,1360950316546,1360950316802,1371698134,1371698390,256
1360950345,1371726524,1,46,46,1360950316930,1360950316930,1371698454,1371698454,0
1360950543,1371924528,3,189,63,1360950538748,1360950541820,1371920276,1371923348,3072
1360950559,1371940472,2,126,63,1360950545909,1360950553909,1371927381,1371935381,8000
1360950613,1371995232,9,861,95.66666667,1360950587386,1360950587578,1371969618,1371969810,192
1360950613,1371995236,8,815,101.875,1360950587704,1360950588408,1371969940,1371970644,704
1360950614,1371995324,8,815,101.875,1360950588041,1360950588233,1371969365,1371969557,192
1360950726,1372107588,1,46,46,1360950700861,1360950700861,1372082449,1372082449,0
1360950831,1372212656,2,92,46,1360950830712,1360950830712,1372212368,1372212368,0
1360950839,1372220672,2,92,46,1360950831720,1360950833704,1372213392,1372215376,1984
1360950858,1372239748,1,46,46,1360950830621,1360950830621,1372212369,1372212369,0
1360950858,1372239780,15,6832,455.4666667,1360950832698,1360950832954,1372214478,1372214734,256
1360950858,1372239808,9,861,95.66666667,1360950833057,1360950833249,1372214865,1372215057,192
1360950858,1372239808,9,861,95.66666667,1360950833313,1360950833569,1372215121,1372215377,256
1360950858,1372239812,9,861,95.66666667,1360950833628,1360950833820,1372215440,1372215632,192
1360950862,1372243952,8,815,101.875,1360950833743,1360950833935,1372215695,1372215887,192
1360950886,1372267720,1,48,48,1360950858101,1360950858101,1372239821,1372239821,0
1360950895,1372276728,4,252,63,1360950887408,1360950894448,1372269136,1372276176,7040
1360950895,1372276804,4,252,63,1360950887397,1360950894501,1372269201,1372276305,7104
1360950930,1372311868,1,63,63,1360950902371,1360950902371,1372284239,1372284239,0
1360950930,1372311872,1,63,63,1360950902433,1360950902433,1372284305,1372284305,0
1360950946,1372327864,3,408,136,1360950919592,1360950925608,1372301456,1372307472,6016
1360951063,1372444804,4,252,63,1360951055649,1360951062689,1372437453,1372444493,7040
1360951095,1372476900,4,252,63,1360951086722,1360951093762,1372468622,1372475662,7040
1360951098,1372480148,1,63,63,1360951070343,1360951070343,1372452491,1372452491,0
1360951111,1372492948,4,252,63,1360951101902,1360951108942,1372483850,1372490890,7040
1360951123,1372504324,1,46,46,1360951096382,1360951096382,1372477706,1372477706,0
1360951127,1372508256,1,63,63,1360951102467,1360951102467,1372483723,1372483723,0
1360951143,1372524260,1,63,63,1360951117694,1360951117694,1372498954,1372498954,0
1360951143,1372524928,3,189,63,1360951139683,1360951142691,1372521611,1372524619,3008
1360951159,1372541012,2,126,63,1360951146641,1360951154705,1372528653,1372536717,8064
1360951175,1372556992,4,252,63,1360951165858,1360951172898,1372547850,1372554890,7040
1360951207,1372588296,1,63,63,1360951181657,1360951181657,1372562953,1372562953,0
1360951707,1373089184,3,408,136,1360951680731,1360951686811,1373062915,1373068995,6080
1360952020,1373402188,9,861,95.66666667,1360951995793,1360951995921,1373377981,1373378109,128
1360952021,1373402232,13,7060,543.0769231,1360951994381,1360951995853,1373375613,1373377085,1472
1360952021,1373402272,10,907,90.7,1360951995941,1360951996581,1373377213,1373377853,640
1360952225,1373606856,3,189,63,1360952219100,1360952222172,1373600956,1373604028,3072
1360952241,1373622856,2,126,63,1360952226204,1360952234204,1373608060,1373616060,8000
1360952265,1373647180,2,126,63,1360952263446,1360952264406,1373645626,1373646586,960
1360952269,1373650768,9,861,95.66666667,1360952241713,1360952241905,1373623481,1373623673,192
1360952269,1373650844,9,861,95.66666667,1360952241064,1360952241320,1373622908,1373623164,256
1360952269,1373650844,8,815,101.875,1360952241381,1360952241573,1373623225,1373623417,192
1360952269,1373650876,8,815,101.875,1360952241863,1360952242055,1373623739,1373623931,192
1360952273,1373655044,2,126,63,1360952266591,1360952270623,1373648635,1373652667,4032
1360952305,1373687000,1,63,63,1360952278730,1360952278730,1373660730,1373660730,0
1360952313,1373695148,2,126,63,1360952310388,1360952311412,1373692536,1373693560,1024
1360952321,1373703140,2,126,63,1360952313404,1360952317436,1373695544,1373699576,4032
1360952349,1373731024,1,46,46,1360952321457,1360952321457,1373703481,1373703481,0
1360952353,1373734928,1,63,63,1360952325714,1360952325714,1373707642,1373707642,0
1360952373,1373755124,3,408,136,1360952347980,1360952353996,1373730104,1373736120,6016
1360952442,1373823452,1,46,46,1360952415852,1360952415852,1373797304,1373797304,0
1360952498,1373879760,4,252,63,1360952488886,1360952495990,1373870646,1373877750,7104
1360952506,1373887732,2,126,63,1360952502931,1360952503891,1373884663,1373885623,960
1360952506,1373887768,2,126,63,1360952503918,1360952504878,1373885686,1373886646,960
1360952514,1373895708,2,126,63,1360952505960,1360952509992,1373887668,1373891700,4032
1360952514,1373895736,2,126,63,1360952506959,1360952510991,1373888695,1373892727,4032
1360952530,1373911520,1,63,63,1360952504229,1360952504229,1373885749,1373885749,0
1360952546,1373927420,1,63,63,1360952518345,1360952518345,1373899765,1373899765,0
1360952546,1373927540,1,63,63,1360952519251,1360952519251,1373900791,1373900791,0
1360952554,1373935840,2,126,63,1360952551908,1360952552868,1373933748,1373934708,960
1360952562,1373943740,2,126,63,1360952555016,1360952559048,1373936756,1373940788,4032
1360952566,1373947732,1,46,46,1360952539090,1360952539090,1373920822,1373920822,0
1360952594,1373975724,1,63,63,1360952567129,1360952567129,1373948853,1373948853,0
1360952606,1373987784,1,46,46,1360952580830,1360952580830,1373962614,1373962614,0
1360952771,1374152424,1,46,46,1360952743168,1360952743168,1374124592,1374124592,0
1360952987,1374368868,3,408,136,1360952960067,1360952966083,1374341935,1374347951,6016
1360953091,1374472388,11,953,86.63636364,1360953071903,1360953082975,1374453291,1374464363,11072
1360953091,1374472508,16,6372,398.25,1360953070824,1360953082920,1374452332,1374464428,12096
1360953091,1374472512,11,953,86.63636364,1360953071204,1360953082916,1374452716,1374464428,11712
1360953091,1374472512,12,999,83.25,1360953071460,1360953082916,1374452972,1374464428,11456
1360953307,1374688496,12,999,83.25,1360953294067,1360953306163,1374675563,1374687659,12096
1360953307,1374688520,11,953,86.63636364,1360953294299,1360953306139,1374675819,1374687659,11840
1360953307,1374688524,11,953,86.63636364,1360953294868,1360953306132,1374676392,1374687656,11264
1360953307,1374688600,12,999,83.25,1360953294539,1360953306059,1374676139,1374687659,11520
1360953475,1374856664,16,6372,398.25,1360953460041,1360953471241,1374841705,1374852905,11200
1360953475,1374856668,12,999,83.25,1360953460420,1360953471236,1374842088,1374852904,10816
1360953475,1374856668,12,999,83.25,1360953459204,1360953471236,1374840872,1374852904,12032
1360953483,1374864720,16,1520,95,1360953458383,1360953477583,1374840103,1374859303,19200
1360953491,1374872728,12,999,83.25,1360953471368,1360953483144,1374853096,1374864872,11776
1360953491,1374872728,12,999,83.25,1360953471047,1360953483143,1374852775,1374864871,12096
1360953491,1374872732,11,953,86.63636364,1360953471619,1360953483139,1374853351,1374864871,11520
1360953491,1374872792,8,7207,900.875,1360953477255,1360953485703,1374859047,1374867495,8448
1360953494,13188572,7,4808,686.8571429,1360953477492,1360953486004,13172064,13180576,8512
1360953596,1374977984,3,408,136,1360953571014,1360953577094,1374952998,1374959078,6080
1360954030,1375411508,1,46,46,1360954004825,1360954004825,1375386333,1375386333,0
1360954206,1375587992,3,408,136,1360954181622,1360954187702,1375563614,1375569694,6080
1360954387,1375768356,9,861,95.66666667,1360954360107,1360954360299,1375741463,1375741655,192
1360954387,1375768360,8,815,101.875,1360954360683,1360954360811,1375742043,1375742171,128
1360954387,1375768432,12,6151,512.5833333,1360954359650,1360954359970,1375741082,1375741402,320
1360954387,1375768460,9,861,95.66666667,1360954360260,1360954360452,1375741720,1375741912,192
1360954596,1375977668,3,189,63,1360954590323,1360954593331,1375971991,1375974999,3008
1360954604,1375985620,3,189,63,1360954598049,1360954601057,1375979669,1375982677,3008
1360954604,1375985696,3,189,63,1360954597973,1360954600981,1375979669,1375982677,3008
1360954612,1375993676,2,126,63,1360954597355,1360954605419,1375979031,1375987095,8064
1360954620,1376001592,2,126,63,1360954605117,1360954613181,1375986709,1375994773,8064
1360954620,1376001664,2,126,63,1360954605044,1360954613108,1375986708,1375994772,8064
1360954684,1376065676,3,189,63,1360954680362,1360954683434,1376062038,1376065110,3072
1360954700,1376081612,2,126,63,1360954687530,1360954695530,1376069142,1376077142,8000
1360954820,1376201832,3,408,136,1360954793098,1360954799178,1376174930,1376181010,6080
1360954868,1376250056,12,999,83.25,1360954852841,1360954864361,1376234897,1376246417,11520
1360954868,1376250104,12,999,83.25,1360954852219,1360954864379,1376234323,1376246483,12160
1360954868,1376250128,12,999,83.25,1360954852450,1360954864290,1376234578,1376246418,11840
1360954868,1376250132,12,999,83.25,1360954853021,1360954864285,1376235153,1376246417,11264
1360955006,1376387352,1,46,46,1360954980774,1360954980774,1376362126,1376362126,0
1360955006,1376387848,1,46,46,1360954980151,1360954980151,1376361999,1376361999,0
1360955434,1376815368,3,408,136,1360955405136,1360955411152,1376786504,1376792520,6016
1360956043,1377425140,3,408,136,1360956015874,1360956021890,1377398014,1377404030,6016
1360956176,1377557256,2,92,46,1360956147892,1360956148916,1377529148,1377530172,1024
1360956180,1377561348,2,92,46,1360956154331,1360956154843,1377535679,1377536191,512
1360956653,1378034244,3,408,136,1360956627004,1360956633020,1378008248,1378014264,6016
1360956657,1378038288,14,6617,472.6428571,1360956629070,1360956629518,1378010358,1378010806,448
1360956657,1378038316,9,861,95.66666667,1360956629555,1360956629811,1378010871,1378011127,256
1360956657,1378038320,9,861,95.66666667,1360956629870,1360956630062,1378011190,1378011382,192
1360956847,1378228252,2,126,63,1360956844209,1360956845233,1378225461,1378226485,1024
1360956854,1378236140,2,126,63,1360956846391,1360956850423,1378228531,1378232563,4032
1360956870,1378252200,4,184,46,1360956862780,1360956863228,1378244980,1378245428,448
1360956870,1378252200,3,138,46,1360956862780,1360956862844,1378244980,1378245044,64
1360956870,1378252204,5,264,52.8,1360956858360,1360956862840,1378240564,1378245044,4480
1360956889,1378270764,9,861,95.66666667,1360956864368,1360956864560,1378246132,1378246324,192
1360956889,1378270856,9,861,95.66666667,1360956864595,1360956864723,1378246451,1378246579,128
1360956893,1378274676,9,861,95.66666667,1360956865030,1360956865222,1378246706,1378246898,192
1360956893,1378274772,8,815,101.875,1360956865191,1360956865383,1378246963,1378247155,192
1360957087,1378468216,3,189,63,1360957082063,1360957085071,1378463279,1378466287,3008
1360957087,1378468244,3,189,63,1360957080373,1360957083381,1378461617,1378464625,3008
1360957087,1378468308,3,189,63,1360957080437,1360957083445,1378461745,1378464753,3008
1360957089,1378470960,1,60,60,1360957062567,1360957062567,1378444527,1378444527,0
1360957103,1378484224,2,126,63,1360957087560,1360957095624,1378468784,1378476848,8064
1360957103,1378484260,2,126,63,1360957089061,1360957097125,1378470321,1378478385,8064
1360957103,1378484296,2,126,63,1360957087359,1360957095423,1378468655,1378476719,8064
1360957143,1378524296,4,252,63,1360957134079,1360957141183,1378515375,1378522479,7104
1360957174,1378555244,1,63,63,1360957149235,1360957149235,1378530479,1378530479,0
1360957266,1378647476,3,408,136,1360957238279,1360957244359,1378619755,1378625835,6080
1360957875,1379257156,3,408,136,1360957849497,1360957855449,1379231653,1379237605,5952
1360958120,1379501636,11,953,86.63636364,1360958106141,1360958117277,1379487777,1379498913,11136
1360958120,1379501716,16,6372,398.25,1360958105166,1360958117198,1379486882,1379498914,12032
1360958120,1379501716,11,953,86.63636364,1360958105548,1360958117196,1379487264,1379498912,11648
1360958120,1379501760,12,999,83.25,1360958105761,1360958117153,1379487521,1379498913,11392
1360958156,1379538076,6,3378,563,1360958128421,1360958153317,1379510497,1379535393,24896
1360958184,1379565616,11,953,86.63636364,1360958170928,1360958183024,1379552544,1379564640,12096
1360958184,1379565616,12,999,83.25,1360958171183,1360958183023,1379552799,1379564639,11840
1360958184,1379565640,11,953,86.63636364,1360958171416,1360958183000,1379553056,1379564640,11584
1360958184,1379565640,11,953,86.63636364,1360958171670,1360958182998,1379553310,1379564638,11328
1360958204,1379586124,1,664,664,1360958177396,1360958177396,1379559520,1379559520,0
1360958233,1379614236,1,48,48,1360958207529,1360958207529,1379588765,1379588765,0
1360958293,1379674508,9,861,95.66666667,1360958268763,1360958268955,1379650271,1379650463,192
1360958293,1379674584,8,815,101.875,1360958268429,1360958268621,1379650013,1379650205,192
1360958293,1379674584,8,815,101.875,1360958268173,1360958268365,1379649757,1379649949,192
1360958297,1379678604,8,815,101.875,1360958268919,1360958269111,1379650523,1379650715,192
1360958353,1379734728,13,6234,479.5384615,1360958328510,1360958328830,1379710238,1379710558,320
1360958357,1379738760,9,861,95.66666667,1360958328859,1360958329051,1379710619,1379710811,192
1360958357,1379738764,8,815,101.875,1360958329176,1360958329304,1379710940,1379711068,128
1360958357,1379738768,9,861,95.66666667,1360958329429,1360958329557,1379711197,1379711325,128
1360958464,1379845832,11,953,86.63636364,1360958448275,1360958460371,1379830107,1379842203,12096
1360958464,1379845836,12,999,83.25,1360958448526,1360958460366,1379830362,1379842202,11840
1360958464,1379845884,12,999,83.25,1360958449055,1360958460319,1379830939,1379842203,11264
1360958464,1379845916,11,953,86.63636364,1360958448767,1360958460287,1379830683,1379842203,11520
1360958489,1379870948,3,408,136,1360958461597,1360958467613,1379843545,1379849561,6016
1360958512,1379893856,11,953,86.63636364,1360958503929,1360958510393,1379885785,1379892249,6464
1360958512,1379893864,14,1428,102,1360958485360,1360958510384,1379867224,1379892248,25024
1360958512,1379893896,11,953,86.63636364,1360958486354,1360958504338,1379868250,1379886234,17984
1360958512,1379893940,11,953,86.63636364,1360958485540,1360958504356,1379867480,1379886296,18816
1360958512,1379893948,11,953,86.63636364,1360958485856,1360958504288,1379867804,1379886236,18432
1360958512,1379893988,11,953,86.63636364,1360958503540,1360958510260,1379885528,1379892248,6720
1360958513,1379894956,1,63,63,1360958485268,1360958485268,1379867224,1379867224,0
1360958520,1379901912,4,252,63,1360958511746,1360958518786,1379893658,1379900698,7040
1360958520,1379901912,4,252,63,1360958511746,1360958518786,1379893658,1379900698,7040
1360958529,1379911080,8,815,101.875,1360958504089,1360958504281,1379886169,1379886361,192
1360958553,1379935028,1,63,63,1360958526734,1360958526734,1379908762,1379908762,0
1360958553,1379935104,1,63,63,1360958526657,1360958526657,1379908761,1379908761,0
1360958600,1379981956,2,126,63,1360958598356,1360958599316,1379980312,1379981272,960
1360958608,1379989992,2,126,63,1360958601327,1360958605359,1379983319,1379987351,4032
1360958641,1380023164,1,63,63,1360958613252,1360958613252,1379995416,1379995416,0
1360958648,1380030032,2,126,63,1360958646086,1360958647110,1380028118,1380029142,1024
1360958648,1380030032,2,126,63,1360958646090,1360958647114,1380028122,1380029146,1024
1360958656,1380038008,2,126,63,1360958649120,1360958653152,1380031128,1380035160,4032
1360958656,1380038008,2,126,63,1360958649184,1360958653216,1380031192,1380035224,4032
1360958664,1380046040,2,126,63,1360958662015,1360958663039,1380044055,1380045079,1024
1360958672,1380054016,2,126,63,1360958665113,1360958669081,1380047129,1380051097,3968
1360958672,1380054056,3,189,63,1360958665007,1360958668015,1380047063,1380050071,3008
1360958688,1380069984,2,126,63,1360958672119,1360958680183,1380054103,1380062167,8064
1360958690,1380071236,1,63,63,1360958661987,1360958661987,1380043223,1380043223,0
1360958690,1380071320,1,63,63,1360958661905,1360958661905,1380043225,1380043225,0
1360958702,1380083460,1,48,48,1360958675907,1360958675907,1380057367,1380057367,0
1360958702,1380083576,1,63,63,1360958677585,1360958677585,1380059161,1380059161,0
1360958702,1380083668,1,48,48,1360958675762,1360958675762,1380057430,1380057430,0
1360958712,1380094024,3,138,46,1360958707661,1360958707725,1380089685,1380089749,64
1360958712,1380094028,5,1353,270.6,1360958711242,1360958711370,1380093270,1380093398,128
1360958720,1380101988,14,6671,476.5,1360958717234,1360958717682,1380099222,1380099670,448
1360958720,1380101992,17,9566,562.7058824,1360958713265,1360958713905,1380095257,1380095897,640
1360958720,1380101996,19,11339,596.7894737,1360958713835,1360958714539,1380095831,1380096535,704
1360958720,1380101996,14,6484,463.1428571,1360958712554,1360958717674,1380094550,1380099670,5120
1360958720,1380102000,5,1414,282.8,1360958718374,1360958718566,1380100374,1380100566,192
1360958720,1380102004,14,6671,476.5,1360958718563,1360958719011,1380100567,1380101015,448
1360958720,1380102036,24,21414,892.25,1360958711618,1360958712642,1380093654,1380094678,1024
1360958720,1380102036,14,6389,456.3571429,1360958711745,1360958712449,1380093781,1380094485,704
1360958720,1380102044,14,6502,464.4285714,1360958712442,1360958717626,1380094486,1380099670,5184
1360958720,1380102044,16,8379,523.6875,1360958717945,1360958718329,1380099989,1380100373,384
1360958720,1380102048,7,2447,349.5714286,1360958712758,1360958712950,1380094806,1380094998,192
1360958720,1380102048,6,3014,502.3333333,1360958718326,1360958718454,1380100374,1380100502,128
1360958720,1380102072,17,9379,551.7058824,1360958714397,1360958716125,1380096469,1380098197,1728
1360958720,1380102072,15,6184,412.2666667,1360958718431,1360958718879,1380100503,1380100951,448
1360958727,18421656,19,21947,1155.105263,1360958710598,1360958722630,18405254,18417286,12032
1360958727,18421660,4,1563,390.75,1360958713729,1360958724801,18408389,18419461,11072
1360958728,1380110008,15,4188,279.2,1360958714335,1360958723359,1380096343,1380105367,9024
1360958728,1380110052,4,1019,254.75,1360958717428,1360958724468,1380099480,1380106520,7040
1360958728,1380110056,15,3951,263.4,1360958712369,1360958723313,1380094425,1380105369,10944
1360958728,1380110084,25,17807,712.28,1360958710865,1360958722257,1380092949,1380104341,11392
1360958735,18429664,4,914,228.5,1360958717565,1360958729661,18412229,18424325,12096
1360958736,1380118044,8,5176,647,1360958718714,1360958730490,1380100758,1380112534,11776
1360958736,1380118052,30,8893,296.4333333,1360958711793,1360958729329,1380093845,1380111381,17536
1360958736,1380118080,18,7828,434.8888889,1360958718165,1360958730453,1380100245,1380112533,12288
1360958848,1380230120,15,6573,438.2,1360958844078,1360958844590,1380226198,1380226710,512
1360958848,1380230204,16,8627,539.1875,1360958845207,1360958845527,1380227411,1380227731,320
1360958856,1380238120,15,6184,412.2666667,1360958852589,1360958852909,1380234709,1380235029,320
1360958864,1380246072,15,6184,412.2666667,1360958856286,1360958856606,1380238358,1380238678,320
1360958864,1380246080,5,714,142.8,1360958854166,1360958862166,1380236246,1380244246,8000
1360958864,1380246084,7,4062,580.2857143,1360958854865,1360958862225,1380236949,1380244309,7360
1360958864,1380246124,15,5581,372.0666667,1360958854121,1360958855977,1380236245,1380238101,1856
1360958872,1380254064,40,44590,1114.75,1360958847907,1360958868195,1380229971,1380250259,20288
1360958872,1380254112,29,39025,1345.689655,1360958855987,1360958868083,1380238099,1380250195,12096
1360958952,1380334160,16,8510,531.875,1360958951493,1360958951813,1380333653,1380333973,320
1360958952,1380334200,16,6607,412.9375,1360958950173,1360958950749,1380332373,1380332949,576
1360958961,1380342228,15,6184,412.2666667,1360958959719,1360958960039,1380340947,1380341267,320
1360958968,1380350180,14,787,56.21428571,1360958960431,1360958960687,1380342611,1380342867,256
1360958978,1380359748,8,1697,212.125,1360958951648,1360958952224,1380333396,1380333972,576
1360958982,1380363728,23,26243,1141,1360958954420,1360958955188,1380336148,1380336916,768
1360958992,1380374144,3,183,61,1360958989842,1360958989842,1380371986,1380371986,0
1360959018,1380399832,1,52,52,1360958990154,1360958990154,1380371986,1380371986,0
1360959018,1380399908,1,46,46,1360958990078,1360958990078,1380371986,1380371986,0
1360959074,1380456056,3,405,135,1360959046826,1360959052842,1380428882,1380434898,6016
1360959120,1380501536,1,46,46,1360959091761,1360959091761,1380473297,1380473297,0
1360959121,1380502848,1,46,46,1360959091447,1360959091447,1380473295,1380473295,0
1360959813,1381194980,1,46,46,1360959786411,1360959786411,1381168391,1381168391,0
1360960049,1381430284,3,402,134,1360960023712,1360960029792,1381404996,1381411076,6080
1360960077,1381458380,1,46,46,1360960050173,1360960050173,1381431553,1381431553,0
1360960333,1381714864,12,6151,512.5833333,1360960308183,1360960308631,1381690047,1381690495,448
1360960333,1381714884,9,861,95.66666667,1360960308674,1360960308866,1381690558,1381690750,192
1360960337,1381718820,9,861,95.66666667,1360960308992,1360960309184,1381690812,1381691004,192
1360960337,1381718908,9,861,95.66666667,1360960309227,1360960309355,1381691135,1381691263,128
1360960578,1381959748,3,189,63,1360960571592,1360960574600,1381953340,1381956348,3008
1360960594,1381975768,2,126,63,1360960591412,1360960592436,1381973180,1381974204,1024
1360960594,1381975800,2,126,63,1360960578577,1360960586641,1381960377,1381968441,8064
1360960602,1381983744,2,126,63,1360960594506,1360960598538,1381976250,1381980282,4032
1360960634,1382015372,1,63,63,1360960606907,1360960606907,1381988279,1381988279,0
1360960634,1382015768,4,252,63,1360960625971,1360960633011,1382007739,1382014779,7040
1360960642,1382023788,4,252,63,1360960634783,1360960641823,1382016571,1382023611,7040
1360960666,1382047424,1,63,63,1360960641353,1360960641353,1382022777,1382022777,0
1360960678,1382059496,1,63,63,1360960650112,1360960650112,1382031608,1382031608,0
1360961195,1382576460,11,953,86.63636364,1360961179550,1360961189662,1382561010,1382571122,10112
1360961195,1382576508,12,999,83.25,1360961179181,1360961189613,1382560689,1382571121,10432
1360961195,1382576512,11,953,86.63636364,1360961179816,1360961189608,1382561328,1382571120,9792
1360961472,1382853452,1,48,48,1360961446242,1360961446242,1382827694,1382827694,0
1360961516,1382897908,3,408,136,1360961489047,1360961495127,1382870955,1382877035,6080
1360961840,1383221996,3,152,50.66666667,1360961813818,1360961822842,1383195814,1383204838,9024
1360961989,1383370308,1,46,46,1360961964007,1360961964007,1383345315,1383345315,0
1360962219,1383600952,12,999,83.25,1360962202210,1360962213154,1383584162,1383595106,10944
1360962219,1383601020,15,6289,419.2666667,1360962201694,1360962213150,1383583714,1383595170,11456
1360962219,1383601032,12,999,83.25,1360962202386,1360962213074,1383584418,1383595106,10688
1360962219,1383601032,11,953,86.63636364,1360962202706,1360962213074,1383584738,1383595106,10368
1360962338,1383719648,3,408,136,1360962311823,1360962317775,1383693471,1383699423,5952
1360962951,1384332560,3,408,136,1360962923295,1360962929247,1384304855,1384310807,5952
1360963216,1384597808,1,48,48,1360963188323,1360963188323,1384570131,1384570131,0
1360963217,1384598380,1,48,48,1360963188748,1360963188748,1384570128,1384570128,0
1360963560,1384941916,3,408,136,1360963534383,1360963540399,1384916299,1384922315,6016
1360963925,1385306764,1,46,46,1360963900036,1360963900036,1385281800,1385281800,0
1360964174,1385555456,3,408,136,1360964146610,1360964152626,1385528066,1385534082,6016
1360964471,1385852448,1,47,47,1360964444981,1360964444981,1385826429,1385826429,0
1360964475,1385856400,1,47,47,1360964446885,1360964446885,1385828285,1385828285,0
1360964783,1386164820,3,408,136,1360964757503,1360964763583,1386139323,1386145403,6080
1360964863,1386244960,3,144,48,1360964836400,1360964845424,1386218360,1386227384,9024
1360965396,1386778180,3,408,136,1360965368651,1360965374731,1386750831,1386756911,6080
1360965553,1386934672,1,46,46,1360965525764,1360965525764,1386907436,1386907436,0
1360966006,1387387944,3,408,136,1360965979822,1360965985838,1387361766,1387367782,6016
1360966319,1387700984,18,6970,387.2222222,1360966301059,1360966313859,1387683043,1387695843,12800
1360966319,1387700984,17,6418,377.5294118,1360966301441,1360966313921,1387683425,1387695905,12480
1360966319,1387700988,12,999,83.25,1360966302398,1360966313534,1387684386,1387695522,11136
1360966319,1387701064,13,1045,80.38461538,1360966301747,1360966313779,1387683811,1387695843,12032
1360966323,1387704396,13,1045,80.38461538,1360966302735,1360966314447,1387684131,1387695843,11712
1360966327,1387708404,11,3267,297,1360966300356,1360966301124,1387681760,1387682528,768
1360966436,1387817564,1,46,46,1360966409571,1360966409571,1387791135,1387791135,0
1360966436,1387817604,1,46,46,1360966409534,1360966409534,1387791138,1387791138,0
1360966567,1387948924,1,46,46,1360966542716,1360966542716,1387924640,1387924640,0
1360966619,1388000976,3,408,136,1360966591111,1360966597191,1387973087,1387979167,6080
1360966632,1388013668,2,141,70.5,1360966628856,1360966628856,1388010524,1388010524,0
1360966648,1388029872,11,953,86.63636364,1360966631980,1360966643692,1388013852,1388025564,11712
1360966648,1388029876,18,6801,377.8333333,1360966631592,1360966643688,1388013468,1388025564,12096
1360966648,1388029880,11,953,86.63636364,1360966632227,1360966643683,1388014107,1388025563,11456
1360966648,1388029960,12,999,83.25,1360966632406,1360966643606,1388014366,1388025566,11200
1360966655,1388037004,11,3267,297,1360966628651,1360966629227,1388010655,1388011231,576
1360966944,1388326092,2,141,70.5,1360966941517,1360966941517,1388323609,1388323609,0
1360966960,1388342088,17,6755,397.3529412,1360966944207,1360966956303,1388326295,1388338391,12096
1360966960,1388342092,12,999,83.25,1360966944846,1360966956238,1388326938,1388338330,11392
1360966960,1388342164,12,999,83.25,1360966944516,1360966956228,1388326680,1388338392,11712
1360966960,1388342168,12,999,83.25,1360966945025,1360966956161,1388327193,1388338329,11136
1360966968,1388349932,11,3267,297,1360966941228,1360966941804,1388323160,1388323736,576
1360967217,1388598216,3,193,64.33333333,1360967209138,1360967209202,1388590354,1388590418,64
1360967225,1388606204,12,999,83.25,1360967213313,1360967224513,1388594517,1388605717,11200
1360967225,1388606252,17,6755,397.3529412,1360967212369,1360967224465,1388593621,1388605717,12096
1360967225,1388606252,12,999,83.25,1360967213007,1360967224463,1388594259,1388605715,11456
1360967225,1388606332,12,999,83.25,1360967212674,1360967224386,1388594006,1388605718,11712
1360967229,1388610740,3,408,136,1360967202281,1360967208297,1388584021,1388590037,6016
1360967839,1389220504,3,408,136,1360967814028,1360967820044,1389195532,1389201548,6016
1360967881,1389262564,11,953,86.63636364,1360967867853,1360967879565,1389249417,1389261129,11712
1360967881,1389262572,12,999,83.25,1360967868358,1360967879494,1389249930,1389261066,11136
1360967881,1389262636,16,6372,398.25,1360967867400,1360967879496,1389249036,1389261132,12096
1360967881,1389262644,12,999,83.25,1360967868031,1360967879487,1389249675,1389261131,11456
1360968453,1389834364,3,408,136,1360968426191,1360968432271,1389807555,1389813635,6080
1360968485,1389866348,8,815,101.875,1360968460125,1360968460317,1389841473,1389841665,192
1360968485,1389866352,9,861,95.66666667,1360968460378,1360968460570,1389841730,1389841922,192
1360968485,1389866424,15,6663,444.2,1360968459666,1360968459986,1389841090,1389841410,320
1360968738,1390119328,3,189,63,1360968734702,1360968737710,1390116030,1390119038,3008
1360968738,1390119404,3,189,63,1360968734625,1360968737697,1390116029,1390119101,3072
1360968754,1390135324,2,126,63,1360968741745,1360968749809,1390123069,1390131133,8064
1360968754,1390135372,2,126,63,1360968741760,1360968749760,1390123132,1390131132,8000
1360968778,1390160056,1,46,46,1360968751251,1360968751251,1390133307,1390133307,0
1360968778,1390160064,1,46,46,1360968751371,1360968751371,1390133435,1390133435,0
1360968837,1390219068,9,861,95.66666667,1360968808967,1360968809159,1390191035,1390191227,192
1360968890,1390271540,4,252,63,1360968882517,1360968889557,1390264057,1390271097,7040
1360968925,1390307136,1,63,63,1360968897025,1360968897025,1390279161,1390279161,0
1360969058,1390439568,9,861,95.66666667,1360969033658,1360969033850,1390415226,1390415418,192
1360969058,1390439696,9,861,95.66666667,1360969033273,1360969033465,1390414969,1390415161,192
1360969062,1390443500,9,861,95.66666667,1360969034043,1360969034171,1390415543,1390415671,128
1360969062,1390443592,8,815,101.875,1360969034209,1360969034401,1390415801,1390415993,192
1360969062,1390443632,3,408,136,1360969036918,1360969042934,1390418550,1390424566,6016
1360969066,1390447836,2,126,63,1360969063980,1360969065004,1390445816,1390446840,1024
1360969074,1390455764,2,126,63,1360969067061,1360969071093,1390448825,1390452857,4032
1360969106,1390487540,1,63,63,1360969079378,1360969079378,1390460918,1390460918,0
1360969322,1390703976,3,189,63,1360969316186,1360969319194,1390698162,1390701170,3008
1360969338,1390720052,2,126,63,1360969323152,1360969331216,1390705204,1390713268,8064
1360969362,1390743988,3,189,63,1360969355856,1360969358928,1390737844,1390740916,3072
1360969378,1390760064,2,126,63,1360969362882,1360969370882,1390744946,1390752946,8000
1360969402,1390784112,3,189,63,1360969396306,1360969399314,1390778418,1390781426,3008
1360969402,1390784156,4,252,63,1360969394725,1360969401829,1390776881,1390783985,7104
1360969418,1390800152,2,126,63,1360969403308,1360969411372,1390785460,1390793524,8064
1360969435,1390816724,1,63,63,1360969410263,1360969410263,1390791987,1390791987,0
1360969675,1391056856,3,408,136,1360969648208,1360969654224,1391030064,1391036080,6016
1360969731,1391112380,17,6755,397.3529412,1360969717548,1360969728428,1391098928,1391109808,10880
1360969731,1391112384,12,999,83.25,1360969718184,1360969728424,1391099568,1391109808,10240
1360969731,1391112448,12,999,83.25,1360969717863,1360969728359,1391099311,1391109807,10496
1360970282,1391663340,1,46,46,1360970253130,1360970253130,1391634470,1391634470,0
1360970282,1391663340,1,46,46,1360970253129,1360970253129,1391634469,1391634469,0
1360970285,1391666460,3,408,136,1360970259024,1360970265104,1391640484,1391646564,6080
1360970503,1391884304,1,48,48,1360970475881,1360970475881,1391857185,1391857185,0
1360970503,1391884624,1,48,48,1360970475562,1360970475562,1391857186,1391857186,0
1360970894,1392275948,3,408,136,1360970869473,1360970875489,1392251421,1392257437,6016
1360971034,1392416048,9,861,95.66666667,1360971009208,1360971009400,1392391256,1392391448,192
1360971034,1392416052,14,6617,472.6428571,1360971008820,1360971009140,1392390872,1392391192,320
1360971034,1392416128,8,815,101.875,1360971009384,1360971009576,1392391512,1392391704,192
1360971117,1392498844,1,48,48,1360971087622,1360971087622,1392469466,1392469466,0
1360971117,1392498848,1,48,48,1360971087618,1360971087618,1392469466,1392469466,0
1360971195,1392576448,1,46,46,1360971168145,1360971168145,1392549593,1392549593,0
1360971303,1392684604,8,815,101.875,1360971276977,1360971277169,1392658581,1392658773,192
1360971303,1392684712,9,861,95.66666667,1360971277188,1360971277316,1392658900,1392659028,128
1360971303,1392684720,9,861,95.66666667,1360971277438,1360971277630,1392659158,1392659350,192
1360971303,1392684724,9,861,95.66666667,1360971277689,1360971277881,1392659413,1392659605,192
1360971307,1392688632,1,63,63,1360971281239,1360971281239,1392662871,1392662871,0
1360971307,1392688708,1,63,63,1360971281096,1360971281096,1392662804,1392662804,0
1360971317,1392698292,4,252,63,1360971309545,1360971316585,1392690837,1392697877,7040
1360971351,1392733120,1,63,63,1360971323821,1360971323821,1392705941,1392705941,0
1360971508,1392889552,3,408,136,1360971481697,1360971487713,1392863249,1392869265,6016
1360971525,1392906448,3,189,63,1360971519242,1360971522314,1392900690,1392903762,3072
1360971541,1392922392,2,126,63,1360971526402,1360971534402,1392907794,1392915794,8000
1360971605,1392986448,3,189,63,1360971601161,1360971604233,1392982609,1392985681,3072
1360971613,1392994452,2,126,63,1360971611845,1360971612869,1392993297,1392994321,1024
1360971621,1393002416,2,126,63,1360971608234,1360971616298,1392989650,1392997714,8064
1360971621,1393002432,2,126,63,1360971614937,1360971618905,1392996369,1393000337,3968
1360971652,1393034036,1,63,63,1360971626364,1360971626364,1393008400,1393008400,0
1360971688,1393070136,1,48,48,1360971662359,1360971662359,1393044495,1393044495,0
1360971693,1393074480,3,189,63,1360971689511,1360971692583,1393070991,1393074063,3072
1360971709,1393090528,2,126,63,1360971696503,1360971704567,1393078031,1393086095,8064
1360971739,31433856,5,573,114.6,1360971738833,1360971738961,31433689,31433817,128
1360971741,1393122540,12,999,83.25,1360971723372,1360971734572,1393104912,1393116112,11200
1360971741,1393122576,17,6755,397.3529412,1360971722438,1360971734534,1393104014,1393116110,12096
1360971741,1393122580,11,953,86.63636364,1360971722818,1360971734530,1393104398,1393116110,11712
1360971741,1393122584,12,999,83.25,1360971723072,1360971734528,1393104656,1393116112,11456
1360971993,1393375068,1,46,46,1360971967766,1360971967766,1393349834,1393349834,0
1360972037,1393419000,1,46,46,1360972009371,1360972009371,1393391371,1393391371,0
1360972097,1393479064,5,250,50,1360972072540,1360972094748,1393454604,1393476812,22208
1360972118,1393499192,3,408,136,1360972093443,1360972099459,1393474635,1393480651,6016
1360972146,1393527172,1,48,48,1360972119767,1360972119767,1393500939,1393500939,0
1360972173,1393555132,1,48,48,1360972148245,1360972148245,1393530377,1393530377,0
1360972731,1394112400,3,408,136,1360972705128,1360972711144,1394086528,1394092544,6016
1360973084,1394465240,1,48,48,1360973059588,1360973059588,1394440828,1394440828,0
1360973087,1394468764,12,999,83.25,1360973070455,1360973080183,1394452219,1394461947,9728
1360973087,1394468804,12,999,83.25,1360973070158,1360973080142,1394451962,1394461946,9984
1360973087,1394468808,11,953,86.63636364,1360973070668,1360973080076,1394452476,1394461884,9408
1360973100,1394481452,11,3267,297,1360973074478,1360973075118,1394455930,1394456570,640
1360973111,1394492888,3,193,64.33333333,1360973108601,1360973108665,1394490489,1394490553,64
1360973344,1394725396,3,408,136,1360973316194,1360973322210,1394697590,1394703606,6016
1360973644,1395025920,1,46,46,1360973619282,1360973619282,1395001202,1395001202,0
1360973953,1395334544,3,408,136,1360973928006,1360973934022,1395309550,1395315566,6016
1360973985,1395366560,13,6234,479.5384615,1360973960117,1360973960437,1395341677,1395341997,320
1360973985,1395366568,8,815,101.875,1360973960494,1360973960686,1395342062,1395342254,192
1360973985,1395366672,7,769,109.8571429,1360973958982,1360973959750,1395340654,1395341422,768
1360974109,1395491144,1,46,46,1360974084203,1360974084203,1395466347,1395466347,0
1360974110,1395491312,1,46,46,1360974085101,1360974085101,1395466413,1395466413,0
1360974216,1395597532,4,252,63,1360974208527,1360974215567,1395590059,1395597099,7040
1360974235,1395616472,1,64,64,1360974206283,1360974206283,1395587755,1395587755,0
1360974236,1395617760,1,64,64,1360974205993,1360974205993,1395587753,1395587753,0
1360974249,1395631072,1,63,63,1360974223090,1360974223090,1395605162,1395605162,0
1360974253,1395635056,8,815,101.875,1360974226240,1360974226432,1395608296,1395608488,192
1360974253,1395635060,9,861,95.66666667,1360974226492,1360974227132,1395608552,1395609192,640
1360974253,1395635080,8,815,101.875,1360974227176,1360974227944,1395609256,1395610024,768
1360974253,1395635136,9,861,95.66666667,1360974225906,1360974226098,1395608042,1395608234,192
1360974264,1395645560,2,126,63,1360974261873,1360974262897,1395643433,1395644457,1024
1360974264,1395645560,2,126,63,1360974261937,1360974262961,1395643497,1395644521,1024
1360974272,1395653596,2,126,63,1360974264845,1360974268877,1395646441,1395650473,4032
1360974272,1395653596,2,126,63,1360974264972,1360974268940,1395646568,1395650536,3968
1360974301,1395683140,1,63,63,1360974276460,1360974276460,1395658600,1395658600,0
1360974302,1395683188,1,63,63,1360974277349,1360974277349,1395658537,1395658537,0
1360974456,1395837732,3,189,63,1360974450883,1360974453891,1395832615,1395835623,3008
1360974464,1395845700,4,252,63,1360974456226,1360974463330,1395837926,1395845030,7104
1360974464,1395845744,4,252,63,1360974456179,1360974463219,1395837923,1395844963,7040
1360974472,1395853752,2,126,63,1360974457900,1360974465964,1395839652,1395847716,8064
1360974498,1395879312,1,63,63,1360974471717,1360974471717,1395853029,1395853029,0
1360974498,1395879388,1,63,63,1360974471641,1360974471641,1395853029,1395853029,0
1360974544,1395925756,3,189,63,1360974538665,1360974541737,1395920421,1395923493,3072
1360974560,1395941808,2,126,63,1360974545654,1360974553718,1395927462,1395935526,8064
1360974566,1395947636,3,408,136,1360974539873,1360974545889,1395921509,1395927525,6016
1360975179,1396560528,3,408,136,1360975151616,1360975157632,1396533144,1396539160,6016
1360975271,1396652804,3,408,136,1360975243181,1360975249197,1396624985,1396631001,6016
1360975388,1396769240,1,46,46,1360975361822,1360975361822,1396743062,1396743062,0
1360975520,1396901400,1,48,48,1360975494335,1360975494335,1396875735,1396875735,0
1360975540,1396921772,2,230,115,1360975514377,1360975514441,1396896149,1396896213,64
1360975777,1397158224,9,861,95.66666667,1360975749994,1360975750122,1397131218,1397131346,128
1360975777,1397158228,9,861,95.66666667,1360975750246,1360975750886,1397131474,1397132114,640
1360975777,1397158300,13,6234,479.5384615,1360975749469,1360975749789,1397130769,1397131089,320
1360975777,1397158340,10,907,90.7,1360975750837,1360975752053,1397132177,1397133393,1216
1360975789,1397170220,1,60,60,1360975761837,1360975761837,1397143057,1397143057,0
1360975793,1397174352,1,60,60,1360975766827,1360975766827,1397148179,1397148179,0
1360975961,1397342372,1,60,60,1360975934097,1360975934097,1397315469,1397315469,0
1360975965,1397346476,1,60,60,1360975939051,1360975939051,1397320527,1397320527,0
1360975973,1397354412,1,60,60,1360975948139,1360975948139,1397329551,1397329551,0
1360975981,1397362420,1,60,60,1360975952930,1360975952930,1397334350,1397334350,0
1360976017,1397398728,3,189,63,1360976010351,1360976013359,1397392079,1397395087,3008
1360976033,1397414564,1,60,60,1360976007056,1360976007056,1397388620,1397388620,0
1360976033,1397414752,2,126,63,1360976017367,1360976025431,1397399119,1397407183,8064
1360976033,1397414792,3,189,63,1360976026479,1360976029487,1397408271,1397411279,3008
1360976041,1397422560,1,60,60,1360976013652,1360976013652,1397395212,1397395212,0
1360976049,1397430788,2,126,63,1360976033521,1360976041585,1397415309,1397423373,8064
1360976113,1397494856,3,189,63,1360976109166,1360976112174,1397491022,1397494030,3008
1360976129,1397510952,2,126,63,1360976116108,1360976124172,1397498060,1397506124,8064
1360976161,1397542936,3,189,63,1360976155677,1360976158749,1397537613,1397540685,3072
1360976177,1397558932,2,126,63,1360976162717,1360976170781,1397544649,1397552713,8064
1360976225,1397606880,2,122,61,1360976199252,1360976201364,1397581132,1397583244,2112
1360976365,1397746996,1,46,46,1360976340571,1360976340571,1397722567,1397722567,0
1360976526,1397907252,1,46,46,1360976499586,1360976499586,1397880838,1397880838,0
1360976830,1398211512,3,144,48,1360976803001,1360976812025,1398184513,1398193537,9024
1360976978,1398359900,17,6755,397.3529412,1360976960691,1360976972083,1398342591,1398353983,11392
1360976978,1398359900,11,953,86.63636364,1360976961330,1360976972082,1398343230,1398353982,10752
1360976978,1398359904,12,999,83.25,1360976961645,1360976972077,1398343549,1398353981,10432
1360976982,1398363560,12,999,83.25,1360976961415,1360976972423,1398342975,1398353983,11008
1360977090,1398472120,1,46,46,1360977064151,1360977064151,1398446271,1398446271,0
1360977435,1398816860,1,46,46,1360977407828,1360977407828,1398789688,1398789688,0
1360977947,1399328172,1,46,46,1360977920701,1360977920701,1399301873,1399301873,0
1360977947,1399328340,1,46,46,1360977920533,1360977920533,1399301873,1399301873,0
1360978622,1400003688,13,6234,479.5384615,1360978597677,1360978597997,1399979365,1399979685,320
1360978626,1400007588,9,861,95.66666667,1360978598418,1360978598610,1399980006,1399980198,192
1360978626,1400007636,9,861,95.66666667,1360978598114,1360978598306,1399979750,1399979942,192
1360978626,1400007640,8,815,101.875,1360978598687,1360978598879,1399980327,1399980519,192
1360978828,1400209200,2,126,63,1360978826193,1360978827217,1400207393,1400208417,1024
1360978836,1400217220,2,126,63,1360978829184,1360978833216,1400210404,1400214436,4032
1360978866,1400248116,1,63,63,1360978840383,1360978840383,1400222499,1400222499,0
1360978908,1400289172,3,189,63,1360978901486,1360978904558,1400282658,1400285730,3072
1360978916,1400297512,3,189,63,1360978910744,1360978913816,1400292256,1400295328,3072
1360978916,1400297512,3,189,63,1360978910808,1360978913816,1400292320,1400295328,3008
1360978924,1400305168,2,126,63,1360978908594,1360978916658,1400289762,1400297826,8064
1360978932,1400313184,2,126,63,1360978918113,1360978926177,1400299297,1400307361,8064
1360978932,1400313204,2,126,63,1360978918156,1360978926220,1400299360,1400307424,8064
1360978933,38627748,5,573,114.6,1360978932330,1360978932394,38627078,38627142,64
1360978940,1400321156,11,953,86.63636364,1360978925053,1360978935037,1400306209,1400316193,9984
1360978940,1400321160,11,953,86.63636364,1360978925307,1360978935035,1400306467,1400316195,9728
1360978940,1400321160,11,953,86.63636364,1360978925562,1360978935034,1400306722,1400316194,9472
1360978940,1400321224,11,953,86.63636364,1360978925753,1360978934969,1400306977,1400316193,9216
1360979508,1400889788,13,6234,479.5384615,1360979482556,1360979482876,1400864344,1400864664,320
1360979508,1400889792,8,815,101.875,1360979483255,1360979483383,1400865047,1400865175,128
1360979508,1400889796,9,861,95.66666667,1360979482934,1360979483126,1400864730,1400864922,192
1360979508,1400889796,9,861,95.66666667,1360979483507,1360979483635,1400865303,1400865431,128
1360979748,1401129692,3,189,63,1360979742809,1360979745817,1401124501,1401127509,3008
1360979756,1401137740,2,126,63,1360979754599,1360979755559,1401136339,1401137299,960
1360979756,1401137744,2,126,63,1360979754595,1360979755555,1401136339,1401137299,960
1360979764,1401145708,2,126,63,1360979757642,1360979761674,1401139350,1401143382,4032
1360979764,1401145708,2,126,63,1360979757641,1360979761673,1401139349,1401143381,4032
1360979764,1401145752,2,126,63,1360979749789,1360979757853,1401131541,1401139605,8064
1360979772,1401153768,4,252,63,1360979764109,1360979771149,1401145877,1401152917,7040
1360979797,1401178628,1,63,63,1360979769818,1360979769818,1401151446,1401151446,0
1360979797,1401178700,1,63,63,1360979769745,1360979769745,1401151445,1401151445,0
1360979805,1401186668,1,63,63,1360979779310,1360979779310,1401160978,1401160978,0
1360980394,1401775488,8,815,101.875,1360980369370,1360980369562,1401750858,1401751050,192
1360980394,1401775556,13,6234,479.5384615,1360980368341,1360980368661,1401749897,1401750217,320
1360980394,1401775560,9,861,95.66666667,1360980368787,1360980368915,1401750347,1401750475,128
1360980394,1401775564,9,861,95.66666667,1360980369039,1360980369231,1401750603,1401750795,192
1360980581,1401962340,2,126,63,1360980579499,1360980580523,1401960839,1401961863,1024
1360980589,1401970296,2,126,63,1360980582551,1360980586583,1401963847,1401967879,4032
1360980613,1401994376,3,189,63,1360980606343,1360980609351,1401987719,1401990727,3008
1360980621,1402002292,1,63,63,1360980594650,1360980594650,1401975942,1401975942,0
1360980629,1402010316,2,126,63,1360980613441,1360980621505,1401994757,1402002821,8064
1360980685,1402066344,2,92,46,1360980679975,1360980679975,1402061319,1402061319,0
1360980685,1402066388,2,92,46,1360980679928,1360980679928,1402061316,1402061316,0
1360980701,1402082364,11,953,86.63636364,1360980682706,1360980693778,1402064070,1402075142,11072
1360980701,1402082400,16,6372,398.25,1360980681709,1360980693805,1402063109,1402075205,12096
1360980701,1402082444,11,953,86.63636364,1360980682048,1360980693760,1402063492,1402075204,11712
1360980701,1402082444,11,953,86.63636364,1360980682371,1360980693763,1402063815,1402075207,11392
1360980707,1402088300,2,109,54.5,1360980680017,1360980680017,1402061317,1402061317,0
1360980707,1402088300,2,109,54.5,1360980680016,1360980680016,1402061316,1402061316,0
1360981143,1402524988,1,48,48,1360981116187,1360981116187,1402498175,1402498175,0
1360981277,1402658748,12,999,83.25,1360981263498,1360981273610,1402645246,1402655358,10112
1360981277,1402658792,12,999,83.25,1360981263711,1360981273567,1402645503,1402655359,9856
1360981277,1402658792,12,999,83.25,1360981263964,1360981273564,1402645756,1402655356,9600
1360981277,1402658828,18,6801,377.8333333,1360981263032,1360981273528,1402644860,1402655356,10496
1360981540,1402921600,1,46,46,1360981511961,1360981511961,1402893561,1402893561,0
1360982442,1403823372,1,46,46,1360982416816,1360982416816,1403798188,1403798188,0
1360982474,1403855296,1,46,46,1360982447035,1360982447035,1403828331,1403828331,0
1360982507,1403888404,1,46,46,1360982479245,1360982479245,1403860649,1403860649,0
1360982508,1403889392,1,46,46,1360982479257,1360982479257,1403860649,1403860649,0
1360982622,1404003536,1,46,46,1360982594887,1360982594887,1403976423,1403976423,0
1360982714,1404095484,1,46,46,1360982687932,1360982687932,1404069416,1404069416,0
1360983071,1404452428,12,999,83.25,1360983060269,1360983070701,1404441697,1404452129,10432
1360983071,1404452468,16,6372,398.25,1360983059398,1360983070534,1404440866,1404452002,11136
1360983071,1404452468,9,861,95.66666667,1360983059844,1360983070468,1404441312,1404451936,10624
1360983071,1404452500,12,999,83.25,1360983061605,1360983070629,1404443105,1404452129,9024
1360983380,1404762024,1,48,48,1360983352148,1360983352148,1404734172,1404734172,0
1360983380,1404762028,1,48,48,1360983352209,1360983352209,1404734237,1404734237,0
1360983872,1405254096,1,46,46,1360983846727,1360983846727,1405228823,1405228823,0
1360984534,1405915960,3,156,52,1360984507204,1360984516292,1405889164,1405898252,9088
1360984775,1406156544,3,156,52,1360984748510,1360984757470,1406130054,1406139014,8960
1360984872,1406253584,11,953,86.63636364,1360984859444,1360984870452,1406241028,1406252036,11008
1360984872,1406253584,12,999,83.25,1360984859702,1360984870454,1406241286,1406252038,10752
1360984872,1406253584,12,999,83.25,1360984859956,1360984870452,1406241540,1406252036,10496
1360984872,1406253600,16,6372,398.25,1360984858983,1360984870503,1406240583,1406252103,11520
1360985597,1406979096,3,144,48,1360985570667,1360985579499,1406952763,1406961595,8832
1360985742,1407123492,2,122,61,1360985716419,1360985718851,1407097911,1407100343,2432
1360985810,1407191652,2,122,61,1360985783268,1360985785700,1407164920,1407167352,2432
1360986659,1408040584,2,92,46,1360986658139,1360986658203,1408039723,1408039787,64
1360986675,1408056580,16,6372,398.25,1360986658207,1360986669855,1408039787,1408051435,11648
1360986675,1408056584,11,953,86.63636364,1360986658907,1360986669787,1408040491,1408051371,10880
1360986675,1408056588,13,1045,80.38461538,1360986659159,1360986669783,1408040747,1408051371,10624
1360986675,1408056628,12,999,83.25,1360986658608,1360986669744,1408040236,1408051372,11136
1360987842,1409223920,1,48,48,1360987815863,1360987815863,1409197783,1409197783,0
1360988420,1409801508,44,56779,1290.431818,1360988419276,1360988419596,1409800784,1409801104,320
1360988436,1409817488,12,999,83.25,1360988423391,1360988432671,1409804879,1409814159,9280
1360988436,1409817492,12,999,83.25,1360988423644,1360988432604,1409805136,1409814096,8960
1360988436,1409817536,16,6372,398.25,1360988420528,1360988432624,1409802064,1409814160,12096
1360988436,1409817568,17,6755,397.3529412,1360988422928,1360988432592,1409804496,1409814160,9664
1360988632,1410013172,1,48,48,1360988607258,1360988607258,1409988430,1409988430,0
1360988632,1410013208,1,48,48,1360988605620,1360988605620,1409986828,1409986828,0
1360988796,1410177592,1,48,48,1360988771635,1360988771635,1410153227,1410153227,0
1360988992,1410373684,1,48,48,1360988966483,1360988966483,1410348167,1410348167,0
1360989020,1410401956,17,6418,377.5294118,1360989000515,1360989012611,1410382471,1410394567,12096
1360989020,1410401960,12,999,83.25,1360989001406,1360989012542,1410383366,1410394502,11136
1360989020,1410401996,12,999,83.25,1360989000860,1360989012508,1410382856,1410394504,11648
1360989020,1410401996,12,999,83.25,1360989001114,1360989012506,1410383110,1410394502,11392
1360989826,1411207956,1,48,48,1360989799352,1360989799352,1411181308,1411181308,0
1360989914,1411295980,1,46,46,1360989887965,1360989887965,1411269945,1411269945,0
1360989914,1411296004,9,861,95.66666667,1360989888644,1360989888900,1411270648,1411270904,256
1360989914,1411296008,9,861,95.66666667,1360989888386,1360989888578,1411270394,1411270586,192
1360989914,1411296052,13,6234,479.5384615,1360989887957,1360989888277,1411270009,1411270329,320
1360989914,1411296060,8,815,101.875,1360989888909,1360989889101,1411270969,1411271161,192
1360990039,1411420636,1,58,58,1360990012340,1360990012340,1411393976,1411393976,0
1360990063,1411444692,1,58,58,1360990038395,1360990038395,1411420087,1411420087,0
1360990085,1411466744,3,189,63,1360990081542,1360990084614,1411463286,1411466358,3072
1360990101,1411482776,2,126,63,1360990088550,1360990096614,1411470326,1411478390,8064
1360990141,1411522788,3,189,63,1360990135898,1360990138906,1411517686,1411520694,3008
1360990157,1411538744,2,126,63,1360990142981,1360990151045,1411524725,1411532789,8064
1360990181,1411562748,2,126,63,1360990179391,1360990180415,1411561139,1411562163,1024
1360990181,1411562748,2,126,63,1360990179458,1360990180482,1411561206,1411562230,1024
1360990189,1411570756,2,126,63,1360990182522,1360990186554,1411564278,1411568310,4032
1360990189,1411570796,2,126,63,1360990182415,1360990186383,1411564211,1411568179,3968
1360990219,1411600932,1,63,63,1360990194311,1360990194311,1411576243,1411576243,0
1360990219,1411600932,1,63,63,1360990194439,1360990194439,1411576371,1411576371,0
1360990476,1411857976,1,46,46,1360990450713,1360990450713,1411832689,1411832689,0
1360990477,1411858396,1,46,46,1360990451294,1360990451294,1411832690,1411832690,0
1360990496,1411877128,1,95,95,1360990470311,1360990470311,1411851439,1411851439,0
1360990660,1412041492,1,46,46,1360990634041,1360990634041,1412015533,1412015533,0
1360991254,1412635752,1,46,46,1360991228139,1360991228139,1412609891,1412609891,0
1360991255,1412636676,1,46,46,1360991228154,1360991228154,1412609830,1412609830,0
1360991402,1412783512,1,46,46,1360991375004,1360991375004,1412756516,1412756516,0
1360991403,1412784556,1,46,46,1360991374958,1360991374958,1412756514,1412756514,0
1360991465,1412846812,4,244,61,1360991438316,1360991449004,1412820128,1412830816,10688
1360991706,1413087232,9,861,95.66666667,1360991680237,1360991680429,1413061469,1413061661,192
1360991706,1413087276,14,6617,472.6428571,1360991679488,1360991679808,1413060764,1413061084,320
1360991706,1413087280,9,861,95.66666667,1360991679933,1360991680061,1413061213,1413061341,128
1360991911,1413292164,3,189,63,1360991904047,1360991907055,1413285211,1413288219,3008
1360991927,1413308160,2,126,63,1360991911092,1360991919156,1413292252,1413300316,8064
1360991951,1413332164,3,189,63,1360991946734,1360991949742,1413327898,1413330906,3008
1360991951,1413332168,3,189,63,1360991947433,1360991950441,1413328601,1413331609,3008
1360991967,1413348200,2,92,46,1360991966857,1360991966857,1413348057,1413348057,0
1360991967,1413348212,4,218,54.5,1360991953725,1360991966845,1413334937,1413348057,13120
1360991967,1413348236,4,218,54.5,1360991954404,1360991966820,1413335640,1413348056,12416
1360991975,1413356160,2,109,54.5,1360991966962,1360991966962,1413348122,1413348122,0
1360991975,1413356160,2,109,54.5,1360991966962,1360991966962,1413348122,1413348122,0
1360991994,1413375804,9,861,95.66666667,1360991967020,1360991967212,1413348824,1413349016,192
1360991994,1413375880,10,907,90.7,1360991967202,1360991968354,1413349082,1413350234,1152
1360991994,1413375880,1,46,46,1360991967393,1360991967393,1413349273,1413349273,0
1360991994,1413375888,8,815,101.875,1360991968474,1360991968666,1413350362,1413350554,192
1360991994,1413375888,9,861,95.66666667,1360991968793,1360991968921,1413350681,1413350809,128
1360992094,1413475952,1,46,46,1360992069080,1360992069080,1413451032,1413451032,0
1360992183,1413564432,2,126,63,1360992180445,1360992181469,1413561877,1413562901,1024
1360992191,1413572420,2,126,63,1360992183467,1360992187563,1413564887,1413568983,4096
1360992199,1413580464,3,189,63,1360992195518,1360992198526,1413576982,1413579990,3008
1360992215,1413596480,2,126,63,1360992202540,1360992210604,1413584020,1413592084,8064
1360992222,1413604072,1,63,63,1360992194910,1360992194910,1413576982,1413576982,0
1360992287,1413668476,3,189,63,1360992282223,1360992285231,1413663699,1413666707,3008
1360992303,1413684544,2,126,63,1360992289197,1360992297261,1413670741,1413678805,8064
1360992359,1413740564,2,126,63,1360992357270,1360992358230,1413738834,1413739794,960
1360992367,1413748548,2,126,63,1360992360293,1360992364325,1413741841,1413745873,4032
1360992399,1413780292,1,63,63,1360992372645,1360992372645,1413753937,1413753937,0
1360992708,1414090032,1,48,48,1360992679742,1360992679742,1414061774,1414061774,0
1360992708,1414090036,1,48,48,1360992679739,1360992679739,1414061775,1414061775,0
1360992996,1414377368,1,46,46,1360992968082,1360992968082,1414349450,1414349450,0
1360993493,1414874528,14,6617,472.6428571,1360993467947,1360993468267,1414849475,1414849795,320
1360993493,1414874532,9,861,95.66666667,1360993468646,1360993468838,1414850178,1414850370,192
1360993493,1414874572,8,815,101.875,1360993468286,1360993468478,1414849858,1414850050,192
1360993497,1414878496,8,815,101.875,1360993468938,1360993469130,1414850434,1414850626,192
1360993557,1414938612,1,46,46,1360993531988,1360993531988,1414913600,1414913600,0
1360993557,1414938612,1,46,46,1360993531988,1360993531988,1414913600,1414913600,0
1360993557,1414938616,1,46,46,1360993531983,1360993531983,1414913599,1414913599,0
1360993557,1414938616,1,46,46,1360993532051,1360993532051,1414913667,1414913667,0
1360993557,1414938616,1,46,46,1360993532051,1360993532051,1414913667,1414913667,0
1360993557,1414938616,1,46,46,1360993532050,1360993532050,1414913666,1414913666,0
1360993557,1414938664,1,46,46,1360993531874,1360993531874,1414913538,1414913538,0
1360993557,1414938664,1,46,46,1360993531874,1360993531874,1414913538,1414913538,0
1360993557,1414938664,1,46,46,1360993531938,1360993531938,1414913602,1414913602,0
1360993557,1414938664,1,46,46,1360993531936,1360993531936,1414913600,1414913600,0
1360993557,1414938664,1,46,46,1360993531936,1360993531936,1414913600,1414913600,0
1360993557,1414938664,1,46,46,1360993532000,1360993532000,1414913664,1414913664,0
1360993730,1415111992,1,48,48,1360993704792,1360993704792,1415086784,1415086784,0
1360993731,1415112844,1,48,48,1360993704939,1360993704939,1415086783,1415086783,0
1360993761,1415142572,4,252,63,1360993752121,1360993759225,1415133693,1415140797,7104
1360993761,1415142572,4,252,63,1360993752121,1360993759161,1415133693,1415140733,7040
1360993769,1415150628,4,252,63,1360993760705,1360993767745,1415142333,1415149373,7040
1360993769,1415151056,4,252,63,1360993760277,1360993767317,1415142333,1415149373,7040
1360993793,1415175088,1,63,63,1360993766710,1360993766710,1415148798,1415148798,0
1360993793,1415175088,1,63,63,1360993766709,1360993766709,1415148797,1415148797,0
1360993802,1415183132,1,63,63,1360993776306,1360993776306,1415157438,1415157438,0
1360993802,1415183180,1,63,63,1360993776257,1360993776257,1415157437,1415157437,0
1360994379,1415760816,14,6617,472.6428571,1360994354044,1360994354364,1415735860,1415736180,320
1360994379,1415760852,8,815,101.875,1360994354650,1360994354842,1415736502,1415736694,192
1360994379,1415760888,9,861,95.66666667,1360994354357,1360994354549,1415736245,1415736437,192
1360994383,1415764832,8,815,101.875,1360994354925,1360994355117,1415736757,1415736949,192
1360994602,1415983144,2,126,63,1360994598938,1360994599898,1415980082,1415981042,960
1360994602,1415983180,2,126,63,1360994598902,1360994599862,1415980082,1415981042,960
1360994602,1415983180,2,126,63,1360994599094,1360994600118,1415980274,1415981298,1024
1360994602,1415983180,2,126,63,1360994599221,1360994600245,1415980401,1415981425,1024
1360994610,1415991124,2,126,63,1360994602158,1360994606190,1415983282,1415987314,4032
1360994610,1415991124,2,126,63,1360994602285,1360994606317,1415983409,1415987441,4032
1360994610,1415991140,2,126,63,1360994601950,1360994605982,1415983090,1415987122,4032
1360994610,1415991140,2,126,63,1360994601950,1360994605982,1415983090,1415987122,4032
1360994640,1416021420,1,63,63,1360994613956,1360994613956,1415995376,1415995376,0
1360994640,1416021468,1,63,63,1360994613651,1360994613651,1415995119,1415995119,0
1360994640,1416021468,1,63,63,1360994613651,1360994613651,1415995119,1415995119,0
1360994640,1416021492,1,63,63,1360994614013,1360994614013,1415995505,1415995505,0
1360994740,1416121824,9,861,95.66666667,1360994714736,1360994714928,1416096560,1416096752,192
1360994740,1416121828,8,815,101.875,1360994714989,1360994715181,1416096817,1416097009,192
1360994740,1416121828,9,861,95.66666667,1360994715243,1360994715435,1416097071,1416097263,192
1360994740,1416121872,8,815,101.875,1360994714432,1360994714624,1416096304,1416096496,192
1360994962,1416343444,2,126,63,1360994959592,1360994960616,1416341036,1416342060,1024
1360994970,1416351424,2,126,63,1360994962620,1360994966652,1416344044,1416348076,4032
1360994970,1416351428,3,189,63,1360994966326,1360994969334,1416347754,1416350762,3008
1360994970,1416351460,4,252,63,1360994961497,1360994968537,1416342957,1416349997,7040
1360994986,1416367404,2,126,63,1360994973391,1360994981455,1416354795,1416362859,8064
1360995001,1416382192,1,63,63,1360994974946,1360994974946,1416356138,1416356138,0
1360995005,1416386124,1,63,63,1360994976936,1360994976936,1416358060,1416358060,0
1360995010,1416391420,2,126,63,1360995008191,1360995009215,1416389611,1416390635,1024
1360995018,1416399468,2,126,63,1360995011215,1360995015247,1416392683,1416396715,4032
1360995049,1416430240,1,63,63,1360995023474,1360995023474,1416404714,1416404714,0
1360995799,1417180204,1,84,84,1360995772555,1360995772555,1417153759,1417153759,0
1360996500,1417881956,1,46,46,1360996474000,1360996474000,1417855956,1417855956,0
1360996528,1417909984,14,6617,472.6428571,1360996502962,1360996503282,1417884946,1417885266,320
1360996528,1417909988,9,861,95.66666667,1360996503344,1360996503536,1417885332,1417885524,192
1360996528,1417910024,16,7737,483.5625,1360996502604,1360996502860,1417884628,1417884884,256
1360996528,1417910032,9,861,95.66666667,1360996503556,1360996503812,1417885588,1417885844,256
1360996532,1417913940,9,861,95.66666667,1360996503969,1360996504161,1417885909,1417886101,192
1360996747,1418128648,3,189,63,1360996742977,1360996746049,1418124625,1418127697,3072
1360996763,1418144640,2,126,63,1360996750088,1360996758088,1418131728,1418139728,8000
1360996771,1418152700,3,189,63,1360996767307,1360996770315,1418149007,1418152015,3008
1360996787,1418168660,2,126,63,1360996774388,1360996782452,1418156048,1418164112,8064
1360996795,1418176676,3,189,63,1360996788642,1360996791650,1418170318,1418173326,3008
1360996811,1418192656,2,126,63,1360996795705,1360996803769,1418177361,1418185425,8064
1360996827,1418208672,4,252,63,1360996819048,1360996826088,1418200720,1418207760,7040
1360996835,1418216644,4,252,63,1360996827395,1360996834499,1418209039,1418216143,7104
1360996861,1418242548,1,63,63,1360996834274,1360996834274,1418215822,1418215822,0
1360996869,1418250600,1,63,63,1360996842544,1360996842544,1418224144,1418224144,0
1360997414,1418795240,9,861,95.66666667,1360997389712,1360997389840,1418770952,1418771080,128
1360997418,1418799188,9,861,95.66666667,1360997390338,1360997390594,1418771526,1418771782,256
1360997418,1418799232,8,815,101.875,1360997389974,1360997390166,1418771206,1418771398,192
1360997594,1418975432,1,46,46,1360997568588,1360997568588,1418950020,1418950020,0
1360997612,1418993288,3,189,63,1360997605597,1360997608605,1418986885,1418989893,3008
1360997626,1419007404,1,46,46,1360997599398,1360997599398,1418980802,1418980802,0
1360997628,1419009316,2,126,63,1360997612608,1360997620672,1418993924,1419001988,8064
1360997668,1419049288,15,6289,419.2666667,1360997654617,1360997666713,1419035905,1419048001,12096
1360997668,1419049296,12,999,83.25,1360997655571,1360997666707,1419036867,1419048003,11136
1360997668,1419049328,11,953,86.63636364,1360997655281,1360997666673,1419036609,1419048001,11392
1360997668,1419049328,12,999,83.25,1360997655024,1360997666672,1419036352,1419048000,11648
1360997724,1419105364,3,189,63,1360997717005,1360997720077,1419098369,1419101441,3072
1360997724,1419105364,3,189,63,1360997717005,1360997720077,1419098369,1419101441,3072
1360997740,1419121296,2,126,63,1360997724175,1360997732239,1419105471,1419113535,8064
1360997740,1419121312,2,126,63,1360997724096,1360997732160,1419105408,1419113472,8064
1360998007,1419388284,1,46,46,1360997981656,1360997981656,1419362940,1419362940,0
1360998035,1419416336,1,48,48,1360998008548,1360998008548,1419389884,1419389884,0
1360998068,1419449772,12,999,83.25,1360998053938,1360998064626,1419435710,1419446398,10688
1360998068,1419449800,17,6418,377.5294118,1360998052947,1360998064595,1419434747,1419446395,11648
1360998068,1419449804,12,999,83.25,1360998053327,1360998064591,1419435131,1419446395,11264
1360998068,1419449804,12,999,83.25,1360998053647,1360998064591,1419435451,1419446395,10944
1360998268,1419649200,1,46,46,1360998243626,1360998243626,1419624826,1419624826,0
1360998276,1419657208,5,250,50,1360998249697,1360998271777,1419630905,1419652985,22080
1360998324,1419705220,1,48,48,1360998295957,1360998295957,1419677177,1419677177,0
1360998352,1419733524,1,48,48,1360998324837,1360998324837,1419706361,1419706361,0
1360998369,1419750940,1,48,48,1360998341314,1360998341314,1419723254,1419723254,0
1360998371,1419752180,1,48,48,1360998342074,1360998342074,1419723254,1419723254,0
1360998371,1419752184,1,48,48,1360998342073,1360998342073,1419723257,1419723257,0
1360998769,1420150664,1,46,46,1360998741840,1360998741840,1420123504,1420123504,0
1360999485,59179360,3,919,306.3333333,1360999486453,1360999486453,59180813,59180813,0
1360999490,59185120,4,478,119.5,1360999486718,1360999486782,59181838,59181902,64
1360999493,1420874492,8,1424,178,1360999489458,1360999489842,1420870950,1420871334,384
1360999493,1420874520,8,3305,413.125,1360999486933,1360999487445,1420868453,1420868965,512
1360999493,1420874524,9,2982,331.3333333,1360999491217,1360999491473,1420872741,1420872997,256
1360999498,59193116,4,478,119.5,1360999492481,1360999492545,59187597,59187661,64
1360999498,59193116,4,971,242.75,1360999490176,1360999490560,59185292,59185676,384
1360999501,1420882492,10,1994,199.4,1360999494196,1360999494452,1420875688,1420875944,256
1360999501,1420882492,8,1890,236.25,1360999494451,1360999494579,1420875943,1420876071,128
1360999501,1420882492,8,2634,329.25,1360999493105,1360999493233,1420874597,1420874725,128
1360999501,1420882496,8,1890,236.25,1360999495151,1360999495215,1420876647,1420876711,64
1360999501,1420882496,10,2490,249,1360999495214,1360999495406,1420876710,1420876902,192
1360999501,1420882496,9,2766,307.3333333,1360999493549,1360999493741,1420875045,1420875237,192
1360999501,1420882496,9,1942,215.7777778,1360999495469,1360999495725,1420876965,1420877221,256
1360999501,1420882496,8,2386,298.25,1360999493741,1360999493805,1420875237,1420875301,64
1360999501,1420882500,7,2694,384.8571429,1360999495724,1360999495852,1420877224,1420877352,128
1360999501,1420882500,10,2482,248.2,1360999493804,1360999494060,1420875304,1420875560,256
1360999501,1420882500,11,3307,300.6363636,1360999488043,1360999496747,1420869543,1420878247,8704
1360999501,1420882500,7,1838,262.5714286,1360999496234,1360999496298,1420877734,1420877798,64
1360999501,1420882500,8,2394,299.25,1360999496425,1360999496553,1420877925,1420878053,128
1360999501,1420882500,7,1838,262.5714286,1360999494057,1360999494185,1420875557,1420875685,128
1360999501,1420882500,7,2870,410,1360999496553,1360999496681,1420878053,1420878181,128
1360999501,1420882504,10,4818,481.8,1360999496296,1360999496424,1420877800,1420877928,128
1360999501,1420882504,11,3350,304.5454545,1360999496679,1360999496807,1420878183,1420878311,128
1360999501,1420882504,9,1942,215.7777778,1360999497254,1360999497510,1420878758,1420879014,256
1360999501,1420882504,8,1890,236.25,1360999497510,1360999497638,1420879014,1420879142,128
1360999501,1420882508,8,2378,297.25,1360999493028,1360999493092,1420874536,1420874600,64
1360999501,1420882508,8,1890,236.25,1360999494564,1360999494692,1420876072,1420876200,128
1360999501,1420882508,10,1994,199.4,1360999494691,1360999495139,1420876199,1420876647,448
1360999501,1420882508,10,1994,199.4,1360999493218,1360999493474,1420874726,1420874982,256
1360999501,1420882532,8,2698,337.25,1360999493452,1360999493516,1420874984,1420875048,64
1360999501,1420882532,8,2506,313.25,1360999495371,1360999495435,1420876903,1420876967,64
1360999501,1420882532,10,2482,248.2,1360999495817,1360999496073,1420877349,1420877605,256
1360999501,1420882536,7,1401,200.1428571,1360999499528,1360999500168,1420881064,1420881704,640
1360999501,1420882536,8,1890,236.25,1360999496070,1360999496198,1420877606,1420877734,128
1360999501,1420882536,8,2021,252.625,1360999496389,1360999496517,1420877925,1420878053,128
1360999501,1420882540,8,1890,236.25,1360999496772,1360999496836,1420878312,1420878376,64
1360999501,1420882540,8,1890,236.25,1360999496835,1360999496963,1420878375,1420878503,128
1360999501,1420882540,11,3598,327.0909091,1360999496963,1360999497219,1420878503,1420878759,256
1360999506,59201120,5,527,105.4,1360999500669,1360999500669,59195789,59195789,0
1360999517,1420898488,5,1275,255,1360999497973,1360999514421,1420879461,1420895909,16448
1360999517,1420898488,10,3160,316,1360999498164,1360999513524,1420879652,1420895012,15360
1360999517,1420898524,7,1925,275,1360999496913,1360999512337,1420878437,1420893861,15424
1360999522,1420903796,1,108,108,1360999495748,1360999495748,1420877544,1420877544,0
1360999522,1420903796,1,108,108,1360999495811,1360999495811,1420877607,1420877607,0
1360999522,1420903844,1,108,108,1360999495633,1360999495633,1420877477,1420877477,0
1360999529,59223512,1,52,52,1360999501341,1360999501341,59195853,59195853,0
1360999547,1420928164,1,46,46,1360999519482,1360999519482,1420900646,1420900646,0
1360999650,59345128,5,527,105.4,1360999647289,1360999647353,59342417,59342481,64
1360999653,1421034652,80416,120523530,1498.750622,1360999501263,1360999646735,1420882915,1421028387,145472
1360999690,59385140,4,478,119.5,1360999688362,1360999688426,59383502,59383566,64
1360999693,1421074672,2,92,46,1360999690620,1360999690620,1421072292,1421072292,0
1360999698,59393132,4,478,119.5,1360999691508,1360999691572,59386640,59386704,64
1360999717,59411748,1,46,46,1360999690546,1360999690546,59385294,59385294,0
1360999719,1421100216,1,46,46,1360999691009,1360999691009,1421072225,1421072225,0
1360999877,1421258836,14,4789,342.0714286,1360999867668,1360999875604,1421249504,1421257440,7936
1360999877,1421258840,12,999,83.25,1360999868048,1360999875600,1421249888,1421257440,7552
1360999877,1421258876,12,999,83.25,1360999868270,1360999875566,1421250146,1421257442,7296
1360999911,1421292504,8,815,101.875,1360999883169,1360999883361,1421264673,1421264865,192
1360999911,1421292504,9,861,95.66666667,1360999883422,1360999883614,1421264926,1421265118,192
1360999911,1421292512,9,861,95.66666667,1360999883929,1360999884121,1421265441,1421265633,192
1360999911,1421292552,8,815,101.875,1360999883633,1360999883825,1421265185,1421265377,192
1361000157,1421539036,4,252,63,1361000148360,1361000155464,1421530396,1421537500,7104
1361000173,1421554996,3,189,63,1361000169520,1361000172592,1421551516,1421554588,3072
1361000189,1421571056,2,126,63,1361000176562,1361000184562,1421558618,1421566618,8000
1361000192,1421573180,1,63,63,1361000164383,1361000164383,1421545563,1421545563,0
1361000261,1421643044,4,252,63,1361000252157,1361000259197,1421634201,1421641241,7040
1361000262,1421643084,4,252,63,1361000253119,1361000260159,1421634203,1421641243,7040
1361000292,1421673432,1,63,63,1361000267875,1361000267875,1421649307,1421649307,0
1361000296,1421677380,1,63,63,1361000267927,1361000267927,1421649307,1421649307,0
1361001157,1422538996,1,46,46,1361001130463,1361001130463,1422512459,1422512459,0
1361001326,1422707828,1,46,46,1361001299142,1361001299142,1422680970,1422680970,0
1361001466,1422848060,1,46,46,1361001441244,1361001441244,1422823304,1422823304,0
1361001699,1423080800,5,677,135.4,1361001673627,1361001674203,1423055427,1423056003,576
1361001699,1423080800,9,861,95.66666667,1361001674267,1361001674459,1423056067,1423056259,192
1361001699,1423080808,9,861,95.66666667,1361001674579,1361001674707,1423056387,1423056515,128
1361001966,1423347880,3,138,46,1361001963207,1361001963271,1423345087,1423345151,64
1361001966,1423347912,7,390,55.71428571,1361001957483,1361001963243,1423339395,1423345155,5760
1361001988,1423369716,2,109,54.5,1361001963371,1361001963371,1423345087,1423345087,0
1361001992,1423373652,8,815,101.875,1361001967341,1361001967533,1423348993,1423349185,192
1361001992,1423373656,9,861,95.66666667,1361001967658,1361001967850,1423349314,1423349506,192
1361001996,1423377636,8,815,101.875,1361001968190,1361001968382,1423349826,1423350018,192
1361001996,1423377676,9,861,95.66666667,1361001967893,1361001968085,1423349569,1423349761,192
1361002198,1423580064,4,252,63,1361002190030,1361002197070,1423572094,1423579134,7040
1361002206,1423588076,4,252,63,1361002198847,1361002205887,1423580923,1423587963,7040
1361002210,1423591208,1,46,46,1361002182372,1361002182372,1423563580,1423563580,0
1361002210,1423591896,1,46,46,1361002181620,1361002181620,1423563516,1423563516,0
1361002210,1423591932,1,46,46,1361002181586,1361002181586,1423563518,1423563518,0
1361002233,1423614192,1,63,63,1361002206004,1361002206004,1423587196,1423587196,0
1361002241,1423622240,1,63,63,1361002214726,1361002214726,1423595966,1423595966,0
1361002359,1423740136,3,189,63,1361002355049,1361002358057,1423736185,1423739193,3008
1361002375,1423756112,2,126,63,1361002362115,1361002370179,1423743227,1423751291,8064
1361002375,1423756136,3,189,63,1361002371178,1361002374186,1423752314,1423755322,3008
1361002391,1423772132,2,126,63,1361002378220,1361002386220,1423759352,1423767352,8000
1361003439,1424820808,1,46,46,1361003411963,1361003411963,1424793771,1424793771,0
1361003495,1424876996,16,6335,395.9375,1361003477311,1361003489791,1424859307,1424871787,12480
1361003495,1424876996,12,999,83.25,1361003478013,1361003489533,1424860009,1424871529,11520
1361003495,1424876996,13,1045,80.38461538,1361003478332,1361003490300,1424860328,1424872296,11968
1361003495,1424877032,12,999,83.25,1361003477659,1361003489499,1424859691,1424871531,11840
1361005176,1426557492,1,48,48,1361005150555,1361005150555,1426532047,1426532047,0
1361005300,1426681812,9,861,95.66666667,1361005274457,1361005274649,1426656269,1426656461,192
1361005300,1426681848,9,861,95.66666667,1361005273910,1361005274102,1426655758,1426655950,192
1361005300,1426681848,9,861,95.66666667,1361005274165,1361005274357,1426656013,1426656205,192
1361005585,1426966940,4,218,54.5,1361005581589,1361005583317,1426963529,1426965257,1728
1361005585,1426966948,7,390,55.71428571,1361005576524,1361005583372,1426958472,1426965320,6848
1361005609,1426990804,2,109,54.5,1361005583453,1361005583453,1426965257,1426965257,0
1361005613,1426994764,8,815,101.875,1361005587203,1361005587395,1426968967,1426969159,192
1361005613,1426994768,9,861,95.66666667,1361005587458,1361005587650,1426969226,1426969418,192
1361005613,1426994768,9,861,95.66666667,1361005587714,1361005587906,1426969482,1426969674,192
1361005613,1426994796,9,861,95.66666667,1361005587941,1361005588133,1426969737,1426969929,192
1361005778,1427159128,3,189,63,1361005771135,1361005774143,1427152263,1427155271,3008
1361005794,1427175108,2,126,63,1361005778194,1361005786258,1427159302,1427167366,8064
1361005866,1427247128,3,189,63,1361005862267,1361005865275,1427243395,1427246403,3008
1361005882,1427263136,2,126,63,1361005869301,1361005877365,1427250437,1427258501,8064
1361005906,1427287140,3,189,63,1361005899889,1361005902897,1427281029,1427284037,3008
1361005922,1427303160,2,126,63,1361005906909,1361005914973,1427288069,1427296133,8064
1361005946,1427327236,3,189,63,1361005940496,1361005943504,1427321732,1427324740,3008
1361005962,1427343196,2,126,63,1361005947576,1361005955640,1427328772,1427336836,8064
1361006884,1428265664,1,46,46,1361006857748,1361006857748,1428239412,1428239412,0
1361007066,1428447768,2,92,46,1361007061482,1361007061482,1428443250,1428443250,0
1361007066,1428447780,2,92,46,1361007061406,1361007061406,1428443186,1428443186,0
1361007066,1428447780,2,92,46,1361007061405,1361007061405,1428443185,1428443185,0
1361007066,1428447780,2,92,46,1361007061469,1361007061469,1428443249,1428443249,0
1361007089,1428470168,14,6617,472.6428571,1361007062976,1361007063296,1428444144,1428444464,320
1361007089,1428470168,9,861,95.66666667,1361007063937,1361007064065,1428445105,1428445233,128
1361007089,1428470204,8,815,101.875,1361007063326,1361007063518,1428444530,1428444722,192
1361007089,1428470204,9,861,95.66666667,1361007063581,1361007063773,1428444785,1428444977,192
1361007378,1428759960,3,189,63,1361007371750,1361007374822,1428753710,1428756782,3072
1361007395,1428776048,2,126,63,1361007379766,1361007387766,1428760814,1428768814,8000
1361007395,1428776056,2,126,63,1361007393771,1361007394731,1428774827,1428775787,960
1361007395,1428776060,3,189,63,1361007390954,1361007394026,1428772014,1428775086,3072
1361007397,1428779000,2,126,63,1361007392767,1361007393791,1428774767,1428775791,1024
1361007402,1428784048,2,126,63,1361007395789,1361007399821,1428777837,1428781869,4032
1361007403,1428784088,2,126,63,1361007396686,1361007400718,1428777774,1428781806,4032
1361007410,1428792052,2,126,63,1361007397065,1361007405065,1428779117,1428787117,8000
1361007434,1428815100,1,63,63,1361007408770,1361007408770,1428789870,1428789870,0
1361007434,1428815100,1,63,63,1361007408769,1361007408769,1428789869,1428789869,0
1361007974,1429355956,9,861,95.66666667,1361007949472,1361007949664,1429331428,1429331620,192
1361007974,1429355956,9,861,95.66666667,1361007949727,1361007949919,1429331683,1429331875,192
1361007978,1429359940,9,861,95.66666667,1361007950063,1361007950191,1429332003,1429332131,128
1361008119,1429500336,1,46,46,1361008094666,1361008094666,1429476002,1429476002,0
1361008251,1429632700,9,861,95.66666667,1361008223515,1361008223707,1429605215,1429605407,192
1361008251,1429632704,8,815,101.875,1361008223769,1361008223961,1429605473,1429605665,192
1361008251,1429632704,8,815,101.875,1361008224024,1361008224216,1429605728,1429605920,192
1361008251,1429632716,9,861,95.66666667,1361008223245,1361008223437,1429604961,1429605153,192
1361008363,1429744580,4,252,63,1361008355153,1361008362193,1429736733,1429743773,7040
1361008363,1429744580,4,252,63,1361008355537,1361008362641,1429737117,1429744221,7104
1361008363,1429744616,2,126,63,1361008361712,1361008362736,1429743328,1429744352,1024
1361008371,1429752584,2,126,63,1361008364813,1361008368845,1429746397,1429750429,4032
1361008380,1429761124,1,48,48,1361008353883,1361008353883,1429735007,1429735007,0
1361008396,1429777152,1,63,63,1361008370687,1361008370687,1429751839,1429751839,0
1361008396,1429777156,1,63,63,1361008371067,1361008371067,1429752223,1429752223,0
1361008404,1429785132,1,63,63,1361008377297,1361008377297,1429758429,1429758429,0
1361008475,1429856624,2,126,63,1361008473571,1361008474595,1429855195,1429856219,1024
1361008475,1429856632,3,189,63,1361008468251,1361008471259,1429849883,1429852891,3008
1361008483,1429864604,2,126,63,1361008476663,1361008480631,1429858267,1429862235,3968
1361008491,1429872632,2,126,63,1361008475291,1361008483355,1429856923,1429864987,8064
1361008507,1429888636,4,252,63,1361008499158,1361008506262,1429880794,1429887898,7104
1361008516,1429897580,1,63,63,1361008488721,1361008488721,1429870301,1429870301,0
1361008523,1429904620,3,189,63,1361008516070,1361008519142,1429897690,1429900762,3072
1361008539,1429920652,2,126,63,1361008523144,1361008531144,1429904796,1429912796,8000
1361008540,1429921632,1,63,63,1361008514268,1361008514268,1429895900,1429895900,0
1361008758,1430139516,1,48,48,1361008731917,1361008731917,1430113433,1430113433,0
1361008759,1430140692,1,48,48,1361008731741,1361008731741,1430113433,1430113433,0
1361008759,1430140732,1,48,48,1361008731700,1361008731700,1430113432,1430113432,0
1361009767,1431148124,14,6617,472.6428571,1361009739141,1361009739461,1431120265,1431120585,320
1361009767,1431148128,8,815,101.875,1361009739522,1361009739714,1431120650,1431120842,192
1361009767,1431148132,9,861,95.66666667,1361009739774,1361009740286,1431120906,1431121418,512
1361009767,1431148136,9,861,95.66666667,1361009740410,1361009740538,1431121546,1431121674,128
1361009883,1431264568,1,48,48,1361009857927,1361009857927,1431239495,1431239495,0
1361010061,1431442172,2,126,63,1361010059215,1361010060239,1431440387,1431441411,1024
1361010064,1431445152,1,60,60,1361010036643,1361010036643,1431417795,1431417795,0
1361010068,1431449100,1,60,60,1361010041432,1361010041432,1431422532,1431422532,0
1361010069,1431450176,2,126,63,1361010062221,1361010066253,1431443397,1431447429,4032
1361010077,1431458160,3,189,63,1361010073434,1361010076442,1431454594,1431457602,3008
1361010080,1431461244,1,60,60,1361010054215,1361010054215,1431435459,1431435459,0
1361010093,1431474184,2,126,63,1361010080450,1361010088514,1431461634,1431469698,8064
1361010100,1431481336,1,63,63,1361010074155,1361010074155,1431455491,1431455491,0
1361010157,1431538180,3,189,63,1361010151685,1361010154693,1431532865,1431535873,3008
1361010157,1431538216,3,189,63,1361010151585,1361010154593,1431532801,1431535809,3008
1361010173,1431554232,2,126,63,1361010158612,1361010166676,1431539844,1431547908,8064
1361010173,1431554232,2,126,63,1361010158675,1361010166739,1431539907,1431547971,8064
1361010521,1431902788,1,48,48,1361010495458,1361010495458,1431877246,1431877246,0
1361010522,1431903680,1,48,48,1361010495436,1361010495436,1431877116,1431877116,0
1361010522,1431903688,1,48,48,1361010495429,1361010495429,1431877117,1431877117,0
1361011445,1432827004,1,56,56,1361011418044,1361011418044,1432800048,1432800048,0
1361011555,1432936680,16,7743,483.9375,1361011527807,1361011528063,1432909487,1432909743,256
1361011555,1432936716,14,6617,472.6428571,1361011528153,1361011528409,1432909869,1432910125,256
1361011555,1432936720,9,861,95.66666667,1361011528790,1361011528982,1432910510,1432910702,192
1361011555,1432936720,8,815,101.875,1361011528534,1361011528662,1432910254,1432910382,128
1361011555,1432936724,9,861,95.66666667,1361011529042,1361011529234,1432910766,1432910958,192
1361011742,1433123128,3,189,63,1361011736290,1361011739298,1433117418,1433120426,3008
1361011742,1433123132,3,189,63,1361011735261,1361011738269,1433116393,1433119401,3008
1361011758,1433139116,2,126,63,1361011742317,1361011750381,1433123433,1433131497,8064
1361011758,1433139128,3,189,63,1361011752418,1361011755426,1433133546,1433136554,3008
1361011758,1433139148,2,126,63,1361011743309,1361011751373,1433124457,1433132521,8064
1361011774,1433155124,2,126,63,1361011759462,1361011767526,1433140586,1433148650,8064
1361011846,1433227124,2,92,46,1361011841830,1361011841830,1433222954,1433222954,0
1361011846,1433227124,2,92,46,1361011841830,1361011841830,1433222954,1433222954,0
1361011846,1433227132,2,92,46,1361011841758,1361011841758,1433222890,1433222890,0
1361011862,1433243168,12,999,83.25,1361011842040,1361011854136,1433223208,1433235304,12096
1361011862,1433243180,16,6372,398.25,1361011842283,1361011854123,1433223463,1433235303,11840
1361011862,1433243180,12,999,83.25,1361011842731,1361011854123,1433223911,1433235303,11392
1361011862,1433243184,11,953,86.63636364,1361011842986,1361011854122,1433224170,1433235306,11136
1361011868,1433249604,2,109,54.5,1361011841284,1361011841284,1433222888,1433222888,0
1361011868,1433249604,2,109,54.5,1361011841283,1361011841347,1433222887,1433222951,64
1361011884,1433265712,2,152,76,1361011858265,1361011873305,1433239977,1433255017,15040
1361011916,1433297628,2,152,76,1361011888429,1361011903469,1433270057,1433285097,15040
1361011944,1433325632,1,76,76,1361011918505,1361011918505,1433300137,1433300137,0
1361012165,1433546112,1,48,48,1361012137006,1361012137006,1433518118,1433518118,0
1361012205,1433586196,1,46,46,1361012178968,1361012178968,1433560164,1433560164,0
1361012209,1433590216,1,46,46,1361012182212,1361012182212,1433563428,1433563428,0
1361012430,1433811580,12,999,83.25,1361012414419,1361012424915,1433795999,1433806495,10496
1361012430,1433811584,12,999,83.25,1361012414673,1361012424913,1433796257,1433806497,10240
1361012430,1433811592,17,6755,397.3529412,1361012414022,1361012424966,1433795614,1433806558,10944
1361012441,1433822516,1,76,76,1361012415826,1361012415826,1433797342,1433797342,0
1361012489,1433870536,2,152,76,1361012460989,1361012476029,1433842525,1433857565,15040
1361012661,1434042724,1,46,46,1361012635522,1361012635522,1434017246,1434017246,0
1361012825,1434206932,1,46,46,1361012798383,1361012798383,1434180315,1434180315,0
1361013006,1434387292,1,46,46,1361012979370,1361012979370,1434360662,1434360662,0
1361013006,1434387296,1,46,46,1361012979880,1361012979880,1434361176,1434361176,0
1361013110,1434491420,1,46,46,1361013083371,1361013083371,1434464791,1434464791,0
1361013671,1435052536,1,60,60,1361013643821,1361013643821,1435025357,1435025357,0
1361013671,1435052548,1,60,60,1361013645538,1361013645538,1435027086,1435027086,0
1361013675,1435056472,1,60,60,1361013648749,1361013648749,1435030221,1435030221,0
1361013687,1435068524,1,60,60,1361013662007,1361013662007,1435043531,1435043531,0
1361013787,1435168736,1,46,46,1361013762405,1361013762405,1435144141,1435144141,0
1361013984,1435365336,1,48,48,1361013959601,1361013959601,1435340937,1435340937,0
1361014239,1435620664,12,999,83.25,1361014226340,1361014236068,1435608004,1435617732,9728
1361014239,1435620672,17,6755,397.3529412,1361014225947,1361014236059,1435607619,1435617731,10112
1361014239,1435620676,12,999,83.25,1361014226582,1361014235990,1435608258,1435617666,9408
1361014577,1435958812,9,861,95.66666667,1361014551754,1361014551882,1435933566,1435933694,128
1361014577,1435958820,9,861,95.66666667,1361014550723,1361014550851,1435932543,1435932671,128
1361014577,1435958852,9,861,95.66666667,1361014551969,1361014552161,1435933821,1435934013,192
1361014577,1435958860,8,815,101.875,1361014550939,1361014551579,1435932799,1435933439,640
1361014594,1435975124,9,861,95.66666667,1361014568186,1361014568314,1435949310,1435949438,128
1361014594,1435975128,8,815,101.875,1361014568440,1361014568568,1435949568,1435949696,128
1361014594,1435975168,8,815,101.875,1361014568657,1361014568785,1435949825,1435949953,128
1361014594,1435975168,9,861,95.66666667,1361014568911,1361014578831,1435950079,1435959999,9920
1361014599,1435980916,5,2106,421.2,1361014597539,1361014597859,1435979455,1435979775,320
1361014599,1435980928,8,3137,392.125,1361014597591,1361014598423,1435979519,1435980351,832
1361014606,74301052,4,1448,362,1361014599269,1361014599333,74294321,74294385,64
1361014606,74301052,5,2109,421.8,1361014604004,1361014604068,74299056,74299120,64
1361014606,74301052,5,451,90.2,1361014604260,1361014605284,74299312,74300336,1024
1361014606,74301052,5,451,90.2,1361014602147,1361014603171,74297199,74298223,1024
1361014607,1435988904,6,798,133,1361014601519,1361014601839,1435983423,1435983743,320
1361014607,1435988908,7,1423,203.2857143,1361014605995,1361014606763,1435987903,1435988671,768
1361014607,1435988912,9,3035,337.2222222,1361014603432,1361014603944,1435985344,1435985856,512
1361014607,1435988912,7,1460,208.5714286,1361014603623,1361014604263,1435985535,1435986175,640
1361014607,1435988916,6,983,163.8333333,1361014601185,1361014601505,1435983101,1435983421,320
1361014607,1435988916,9,1913,212.5555556,1361014605475,1361014605603,1435987391,1435987519,128
1361014607,1435988916,10,3632,363.2,1361014602210,1361014603362,1435984126,1435985278,1152
1361014607,1435988920,8,3492,436.5,1361014599516,1361014600284,1435981436,1435982204,768
1361014607,1435988920,5,1257,251.4,1361014603422,1361014603422,1435985342,1435985342,0
1361014607,1435988920,11,3294,299.4545455,1361014600605,1361014601181,1435982525,1435983101,576
1361014607,1435988944,4,724,181,1361014604680,1361014604744,1435986624,1435986688,64
1361014614,74309036,5,451,90.2,1361014606965,1361014608181,74302001,74303217,1216
1361014614,74309036,5,451,90.2,1361014609460,1361014610292,74304496,74305328,832
1361014614,74309036,5,451,90.2,1361014612916,1361014613108,74307952,74308144,192
1361014614,74309040,5,451,90.2,1361014611506,1361014611762,74306546,74306802,256
1361014615,1435996912,15,8365,557.6666667,1361014609958,1361014610150,1435991870,1435992062,192
1361014615,1435996916,12,4735,394.5833333,1361014613924,1361014614116,1435995840,1435996032,192
1361014615,1435996916,5,609,121.8,1361014611105,1361014611489,1435993021,1435993405,384
1361014615,1435996920,10,1965,196.5,1361014608348,1361014608540,1435990268,1435990460,192
1361014615,1435996920,9,1913,212.5555556,1361014611616,1361014611808,1435993536,1435993728,192
1361014615,1435996920,9,1913,212.5555556,1361014608351,1361014608863,1435990271,1435990783,512
1361014615,1435996924,5,609,121.8,1361014612569,1361014612953,1435994493,1435994877,384
1361014615,1435996924,9,1913,212.5555556,1361014609308,1361014609500,1435991232,1435991424,192
1361014615,1435996924,9,1913,212.5555556,1361014613211,1361014613595,1435995135,1435995519,384
1361014615,1435996928,9,1913,212.5555556,1361014610388,1361014610708,1435992316,1435992636,320
1361014615,1435996928,5,609,121.8,1361014613976,1361014614424,1435995904,1435996352,448
1361014615,1435996928,9,1913,212.5555556,1361014607704,1361014607832,1435989632,1435989760,128
1361014615,1435996928,12,4967,413.9166667,1361014610648,1361014611160,1435992576,1435993088,512
1361014615,1435996928,8,1785,223.125,1361014614549,1361014614933,1435996477,1435996861,384
1361014615,1435996932,11,4921,447.3636364,1361014611796,1361014612180,1435993728,1435994112,384
1361014615,1435996952,5,609,121.8,1361014608895,1361014609407,1435990847,1435991359,512
1361014618,1435999108,10,3381,338.1,1361014613705,1361014613897,1435994813,1435995005,192
1361014622,1436003192,13,6197,476.6923077,1361014597557,1361014597941,1435978749,1435979133,384
1361014622,74317036,4,445,111.25,1361014614518,1361014614582,74309554,74309618,64
1361014622,74317036,4,445,111.25,1361014614582,1361014614710,74309618,74309746,128
1361014622,74317036,4,1448,362,1361014617332,1361014617332,74312368,74312368,0
1361014622,74317036,4,445,111.25,1361014614707,1361014614835,74309743,74309871,128
1361014623,1436004944,9,2849,316.5555556,1361014616775,1361014616903,1435998719,1435998847,128
1361014623,1436004944,9,3310,367.7777778,1361014617476,1361014619268,1435999420,1436001212,1792
1361014623,1436004948,5,767,153.4,1361014621508,1361014621572,1436003456,1436003520,64
1361014623,1436004948,10,3050,305,1361014621762,1361014622466,1436003710,1436004414,704
1361014623,1436004948,2,92,46,1361014615361,1361014615361,1435997309,1435997309,0
1361014623,1436004952,9,1913,212.5555556,1361014615484,1361014615676,1435997436,1435997628,192
1361014623,1436004952,9,3345,371.6666667,1361014619326,1361014620222,1436001278,1436002174,896
1361014623,1436004972,9,1913,212.5555556,1361014616107,1361014616235,1435998079,1435998207,128
1361014626,1436007140,9,861,95.66666667,1361014598315,1361014598507,1435979455,1435979647,192
1361014626,1436007144,9,861,95.66666667,1361014598568,1361014598760,1435979712,1435979904,192
1361014626,1436007156,9,861,95.66666667,1361014598042,1361014598234,1435979198,1435979390,192
1361014630,1436011220,7,1877,268.1428571,1361014605529,1361014607193,1435986749,1435988413,1664
1361014631,1436012928,14,7501,535.7857143,1361014622552,1361014623192,1436004480,1436005120,640
1361014799,1436181004,2,126,63,1361014796424,1361014797384,1436178428,1436179388,960
1361014799,1436181004,2,126,63,1361014796423,1361014797447,1436178427,1436179451,1024
1361014807,1436189016,2,126,63,1361014799420,1361014803452,1436181436,1436185468,4032
1361014808,1436189028,2,126,63,1361014800409,1361014804441,1436181437,1436185469,4032
1361014808,1436189028,4,252,63,1361014800729,1361014807769,1436181757,1436188797,7040
1361014838,1436219712,1,63,63,1361014811820,1361014811820,1436193532,1436193532,0
1361014838,1436219712,1,63,63,1361014811820,1361014811820,1436193532,1436193532,0
1361014842,1436223700,1,63,63,1361014815160,1361014815160,1436196860,1436196860,0
1361014856,1436237036,4,252,63,1361014847056,1361014854096,1436228092,1436235132,7040
1361014864,1436245032,4,252,63,1361014855635,1361014862675,1436236667,1436243707,7040
1361014864,1436245032,4,252,63,1361014856595,1361014863699,1436237627,1436244731,7104
1361014864,1436245036,2,126,63,1361014861965,1361014862989,1436243001,1436244025,1024
1361014864,1436245044,4,252,63,1361014856647,1361014863687,1436237691,1436244731,7040
1361014872,1436253040,2,126,63,1361014865033,1361014869001,1436246073,1436250041,3968
1361014886,1436267684,1,63,63,1361014861509,1361014861509,1436243193,1436243193,0
1361014888,1436269036,3,189,63,1361014882317,1361014885325,1436263353,1436266361,3008
1361014896,1436277072,2,126,63,1361014893480,1361014894504,1436274552,1436275576,1024
1361014896,1436277080,4,252,63,1361014887140,1361014894180,1436268220,1436275260,7040
1361014898,1436279716,1,63,63,1361014871076,1361014871076,1436252792,1436252792,0
1361014898,1436279716,1,63,63,1361014871076,1361014871076,1436252792,1436252792,0
1361014898,1436279724,1,63,63,1361014870046,1361014870046,1436251770,1436251770,0
1361014903,1436284076,1,63,63,1361014877032,1361014877032,1436258108,1436258108,0
1361014904,1436285048,2,126,63,1361014889410,1361014897410,1436270458,1436278458,8000
1361014904,1436285056,2,126,63,1361014896507,1361014900539,1436277563,1436281595,4032
1361014912,1436293088,2,126,63,1361014909787,1361014910811,1436290875,1436291899,1024
1361014920,1436301068,2,126,63,1361014912878,1361014916910,1436293946,1436297978,4032
1361014927,1436308092,1,63,63,1361014902231,1361014902231,1436283323,1436283323,0
1361014935,1436316124,1,63,63,1361014908533,1361014908533,1436289657,1436289657,0
1361014951,1436332104,1,63,63,1361014924873,1361014924873,1436305977,1436305977,0
1361015456,1436837464,1,60,60,1361015431833,1361015431833,1436813297,1436813297,0
1361015468,1436849428,1,60,60,1361015440638,1361015440638,1436822066,1436822066,0
1361015496,1436877488,1,60,60,1361015470081,1361015470081,1436851569,1436851569,0
1361015532,1436913488,1,56,56,1361015505602,1361015505602,1436887090,1436887090,0
1361015808,1437189852,3,180,60,1361015783057,1361015786065,1437164909,1437167917,3008
1361016231,1437612340,1,48,48,1361016204874,1361016204874,1437586214,1437586214,0
1361016231,1437612352,1,48,48,1361016204863,1361016204863,1437586215,1437586215,0
1361016231,1437612360,1,48,48,1361016204852,1361016204852,1437586212,1437586212,0
1361016330,1437711352,1,46,46,1361016302908,1361016302908,1437684260,1437684260,0
1361016330,1437711388,1,46,46,1361016303001,1361016303001,1437684389,1437684389,0
1361016330,1437711764,1,46,46,1361016302558,1361016302558,1437684322,1437684322,0
1361016341,1437722756,13,6234,479.5384615,1361016316330,1361016316650,1437698086,1437698406,320
1361016341,1437722756,9,861,95.66666667,1361016316712,1361016316904,1437698468,1437698660,192
1361016345,1437726724,8,815,101.875,1361016317000,1361016317192,1437698724,1437698916,192
1361016345,1437726728,9,861,95.66666667,1361016317318,1361016317510,1437699046,1437699238,192
1361016361,1437742788,2,122,61,1361016336905,1361016339273,1437718693,1437721061,2368
1361016545,1437926580,3,189,63,1361016539095,1361016542167,1437920675,1437923747,3072
1361016545,1437926580,3,189,63,1361016539286,1361016542358,1437920866,1437923938,3072
1361016561,1437942596,2,126,63,1361016546179,1361016554179,1437927775,1437935775,8000
1361016561,1437942600,2,126,63,1361016546370,1361016554370,1437927970,1437935970,8000
1361016577,1437958608,3,189,63,1361016573686,1361016576694,1437955294,1437958302,3008
1361016593,1437974592,2,126,63,1361016580743,1361016588807,1437962335,1437970399,8064
1361016617,1437998608,2,126,63,1361016614519,1361016615543,1437996127,1437997151,1024
1361016625,1438006620,2,126,63,1361016617514,1361016621610,1437999134,1438003230,4096
1361016658,1438039312,1,63,63,1361016629917,1361016629917,1438011229,1438011229,0
1361016894,1438275552,1,46,46,1361016867946,1361016867946,1438249498,1438249498,0
1361017006,1438387644,1,46,46,1361016981518,1361016981518,1438363162,1438363162,0
1361017183,1438564056,2,122,61,1361017154968,1361017155352,1438536024,1438536408,384
1361017251,1438632412,2,128,64,1361017223923,1361017225011,1438605335,1438606423,1088
1361017651,1439032924,1,46,46,1361017624618,1361017624618,1439006542,1439006542,0
1361017732,1439113096,3,144,48,1361017707176,1361017716072,1439088272,1439097168,8896
1361017836,1439217312,1,46,46,1361017808077,1361017808077,1439189389,1439189389,0
1361018137,1439518140,9,861,95.66666667,1361018109556,1361018109684,1439490696,1439490824,128
1361018137,1439518144,8,815,101.875,1361018110065,1361018110193,1439491209,1439491337,128
1361018137,1439518180,9,861,95.66666667,1361018109773,1361018109901,1439490953,1439491081,128
1361018370,1439751720,6,327,54.5,1361018361710,1361018363822,1439743430,1439745542,2112
1361018389,1439770932,2,109,54.5,1361018363546,1361018363546,1439745478,1439745478,0
1361018389,1439770932,2,109,54.5,1361018363543,1361018363543,1439745475,1439745475,0
1361018393,1439774884,9,861,95.66666667,1361018367689,1361018367881,1439749573,1439749765,192
1361018393,1439774884,8,815,101.875,1361018367945,1361018368137,1439749829,1439750021,192
1361018393,1439774884,8,815,101.875,1361018368199,1361018368391,1439750083,1439750275,192
1361018393,1439774928,9,861,95.66666667,1361018368414,1361018368606,1439750342,1439750534,192
1361018574,1439955204,5,250,50,1361018546096,1361018568176,1439927300,1439949380,22080
1361018594,1439975644,1,52,52,1361018566516,1361018566516,1439948160,1439948160,0
1361018594,1439975672,1,52,52,1361018566808,1361018566808,1439948480,1439948480,0
1361018594,1439975684,1,52,52,1361018566991,1361018566991,1439948675,1439948675,0
1361018595,1439976040,1,52,52,1361018567058,1361018567058,1439948098,1439948098,0
1361018618,1439999276,1,48,48,1361018592548,1361018592548,1439973824,1439973824,0
1361018630,1440011288,1,60,60,1361018603802,1361018603802,1439985090,1439985090,0
1361018646,1440027340,1,48,48,1361018621542,1361018621542,1440002882,1440002882,0
1361018650,1440031888,3,189,63,1361018645377,1361018648385,1440027265,1440030273,3008
1361018666,1440047876,2,126,63,1361018652430,1361018660430,1440034306,1440042306,8000
1361018690,1440071900,3,189,63,1361018685683,1361018688691,1440067583,1440070591,3008
1361018706,1440087888,2,126,63,1361018692737,1361018700801,1440074625,1440082689,8064
1361018730,1440111884,3,189,63,1361018726402,1361018729410,1440108286,1440111294,3008
1361018738,1440119912,4,252,63,1361018729701,1361018736741,1440111613,1440118653,7040
1361018746,1440127912,2,126,63,1361018733415,1361018741415,1440115327,1440123327,8000
1361018770,1440151412,1,63,63,1361018745242,1361018745242,1440126654,1440126654,0
1361018918,1440299772,1,46,46,1361018892851,1361018892851,1440274623,1440274623,0
1361018995,1440376144,1,46,46,1361018967714,1361018967714,1440348858,1440348858,0
1361019440,1440821472,1,48,48,1361019414036,1361019414036,1440795508,1440795508,0
1361019713,1441094676,1,46,46,1361019688389,1361019688389,1441070065,1441070065,0
1361019713,1441095000,1,46,46,1361019688000,1361019688000,1441070000,1441070000,0
1361019713,1441095004,1,46,46,1361019687998,1361019687998,1441070002,1441070002,0
1361019714,1441095036,1,46,46,1361019688963,1361019688963,1441069999,1441069999,0
1361019907,1441288796,2,92,46,1361019900620,1361019900620,1441282416,1441282416,0
1361019907,1441288796,2,92,46,1361019900619,1361019900619,1441282415,1441282415,0
1361019907,1441288804,2,92,46,1361019900608,1361019900608,1441282412,1441282412,0
1361019907,1441288804,2,92,46,1361019900608,1361019900608,1441282412,1441282412,0
1361019929,1441310116,9,861,95.66666667,1361019902450,1361019902578,1441283566,1441283694,128
1361019929,1441310152,14,6617,472.6428571,1361019902028,1361019902348,1441283180,1441283500,320
1361019929,1441310160,9,861,95.66666667,1361019902660,1361019902788,1441283820,1441283948,128
1361019929,1441310160,8,815,101.875,1361019902917,1361019903109,1441284077,1441284269,192
1361020108,1441489060,3,138,46,1361020103782,1361020103846,1441484842,1441484906,64
1361020108,1441489072,3,138,46,1361020103771,1361020103835,1441484843,1441484907,64
1361020108,1441489072,3,138,46,1361020103771,1361020103835,1441484843,1441484907,64
1361020108,1441489072,3,138,46,1361020103770,1361020103834,1441484842,1441484906,64
1361020124,1441505072,17,6755,397.3529412,1361020105562,1361020117658,1441486634,1441498730,12096
1361020124,1441505072,12,999,83.25,1361020105945,1361020117657,1441487017,1441498729,11712
1361020124,1441505076,12,999,83.25,1361020106199,1361020117655,1441487275,1441498731,11456
1361020124,1441505080,12,999,83.25,1361020106451,1361020117651,1441487531,1441498731,11200
1361020252,1441633176,4,190,47.5,1361020250161,1361020250481,1441631337,1441631657,320
1361020252,1441633176,4,190,47.5,1361020250288,1361020250608,1441631464,1441631784,320
1361020252,1441633176,4,190,47.5,1361020250351,1361020250607,1441631527,1441631783,256
1361020252,1441633180,4,190,47.5,1361020250605,1361020250861,1441631785,1441632041,256
1361020252,1441633180,4,190,47.5,1361020250796,1361020251244,1441631976,1441632424,448
1361020252,1441633180,4,190,47.5,1361020251115,1361020251179,1441632295,1441632359,64
1361020252,1441633184,4,190,47.5,1361020248106,1361020249130,1441629290,1441630314,1024
1361020252,1441633184,4,190,47.5,1361020251178,1361020251242,1441632362,1441632426,64
1361020252,1441633184,4,190,47.5,1361020251178,1361020251690,1441632362,1441632874,512
1361020252,1441633184,4,190,47.5,1361020251369,1361020251433,1441632553,1441632617,64
1361020252,1441633184,4,190,47.5,1361020248745,1361020249001,1441629929,1441630185,256
1361020252,1441633184,4,190,47.5,1361020248681,1361020248937,1441629865,1441630121,256
1361020252,1441633184,4,190,47.5,1361020249192,1361020249448,1441630376,1441630632,256
1361020252,1441633184,4,190,47.5,1361020249256,1361020249512,1441630440,1441630696,256
1361020252,1441633184,4,190,47.5,1361020249447,1361020249703,1441630631,1441630887,256
1361020252,1441633184,4,190,47.5,1361020249383,1361020249639,1441630567,1441630823,256
1361020252,1441633184,4,190,47.5,1361020249511,1361020249831,1441630695,1441631015,320
1361020252,1441633184,4,190,47.5,1361020249639,1361020249895,1441630823,1441631079,256
1361020252,1441633184,4,190,47.5,1361020249702,1361020250022,1441630886,1441631206,320
1361020252,1441633188,4,190,47.5,1361020249826,1361020250082,1441631014,1441631270,256
1361020252,1441633188,4,190,47.5,1361020249894,1361020250150,1441631082,1441631338,256
1361020252,1441633188,4,190,47.5,1361020250021,1361020250277,1441631209,1441631465,256
1361020252,1441633188,4,190,47.5,1361020250085,1361020250341,1441631273,1441631529,256
1361020252,1441633188,4,190,47.5,1361020250724,1361020251172,1441631912,1441632360,448
1361020252,1441633188,4,190,47.5,1361020250467,1361020250723,1441631655,1441631911,256
1361020252,1441633188,4,190,47.5,1361020250787,1361020251235,1441631975,1441632423,448
1361020252,1441633188,4,190,47.5,1361020250979,1361020251491,1441632167,1441632679,512
1361020252,1441633188,4,190,47.5,1361020251043,1361020251171,1441632231,1441632359,128
1361020252,1441633192,4,190,47.5,1361020247842,1361020251874,1441629034,1441633066,4032
1361020252,1441633192,4,190,47.5,1361020251234,1361020251362,1441632426,1441632554,128
1361020252,1441633192,4,190,47.5,1361020251234,1361020251362,1441632426,1441632554,128
1361020252,1441633192,4,190,47.5,1361020247905,1361020248737,1441629097,1441629929,832
1361020252,1441633212,3,144,48,1361020248013,1361020249037,1441629225,1441630249,1024
1361020252,1441633212,4,190,47.5,1361020251341,1361020251405,1441632553,1441632617,64
1361020252,1441633212,4,190,47.5,1361020251146,1361020251210,1441632358,1441632422,64
1361020252,1441633216,4,190,47.5,1361020251530,1361020251914,1441632746,1441633130,384
1361020252,1441633216,4,190,47.5,1361020251210,1361020251338,1441632426,1441632554,128
1361020252,1441633216,4,190,47.5,1361020251338,1361020251402,1441632554,1441632618,64
1361020252,1441633216,4,190,47.5,1361020251529,1361020251913,1441632745,1441633129,384
1361020252,1441633216,4,190,47.5,1361020249095,1361020249351,1441630311,1441630567,256
1361020252,1441633216,4,190,47.5,1361020248903,1361020249159,1441630119,1441630375,256
1361020252,1441633216,4,190,47.5,1361020248967,1361020249223,1441630183,1441630439,256
1361020256,79950336,2,98,49,1361020247446,1361020252374,79941782,79946710,4928
1361020256,79950336,2,98,49,1361020247382,1361020251350,79941718,79945686,3968
1361020260,1441641168,4,190,47.5,1361020251960,1361020252280,1441633128,1441633448,320
1361020260,1441641168,4,190,47.5,1361020251959,1361020252343,1441633127,1441633511,384
1361020260,1441641172,4,190,47.5,1361020252342,1361020252662,1441633514,1441633834,320
1361020260,1441641172,4,190,47.5,1361020252277,1361020254645,1441633449,1441635817,2368
1361020260,1441641172,4,190,47.5,1361020252595,1361020252979,1441633767,1441634151,384
1361020260,1441641176,4,190,47.5,1361020251566,1361020251950,1441632742,1441633126,384
1361020260,1441641176,4,190,47.5,1361020251630,1361020251950,1441632806,1441633126,320
1361020260,1441641180,4,190,47.5,1361020251949,1361020252269,1441633129,1441633449,320
1361020260,1441641180,4,190,47.5,1361020252267,1361020252651,1441633447,1441633831,384
1361020260,1441641180,4,190,47.5,1361020252266,1361020252586,1441633446,1441633766,320
1361020260,1441641184,4,190,47.5,1361020252648,1361020252968,1441633832,1441634152,320
1361020260,1441641184,4,190,47.5,1361020252648,1361020252968,1441633832,1441634152,320
1361020260,1441641212,4,190,47.5,1361020251918,1361020252238,1441633130,1441633450,320
1361020268,1441649180,4,465,116.25,1361020265772,1361020265900,1441646952,1441647080,128
1361020268,1441649184,4,292,73,1361020266214,1361020266278,1441647398,1441647462,64
1361020268,1441649184,4,456,114,1361020266282,1361020266474,1441647466,1441647658,192
1361020268,1441649184,4,292,73,1361020266409,1361020266537,1441647593,1441647721,128
1361020268,1441649184,4,445,111.25,1361020263016,1361020263144,1441644200,1441644328,128
1361020268,1441649184,4,488,122,1361020266600,1361020266728,1441647784,1441647912,128
1361020268,1441649184,4,727,181.75,1361020263207,1361020263335,1441644391,1441644519,128
1361020268,1441649184,4,403,100.75,1361020260839,1361020261031,1441642023,1441642215,192
1361020268,1441649184,4,431,107.75,1361020260775,1361020260839,1441641959,1441642023,64
1361020268,1441649184,4,292,73,1361020266791,1361020266919,1441647975,1441648103,128
1361020268,1441649184,4,460,115,1361020266983,1361020267047,1441648167,1441648231,64
1361020268,1441649184,4,475,118.75,1361020263207,1361020263335,1441644391,1441644519,128
1361020268,1441649184,4,427,106.75,1361020261030,1361020261158,1441642214,1441642342,128
1361020268,1441649184,4,292,73,1361020266982,1361020267110,1441648166,1441648294,128
1361020268,1441649188,4,253,63.25,1361020267110,1361020267302,1441648298,1441648490,192
1361020268,1441649188,4,443,110.75,1361020267173,1361020267237,1441648361,1441648425,64
1361020268,1441649188,4,312,78,1361020267173,1361020267237,1441648361,1441648425,64
1361020268,1441649188,4,405,101.25,1361020261285,1361020261413,1441642473,1441642601,128
1361020268,1441649188,4,437,109.25,1361020267556,1361020267620,1441648744,1441648808,64
1361020268,1441649188,4,461,115.25,1361020263844,1361020263908,1441645032,1441645096,64
1361020268,1441649188,4,292,73,1361020267684,1361020267812,1441648872,1441649000,128
1361020268,1441649188,4,393,98.25,1361020261603,1361020261731,1441642791,1441642919,128
1361020268,1441649188,4,466,116.5,1361020267747,1361020267875,1441648935,1441649063,128
1361020268,1441649188,4,427,106.75,1361020261730,1361020261858,1441642918,1441643046,128
1361020268,1441649192,4,448,112,1361020265057,1361020265185,1441646249,1441646377,128
1361020268,1441649192,4,431,107.75,1361020264865,1361020265057,1441646057,1441646249,192
1361020268,1441649192,4,414,103.5,1361020265057,1361020265185,1441646249,1441646377,128
1361020268,1441649192,4,488,122,1361020265377,1361020265569,1441646569,1441646761,192
1361020268,1441649192,4,467,116.75,1361020265633,1361020265697,1441646825,1441646889,64
1361020268,1441649192,4,292,73,1361020265761,1361020265889,1441646953,1441647081,128
1361020268,1441649192,4,469,117.25,1361020266016,1361020266080,1441647208,1441647272,64
1361020268,1441649192,3,144,48,1361020266015,1361020266207,1441647207,1441647399,192
1361020268,1441649196,4,479,119.75,1361020262362,1361020262490,1441643558,1441643686,128
1361020268,1441649196,4,447,111.75,1361020266206,1361020266270,1441647402,1441647466,64
1361020268,1441649196,5,1256,251.2,1361020266205,1361020267229,1441647401,1441648425,1024
1361020268,1441649196,4,648,162,1361020262493,1361020263005,1441643689,1441644201,512
1361020268,1441649196,4,470,117.5,1361020266781,1361020266909,1441647977,1441648105,128
1361020268,1441649196,4,447,111.75,1361020266396,1361020266524,1441647592,1441647720,128
1361020268,1441649196,4,442,110.5,1361020266524,1361020266652,1441647720,1441647848,128
1361020268,1441649196,4,291,72.75,1361020260892,1361020261020,1441642088,1441642216,128
1361020268,1441649196,4,291,72.75,1361020263003,1361020263131,1441644199,1441644327,128
1361020268,1441649196,4,385,96.25,1361020263003,1361020263131,1441644199,1441644327,128
1361020268,1441649196,5,480,96,1361020267163,1361020267291,1441648359,1441648487,128
1361020268,1441649200,4,461,115.25,1361020266710,1361020266838,1441647910,1441648038,128
1361020268,1441649200,4,431,107.75,1361020267418,1361020267482,1441648618,1441648682,64
1361020268,1441649200,4,427,106.75,1361020261145,1361020261273,1441642345,1441642473,128
1361020268,1441649200,4,292,73,1361020266905,1361020266969,1441648105,1441648169,64
1361020268,1441649200,4,292,73,1361020267737,1361020267801,1441648937,1441649001,64
1361020268,1441649200,4,461,115.25,1361020263320,1361020263512,1441644520,1441644712,192
1361020268,1441649200,4,427,106.75,1361020261400,1361020261592,1441642600,1441642792,192
1361020268,1441649200,4,468,117,1361020263512,1361020263704,1441644712,1441644904,192
1361020268,1441649200,4,292,73,1361020267160,1361020267224,1441648360,1441648424,64
1361020268,1441649220,4,461,115.25,1361020263492,1361020263684,1441644712,1441644904,192
1361020268,1441649220,4,434,108.5,1361020267267,1361020267331,1441648487,1441648551,64
1361020268,1441649220,4,469,117.25,1361020264196,1361020264324,1441645416,1441645544,128
1361020268,1441649220,4,471,117.75,1361020267779,1361020267843,1441648999,1441649063,64
1361020268,1441649220,4,469,117.25,1361020265283,1361020265347,1441646503,1441646567,64
1361020268,1441649220,4,469,117.25,1361020265475,1361020265603,1441646695,1441646823,128
1361020268,1441649220,4,461,115.25,1361020265282,1361020265346,1441646502,1441646566,64
1361020269,1441650996,4,292,73,1361020264762,1361020264890,1441646758,1441646886,128
1361020269,1441650996,4,487,121.75,1361020264890,1361020265018,1441646886,1441647014,128
1361020276,1441657200,4,292,73,1361020267928,1361020267992,1441649128,1441649192,64
1361020276,1441657200,4,312,78,1361020269784,1361020269912,1441650984,1441651112,128
1361020276,1441657200,4,439,109.75,1361020269784,1361020269912,1441650984,1441651112,128
1361020276,1441657204,4,292,73,1361020268242,1361020268370,1441649446,1441649574,128
1361020276,1441657204,4,463,115.75,1361020268182,1361020268246,1441649386,1441649450,64
1361020276,1441657204,30,37399,1246.633333,1361020270293,1361020275477,1441651497,1441656681,5184
1361020276,1441657204,4,313,78.25,1361020270293,1361020270421,1441651497,1441651625,128
1361020276,1441657204,4,292,73,1361020268309,1361020268373,1441649513,1441649577,64
1361020276,1441657204,4,312,78,1361020274835,1361020274963,1441656039,1441656167,128
1361020276,1441657208,4,292,73,1361020269202,1361020269266,1441650410,1441650474,64
1361020276,1441657208,4,292,73,1361020267856,1361020267920,1441649064,1441649128,64
1361020276,1441657208,12,999,83.25,1361020256656,1361020268752,1441637864,1441649960,12096
1361020276,1441657208,4,455,113.75,1361020267856,1361020267984,1441649064,1441649192,128
1361020276,1441657208,12,999,83.25,1361020257487,1361020269135,1441638695,1441650343,11648
1361020276,1441657212,4,336,84,1361020273230,1361020273294,1441654442,1441654506,64
1361020276,1441657212,4,292,73,1361020267981,1361020268045,1441649193,1441649257,64
1361020276,1441657212,4,497,124.25,1361020268045,1361020268109,1441649257,1441649321,64
1361020276,1441657212,4,292,73,1361020268108,1361020268236,1441649320,1441649448,128
1361020276,1441657212,4,473,118.25,1361020268236,1361020268300,1441649448,1441649512,64
1361020276,1441657212,4,292,73,1361020268300,1361020268428,1441649512,1441649640,128
1361020276,1441657212,4,312,78,1361020270092,1361020270220,1441651304,1441651432,128
1361020276,1441657212,28,33157,1184.178571,1361020270348,1361020271820,1441651560,1441653032,1472
1361020276,1441657212,4,1195,298.75,1361020268427,1361020268555,1441649639,1441649767,128
1361020276,1441657212,5,808,161.6,1361020266699,1361020267915,1441647911,1441649127,1216
1361020276,1441657212,4,292,73,1361020268746,1361020268810,1441649958,1441650022,64
1361020276,1441657212,4,464,116,1361020268682,1361020268746,1441649894,1441649958,64
1361020276,1441657216,4,292,73,1361020268678,1361020268806,1441649894,1441650022,128
1361020276,1441657216,4,313,78.25,1361020271113,1361020271177,1441652329,1441652393,64
1361020276,1441657216,7,2548,364,1361020275081,1361020275465,1441656297,1441656681,384
1361020276,1441657216,4,312,78,1361020275144,1361020275208,1441656360,1441656424,64
1361020276,1441657240,3,144,48,1361020269296,1361020269488,1441650536,1441650728,192
1361020276,1441657240,15,5833,388.8666667,1361020267248,1361020267888,1441648488,1441649128,640
1361020276,1441657240,12,999,83.25,1361020256880,1361020268720,1441638120,1441649960,11840
1361020276,1441657240,11,953,86.63636364,1361020257199,1361020268719,1441638439,1441649959,11520
1361020276,1441657244,4,292,73,1361020272558,1361020272622,1441653802,1441653866,64
1361020278,1441659064,1,52,52,1361020251934,1361020251934,1441632998,1441632998,0
1361020280,79974332,2,98,49,1361020265304,1361020272600,79959636,79966932,7296
1361020280,79974332,2,98,49,1361020265304,1361020273560,79959636,79967892,8256
1361020284,1441665216,4,313,78.25,1361020283336,1361020283464,1441664552,1441664680,128
1361020284,1441665220,15,12993,866.2,1361020263878,1361020280774,1441645098,1441661994,16896
1361020284,1441665220,7,2656,379.4285714,1361020280261,1361020280581,1441661481,1441661801,320
1361020284,1441665220,4,313,78.25,1361020280325,1361020280389,1441661545,1441661609,64
1361020284,1441665224,7,2548,364,1361020282878,1361020283262,1441664102,1441664486,384
1361020284,1441665224,4,312,78,1361020282942,1361020283006,1441664166,1441664230,64
1361020284,1441665228,4,1493,373.25,1361020283261,1361020283325,1441664489,1441664553,64
1361020284,1441665228,7,2504,357.7142857,1361020283261,1361020283645,1441664489,1441664873,384
1361020292,1441673212,7,2504,357.7142857,1361020284491,1361020284875,1441665703,1441666087,384
1361020292,1441673224,4,313,78.25,1361020284544,1361020284608,1441665768,1441665832,64
1361020292,1441673224,11,5602,509.2727273,1361020271294,1361020286590,1441652518,1441667814,15296
1361020292,1441673228,11,6050,550,1361020271485,1361020286845,1441652713,1441668073,15360
1361020292,1441673228,446,652411,1462.804933,1361020271548,1361020290172,1441652776,1441671400,18624
1361020294,1441675044,51,61050,1197.058824,1361020269043,1361020283827,1441650087,1441664871,14784
1361020294,79988860,4,640,160,1361020269515,1361020269771,79964375,79964631,256
1361020296,1441677912,5,3947,789.4,1361020269072,1361020269136,1441650984,1441651048,64
1361020298,79992856,1,52,52,1361020270223,1361020270223,79965079,79965079,0
1361020298,79992856,4,612,153,1361020270540,1361020270796,79965396,79965652,256
1361020300,1441681188,4,511,127.75,1361020299364,1361020299492,1441680552,1441680680,128
1361020302,1441683056,2,98,49,1361020274983,1361020275047,1441656039,1441656103,64
1361020308,1441689188,4,312,78,1361020302757,1361020302821,1441683945,1441684009,64
1361020308,1441689188,4,312,78,1361020302948,1361020303012,1441684136,1441684200,64
1361020308,1441689188,4,312,78,1361020302883,1361020302947,1441684071,1441684135,64
1361020308,1441689196,6,622,103.6666667,1361020302746,1361020306842,1441683942,1441688038,4096
1361020308,1441689196,4,312,78,1361020302810,1361020302938,1441684006,1441684134,128
1361020308,1441689196,4,312,78,1361020302810,1361020302874,1441684006,1441684070,64
1361020308,1441689200,4,312,78,1361020302933,1361020303061,1441684133,1441684261,128
1361020316,1441697196,4,601,150.25,1361020309402,1361020309530,1441690598,1441690726,128
1361020318,1441699112,1,46,46,1361020292465,1361020292465,1441673577,1441673577,0
1361020324,1441705216,3,144,48,1361020323656,1361020323848,1441704872,1441705064,192
1361020324,1441705216,4,442,110.5,1361020320134,1361020320262,1441701350,1441701478,128
1361020324,1441705224,3,144,48,1361020323646,1361020323838,1441704870,1441705062,192
1361020324,1441705252,12,6459,538.25,1361020321314,1361020321954,1441702566,1441703206,640
1361020330,80024832,6,2203,367.1666667,1361020302182,1361020302374,79997014,79997206,192
1361020332,1441713252,4,531,132.75,1361020329508,1361020329572,1441710760,1441710824,64
1361020346,1441727132,2,265,132.5,1361020319065,1361020319129,1441700197,1441700261,64
1361020348,1441729240,4,1271,317.75,1361020343600,1361020343728,1441724840,1441724968,128
1361020356,1441737224,4,292,73,1361020353855,1361020353983,1441735079,1441735207,128
1361020356,1441737228,4,446,111.5,1361020355259,1361020355387,1441736487,1441736615,128
1361020356,1441737232,4,457,114.25,1361020355832,1361020355896,1441737064,1441737128,64
1361020356,1441737232,4,488,122,1361020353526,1361020353654,1441734758,1441734886,128
1361020356,1441737236,4,469,117.25,1361020354228,1361020354292,1441735464,1441735528,64
1361020356,1441737240,4,507,126.75,1361020352493,1361020352621,1441733733,1441733861,128
1361020362,80056884,1,46,46,1361020334964,1361020334964,80029848,80029848,0
1361020364,1441745224,4,292,73,1361020355967,1361020356095,1441737191,1441737319,128
1361020364,1441745228,4,713,178.25,1361020363769,1361020363833,1441744997,1441745061,64
1361020364,1441745232,12,6459,538.25,1361020360759,1361020361399,1441741991,1441742631,640
1361020364,1441745240,4,1382,345.5,1361020357680,1361020357808,1441738920,1441739048,128
1361020372,1441753232,33,39666,1202,1361020351927,1361020367287,1441733159,1441748519,15360
1361020378,1441759172,2,287,143.5,1361020351922,1361020352818,1441733094,1441733990,896
1361020378,1441759172,1,46,46,1361020351985,1361020351985,1441733157,1441733157,0
1361020396,1441777220,2,123,61.5,1361020388801,1361020388801,1441770021,1441770021,0
1361020410,80104888,1,46,46,1361020383214,1361020383214,80078102,80078102,0
1361020420,1441801228,15,8003,533.5333333,1361020419323,1361020419835,1441800551,1441801063,512
1361020420,1441801236,4,456,114,1361020416176,1361020416240,1441797412,1441797476,64
1361020420,1441801236,4,292,73,1361020416304,1361020416368,1441797540,1441797604,64
1361020428,1441809232,4,312,78,1361020420983,1361020421111,1441802215,1441802343,128
1361020428,1441809232,4,310,77.5,1361020422070,1361020422198,1441803302,1441803430,128
1361020428,1441809240,6,2981,496.8333333,1361020420973,1361020421101,1441802213,1441802341,128
1361020428,1441809240,4,2893,723.25,1361020421356,1361020421420,1441802596,1441802660,64
1361020428,1441809240,4,312,78,1361020421420,1361020421484,1441802660,1441802724,64
1361020428,1441809240,4,312,78,1361020421548,1361020421612,1441802788,1441802852,64
1361020434,1441815492,2,265,132.5,1361020407985,1361020408113,1441789477,1441789605,128
1361020436,1441817224,4,292,73,1361020431358,1361020431486,1441812582,1441812710,128
1361020436,1441817224,4,456,114,1361020432125,1361020432253,1441813349,1441813477,128
1361020436,1441817224,4,456,114,1361020431933,1361020431997,1441813157,1441813221,64
1361020436,1441817232,3,144,48,1361020434294,1361020434486,1441815526,1441815718,192
1361020436,1441817232,3,144,48,1361020434294,1361020434486,1441815526,1441815718,192
1361020436,1441817236,4,495,123.75,1361020431216,1361020431344,1441812452,1441812580,128
1361020436,1441817236,232,343545,1480.797414,1361020421489,1361020430705,1441802725,1441811941,9216
1361020446,80141120,1,46,46,1361020421896,1361020421896,80117016,80117016,0
1361020490,1441871572,2,265,132.5,1361020463073,1361020463137,1441844645,1441844709,64
1361020516,1441897248,4,292,73,1361020509284,1361020509412,1441890532,1441890660,128
1361020516,1441897260,29,33602,1158.689655,1361020495958,1361020511318,1441877218,1441892578,15360
1361020522,1441903608,2,287,143.5,1361020495547,1361020496251,1441877155,1441877859,704
1361020524,1441905236,77304,115679527,1496.423562,1361020276144,1361020517872,1441657380,1441899108,241728
1361020534,1441915592,1,48,48,1361020508170,1361020508170,1441889762,1441889762,0
1361020560,80254428,2,98,49,1361020555197,1361020558653,80249625,80253081,3456
1361020560,80254428,2,98,49,1361020555197,1361020559677,80249625,80254105,4480
1361020578,1441959624,2,265,132.5,1361020551853,1361020551917,1441933477,1441933541,64
1361020596,1441977264,4,312,78,1361020594578,1361020594642,1441975842,1441975906,64
1361020596,1441977268,4,312,78,1361020595087,1361020595215,1441976355,1441976483,128
1361020596,1441977268,4,312,78,1361020595086,1361020595214,1441976354,1441976482,128
1361020596,1441977272,4,312,78,1361020595724,1361020595788,1441976996,1441977060,64
1361020596,1441977280,4,449,112.25,1361020591171,1361020591299,1441972451,1441972579,128
1361020596,1441977280,4,292,73,1361020591235,1361020591299,1441972515,1441972579,64
1361020596,1441977284,5,1797,359.4,1361020595521,1361020595777,1441976805,1441977061,256
1361020596,1441977284,4,312,78,1361020595584,1361020595712,1441976868,1441976996,128
1361020598,1441979716,1,46,46,1361020570829,1361020570829,1441952545,1441952545,0
1361020604,1441985264,9,6280,697.7777778,1361020596306,1361020601938,1441977570,1441983202,5632
1361020604,1441985264,19,12729,669.9473684,1361020599058,1361020603218,1441980322,1441984482,4160
1361020604,1441985264,24,16181,674.2083333,1361020599057,1361020603217,1441980321,1441984481,4160
1361020604,1441985268,34,35089,1032.029412,1361020599053,1361020603149,1441980321,1441984417,4096
1361020604,1441985268,26,16028,616.4615385,1361020599053,1361020603213,1441980321,1441984481,4160
1361020604,1441985268,4,395,98.75,1361020596687,1361020596815,1441977955,1441978083,128
1361020604,1441985272,2,98,49,1361020595532,1361020600972,1441976804,1441982244,5440
1361020604,1441985280,2,92,46,1361020595012,1361020600900,1441976292,1441982180,5888
1361020604,1441985280,4,449,112.25,1361020596483,1361020596547,1441977763,1441977827,64
1361020604,1441985280,4,292,73,1361020596483,1361020596611,1441977763,1441977891,128
1361020604,1441985304,4,312,78,1361020600298,1361020600490,1441981602,1441981794,192
1361020604,1441985304,11,5748,522.5454545,1361020600681,1361020601065,1441981985,1441982369,384
1361020604,1441985308,4,292,73,1361020596837,1361020596901,1441978145,1441978209,64
1361020604,1441985308,13,5365,412.6923077,1361020595624,1361020600872,1441976932,1441982180,5248
1361020604,1441985308,11,5044,458.5454545,1361020601064,1361020601256,1441982372,1441982564,192
1361020608,80302428,8,544,68,1361020600061,1361020605821,80294489,80300249,5760
1361020612,1441993280,8,535,66.875,1361020603268,1361020608900,1441984548,1441990180,5632
1361020612,1441993280,8,544,68,1361020599938,1361020605890,1441981218,1441987170,5952
1361020612,1441993280,9,587,65.22222222,1361020600130,1361020605890,1441981410,1441987170,5760
1361020612,1441993288,13,5365,412.6923077,1361020602172,1361020607868,1441983460,1441989156,5696
1361020612,1441993292,8,535,66.875,1361020603318,1361020608886,1441984610,1441990178,5568
1361020612,1441993292,9,581,64.55555556,1361020599926,1361020610806,1441981218,1441992098,10880
1361020612,1441993292,5,1019,203.8,1361020604918,1361020607094,1441986210,1441988386,2176
1361020612,1441993292,2,98,49,1361020600117,1361020605877,1441981409,1441987169,5760
1361020612,1441993292,9,587,65.22222222,1361020600117,1361020605877,1441981409,1441987169,5760
1361020612,1441993296,12,5071,422.5833333,1361020600435,1361020605875,1441981731,1441987171,5440
1361020612,1441993320,8,535,66.875,1361020601308,1361020606876,1441982628,1441988196,5568
1361020618,1441999668,4,1304,326,1361020593085,1361020594301,1441974753,1441975969,1216
1361020618,1441999700,1,76,76,1361020592159,1361020592159,1441973859,1441973859,0
1361020622,1442003676,16,12995,812.1875,1361020594230,1361020598134,1441975906,1441979810,3904
1361020622,1442003680,10,3099,309.9,1361020596020,1361020597492,1441977700,1441979172,1472
1361020622,1442003680,16,7288,455.5,1361020594610,1361020600498,1441976290,1441982178,5888
1361020622,1442003684,10,3377,337.7,1361020595055,1361020596079,1441976739,1441977763,1024
1361020622,1442003688,8,3183,397.875,1361020597545,1361020597609,1441979233,1441979297,64
1361020622,1442003692,6,2403,400.5,1361020597800,1361020598248,1441979492,1441979940,448
1361020622,1442003720,6,2036,339.3333333,1361020594569,1361020594633,1441976289,1441976353,64
1361020622,1442003724,43,56294,1309.162791,1361020594950,1361020595462,1441976674,1441977186,512
1361020622,1442003728,36,41221,1145.027778,1361020595202,1361020602882,1441976930,1441984610,7680
1361020622,1442003728,12,12122,1010.166667,1361020595329,1361020595457,1441977057,1441977185,128
1361020623,80317336,46,59819,1300.413043,1361020595606,1361020601046,80289942,80295382,5440
1361020623,80317340,17,17163,1009.588235,1361020595669,1361020600661,80290009,80295001,4992
1361020623,80317364,89,123943,1392.617978,1361020595581,1361020601469,80289945,80295833,5888
1361020623,80317364,23,24944,1084.521739,1361020595581,1361020600317,80289945,80294681,4736
1361020626,1442007656,31,35985,1160.806452,1361020598475,1361020599883,1441980131,1441981539,1408
1361020626,1442007656,47,60820,1294.042553,1361020598666,1361020601546,1441980322,1441983202,2880
1361020626,1442007656,14,3624,258.8571429,1361020598729,1361020601225,1441980385,1441982881,2496
1361020626,1442007660,9,7166,796.2222222,1361020599559,1361020600455,1441981219,1441982115,896
1361020626,1442007660,40,51200,1280,1361020599559,1361020600007,1441981219,1441981667,448
1361020626,1442007660,25,28677,1147.08,1361020599750,1361020600262,1441981410,1441981922,512
1361020626,1442007660,31,37839,1220.612903,1361020599750,1361020600198,1441981410,1441981858,448
1361020626,1442007660,4,1659,414.75,1361020599749,1361020599941,1441981409,1441981601,192
1361020626,1442007664,28,26470,945.3571429,1361020600706,1361020603074,1441982370,1441984738,2368
1361020626,1442007664,10,2136,213.6,1361020600706,1361020601090,1441982370,1441982754,384
1361020626,1442007672,60,77425,1290.416667,1361020598524,1361020599676,1441980196,1441981348,1152
1361020626,1442007672,7,3826,546.5714286,1361020598524,1361020599804,1441980196,1441981476,1280
1361020626,1442007672,50,65986,1319.72,1361020598652,1361020599676,1441980324,1441981348,1024
1361020626,1442007672,14,11384,813.1428571,1361020598651,1361020602875,1441980323,1441984547,4224
1361020626,1442007688,7,2161,308.7142857,1361020599530,1361020600170,1441981218,1441981858,640
1361020626,1442007688,57,76407,1340.473684,1361020599530,1361020600298,1441981218,1441981986,768
1361020626,1442007688,56,75281,1344.303571,1361020599721,1361020600873,1441981409,1441982561,1152
1361020626,1442007688,38,48212,1268.736842,1361020599721,1361020600873,1441981409,1441982561,1152
1361020626,1442007692,11,2326,211.4545455,1361020600678,1361020601190,1441982370,1441982882,512
1361020626,1442007692,10,2130,213,1361020600678,1361020601062,1441982370,1441982754,384
1361020626,1442007696,9,3676,408.4444444,1361020601634,1361020602978,1441983330,1441984674,1344
1361020627,80321328,13,13510,1039.230769,1361020600161,1361020600545,80294489,80294873,384
1361020627,80321328,7,4246,606.5714286,1361020600161,1361020600481,80294489,80294809,320
1361020627,80321328,6,3118,519.6666667,1361020600161,1361020600481,80294489,80294809,320
1361020627,80321340,6,2062,343.6666667,1361020600149,1361020600405,80294489,80294745,256
1361020627,80321340,7,4406,629.4285714,1361020600149,1361020600469,80294489,80294809,320
1361020627,80321340,6,2846,474.3333333,1361020600149,1361020600469,80294489,80294809,320
1361020627,80321340,22,26099,1186.318182,1361020599125,1361020600213,80293465,80294553,1088
1361020627,80321340,6,2558,426.3333333,1361020600149,1361020600469,80294489,80294809,320
1361020627,80321352,21,23398,1114.190476,1361020599496,1361020600520,80293848,80294872,1024
1361020630,1442011680,7,3771,538.7142857,1361020602865,1361020602993,1441984545,1441984673,128
1361020630,1442011720,8,5032,629,1361020604299,1361020604683,1441986019,1441986403,384
1361020630,1442011720,6,3310,551.6666667,1361020602827,1361020602955,1441984547,1441984675,128
1361020630,1442011720,9,1254,139.3333333,1361020602891,1361020603147,1441984611,1441984867,256
1361020634,1442015656,2,265,132.5,1361020607049,1361020607177,1441988705,1441988833,128
1361020634,1442015692,1,46,46,1361020606886,1361020606886,1441988578,1441988578,0
1361020638,1442019704,1,46,46,1361020612764,1361020612764,1441994468,1441994468,0
1361020638,1442019704,1,46,46,1361020613147,1361020613147,1441994851,1441994851,0
1361020638,1442019704,1,46,46,1361020613274,1361020613274,1441994978,1441994978,0
1361020638,1442019748,1,46,46,1361020612719,1361020612719,1441994467,1441994467,0
1361020638,1442019752,1,46,46,1361020613612,1361020613612,1441995364,1441995364,0
1361020646,1442027684,1,46,46,1361020618288,1361020618288,1441999972,1441999972,0
1361020660,1442041332,2,123,61.5,1361020658316,1361020658316,1442039648,1442039648,0
1361020660,1442041336,4,312,78,1361020658762,1361020658826,1442040098,1442040162,64
1361020660,1442041336,4,312,78,1361020659081,1361020659145,1442040417,1442040481,64
1361020660,1442041348,4,312,78,1361020658879,1361020658943,1442040227,1442040291,64
1361020660,1442041376,4,314,78.5,1361020657955,1361020658083,1442039331,1442039459,128
1361020662,1442043696,2,123,61.5,1361020657827,1361020657827,1442039523,1442039523,0
1361020666,1442047716,2,154,77,1361020641485,1361020641741,1442023201,1442023457,256
1361020666,1442047716,2,154,77,1361020641677,1361020641933,1442023393,1442023649,256
1361020668,1442049316,2,92,46,1361020658846,1361020663966,1442040162,1442045282,5120
1361020668,1442049332,2,92,46,1361020659024,1361020665040,1442040356,1442046372,6016
1361020670,1442051696,2,474,237,1361020645475,1361020645539,1442027171,1442027235,64
1361020670,1442051724,2,154,77,1361020642692,1361020642948,1442024416,1442024672,256
1361020678,1442059752,2,92,46,1361020653160,1361020653864,1442034912,1442035616,704
1361020682,1442063752,27,33829,1252.925926,1361020657514,1361020658538,1442039266,1442040290,1024
1361020684,1442065340,24054,35871257,1491.280328,1361020518021,1361020677061,1441899361,1442058401,159040
1361020686,1442067704,5,4331,866.2,1361020658395,1361020658587,1442040099,1442040291,192
1361020686,1442067704,18,23875,1326.388889,1361020658395,1361020658779,1442040099,1442040483,384
1361020686,1442067740,3,2177,725.6666667,1361020658359,1361020658551,1442040099,1442040291,192
1361020686,1442067740,14,16319,1165.642857,1361020658167,1361020658359,1442039907,1442040099,192
1361020686,1442067740,3,776,258.6666667,1361020658422,1361020658550,1442040162,1442040290,128
1361020686,1442067740,6,6803,1133.833333,1361020658357,1361020658613,1442040097,1442040353,256
1361020686,1442067740,12,8507,708.9166667,1361020658421,1361020658869,1442040161,1442040609,448
1361020686,1442067744,11,5054,459.4545455,1361020658611,1361020658803,1442040355,1442040547,192
1361020686,1442067744,3,1218,406,1361020658674,1361020658866,1442040418,1442040610,192
1361020690,1442071772,1,46,46,1361020662550,1361020662550,1442044322,1442044322,0
1361020690,1442071808,2,265,132.5,1361020662193,1361020662321,1442044001,1442044129,128
1361020690,1442071812,1,46,46,1361020662511,1361020662511,1442044323,1442044323,0
1361020710,1442091812,1,77,77,1361020685742,1361020685742,1442067554,1442067554,0
1361020714,1442095748,2,154,77,1361020687021,1361020687213,1442068769,1442068961,192
1361020714,1442095752,2,154,77,1361020688041,1361020688233,1442069793,1442069985,192
1361020714,1442095784,2,474,237,1361020685963,1361020686027,1442067747,1442067811,64
1361020716,1442097360,384,567410,1477.630208,1361020595699,1361020713075,1441977059,1442094435,117376
1361020718,1442099796,1,46,46,1361020690750,1361020690750,1442072546,1442072546,0
1361020724,1442105348,6,381,63.5,1361020719869,1361020723581,1442101217,1442104929,3712
1361020724,1442105348,3,180,60,1361020723261,1361020723645,1442104609,1442104993,384
1361020724,1442105348,3,180,60,1361020723452,1361020723708,1442104800,1442105056,256
1361020724,1442105348,5,314,62.8,1361020720060,1361020721852,1442101408,1442103200,1792
1361020724,1442105348,5,314,62.8,1361020720252,1361020722044,1442101600,1442103392,1792
1361020724,1442105352,5,314,62.8,1361020720379,1361020722683,1442101731,1442104035,2304
1361020724,1442105352,4,247,61.75,1361020720379,1361020722107,1442101731,1442103459,1728
1361020724,1442105352,4,247,61.75,1361020721144,1361020722808,1442102496,1442104160,1664
1361020724,1442105352,6,1226,204.3333333,1361020713144,1361020720888,1442094496,1442102240,7744
1361020724,1442105352,5,314,62.8,1361020721272,1361020723128,1442102624,1442104480,1856
1361020724,1442105352,5,230,46,1361020718135,1361020723255,1442099487,1442104607,5120
1361020724,1442105360,3,180,60,1361020723185,1361020723441,1442104545,1442104801,256
1361020724,1442105360,6,381,63.5,1361020719793,1361020723377,1442101153,1442104737,3584
1361020724,1442105360,5,314,62.8,1361020719857,1361020723569,1442101217,1442104929,3712
1361020724,1442105360,5,314,62.8,1361020720240,1361020722160,1442101600,1442103520,1920
1361020724,1442105360,5,314,62.8,1361020720368,1361020722480,1442101728,1442103840,2112
1361020724,1442105360,5,314,62.8,1361020720368,1361020722352,1442101728,1442103712,1984
1361020724,1442105364,4,184,46,1361020718254,1361020723118,1442099618,1442104482,4864
1361020724,1442105364,5,314,62.8,1361020721261,1361020723181,1442102625,1442104545,1920
1361020724,1442105388,5,314,62.8,1361020721236,1361020723156,1442102624,1442104544,1920
1361020732,1442113348,2,134,67,1361020724095,1361020728255,1442105443,1442109603,4160
1361020732,1442113348,2,134,67,1361020724350,1361020728830,1442105698,1442110178,4480
1361020732,1442113348,2,134,67,1361020724476,1361020729148,1442105824,1442110496,4672
1361020732,1442113348,2,134,67,1361020724603,1361020729147,1442105951,1442110495,4544
1361020732,1442113352,2,134,67,1361020724921,1361020729849,1442106273,1442111201,4928
1361020732,1442113352,2,134,67,1361020724985,1361020729465,1442106337,1442110817,4480
1361020732,1442113352,2,134,67,1361020725304,1361020730552,1442106656,1442111904,5248
1361020732,1442113356,2,134,67,1361020723957,1361020728181,1442105313,1442109537,4224
1361020732,1442113356,4,268,67,1361020723957,1361020731253,1442105313,1442112609,7296
1361020732,1442113356,4,268,67,1361020724212,1361020731252,1442105568,1442112608,7040
1361020732,1442113356,3,201,67,1361020724339,1361020728819,1442105695,1442110175,4480
1361020732,1442113360,2,134,67,1361020725232,1361020729456,1442106592,1442110816,4224
1361020732,1442113360,2,134,67,1361020725296,1361020729584,1442106656,1442110944,4288
1361020732,1442113360,2,134,67,1361020725296,1361020729584,1442106656,1442110944,4288
1361020732,1442113388,12,5070,422.5,1361020713109,1361020729621,1442094497,1442111009,16512
1361020738,1442119796,2,92,46,1361020710523,1361020710523,1442092319,1442092319,0
1361020738,1442119836,1,46,46,1361020711444,1361020711444,1442093280,1442093280,0
1361020738,1442119840,2,92,46,1361020711443,1361020711443,1442093283,1442093283,0
1361020738,1442119844,9,5383,598.1111111,1361020712654,1361020713166,1442094498,1442095010,512
1361020740,1442121356,2,134,67,1361020727605,1361020735669,1442108961,1442117025,8064
1361020740,1442121356,2,134,67,1361020727860,1361020736436,1442109216,1442117792,8576
1361020740,1442121360,2,92,46,1361020728690,1361020739890,1442110050,1442121250,11200
1361020740,1442121368,2,134,67,1361020727082,1361020734634,1442108450,1442116002,7552
1361020740,1442121372,2,92,46,1361020728614,1361020739366,1442109986,1442120738,10752
1361020748,1442129348,2,134,67,1361020734718,1361020746494,1442116066,1442127842,11776
1361020748,1442129348,2,92,46,1361020734782,1361020745022,1442116130,1442126370,10240
1361020750,1442131788,3,657,219,1361020723718,1361020743110,1442105506,1442124898,19392
1361020754,1442135820,7,2996,428,1361020726181,1361020743525,1442108001,1442125345,17344
1361020756,1442137372,2,134,67,1361020737892,1361020754788,1442119264,1442136160,16896
1361020756,1442137376,2,134,67,1361020739297,1361020755361,1442120673,1442136737,16064
1361020756,1442137376,2,134,67,1361020736479,1361020752991,1442117855,1442134367,16512
1361020756,1442137380,2,134,67,1361020736542,1361020753246,1442117922,1442134626,16704
1361020756,1442137380,12,999,83.25,1361020745756,1361020755228,1442127136,1442136608,9472
1361020756,1442137396,2,134,67,1361020737612,1361020755340,1442119008,1442136736,17728
1361020756,1442137396,2,134,67,1361020738124,1361020755276,1442119520,1442136672,17152
1361020756,1442137396,12,999,83.25,1361020745995,1361020755211,1442127391,1442136607,9216
1361020758,1442139804,2,134,67,1361020737715,1361020754867,1442119519,1442136671,17152
1361020762,1442143816,2,134,67,1361020737832,1361020755560,1442119648,1442137376,17728
1361020762,1442143864,2,134,67,1361020737721,1361020755897,1442119585,1442137761,18176
1361020764,1442145376,2,134,67,1361020739617,1361020759137,1442120993,1442140513,19520
1361020764,1442145376,2,134,67,1361020741087,1361020762207,1442122463,1442143583,21120
1361020764,1442145384,2,134,67,1361020738521,1361020757337,1442119905,1442138721,18816
1361020764,1442145388,2,134,67,1361020739477,1361020756053,1442120865,1442137441,16576
1361020772,1442153364,4,184,46,1361020769645,1361020771245,1442151009,1442152609,1600
1361020774,1442155808,1,67,67,1361020749296,1361020749296,1442131104,1442131104,0
1361020778,1442159808,1,67,67,1361020753135,1361020753135,1442134943,1442134943,0
1361020778,1442159836,1,67,67,1361020751315,1361020751315,1442133151,1442133151,0
1361020780,1442161376,5,354,70.8,1361020773409,1361020777057,1442154785,1442158433,3648
1361020786,1442167856,1,46,46,1361020760450,1361020760450,1442142306,1442142306,0
1361020786,1442167900,1,428,428,1361020760981,1361020760981,1442142881,1442142881,0
1361020786,1442167900,1,46,46,1361020761619,1361020761619,1442143519,1442143519,0
1361020790,1442171872,1,46,46,1361020764975,1361020764975,1442146847,1442146847,0
1361020794,1442175868,1,219,219,1361020768946,1361020768946,1442150814,1442150814,0
1361020794,1442175868,1,67,67,1361020769587,1361020769587,1442151455,1442151455,0
1361020796,1442177376,327,457932,1400.40367,1361020658718,1361020791198,1442040094,1442172574,132480
1361020806,1442187836,1,67,67,1361020779411,1361020779411,1442161247,1442161247,0
1361020806,1442187836,3,231,77,1361020780754,1361020805778,1442162590,1442187614,25024
1361020810,1442191860,1,67,67,1361020785532,1361020785532,1442167392,1442167392,0
1361020810,1442191860,1,46,46,1361020785724,1361020785724,1442167584,1442167584,0
1361020810,1442191860,1,46,46,1361020785724,1361020785724,1442167584,1442167584,0
1361020810,1442191884,1,67,67,1361020783395,1361020783395,1442165279,1442165279,0
1361020810,1442191892,1,46,46,1361020785691,1361020785691,1442167583,1442167583,0
1361020812,1442193364,1,46,46,1361020786219,1361020786219,1442167583,1442167583,0
1361020814,1442195828,2,495,247.5,1361020786206,1361020796254,1442168034,1442178082,10048
1361020814,1442195828,1,67,67,1361020788123,1361020788123,1442169951,1442169951,0
1361020814,1442195832,1,67,67,1361020787095,1361020787095,1442168927,1442168927,0
1361020814,1442195836,1,67,67,1361020787412,1361020787412,1442169248,1442169248,0
1361020814,1442195836,1,67,67,1361020789075,1361020789075,1442170911,1442170911,0
1361020814,1442195860,1,67,67,1361020786301,1361020786301,1442168161,1442168161,0
1361020814,1442195864,1,67,67,1361020788728,1361020788728,1442170592,1442170592,0
1361020814,1442195868,1,67,67,1361020789046,1361020789046,1442170914,1442170914,0
1361020818,1442199844,1,46,46,1361020790730,1361020790730,1442172574,1442172574,0
1361020818,1442199852,1,67,67,1361020792195,1361020792195,1442174047,1442174047,0
1361020818,1442199860,1,67,67,1361020790268,1361020790268,1442172128,1442172128,0
1361020818,1442199884,1,67,67,1361020790948,1361020790948,1442172832,1442172832,0
1361020822,1442203848,1,67,67,1361020794503,1361020794503,1442176351,1442176351,0
1361020822,1442203864,1,67,67,1361020797754,1361020797754,1442179618,1442179618,0
1361020828,1442209392,134,146464,1093.014925,1361020594448,1361020825488,1441975840,1442206880,231040
1361020830,1442211888,1,46,46,1361020805921,1361020805921,1442187809,1442187809,0
1361020830,1442211892,1,67,67,1361020803868,1361020803868,1442185760,1442185760,0
1361020836,1442217404,2,134,67,1361020828610,1361020834818,1442210014,1442216222,6208
1361020842,1442223940,1,67,67,1361020816748,1361020816748,1442198688,1442198688,0
1361020844,1442225388,7,632,90.28571429,1361020836369,1361020840465,1442217757,1442221853,4096
1361020844,1442225432,7,632,90.28571429,1361020837733,1361020841893,1442219165,1442223325,4160
1361020844,1442225432,7,632,90.28571429,1361020837865,1361020842089,1442219297,1442223521,4224
1361020852,1442233388,3,138,46,1361020847443,1361020850451,1442228831,1442231839,3008
1361020866,1442247912,1,77,77,1361020839045,1361020839045,1442220957,1442220957,0
1361020868,1442249396,2,92,46,1361020854474,1361020862474,1442235870,1442243870,8000
1361020874,1442255944,2,134,67,1361020846823,1361020871783,1442228767,1442253727,24960
1361020882,1442263888,7,508,72.57142857,1361020856096,1361020872672,1442237984,1442254560,16576
1361020900,1442281428,3,138,46,1361020898666,1361020899562,1442280094,1442280990,896
1361020899,80593616,225,318033,1413.48,1361020595328,1361020601792,80289944,80296408,6464
1361020899,80593616,117,158962,1358.649573,1361020595264,1361020600192,80289880,80294808,4928
1361020906,1442287912,1255,1876734,1495.405578,1361020597958,1361020601478,1441979870,1441983390,3520
1361020908,1442289452,2,92,46,1361020900819,1361020903251,1442282271,1442284703,2432
1361020915,1442296228,1,77,77,1361020890483,1361020890483,1442271711,1442271711,0
1361020927,1442308232,1,46,46,1361020902256,1361020902256,1442283488,1442283488,0
1361020931,1442312204,1,46,46,1361020904075,1361020904075,1442285279,1442285279,0
1361020931,1442312208,1,46,46,1361020904711,1361020904711,1442285919,1442285919,0
1361020931,1442312208,1,46,46,1361020905349,1361020905349,1442286557,1442286557,0
1361020931,1442312240,1,46,46,1361020904038,1361020904038,1442285278,1442285278,0
1361020931,1442312244,1,46,46,1361020904673,1361020904673,1442285917,1442285917,0
1361020931,1442312248,1,46,46,1361020905439,1361020905439,1442286687,1442286687,0
1361020931,1442312248,1,46,46,1361020905247,1361020905247,1442286495,1442286495,0
1361020931,1442312248,1,46,46,1361020905311,1361020905311,1442286559,1442286559,0
1361020931,1442312248,1,46,46,1361020905757,1361020905757,1442287005,1442287005,0
1361020940,1442321452,4,184,46,1361020931475,1361020938451,1442312927,1442319903,6976
1361020947,1442328228,1,67,67,1361020922545,1361020922545,1442303773,1442303773,0
1361020951,1442332236,1,77,77,1361020924714,1361020924714,1442305950,1442305950,0
1361020971,1442352204,1,46,46,1361020946697,1361020946697,1442327901,1442327901,0
1361021100,1442481516,2,123,61.5,1361021099665,1361021099665,1442481181,1442481181,0
1361021104,80798600,6,431,71.83333333,1361021099924,1361021103700,80794524,80798300,3776
1361021104,80798600,6,431,71.83333333,1361021100115,1361021103763,80794715,80798363,3648
1361021104,80798600,5,354,70.8,1361021100179,1361021102035,80794779,80796635,1856
1361021104,80798600,4,277,69.25,1361021100371,1361021102291,80794971,80796891,1920
1361021104,80798600,5,354,70.8,1361021100115,1361021103187,80794715,80797787,3072
1361021104,80798600,6,431,71.83333333,1361021100179,1361021103891,80794779,80798491,3712
1361021104,80798600,5,354,70.8,1361021100179,1361021103315,80794779,80797915,3136
1361021104,80798600,5,354,70.8,1361021101842,1361021103506,80796442,80798106,1664
1361021104,80798604,6,431,71.83333333,1361021100176,1361021103888,80794780,80798492,3712
1361021104,80798604,6,431,71.83333333,1361021100176,1361021103952,80794780,80798556,3776
1361021104,80798604,5,354,70.8,1361021100112,1361021101904,80794716,80796508,1792
1361021104,80798604,6,431,71.83333333,1361021100176,1361021103824,80794780,80798428,3648
1361021104,80798604,6,431,71.83333333,1361021100176,1361021103952,80794780,80798556,3776
1361021104,80798604,6,431,71.83333333,1361021100176,1361021103824,80794780,80798428,3648
1361021104,80798604,5,354,70.8,1361021100687,1361021102287,80795291,80796891,1600
1361021108,1442489504,5,354,70.8,1361021100058,1361021104090,1442481562,1442485594,4032
1361021108,1442489508,6,431,71.83333333,1361021103125,1361021106645,1442484633,1442488153,3520
1361021108,1442489508,4,308,77,1361021100249,1361021107737,1442481757,1442489245,7488
1361021108,1442489516,5,354,70.8,1361021103053,1361021105357,1442484569,1442486873,2304
1361021108,1442489520,6,431,71.83333333,1361021103053,1361021106701,1442484573,1442488221,3648
1361021108,1442489520,6,431,71.83333333,1361021103117,1361021106637,1442484637,1442488157,3520
1361021112,80806608,2,154,77,1361021104140,1361021108364,80798748,80802972,4224
1361021112,80806608,2,154,77,1361021104010,1361021108234,80798618,80802842,4224
1361021112,80806608,2,154,77,1361021104138,1361021107786,80798746,80802394,3648
1361021112,80806608,2,154,77,1361021104906,1361021110154,80799514,80804762,5248
1361021112,80806608,2,154,77,1361021105417,1361021109321,80800025,80803929,3904
1361021119,80813932,2,154,77,1361021107337,1361021115081,80802269,80810013,7744
1361021120,80814608,2,154,77,1361021107789,1361021115661,80802397,80810269,7872
1361021120,80814608,2,154,77,1361021107852,1361021115852,80802460,80810460,8000
1361021120,80814608,2,154,77,1361021107916,1361021115916,80802524,80810524,8000
1361021120,80814608,2,154,77,1361021107594,1361021115274,80802202,80809882,7680
1361021120,80814608,2,154,77,1361021107658,1361021115722,80802266,80810330,8064
1361021120,80814608,2,154,77,1361021107850,1361021115786,80802458,80810394,7936
1361021120,80814608,2,154,77,1361021107978,1361021116042,80802586,80810650,8064
1361021120,80814612,2,154,77,1361021106632,1361021113672,80801244,80808284,7040
1361021120,80814612,2,154,77,1361021106888,1361021114056,80801500,80808668,7168
1361021124,1442505544,2,154,77,1361021108658,1361021117810,1442490202,1442499354,9152
1361021135,1442516360,3,231,77,1361021108140,1361021123884,1442489500,1442505244,15744
1361021135,1442516376,3,231,77,1361021110554,1361021133082,1442491930,1442514458,22528
1361021135,1442516416,3,231,77,1361021110452,1361021132788,1442491868,1442514204,22336
1361021135,1442516416,3,231,77,1361021110644,1361021133812,1442492060,1442515228,23168
1361021136,80830640,2,154,77,1361021116971,1361021132459,80811611,80827099,15488
1361021136,80830644,2,154,77,1361021116776,1361021133608,80811420,80828252,16832
1361021136,80830644,2,154,77,1361021116648,1361021133544,80811292,80828188,16896
1361021136,80830644,2,154,77,1361021115111,1361021129831,80809755,80824475,14720
1361021140,1442521552,2,154,77,1361021116266,1361021133482,1442497818,1442515034,17216
1361021144,80838628,2,154,77,1361021120565,1361021141493,80815193,80836121,20928
1361021156,80850156,1,77,77,1361021128846,1361021128846,80823002,80823002,0
1361021156,80850164,1,77,77,1361021131272,1361021131272,80825436,80825436,0
1361021156,80850164,1,77,77,1361021131782,1361021131782,80825946,80825946,0
1361021156,80850168,1,77,77,1361021128133,1361021128133,80822301,80822301,0
1361021156,80850184,1,77,77,1361021131125,1361021131125,80825309,80825309,0
1361021156,80850184,1,77,77,1361021132019,1361021132019,80826203,80826203,0
1361021160,80854164,1,77,77,1361021132166,1361021132166,80826330,80826330,0
1361021160,80854164,1,77,77,1361021132297,1361021132297,80826461,80826461,0
1361021160,80854168,1,77,77,1361021132548,1361021132548,80826716,80826716,0
1361021160,80854192,1,77,77,1361021132267,1361021132267,80826459,80826459,0
1361021163,1442544392,1,77,77,1361021136331,1361021136331,1442517723,1442517723,0
1361021164,1442545560,6,381,63.5,1361021159072,1361021162528,1442540632,1442544088,3456
1361021171,1442552416,1,77,77,1361021144755,1361021144755,1442526171,1442526171,0
1361021184,80878208,1,77,77,1361021156125,1361021156125,80850333,80850333,0
1361021184,80878228,1,77,77,1361021157446,1361021157446,80851674,80851674,0
1361021184,80878236,1,77,77,1361021159552,1361021159552,80853788,80853788,0
1361021187,1442568464,1,77,77,1361021162436,1361021162436,1442543900,1442543900,0
1361021188,80882208,1,77,77,1361021161883,1361021161883,80856091,80856091,0
1361021188,80882212,1,77,77,1361021163159,1361021163159,80857371,80857371,0
1361021188,80882212,1,77,77,1361021163671,1361021163671,80857883,80857883,0
1361021188,80882212,1,77,77,1361021163799,1361021163799,80858011,80858011,0
1361021188,80882212,1,77,77,1361021163926,1361021163926,80858138,80858138,0
1361021188,80882228,1,77,77,1361021162184,1361021162184,80856412,80856412,0
1361021191,1442572432,1,77,77,1361021162976,1361021162976,1442544408,1442544408,0
1361021191,1442572444,1,77,77,1361021164695,1361021164695,1442546139,1442546139,0
1361021191,1442572476,3,201,67,1361021166262,1361021188278,1442547738,1442569754,22016
1361021192,80886208,1,77,77,1361021164187,1361021164187,80858395,80858395,0
1361021192,80886208,1,77,77,1361021164379,1361021164379,80858587,80858587,0
1361021192,80886208,1,77,77,1361021164698,1361021164698,80858906,80858906,0
1361021192,80886220,1,77,77,1361021167760,1361021167760,80861980,80861980,0
1361021192,80886240,1,77,77,1361021167803,1361021167803,80862043,80862043,0
1361021195,1442576416,1,77,77,1361021167986,1361021167986,1442549402,1442549402,0
1361021199,1442580464,1,77,77,1361021172930,1361021172930,1442554394,1442554394,0
1361021208,80902240,1,77,77,1361021183740,1361021183740,80877980,80877980,0
1361021211,1442592444,1,77,77,1361021186646,1361021186646,1442568090,1442568090,0
1361021243,1442624496,1,67,67,1361021217696,1361021217696,1442599192,1442599192,0
1361021560,1442941132,2,122,61,1361021532425,1361021534857,1442913557,1442915989,2432
1361021628,1443009400,2,122,61,1361021603067,1361021605243,1442984467,1442986643,2176
1361022341,1443722260,1,48,48,1361022315006,1361022315006,1443696266,1443696266,0
1361022569,1443950644,9,861,95.66666667,1361022544120,1361022544312,1443925764,1443925956,192
1361022569,1443950680,14,6617,472.6428571,1361022543443,1361022543763,1443925123,1443925443,320
1361022569,1443950680,9,861,95.66666667,1361022543830,1361022543958,1443925510,1443925638,128
1361022797,1444178700,11,953,86.63636364,1361022781116,1361022792700,1444162816,1444174400,11584
1361022797,1444178700,12,999,83.25,1361022781564,1361022792700,1444163264,1444174400,11136
1361022797,1444178712,12,999,83.25,1361022780594,1361022792690,1444162306,1444174402,12096
1361022797,1444178712,12,999,83.25,1361022780849,1361022792689,1444162561,1444174401,11840
1361022810,1444191124,1,46,46,1361022785662,1361022785662,1444166786,1444166786,0
1361022878,1444259240,1,63,63,1361022851529,1361022851529,1444232769,1444232769,0
1361022886,1444267248,1,46,46,1361022858752,1361022858752,1444240000,1444240000,0
1361022957,1444338812,3,189,63,1361022952396,1361022955404,1444334208,1444337216,3008
1361022957,1444338812,4,252,63,1361022948234,1361022955338,1444330046,1444337150,7104
1361022973,1444354808,2,126,63,1361022959440,1361022967504,1444341248,1444349312,8064
1361022990,1444371424,1,63,63,1361022963728,1361022963728,1444345152,1444345152,0
1361023278,1444659824,1,48,48,1361023250041,1361023250041,1444631865,1444631865,0
1361023435,1444816376,1,46,46,1361023410039,1361023410039,1444791415,1444791415,0
1361023655,1445036992,1,48,48,1361023627979,1361023627979,1445009971,1445009971,0
1361023700,1445081188,1,46,46,1361023674671,1361023674671,1445055859,1445055859,0
1361023708,1445089176,1,46,46,1361023680124,1361023680124,1445061300,1445061300,0
1361023734,1445115200,16,6372,398.25,1361023716645,1361023728805,1445097845,1445110005,12160
1361023734,1445115204,13,1045,80.38461538,1361023717021,1361023729117,1445098225,1445110321,12096
1361023734,1445115204,12,999,83.25,1361023717598,1361023728734,1445098802,1445109938,11136
1361023734,1445115240,12,999,83.25,1361023717307,1361023728699,1445098547,1445109939,11392
1361023889,1445270872,1,46,46,1361023860863,1361023860863,1445242735,1445242735,0
1361023889,1445270872,1,46,46,1361023860863,1361023860863,1445242735,1445242735,0
1361023889,1445270876,1,46,46,1361023860860,1361023860860,1445242736,1445242736,0
1361023889,1445270888,1,46,46,1361023860913,1361023860913,1445242801,1445242801,0
1361024126,1445507540,12,999,83.25,1361024114442,1361024123914,1445495982,1445505454,9472
1361024126,1445507540,12,999,83.25,1361024114696,1361024123912,1445496236,1445505452,9216
1361024126,1445507552,16,6372,398.25,1361024114045,1361024123901,1445495597,1445505453,9856
1361024126,1445507576,12,999,83.25,1361024114919,1361024123879,1445496495,1445505455,8960
1361024694,1446075224,2,122,61,1361024666173,1361024666557,1446047397,1446047781,384
1361024730,1446111308,2,122,61,1361024702569,1361024704553,1446083877,1446085861,1984
1361024854,1446235584,2,122,61,1361024828945,1361024831313,1446210529,1446212897,2368
1361025002,1446383620,1,46,46,1361024977196,1361024977196,1446358816,1446358816,0
1361025006,1446387968,12,999,83.25,1361024992464,1361025004112,1446374432,1446386080,11648
1361025006,1446387976,16,6372,398.25,1361024992007,1361025004103,1446373983,1446386079,12096
1361025006,1446387980,12,999,83.25,1361024992706,1361025004034,1446374686,1446386014,11328
1361025007,1446388000,12,999,83.25,1361024993942,1361025005014,1446374942,1446386014,11072
1361025070,1446451880,1,46,46,1361025045479,1361025045479,1446427359,1446427359,0
1361025098,1446479888,1,56,56,1361025070367,1361025070367,1446452255,1446452255,0
1361025195,1446576056,1,46,46,1361025170079,1361025170079,1446551135,1446551135,0
1361025451,1446832516,2,122,61,1361025425486,1361025427918,1446807002,1446809434,2432
1361025904,1447285320,12,999,83.25,1361025889161,1361025898377,1447270481,1447279697,9216
1361025904,1447285332,16,6372,398.25,1361025888765,1361025898365,1447270097,1447279697,9600
1361025904,1447285336,11,953,86.63636364,1361025889404,1361025898364,1447270740,1447279700,8960
1361025904,1447285336,11,953,86.63636364,1361025889659,1361025898363,1447270995,1447279699,8704
1361026152,1447533904,2,122,61,1361026125180,1361026127484,1447507084,1447509388,2304
1361026160,1447541456,12,999,83.25,1361026148607,1361026157951,1447530063,1447539407,9344
1361026160,1447541456,11,953,86.63636364,1361026149117,1361026157949,1447530573,1447539405,8832
1361026160,1447541464,17,6895,405.5882353,1361026147830,1361026157942,1447529294,1447539406,10112
1361026160,1447541468,11,953,86.63636364,1361026148851,1361026157939,1447530319,1447539407,9088
1361026160,1447541500,16,6372,398.25,1361026148115,1361026157907,1447529615,1447539407,9792
1361026204,1447585944,3,138,46,1361026177685,1361026186773,1447559629,1447568717,9088
1361026365,1447746392,1,46,46,1361026337659,1361026337659,1447719051,1447719051,0
1361026760,1448141796,5,1797,359.4,1361026756257,1361026756385,1448138053,1448138181,128
1361026768,1448149788,4,190,47.5,1361026765479,1361026765863,1448147267,1448147651,384
1361026768,1448149792,4,190,47.5,1361026761511,1361026761767,1448143303,1448143559,256
1361026768,1448149792,4,190,47.5,1361026765543,1361026765863,1448147335,1448147655,320
1361026768,1448149792,8,1501,187.625,1361026757797,1361026763109,1448139589,1448144901,5312
1361026768,1448149792,4,190,47.5,1361026760229,1361026760805,1448142021,1448142597,576
1361026768,1448149792,4,190,47.5,1361026762213,1361026762469,1448144005,1448144261,256
1361026768,1448149792,4,190,47.5,1361026762276,1361026762596,1448144068,1448144388,320
1361026768,1448149792,4,190,47.5,1361026762212,1361026762468,1448144004,1448144260,256
1361026768,1448149796,4,190,47.5,1361026762463,1361026762783,1448144259,1448144579,320
1361026768,1448149796,4,190,47.5,1361026763041,1361026763297,1448144837,1448145093,256
1361026768,1448149796,4,190,47.5,1361026766241,1361026766561,1448148037,1448148357,320
1361026768,1448149796,4,190,47.5,1361026763233,1361026763553,1448145029,1448145349,320
1361026768,1448149796,4,190,47.5,1361026763296,1361026763616,1448145092,1448145412,320
1361026768,1448149796,4,190,47.5,1361026763360,1361026765664,1448145156,1448147460,2304
1361026768,1448149796,4,190,47.5,1361026760928,1361026761824,1448142724,1448143620,896
1361026768,1448149800,4,190,47.5,1361026763870,1361026764382,1448145670,1448146182,512
1361026768,1448149800,4,190,47.5,1361026764189,1361026764253,1448145989,1448146053,64
1361026768,1448149800,4,190,47.5,1361026764189,1361026764701,1448145989,1448146501,512
1361026768,1448149800,4,190,47.5,1361026764381,1361026764445,1448146181,1448146245,64
1361026768,1448149800,11,2994,272.1818182,1361026756125,1361026762141,1448137925,1448143941,6016
1361026768,1448149800,2,92,46,1361026756253,1361026762205,1448138053,1448144005,5952
1361026768,1448149800,4,190,47.5,1361026764444,1361026764508,1448146244,1448146308,64
1361026768,1448149800,4,190,47.5,1361026764508,1361026764636,1448146308,1448146436,128
1361026768,1448149800,4,190,47.5,1361026764508,1361026764572,1448146308,1448146372,64
1361026768,1448149800,4,190,47.5,1361026764764,1361026765084,1448146564,1448146884,320
1361026768,1448149800,4,190,47.5,1361026764827,1361026765147,1448146627,1448146947,320
1361026768,1448149804,4,190,47.5,1361026765083,1361026765467,1448146887,1448147271,384
1361026768,1448149804,2,92,46,1361026756443,1361026762203,1448138247,1448144007,5760
1361026768,1448149804,2,98,49,1361026756251,1361026762139,1448138055,1448143943,5888
1361026768,1448149804,2,92,46,1361026756378,1361026762138,1448138182,1448143942,5760
1361026768,1448149804,2,92,46,1361026756442,1361026762202,1448138246,1448144006,5760
1361026768,1448149804,11,2994,272.1818182,1361026756506,1361026762138,1448138310,1448143942,5632
1361026768,1448149804,4,190,47.5,1361026765146,1361026765530,1448146950,1448147334,384
1361026768,1448149804,4,190,47.5,1361026765529,1361026765913,1448147333,1448147717,384
1361026768,1448149804,4,190,47.5,1361026765720,1361026766040,1448147524,1448147844,320
1361026768,1448149804,4,190,47.5,1361026761752,1361026762008,1448143556,1448143812,256
1361026768,1448149804,14,5411,386.5,1361026757784,1361026767256,1448139588,1448149060,9472
1361026768,1448149804,4,190,47.5,1361026762007,1361026762263,1448143811,1448144067,256
1361026768,1448149808,4,190,47.5,1361026765910,1361026766230,1448147718,1448148038,320
1361026768,1448149808,4,190,47.5,1361026760342,1361026761238,1448142150,1448143046,896
1361026768,1448149808,4,190,47.5,1361026762453,1361026762773,1448144261,1448144581,320
1361026768,1448149808,4,190,47.5,1361026762581,1361026762837,1448144389,1448144645,256
1361026768,1448149808,4,190,47.5,1361026766037,1361026766421,1448147845,1448148229,384
1361026768,1448149808,4,190,47.5,1361026762772,1361026763028,1448144580,1448144836,256
1361026768,1448149808,4,190,47.5,1361026762772,1361026763028,1448144580,1448144836,256
1361026768,1448149808,4,190,47.5,1361026762836,1361026763092,1448144644,1448144900,256
1361026768,1448149808,4,190,47.5,1361026763027,1361026763283,1448144835,1448145091,256
1361026768,1448149812,4,190,47.5,1361026763091,1361026763347,1448144903,1448145159,256
1361026768,1448149832,4,190,47.5,1361026763261,1361026763517,1448145093,1448145349,256
1361026768,1448149832,4,190,47.5,1361026760893,1361026763197,1448142725,1448145029,2304
1361026768,1448149832,4,190,47.5,1361026763516,1361026763772,1448145348,1448145604,256
1361026768,1448149832,4,190,47.5,1361026763644,1361026764092,1448145476,1448145924,448
1361026768,1448149832,4,190,47.5,1361026763707,1361026764219,1448145539,1448146051,512
1361026768,1448149836,4,190,47.5,1361026764090,1361026764602,1448145926,1448146438,512
1361026768,1448149836,4,190,47.5,1361026764218,1361026764346,1448146054,1448146182,128
1361026768,1448149836,4,190,47.5,1361026764537,1361026764665,1448146373,1448146501,128
1361026768,1448149836,4,190,47.5,1361026764601,1361026764665,1448146437,1448146501,64
1361026768,1448149836,4,190,47.5,1361026764409,1361026764473,1448146245,1448146309,64
1361026768,1448149836,4,190,47.5,1361026764473,1361026764601,1448146309,1448146437,128
1361026768,1448149836,4,190,47.5,1361026764792,1361026765176,1448146628,1448147012,384
1361026768,1448149836,4,190,47.5,1361026765176,1361026765496,1448147012,1448147332,320
1361026769,86463564,2,98,49,1361026760925,1361026766301,86455489,86460865,5376
1361026769,86463564,2,98,49,1361026761884,1361026765276,86456448,86459840,3392
1361026769,86463564,3,144,48,1361026761884,1361026767516,86456448,86462080,5632
1361026769,86463564,2,98,49,1361026760922,1361026764250,86455486,86458814,3328
1361026776,1448157816,3,144,48,1361026775181,1361026775309,1448156997,1448157125,128
1361026776,1448157820,51,65845,1291.078431,1361026757002,1361026772362,1448138822,1448154182,15360
1361026776,1448157820,4,190,47.5,1361026765832,1361026768200,1448147652,1448150020,2368
1361026776,1448157820,4,190,47.5,1361026765831,1361026768263,1448147651,1448150083,2432
1361026777,86471564,2,98,49,1361026768154,1361026771546,86462718,86466110,3392
1361026777,86471564,2,98,49,1361026768154,1361026772570,86462718,86467134,4416
1361026782,1448163352,11,4804,436.7272727,1361026756828,1361026757724,1448138180,1448139076,896
1361026782,1448163352,12,4205,350.4166667,1361026756892,1361026758044,1448138244,1448139396,1152
1361026782,1448163392,9,5369,596.5555556,1361026756469,1361026756917,1448137861,1448138309,448
1361026782,1448163396,13,6784,521.8461538,1361026756466,1361026757874,1448137862,1448139270,1408
1361026782,1448163396,3,1074,358,1361026756658,1361026756786,1448138054,1448138182,128
1361026782,1448163396,6,2425,404.1666667,1361026756785,1361026757105,1448138181,1448138501,320
1361026782,1448163396,16,7398,462.375,1361026756785,1361026758385,1448138181,1448139781,1600
1361026782,1448163400,1,76,76,1361026757358,1361026757358,1448138758,1448138758,0
1361026784,1448165812,4,448,112,1361026783633,1361026783761,1448165445,1448165573,128
1361026784,1448165812,4,292,73,1361026783696,1361026783760,1448165508,1448165572,64
1361026786,1448167348,6,4166,694.3333333,1361026758242,1361026758370,1448139590,1448139718,128
1361026786,1448167356,1,76,76,1361026761753,1361026761753,1448143109,1448143109,0
1361026786,1448167384,7,4451,635.8571429,1361026758204,1361026758332,1448139588,1448139716,128
1361026790,1448171360,1,52,52,1361026763733,1361026763733,1448145093,1448145093,0
1361026790,1448171392,1,52,52,1361026763764,1361026763764,1448145156,1448145156,0
1361026792,1448173816,3,144,48,1361026787212,1361026787404,1448169028,1448169220,192
1361026792,1448173852,2,123,61.5,1361026787113,1361026787113,1448168965,1448168965,0
1361026792,1448173852,3,144,48,1361026787176,1361026787368,1448169028,1448169220,192
1361026792,1448173856,2,123,61.5,1361026788134,1361026788134,1448169990,1448169990,0
1361026794,1448175412,2,98,49,1361026766496,1361026766560,1448147908,1448147972,64
1361026808,1448189848,4,312,78,1361026805805,1361026805869,1448187653,1448187717,64
1361026808,1448189860,4,312,78,1361026800351,1361026800479,1448182211,1448182339,128
1361026822,1448203384,2,474,237,1361026797819,1361026797819,1448179203,1448179203,0
1361026826,1448207368,5,3829,765.8,1361026800843,1361026800843,1448182211,1448182211,0
1361026834,1448215356,2,265,132.5,1361026806230,1361026806294,1448187586,1448187650,64
1361026840,1448221860,4,434,108.5,1361026833567,1361026833631,1448215427,1448215491,64
1361026840,1448221864,4,292,73,1361026833694,1361026833758,1448215558,1448215622,64
1361026866,1448247432,2,474,237,1361026838154,1361026838218,1448219586,1448219650,64
1361026880,1448261888,4,205,51.25,1361026873029,1361026873093,1448254917,1448254981,64
1361026880,1448261924,4,205,51.25,1361026872992,1361026872992,1448254916,1448254916,0
1361026886,1448267488,2,265,132.5,1361026861394,1361026861522,1448242882,1448243010,128
1361026898,1448279420,1,46,46,1361026872535,1361026872535,1448253955,1448253955,0
1361026898,1448279420,1,46,46,1361026872599,1361026872599,1448254019,1448254019,0
1361026898,1448279432,1,46,46,1361026873548,1361026873548,1448254980,1448254980,0
1361026898,1448279432,1,46,46,1361026871435,1361026871435,1448252867,1448252867,0
1361026898,1448279468,1,46,46,1361026871398,1361026871398,1448252866,1448252866,0
1361026898,1448279468,1,46,46,1361026873510,1361026873510,1448254978,1448254978,0
1361026906,1448287496,2,474,237,1361026877897,1361026877961,1448259393,1448259457,64
1361026942,1448323520,2,265,132.5,1361026917043,1361026917171,1448298563,1448298691,128
1361026946,1448327528,2,474,237,1361026917931,1361026917995,1448299459,1448299523,64
1361026986,1448367524,4,1330,332.5,1361026958510,1361026959534,1448340034,1448341058,1024
1361026998,1448379528,2,265,132.5,1361026972520,1361026972648,1448354048,1448354176,128
1361027001,1448381992,4,312,78,1361026998914,1361026999042,1448379906,1448380034,128
1361027001,1448382000,4,312,78,1361027000441,1361027000569,1448381441,1448381569,128
1361027001,1448382000,4,312,78,1361026997305,1361026997433,1448378305,1448378433,128
1361027022,1448403572,9,9286,1031.777778,1361026996671,1361026996799,1448378243,1448378371,128
1361027026,1448407584,2,474,237,1361026999153,1361026999217,1448380737,1448380801,64
1361027054,1448435688,2,265,132.5,1361027027975,1361027028103,1448409663,1448409791,128
1361027065,1448446036,10,4620,462,1361027059348,1361027059476,1448440384,1448440512,128
1361027066,1448447716,2,474,237,1361027039150,1361027039214,1448420866,1448420930,64
1361027073,1448454076,4,312,78,1361027065708,1361027065772,1448446784,1448446848,64
1361027073,1448454084,4,312,78,1361027069668,1361027069732,1448450752,1448450816,64
1361027073,1448454104,4,336,84,1361027067471,1361027067599,1448448575,1448448703,128
1361027073,1448454104,8,1501,187.625,1361027059280,1361027065232,1448440384,1448446336,5952
1361027073,1448454104,4,312,78,1361027067600,1361027067664,1448448704,1448448768,64
1361027081,86775580,2,98,49,1361027070478,1361027075086,86765058,86769666,4608
1361027081,86775584,2,98,49,1361027070410,1361027074058,86764994,86768642,3648
1361027082,1448463724,11,2196,199.6363636,1361027057573,1361027058085,1448439297,1448439809,512
1361027086,1448467712,9,6739,748.7777778,1361027058671,1361027058799,1448440383,1448440511,128
1361027094,1448475764,1,76,76,1361027068410,1361027068410,1448450174,1448450174,0
1361027106,1448487908,2,474,237,1361027079274,1361027079338,1448461182,1448461246,64
1361027110,1448491932,2,265,132.5,1361027083414,1361027083542,1448465346,1448465474,128
1361027121,1448502144,8,3752,469,1361027109993,1361027116265,1448491137,1448497409,6272
1361027137,1448518092,4,312,78,1361027132315,1361027132379,1448513407,1448513471,64
1361027137,1448518092,4,312,78,1361027132634,1361027132762,1448513726,1448513854,128
1361027137,1448518100,4,312,78,1361027134225,1361027134289,1448515325,1448515389,64
1361027137,1448518100,4,312,78,1361027134161,1361027134289,1448515261,1448515389,128
1361027137,1448518100,4,312,78,1361027134613,1361027134741,1448515713,1448515841,128
1361027137,1448518100,4,312,78,1361027134357,1361027134421,1448515457,1448515521,64
1361027137,1448518100,4,312,78,1361027134869,1361027134997,1448515969,1448516097,128
1361027137,1448518100,4,312,78,1361027131092,1361027131220,1448512192,1448512320,128
1361027137,1448518100,4,312,78,1361027135250,1361027135314,1448516350,1448516414,64
1361027137,1448518128,4,312,78,1361027135737,1361027135801,1448516865,1448516929,64
1361027137,1448518132,4,312,78,1361027133235,1361027133299,1448514367,1448514431,64
1361027137,1448518136,4,312,78,1361027133553,1361027133617,1448514689,1448514753,64
1361027138,1448519904,1,46,46,1361027112431,1361027112431,1448494335,1448494335,0
1361027146,1448527924,2,474,237,1361027120349,1361027120413,1448502273,1448502337,64
1361027167,1448547992,2,265,132.5,1361027140159,1361027140287,1448521151,1448521279,128
1361027177,1448558100,4,205,51.25,1361027174291,1361027174291,1448555391,1448555391,0
1361027177,1448558124,3,169,56.33333333,1361027171833,1361027173241,1448552957,1448554365,1408
1361027187,1448568016,2,474,237,1361027161382,1361027161446,1448542398,1448542462,64
1361027201,1448582128,4,312,78,1361027196853,1361027196917,1448577981,1448578045,64
1361027201,1448582128,4,312,78,1361027197367,1361027197431,1448578495,1448578559,64
1361027223,1448604044,2,265,132.5,1361027195785,1361027195849,1448576829,1448576893,64
1361027227,1448608008,2,474,237,1361027201263,1361027201327,1448582271,1448582335,64
1361027263,1448644380,7,1450,207.1428571,1361027236474,1361027237050,1448617854,1448618430,576
1361027267,1448648368,2,474,237,1361027241095,1361027241159,1448622463,1448622527,64
1361027279,1448660368,2,265,132.5,1361027251014,1361027251078,1448632382,1448632446,64
1361027307,1448688316,2,474,237,1361027280952,1361027281016,1448662268,1448662332,64
1361027313,1448694172,1887,2724896,1444.036036,1361026998665,1361027312713,1448379837,1448693885,314048
1361027327,1448708372,1,46,46,1361027300865,1361027300865,1448682237,1448682237,0
1361027331,1448712412,2,265,132.5,1361027306519,1361027306583,1448687931,1448687995,64
1361027347,1448728428,2,474,237,1361027320903,1361027320967,1448702331,1448702395,64
1361027353,1448734232,4,205,51.25,1361027352653,1361027352653,1448733885,1448733885,0
1361027383,1448764456,10,2086,208.6,1361027358442,1361027358890,1448739898,1448740346,448
1361027385,87079728,2,98,49,1361027380350,1361027383486,87075078,87078214,3136
1361027385,87079728,2,98,49,1361027380350,1361027384446,87075078,87079174,4096
1361027387,1448768428,2,474,237,1361027360903,1361027360967,1448742331,1448742395,64
1361027387,1448768428,7,4642,663.1428571,1361027359302,1361027359430,1448740730,1448740858,128
1361027387,1448768444,2,265,132.5,1361027362361,1361027362489,1448743805,1448743933,128
1361027427,1448808756,2,474,237,1361027400767,1361027400831,1448782523,1448782587,64
1361027443,1448824812,2,265,132.5,1361027417224,1361027417288,1448799036,1448799100,64
1361027447,1448828780,1,46,46,1361027420518,1361027420518,1448802298,1448802298,0
1361027457,1448838236,4,292,73,1361027455556,1361027455684,1448836792,1448836920,128
1361027457,1448838240,4,446,111.5,1361027456002,1361027456066,1448837242,1448837306,64
1361027457,1448838240,4,292,73,1361027456129,1361027456193,1448837369,1448837433,64
1361027457,1448838240,4,292,73,1361027449473,1361027449537,1448830713,1448830777,64
1361027457,1448838244,4,394,98.5,1361027452480,1361027453568,1448833724,1448834812,1088
1361027457,1448838244,4,292,73,1361027456445,1361027456573,1448837689,1448837817,128
1361027457,1448838248,4,445,111.25,1361027456568,1361027456696,1448837816,1448837944,128
1361027457,1448838248,4,292,73,1361027450044,1361027450108,1448831292,1448831356,64
1361027457,1448838248,4,292,73,1361027453755,1361027453819,1448835003,1448835067,64
1361027457,1448838248,4,292,73,1361027454010,1361027454074,1448835258,1448835322,64
1361027457,1448838248,12,660,55,1361027450362,1361027453498,1448831610,1448834746,3136
1361027457,1448838248,3,144,48,1361027453754,1361027453946,1448835002,1448835194,192
1361027457,1448838248,4,439,109.75,1361027454138,1361027454202,1448835386,1448835450,64
1361027457,1448838248,4,432,108,1361027454393,1361027454457,1448835641,1448835705,64
1361027457,1448838252,4,434,108.5,1361027454902,1361027454966,1448836154,1448836218,64
1361027457,1448838252,4,426,106.5,1361027455285,1361027455413,1448836537,1448836665,128
1361027457,1448838252,4,425,106.25,1361027455477,1361027455605,1448836729,1448836857,128
1361027457,1448838256,4,425,106.25,1361027455668,1361027455732,1448836924,1448836988,64
1361027457,1448838256,4,292,73,1361027455732,1361027455796,1448836988,1448837052,64
1361027457,1448838256,4,454,113.5,1361027455859,1361027455923,1448837115,1448837179,64
1361027457,1448838256,4,292,73,1361027449457,1361027449521,1448830713,1448830777,64
1361027457,1448838256,4,292,73,1361027449457,1361027449521,1448830713,1448830777,64
1361027457,1448838260,4,446,111.5,1361027456240,1361027456304,1448837500,1448837564,64
1361027457,1448838260,4,292,73,1361027452592,1361027453552,1448833852,1448834812,960
1361027457,1448838280,4,277,69.25,1361027452699,1361027453339,1448833979,1448834619,640
1361027457,1448838280,3,144,48,1361027449690,1361027449882,1448830970,1448831162,192
1361027457,1448838280,4,292,73,1361027449690,1361027449754,1448830970,1448831034,64
1361027457,1448838284,4,439,109.75,1361027453528,1361027453656,1448834812,1448834940,128
1361027457,1448838284,4,394,98.5,1361027450199,1361027450263,1448831483,1448831547,64
1361027457,1448838284,4,292,73,1361027456791,1361027456855,1448838075,1448838139,64
1361027457,1448838284,4,394,98.5,1361027453782,1361027453910,1448835066,1448835194,128
1361027457,1448838284,4,292,73,1361027454229,1361027454293,1448835513,1448835577,64
1361027457,1448838288,4,292,73,1361027454420,1361027454484,1448835708,1448835772,64
1361027457,1448838288,4,425,106.25,1361027454484,1361027454612,1448835772,1448835900,128
1361027457,1448838288,4,292,73,1361027454547,1361027454611,1448835835,1448835899,64
1361027457,1448838288,4,425,106.25,1361027454739,1361027454867,1448836027,1448836155,128
1361027457,1448838288,4,431,107.75,1361027454675,1361027454739,1448835963,1448836027,64
1361027457,1448838288,4,447,111.75,1361027454931,1361027454995,1448836219,1448836283,64
1361027457,1448838288,4,292,73,1361027455059,1361027455123,1448836347,1448836411,64
1361027457,1448838288,4,424,106,1361027455186,1361027455250,1448836474,1448836538,64
1361027458,1448839200,4,292,73,1361027455466,1361027455530,1448836666,1448836730,64
1361027465,1448846256,4,394,98.5,1361027456948,1361027457012,1448838204,1448838268,64
1361027465,1448846256,4,292,73,1361027463667,1361027463731,1448844923,1448844987,64
1361027465,1448846260,4,292,73,1361027463984,1361027464112,1448845244,1448845372,128
1361027465,1448846260,4,371,92.75,1361027464239,1361027464367,1448845499,1448845627,128
1361027465,1448846260,4,371,92.75,1361027464365,1361027464429,1448845625,1448845689,64
1361027465,1448846264,4,292,73,1361027458218,1361027458346,1448839482,1448839610,128
1361027465,1448846264,5,236,47.2,1361027461800,1361027461992,1448843064,1448843256,192
1361027465,1448846268,4,292,73,1361027458856,1361027458984,1448840124,1448840252,128
1361027465,1448846268,4,461,115.25,1361027459367,1361027459495,1448840635,1448840763,128
1361027465,1448846268,4,292,73,1361027463397,1361027463461,1448844665,1448844729,64
1361027465,1448846272,4,345,86.25,1361027459556,1361027459684,1448840828,1448840956,128
1361027465,1448846272,4,292,73,1361027457059,1361027457123,1448838331,1448838395,64
1361027465,1448846272,4,463,115.75,1361027463779,1361027463843,1448845051,1448845115,64
1361027465,1448846272,4,511,127.75,1361027457123,1361027457251,1448838395,1448838523,128
1361027465,1448846272,4,443,110.75,1361027464097,1361027464161,1448845369,1448845433,64
1361027465,1448846276,4,292,73,1361027457504,1361027457568,1448838780,1448838844,64
1361027465,1448846296,4,463,115.75,1361027457609,1361027457673,1448838905,1448838969,64
1361027465,1448846300,4,462,115.5,1361027458054,1361027458182,1448839354,1448839482,128
1361027465,1448846300,4,442,110.5,1361027464838,1361027464902,1448846138,1448846202,64
1361027465,1448846300,4,461,115.25,1361027458245,1361027458309,1448839545,1448839609,64
1361027465,1448846304,4,448,112,1361027458946,1361027459010,1448840250,1448840314,64
1361027465,1448846304,4,292,73,1361027459202,1361027459330,1448840506,1448840634,128
1361027465,1448846304,4,292,73,1361027459010,1361027459074,1448840314,1448840378,64
1361027465,1448846304,4,292,73,1361027459458,1361027459522,1448840762,1448840826,64
1361027465,1448846304,4,448,112,1361027459138,1361027459202,1448840442,1448840506,64
1361027465,1448846308,4,442,110.5,1361027463423,1361027463551,1448844731,1448844859,128
1361027467,1448848832,1,46,46,1361027441778,1361027441778,1448823610,1448823610,0
1361027467,1448848864,2,474,237,1361027440530,1361027440594,1448822394,1448822458,64
1361027473,1448854284,4,461,115.25,1361027465879,1361027465943,1448847163,1448847227,64
1361027473,1448854284,4,292,73,1361027465878,1361027466006,1448847162,1448847290,128
1361027473,1448854284,4,728,182,1361027466070,1361027466134,1448847354,1448847418,64
1361027473,1448854284,4,476,119,1361027465942,1361027466070,1448847226,1448847354,128
1361027473,1448854288,4,461,115.25,1361027466324,1361027466388,1448847612,1448847676,64
1361027473,1448854288,4,442,110.5,1361027467090,1361027467218,1448848378,1448848506,128
1361027473,1448854288,4,386,96.5,1361027467217,1361027467281,1448848505,1448848569,64
1361027473,1448854312,4,442,110.5,1361027465336,1361027465400,1448846648,1448846712,64
1361027473,1448854312,4,292,73,1361027465336,1361027465464,1448846648,1448846776,128
1361027473,1448854316,4,460,115,1361027466102,1361027466166,1448847418,1448847482,64
1361027473,1448854316,4,435,108.75,1361027466485,1361027466549,1448847801,1448847865,64
1361027473,1448854320,4,414,103.5,1361027466228,1361027466292,1448847548,1448847612,64
1361027473,1448854320,3,144,48,1361027469748,1361027469940,1448851068,1448851260,192
1361027473,1448854320,4,469,117.25,1361027466355,1361027466483,1448847675,1448847803,128
1361027475,1448856860,3,156,52,1361027449815,1361027452823,1448831675,1448834683,3008
1361027475,1448856908,1,52,52,1361027449960,1361027449960,1448831868,1448831868,0
1361027481,1448862284,4,205,51.25,1361027474646,1361027474646,1448855930,1448855930,0
1361027489,1448870272,4,292,73,1361027483681,1361027483809,1448864953,1448865081,128
1361027499,1448880876,1,46,46,1361027473031,1361027473031,1448854907,1448854907,0
1361027499,1448880920,2,265,132.5,1361027472282,1361027472346,1448854202,1448854266,64
1361027507,1448888868,2,474,237,1361027480974,1361027481038,1448862842,1448862906,64
1361027537,1448918316,11,5698,518,1361027520503,1361027535799,1448901819,1448917115,15296
1361027547,1448928888,2,474,237,1361027520376,1361027520440,1448902264,1448902328,64
1361027555,1448936912,2,265,132.5,1361027527905,1361027527969,1448909817,1448909881,64
1361027587,1448968916,2,474,237,1361027560862,1361027560926,1448942778,1448942842,64
1361027611,1448992932,2,265,132.5,1361027583116,1361027583180,1448965048,1448965112,64
1361027615,1448996928,1,46,46,1361027588881,1361027588881,1448970809,1448970809,0
1361027627,1449008900,2,474,237,1361027600620,1361027600684,1448982520,1448982584,64
1361027639,1449020972,5,250,50,1361027612450,1361027633762,1448994422,1449015734,21312
1361027664,1449044988,2,265,132.5,1361027639420,1361027639484,1449020408,1449020472,64
1361027665,1449046348,3,144,48,1361027656977,1361027656977,1449038325,1449038325,0
1361027668,1449049044,2,474,237,1361027641861,1361027641925,1449022905,1449022969,64
1361027673,1449054332,8,1505,188.125,1361027660004,1361027665188,1449041336,1449046520,5184
1361027673,1449054332,8,1505,188.125,1361027660003,1361027665187,1449041335,1449046519,5184
1361027673,1449054332,125,159936,1279.488,1361027660003,1361027667747,1449041335,1449049079,7744
1361027681,1449062372,3,144,48,1361027679033,1361027679225,1449060405,1449060597,192
1361027681,1449062400,385,537837,1396.979221,1361027668001,1361027679649,1449049401,1449061049,11648
1361027684,1449065128,11,2191,199.1818182,1361027659311,1361027659695,1449040439,1449040823,384
1361027697,1449078344,318,441113,1387.147799,1361027679702,1361027691990,1449061046,1449073334,12288
1361027697,1449078360,658,939974,1428.531915,1361027692039,1361027696135,1449073399,1449077495,4096
1361027697,87391720,2,98,49,1361027690374,1361027694278,87385094,87388998,3904
1361027697,87391724,2,98,49,1361027690371,1361027695235,87385095,87389959,4864
1361027705,1449086360,823,1146877,1393.532199,1361027696133,1361027700613,1449077493,1449081973,4480
1361027708,1449089076,6,2186,364.3333333,1361027681572,1361027685604,1449062648,1449066680,4032
1361027713,1449094392,748,1065015,1423.816845,1361027700647,1361027705511,1449082039,1449086903,4864
1361027713,1449094424,680,964814,1418.844118,1361027705608,1361027710344,1449087032,1449091768,4736
1361027720,1449101124,2,265,132.5,1361027694388,1361027694452,1449075512,1449075576,64
1361027721,1449102432,685,970501,1416.789781,1361027714943,1361027719551,1449096375,1449100983,4608
1361027721,1449102432,617,869071,1408.54295,1361027710398,1361027714878,1449091830,1449096310,4480
1361027729,1449110400,628,877320,1397.006369,1361027719646,1361027724190,1449101046,1449105590,4544
1361027737,1449118396,1073,1521666,1418.141659,1361027724258,1361027730594,1449105654,1449111990,6336
1361027737,1449118408,3,144,48,1361027731925,1361027731925,1449113333,1449113333,0
1361027737,1449118444,672,968500,1441.220238,1361027730610,1361027735282,1449112054,1449116726,4672
1361027744,1449125096,2,583,291.5,1361027717198,1361027717198,1449098294,1449098294,0
1361027745,1449126416,114,152868,1340.947368,1361027739278,1361027742926,1449120694,1449124342,3648
1361027748,1449129064,131,176222,1345.206107,1361027735724,1361027739436,1449116788,1449120500,3712
1361027752,1449133132,2,474,237,1361027725611,1361027725675,1449106743,1449106807,64
1361027753,1449134404,122,163001,1336.07377,1361027743064,1361027747224,1449124468,1449128628,4160
1361027753,1449134428,126,170982,1357,1361027747393,1361027751553,1449128821,1449132981,4160
1361027761,1449142388,154,209955,1363.344156,1361027751659,1361027755691,1449133047,1449137079,4032
1361027761,1449142404,153,209694,1370.54902,1361027755803,1361027759707,1449137207,1449141111,3904
1361027769,1449150372,159,219158,1378.352201,1361027763705,1361027767801,1449145077,1449149173,4096
1361027769,1449150376,153,208516,1362.849673,1361027759927,1361027763639,1449141303,1449145015,3712
1361027776,1449157108,2,265,132.5,1361027749632,1361027749760,1449130740,1449130868,128
1361027777,1449158412,176,243509,1383.573864,1361027771859,1361027775827,1449153271,1449157239,3968
1361027777,1449158412,149,205070,1376.308725,1361027767954,1361027771666,1449149366,1449153078,3712
1361027785,1449166388,168,230698,1373.202381,1361027775976,1361027780328,1449157364,1449161716,4352
1361027785,1449166392,241,329042,1365.319502,1361027780453,1361027784677,1449161845,1449166069,4224
1361027792,1449173188,2,474,237,1361027765168,1361027765232,1449146356,1449146420,64
1361027793,1449174400,3,144,48,1361027791838,1361027791902,1449173238,1449173302,64
1361027793,1449174408,152,207259,1363.546053,1361027784790,1361027789078,1449166198,1449170486,4288
1361027801,1449182416,152,209992,1381.526316,1361027789197,1361027793549,1449170613,1449174965,4352
1361027801,1449182452,170,233541,1373.770588,1361027793642,1361027797738,1449175094,1449179190,4096
1361027809,1449190436,124,169098,1363.693548,1361027797882,1361027802170,1449179318,1449183606,4288
1361027809,1449190464,23,21775,946.7391304,1361027802269,1361027806749,1449183733,1449188213,4480
1361027817,1449198440,24,24148,1006.166667,1361027811638,1361027816886,1449193078,1449198326,5248
1361027817,1449198456,23,23795,1034.565217,1361027806950,1361027811558,1449188406,1449193014,4608
1361027825,1449206440,29,31473,1085.275862,1361027817078,1361027822070,1449198518,1449203510,4992
1361027832,1449213220,2,474,237,1361027805329,1361027805393,1449186549,1449186613,64
1361027832,1449213220,2,265,132.5,1361027805393,1361027805457,1449186613,1449186677,64
1361027833,1449214464,4,205,51.25,1361027832092,1361027832092,1449213556,1449213556,0
1361027833,1449214488,1222,1766554,1445.625205,1361027822212,1361027828036,1449203700,1449209524,5824
1361027841,1449222456,1396,2001990,1434.090258,1361027828067,1361027834915,1449209523,1449216371,6848
1361027857,1449238492,1159,1666318,1437.720449,1361027850114,1361027856322,1449231606,1449237814,6208
1361027857,1449238496,1849,2640197,1427.905354,1361027834938,1361027850106,1449216434,1449231602,15168
1361027865,1449246444,102,130886,1283.196078,1361027856560,1361027859952,1449238004,1449241396,3392
1361027872,1449253236,4,1330,332.5,1361027846016,1361027847360,1449227252,1449228596,1344
1361027873,1449254484,3,144,48,1361027866759,1361027866759,1449248243,1449248243,0
1361027881,1449262444,1086,1503380,1384.327808,1361027860079,1361027874927,1449241523,1449256371,14848
1361027888,1449269292,2,265,132.5,1361027860999,1361027861127,1449242291,1449242419,128
1361027905,1449286480,429,577730,1346.689977,1361027899722,1361027904074,1449281202,1449285554,4352
1361027905,1449286480,1446,2096590,1449.923928,1361027875786,1361027899722,1449257266,1449281202,23936
1361027912,1449293324,2,474,237,1361027887080,1361027887144,1449268404,1449268468,64
1361027913,1449294464,53,55257,1042.584906,1361027904154,1361027906906,1449285618,1449288370,2752
1361027913,1449294472,273,380791,1394.838828,1361027906962,1361027912338,1449288434,1449293810,5376
1361027921,1449302468,278,379000,1363.309353,1361027912472,1361027916632,1449293940,1449298100,4160
1361027921,1449302484,23,9468,411.6521739,1361027916677,1361027919109,1449298161,1449300593,2432
1361027929,1449310452,213,281487,1321.535211,1361027922342,1361027925286,1449303794,1449306738,2944
1361027929,1449310456,3,144,48,1361027926818,1361027926818,1449308274,1449308274,0
1361027929,1449310488,86,94651,1100.593023,1361027925317,1361027927877,1449306805,1449309365,2560
1361027929,1449310496,322,445964,1384.981366,1361027919164,1361027922300,1449300660,1449303796,3136
1361027937,1449318452,147,182757,1243.244898,1361027927974,1361027930662,1449309426,1449312114,2688
1361027937,1449318460,23,9461,411.3478261,1361027933534,1361027936030,1449314994,1449317490,2496
1361027937,1449318500,86,97432,1132.930233,1361027930680,1361027933432,1449312180,1449314932,2752
1361027944,1449325488,2,265,132.5,1361027916805,1361027916869,1449298293,1449298357,64
1361027945,1449326484,152,185969,1223.480263,1361027936071,1361027938887,1449317555,1449320371,2816
1361027952,1449333580,2,474,237,1361027926888,1361027927016,1449308468,1449308596,128
1361027953,1449334484,5,236,47.2,1361027951943,1361027952775,1449333427,1449334259,832
1361027953,1449334500,4,190,47.5,1361027951030,1361027951990,1449332530,1449333490,960
1361027953,1449334500,8,374,46.75,1361027951734,1361027952758,1449333234,1449334258,1024
1361027953,1449334500,4,190,47.5,1361027951606,1361027951926,1449333106,1449333426,320
1361027953,1449334540,4,190,47.5,1361027950927,1361027951695,1449332467,1449333235,768
1361027953,1449334540,4,190,47.5,1361027950863,1361027951439,1449332403,1449332979,576
1361027953,1449334540,4,190,47.5,1361027950991,1361027951887,1449332531,1449333427,896
1361027953,1449334540,5,236,47.2,1361027951886,1361027952718,1449333426,1449334258,832
1361027953,1449334540,4,190,47.5,1361027951438,1361027951694,1449332978,1449333234,256
1361027953,1449334540,4,190,47.5,1361027951630,1361027951886,1449333170,1449333426,256
1361027961,1449342492,4,190,47.5,1361027952895,1361027953215,1449334387,1449334707,320
1361027961,1449342492,4,190,47.5,1361027956030,1361027956414,1449337522,1449337906,384
1361027961,1449342492,4,190,47.5,1361027951998,1361027952894,1449333490,1449334386,896
1361027961,1449342492,4,190,47.5,1361027956030,1361027956414,1449337522,1449337906,384
1361027961,1449342492,2,92,46,1361027953086,1361027953534,1449334578,1449335026,448
1361027961,1449342496,4,190,47.5,1361027953081,1361027953401,1449334577,1449334897,320
1361027961,1449342496,4,190,47.5,1361027956413,1361027956861,1449337909,1449338357,448
1361027961,1449342496,4,190,47.5,1361027953211,1361027953531,1449334707,1449335027,320
1361027961,1449342496,4,190,47.5,1361027953402,1361027953658,1449334898,1449335154,256
1361027961,1449342500,4,190,47.5,1361027952757,1361027953077,1449334257,1449334577,320
1361027961,1449342500,4,190,47.5,1361027952761,1361027953081,1449334261,1449334581,320
1361027961,1449342500,4,190,47.5,1361027953911,1361027954487,1449335411,1449335987,576
1361027961,1449342500,4,190,47.5,1361027954166,1361027954742,1449335666,1449336242,576
1361027961,1449342500,4,190,47.5,1361027954294,1361027954422,1449335794,1449335922,128
1361027961,1449342500,4,190,47.5,1361027954486,1361027954678,1449335986,1449336178,192
1361027961,1449342504,4,190,47.5,1361027954545,1361027954673,1449336049,1449336177,128
1361027961,1449342504,4,190,47.5,1361027954673,1361027954737,1449336177,1449336241,64
1361027961,1449342504,4,190,47.5,1361027954677,1361027954741,1449336181,1449336245,64
1361027961,1449342504,4,190,47.5,1361027954741,1361027954933,1449336245,1449336437,192
1361027961,1449342504,4,190,47.5,1361027954868,1361027955252,1449336372,1449336756,384
1361027961,1449342504,4,190,47.5,1361027954868,1361027955252,1449336372,1449336756,384
1361027961,1449342504,4,190,47.5,1361027955251,1361027955571,1449336755,1449337075,320
1361027961,1449342504,4,190,47.5,1361027955379,1361027955827,1449336883,1449337331,448
1361027961,1449342504,4,190,47.5,1361027955443,1361027955827,1449336947,1449337331,384
1361027961,1449342504,4,190,47.5,1361027955570,1361027956018,1449337074,1449337522,448
1361027961,1449342504,4,190,47.5,1361027955634,1361027956018,1449337138,1449337522,384
1361027961,1449342504,4,190,47.5,1361027955826,1361027958258,1449337330,1449339762,2432
1361027961,1449342508,4,190,47.5,1361027953070,1361027953390,1449334578,1449334898,320
1361027961,1449342508,4,190,47.5,1361027953070,1361027953390,1449334578,1449334898,320
1361027961,1449342532,4,190,47.5,1361027953368,1361027953624,1449334900,1449335156,256
1361027961,1449342532,4,190,47.5,1361027953367,1361027953623,1449334899,1449335155,256
1361027961,1449342532,4,190,47.5,1361027953495,1361027953815,1449335027,1449335347,320
1361027961,1449342532,4,190,47.5,1361027952727,1361027953047,1449334259,1449334579,320
1361027961,1449342532,4,190,47.5,1361027953621,1361027954005,1449335153,1449335537,384
1361027961,1449342532,4,190,47.5,1361027953749,1361027954197,1449335281,1449335729,448
1361027961,1449342536,4,190,47.5,1361027953620,1361027954004,1449335156,1449335540,384
1361027961,1449342536,4,190,47.5,1361027954067,1361027954643,1449335603,1449336179,576
1361027961,1449342536,4,190,47.5,1361027954386,1361027954514,1449335922,1449336050,128
1361027961,1449342536,4,190,47.5,1361027954258,1361027954706,1449335794,1449336242,448
1361027961,1449342536,4,190,47.5,1361027954450,1361027954642,1449335986,1449336178,192
1361027961,1449342540,4,190,47.5,1361027954637,1361027954701,1449336177,1449336241,64
1361027961,1449342540,4,190,47.5,1361027954640,1361027954832,1449336180,1449336372,192
1361027961,1449342540,4,190,47.5,1361027954960,1361027955344,1449336500,1449336884,384
1361027961,1449342540,4,190,47.5,1361027955024,1361027955408,1449336564,1449336948,384
1361027961,1449342540,4,190,47.5,1361027955213,1361027955597,1449336753,1449337137,384
1361027961,1449342544,4,190,47.5,1361027955788,1361027958220,1449337332,1449339764,2432
1361027961,1449342544,4,190,47.5,1361027951563,1361027953035,1449333107,1449334579,1472
1361027968,1449349528,14,6617,472.6428571,1361027943131,1361027943451,1449324659,1449324979,320
1361027968,1449349532,9,861,95.66666667,1361027943768,1361027943960,1449325300,1449325492,192
1361027968,1449349572,9,861,95.66666667,1361027943469,1361027943661,1449325041,1449325233,192
1361027969,1449350492,8,1505,188.125,1361027960127,1361027965439,1449341619,1449346931,5312
1361027969,1449350508,8,1505,188.125,1361027960112,1361027965424,1449341620,1449346932,5312
1361027969,1449350508,8,1505,188.125,1361027960110,1361027965422,1449341618,1449346930,5312
1361027984,1449365520,11,2351,213.7272727,1361027959394,1361027959714,1449340914,1449341234,320
1361027988,1449369560,7,4184,597.7142857,1361027960058,1361027960314,1449341618,1449341874,256
1361027992,1449373556,2,474,237,1361027967103,1361027967167,1449348659,1449348723,64
1361028000,1449381568,2,265,132.5,1361027972403,1361027972467,1449353971,1449354035,64
1361028001,1449382580,4,336,84,1361027998566,1361027998694,1449380146,1449380274,128
1361028009,1449390528,3,144,48,1361028001691,1361028001755,1449383219,1449383283,64
1361028005,87699992,2,98,49,1361028001270,1361028005430,87696262,87700422,4160
1361028009,87703916,2,98,49,1361028001282,1361028004482,87696198,87699398,3200
1361028017,1449398532,2,123,61.5,1361028009429,1361028009429,1449390961,1449390961,0
1361028032,1449413656,2,474,237,1361028007580,1361028007644,1449389236,1449389300,64
1361028052,1449433728,2,265,132.5,1361028027474,1361028027538,1449409202,1449409266,64
1361028065,1449446560,3,144,48,1361028064059,1361028064059,1449445619,1449445619,0
1361028072,1449453668,1,404,404,1361028045708,1361028045708,1449427376,1449427376,0
1361028076,1449457912,2,474,237,1361028047832,1361028047896,1449429744,1449429808,64
1361028081,1449462596,4,205,51.25,1361028075414,1361028075414,1449457010,1449457010,0
1361028101,1449482016,1,46,46,1361028074905,1361028074905,1449455921,1449455921,0
1361028109,1449490048,2,265,132.5,1361028083447,1361028083575,1449464495,1449464623,128
1361028113,1449494064,2,474,237,1361028088298,1361028088362,1449469362,1449469426,64
1361028137,1449518640,3,144,48,1361028136616,1361028136616,1449518256,1449518256,0
1361028153,1449534088,2,474,237,1361028128335,1361028128399,1449509423,1449509487,64
1361028165,1449546148,2,265,132.5,1361028139410,1361028139474,1449520558,1449520622,64
1361028193,1449574216,2,474,237,1361028168017,1361028168081,1449549233,1449549297,64
1361028201,1449582644,3,144,48,1361028196643,1361028196707,1449578287,1449578351,64
1361028217,1449598676,3,189,63,1361028210626,1361028213634,1449592302,1449595310,3008
1361028221,1449602160,2,265,132.5,1361028195271,1361028195399,1449576431,1449576559,128
1361028225,1449606148,6,913,152.1666667,1361028197396,1361028197652,1449578544,1449578800,256
1361028233,1449614436,2,474,237,1361028208050,1361028208114,1449589486,1449589550,64
1361028233,1449614668,2,126,63,1361028217673,1361028225737,1449599341,1449607405,8064
1361028241,1449622664,3,189,63,1361028237584,1361028240592,1449619248,1449622256,3008
1361028257,1449638628,2,126,63,1361028244659,1361028252723,1449626287,1449634351,8064
1361028257,1449638672,3,189,63,1361028253766,1361028256774,1449635438,1449638446,3008
1361028273,1449654428,2,474,237,1361028248185,1361028248249,1449629613,1449629677,64
1361028273,1449654640,2,126,63,1361028260837,1361028268837,1449642477,1449650477,8000
1361028273,1449654656,3,144,48,1361028271574,1361028271638,1449653230,1449653294,64
1361028273,1449654696,8,1505,188.125,1361028260206,1361028265326,1449641902,1449647022,5120
1361028277,1449658388,2,265,132.5,1361028250851,1361028250915,1449632239,1449632303,64
1361028281,1449662656,12,999,83.25,1361028272470,1361028280406,1449654126,1449662062,7936
1361028285,1449666484,7,1892,270.2857143,1361028259843,1361028260035,1449641327,1449641519,192
1361028285,1449666488,7,4375,625,1361028260416,1361028260480,1449641904,1449641968,64
1361028313,1449694524,2,474,237,1361028288154,1361028288218,1449669678,1449669742,64
1361028313,1449694672,3,144,48,1361028306501,1361028306693,1449688173,1449688365,192
1361028321,88015956,2,98,49,1361028311839,1361028315871,88006795,88010827,4032
1361028321,88015960,2,98,49,1361028311899,1361028316891,88006859,88011851,4992
1361028333,1449714464,2,265,132.5,1361028306261,1361028306325,1449687725,1449687789,64
1361028337,1449718668,3,144,48,1361028331595,1361028331659,1449713263,1449713327,64
1361028353,1449734492,2,474,237,1361028327800,1361028327864,1449709292,1449709356,64
1361028377,1449758728,3,169,56.33333333,1361028375246,1361028375246,1449756974,1449756974,0
1361028377,1449758728,4,205,51.25,1361028375310,1361028375310,1449757038,1449757038,0
1361028389,1449770812,2,265,132.5,1361028361208,1361028361336,1449743020,1449743148,128
1361028393,1449774532,2,474,237,1361028368271,1361028368335,1449749803,1449749867,64
1361028393,1449774760,3,144,48,1361028391470,1361028391534,1449773230,1449773294,64
1361028433,1449814668,2,474,237,1361028407753,1361028407881,1449789421,1449789549,128
1361028445,1449826664,2,265,132.5,1361028417037,1361028417165,1449798701,1449798829,128
1361028457,1449838796,3,144,48,1361028453319,1361028453511,1449835115,1449835307,192
1361028473,1449854676,2,474,237,1361028448065,1361028448129,1449829741,1449829805,64
1361028473,1449854816,3,144,48,1361028466418,1361028466482,1449848234,1449848298,64
1361028497,1449878728,2,265,132.5,1361028472265,1361028472393,1449853993,1449854121,128
1361028513,1449894756,2,474,237,1361028487727,1361028487791,1449869483,1449869547,64
1361028545,1449926856,3,144,48,1361028541386,1361028541450,1449923242,1449923306,64
1361028553,1449934700,2,474,237,1361028527844,1361028527908,1449909544,1449909608,64
1361028553,1449934768,2,265,132.5,1361028527715,1361028527843,1449909483,1449909611,128
1361028561,1449942836,7,1406,200.8571429,1361028551453,1361028556765,1449933289,1449938601,5312
1361028561,1449942836,8,535,66.875,1361028551709,1361028557725,1449933545,1449939561,6016
1361028561,88256012,8,1505,188.125,1361028552424,1361028557672,88247436,88252684,5248
1361028561,1449942868,4,292,73,1361028558589,1361028558717,1449940457,1449940585,128
1361028561,1449942872,8,535,66.875,1361028551674,1361028557690,1449933546,1449939562,6016
1361028569,1449950844,4,413,103.25,1361028560855,1361028560919,1449942699,1449942763,64
1361028569,1449950856,4,620,155,1361028567818,1361028567882,1449949674,1449949738,64
1361028577,1449958716,51,51713,1013.980392,1361028549844,1361028560340,1449931560,1449942056,10496
1361028577,1449958732,9,6032,670.2222222,1361028551812,1361028551876,1449933544,1449933608,64
1361028577,1449958732,9,6352,705.7777778,1361028551812,1361028551940,1449933544,1449933672,128
1361028577,1449958732,9,6603,733.6666667,1361028551812,1361028551940,1449933544,1449933672,128
1361028577,1449958768,42,52621,1252.880952,1361028551520,1361028551968,1449933288,1449933736,448
1361028577,1449958792,16,15128,945.5,1361028551498,1361028552266,1449933290,1449934058,768
1361028577,1449958792,36,45715,1269.861111,1361028551498,1361028551882,1449933290,1449933674,384
1361028577,1449958792,8,5821,727.625,1361028551752,1361028551880,1449933544,1449933672,128
1361028577,1449958792,10,7347,734.7,1361028551752,1361028551880,1449933544,1449933672,128
1361028577,1449958856,4,190,47.5,1361028572811,1361028572875,1449954667,1449954731,64
1361028577,1449958856,4,190,47.5,1361028572874,1361028573066,1449954730,1449954922,192
1361028577,1449958856,4,190,47.5,1361028569098,1361028569418,1449950954,1449951274,320
1361028577,1449958856,3,144,48,1361028569226,1361028570122,1449951082,1449951978,896
1361028577,1449958856,4,190,47.5,1361028573192,1361028573640,1449955048,1449955496,448
1361028577,1449958856,4,190,47.5,1361028573192,1361028573640,1449955048,1449955496,448
1361028577,1449958860,4,190,47.5,1361028569796,1361028570244,1449951656,1449952104,448
1361028577,1449958860,4,190,47.5,1361028569603,1361028569987,1449951463,1449951847,384
1361028577,1449958860,4,190,47.5,1361028569863,1361028570247,1449951723,1449952107,384
1361028577,1449958860,4,190,47.5,1361028570245,1361028570629,1449952105,1449952489,384
1361028577,1449958860,4,190,47.5,1361028573637,1361028574085,1449955497,1449955945,448
1361028577,1449958860,4,190,47.5,1361028573637,1361028574085,1449955497,1449955945,448
1361028577,1449958860,4,190,47.5,1361028570692,1361028571012,1449952552,1449952872,320
1361028577,1449958860,4,190,47.5,1361028571012,1361028571460,1449952872,1449953320,448
1361028577,1449958864,4,190,47.5,1361028571011,1361028571459,1449952875,1449953323,448
1361028577,1449958864,4,190,47.5,1361028574211,1361028576387,1449956075,1449958251,2176
1361028577,1449958864,4,190,47.5,1361028574465,1361028574849,1449956329,1449956713,384
1361028577,1449958864,4,190,47.5,1361028574401,1361028574849,1449956265,1449956713,448
1361028577,1449958864,4,190,47.5,1361028574785,1361028575169,1449956649,1449957033,384
1361028577,1449958864,4,190,47.5,1361028572352,1361028572480,1449954216,1449954344,128
1361028577,1449958864,4,190,47.5,1361028571968,1361028572416,1449953832,1449954280,448
1361028577,1449958864,4,190,47.5,1361028572224,1361028572864,1449954088,1449954728,640
1361028577,1449958868,4,190,47.5,1361028568445,1361028570173,1449950313,1449952041,1728
1361028577,1449958868,4,190,47.5,1361028568573,1361028571005,1449950441,1449952873,2432
1361028577,1449958868,4,190,47.5,1361028572797,1361028572861,1449954665,1449954729,64
1361028577,1449958868,4,190,47.5,1361028572796,1361028572860,1449954664,1449954728,64
1361028577,1449958868,4,190,47.5,1361028572860,1361028573052,1449954728,1449954920,192
1361028577,1449958868,4,190,47.5,1361028572860,1361028573052,1449954728,1449954920,192
1361028577,1449958868,4,190,47.5,1361028569212,1361028569596,1449951080,1449951464,384
1361028577,1449958872,4,190,47.5,1361028569399,1361028569783,1449951271,1449951655,384
1361028577,1449958872,4,190,47.5,1361028573178,1361028573626,1449955050,1449955498,448
1361028577,1449958872,5,578,115.6,1361028569786,1361028569978,1449951658,1449951850,192
1361028577,1449958896,4,190,47.5,1361028569953,1361028570401,1449951849,1449952297,448
1361028577,1449958896,4,190,47.5,1361028570593,1361028570977,1449952489,1449952873,384
1361028577,1449958896,4,190,47.5,1361028570209,1361028570593,1449952105,1449952489,384
1361028577,1449958896,4,190,47.5,1361028573600,1361028574048,1449955496,1449955944,448
1361028577,1449958896,4,190,47.5,1361028570400,1361028570784,1449952296,1449952680,384
1361028577,1449958896,4,311,77.75,1361028573792,1361028573856,1449955688,1449955752,64
1361028577,1449958896,4,190,47.5,1361028573792,1361028574176,1449955688,1449956072,384
1361028577,1449958896,4,190,47.5,1361028570976,1361028571424,1449952872,1449953320,448
1361028577,1449958896,4,190,47.5,1361028570592,1361028570976,1449952488,1449952872,384
1361028577,1449958900,4,190,47.5,1361028571227,1361028571611,1449953127,1449953511,384
1361028577,1449958900,4,190,47.5,1361028573983,1361028574367,1449955883,1449956267,384
1361028577,1449958900,4,190,47.5,1361028570783,1361028571231,1449952683,1449953131,448
1361028577,1449958900,4,190,47.5,1361028574046,1361028574430,1449955946,1449956330,384
1361028577,1449958900,4,190,47.5,1361028571422,1361028573790,1449953322,1449955690,2368
1361028577,1449958900,4,190,47.5,1361028571422,1361028571806,1449953322,1449953706,384
1361028577,1449958900,4,190,47.5,1361028571741,1361028572189,1449953641,1449954089,448
1361028577,1449958900,4,190,47.5,1361028574045,1361028574429,1449955945,1449956329,384
1361028577,1449958900,4,190,47.5,1361028571932,1361028572572,1449953832,1449954472,640
1361028577,1449958900,4,190,47.5,1361028571420,1361028571804,1449953320,1449953704,384
1361028577,1449958904,4,190,47.5,1361028574427,1361028574875,1449956331,1449956779,448
1361028577,1449958904,4,190,47.5,1361028572443,1361028572571,1449954347,1449954475,128
1361028577,1449958904,4,190,47.5,1361028572570,1361028572762,1449954474,1449954666,192
1361028577,1449958904,4,190,47.5,1361028572377,1361028572953,1449954281,1449954857,576
1361028577,1449958904,4,190,47.5,1361028572633,1361028572761,1449954537,1449954665,128
1361028577,1449958908,4,190,47.5,1361028568531,1361028570707,1449950439,1449952615,2176
1361028581,1449962712,4,190,47.5,1361028568666,1361028570650,1449950378,1449952362,1984
1361028585,1449966852,4,311,77.75,1361028577805,1361028577869,1449959657,1449959721,64
1361028585,1449966888,4,572,143,1361028581800,1361028581864,1449963688,1449963752,64
1361028593,1449974788,1,46,46,1361028567116,1361028567116,1449948904,1449948904,0
1361028593,1449974792,2,474,237,1361028567753,1361028567881,1449949545,1449949673,128
1361028593,1449974792,1,46,46,1361028568136,1361028568136,1449949928,1449949928,0
1361028593,1449974896,4,311,77.75,1361028589859,1361028589923,1449971755,1449971819,64
1361028601,1449982900,4,376,94,1361028599902,1361028599966,1449981802,1449981866,64
1361028609,1449990780,2,265,132.5,1361028582933,1361028583061,1449964713,1449964841,128
1361028609,1449990908,3,144,48,1361028601364,1361028601364,1449983272,1449983272,0
1361028617,1449998932,4,661,165.25,1361028614973,1361028615037,1449996905,1449996969,64
1361028617,1449998940,4,628,157,1361028609910,1361028610038,1449991850,1449991978,128
1361028617,1449998968,4,311,77.75,1361028615961,1361028616025,1449997929,1449997993,64
1361028625,88320052,2,98,49,1361028621567,1361028624639,88316619,88319691,3072
1361028625,1450006932,4,376,94,1361028616956,1361028617084,1449998888,1449999016,128
1361028625,1450006960,4,460,115,1361028621984,1361028622048,1450003944,1450004008,64
1361028633,1450014820,2,474,237,1361028607469,1361028607533,1449989289,1449989353,64
1361028633,1450014956,4,580,145,1361028626019,1361028626083,1450007975,1450008039,64
1361028633,1450014960,4,376,94,1361028630048,1361028630112,1450012008,1450012072,64
1361028633,88328052,3,144,48,1361028621568,1361028625600,88316620,88320652,4032
1361028641,1450022976,4,311,77.75,1361028634063,1361028634127,1450016039,1450016103,64
1361028642,1450023000,4,628,157,1361028639009,1361028639137,1450020009,1450020137,128
1361028649,1450030952,4,505,126.25,1361028642089,1361028642217,1450024041,1450024169,128
1361028649,1450030960,4,414,103.5,1361028648160,1361028648224,1450030120,1450030184,64
1361028665,1450046876,2,265,132.5,1361028638643,1361028638707,1450020519,1450020583,64
1361028665,1450046968,4,292,73,1361028660185,1361028660313,1450042153,1450042281,128
1361028673,1450054896,2,474,237,1361028647393,1361028647457,1450029289,1450029353,64
1361028674,1450055020,4,617,154.25,1361028667530,1361028667594,1450048550,1450048614,64
1361028674,1450055028,3,169,56.33333333,1361028668550,1361028668550,1450049578,1450049578,0
1361028674,1450055028,4,205,51.25,1361028668549,1361028668549,1450049577,1450049577,0
1361028674,1450055028,3,169,56.33333333,1361028668549,1361028668549,1450049577,1450049577,0
1361028674,1450055028,4,205,51.25,1361028668549,1361028668549,1450049577,1450049577,0
1361028674,1450055068,3,169,56.33333333,1361028668510,1361028668510,1450049578,1450049578,0
1361028674,1450055068,3,169,56.33333333,1361028668510,1361028668510,1450049578,1450049578,0
1361028674,1450055068,3,169,56.33333333,1361028668509,1361028668509,1450049577,1450049577,0
1361028674,1450055068,3,169,56.33333333,1361028668509,1361028668509,1450049577,1450049577,0
1361028682,1450063036,4,452,113,1361028675196,1361028675324,1450056232,1450056360,128
1361028682,1450063040,3,144,48,1361028677174,1361028677302,1450058214,1450058342,128
1361028682,1450063076,4,205,51.25,1361028676565,1361028676565,1450057641,1450057641,0
1361028682,1450063076,4,310,77.5,1361028681234,1361028681362,1450062310,1450062438,128
1361028690,1450071044,4,432,108,1361028687282,1361028687346,1450068326,1450068390,64
1361028690,1450071088,4,540,135,1361028689289,1361028689353,1450070377,1450070441,64
1361028698,1450079112,4,376,94,1361028695278,1361028695342,1450076390,1450076454,64
1361028698,1450079124,4,502,125.5,1361028697250,1361028697378,1450078374,1450078502,128
1361028701,1450082936,1,46,46,1361028676789,1361028676789,1450058725,1450058725,0
1361028701,1450082972,1,46,46,1361028676181,1361028676181,1450058153,1450058153,0
1361028705,1450086976,7,1450,207.1428571,1361028676879,1361028677519,1450058855,1450059495,640
1361028706,1450087040,4,310,77.5,1361028701368,1361028701496,1450082408,1450082536,128
1361028706,1450087080,4,413,103.25,1361028705360,1361028705424,1450086440,1450086504,64
1361028713,1450094920,2,474,237,1361028687623,1361028687687,1450069543,1450069607,64
1361028714,1450095064,4,720,180,1361028713438,1361028713502,1450094502,1450094566,64
1361028721,1450102904,2,265,132.5,1361028693976,1361028694104,1450075880,1450076008,128
1361028730,1450111096,6,1010,168.3333333,1361028723457,1361028723585,1450104553,1450104681,128
1361028730,1450111100,4,621,155.25,1361028725499,1361028725563,1450106599,1450106663,64
1361028738,1450119100,4,292,73,1361028731516,1361028731580,1450112616,1450112680,64
1361028738,1450119108,4,376,94,1361028737524,1361028737652,1450118632,1450118760,128
1361028738,1450119136,4,414,103.5,1361028731479,1361028731543,1450112615,1450112679,64
1361028738,1450119136,4,310,77.5,1361028735510,1361028735574,1450116646,1450116710,64
1361028746,1450127152,4,504,126,1361028743558,1361028743622,1450124710,1450124774,64
1361028746,1450127160,4,376,94,1361028745600,1361028745728,1450126760,1450126888,128
1361028754,1450135116,4,412,103,1361028747628,1361028747692,1450128744,1450128808,64
1361028754,1450135120,4,460,115,1361028751589,1361028751717,1450132709,1450132837,128
1361028754,1450135124,4,413,103.25,1361028753635,1361028753699,1450134759,1450134823,64
1361028754,1450135152,3,144,48,1361028752072,1361028752136,1450133224,1450133288,64
1361028754,1450135272,2,474,237,1361028728591,1361028728655,1450109863,1450109927,64
1361028770,1450151168,4,460,115,1361028769654,1361028769782,1450150822,1450150950,128
1361028778,1450159156,4,719,179.75,1361028773700,1361028773828,1450154856,1450154984,128
1361028778,1450159156,4,413,103.25,1361028777729,1361028777793,1450158885,1450158949,64
1361028778,1450159228,2,265,132.5,1361028750012,1361028750204,1450131240,1450131432,192
1361028786,1450167148,4,628,157,1361028779784,1361028779848,1450160932,1450160996,64
1361028794,1450175200,2,474,237,1361028768919,1361028768983,1450150119,1450150183,64
1361028802,1450183060,4,310,77.5,1361028793953,1361028794017,1450175013,1450175077,64
1361028802,1450183076,4,205,51.25,1361028793938,1361028793938,1450175014,1450175014,0
1361028834,1450215084,4,501,125.25,1361028830153,1361028830217,1450211237,1450211301,64
1361028834,1450215152,3,144,48,1361028827076,1361028827140,1450208228,1450208292,64
1361028834,1450215188,2,265,132.5,1361028805983,1361028806047,1450187171,1450187235,64
1361028834,1450215204,2,474,237,1361028809042,1361028809106,1450190246,1450190310,64
1361028866,1450247064,6,1360,226.6666667,1361028862108,1361028862236,1450243172,1450243300,128
1361028866,1450247080,6,1360,226.6666667,1361028862093,1361028862221,1450243173,1450243301,128
1361028866,1450247080,6,1360,226.6666667,1361028862093,1361028862221,1450243173,1450243301,128
1361028874,1450255100,7,1406,200.8571429,1361028862138,1361028868026,1450243238,1450249126,5888
1361028874,1450255112,7,2167,309.5714286,1361028872366,1361028872494,1450253478,1450253606,128
1361028874,1450255116,8,544,68,1361028862185,1361028868009,1450243301,1450249125,5824
1361028874,1450255116,8,544,68,1361028862185,1361028868009,1450243301,1450249125,5824
1361028874,1450255284,2,474,237,1361028849219,1361028849283,1450230503,1450230567,64
1361028882,1450263104,4,413,103.25,1361028878389,1361028878517,1450259493,1450259621,128
1361028886,1450267276,2,265,132.5,1361028861257,1361028861321,1450242533,1450242597,64
1361028886,1450267320,10,2373,237.3,1361028860765,1361028861277,1450242085,1450242597,512
1361028890,1450271140,7,2164,309.1428571,1361028888272,1361028888464,1450269412,1450269604,192
1361028890,1450271520,7,4626,660.8571429,1361028861718,1361028861782,1450243238,1450243302,64
1361028890,1450271520,7,3707,529.5714286,1361028861781,1361028861845,1450243301,1450243365,64
1361028890,1450271564,7,3734,533.4285714,1361028861735,1361028861735,1450243299,1450243299,0
1361028906,1450287092,4,652,163,1361028900544,1361028900672,1450281636,1450281764,128
1361028906,1450287096,3,144,48,1361028902139,1361028902139,1450283235,1450283235,0
1361028906,1450287128,4,1073,268.25,1361028904539,1361028904667,1450285667,1450285795,128
1361028914,1450295664,2,474,237,1361028888899,1361028889027,1450270563,1450270691,128
1361028937,88632052,2,98,49,1361028931651,1361028935427,88626703,88630479,3776
1361028937,88632052,2,98,49,1361028931651,1361028936387,88626703,88631439,4736
1361028938,1450319144,4,336,84,1361028930698,1361028930762,1450311842,1450311906,64
1361028938,1450319172,4,1375,343.75,1361028932655,1361028932783,1450313827,1450313955,128
1361028938,1450319176,4,310,77.5,1361028936682,1361028936810,1450317858,1450317986,128
1361028942,1450323684,2,265,132.5,1361028916722,1361028916850,1450298406,1450298534,128
1361028946,1450327128,5,1358,271.6,1361028942810,1361028942938,1450323938,1450324066,128
1361028954,1450335140,4,615,153.75,1361028946767,1361028946895,1450327907,1450328035,128
1361028954,1450335140,4,312,78,1361028950735,1361028950799,1450331875,1450331939,64
1361028954,1450335140,4,311,77.75,1361028950798,1361028950926,1450331938,1450332066,128
1361028954,1450335144,4,312,78,1361028950858,1361028950986,1450332002,1450332130,128
1361028954,1450335148,4,312,78,1361028951753,1361028951817,1450332901,1450332965,64
1361028954,1450335148,4,312,78,1361028952073,1361028952137,1450333221,1450333285,64
1361028954,1450335156,4,312,78,1361028950593,1361028950657,1450331749,1450331813,64
1361028954,1450335180,4,312,78,1361028951271,1361028951335,1450332451,1450332515,64
1361028954,1450335180,4,312,78,1361028951335,1361028951463,1450332515,1450332643,128
1361028954,1450335180,4,312,78,1361028951271,1361028951399,1450332451,1450332579,128
1361028954,1450335180,4,312,78,1361028951399,1361028951527,1450332579,1450332707,128
1361028954,1450335184,4,312,78,1361028952035,1361028952099,1450333219,1450333283,64
1361028954,1450335672,2,474,237,1361028929530,1361028929594,1450311202,1450311266,64
1361028962,1450343140,4,517,129.25,1361028956880,1361028956944,1450338020,1450338084,64
1361028970,1450351156,4,692,173,1361028961921,1361028961985,1450343077,1450343141,64
1361028970,1450351156,3,144,48,1361028962111,1361028962111,1450343267,1450343267,0
1361028970,1450351172,4,516,129,1361028961905,1361028961969,1450343077,1450343141,64
1361028974,1450355712,4,2088,522,1361028949779,1361028949843,1450331491,1450331555,64
1361028978,1450359152,3,169,56.33333333,1361028977346,1361028977346,1450358498,1450358498,0
1361028978,1450359188,3,169,56.33333333,1361028977313,1361028977313,1450358501,1450358501,0
1361028978,1450359188,3,169,56.33333333,1361028977313,1361028977313,1450358501,1450358501,0
1361028978,1450359636,4,205,51.25,1361028976865,1361028976865,1450358501,1450358501,0
1361028994,1450375728,2,474,237,1361028969538,1361028969602,1450351266,1450351330,64
1361028998,1450379688,2,265,132.5,1361028972844,1361028972908,1450354532,1450354596,64
1361029038,1450419764,2,474,237,1361029009888,1361029009952,1450391652,1450391716,64
1361029042,1450423192,3,144,48,1361029037084,1361029037084,1450418276,1450418276,0
1361029055,1450435980,2,265,132.5,1361029029552,1361029029616,1450410532,1450410596,64
1361029072,1450453256,1,46,46,1361029045659,1361029045659,1450426915,1450426915,0
1361029072,1450453260,1,46,46,1361029045718,1361029045718,1450426978,1450426978,0
1361029072,1450453304,1,46,46,1361029045738,1361029045738,1450427042,1450427042,0
1361029073,1450454148,1,46,46,1361029045831,1361029045831,1450426979,1450426979,0
1361029074,1450455216,326,465152,1426.846626,1361028950465,1361029067265,1450331681,1450448481,116800
1361029075,1450456216,2,474,237,1361029050371,1361029050435,1450431587,1450431651,64
1361029091,1450472036,1,46,46,1361029066420,1361029066420,1450447456,1450447456,0
1361029091,1450472048,1,60,60,1361029064426,1361029064426,1450445474,1450445474,0
1361029095,1450476056,1,60,60,1361029069026,1361029069026,1450450082,1450450082,0
1361029103,1450484004,1,60,60,1361029076181,1361029076181,1450457185,1450457185,0
1361029111,1450492052,2,265,132.5,1361029084646,1361029084710,1450465698,1450465762,64
1361029114,1450495224,3,144,48,1361029111993,1361029112057,1450493217,1450493281,64
1361029119,1450500080,2,474,237,1361029090952,1361029091016,1450472032,1450472096,64
1361029123,1450504068,1,60,60,1361029095383,1361029095383,1450476451,1450476451,0
1361029155,1450536064,2,474,237,1361029130906,1361029130970,1450511970,1450512034,64
1361029167,1450548104,2,265,132.5,1361029139826,1361029139954,1450520930,1450521058,128
1361029183,1450564208,12,3020,251.6666667,1361029158216,1361029161864,1450539424,1450543072,3648
1361029194,1450575268,3,144,48,1361029186956,1361029187020,1450568224,1450568288,64
1361029199,1450580140,2,474,237,1361029171019,1361029171083,1450552159,1450552223,64
1361029223,1450604460,2,265,132.5,1361029195467,1361029195595,1450576927,1450577055,128
1361029239,1450620460,2,474,237,1361029210891,1361029210955,1450592351,1450592415,64
1361029250,88944176,2,98,49,1361029243951,1361029247599,88938127,88941775,3648
1361029250,88944180,2,98,49,1361029243947,1361029248619,88938127,88942799,4672
1361029266,1450647320,3,144,48,1361029261910,1361029261974,1450643230,1450643294,64
1361029279,1450660448,2,474,237,1361029250968,1361029251032,1450632416,1450632480,64
1361029279,1450660452,2,265,132.5,1361029251476,1361029251604,1450632928,1450633056,128
1361029279,1450660452,2,96,48,1361029251476,1361029254420,1450632928,1450635872,2944
1361029282,1450663304,4,312,78,1361029276519,1361029276583,1450657823,1450657887,64
1361029282,1450663304,4,312,78,1361029276518,1361029276582,1450657822,1450657886,64
1361029282,1450663308,4,205,51.25,1361029277156,1361029277156,1450658464,1450658464,0
1361029282,1450663312,2,98,49,1361029274141,1361029280157,1450655453,1450661469,6016
1361029282,1450663312,2,98,49,1361029274141,1361029280157,1450655453,1450661469,6016
1361029282,1450663312,2,98,49,1361029274141,1361029280157,1450655453,1450661469,6016
1361029287,88981740,6,969,161.5,1361029283005,1361029283197,88977745,88977937,192
1361029287,88981740,5,564,112.8,1361029283005,1361029283197,88977745,88977937,192
1361029290,88984180,23,29360,1276.521739,1361029283182,1361029283566,88977362,88977746,384
1361029290,88984180,6,1672,278.6666667,1361029283565,1361029283757,88977745,88977937,192
1361029290,88984180,9,7139,793.2222222,1361029283565,1361029283821,88977745,88978001,256
1361029290,88984180,5,564,112.8,1361029283565,1361029283757,88977745,88977937,192
1361029290,88984180,7,4624,660.5714286,1361029283821,1361029284013,88978001,88978193,192
1361029290,1450671300,2,98,49,1361029283308,1361029288492,1450664608,1450669792,5184
1361029290,1450671300,4,312,78,1361029283691,1361029283755,1450664991,1450665055,64
1361029290,1450671304,4,312,78,1361029282536,1361029282600,1450663840,1450663904,64
1361029290,1450671304,4,312,78,1361029282599,1361029282727,1450663903,1450664031,128
1361029290,1450671308,4,312,78,1361029282980,1361029283044,1450664288,1450664352,64
1361029290,1450671312,4,312,78,1361029283359,1361029283487,1450664671,1450664799,128
1361029290,1450671340,2,98,49,1361029282498,1361029288450,1450663838,1450669790,5952
1361029290,1450671344,4,312,78,1361029282560,1361029282688,1450663904,1450664032,128
1361029290,88984184,6,3035,505.8333333,1361029283178,1361029283690,88977362,88977874,512
1361029299,1450680488,16,9327,582.9375,1361029273967,1361029283823,1450655455,1450665311,9856
1361029299,1450680488,4,1692,423,1361029273967,1361029274031,1450655455,1450655519,64
1361029299,1450680524,11,8633,784.8181818,1361029273545,1361029279369,1450655069,1450660893,5824
1361029299,1450680528,12,4184,348.6666667,1361029273735,1361029279559,1450655263,1450661087,5824
1361029299,1450680532,14,8093,578.0714286,1361029273924,1361029282628,1450655456,1450664160,8704
1361029299,1450680576,24,22339,930.7916667,1361029273560,1361029274328,1450655136,1450655904,768
1361029307,1450688472,4,915,228.75,1361029282301,1361029282429,1450663773,1450663901,128
1361029307,1450688476,8,5690,711.25,1361029282428,1361029283644,1450663904,1450665120,1216
1361029311,1450692524,24,31346,1306.083333,1361029283081,1361029283209,1450664605,1450664733,128
1361029311,1450692528,3,514,171.3333333,1361029283336,1361029283464,1450664864,1450664992,128
1361029319,1450700468,2,474,237,1361029291587,1361029291715,1450673055,1450673183,128
1361029331,1450712500,3,144,48,1361029321761,1361029321761,1450703261,1450703261,0
1361029331,1450712552,2,265,132.5,1361029306862,1361029306926,1450688414,1450688478,64
1361029343,1450724560,1,77,77,1361029318822,1361029318822,1450700382,1450700382,0
1361029346,1450727340,3,200,66.66666667,1361029338689,1361029343681,1450720029,1450725021,4992
1361029351,1450732540,2,154,77,1361029323833,1361029324089,1450705373,1450705629,256
1361029359,1450740860,2,474,237,1361029331321,1361029331385,1450713181,1450713245,64
1361029359,1450740868,2,92,46,1361029332913,1361029332913,1450714781,1450714781,0
1361029367,1450748868,2,92,46,1361029342897,1361029342897,1450724765,1450724765,0
1361029367,1450748884,2,92,46,1361029341856,1361029341920,1450723740,1450723804,64
1361029371,1450752940,2,92,46,1361029343082,1361029343082,1450725022,1450725022,0
1361029383,1450764924,1,56,56,1361029356280,1361029356280,1450738204,1450738204,0
1361029387,1450768892,2,265,132.5,1361029362392,1361029362456,1450744284,1450744348,64
1361029391,1450772892,1,77,77,1361029363418,1361029363418,1450745310,1450745310,0
1361029396,1450777004,2,154,77,1361029369362,1361029369618,1450750366,1450750622,256
1361029399,1450780920,2,474,237,1361029372350,1361029372414,1450754270,1450754334,64
1361029402,1450783372,3,144,48,1361029396899,1361029396899,1450778271,1450778271,0
1361029410,1450791332,6,366,61,1361029408903,1361029408967,1450790235,1450790299,64
1361029415,1450796988,1,46,46,1361029387834,1361029387834,1450769822,1450769822,0
1361029418,1450799340,6,366,61,1361029413889,1361029413953,1450795229,1450795293,64
1361029418,1450799372,296,349396,1180.391892,1361029264672,1361029413920,1450646044,1450795292,149248
1361029423,1450804956,1,46,46,1361029397849,1361029397849,1450779805,1450779805,0
1361029423,1450804956,1,46,46,1361029397849,1361029397849,1450779805,1450779805,0
1361029424,1450805020,1,46,46,1361029399807,1361029399807,1450780827,1450780827,0
1361029439,1450820960,2,474,237,1361029412947,1361029413011,1450794907,1450794971,64
1361029444,1450825020,2,265,132.5,1361029419074,1361029419138,1450800094,1450800158,64
1361029474,1450855440,8,1505,188.125,1361029462490,1361029467546,1450843930,1450848986,5056
1361029474,1450855444,3,144,48,1361029471832,1361029471832,1450853276,1450853276,0
1361029474,1450855480,8,1505,188.125,1361029462450,1361029467506,1450843930,1450848986,5056
1361029474,1450855480,7,1406,200.8571429,1361029462450,1361029467506,1450843930,1450848986,5056
1361029480,1450861140,2,474,237,1361029453831,1361029453895,1450834971,1450835035,64
1361029488,1450869092,11,2302,209.2727273,1361029462071,1361029462391,1450843163,1450843483,320
1361029500,1450881052,2,265,132.5,1361029474464,1361029474592,1450855516,1450855644,128
1361029520,1450901408,2,474,237,1361029493113,1361029493241,1450874521,1450874649,128
1361029530,1450911444,2,98,49,1361029527959,1361029527959,1450909403,1450909403,0
1361029538,89232216,23,29360,1276.521739,1361029530888,1361029531272,89225104,89225488,384
1361029538,89232220,22,27635,1256.136364,1361029531271,1361029532871,89225491,89227091,1600
1361029538,89232220,2,98,49,1361029531272,1361029536520,89225492,89230740,5248
1361029538,1450919440,2,98,49,1361029528025,1361029534105,1450909465,1450915545,6080
1361029538,1450919448,2,98,49,1361029530899,1361029536147,1450912347,1450917595,5248
1361029538,1450919448,2,98,49,1361029530962,1361029536146,1450912410,1450917594,5184
1361029538,1450919456,8,544,68,1361029527947,1361029533131,1450909403,1450914587,5184
1361029538,1450919456,2,98,49,1361029528011,1361029534091,1450909467,1450915547,6080
1361029552,1450933420,10,2837,283.7,1361029527726,1361029528046,1450909146,1450909466,320
1361029552,1450933464,5,437,87.4,1361029527747,1361029528003,1450909211,1450909467,256
1361029554,1450935496,3,144,48,1361029547746,1361029547810,1450929242,1450929306,64
1361029556,1450937364,7,3260,465.7142857,1361029528038,1361029528422,1450909402,1450909786,384
1361029556,1450937364,14,8031,573.6428571,1361029528038,1361029530022,1450909402,1450911386,1984
1361029556,1450937364,14,8031,573.6428571,1361029528038,1361029530278,1450909402,1450911642,2240
1361029556,1450937368,4,1380,345,1361029530466,1361029532130,1450911834,1450913498,1664
1361029556,1450937408,9,3512,390.2222222,1361029527994,1361029528186,1450909402,1450909594,192
1361029556,1450937444,4,930,232.5,1361029530967,1361029532567,1450912411,1450914011,1600
1361029556,1450937444,2,265,132.5,1361029529495,1361029529559,1450910939,1450911003,64
1361029560,1450941364,8,5655,706.875,1361029532200,1361029532840,1450913564,1450914204,640
1361029560,1450941420,2,474,237,1361029533679,1361029533743,1450915099,1450915163,64
1361029562,89256220,2,98,49,1361029553862,1361029558342,89248082,89252562,4480
1361029562,89256224,2,98,49,1361029553858,1361029557314,89248082,89251538,3456
1361029578,89272216,2,98,49,1361029570248,1361029575880,89264464,89270096,5632
1361029578,89272216,23,29099,1265.173913,1361029569804,1361029570252,89264020,89264468,448
1361029578,89272220,2,98,49,1361029570245,1361029575877,89264465,89270097,5632
1361029578,1450959504,4,205,51.25,1361029577499,1361029577499,1450959003,1450959003,0
1361029578,1450959504,2,98,49,1361029569817,1361029575449,1450951321,1450956953,5632
1361029578,1450959536,4,313,78.25,1361029577465,1361029577593,1450959001,1450959129,128
1361029578,1450959540,4,312,78,1361029577720,1361029577784,1450959260,1450959324,64
1361029578,1450959540,4,312,78,1361029577720,1361029577784,1450959260,1450959324,64
1361029578,1450959540,4,312,78,1361029577783,1361029577847,1450959323,1450959387,64
1361029586,1450967480,3,169,56.33333333,1361029572018,1361029580978,1450953498,1450962458,8960
1361029586,1450967484,3,140,46.66666667,1361029578223,1361029583471,1450959707,1450964955,5248
1361029586,1450967484,4,313,78.25,1361029578414,1361029578542,1450959898,1450960026,128
1361029586,1450967484,2,98,49,1361029578541,1361029584493,1450960025,1450965977,5952
1361029586,1450967484,2,98,49,1361029578541,1361029584493,1450960025,1450965977,5952
1361029586,1450967484,3,751,250.3333333,1361029578604,1361029578732,1450960088,1450960216,128
1361029586,1450967488,4,312,78,1361029578664,1361029578728,1450960152,1450960216,64
1361029586,1450967488,4,312,78,1361029578536,1361029578664,1450960024,1450960152,128
1361029586,1450967488,4,190,47.5,1361029578732,1361029584492,1450960220,1450965980,5760
1361029586,1450967488,2,98,49,1361029578857,1361029584489,1450960345,1450965977,5632
1361029586,1450967488,4,313,78.25,1361029578921,1361029578985,1450960409,1450960473,64
1361029586,1450967496,6,1881,313.5,1361029577700,1361029583460,1450959196,1450964956,5760
1361029586,1450967496,6,2218,369.6666667,1361029577699,1361029583523,1450959195,1450965019,5824
1361029586,1450967496,2,98,49,1361029577699,1361029583459,1450959195,1450964955,5760
1361029586,1450967496,2,98,49,1361029577699,1361029583523,1450959195,1450965019,5824
1361029586,1450967496,15,14037,935.8,1361029577891,1361029582435,1450959387,1450963931,4544
1361029586,1450967496,2,98,49,1361029577891,1361029583523,1450959387,1450965019,5632
1361029586,1450967496,67,89798,1340.268657,1361029577891,1361029582435,1450959387,1450963931,4544
1361029586,1450967496,6,1715,285.8333333,1361029577891,1361029581923,1450959387,1450963419,4032
1361029586,1450967500,3,447,149,1361029578076,1361029578204,1450959576,1450959704,128
1361029586,1450967500,4,312,78,1361029578143,1361029578271,1450959643,1450959771,128
1361029586,1450967500,3,609,203,1361029578207,1361029578271,1450959707,1450959771,64
1361029586,1450967500,4,313,78.25,1361029578334,1361029578398,1450959834,1450959898,64
1361029586,1450967520,4,312,78,1361029578250,1361029578314,1450959770,1450959834,64
1361029586,1450967520,4,312,78,1361029578377,1361029578505,1450959897,1450960025,128
1361029586,1450967524,10,6884,688.4,1361029578504,1361029582792,1450960028,1450964316,4288
1361029586,1450967524,6,2044,340.6666667,1361029578504,1361029584456,1450960028,1450965980,5952
1361029586,1450967524,59,81232,1376.813559,1361029578504,1361029584456,1450960028,1450965980,5952
1361029586,1450967524,2,98,49,1361029578504,1361029584456,1450960028,1450965980,5952
1361029586,1450967524,4,312,78,1361029578568,1361029578632,1450960092,1450960156,64
1361029586,1450967524,3,751,250.3333333,1361029578567,1361029578695,1450960091,1450960219,128
1361029586,1450967524,4,312,78,1361029578631,1361029578759,1450960155,1450960283,128
1361029586,1450967524,25,30514,1220.56,1361029578695,1361029582471,1450960219,1450963995,3776
1361029586,1450967524,4,312,78,1361029578758,1361029578822,1450960282,1450960346,64
1361029586,1450967524,4,312,78,1361029578694,1361029578822,1450960218,1450960346,128
1361029586,1450967524,2,279,139.5,1361029578757,1361029584453,1450960281,1450965977,5696
1361029586,1450967524,4,313,78.25,1361029578821,1361029578885,1450960345,1450960409,64
1361029586,1450967524,4,312,78,1361029578885,1361029579013,1450960409,1450960537,128
1361029586,1450967524,6,1848,308,1361029578821,1361029580933,1450960345,1450962457,2112
1361029586,1450967532,7,3429,489.8571429,1361029577660,1361029583420,1450959192,1450964952,5760
1361029586,1450967532,2,98,49,1361029577660,1361029583420,1450959192,1450964952,5760
1361029586,1450967532,2,98,49,1361029577855,1361029583487,1450959387,1450965019,5632
1361029586,1450967532,4,312,78,1361029577855,1361029577983,1450959387,1450959515,128
1361029586,1450967532,3,144,48,1361029577855,1361029583487,1450959387,1450965019,5632
1361029586,1450967532,4,352,88,1361029577854,1361029577982,1450959386,1450959514,128
1361029592,1450973472,8,7344,918,1361029566650,1361029575162,1450948122,1450956634,8512
1361029592,1450973476,9,4155,461.6666667,1361029567606,1361029578614,1450949082,1450960090,11008
1361029594,1450975512,5,1736,347.2,1361029578772,1361029593876,1450960284,1450975388,15104
1361029594,1450975516,14,13510,965,1361029577422,1361029593422,1450958938,1450974938,16000
1361029594,1450975544,5,458,91.6,1361029578355,1361029593459,1450959899,1450975003,15104
1361029596,1450977376,6,2520,420,1361029567960,1361029576088,1450949336,1450957464,8128
1361029596,1450977416,2,832,416,1361029569971,1361029578291,1450951387,1450959707,8320
1361029596,1450977452,14,10744,767.4285714,1361029569421,1361029578509,1450950873,1450959961,9088
1361029596,1450977452,2,1301,650.5,1361029569357,1361029577421,1450950809,1450958873,8064
1361029600,1450981432,2,154,77,1361029572066,1361029572322,1450953498,1450953754,256
1361029600,1450981440,2,154,77,1361029573019,1361029573275,1450954459,1450954715,256
1361029600,1450981440,2,474,237,1361029573402,1361029573530,1450954842,1450954970,128
1361029604,1450985412,4,914,228.5,1361029578741,1361029578997,1450960153,1450960409,256
1361029604,1450985412,8,6540,817.5,1361029578805,1361029579061,1450960217,1450960473,256
1361029604,1450985448,14,14642,1045.857143,1361029578384,1361029578832,1450959832,1450960280,448
1361029604,1450985456,4,914,228.5,1361029578696,1361029578952,1450960152,1450960408,256
1361029612,1450993392,2,265,132.5,1361029585162,1361029585290,1450966554,1450966682,128
1361029620,1451001432,1,46,46,1361029594019,1361029594019,1450975451,1450975451,0
1361029626,1451007576,3,144,48,1361029621713,1361029621713,1451003289,1451003289,0
1361029634,1451015520,2,98,49,1361029628107,1361029633611,1451009627,1451015131,5504
1361029634,1451015520,3,140,46.66666667,1361029628170,1361029633546,1451009690,1451015066,5376
1361029634,1451015520,3,663,221,1361029628234,1361029628298,1451009754,1451009818,64
1361029634,1451015520,2,98,49,1361029628297,1361029633609,1451009817,1451015129,5312
1361029634,1451015520,4,313,78.25,1361029628297,1361029628425,1451009817,1451009945,128
1361029634,1451015524,3,751,250.3333333,1361029628743,1361029628871,1451010267,1451010395,128
1361029634,1451015524,25,30514,1220.56,1361029628871,1361029632455,1451010395,1451013979,3584
1361029634,1451015524,4,313,78.25,1361029628934,1361029629062,1451010458,1451010586,128
1361029634,1451015532,6,2186,364.3333333,1361029628092,1361029633468,1451009624,1451015000,5376
1361029634,1451015532,4,313,78.25,1361029627964,1361029628028,1451009496,1451009560,64
1361029634,1451015532,2,98,49,1361029628092,1361029633596,1451009624,1451015128,5504
1361029634,1451015532,2,98,49,1361029628092,1361029633596,1451009624,1451015128,5504
1361029634,1451015532,2,98,49,1361029628092,1361029633596,1451009624,1451015128,5504
1361029634,1451015532,4,312,78,1361029628155,1361029628219,1451009687,1451009751,64
1361029634,1451015536,5,1500,300,1361029628091,1361029633467,1451009627,1451015003,5376
1361029634,1451015536,4,312,78,1361029628155,1361029628219,1451009691,1451009755,64
1361029634,1451015536,4,312,78,1361029628282,1361029628346,1451009818,1451009882,64
1361029634,1451015536,8,535,66.875,1361029628410,1361029633594,1451009946,1451015130,5184
1361029640,1451021444,2,474,237,1361029613780,1361029613844,1450995224,1450995288,64
1361029642,1451023544,2,98,49,1361029628594,1361029634546,1451010138,1451016090,5952
1361029642,1451023544,31,40587,1309.258065,1361029628594,1361029634418,1451010138,1451015962,5824
1361029642,1451023544,4,190,47.5,1361029628849,1361029634545,1451010393,1451016089,5696
1361029642,1451023552,2,123,61.5,1361029638953,1361029638953,1451020505,1451020505,0
1361029642,1451023580,3,325,108.3333333,1361029628814,1361029634510,1451010394,1451016090,5696
1361029644,1451025460,1,77,77,1361029616966,1361029616966,1450998426,1450998426,0
1361029644,1451025472,2,154,77,1361029617914,1361029618170,1450999386,1450999642,256
1361029650,1451031536,12,12234,1019.5,1361029627895,1361029643383,1451009431,1451024919,15488
1361029650,1451031544,5,1435,287,1361029628785,1361029644017,1451010329,1451025561,15232
1361029652,1451033496,1,644,644,1361029627871,1361029627871,1451009367,1451009367,0
1361029652,1451033500,3,2931,977,1361029624157,1361029624285,1451005657,1451005785,128
1361029652,1451033508,3,1310,436.6666667,1361029625044,1361029625044,1451006552,1451006552,0
1361029652,1451033512,3,1310,436.6666667,1361029625298,1361029625298,1451006810,1451006810,0
1361029656,1451037484,7,5089,727,1361029627948,1361029628524,1451009432,1451010008,576
1361029656,1451037488,11,2156,196,1361029628458,1361029638378,1451009946,1451019866,9920
1361029656,1451037488,9,8144,904.8888889,1361029628394,1361029628970,1451009882,1451010458,576
1361029656,1451037612,1,416,416,1361029628140,1361029628140,1451009752,1451009752,0
1361029656,1451037616,2,454,227,1361029628714,1361029628778,1451010330,1451010394,64
1361029664,1451045536,2,92,46,1361029638329,1361029638329,1451019865,1451019865,0
1361029666,1451047548,6,366,61,1361029662828,1361029662828,1451044376,1451044376,0
1361029666,1451047584,6,366,61,1361029661767,1361029661831,1451043351,1451043415,64
1361029668,1451049464,2,265,132.5,1361029640257,1361029640321,1451021721,1451021785,64
1361029680,1451061520,2,474,237,1361029654729,1361029654793,1451036249,1451036313,64
1361029698,1451079576,3,144,48,1361029696656,1361029696720,1451078232,1451078296,64
1361029704,1451085600,23,15522,674.8695652,1361029679482,1361029682554,1451061082,1451064154,3072
1361029704,1451085600,6,5862,977,1361029679545,1361029682105,1451061145,1451063705,2560
1361029708,1451089516,8,4785,598.125,1361029680780,1361029682956,1451062296,1451064472,2176
1361029708,1451089548,7,4733,676.1428571,1361029680556,1361029682668,1451062104,1451064216,2112
1361029712,1451093524,2,92,46,1361029687493,1361029687493,1451069017,1451069017,0
1361029716,1451097512,2,92,46,1361029688335,1361029688399,1451069847,1451069911,64
1361029716,1451097560,2,92,46,1361029688289,1361029688353,1451069849,1451069913,64
1361029720,1451101532,2,474,237,1361029695227,1361029695291,1451076759,1451076823,64
1361029720,1451101556,2,265,132.5,1361029695845,1361029695909,1451077401,1451077465,64
1361029720,1451101564,1,46,46,1361029693531,1361029693531,1451075095,1451075095,0
1361029752,1451133624,1,77,77,1361029726689,1361029726689,1451108313,1451108313,0
1361029754,1451135600,4,246,61.5,1361029741433,1361029752505,1451123033,1451134105,11072
1361029754,1451135600,4,205,51.25,1361029753527,1361029753527,1451135127,1451135127,0
1361029760,1451141692,2,474,237,1361029734811,1361029734875,1451116503,1451116567,64
1361029762,1451143620,3,144,48,1361029756644,1361029756644,1451138264,1451138264,0
1361029764,1451145668,1,46,46,1361029738354,1361029738354,1451120022,1451120022,0
1361029768,1451149672,2,92,46,1361029741808,1361029741872,1451123480,1451123544,64
1361029768,1451149672,2,92,46,1361029741808,1361029741872,1451123480,1451123544,64
1361029768,1451149700,1,46,46,1361029743379,1361029743379,1451125079,1451125079,0
1361029768,1451149700,1,46,46,1361029743379,1361029743379,1451125079,1451125079,0
1361029776,1451157724,2,265,132.5,1361029751417,1361029751545,1451133141,1451133269,128
1361029788,1451169688,10,1912,191.2,1361029761888,1361029762400,1451143576,1451144088,512
1361029796,1451177684,1,77,77,1361029771554,1361029771554,1451153238,1451153238,0
1361029800,1451181664,2,474,237,1361029774711,1361029774775,1451156375,1451156439,64
1361029818,1451199608,6,366,61,1361029816623,1361029816623,1451198231,1451198231,0
1361029832,1451213720,2,265,132.5,1361029806972,1361029807036,1451188692,1451188756,64
1361029834,1451215648,3,144,48,1361029831621,1361029831621,1451213269,1451213269,0
1361029840,1451221760,2,474,237,1361029814742,1361029814806,1451196502,1451196566,64
1361029866,1451247672,4,336,84,1361029861806,1361029861934,1451243478,1451243606,128
1361029874,89568320,2,98,49,1361029864227,1361029867875,89558547,89562195,3648
1361029874,89568320,2,98,49,1361029864227,1361029868899,89558547,89563219,4672
1361029880,1451261820,6,2186,364.3333333,1361029854425,1361029858649,1451236245,1451240469,4224
1361029882,1451263628,4,205,51.25,1361029878041,1361029878041,1451259669,1451259669,0
1361029888,1451269820,2,265,132.5,1361029862040,1361029862104,1451243860,1451243924,64
1361029898,1451279692,3,144,48,1361029893978,1361029893978,1451275670,1451275670,0
1361029924,1451305836,2,474,237,1361029898696,1361029898760,1451280532,1451280596,64
1361029944,1451325856,2,265,132.5,1361029917365,1361029917557,1451299221,1451299413,192
1361029964,1451345880,2,474,237,1361029939037,1361029939101,1451320917,1451320981,64
1361029970,1451351684,3,144,48,1361029966561,1361029966561,1451348245,1451348245,0
1361030000,1451381904,2,265,132.5,1361029972613,1361029972677,1451354517,1451354581,64
1361030004,1451385952,2,474,237,1361029978834,1361029978898,1451360786,1451360850,64
1361030042,1451423732,3,144,48,1361030041518,1361030041518,1451423250,1451423250,0
1361030045,1451426092,2,474,237,1361030019182,1361030019246,1451400274,1451400338,64
1361030053,1451434124,2,265,132.5,1361030028687,1361030028815,1451409811,1451409939,128
1361030082,1451463740,17,6755,397.3529412,1361030068902,1361030078566,1451450642,1451460306,9664
1361030082,1451463740,12,999,83.25,1361030069285,1361030078565,1451451025,1451460305,9280
1361030082,1451463744,11,953,86.63636364,1361030069539,1361030078563,1451451283,1451460307,9024
1361030085,1451466288,2,474,237,1361030059498,1361030059626,1451440786,1451440914,128
1361030089,1451470236,10,2102,210.2,1361030062876,1361030063388,1451444112,1451444624,512
1361030089,1451470300,6,4202,700.3333333,1361030063710,1361030063838,1451445010,1451445138,128
1361030109,1451490256,2,265,132.5,1361030083659,1361030083787,1451464915,1451465043,128
1361030122,1451503764,3,144,48,1361030116492,1361030116492,1451498256,1451498256,0
1361030125,1451506260,2,474,237,1361030099846,1361030099910,1451481106,1451481170,64
1361030145,1451526276,3,1120,373.3333333,1361030118709,1361030119157,1451499985,1451500433,448
1361030165,1451546304,2,474,237,1361030139035,1361030139099,1451520339,1451520403,64
1361030165,1451546352,2,265,132.5,1361030139306,1361030139370,1451520658,1451520722,64
1361030178,89872352,2,98,49,1361030174214,1361030177350,89868566,89871702,3136
1361030186,89880360,2,98,49,1361030174208,1361030178368,89868568,89872728,4160
1361030186,1451567832,3,169,56.33333333,1361030178377,1361030178377,1451560209,1451560209,0
1361030194,1451575852,3,144,48,1361030191413,1361030191413,1451573265,1451573265,0
1361030205,1451586576,2,474,237,1361030179529,1361030179593,1451561105,1451561169,64
1361030221,1451602680,2,265,132.5,1361030194976,1361030195104,1451576656,1451576784,128
1361030226,1451607840,11,5602,509.2727273,1361030208961,1361030224257,1451590801,1451606097,15296
1361030242,1451623856,4,205,51.25,1361030234352,1361030234352,1451616208,1451616208,0
1361030245,1451626628,2,474,237,1361030218900,1361030219028,1451600528,1451600656,128
1361030258,1451639852,3,144,48,1361030251382,1361030251446,1451633234,1451633298,64
1361030277,1451658644,2,265,132.5,1361030250565,1361030250629,1451632209,1451632273,64
1361030285,1451666700,2,474,237,1361030258955,1361030259019,1451640655,1451640719,64
1361030325,1451706660,2,474,237,1361030299637,1361030299701,1451681297,1451681361,64
1361030330,1451711900,3,144,48,1361030326340,1361030326340,1451708240,1451708240,0
1361030333,1451714712,2,265,132.5,1361030306301,1361030306429,1451688013,1451688141,128
1361030341,1451722680,1,48,48,1361030313757,1361030313757,1451695437,1451695437,0
1361030354,1451735892,4,891,222.75,1361030348876,1361030349004,1451730768,1451730896,128
1361030365,1451746700,2,474,237,1361030339658,1361030339786,1451721358,1451721486,128
1361030377,1451758684,7,4578,654,1361030351961,1361030352153,1451733645,1451733837,192
1361030377,1451758684,9,7351,816.7777778,1361030351961,1361030352217,1451733645,1451733901,256
1361030377,1451758716,51,52136,1022.27451,1361030349883,1361030363323,1451731599,1451745039,13440
1361030377,1451758724,10,7305,730.5,1361030351922,1361030352114,1451733646,1451733838,192
1361030377,1451758724,9,7484,831.5555556,1361030351922,1361030352114,1451733646,1451733838,192
1361030377,1451758724,6,3983,663.8333333,1361030351984,1361030352112,1451733708,1451733836,128
1361030377,1451758724,6,3070,511.6666667,1361030352048,1361030352112,1451733772,1451733836,64
1361030378,1451759940,3,144,48,1361030376667,1361030377563,1451758607,1451759503,896
1361030387,1451768000,4,190,47.5,1361030381703,1361030382215,1451762703,1451763215,512
1361030387,1451768000,4,190,47.5,1361030381894,1361030381958,1451762894,1451762958,64
1361030387,1451768000,4,190,47.5,1361030381958,1361030382406,1451762958,1451763406,448
1361030387,1451768000,4,190,47.5,1361030381957,1361030382085,1451762957,1451763085,128
1361030387,1451768000,4,190,47.5,1361030382021,1361030382085,1451763021,1451763085,64
1361030387,1451768000,4,190,47.5,1361030382085,1361030382149,1451763085,1451763149,64
1361030387,1451768000,4,190,47.5,1361030382085,1361030382213,1451763085,1451763213,128
1361030387,1451768000,4,190,47.5,1361030382149,1361030382277,1451763149,1451763277,128
1361030387,1451768004,4,190,47.5,1361030378176,1361030380544,1451759180,1451761548,2368
1361030387,1451768004,4,190,47.5,1361030382339,1361030382659,1451763343,1451763663,320
1361030387,1451768004,4,190,47.5,1361030382657,1361030383041,1451763661,1451764045,384
1361030387,1451768004,4,190,47.5,1361030382721,1361030383105,1451763725,1451764109,384
1361030387,1451768004,4,190,47.5,1361030379840,1361030380096,1451760844,1451761100,256
1361030387,1451768008,4,190,47.5,1361030379712,1361030380032,1451760720,1451761040,320
1361030387,1451768008,4,190,47.5,1361030383039,1361030383423,1451764047,1451764431,384
1361030387,1451768008,4,190,47.5,1361030380031,1361030380287,1451761039,1451761295,256
1361030387,1451768008,4,190,47.5,1361030383102,1361030385534,1451764110,1451766542,2432
1361030387,1451768008,4,190,47.5,1361030383166,1361030385534,1451764174,1451766542,2368
1361030387,1451768008,4,190,47.5,1361030380094,1361030380350,1451761102,1451761358,256
1361030387,1451768008,4,190,47.5,1361030383358,1361030383678,1451764366,1451764686,320
1361030387,1451768008,4,190,47.5,1361030380541,1361030380797,1451761549,1451761805,256
1361030387,1451768012,4,190,47.5,1361030380924,1361030381180,1451761936,1451762192,256
1361030387,1451768012,4,190,47.5,1361030380795,1361030381051,1451761807,1451762063,256
1361030387,1451768012,4,190,47.5,1361030383675,1361030384059,1451764687,1451765071,384
1361030387,1451768012,4,190,47.5,1361030381051,1361030381307,1451762063,1451762319,256
1361030387,1451768012,4,190,47.5,1361030381050,1361030381306,1451762062,1451762318,256
1361030387,1451768012,4,190,47.5,1361030381177,1361030381497,1451762189,1451762509,320
1361030387,1451768012,5,236,47.2,1361030377592,1361030380600,1451758604,1451761612,3008
1361030387,1451768016,4,190,47.5,1361030381814,1361030381942,1451762830,1451762958,128
1361030387,1451768016,4,190,47.5,1361030381940,1361030382004,1451762956,1451763020,64
1361030387,1451768020,4,190,47.5,1361030382004,1361030382068,1451763024,1451763088,64
1361030387,1451768020,4,190,47.5,1361030382067,1361030382195,1451763087,1451763215,128
1361030387,1451768020,4,190,47.5,1361030382323,1361030382643,1451763343,1451763663,320
1361030387,1451768020,4,190,47.5,1361030382322,1361030382770,1451763342,1451763790,448
1361030387,1451768040,4,190,47.5,1361030382366,1361030382686,1451763406,1451763726,320
1361030387,1451768040,4,190,47.5,1361030378460,1361030380700,1451759500,1451761740,2240
1361030387,1451768044,4,190,47.5,1361030382620,1361030383004,1451763664,1451764048,384
1361030387,1451768044,4,190,47.5,1361030382747,1361030383131,1451763791,1451764175,384
1361030387,1451768044,4,190,47.5,1361030383001,1361030383321,1451764045,1451764365,320
1361030387,1451768048,4,190,47.5,1361030380248,1361030380504,1451761296,1451761552,256
1361030387,1451768048,4,190,47.5,1361030383384,1361030383768,1451764432,1451764816,384
1361030387,1451768048,4,190,47.5,1361030380311,1361030380567,1451761359,1451761615,256
1361030387,1451768048,4,190,47.5,1361030380375,1361030380631,1451761423,1451761679,256
1361030387,1451768048,4,190,47.5,1361030380502,1361030380758,1451761550,1451761806,256
1361030387,1451768048,4,190,47.5,1361030380630,1361030380886,1451761678,1451761934,256
1361030387,1451768048,4,190,47.5,1361030380758,1361030381014,1451761806,1451762062,256
1361030387,1451768048,4,190,47.5,1361030380566,1361030380822,1451761614,1451761870,256
1361030387,1451768048,4,190,47.5,1361030380885,1361030381141,1451761933,1451762189,256
1361030387,1451768048,4,190,47.5,1361030381141,1361030381397,1451762189,1451762445,256
1361030387,1451768048,4,190,47.5,1361030381269,1361030381589,1451762317,1451762637,320
1361030387,1451768048,4,190,47.5,1361030381396,1361030381844,1451762444,1451762892,448
1361030387,1451768052,4,190,47.5,1361030381520,1361030381968,1451762572,1451763020,448
1361030387,1451768052,4,190,47.5,1361030381520,1361030382032,1451762572,1451763084,512
1361030389,1451770748,2,265,132.5,1361030362202,1361030362266,1451743950,1451744014,64
1361030401,1451782772,3,144,48,1361030376643,1361030379971,1451758415,1451761743,3328
1361030401,1451782772,3,144,48,1361030376769,1361030380161,1451758541,1451761933,3392
1361030403,1451784032,3,144,48,1361030402215,1361030402215,1451783247,1451783247,0
1361030405,1451786792,2,474,237,1361030379886,1361030379950,1451761678,1451761742,64
1361030427,1451808048,4,312,78,1361030419029,1361030419157,1451800077,1451800205,128
1361030427,1451808076,4,448,112,1361030420729,1361030420793,1451801805,1451801869,64
1361030443,1451824072,3,169,56.33333333,1361030441851,1361030441915,1451822923,1451822987,64
1361030443,1451824084,3,169,56.33333333,1361030441840,1361030441904,1451822924,1451822988,64
1361030445,1451826752,2,474,237,1361030419669,1361030419733,1451801421,1451801485,64
1361030445,1451826780,2,265,132.5,1361030418231,1361030418359,1451800011,1451800139,128
1361030475,1451856108,4,312,78,1361030470489,1361030470553,1451851597,1451851661,64
1361030475,1451856112,3,169,56.33333333,1361030468501,1361030468501,1451849613,1451849613,0
1361030475,1451856112,3,169,56.33333333,1361030468501,1361030468501,1451849613,1451849613,0
1361030475,1451856148,6,1746,291,1361030471602,1361030471730,1451852750,1451852878,128
1361030475,1451856148,4,312,78,1361030471666,1361030471794,1451852814,1451852942,128
1361030475,1451856148,3,169,56.33333333,1361030468466,1361030468466,1451849614,1451849614,0
1361030475,1451856148,3,169,56.33333333,1361030468466,1361030468466,1451849614,1451849614,0
1361030483,1451864104,3,144,48,1361030479196,1361030479196,1451860300,1451860300,0
1361030483,1451864152,4,205,51.25,1361030479277,1361030479277,1451860429,1451860429,0
1361030483,1451864152,9,5154,572.6666667,1361030471340,1361030479340,1451852492,1451860492,8000
1361030485,1451866792,2,474,237,1361030459886,1361030459950,1451841678,1451841742,64
1361030490,90184424,2,98,49,1361030485185,1361030488193,90179609,90182617,3008
1361030490,90184428,2,98,49,1361030485181,1361030489213,90179609,90183641,4032
1361030491,1451872096,73,97239,1332.041096,1361030470245,1361030487077,1451851341,1451868173,16832
1361030491,1451872104,13,3994,307.2307692,1361030472540,1361030483548,1451853644,1451864652,11008
1361030491,1451872104,14,5238,374.1428571,1361030472412,1361030483548,1451853516,1451864652,11136
1361030491,1451872104,13,6796,522.7692308,1361030472476,1361030483548,1451853580,1451864652,11072
1361030491,1451872104,13,3994,307.2307692,1361030472539,1361030483547,1451853643,1451864651,11008
1361030491,1451872140,24,20663,860.9583333,1361030472119,1361030484535,1451853259,1451865675,12416
1361030491,1451872140,13,6826,525.0769231,1361030472441,1361030483513,1451853581,1451864653,11072
1361030497,1451878824,6,2467,411.1666667,1361030469707,1361030469835,1451851531,1451851659,128
1361030501,1451882808,6,1141,190.1666667,1361030473756,1361030478364,1451855564,1451860172,4608
1361030526,1451907364,1,46,46,1361030497943,1361030497943,1451879307,1451879307,0
1361030526,1451907396,1,46,46,1361030497977,1361030497977,1451879373,1451879373,0
1361030526,1451907404,1,46,46,1361030498097,1361030498097,1451879501,1451879501,0
1361030526,1451907692,2,474,237,1361030500367,1361030500431,1451882059,1451882123,64
1361030526,1451907896,1,46,46,1361030497477,1361030497477,1451879373,1451879373,0
1361030555,1451936140,3,144,48,1361030554487,1361030554487,1451935627,1451935627,0
1361030561,1451942952,2,265,132.5,1361030533385,1361030533513,1451915337,1451915465,128
1361030566,1451947004,2,474,237,1361030540671,1361030540735,1451921675,1451921739,64
1361030603,1451984160,9,3230,358.8888889,1361030591844,1361030596900,1451973004,1451978060,5056
1361030603,1451984160,4,312,78,1361030600353,1361030600481,1451981513,1451981641,128
1361030603,1451984160,4,312,78,1361030600353,1361030600481,1451981513,1451981641,128
1361030603,1451984164,2,98,49,1361030600413,1361030600477,1451981577,1451981641,64
1361030603,1451984192,4,314,78.5,1361030598977,1361030599041,1451980169,1451980233,64
1361030606,1451987080,2,474,237,1361030580594,1361030580658,1451961674,1451961738,64
1361030611,1451992160,3,144,48,1361030600356,1361030605924,1451981516,1451987084,5568
1361030611,1451992192,2,98,49,1361030599363,1361030604931,1451980555,1451986123,5568
1361030611,1451992192,2,98,49,1361030599363,1361030604931,1451980555,1451986123,5568
1361030614,1451995036,2,265,132.5,1361030589535,1361030589663,1451970571,1451970699,128
1361030614,1451995064,1,46,46,1361030586370,1361030586370,1451967434,1451967434,0
1361030618,1451999064,26,15061,579.2692308,1361030592834,1361030596226,1451973898,1451977290,3392
1361030618,1451999064,24,16049,668.7083333,1361030592834,1361030596866,1451973898,1451977930,4032
1361030618,1451999092,16,10597,662.3125,1361030593640,1361030596072,1451974732,1451977164,2432
1361030618,1451999104,8,836,104.5,1361030591772,1361030592860,1451972876,1451973964,1088
1361030618,1451999104,11,8633,784.8181818,1361030591899,1361030592923,1451973003,1451974027,1024
1361030618,1451999128,21,14130,672.8571429,1361030592833,1361030596737,1451973961,1451977865,3904
1361030626,1452007064,32,40518,1266.1875,1361030599044,1361030611588,1451980108,1451992652,12544
1361030626,1452007064,7,1450,207.1428571,1361030599235,1361030599683,1451980299,1451980747,448
1361030626,1452007064,3,1152,384,1361030599490,1361030599682,1451980554,1451980746,192
1361030626,1452007064,3,1390,463.3333333,1361030599490,1361030599682,1451980554,1451980746,192
1361030626,1452007064,3,1764,588,1361030599553,1361030611585,1451980617,1451992649,12032
1361030626,1452007068,4,1163,290.75,1361030600191,1361030612031,1451981259,1451993099,11840
1361030626,1452007108,27,26742,990.4444444,1361030599510,1361030611926,1451980618,1451993034,12416
1361030626,1452007108,2,650,325,1361030599510,1361030599638,1451980618,1451980746,128
1361030626,1452007108,5,4062,812.4,1361030599510,1361030611542,1451980618,1451992650,12032
1361030626,1452007108,5,1346,269.2,1361030599381,1361030611541,1451980489,1451992649,12160
1361030626,1452007112,4,503,125.75,1361030600147,1361030611987,1451981259,1451993099,11840
1361030626,1452007112,3,808,269.3333333,1361030600402,1361030600402,1451981514,1451981514,0
1361030626,1452007112,4,502,125.5,1361030600146,1361030611986,1451981258,1451993098,11840
1361030626,1452007112,5,3924,784.8,1361030600401,1361030600401,1451981513,1451981513,0
1361030626,1452007112,7,968,138.2857143,1361030600528,1361030600592,1451981640,1451981704,64
1361030635,1452016152,3,144,48,1361030627113,1361030627113,1452008265,1452008265,0
1361030638,1452019056,6,2245,374.1666667,1361030611529,1361030612809,1451992585,1451993865,1280
1361030642,1452023168,1,46,46,1361030617497,1361030617497,1451998665,1451998665,0
1361030646,1452027096,2,474,237,1361030620195,1361030620323,1452001291,1452001419,128
1361030659,1452040164,3,200,66.66666667,1361030652447,1361030657439,1452033611,1452038603,4992
1361030662,1452043144,1,77,77,1361030637554,1361030637554,1452018698,1452018698,0
1361030670,1452051148,2,265,132.5,1361030645294,1361030645422,1452026442,1452026570,128
1361030670,1452051192,1,77,77,1361030645440,1361030645440,1452026632,1452026632,0
1361030682,1452063376,2,92,46,1361030656394,1361030656394,1452037770,1452037770,0
1361030682,1452063412,2,92,46,1361030655334,1361030655398,1452036746,1452036810,64
1361030682,1452063412,2,92,46,1361030655334,1361030655398,1452036746,1452036810,64
1361030682,1452063416,2,92,46,1361030656351,1361030656351,1452037767,1452037767,0
1361030686,1452067412,2,474,237,1361030660453,1361030660517,1452041865,1452041929,64
1361030690,1452071360,6,1675,279.1666667,1361030663769,1361030664345,1452045129,1452045705,576
1361030698,1452079436,2,92,46,1361030672140,1361030672204,1452053576,1452053640,64
1361030707,1452088184,4,312,78,1361030703754,1361030703882,1452084938,1452085066,128
1361030707,1452088184,4,312,78,1361030704008,1361030704136,1452085192,1452085320,128
1361030707,1452088188,4,312,78,1361030704964,1361030705092,1452086152,1452086280,128
1361030707,1452088224,4,312,78,1361030703840,1361030703904,1452085064,1452085128,64
1361030707,1452088228,4,312,78,1361030703899,1361030704027,1452085127,1452085255,128
1361030707,1452088228,4,312,78,1361030704031,1361030704095,1452085259,1452085323,64
1361030707,1452088232,3,144,48,1361030702040,1361030702040,1452083272,1452083272,0
1361030710,1452091372,1,77,77,1361030682251,1361030682251,1452063623,1452063623,0
1361030710,1452091420,1,46,46,1361030684827,1361030684827,1452066247,1452066247,0
1361030718,1452099380,1,77,77,1361030690183,1361030690183,1452071563,1452071563,0
1361030723,1452104200,2,92,46,1361030715513,1361030715513,1452096713,1452096713,0
1361030723,1452104212,2,92,46,1361030715499,1361030715499,1452096711,1452096711,0
1361030723,1452104212,2,92,46,1361030715499,1361030715499,1452096711,1452096711,0
1361030726,1452107412,2,474,237,1361030700134,1361030700198,1452081546,1452081610,64
1361030726,1452107416,2,265,132.5,1361030700835,1361030700899,1452082251,1452082315,64
1361030730,1452111452,3,1333,444.3333333,1361030703420,1361030703484,1452084872,1452084936,64
1361030731,1452112212,6,366,61,1361030727340,1361030727404,1452108552,1452108616,64
1361030731,1452112212,2,92,46,1361030727467,1361030727467,1452108679,1452108679,0
1361030731,1452112212,2,92,46,1361030727467,1361030727467,1452108679,1452108679,0
1361030731,1452112248,2,92,46,1361030727432,1361030727432,1452108680,1452108680,0
1361030731,1452112252,108,147886,1369.314815,1361030599238,1361030727366,1451980490,1452108618,128128
1361030734,1452115428,1,46,46,1361030707220,1361030707220,1452088648,1452088648,0
1361030739,1452120276,7,412,58.85714286,1361030735276,1361030735276,1452116552,1452116552,0
1361030742,1452123408,1,46,46,1361030715241,1361030715241,1452096649,1452096649,0
1361030742,1452123408,1,46,46,1361030715241,1361030715241,1452096649,1452096649,0
1361030754,1452135436,1,46,46,1361030727179,1361030727179,1452108615,1452108615,0
1361030754,1452135436,1,46,46,1361030727179,1361030727179,1452108615,1452108615,0
1361030754,1452135472,1,46,46,1361030726186,1361030726186,1452107658,1452107658,0
1361030754,1452135476,1,46,46,1361030727140,1361030727140,1452108616,1452108616,0
1361030754,1452135476,1,46,46,1361030727140,1361030727140,1452108616,1452108616,0
1361030766,1452147460,2,474,237,1361030740403,1361030740467,1452121863,1452121927,64
1361030779,1452160268,3,144,48,1361030777011,1361030777011,1452158279,1452158279,0
1361030782,1452163424,2,265,132.5,1361030756441,1361030756505,1452137865,1452137929,64
1361030787,1452168296,4,205,51.25,1361030779416,1361030779416,1452160712,1452160712,0
1361030802,90496516,2,98,49,1361030794597,1361030799461,90489113,90493977,4864
1361030802,90496516,2,98,49,1361030794532,1361030798436,90489048,90492952,3904
1361030806,1452187440,2,474,237,1361030780038,1361030780102,1452161478,1452161542,64
1361030827,1452208280,171,240518,1406.538012,1361030703720,1361030820328,1452085000,1452201608,116608
1361030838,1452219720,2,265,132.5,1361030811630,1361030811758,1452193350,1452193478,128
1361030843,1452224308,3,144,48,1361030836938,1361030836938,1452218246,1452218246,0
1361030846,1452227780,2,474,237,1361030819700,1361030819764,1452201480,1452201544,64
1361030846,1452227816,1,46,46,1361030818833,1361030818833,1452200649,1452200649,0
1361030886,1452267904,2,474,237,1361030859766,1361030859830,1452241670,1452241734,64
1361030894,1452275900,8,1126,140.75,1361030866681,1361030889977,1452248581,1452271877,23296
1361030902,1452283876,20,9356,467.8,1361030875859,1361030889683,1452257735,1452271559,13824
1361030902,1452283880,69,92535,1341.086957,1361030876750,1361030889870,1452258630,1452271750,13120
1361030906,1452287916,14,6545,467.5,1361030880168,1361030880872,1452262084,1452262788,704
1361030907,1452288328,10,5620,562,1361030884916,1361030900212,1452266244,1452281540,15296
1361030907,1452288336,2,123,61.5,1361030905197,1361030905197,1452286533,1452286533,0
1361030907,1452288372,2,123,61.5,1361030905225,1361030905225,1452286597,1452286597,0
1361030914,1452295876,10,5115,511.5,1361030887697,1361030889041,1452269573,1452270917,1344
1361030915,1452296364,3,144,48,1361030911891,1361030911891,1452293255,1452293255,0
1361030926,1452307880,2,474,237,1361030899983,1361030900047,1452281863,1452281927,64
1361030947,1452328384,2,123,61.5,1361030941119,1361030941119,1452322503,1452322503,0
1361030955,1452336348,3,169,56.33333333,1361030949344,1361030950112,1452330692,1452331460,768
1361030966,1452347916,2,474,237,1361030939562,1361030939626,1452321478,1452321542,64
1361030971,1452351996,2,265,132.5,1361030946048,1361030946176,1452327044,1452327172,128
1361030971,1452352004,1,46,46,1361030946619,1361030946619,1452327623,1452327623,0
1361030974,1452355948,1,46,46,1361030949576,1361030949576,1452331524,1452331524,0
1361030975,1452355988,1,46,46,1361030950536,1361030950536,1452331524,1452331524,0
1361030979,1452360372,3,144,48,1361030971849,1361030971913,1452353221,1452353285,64
1361030991,1452372240,9,2045,227.2222222,1361030964238,1361030971022,1452345478,1452352262,6784
1361030999,1452380212,8,4928,616,1361030971498,1361030971690,1452352710,1452352902,192
1361031007,1452388184,2,474,237,1361030980101,1361030980165,1452361285,1452361349,64
1361031027,1452408232,2,265,132.5,1361031001365,1361031001429,1452382597,1452382661,64
1361031047,1452428292,2,474,237,1361031020185,1361031020249,1452401477,1452401541,64
1361031051,1452432508,3,144,48,1361031046718,1361031046782,1452428226,1452428290,64
1361031059,1452440520,2,123,61.5,1361031052403,1361031052403,1452433923,1452433923,0
1361031064,1452445624,1,46,46,1361031038025,1361031038025,1452419649,1452419649,0
1361031065,1452446532,1,46,46,1361031038054,1361031038054,1452419586,1452419586,0
1361031065,1452446536,1,46,46,1361031038053,1361031038053,1452419589,1452419589,0
1361031065,1452446572,1,46,46,1361031038080,1361031038080,1452419652,1452419652,0
1361031083,1452464276,2,265,132.5,1361031056808,1361031056872,1452438084,1452438148,64
1361031087,1452468292,3,902,300.6666667,1361031060440,1361031060888,1452441732,1452442180,448
1361031107,1452488332,2,583,291.5,1361031079214,1361031079470,1452460546,1452460802,256
1361031107,1452488524,4,336,84,1361031103535,1361031103599,1452485059,1452485123,64
1361031111,1452492304,1,46,46,1361031085452,1361031085452,1452466756,1452466756,0
1361031114,90808652,2,98,49,1361031105311,1361031109087,90799963,90803739,3776
1361031114,90808652,2,98,49,1361031105311,1361031110111,90799963,90804763,4800
1361031123,1452504648,3,144,48,1361031121585,1361031121649,1452503233,1452503297,64
1361031127,1452508368,2,474,237,1361031101834,1361031101898,1452483202,1452483266,64
1361031139,1452520360,2,265,132.5,1361031112595,1361031112659,1452493955,1452494019,64
1361031143,1452524636,1,48,48,1361031115328,1361031115328,1452496964,1452496964,0
1361031167,1452548372,2,474,237,1361031142533,1361031142597,1452523905,1452523969,64
1361031195,1452576304,2,265,132.5,1361031168075,1361031168139,1452549379,1452549443,64
1361031203,1452584808,4,205,51.25,1361031194963,1361031194963,1452576771,1452576771,0
1361031203,1452584808,3,144,48,1361031198800,1361031198864,1452580608,1452580672,64
1361031207,1452588400,2,474,237,1361031182312,1361031182376,1452563712,1452563776,64
1361031247,1452628384,2,474,237,1361031222266,1361031222330,1452603650,1452603714,64
1361031251,1452632356,2,265,132.5,1361031223254,1361031223318,1452604610,1452604674,64
1361031275,1452656824,7,1406,200.8571429,1361031271490,1361031271618,1452653314,1452653442,128
1361031275,1452656860,3,144,48,1361031271387,1361031271387,1452653247,1452653247,0
1361031283,1452664816,7,498,71.14285714,1361031271624,1361031277576,1452653440,1452659392,5952
1361031283,1452664856,8,544,68,1361031271584,1361031277600,1452653440,1452659456,6016
1361031287,1452668388,2,474,237,1361031262453,1361031262517,1452643841,1452643905,64
1361031299,1452680400,11,2234,203.0909091,1361031270953,1361031271337,1452652353,1452652737,384
1361031299,1452680444,7,5111,730.1428571,1361031271869,1361031271997,1452653313,1452653441,128
1361031307,1452688396,2,265,132.5,1361031279085,1361031279213,1452660481,1452660609,128
1361031327,1452708448,2,474,237,1361031302072,1361031302136,1452683520,1452683584,64
1361031339,1452720876,3,144,48,1361031331405,1361031331405,1452713281,1452713281,0
1361031343,1452724560,1,46,46,1361031315654,1361031315654,1452697214,1452697214,0
1361031355,1452736856,2,123,61.5,1361031352095,1361031352095,1452733951,1452733951,0
1361031363,1452744540,2,265,132.5,1361031334940,1361031335004,1452716480,1452716544,64
1361031367,1452748624,2,474,237,1361031342085,1361031342149,1452723709,1452723773,64
1361031391,1452772536,4,205,51.25,1361031386909,1361031386909,1452768445,1452768445,0
1361031407,1452788576,2,474,237,1361031382135,1361031382199,1452763711,1452763775,64
1361031411,1452792572,1,46,46,1361031385787,1361031385787,1452767359,1452767359,0
1361031411,1452792840,3,144,48,1361031408431,1361031408431,1452790271,1452790271,0
1361031415,1452796632,2,265,132.5,1361031390016,1361031390144,1452771648,1452771776,128
1361031426,91120740,2,98,49,1361031414860,1361031418828,91109600,91113568,3968
1361031426,91120744,2,98,49,1361031414856,1361031419848,91109600,91114592,4992
1361031447,1452828672,2,474,237,1361031422421,1361031422485,1452804093,1452804157,64
1361031467,1452848940,3,144,48,1361031466312,1361031466312,1452848252,1452848252,0
1361031471,1452852664,2,265,132.5,1361031445212,1361031445276,1452826876,1452826940,64
1361031487,1452868896,2,474,237,1361031461620,1361031461684,1452843516,1452843580,64
1361031528,1452909028,2,265,132.5,1361031501464,1361031501528,1452882492,1452882556,64
1361031528,1452909032,2,474,237,1361031502421,1361031502485,1452883453,1452883517,64
1361031547,1452928908,3,144,48,1361031541417,1361031541481,1452923325,1452923389,64
1361031568,1452949052,2,474,237,1361031543167,1361031543231,1452924219,1452924283,64
1361031579,1452960916,9,1498,166.4444444,1361031571678,1361031578078,1452953594,1452959994,6400
1361031579,1452960916,8,1452,181.5,1361031571678,1361031572318,1452953594,1452954234,640
1361031579,1452960916,8,1452,181.5,1361031571678,1361031572318,1452953594,1452954234,640
1361031579,1452960916,10,1597,159.7,1361031571678,1361031578078,1452953594,1452959994,6400
1361031579,1452960956,8,1452,181.5,1361031571638,1361031572278,1452953594,1452954234,640
1361031579,1452960956,10,1597,159.7,1361031571959,1361031578295,1452953915,1452960251,6336
1361031584,1452965092,2,265,132.5,1361031556952,1361031557016,1452938044,1452938108,64
1361031584,1452965124,13,3803,292.5384615,1361031559735,1361031572343,1452940859,1452953467,12608
1361031595,1452976936,11,4698,427.0909091,1361031571980,1361031591500,1452953916,1452973436,19520
1361031595,1452976936,11,4490,408.1818182,1361031571980,1361031591500,1452953916,1452973436,19520
1361031595,1452976976,11,4842,440.1818182,1361031571940,1361031591460,1452953916,1452973436,19520
1361031608,1452989172,2,474,237,1361031583686,1361031583814,1452964858,1452964986,128
1361031619,1453000972,3,144,48,1361031616293,1361031616293,1452998265,1452998265,0
1361031640,1453021168,2,265,132.5,1361031611980,1361031612044,1452993148,1452993212,64
1361031648,1453029416,2,474,237,1361031622865,1361031622993,1453004281,1453004409,128
1361031688,1453069660,2,474,237,1361031662813,1361031662877,1453044473,1453044537,64
1361031692,1453072976,4,205,51.25,1361031687691,1361031687691,1453068667,1453068667,0
1361031692,1453073668,2,265,132.5,1361031666904,1361031666968,1453048572,1453048636,64
1361031699,1453080908,3,144,48,1361031691366,1361031691366,1453073274,1453073274,0
1361031728,1453109716,2,474,237,1361031702503,1361031702567,1453084219,1453084283,64
1361031730,91424720,2,98,49,1361031723041,1361031726497,91417761,91421217,3456
1361031730,91424724,2,98,49,1361031723101,1361031727517,91417825,91422241,4416
1361031748,1453129680,2,265,132.5,1361031722185,1361031722313,1453103865,1453103993,128
1361031768,1453149748,2,474,237,1361031743174,1361031743238,1453124922,1453124986,64
1361031772,1453153004,3,144,48,1361031767211,1361031767275,1453148215,1453148279,64
1361031804,1453185880,2,265,132.5,1361031777153,1361031777217,1453159033,1453159097,64
1361031808,1453189940,2,474,237,1361031782980,1361031783044,1453164920,1453164984,64
1361031849,1453229992,2,474,237,1361031824056,1361031824120,1453205048,1453205112,64
1361031852,1453233048,3,144,48,1361031844607,1361031844607,1453225655,1453225655,0
1361031860,1453241940,2,265,132.5,1361031832962,1361031833090,1453214902,1453215030,128
1361031876,1453257052,44,56507,1284.25,1361031869625,1361031869945,1453250677,1453250997,320
1361031884,1453265004,8,1505,188.125,1361031873067,1361031878315,1453254071,1453259319,5248
1361031884,1453265004,12,999,83.25,1361031869481,1361031879529,1453250485,1453260533,10048
1361031884,1453265040,16,6372,398.25,1361031869062,1361031879494,1453250102,1453260534,10432
1361031884,1453265044,12,999,83.25,1361031869762,1361031879490,1453250806,1453260534,9728
1361031889,1453270040,2,474,237,1361031864135,1361031864199,1453245175,1453245239,64
1361031897,1453278052,10,2102,210.2,1361031872252,1361031872636,1453253304,1453253688,384
1361031908,1453289008,3,144,48,1361031902245,1361031902245,1453283253,1453283253,0
1361031913,1453293984,8,815,101.875,1361031886144,1361031886336,1453267128,1453267320,192
1361031913,1453293984,9,861,95.66666667,1361031886398,1361031886590,1453267382,1453267574,192
1361031913,1453293984,9,861,95.66666667,1361031886654,1361031886846,1453267638,1453267830,192
1361031913,1453294028,8,815,101.875,1361031886866,1361031887058,1453267894,1453268086,192
1361031917,1453298060,2,265,132.5,1361031889586,1361031889714,1453270646,1453270774,128
1361031933,1453314036,2,474,237,1361031905164,1361031905228,1453286200,1453286264,64
1361031969,1453350300,2,265,132.5,1361031944512,1361031944640,1453325812,1453325940,128
1361031973,1453354256,2,474,237,1361031945072,1361031945136,1453326328,1453326392,64
1361031980,1453361036,3,144,48,1361031977225,1361031977225,1453358261,1453358261,0
1361031996,1453377112,4,205,51.25,1361031988349,1361031988349,1453369461,1453369461,0
1361032013,1453394420,2,474,237,1361031984970,1361031985034,1453366390,1453366454,64
1361032025,1453406488,2,265,132.5,1361031999685,1361031999813,1453381173,1453381301,128
1361032042,91736852,2,98,49,1361032032927,1361032037535,91727779,91732387,4608
1361032042,91736856,2,98,49,1361032032922,1361032036506,91727778,91731362,3584
1361032044,1453425100,3,144,48,1361032037127,1361032037191,1453418227,1453418291,64
1361032053,1453434484,5,1758,351.6,1361032025161,1361032027081,1453406645,1453408565,1920
1361032065,1453446512,7,1450,207.1428571,1361032039787,1361032040299,1453421299,1453421811,512
1361032081,1453462448,2,265,132.5,1361032055341,1361032055469,1453436789,1453436917,128
1361032093,1453474460,2,474,237,1361032066847,1361032066911,1453448307,1453448371,64
1361032108,1453489132,3,189,63,1361032103593,1361032106601,1453484725,1453487733,3008
1361032116,1453497148,3,189,63,1361032112407,1361032115479,1453493555,1453496627,3072
1361032116,1453497188,3,144,48,1361032112047,1361032112111,1453493235,1453493299,64
1361032124,1453505156,2,126,63,1361032110608,1361032118672,1453491764,1453499828,8064
1361032132,1453513168,2,126,63,1361032119491,1361032127491,1453500659,1453508659,8000
1361032133,1453514756,2,474,237,1361032106488,1361032106552,1453488244,1453488308,64
1361032137,1453518752,2,265,132.5,1361032110779,1361032110907,1453492531,1453492659,128
1361032164,1453545208,8,535,66.875,1361032152474,1361032158170,1453533682,1453539378,5696
1361032164,1453545208,8,535,66.875,1361032152474,1361032158170,1453533682,1453539378,5696
1361032164,1453545208,8,1505,188.125,1361032152409,1361032158105,1453533617,1453539313,5696
1361032173,1453554828,2,474,237,1361032146733,1361032146797,1453528561,1453528625,64
1361032177,1453558808,44,51903,1179.613636,1361032149825,1361032172481,1453531633,1453554289,22656
1361032177,1453558816,7,4450,635.7142857,1361032151801,1361032151929,1453533617,1453533745,128
1361032177,1453558816,7,4088,584,1361032151801,1361032151929,1453533617,1453533745,128
1361032177,1453558820,16,15100,943.75,1361032151480,1361032151928,1453533300,1453533748,448
1361032177,1453558860,7,4311,615.8571429,1361032151757,1361032151885,1453533617,1453533745,128
1361032177,1453558860,6,4058,676.3333333,1361032151757,1361032151885,1453533617,1453533745,128
1361032177,1453558860,22,24790,1126.818182,1361032151437,1361032151821,1453533297,1453533681,384
1361032177,1453558864,6,4170,695,1361032151756,1361032151884,1453533620,1453533748,128
1361032188,1453569156,4,190,47.5,1361032185613,1361032186189,1453566769,1453567345,576
1361032188,1453569156,4,190,47.5,1361032185676,1361032186508,1453566832,1453567664,832
1361032188,1453569156,4,190,47.5,1361032185740,1361032186636,1453566896,1453567792,896
1361032188,1453569168,4,190,47.5,1361032186753,1361032187009,1453567921,1453568177,256
1361032188,1453569168,4,190,47.5,1361032186883,1361032187139,1453568051,1453568307,256
1361032188,1453569168,4,190,47.5,1361032186883,1361032187139,1453568051,1453568307,256
1361032188,1453569168,4,190,47.5,1361032187010,1361032187266,1453568178,1453568434,256
1361032188,1453569168,4,190,47.5,1361032187138,1361032187394,1453568306,1453568562,256
1361032188,1453569168,4,190,47.5,1361032187265,1361032187521,1453568433,1453568689,256
1361032188,1453569192,4,190,47.5,1361032186219,1361032186475,1453567411,1453567667,256
1361032188,1453569192,4,190,47.5,1361032186282,1361032187114,1453567474,1453568306,832
1361032188,1453569192,4,190,47.5,1361032186281,1361032186601,1453567473,1453567793,320
1361032188,1453569192,4,190,47.5,1361032186473,1361032186729,1453567665,1453567921,256
1361032188,1453569196,4,190,47.5,1361032186600,1361032186856,1453567796,1453568052,256
1361032188,1453569200,3,144,48,1361032187040,1361032187040,1453568240,1453568240,0
1361032188,1453569200,4,190,47.5,1361032187363,1361032187619,1453568563,1453568819,256
1361032188,1453569200,4,190,47.5,1361032187491,1361032187747,1453568691,1453568947,256
1361032189,1453570856,1,46,46,1361032164369,1361032164369,1453546225,1453546225,0
1361032193,1453574816,1,46,46,1361032165052,1361032165052,1453546868,1453546868,0
1361032193,1453574860,2,265,132.5,1361032165840,1361032165904,1453547700,1453547764,64
1361032196,1453577180,4,190,47.5,1361032188087,1361032188343,1453569267,1453569523,256
1361032196,1453577180,4,190,47.5,1361032190005,1361032190517,1453571185,1453571697,512
1361032196,1453577184,4,190,47.5,1361032190387,1361032190515,1453571571,1453571699,128
1361032196,1453577184,4,190,47.5,1361032190514,1361032190578,1453571698,1453571762,64
1361032196,1453577184,4,190,47.5,1361032190322,1361032190386,1453571506,1453571570,64
1361032196,1453577184,4,190,47.5,1361032190578,1361032190642,1453571762,1453571826,64
1361032196,1453577184,4,190,47.5,1361032188466,1361032188722,1453569650,1453569906,256
1361032196,1453577184,4,190,47.5,1361032190386,1361032190514,1453571570,1453571698,128
1361032196,1453577184,4,190,47.5,1361032190513,1361032190577,1453571697,1453571761,64
1361032196,1453577188,4,190,47.5,1361032190828,1361032191212,1453572016,1453572400,384
1361032196,1453577188,2,126,63,1361032194352,1361032195376,1453575540,1453576564,1024
1361032196,1453577188,4,190,47.5,1361032191215,1361032191663,1453572403,1453572851,448
1361032196,1453577188,4,190,47.5,1361032189293,1361032189805,1453570481,1453570993,512
1361032196,1453577188,4,190,47.5,1361032191213,1361032191533,1453572401,1453572721,320
1361032196,1453577188,4,190,47.5,1361032187117,1361032189421,1453568305,1453570609,2304
1361032196,1453577192,4,190,47.5,1361032191595,1361032191979,1453572787,1453573171,384
1361032196,1453577192,4,190,47.5,1361032191978,1361032194346,1453573170,1453575538,2368
1361032196,1453577192,4,190,47.5,1361032191914,1361032192298,1453573106,1453573490,384
1361032196,1453577192,4,190,47.5,1361032192169,1361032192489,1453573361,1453573681,320
1361032196,1453577192,4,190,47.5,1361032192297,1361032192617,1453573489,1453573809,320
1361032196,1453577216,4,190,47.5,1361032187922,1361032188178,1453569138,1453569394,256
1361032196,1453577216,4,190,47.5,1361032189777,1361032192209,1453570993,1453573425,2432
1361032196,1453577220,4,190,47.5,1361032188048,1361032190352,1453569268,1453571572,2304
1361032196,1453577220,4,190,47.5,1361032188175,1361032188431,1453569395,1453569651,256
1361032196,1453577220,4,190,47.5,1361032188302,1361032190606,1453569522,1453571826,2304
1361032196,1453577220,4,190,47.5,1361032190285,1361032190349,1453571505,1453571569,64
1361032196,1453577224,4,190,47.5,1361032190538,1361032190602,1453571762,1453571826,64
1361032196,1453577224,4,190,47.5,1361032190538,1361032190666,1453571762,1453571890,128
1361032196,1453577224,4,190,47.5,1361032190601,1361032190729,1453571825,1453571953,128
1361032196,1453577224,4,190,47.5,1361032188809,1361032189257,1453570033,1453570481,448
1361032196,1453577224,4,190,47.5,1361032190856,1361032191176,1453572080,1453572400,320
1361032196,1453577228,4,190,47.5,1361032190792,1361032191176,1453572020,1453572404,384
1361032196,1453577228,4,190,47.5,1361032191174,1361032191494,1453572402,1453572722,320
1361032196,1453577232,4,190,47.5,1361032189508,1361032189956,1453570740,1453571188,448
1361032196,1453577232,4,190,47.5,1361032191555,1361032191939,1453572787,1453573171,384
1361032196,1453577232,4,190,47.5,1361032191491,1361032191875,1453572723,1453573107,384
1361032196,1453577232,4,190,47.5,1361032187650,1361032187906,1453568882,1453569138,256
1361032196,1453577232,4,190,47.5,1361032191937,1361032194305,1453573169,1453575537,2368
1361032196,1453577232,4,190,47.5,1361032187713,1361032188033,1453568945,1453569265,320
1361032196,1453577236,4,190,47.5,1361032192448,1361032192832,1453573684,1453574068,384
1361032204,1453585176,2,126,63,1361032197370,1361032201402,1453578546,1453582578,4032
1361032213,1453594824,5,236,47.2,1361032185139,1361032206963,1453566963,1453588787,21824
1361032213,1453594836,2,474,237,1361032186471,1361032186535,1453568307,1453568371,64
1361032228,1453609200,3,189,63,1361032222562,1361032225634,1453603762,1453606834,3072
1361032233,1453614956,1,63,63,1361032208684,1361032208684,1453590640,1453590640,0
1361032241,1453622868,1,46,46,1361032215557,1361032215557,1453597425,1453597425,0
1361032244,1453625312,2,126,63,1361032229554,1361032237554,1453610866,1453618866,8000
1361032249,1453630944,2,265,132.5,1361032221178,1361032221242,1453603122,1453603186,64
1361032253,1453634876,2,474,237,1361032227324,1361032227388,1453609200,1453609264,64
1361032268,1453649376,3,144,48,1361032261874,1361032261874,1453643250,1453643250,0
1361032276,1453657344,3,169,56.33333333,1361032267986,1361032267986,1453649330,1453649330,0
1361032276,1453657344,4,205,51.25,1361032268050,1361032268050,1453649394,1453649394,0
1361032276,1453657344,3,169,56.33333333,1361032267985,1361032267985,1453649329,1453649329,0
1361032276,1453657344,3,169,56.33333333,1361032267985,1361032267985,1453649329,1453649329,0
1361032276,1453657384,5,251,50.2,1361032268010,1361032273642,1453649394,1453655026,5632
1361032276,1453657384,4,215,53.75,1361032267946,1361032267946,1453649330,1453649330,0
1361032276,1453657384,3,169,56.33333333,1361032267946,1361032267946,1453649330,1453649330,0
1361032292,1453673348,4,205,51.25,1361032288077,1361032288077,1453669425,1453669425,0
1361032294,1453675244,2,474,237,1361032268150,1361032268214,1453649394,1453649458,64
1361032306,1453687216,2,265,132.5,1361032277970,1361032278098,1453659186,1453659314,128
1361032306,1453687220,1,46,46,1361032278859,1361032278859,1453660079,1453660079,0
1361032336,1453717084,2,474,237,1361032308564,1361032308628,1453689648,1453689712,64
1361032340,1453721396,3,144,48,1361032336861,1361032336861,1453718257,1453718257,0
1361032354,92048896,2,98,49,1361032342902,1361032347638,92037798,92042534,4736
1361032354,92048896,2,98,49,1361032342838,1361032346614,92037734,92041510,3776
1361032358,1453739312,2,265,132.5,1361032333423,1361032333551,1453714735,1453714863,128
1361032378,1453759272,2,474,237,1361032347990,1361032348054,1453729262,1453729326,64
1361032412,1453793404,3,144,48,1361032411857,1361032411857,1453793261,1453793261,0
1361032414,1453795312,2,265,132.5,1361032389232,1361032389360,1453770544,1453770672,128
1361032414,1453795380,2,474,237,1361032387882,1361032387946,1453769262,1453769326,64
1361032454,1453835424,2,474,237,1361032428736,1361032428800,1453810160,1453810224,64
1361032468,1453849428,4,312,78,1361032467001,1361032467065,1453848429,1453848493,64
1361032468,1453849464,4,312,78,1361032466967,1361032467031,1453848431,1453848495,64
1361032468,1453849464,4,352,88,1361032467031,1361032467159,1453848495,1453848623,128
1361032470,1453851432,2,265,132.5,1361032444788,1361032444916,1453826220,1453826348,128
1361032476,1453857428,3,144,48,1361032471800,1361032471864,1453853228,1453853292,64
1361032490,1453871428,3,1109,369.6666667,1361032464444,1361032464508,1453845872,1453845936,64
1361032490,1453871428,20,24008,1200.4,1361032464569,1361032464761,1453845997,1453846189,192
1361032494,1453875436,2,474,237,1361032469488,1361032469552,1453850924,1453850988,64
1361032498,1453879448,10,1884,188.4,1361032472679,1361032473063,1453854127,1453854511,384
1361032526,1453907480,2,265,132.5,1361032500039,1361032500103,1453881519,1453881583,64
1361032534,1453915468,2,474,237,1361032509074,1361032509138,1453890542,1453890606,64
1361032546,1453927484,3,1120,373.3333333,1361032520130,1361032520450,1453901614,1453901934,320
1361032548,1453929512,3,144,48,1361032546726,1361032546726,1453928238,1453928238,0
1361032574,1453955484,2,474,237,1361032549311,1361032549375,1453930795,1453930859,64
1361032582,1453963668,2,265,132.5,1361032555591,1361032555719,1453937259,1453937387,128
1361032606,1453987568,1,46,46,1361032579628,1361032579628,1453961196,1453961196,0
1361032606,1453987604,1,46,46,1361032579592,1361032579592,1453961196,1453961196,0
1361032614,1453995528,2,474,237,1361032588821,1361032588885,1453970349,1453970413,64
1361032628,1454009640,3,144,48,1361032621602,1361032621602,1454003242,1454003242,0
1361032636,1454017620,4,205,51.25,1361032635638,1361032635638,1454017258,1454017258,0
1361032638,1454019716,2,265,132.5,1361032611096,1361032611224,1453992812,1453992940,128
1361032654,1454035584,2,96,48,1361032626649,1361032629593,1454008233,1454011177,2944
1361032654,1454035584,2,474,237,1361032628891,1361032628955,1454010475,1454010539,64
1361032658,92352940,2,98,49,1361032652808,1361032655880,92347748,92350820,3072
1361032658,92352944,2,98,49,1361032652872,1361032656904,92347816,92351848,4032
1361032694,1454075604,2,265,132.5,1361032667144,1361032667208,1454048748,1454048812,64
1361032694,1454075604,2,474,237,1361032669447,1361032669511,1454051051,1454051115,64
1361032700,1454081656,3,144,48,1361032696594,1361032696594,1454078250,1454078250,0
1361032734,1454115716,2,474,237,1361032709014,1361032709078,1454090730,1454090794,64
1361032747,1454128676,1,48,48,1361032719422,1361032719422,1454101098,1454101098,0
1361032748,1454129600,1,48,48,1361032719433,1361032719433,1454101033,1454101033,0
1361032748,1454129604,1,48,48,1361032719493,1361032719493,1454101097,1454101097,0
1361032748,1454129676,1,48,48,1361032719486,1361032719486,1454101162,1454101162,0
1361032751,1454131968,2,265,132.5,1361032722947,1361032723075,1454103915,1454104043,128
1361032772,1454153756,3,144,48,1361032771629,1361032771629,1454153385,1454153385,0
1361032774,1454155920,2,474,237,1361032748810,1361032748938,1454130730,1454130858,128
1361032780,1454161712,7,1459,208.4285714,1361032773850,1361032778970,1454155562,1454160682,5120
1361032798,1454179956,11,2185,198.6363636,1361032772583,1361032773095,1454154539,1454155051,512
1361032799,1454180036,6,3834,639,1361032774524,1361032774588,1454155560,1454155624,64
1361032807,1454187996,1,46,46,1361032779495,1361032779495,1454160491,1454160491,0
1361032807,1454188032,2,265,132.5,1361032778944,1361032779008,1454159976,1454160040,64
1361032815,1454195988,2,474,237,1361032790124,1361032790188,1454171112,1454171176,64
1361032852,1454233784,2,123,61.5,1361032846162,1361032846162,1454227946,1454227946,0
1361032852,1454233788,3,144,48,1361032846477,1361032846477,1454228265,1454228265,0
1361032859,1454240100,2,474,237,1361032830907,1361032830971,1454212007,1454212071,64
1361032859,1454240100,2,265,132.5,1361032834875,1361032835003,1454215975,1454216103,128
1361032892,1454273816,4,205,51.25,1361032888815,1361032888815,1454270631,1454270631,0
1361032895,1454276140,2,474,237,1361032870291,1361032870419,1454251431,1454251559,128
1361032915,1454296196,2,265,132.5,1361032890332,1361032890460,1454271528,1454271656,128
1361032915,1454296208,1,46,46,1361032888400,1361032888400,1454269608,1454269608,0
1361032924,1454305792,3,144,48,1361032921478,1361032921478,1454303270,1454303270,0
1361032935,1454316404,2,474,237,1361032910861,1361032910925,1454292265,1454292329,64
1361032970,92665012,2,98,49,1361032962758,1361032966278,92657770,92661290,3520
1361032970,92665016,2,98,49,1361032962754,1361032967298,92657770,92662314,4544
1361032971,1454352492,2,265,132.5,1361032945456,1361032945520,1454326948,1454327012,64
1361032979,1454360380,2,474,237,1361032951075,1361032951139,1454332455,1454332519,64
1361033004,1454385888,3,144,48,1361032996327,1361032996391,1454378215,1454378279,64
1361033019,1454400496,2,474,237,1361032991343,1361032991407,1454372839,1454372903,64
1361033027,1454408476,7,1450,207.1428571,1361033000257,1361033000833,1454381733,1454382309,576
1361033027,1454408480,2,265,132.5,1361033000639,1361033000703,1454382119,1454382183,64
1361033039,1454420436,1,46,46,1361033012713,1361033012713,1454394149,1454394149,0
1361033059,1454440544,2,474,237,1361033030909,1361033031037,1454412453,1454412581,128
1361033076,1454457948,3,144,48,1361033073703,1361033073703,1454455651,1454455651,0
1361033083,1454464536,2,265,132.5,1361033056197,1361033056325,1454437733,1454437861,128
1361033084,1454465952,8,1505,188.125,1361033073955,1361033079075,1454455907,1454461027,5120
1361033093,1454473996,4,312,78,1361033088417,1361033088609,1454469413,1454469605,192
1361033099,1454480560,2,474,237,1361033071470,1361033071534,1454453030,1454453094,64
1361033099,1454480572,6,1827,304.5,1361033073568,1361033074208,1454455140,1454455780,640
1361033101,1454482012,3,144,48,1361033092946,1361033098066,1454473958,1454479078,5120
1361033101,1454482016,2,98,49,1361033093899,1361033099083,1454474915,1454480099,5184
1361033101,1454482020,2,98,49,1361033092746,1361033098058,1454473766,1454479078,5312
1361033101,1454482020,4,312,78,1361033092809,1361033093001,1454473829,1454474021,192
1361033115,1454496552,12,15073,1256.083333,1361033087542,1361033092086,1454469094,1454473638,4544
1361033115,1454496552,5,1525,305,1361033087796,1361033092532,1454469348,1454474084,4736
1361033119,1454500564,4,930,232.5,1361033092200,1361033092520,1454473764,1454474084,320
1361033119,1454500596,10,10450,1045,1361033092294,1361033092998,1454473890,1454474594,704
1361033119,1454500608,41,55599,1356.073171,1361033092156,1361033093244,1454473764,1454474852,1088
1361033119,1454500628,3,300,100,1361033092199,1361033092327,1454473827,1454473955,128
1361033139,1454520644,2,474,237,1361033110998,1361033111062,1454492642,1454492706,64
1361033139,1454520652,2,265,132.5,1361033112080,1361033112208,1454493732,1454493860,128
1361033149,1454530064,3,144,48,1361033147230,1361033147230,1454528294,1454528294,0
1361033175,1454556636,2,474,237,1361033150557,1361033150621,1454532193,1454532257,64
1361033179,1454560672,2,92,46,1361033151548,1361033151612,1454533220,1454533284,64
1361033195,1454576696,2,265,132.5,1361033167843,1361033167971,1454549539,1454549667,128
1361033197,1454578008,4,205,51.25,1361033190098,1361033190098,1454571106,1454571106,0
1361033213,1454594012,2,92,46,1361033208143,1361033208143,1454589155,1454589155,0
1361033213,1454594060,3,144,48,1361033207199,1361033207199,1454588259,1454588259,0
1361033219,1454600660,2,474,237,1361033191368,1361033191432,1454573028,1454573092,64
1361033235,1454616660,1,46,46,1361033207431,1361033207431,1454589091,1454589091,0
1361033235,1454616668,1,46,46,1361033208444,1361033208444,1454590112,1454590112,0
1361033235,1454616704,1,46,46,1361033207386,1361033207386,1454589090,1454589090,0
1361033235,1454616712,1,46,46,1361033208402,1361033208402,1454590114,1454590114,0
1361033251,1454632724,2,265,132.5,1361033223557,1361033223685,1454605281,1454605409,128
1361033255,1454636752,2,474,237,1361033230764,1361033230828,1454612516,1454612580,64
1361033282,92977088,2,98,49,1361033272697,1361033276345,92967785,92971433,3648
1361033282,92977096,2,98,49,1361033272692,1361033277300,92967788,92972396,4608
1361033285,1454666120,3,144,48,1361033282081,1361033282145,1454663201,1454663265,64
1361033295,1454676804,2,474,237,1361033270772,1361033270836,1454652576,1454652640,64
1361033303,1454684776,1,46,46,1361033275089,1361033275089,1454656865,1454656865,0
1361033307,1454688784,2,265,132.5,1361033279435,1361033279563,1454661219,1454661347,128
1361033335,1454716788,2,474,237,1361033310534,1361033310598,1454692322,1454692386,64
1361033349,1454730104,3,144,48,1361033342129,1361033342193,1454723233,1454723297,64
1361033363,1454744808,2,265,132.5,1361033335088,1361033335152,1454716896,1454716960,64
1361033375,1454756876,2,474,237,1361033350445,1361033350509,1454732321,1454732385,64
1361033381,1454762252,7,1459,208.4285714,1361033375258,1361033380442,1454756510,1454761694,5184
1361033389,1454770160,12,5735,477.9166667,1361033381878,1361033382390,1454763038,1454763550,512
1361033389,1454770164,9,4798,533.1111111,1361033382389,1361033387573,1454763553,1454768737,5184
1361033395,93089100,8,544,68,1361033381720,1361033387736,93075820,93081836,6016
1361033395,93089104,8,544,68,1361033381715,1361033387731,93075819,93081835,6016
1361033399,1454780916,7,1006,143.7142857,1361033374786,1361033375298,1454756702,1454757214,512
1361033399,1454780952,29,19388,668.5517241,1361033373664,1361033380960,1454755616,1454762912,7296
1361033407,1454788864,6,2488,414.6666667,1361033381368,1361033381496,1454763232,1454763360,128
1361033409,93103552,6,3102,517,1361033381205,1361033381269,93075757,93075821,64
1361033409,93103556,7,4882,697.4285714,1361033381201,1361033381265,93075757,93075821,64
1361033409,93103556,13,14498,1115.230769,1361033381265,1361033381329,93075821,93075885,64
1361033409,93103580,7,4962,708.8571429,1361033381176,1361033381240,93075756,93075820,64
1361033409,93103580,16,16375,1023.4375,1361033381176,1361033381496,93075756,93076076,320
1361033409,93103580,7,5186,740.8571429,1361033381240,1361033381240,93075820,93075820,0
1361033415,1454796964,2,265,132.5,1361033390356,1361033390420,1454772320,1454772384,64
1361033419,1454800872,2,474,237,1361033391153,1361033391217,1454773025,1454773089,64
1361033421,1454802200,3,144,48,1361033417039,1361033417039,1454798239,1454798239,0
1361033456,1454837260,2,474,237,1361033431381,1361033431445,1454812641,1454812705,64
1361033472,1454853296,2,265,132.5,1361033446640,1361033446704,1454827936,1454828000,64
1361033477,1454858300,12,999,83.25,1361033463146,1361033472746,1454844446,1454854046,9600
1361033477,1454858344,17,6755,397.3529412,1361033462463,1361033472703,1454843807,1454854047,10240
1361033477,1454858344,12,999,83.25,1361033462846,1361033472702,1454844190,1454854046,9856
1361033485,1454866284,3,144,48,1361033476987,1361033476987,1454858271,1454858271,0
1361033493,1454874376,4,205,51.25,1361033491356,1361033491356,1454872732,1454872732,0
1361033496,1454877252,2,474,237,1361033471259,1361033471323,1454852511,1454852575,64
1361033497,93191620,3,169,56.33333333,1361033497233,1361033497233,93191853,93191853,0
1361033499,93193168,3,169,56.33333333,1361033497684,1361033497684,93191852,93191852,0
1361033499,93193172,3,169,56.33333333,1361033497678,1361033497678,93191850,93191850,0
1361033499,93193172,3,169,56.33333333,1361033497678,1361033497678,93191850,93191850,0
1361033499,93193172,3,169,56.33333333,1361033497678,1361033497678,93191850,93191850,0
1361033499,93193172,3,169,56.33333333,1361033497678,1361033497678,93191850,93191850,0
1361033508,1454889240,2,583,291.5,1361033480871,1361033481127,1454862111,1454862367,256
1361033524,1454905272,1,46,46,1361033497541,1361033497541,1454878813,1454878813,0
1361033528,1454909348,2,265,132.5,1361033502202,1361033502266,1454883550,1454883614,64
1361033536,1454917300,2,474,237,1361033511018,1361033511082,1454892318,1454892382,64
1361033557,1454938360,3,144,48,1361033551853,1361033551917,1454933213,1454933277,64
1361033576,1454957408,2,474,237,1361033551228,1361033551292,1454932636,1454932700,64
1361033584,1454965612,2,265,132.5,1361033557298,1361033557362,1454938910,1454938974,64
1361033589,1454970384,4,336,84,1361033582611,1361033582739,1454963995,1454964123,128
1361033595,93289180,2,98,49,1361033585416,1361033589960,93279596,93284140,4544
1361033595,93289180,2,98,49,1361033585416,1361033588936,93279596,93283116,3520
1361033597,1454978440,4,205,51.25,1361033596318,1361033596318,1454977758,1454977758,0
1361033616,1454997592,2,474,237,1361033591236,1361033591364,1454972828,1454972956,128
1361033629,1455010440,3,144,48,1361033626781,1361033626845,1455008221,1455008285,64
1361033640,1455021664,2,265,132.5,1361033612348,1361033612476,1454994012,1454994140,128
1361033656,1455037772,2,474,237,1361033631055,1361033631119,1455012827,1455012891,64
1361033668,1455049772,1,78,78,1361033640528,1361033640528,1455022300,1455022300,0
1361033693,1455074484,10,5061,506.1,1361033672174,1361033687470,1455053658,1455068954,15296
1361033696,1455077784,2,265,132.5,1361033668035,1361033668099,1455049819,1455049883,64
1361033696,1455077832,2,474,237,1361033671252,1361033671316,1455053084,1455053148,64
1361033700,1455081900,10,2128,212.8,1361033674320,1361033674768,1455056220,1455056668,448
1361033709,1455090724,3,144,48,1361033703870,1361033703934,1455085594,1455085658,64
1361033716,1455097852,1,78,78,1361033690303,1361033690303,1455072155,1455072155,0
1361033736,1455117908,2,474,237,1361033710853,1361033710917,1455092761,1455092825,64
1361033736,1455117944,1,78,78,1361033708195,1361033708195,1455090139,1455090139,0
1361033749,1455130252,2,265,132.5,1361033723736,1361033723800,1455104988,1455105052,64
1361033761,1455142192,1,78,78,1361033735060,1361033735060,1455116252,1455116252,0
1361033777,1455158200,2,474,237,1361033751051,1361033751115,1455132251,1455132315,64
1361033781,1455162776,3,144,48,1361033776460,1361033776460,1455158236,1455158236,0
1361033797,1455178824,4,205,51.25,1361033790424,1361033790424,1455172248,1455172248,0
1361033802,1455183436,1,48,48,1361033775134,1361033775134,1455156570,1455156570,0
1361033802,1455183516,1,48,48,1361033775117,1361033775117,1455156633,1455156633,0
1361033803,1455184888,1,48,48,1361033774747,1361033774747,1455156635,1455156635,0
1361033805,1455186292,2,265,132.5,1361033779503,1361033779695,1455160795,1455160987,192
1361033817,1455198320,2,474,237,1361033791825,1361033791889,1455173145,1455173209,64
1361033829,1455210848,5,358,71.6,1361033823106,1361033823362,1455204954,1455205210,256
1361033849,1455230272,4,1692,423,1361033823616,1361033823744,1455204888,1455205016,128
1361033853,1455234796,3,144,48,1361033851446,1361033851446,1455233242,1455233242,0
1361033857,1455238288,2,474,237,1361033832560,1361033832624,1455213848,1455213912,64
1361033861,1455242288,2,265,132.5,1361033835121,1361033835185,1455216409,1455216473,64
1361033897,1455278472,2,474,237,1361033872695,1361033872823,1455254167,1455254295,128
1361033899,93593304,2,98,49,1361033893455,1361033896783,93587759,93591087,3328
1361033899,93593304,3,144,48,1361033893455,1361033897743,93587759,93592047,4288
1361033909,1455290452,2,92,46,1361033883275,1361033883339,1455264727,1455264791,64
1361033917,1455298508,2,265,132.5,1361033890388,1361033890516,1455271896,1455272024,128
1361033933,1455314868,3,144,48,1361033926381,1361033926381,1455308249,1455308249,0
1361033941,1455322512,2,474,237,1361033913358,1361033913422,1455294870,1455294934,64
1361033957,1455338856,8,535,66.875,1361033949944,1361033955128,1455331800,1455336984,5184
1361033957,1455338868,6,2682,447,1361033956012,1361033956140,1455337880,1455338008,128
1361033957,1455338868,12,5349,445.75,1361033955884,1361033956204,1455337752,1455338072,320
1361033957,1455338868,4,891,222.75,1361033948970,1361033949162,1455330838,1455331030,192
1361033957,1455338908,4,313,78.25,1361033956101,1361033956165,1455338009,1455338073,64
1361033957,1455338908,12,5381,448.4166667,1361033956165,1361033956485,1455338073,1455338393,320
1361033963,93657352,8,544,68,1361033956192,1361033962208,93650544,93656560,6016
1361033963,93657352,8,544,68,1361033956192,1361033961184,93650544,93655536,4992
1361033963,93657352,8,544,68,1361033956192,1361033962208,93650544,93656560,6016
1361033963,93657356,8,544,68,1361033956185,1361033962201,93650541,93656557,6016
1361033973,1455354560,2,265,132.5,1361033946464,1361033946528,1455328024,1455328088,64
1361033977,1455358536,7,1006,143.7142857,1361033950200,1361033950776,1455331736,1455332312,576
1361033977,1455358568,7,3542,506,1361033952792,1361033952856,1455334360,1455334424,64
1361033977,1455358572,72,69065,959.2361111,1361033950162,1361033975698,1455331734,1455357270,25536
1361033977,1455358576,17,17768,1045.176471,1361033950543,1361033952975,1455332119,1455334551,2432
1361033977,1455358608,6,3310,551.6666667,1361033952751,1361033952879,1455334359,1455334487,128
1361033981,1455362552,9,6939,771,1361033952807,1361033952935,1455334359,1455334487,128
1361033981,1455362552,9,6672,741.3333333,1361033952807,1361033952999,1455334359,1455334551,192
1361033981,1455362552,6,2867,477.8333333,1361033952807,1361033953063,1455334359,1455334615,256
1361033981,1455362596,9,3999,444.3333333,1361033956153,1361033956409,1455337749,1455338005,256
1361033981,1455362600,2,474,237,1361033953334,1361033953846,1455334934,1455335446,512
1361033982,93676324,7,3878,554,1361033956218,1361033956282,93650542,93650606,64
1361033982,93676352,16,18296,1143.5,1361033956191,1361033956255,93650543,93650607,64
1361033982,93676352,15,15638,1042.533333,1361033956191,1361033956255,93650543,93650607,64
1361033982,93676352,6,2206,367.6666667,1361033956190,1361033956254,93650542,93650606,64
1361033982,93676356,8,1905,238.125,1361033956891,1361033957147,93651247,93651503,256
1361033997,1455378868,4,190,47.5,1361033993962,1361033994858,1455375830,1455376726,896
1361033997,1455378868,5,236,47.2,1361033993962,1361033996458,1455375830,1455378326,2496
1361033997,1455378872,4,190,47.5,1361033994534,1361033994790,1455376406,1455376662,256
1361033997,1455378872,4,190,47.5,1361033994725,1361033995557,1455376597,1455377429,832
1361033997,1455378876,4,190,47.5,1361033994853,1361033995109,1455376729,1455376985,256
1361033997,1455378876,4,190,47.5,1361033995106,1361033995362,1455376982,1455377238,256
1361033997,1455378880,4,190,47.5,1361033995357,1361033995613,1455377237,1455377493,256
1361033997,1455378880,4,190,47.5,1361033995551,1361033995807,1455377431,1455377687,256
1361033997,1455378880,4,190,47.5,1361033995615,1361033995871,1455377495,1455377751,256
1361033997,1455378880,4,190,47.5,1361033995678,1361033995934,1455377558,1455377814,256
1361033997,1455378880,4,190,47.5,1361033995870,1361033996126,1455377750,1455378006,256
1361033997,1455378900,4,190,47.5,1361033996042,1361033996298,1455377942,1455378198,256
1361033997,1455378904,4,190,47.5,1361033996101,1361033996357,1455378005,1455378261,256
1361033997,1455378912,3,144,48,1361033993984,1361033994880,1455375896,1455376792,896
1361033997,1455378912,4,190,47.5,1361033993792,1361033995328,1455375704,1455377240,1536
1361033997,1455378916,4,190,47.5,1361033994748,1361033995068,1455376664,1455376984,320
1361033997,1455378916,4,190,47.5,1361033994554,1361033994810,1455376470,1455376726,256
1361033997,1455378916,4,190,47.5,1361033995065,1361033995321,1455376981,1455377237,256
1361033997,1455378920,4,190,47.5,1361033995256,1361033995512,1455377176,1455377432,256
1361033997,1455378920,4,190,47.5,1361033995383,1361033995639,1455377303,1455377559,256
1361033997,1455378944,4,190,47.5,1361033995744,1361033996000,1455377688,1455377944,256
1361033997,1455378944,4,190,47.5,1361033996254,1361033996510,1455378198,1455378454,256
1361033997,1455378944,4,190,47.5,1361033995870,1361033996126,1455377814,1455378070,256
1361034005,1455386872,4,190,47.5,1361033997221,1361033997669,1455379093,1455379541,448
1361034005,1455386876,4,190,47.5,1361033998050,1361033998178,1455379926,1455380054,128
1361034005,1455386876,4,190,47.5,1361033997986,1361033998050,1455379862,1455379926,64
1361034005,1455386876,2,123,61.5,1361033998113,1361033998113,1455379989,1455379989,0
1361034005,1455386880,4,190,47.5,1361033998432,1361033998560,1455380312,1455380440,128
1361034005,1455386880,4,190,47.5,1361033998751,1361033999135,1455380631,1455381015,384
1361034005,1455386880,4,190,47.5,1361033998687,1361033999007,1455380567,1455380887,320
1361034005,1455386880,4,190,47.5,1361033998815,1361033999199,1455380695,1455381079,384
1361034005,1455386880,4,190,47.5,1361033999070,1361033999454,1455380950,1455381334,384
1361034005,1455386880,4,190,47.5,1361033999133,1361033999517,1455381013,1455381397,384
1361034005,1455386884,2,123,61.5,1361034002589,1361034002589,1455384473,1455384473,0
1361034005,1455386884,4,190,47.5,1361033999452,1361033999836,1455381336,1455381720,384
1361034005,1455386884,4,190,47.5,1361034000218,1361034000602,1455382102,1455382486,384
1361034005,1455386888,2,123,61.5,1361034003736,1361034003736,1455385624,1455385624,0
1361034005,1455386912,4,190,47.5,1361033996670,1361033997118,1455378582,1455379030,448
1361034005,1455386916,4,190,47.5,1361033997562,1361033998010,1455379478,1455379926,448
1361034005,1455386916,4,190,47.5,1361033997626,1361033998138,1455379542,1455380054,512
1361034005,1455386916,3,144,48,1361034001337,1361034001337,1455383253,1455383253,0
1361034005,1455386920,4,190,47.5,1361033998136,1361033998200,1455380056,1455380120,64
1361034005,1455386920,4,190,47.5,1361033998071,1361033998519,1455379991,1455380439,448
1361034005,1455386920,4,190,47.5,1361033998327,1361033998391,1455380247,1455380311,64
1361034005,1455386920,4,190,47.5,1361033998199,1361033998327,1455380119,1455380247,128
1361034005,1455386920,4,190,47.5,1361033998390,1361033998454,1455380310,1455380374,64
1361034005,1455386920,4,190,47.5,1361033998326,1361033998454,1455380246,1455380374,128
1361034005,1455386920,4,190,47.5,1361033998454,1361033998518,1455380374,1455380438,64
1361034005,1455386920,4,190,47.5,1361033998453,1361033998581,1455380373,1455380501,128
1361034005,1455386924,4,190,47.5,1361033998709,1361033999157,1455380633,1455381081,448
1361034005,1455386924,4,190,47.5,1361033999155,1361033999539,1455381079,1455381463,384
1361034005,1455386924,4,190,47.5,1361033999154,1361033999538,1455381078,1455381462,384
1361034005,1455386924,4,190,47.5,1361033999474,1361033999858,1455381398,1455381782,384
1361034005,1455386924,4,190,47.5,1361033999537,1361034001969,1455381461,1455383893,2432
1361034005,1455386928,4,190,47.5,1361033999533,1361034001901,1455381461,1455383829,2368
1361034005,1455386928,4,190,47.5,1361033999856,1361034000176,1455381784,1455382104,320
1361034005,1455386928,4,190,47.5,1361033999792,1361034000112,1455381720,1455382040,320
1361034005,1455386928,4,190,47.5,1361033995119,1361033997487,1455377047,1455379415,2368
1361034005,1455386948,4,190,47.5,1361033996123,1361033998427,1455378071,1455380375,2304
1361034009,1455390544,4,190,47.5,1361033996718,1361033999086,1455378262,1455380630,2368
1361034013,1455394860,3,169,56.33333333,1361034005108,1361034005172,1455386968,1455387032,64
1361034013,1455394908,3,169,56.33333333,1361034005057,1361034005121,1455386965,1455387029,64
1361034021,1455402568,2,474,237,1361033993752,1361033993816,1455375320,1455375384,64
1361034021,1455402880,2,123,61.5,1361034019102,1361034019102,1455400982,1455400982,0
1361034029,1455410588,2,265,132.5,1361034002177,1361034002241,1455383765,1455383829,64
1361034029,1455410944,2,123,61.5,1361034016095,1361034021087,1455398039,1455403031,4992
1361034062,1455443060,2,474,237,1361034034771,1361034034835,1455415831,1455415895,64
1361034062,1455443104,4,312,78,1361034057958,1361034058022,1455439062,1455439126,64
1361034070,1455451116,3,144,48,1361034062105,1361034062169,1455443221,1455443285,64
1361034070,1455451160,4,205,51.25,1361034066288,1361034066288,1455447448,1455447448,0
1361034075,93769336,2,123,61.5,1361034072239,1361034072239,93766575,93766575,0
1361034075,93769336,3,169,56.33333333,1361034072239,1361034072239,93766575,93766575,0
1361034075,93769340,3,169,56.33333333,1361034072234,1361034072234,93766574,93766574,0
1361034075,93769340,3,169,56.33333333,1361034072234,1361034072234,93766574,93766574,0
1361034075,93769340,3,169,56.33333333,1361034072238,1361034072238,93766578,93766578,0
1361034086,1455466972,2,265,132.5,1361034058023,1361034058087,1455438995,1455439059,64
1361034090,1455471016,1,46,46,1361034065405,1361034065405,1455446421,1455446421,0
1361034090,1455471060,1,46,46,1361034065359,1361034065359,1455446419,1455446419,0
1361034090,1455471060,1,46,46,1361034065359,1361034065359,1455446419,1455446419,0
1361034090,1455471060,1,46,46,1361034065359,1361034065359,1455446419,1455446419,0
1361034090,1455471064,1,46,46,1361034065357,1361034065357,1455446421,1455446421,0
1361034094,1455475172,4,205,51.25,1361034091295,1361034091295,1455472467,1455472467,0
1361034102,1455482996,2,474,237,1361034075153,1361034075217,1455456149,1455456213,64
1361034142,1455523008,2,265,132.5,1361034113987,1361034114115,1455494995,1455495123,128
1361034142,1455523020,2,474,237,1361034116153,1361034116217,1455497173,1455497237,64
1361034142,1455523344,3,144,48,1361034136884,1361034136884,1455518228,1455518228,0
1361034182,1455563160,2,474,237,1361034156266,1361034156330,1455537426,1455537490,64
1361034198,1455579060,2,265,132.5,1361034169935,1361034170063,1455550995,1455551123,128
1361034211,93905372,2,98,49,1361034205707,1361034209867,93900079,93904239,4160
1361034211,93905372,2,98,49,1361034205707,1361034208843,93900079,93903215,3136
1361034214,1455595276,3,144,48,1361034211961,1361034211961,1455593237,1455593237,0
1361034222,1455603372,6,2186,364.3333333,1361034196825,1361034201113,1455578197,1455582485,4288
1361034250,1455631504,2,265,132.5,1361034224787,1361034224851,1455606291,1455606355,64
1361034266,1455647544,2,474,237,1361034241514,1361034241642,1455623058,1455623186,128
1361034286,1455667292,5,1236,247.2,1361034277223,1361034278567,1455658515,1455659859,1344
1361034294,1455675332,3,144,48,1361034286910,1361034286910,1455668242,1455668242,0
1361034302,1455683316,3,138,46,1361034298512,1361034299600,1455679828,1455680916,1088
1361034302,1455683356,3,138,46,1361034298471,1361034299559,1455679827,1455680915,1088
1361034302,1455683588,10,2157,215.7,1361034275772,1361034276284,1455657360,1455657872,512
1361034306,1455687600,2,265,132.5,1361034279857,1361034279985,1455661457,1455661585,128
1361034306,1455687628,2,474,237,1361034280982,1361034281046,1455662610,1455662674,64
1361034306,1455687668,6,1329,221.5,1361034279790,1361034282222,1455661458,1455663890,2432
1361034346,1455727720,2,474,237,1361034321016,1361034321080,1455702736,1455702800,64
1361034358,1455739372,2,92,46,1361034341588,1361034353300,1455722960,1455734672,11712
1361034362,1455743656,2,265,132.5,1361034335416,1361034335480,1455717072,1455717136,64
1361034366,1455747364,3,144,48,1361034364255,1361034364319,1455745619,1455745683,64
1361034374,1455755352,3,138,46,1361034371818,1361034372906,1455753170,1455754258,1088
1361034374,1455755380,2,92,46,1361034372876,1361034373388,1455754256,1455754768,512
1361034374,1455755384,4,312,78,1361034373641,1361034373705,1455755025,1455755089,64
1361034374,1455755384,4,312,78,1361034373768,1361034373832,1455755152,1455755216,64
1361034374,1455755388,3,138,46,1361034370694,1361034371718,1455752082,1455753106,1024
1361034382,1455763364,4,312,78,1361034373917,1361034374045,1455755281,1455755409,128
1361034382,1455763408,4,312,78,1361034373938,1361034374066,1455755346,1455755474,128
1361034382,1455763408,4,312,78,1361034374002,1361034374130,1455755410,1455755538,128
1361034382,1455763888,4,312,78,1361034373331,1361034373459,1455755219,1455755347,128
1361034386,1455767900,2,474,237,1361034360835,1361034360899,1455742735,1455742799,64
1361034398,1455779392,4,205,51.25,1361034391617,1361034391617,1455773009,1455773009,0
1361034398,1455779900,1,46,46,1361034373443,1361034373443,1455755343,1455755343,0
1361034398,1455779904,1,46,46,1361034370112,1361034370112,1455752016,1455752016,0
1361034398,1455779940,4,2398,599.5,1361034373019,1361034373275,1455754959,1455755215,256
1361034398,1455779944,23,26704,1161.043478,1361034373146,1361034373466,1455755090,1455755410,320
1361034419,1455799996,2,265,132.5,1361034392142,1361034392206,1455773138,1455773202,64
1361034427,1455808020,2,474,237,1361034401269,1361034401333,1455782289,1455782353,64
1361034438,1455819380,3,144,48,1361034436876,1361034436876,1455818256,1455818256,0
1361034467,1455847964,7,1450,207.1428571,1361034441771,1361034442347,1455822735,1455823311,576
1361034467,1455847964,2,474,237,1361034441834,1361034441898,1455822798,1455822862,64
1361034475,1455856016,2,265,132.5,1361034447734,1361034447798,1455828750,1455828814,64
1361034507,1455888116,2,474,237,1361034481106,1361034481170,1455862222,1455862286,64
1361034515,1455896056,1,46,46,1361034489678,1361034489678,1455870734,1455870734,0
1361034515,1455896056,1,46,46,1361034489678,1361034489678,1455870734,1455870734,0
1361034518,1455899452,3,144,48,1361034511811,1361034511811,1455893263,1455893263,0
1361034518,1455899536,4,336,84,1361034514158,1361034514222,1455895694,1455895758,64
1361034523,94217444,2,98,49,1361034516165,1361034520069,94210609,94214513,3904
1361034523,94217452,2,98,49,1361034516224,1361034521024,94210676,94215476,4800
1361034531,1455912328,2,265,132.5,1361034502974,1361034503102,1455884302,1455884430,128
1361034534,1455915504,11,5602,509.2727273,1361034510734,1361034526030,1455892238,1455907534,15296
1361034547,1455928400,2,474,237,1361034521464,1361034521528,1455902864,1455902928,64
1361034558,1455939608,4,205,51.25,1361034557159,1361034557159,1455938767,1455938767,0
1361034583,1455964388,2,265,132.5,1361034558403,1361034558467,1455939791,1455939855,64
1361034587,1455968352,2,474,237,1361034561446,1361034561510,1455942798,1455942862,64
1361034590,1455971572,8,1505,188.125,1361034577226,1361034582410,1455958798,1455963982,5184
1361034590,1455971592,3,144,48,1361034586676,1361034586676,1455968268,1455968268,0
1361034603,1455984400,11,2282,207.4545455,1361034576500,1361034577012,1455957900,1455958412,512
1361034603,1455984408,8,4336,542,1361034577391,1361034577583,1455958799,1455958991,192
1361034627,1456008476,2,474,237,1361034601575,1361034601639,1455983051,1455983115,64
1361034639,1456020444,2,265,132.5,1361034614408,1361034614472,1455995852,1455995916,64
1361034654,1456035588,4,463,115.75,1361034647034,1361034647162,1456028622,1456028750,128
1361034654,1456035628,4,442,110.5,1361034646930,1361034646994,1456028558,1456028622,64
1361034654,1456035636,4,292,73,1361034646795,1361034646859,1456028431,1456028495,64
1361034654,1456035640,3,144,48,1361034648966,1361034649222,1456030606,1456030862,256
1361034662,1456043596,3,144,48,1361034661679,1361034661679,1456043275,1456043275,0
1361034667,1456048508,2,474,237,1361034640776,1361034640840,1456022284,1456022348,64
1361034670,1456051604,2,123,61.5,1361034664361,1361034664361,1456045965,1456045965,0
1361034694,1456075644,4,205,51.25,1361034692352,1361034692352,1456073996,1456073996,0
1361034699,1456080784,2,265,132.5,1361034669746,1361034669810,1456051530,1456051594,64
1361034707,1456088808,2,474,237,1361034681115,1361034681179,1456062923,1456062987,64
1361034719,1456100820,1,46,46,1361034691152,1361034691152,1456072972,1456072972,0
1361034726,1456107636,3,144,48,1361034721606,1361034721606,1456103242,1456103242,0
1361034747,1456128864,2,474,237,1361034721188,1361034721252,1456103052,1456103116,64
1361034751,1456132928,2,265,132.5,1361034725154,1361034725218,1456107082,1456107146,64
1361034787,1456168952,2,474,237,1361034760714,1361034760778,1456142666,1456142730,64
1361034798,1456179692,3,144,48,1361034796558,1361034796558,1456178250,1456178250,0
1361034808,1456188992,2,265,132.5,1361034781451,1361034781643,1456162443,1456162635,192
1361034828,1456208996,2,474,237,1361034801669,1361034801733,1456182665,1456182729,64
1361034835,94529540,2,98,49,1361034826091,1361034829931,94520631,94524471,3840
1361034835,94529544,3,144,48,1361034826086,1361034830950,94520630,94525494,4864
1361034864,1456245324,2,265,132.5,1361034836541,1361034836669,1456217865,1456217993,128
1361034868,1456249348,2,474,237,1361034841063,1361034841127,1456222411,1456222475,64
1361034878,1456259656,3,144,48,1361034871602,1361034871602,1456253258,1456253258,0
1361034886,1456267680,8,1505,188.125,1361034877723,1361034882843,1456259403,1456264523,5120
1361034904,1456285468,10,2124,212.4,1361034877035,1361034877547,1456258503,1456259015,512
1361034908,1456289480,2,474,237,1361034881571,1361034881699,1456263051,1456263179,128
1361034920,1456301420,2,265,132.5,1361034892251,1361034892315,1456273671,1456273735,64
1361034948,1456329452,2,474,237,1361034921466,1361034921530,1456302918,1456302982,64
1361034948,1456329452,3,1120,373.3333333,1361034921661,1361034922109,1456303113,1456303561,448
1361034950,1456331688,3,144,48,1361034946577,1361034946577,1456328265,1456328265,0
1361034972,1456353532,2,265,132.5,1361034947821,1361034947885,1456329353,1456329417,64
1361034988,1456369512,2,474,237,1361034960961,1361034961089,1456342473,1456342601,128
1361035028,1456409752,2,474,237,1361035001104,1361035001168,1456382856,1456382920,64
1361035028,1456409788,2,265,132.5,1361035003499,1361035003627,1456385287,1456385415,128
1361035030,1456411708,3,144,48,1361035024185,1361035024185,1456405893,1456405893,0
1361035038,1456419712,4,205,51.25,1361035036856,1361035036856,1456418568,1456418568,0
1361035068,1456449768,2,474,237,1361035041216,1361035041280,1456422984,1456423048,64
1361035084,1456465752,2,265,132.5,1361035059151,1361035059279,1456440903,1456441031,128
1361035102,1456483788,3,144,48,1361035096490,1361035096490,1456478278,1456478278,0
1361035108,1456489760,2,474,237,1361035081476,1361035081540,1456463236,1456463300,64
1361035110,1456491816,4,309,77.25,1361035105486,1361035105614,1456487302,1456487430,128
1361035118,1456499820,4,312,78,1361035117514,1361035117578,1456499334,1456499398,64
1361035126,1456507776,4,312,78,1361035118132,1361035118196,1456499908,1456499972,64
1361035126,1456507792,4,309,77.25,1361035119591,1361035119655,1456501383,1456501447,64
1361035126,1456507820,4,312,78,1361035120011,1361035120139,1456501831,1456501959,128
1361035126,1456507820,4,312,78,1361035118154,1361035118218,1456499974,1456500038,64
1361035140,1456521832,2,265,132.5,1361035114239,1361035114303,1456496071,1456496135,64
1361035142,1456523800,4,292,73,1361035135071,1361035135199,1456516871,1456516999,128
1361035143,94837860,59,82024,1390.237288,1361035118121,1361035120169,94812981,94815029,2048
1361035144,1456525824,7,2502,357.4285714,1361035117126,1361035117574,1456498950,1456499398,448
1361035144,1456525892,2,1274,637,1361035117376,1361035117440,1456499268,1456499332,64
1361035147,94841580,2,98,49,1361035136003,1361035140675,94830583,94835255,4672
1361035147,94841580,2,98,49,1361035136003,1361035139651,94830583,94834231,3648
1361035148,1456529804,2,474,237,1361035121752,1361035121752,1456503556,1456503556,0
1361035150,1456531784,4,312,78,1361035148204,1361035148268,1456529988,1456530052,64
1361035150,1456531784,4,312,78,1361035148268,1361035148396,1456530052,1456530180,128
1361035150,1456531824,4,312,78,1361035147781,1361035147909,1456529605,1456529733,128
1361035150,1456531824,4,312,78,1361035147845,1361035147973,1456529669,1456529797,128
1361035150,1456531824,4,312,78,1361035147972,1361035148036,1456529796,1456529860,64
1361035150,1456531824,4,312,78,1361035148036,1361035148164,1456529860,1456529988,128
1361035150,1456531828,4,312,78,1361035148095,1361035148159,1456529923,1456529987,64
1361035158,1456539828,6,622,103.6666667,1361035147906,1361035152130,1456529734,1456533958,4224
1361035174,1456555912,3,144,48,1361035171309,1361035171373,1456553221,1456553285,64
1361035175,94869928,5,898,179.6,1361035147878,1361035148134,94842806,94843062,256
1361035175,94869960,4,646,161.5,1361035147783,1361035147975,94842743,94842935,192
1361035176,1456557888,1,46,46,1361035151236,1361035151236,1456533124,1456533124,0
1361035176,1456557896,19,24886,1309.789474,1361035148155,1361035148219,1456530051,1456530115,64
1361035182,1456563820,2,123,61.5,1361035180169,1361035180169,1456561989,1456561989,0
1361035182,1456563836,4,1184,296,1361035178297,1361035178361,1456560133,1456560197,64
1361035182,1456563836,4,1184,296,1361035178296,1361035178360,1456560132,1456560196,64
1361035188,1456569876,2,474,237,1361035162127,1361035162191,1456544003,1456544067,64
1361035190,1456571836,3,144,48,1361035188026,1361035188218,1456569862,1456570054,192
1361035190,1456571836,149,194478,1305.221477,1361035174329,1361035184569,1456556165,1456566405,10240
1361035190,1456571836,423,576678,1363.304965,1361035184567,1361035186423,1456566403,1456568259,1856
1361035190,1456571892,7,1459,208.4285714,1361035178304,1361035184192,1456560196,1456566084,5888
1361035190,1456571892,7,1459,208.4285714,1361035178304,1361035184192,1456560196,1456566084,5888
1361035190,1456571892,8,1505,188.125,1361035178304,1361035184192,1456560196,1456566084,5888
1361035196,1456577940,2,265,132.5,1361035169298,1361035169426,1456551238,1456551366,128
1361035198,1456579924,608,853466,1403.726974,1361035186400,1361035192864,1456568324,1456574788,6464
1361035204,1456585872,6,4074,679,1361035178325,1361035178453,1456560197,1456560325,128
1361035204,1456585916,11,2218,201.6363636,1361035177190,1361035177638,1456559106,1456559554,448
1361035204,1456585940,7,4647,663.8571429,1361035178257,1361035178385,1456560197,1456560325,128
1361035206,1456587896,829,1193054,1439.148372,1361035192891,1361035202747,1456574787,1456584643,9856
1361035206,1456587932,109,131605,1207.385321,1361035203415,1361035205527,1456585347,1456587459,2112
1361035211,94906092,1,46,46,1361035185028,1361035185028,94880120,94880120,0
1361035214,1456595856,195,261960,1343.384615,1361035208803,1361035210211,1456590659,1456592067,1408
1361035214,1456595868,148,185225,1251.52027,1361035210264,1361035211608,1456592132,1456593476,1344
1361035214,1456595908,385,534256,1387.677922,1361035207089,1361035208689,1456588997,1456590597,1600
1361035214,1456595940,261,357971,1371.536398,1361035205522,1361035206994,1456587462,1456588934,1472
1361035214,1456595940,148,187039,1263.777027,1361035211536,1361035212880,1456593476,1456594820,1344
1361035220,1456601948,2,92,46,1361035194120,1361035194248,1456576068,1456576196,128
1361035222,1456603820,377,527401,1398.941645,1361035214280,1361035215368,1456596100,1456597188,1088
1361035222,1456603828,57,59700,1047.368421,1361035212991,1361035214207,1456594819,1456596035,1216
1361035229,1456610012,2,474,237,1361035202990,1361035202990,1456584002,1456584002,0
1361035238,1456619860,3,144,48,1361035231390,1361035231390,1456613250,1456613250,0
1361035244,94938120,1,46,46,1361035216080,1361035216080,94910200,94910200,0
1361035244,94938148,1,46,46,1361035216052,1361035216052,94910200,94910200,0
1361035253,1456633992,2,265,132.5,1361035225413,1361035225477,1456606405,1456606469,64
1361035269,1456650000,2,474,237,1361035242874,1361035242938,1456623874,1456623938,64
1361035270,1456651912,2,123,61.5,1361035269034,1361035269034,1456650946,1456650946,0
1361035278,1456659880,2,123,61.5,1361035274058,1361035274058,1456655938,1456655938,0
1361035285,1456666076,8,815,101.875,1361035260782,1361035260974,1456641858,1456642050,192
1361035289,1456670024,9,861,95.66666667,1361035261091,1361035261283,1456642115,1456642307,192
1361035289,1456670032,8,815,101.875,1361035261405,1361035261597,1456642437,1456642629,192
1361035289,1456670032,8,815,101.875,1361035261658,1361035261914,1456642690,1456642946,256
1361035294,1456675880,4,205,51.25,1361035293260,1361035293260,1456675140,1456675140,0
1361035309,1456690068,2,265,132.5,1361035281013,1361035281077,1456662081,1456662145,64
1361035309,1456690076,2,474,237,1361035282413,1361035282477,1456663489,1456663553,64
1361035310,1456691880,3,144,48,1361035306379,1361035306379,1456688259,1456688259,0
1361035321,1456702068,1,46,46,1361035293049,1361035293049,1456674117,1456674117,0
1361035321,1456702068,1,46,46,1361035293048,1361035293048,1456674116,1456674116,0
1361035349,1456730064,2,474,237,1361035322363,1361035322427,1456703427,1456703491,64
1361035365,1456746076,2,265,132.5,1361035336943,1361035337071,1456718019,1456718147,128
1361035382,1456763880,3,144,48,1361035381387,1361035381387,1456763267,1456763267,0
1361035389,1456770140,2,474,237,1361035362095,1361035362159,1456743235,1456743299,64
1361035417,1456798132,2,265,132.5,1361035392183,1361035392311,1456773315,1456773443,128
1361035429,1456810132,6,913,152.1666667,1361035402291,1361035402675,1456783423,1456783807,384
1361035429,1456810176,2,474,237,1361035402696,1361035402824,1456783872,1456784000,128
1361035446,1456827936,4,336,84,1361035445394,1361035445458,1456827330,1456827394,64
1361035451,95145628,2,98,49,1361035446998,1361035450582,95141626,95145210,3584
1361035459,95153628,2,98,49,1361035446997,1361035451605,95141625,95146233,4608
1361035462,1456843956,3,144,48,1361035456315,1361035456315,1456838271,1456838271,0
1361035468,95162396,1,46,46,1361035441980,1361035441980,95136376,95136376,0
1361035469,1456850216,2,474,237,1361035442080,1361035442144,1456823296,1456823360,64
1361035473,1456854292,2,265,132.5,1361035447766,1361035447830,1456829058,1456829122,64
1361035486,1456867964,3,189,63,1361035481779,1361035484787,1456863743,1456866751,3008
1361035494,1456875928,3,189,63,1361035489878,1361035492886,1456871806,1456874814,3008
1361035502,1456883932,2,126,63,1361035488854,1361035496854,1456870786,1456878786,8000
1361035505,1456886504,6,1570,261.6666667,1361035478144,1361035478464,1456859648,1456859968,320
1361035509,1456890480,2,474,237,1361035482583,1361035482647,1456864063,1456864127,64
1361035511,1456891976,2,126,63,1361035497873,1361035505937,1456878849,1456886913,8064
1361035518,1456899952,3,189,63,1361035512001,1361035515009,1456893953,1456896961,3008
1361035529,1456910496,2,265,132.5,1361035503239,1361035503303,1456884735,1456884799,64
1361035534,1456915944,2,126,63,1361035519049,1361035527113,1456900993,1456909057,8064
1361035534,1456915952,3,144,48,1361035531328,1361035531328,1456913280,1456913280,0
1361035535,1456916012,2,126,63,1361035533033,1361035534057,1456914045,1456915069,1024
1361035543,1456923988,2,126,63,1361035536132,1361035540164,1456917120,1456921152,4032
1361035549,1456930508,2,474,237,1361035521979,1361035522043,1456903487,1456903551,64
1361035573,1456954672,1,63,63,1361035547479,1361035547479,1456929151,1456929151,0
1361035585,1456966608,2,265,132.5,1361035558360,1361035558488,1456939968,1456940096,128
1361035589,1456970628,2,474,237,1361035561922,1361035561986,1456943550,1456943614,64
1361035599,1456979988,4,205,51.25,1361035594499,1361035594499,1456975487,1456975487,0
1361035615,1456996040,3,144,48,1361035607182,1361035607182,1456988222,1456988222,0
1361035629,1457010736,2,474,237,1361035602008,1361035602072,1456983744,1456983808,64
1361035641,1457022696,2,265,132.5,1361035613501,1361035613629,1456995197,1456995325,128
1361035669,1457050860,2,474,237,1361035642329,1361035642457,1457024189,1457024317,128
1361035673,1457054848,3,144,48,1361035668773,1361035668773,1457050621,1457050621,0
1361035697,1457078888,2,265,132.5,1361035669245,1361035669373,1457051133,1457051261,128
1361035709,1457090920,2,474,237,1361035682334,1361035682398,1457064254,1457064318,64
1361035735,1457116108,3,144,48,1361035727110,1361035727174,1457108218,1457108282,64
1361035750,1457131020,2,474,237,1361035723359,1361035723423,1457104379,1457104443,64
1361035750,1457131100,2,265,132.5,1361035725328,1361035725456,1457106428,1457106556,128
1361035763,95457776,2,98,49,1361035756804,1361035760516,95451580,95455292,3712
1361035763,95457776,2,98,49,1361035756804,1361035761540,95451580,95456316,4736
1361035790,1457171124,2,474,237,1361035763894,1361035763958,1457145018,1457145082,64
1361035791,1457172072,9,1557,173,1361035779947,1361035785067,1457161019,1457166139,5120
1361035791,1457172120,8,1505,188.125,1361035779899,1361035785019,1457161019,1457166139,5120
1361035806,1457187364,11,3534,321.2727273,1361035778761,1361035779209,1457160125,1457160573,448
1361035806,1457187392,2,265,132.5,1361035780204,1361035780332,1457161596,1457161724,128
1361035807,1457188076,3,144,48,1361035802149,1361035802149,1457183225,1457183225,0
1361035807,1457188084,4,190,47.5,1361035803102,1361035803870,1457184186,1457184954,768
1361035807,1457188084,4,190,47.5,1361035803101,1361035803869,1457184185,1457184953,768
1361035807,1457188084,4,190,47.5,1361035803101,1361035803933,1457184185,1457185017,832
1361035807,1457188088,4,190,47.5,1361035803611,1361035803867,1457184699,1457184955,256
1361035807,1457188088,4,190,47.5,1361035803674,1361035804442,1457184762,1457185530,768
1361035807,1457188088,4,190,47.5,1361035803865,1361035804121,1457184953,1457185209,256
1361035807,1457188092,4,190,47.5,1361035804184,1361035806488,1457185276,1457187580,2304
1361035807,1457188092,4,190,47.5,1361035804184,1361035804440,1457185276,1457185532,256
1361035807,1457188092,4,190,47.5,1361035804375,1361035804631,1457185467,1457185723,256
1361035807,1457188092,4,190,47.5,1361035804438,1361035804694,1457185530,1457185786,256
1361035807,1457188092,4,190,47.5,1361035804694,1361035804950,1457185786,1457186042,256
1361035807,1457188120,4,190,47.5,1361035804924,1361035805180,1457186044,1457186300,256
1361035807,1457188132,4,190,47.5,1361035802925,1361035803501,1457184057,1457184633,576
1361035807,1457188132,4,190,47.5,1361035803566,1361035803886,1457184698,1457185018,320
1361035807,1457188136,4,190,47.5,1361035803821,1361035804077,1457184957,1457185213,256
1361035807,1457188136,4,190,47.5,1361035803565,1361035803821,1457184701,1457184957,256
1361035807,1457188136,4,190,47.5,1361035803884,1361035804140,1457185020,1457185276,256
1361035807,1457188136,4,190,47.5,1361035804075,1361035804331,1457185211,1457185467,256
1361035807,1457188136,4,190,47.5,1361035804138,1361035806442,1457185274,1457187578,2304
1361035807,1457188164,4,190,47.5,1361035805137,1361035805393,1457186301,1457186557,256
1361035807,1457188164,4,190,47.5,1361035804624,1361035804880,1457185788,1457186044,256
1361035807,1457188164,4,190,47.5,1361035804880,1361035805136,1457186044,1457186300,256
1361035807,1457188164,4,190,47.5,1361035805391,1361035805647,1457186555,1457186811,256
1361035815,1457196064,4,190,47.5,1361035807605,1361035808053,1457188669,1457189117,448
1361035815,1457196064,4,190,47.5,1361035807987,1361035808115,1457189051,1457189179,128
1361035815,1457196064,4,190,47.5,1361035808179,1361035808243,1457189243,1457189307,64
1361035815,1457196064,4,190,47.5,1361035808370,1361035808434,1457189434,1457189498,64
1361035815,1457196064,4,190,47.5,1361035808370,1361035808434,1457189434,1457189498,64
1361035815,1457196064,4,190,47.5,1361035808242,1361035808370,1457189306,1457189434,128
1361035815,1457196068,4,190,47.5,1361035808557,1361035808941,1457189625,1457190009,384
1361035815,1457196068,4,190,47.5,1361035808561,1361035808945,1457189629,1457190013,384
1361035815,1457196068,4,190,47.5,1361035808880,1361035809200,1457189948,1457190268,320
1361035815,1457196068,4,190,47.5,1361035809327,1361035809647,1457190395,1457190715,320
1361035815,1457196068,4,190,47.5,1361035809327,1361035809711,1457190395,1457190779,384
1361035815,1457196068,4,190,47.5,1361035809262,1361035809646,1457190330,1457190714,384
1361035815,1457196068,4,190,47.5,1361035809262,1361035809646,1457190330,1457190714,384
1361035815,1457196068,4,190,47.5,1361035809645,1361035810029,1457190713,1457191097,384
1361035815,1457196104,4,190,47.5,1361035807052,1361035807564,1457188156,1457188668,512
1361035815,1457196104,4,190,47.5,1361035806476,1361035808780,1457187580,1457189884,2304
1361035815,1457196104,4,190,47.5,1361035806603,1361035807051,1457187707,1457188155,448
1361035815,1457196108,4,190,47.5,1361035807687,1361035808199,1457188795,1457189307,512
1361035815,1457196108,4,190,47.5,1361035807942,1361035808006,1457189050,1457189114,64
1361035815,1457196108,4,190,47.5,1361035808005,1361035808517,1457189113,1457189625,512
1361035815,1457196108,4,190,47.5,1361035808005,1361035808133,1457189113,1457189241,128
1361035815,1457196112,4,190,47.5,1361035808069,1361035808133,1457189181,1457189245,64
1361035815,1457196112,4,190,47.5,1361035808133,1361035808261,1457189245,1457189373,128
1361035815,1457196112,4,190,47.5,1361035808260,1361035808324,1457189372,1457189436,64
1361035815,1457196112,4,190,47.5,1361035808515,1361035808835,1457189627,1457189947,320
1361035815,1457196112,4,190,47.5,1361035808898,1361035809282,1457190010,1457190394,384
1361035815,1457196112,4,190,47.5,1361035808833,1361035809217,1457189945,1457190329,384
1361035815,1457196112,4,190,47.5,1361035808897,1361035809281,1457190009,1457190393,384
1361035815,1457196116,4,190,47.5,1361035809535,1361035811839,1457190651,1457192955,2304
1361035815,1457196116,4,190,47.5,1361035809599,1361035809983,1457190715,1457191099,384
1361035815,1457196116,4,190,47.5,1361035809663,1361035810111,1457190779,1457191227,448
1361035815,1457196136,4,190,47.5,1361035805674,1361035807978,1457186810,1457189114,2304
1361035815,1457196136,4,190,47.5,1361035805162,1361035807530,1457186298,1457188666,2368
1361035830,1457211380,2,474,237,1361035803768,1361035803832,1457185148,1457185212,64
1361035862,1457243532,2,265,132.5,1361035835485,1361035835613,1457217017,1457217145,128
1361035863,1457244140,3,144,48,1361035862118,1361035862118,1457243258,1457243258,0
1361035866,1457247716,1,48,48,1361035841704,1361035841704,1457223420,1457223420,0
1361035866,1457247720,1,48,48,1361035841699,1361035841699,1457223419,1457223419,0
1361035867,1457248084,1,48,48,1361035842336,1361035842336,1457223420,1457223420,0
1361035870,1457251856,2,474,237,1361035843481,1361035843545,1457225337,1457225401,64
1361035910,1457291640,3,1120,373.3333333,1361035882291,1361035882739,1457263931,1457264379,448
1361035910,1457291756,2,474,237,1361035883901,1361035884029,1457265657,1457265785,128
1361035918,1457299636,2,265,132.5,1361035890615,1361035890679,1457272251,1457272315,64
1361035927,1457308160,3,144,48,1361035922066,1361035922130,1457303226,1457303290,64
1361035950,1457331672,2,474,237,1361035924561,1361035924625,1457306233,1457306297,64
1361035974,1457355852,2,265,132.5,1361035946078,1361035946206,1457327930,1457328058,128
1361035990,1457371864,2,474,237,1361035965264,1361035965328,1457347128,1457347192,64
1361035999,1457380292,3,144,48,1361035996940,1361035996940,1457378232,1457378232,0
1361036007,1457388196,4,205,51.25,1361035998957,1361035998957,1457380153,1457380153,0
1361036026,1457407920,2,265,132.5,1361036001817,1361036001881,1457383737,1457383801,64
1361036030,1457411908,2,474,237,1361036005411,1361036005475,1457387319,1457387383,64
1361036071,1457451976,2,474,237,1361036046599,1361036046663,1457427575,1457427639,64
1361036071,1457452272,3,144,48,1361036064990,1361036065054,1457446262,1457446326,64
1361036071,1457452276,7,489,69.85714286,1361036052957,1361036062941,1457434233,1457444217,9984
1361036074,1457455952,42,46272,1101.714286,1361036049720,1361036052536,1457431672,1457434488,2816
1361036075,95769780,2,98,49,1361036068866,1361036073410,95763646,95768190,4544
1361036075,95769784,2,98,49,1361036068861,1361036072381,95763645,95767165,3520
1361036078,1457459904,11,8951,813.7272727,1361036051817,1361036052329,1457433721,1457434233,512
1361036078,1457459904,6,3214,535.6666667,1361036052327,1361036052391,1457434231,1457434295,64
1361036078,1457459904,6,2947,491.1666667,1361036052326,1361036052454,1457434230,1457434358,128
1361036078,1457459948,10,8071,807.1,1361036051771,1361036052347,1457433719,1457434295,576
1361036078,1457459948,7,3606,515.1428571,1361036052282,1361036052346,1457434230,1457434294,64
1361036078,1457459952,7,4578,654,1361036052280,1361036052408,1457434232,1457434360,128
1361036078,1457459952,6,3251,541.8333333,1361036052280,1361036052344,1457434232,1457434296,64
1361036083,1457463972,6,1141,190.1666667,1361036058252,1361036062988,1457439224,1457443960,4736
1361036099,1457479964,1,46,46,1361036074067,1361036074067,1457455031,1457455031,0
1361036106,1457487936,3,3197,1065.666667,1361036079494,1361036079494,1457461430,1457461430,0
1361036107,1457487984,8,2101,262.625,1361036079677,1361036080061,1457460661,1457461045,384
1361036111,1457492020,2,474,237,1361036086300,1361036086364,1457467320,1457467384,64
1361036119,1457500384,4,312,78,1361036112239,1361036112367,1457493623,1457493751,128
1361036119,1457500424,4,312,78,1361036112007,1361036112071,1457493431,1457493495,64
1361036119,1457500424,4,312,78,1361036112071,1361036112135,1457493495,1457493559,64
1361036119,1457500424,4,312,78,1361036112135,1361036112263,1457493559,1457493687,128
1361036135,1457516424,3,144,48,1361036131782,1361036131846,1457513206,1457513270,64
1361036139,1457520212,4,2128,532,1361036111963,1361036112283,1457493175,1457493495,320
1361036139,1457520212,16,15537,971.0625,1361036112154,1361036112410,1457493366,1457493622,256
1361036143,1457524272,2,265,132.5,1361036117725,1361036117853,1457498997,1457499125,128
1361036151,1457532252,2,474,237,1361036126706,1361036126834,1457507958,1457508086,128
1361036175,1457556456,3,169,56.33333333,1361036168806,1361036168806,1457550262,1457550262,0
1361036175,1457556456,3,169,56.33333333,1361036168806,1361036168806,1457550262,1457550262,0
1361036175,1457556456,5,251,50.2,1361036168806,1361036174374,1457550262,1457555830,5568
1361036175,1457556456,3,169,56.33333333,1361036168806,1361036168806,1457550262,1457550262,0
1361036175,1457556456,3,169,56.33333333,1361036168806,1361036168806,1457550262,1457550262,0
1361036175,1457556488,2,123,61.5,1361036168771,1361036168771,1457550259,1457550259,0
1361036191,1457572332,2,474,237,1361036166560,1361036166624,1457547892,1457547956,64
1361036199,1457580348,2,265,132.5,1361036172816,1361036172944,1457554164,1457554292,128
1361036199,1457580468,4,205,51.25,1361036194905,1361036194905,1457576373,1457576373,0
1361036199,1457580476,3,169,56.33333333,1361036195730,1361036195730,1457577206,1457577206,0
1361036207,1457588420,3,144,48,1361036206792,1361036206856,1457588212,1457588276,64
1361036231,1457612436,2,474,237,1361036206583,1361036206647,1457588019,1457588083,64
1361036255,1457636320,1,46,46,1361036227884,1361036227884,1457609204,1457609204,0
1361036255,1457636324,2,265,132.5,1361036228456,1361036228520,1457609780,1457609844,64
1361036255,1457636368,1,46,46,1361036227836,1361036227836,1457609204,1457609204,0
1361036255,1457636488,4,312,78,1361036251461,1361036251525,1457632949,1457633013,64
1361036255,1457636492,4,312,78,1361036248705,1361036248769,1457630197,1457630261,64
1361036255,1457636492,2,98,49,1361036248640,1361036254080,1457630132,1457635572,5440
1361036255,1457636492,4,312,78,1361036252480,1361036252608,1457633972,1457634100,128
1361036255,1457636496,4,312,78,1361036252798,1361036252862,1457634294,1457634358,64
1361036255,1457636536,2,98,49,1361036248598,1361036254038,1457630134,1457635574,5440
1361036255,1457636536,4,312,78,1361036248661,1361036248725,1457630197,1457630261,64
1361036259,95953876,5,491,98.2,1361036252196,1361036252580,95947072,95947456,384
1361036259,95953876,8,7499,937.375,1361036252196,1361036252452,95947072,95947328,256
1361036263,1457644496,4,312,78,1361036259773,1361036259837,1457641269,1457641333,64
1361036267,1457648444,68,71843,1056.514706,1361036242799,1361036248751,1457624243,1457630195,5952
1361036267,95961868,8,7146,893.25,1361036259498,1361036259626,95954366,95954494,128
1361036271,1457652388,2,474,237,1361036245929,1361036245993,1457627317,1457627381,64
1361036275,1457656648,9,8039,893.2222222,1361036247909,1361036248549,1457629557,1457630197,640
1361036275,1457656648,9,7090,787.7777778,1361036248482,1361036253154,1457630130,1457634802,4672
1361036275,1457656716,5,437,87.4,1361036248159,1361036248415,1457629875,1457630131,256
1361036275,1457656720,6,4068,678,1361036248412,1361036248540,1457630132,1457630260,128
1361036279,1457660664,3,733,244.3333333,1361036251221,1361036251285,1457632885,1457632949,64
1361036279,1457660704,10,5631,563.1,1361036251309,1361036259757,1457633013,1457641461,8448
1361036287,1457668536,4,312,78,1361036286356,1361036286484,1457667892,1457668020,128
1361036287,1457668592,3,144,48,1361036283996,1361036283996,1457665588,1457665588,0
1361036291,1457672680,1,46,46,1361036263556,1361036263556,1457645236,1457645236,0
1361036291,95985860,7,5331,761.5714286,1361036286130,1361036286322,95980990,95981182,192
1361036303,1457684532,3,169,56.33333333,1361036293527,1361036302487,1457675059,1457684019,8960
1361036311,1457692708,2,265,132.5,1361036283494,1361036283622,1457665202,1457665330,128
1361036311,1457692788,2,474,237,1361036285909,1361036285973,1457667697,1457667761,64
1361036311,1457692792,2,828,414,1361036286356,1361036286356,1457668148,1457668148,0
1361036319,1457700536,3,200,66.66666667,1361036308243,1361036313235,1457689779,1457694771,4992
1361036319,1457700724,1,77,77,1361036293335,1361036293335,1457675059,1457675059,0
1361036335,1457716756,2,92,46,1361036307960,1361036308024,1457689716,1457689780,64
1361036339,1457720752,2,92,46,1361036311994,1361036311994,1457693746,1457693746,0
1361036351,1457732868,2,474,237,1361036326152,1361036326216,1457708020,1457708084,64
1361036359,1457740584,3,144,48,1361036356641,1361036356641,1457738225,1457738225,0
1361036363,1457744872,1,77,77,1361036338115,1361036338115,1457719987,1457719987,0
1361036367,1457748856,2,265,132.5,1361036339155,1361036339219,1457721011,1457721075,64
1361036371,1457752852,2,92,46,1361036345944,1361036345944,1457727796,1457727796,0
1361036383,1457764596,4,336,84,1361036377301,1361036377365,1457758897,1457758961,64
1361036387,96081872,2,98,49,1361036378216,1361036381800,96073088,96076672,3584
1361036387,96081872,2,98,49,1361036378216,1361036382824,96073088,96077696,4608
1361036387,1457768944,14,3162,225.8571429,1361036362299,1361036379771,1457744243,1457761715,17472
1361036391,1457772588,6,366,61,1361036383327,1361036383391,1457764915,1457764979,64
1361036391,1457772908,1,46,46,1361036362975,1361036362975,1457744883,1457744883,0
1361036391,1457772948,2,474,237,1361036365558,1361036365622,1457747506,1457747570,64
1361036395,1457776888,1,46,46,1361036367027,1361036367027,1457748915,1457748915,0
1361036407,1457788568,6,2682,447,1361036406832,1361036406896,1457788400,1457788464,64
1361036411,96105860,6,1172,195.3333333,1361036406900,1361036407156,96101760,96102016,256
1361036411,96105864,11,8618,783.4545455,1361036406512,1361036406896,96101376,96101760,384
1361036415,1457796580,8,544,68,1361036401637,1361036406885,1457783217,1457788465,5248
1361036419,96113864,5,375,75,1361036406961,1361036412145,96101825,96107009,5184
1361036420,1457800968,2,265,132.5,1361036395529,1361036395657,1457776497,1457776625,128
1361036423,1457804616,3,144,48,1361036416640,1361036416640,1457798256,1457798256,0
1361036424,1457804964,8,4636,579.5,1361036399501,1361036407757,1457780465,1457788721,8256
1361036427,1457808904,6,3214,535.6666667,1361036401251,1361036401443,1457783155,1457783347,192
1361036428,1457808968,10,1240,124,1361036402187,1361036406603,1457783155,1457787571,4416
1361036428,1457808968,8,5636,704.5,1361036402377,1361036407817,1457783345,1457788785,5440
1361036428,1457808976,4,2526,631.5,1361036403139,1361036403331,1457784115,1457784307,192
1361036432,1457813196,2,474,237,1361036406052,1361036406116,1457787248,1457787312,64
1361036471,1457852616,2,123,61.5,1361036461185,1361036466177,1457842801,1457847793,4992
1361036472,1457853252,2,474,237,1361036446828,1361036446892,1457828080,1457828144,64
1361036476,1457857256,2,154,77,1361036450537,1361036450793,1457831793,1457832049,256
1361036476,1457857332,2,265,132.5,1361036451165,1361036451293,1457832497,1457832625,128
1361036488,1457869320,2,92,46,1361036462440,1361036462440,1457843760,1457843760,0
1361036492,1457873268,2,92,46,1361036467485,1361036467485,1457848753,1457848753,0
1361036492,1457873312,2,92,46,1361036466481,1361036466481,1457847793,1457847793,0
1361036495,1457876608,3,144,48,1361036491592,1361036491656,1457873200,1457873264,64
1361036503,1457884628,4,205,51.25,1361036495221,1361036495221,1457876849,1457876849,0
1361036512,1457893368,2,474,237,1361036486137,1361036486201,1457867505,1457867569,64
1361036520,1457901324,1,46,46,1361036494499,1361036494499,1457875823,1457875823,0
1361036520,1457901336,1,77,77,1361036495382,1361036495382,1457876718,1457876718,0
1361036532,1457913312,2,265,132.5,1361036506351,1361036506479,1457887663,1457887791,128
1361036543,1457924648,6,366,61,1361036540063,1361036540063,1457921711,1457921711,0
1361036552,1457933340,2,474,237,1361036526422,1361036526486,1457907762,1457907826,64
1361036559,1457940668,3,144,48,1361036551565,1361036551629,1457933233,1457933297,64
1361036588,1457969736,2,265,132.5,1361036562057,1361036562185,1457943793,1457943921,128
1361036592,1457973652,2,474,237,1361036566491,1361036566555,1457948143,1457948207,64
1361036631,1458012712,3,144,48,1361036626528,1361036626528,1458008240,1458008240,0
1361036632,1458013664,2,474,237,1361036606543,1361036606607,1457988207,1457988271,64
1361036644,1458025648,2,265,132.5,1361036618142,1361036618270,1457999790,1457999918,128
1361036672,1458053792,2,474,237,1361036646734,1361036646798,1458028526,1458028590,64
1361036695,1458076784,8,1505,188.125,1361036684630,1361036689750,1458066414,1458071534,5120
1361036698,96392312,2,98,49,1361036689816,1361036694360,96384128,96388672,4544
1361036700,1458081684,2,265,132.5,1361036673339,1361036673467,1458055023,1458055151,128
1361036699,96393940,2,98,49,1361036689189,1361036692709,96384129,96387649,3520
1361036703,1458084752,3,144,48,1361036701495,1361036701495,1458083247,1458083247,0
1361036708,1458089764,11,2175,197.7272727,1361036683754,1361036684266,1458065518,1458066030,512
1361036711,1458092748,8,2777,347.125,1361036704571,1361036709691,1458086319,1458091439,5120
1361036711,1458092748,2,98,49,1361036703675,1361036709691,1458085423,1458091439,6016
1361036711,1458092756,4,312,78,1361036707122,1361036707250,1458088878,1458089006,128
1361036711,1458092756,4,312,78,1361036707697,1361036707761,1458089453,1458089517,64
1361036711,1458092796,4,312,78,1361036705801,1361036705865,1458087597,1458087661,64
1361036712,1458093724,2,474,237,1361036687315,1361036687379,1458069039,1458069103,64
1361036715,96409944,3,144,48,1361036707039,1361036712607,96401983,96407551,5568
1361036715,96409948,72,97980,1360.833333,1361036707036,1361036712668,96401984,96407616,5632
1361036719,1458100756,4,310,77.5,1361036711089,1361036711217,1458092845,1458092973,128
1361036728,1458109696,10,2837,283.7,1361036703469,1361036703789,1458085165,1458085485,320
1361036728,1458109736,8,5611,701.375,1361036703620,1361036707972,1458085356,1458089708,4352
1361036728,1458109740,6,4068,678,1361036703618,1361036704066,1458085358,1458085806,448
1361036732,1458113656,5,484,96.8,1361036703955,1361036704275,1458085611,1458085931,320
1361036732,1458113684,8,6079,759.875,1361036705849,1361036707961,1458087533,1458089645,2112
1361036732,1458113724,8,5539,692.375,1361036704592,1361036704784,1458086316,1458086508,192
1361036732,1458113732,3,757,252.3333333,1361036705611,1361036705675,1458087343,1458087407,64
1361036736,1458116972,4,309,77.25,1361036732031,1361036732095,1458113003,1458113067,64
1361036743,1458124852,4,292,73,1361036739537,1361036739601,1458121389,1458121453,64
1361036752,1458133728,2,474,237,1361036727181,1361036727245,1458108909,1458108973,64
1361036756,1458137704,2,265,132.5,1361036728486,1361036728614,1458110190,1458110318,128
1361036759,1458140860,3,169,56.33333333,1361036748103,1361036757063,1458129963,1458138923,8960
1361036775,1458156916,2,123,61.5,1361036763857,1361036768465,1458145773,1458150381,4608
1361036776,1458157728,2,154,77,1361036748236,1361036748492,1458129964,1458130220,256
1361036783,1458164864,3,144,48,1361036776388,1361036776388,1458158252,1458158252,0
1361036792,1458173704,2,92,46,1361036764005,1361036764069,1458145709,1458145773,64
1361036792,1458173744,2,474,237,1361036766780,1361036766844,1458148524,1458148588,64
1361036792,1458173792,2,92,46,1361036766989,1361036766989,1458148781,1458148781,0
1361036796,1458177740,2,92,46,1361036766977,1361036767041,1458148717,1458148781,64
1361036808,1458189012,4,205,51.25,1361036800408,1361036800408,1458181420,1458181420,0
1361036808,1458189776,2,265,132.5,1361036783643,1361036783707,1458165419,1458165483,64
1361036820,1458201768,1,77,77,1361036793124,1361036793124,1458174892,1458174892,0
1361036824,1458205860,1,46,46,1361036798537,1361036798537,1458180397,1458180397,0
1361036832,1458213876,2,474,237,1361036806904,1361036806968,1458188780,1458188844,64
1361036840,1458221064,6,366,61,1361036838754,1361036838818,1458219818,1458219882,64
1361036848,1458229864,1,46,46,1361036821569,1361036821569,1458203433,1458203433,0
1361036856,1458237056,3,144,48,1361036852204,1361036852204,1458233260,1458233260,0
1361036864,1458245792,2,265,132.5,1361036838859,1361036838987,1458220651,1458220779,128
1361036868,1458249820,7,1450,207.1428571,1361036842672,1361036843248,1458224492,1458225068,576
1361036872,1458253836,2,474,237,1361036846749,1361036846813,1458228585,1458228649,64
1361036912,1458293904,2,474,237,1361036886491,1361036886555,1458268395,1458268459,64
1361036920,1458301024,3,144,48,1361036914569,1361036914569,1458295593,1458295593,0
1361036920,1458301920,2,265,132.5,1361036893960,1361036894024,1458275880,1458275944,64
1361036952,1458333900,2,814,407,1361036924703,1361036924831,1458306603,1458306731,128
1361036960,1458341164,4,205,51.25,1361036959421,1361036959421,1458340585,1458340585,0
1361036977,1458357968,2,265,132.5,1361036950847,1361036950975,1458331815,1458331943,128
1361036992,1458373028,3,144,48,1361036987205,1361036987205,1458368233,1458368233,0
1361036993,1458374036,2,474,237,1361036966206,1361036966270,1458347242,1458347306,64
1361037003,96698052,2,98,49,1361036999031,1361037002423,96694083,96697475,3392
1361037011,96706048,2,98,49,1361036999035,1361037003451,96694083,96698499,4416
1361037013,1458393976,11,1989,180.8181818,1361036985145,1361036985593,1458366121,1458366569,448
1361037033,1458413988,2,265,132.5,1361037006059,1361037006187,1458387047,1458387175,128
1361037033,1458413992,2,474,237,1361037006505,1361037006569,1458387497,1458387561,64
1361037064,1458445184,3,144,48,1361037062058,1361037062122,1458443242,1458443306,64
1361037072,1458453260,12,999,83.25,1361037059930,1361037069402,1458441190,1458450662,9472
1361037072,1458453264,11,953,86.63636364,1361037060248,1361037069400,1458441512,1458450664,9152
1361037072,1458453264,12,999,83.25,1361037060503,1361037069399,1458441767,1458450663,8896
1361037073,1458454164,2,474,237,1361037046588,1361037046652,1458427752,1458427816,64
1361037089,1458470284,2,265,132.5,1361037061188,1361037061252,1458442472,1458442536,64
1361037104,1458485420,4,205,51.25,1361037100731,1361037100731,1458482151,1458482151,0
1361037113,1458494348,2,474,237,1361037086659,1361037086723,1458468007,1458468071,64
1361037141,1458522376,2,265,132.5,1361037116262,1361037116326,1458497638,1458497702,64
1361037144,1458525612,3,144,48,1361037136634,1361037136634,1458518246,1458518246,0
1361037153,1458534368,2,474,237,1361037126701,1361037126765,1458508069,1458508133,64
1361037193,1458574392,2,474,237,1361037166036,1361037166100,1458547428,1458547492,64
1361037197,1458578412,2,265,132.5,1361037172226,1361037172290,1458553638,1458553702,64
1361037216,1458597668,3,144,48,1361037211586,1361037211586,1458593254,1458593254,0
1361037233,1458614360,2,474,237,1361037205940,1361037206004,1458587300,1458587364,64
1361037253,1458634472,2,265,132.5,1361037227781,1361037227909,1458609253,1458609381,128
1361037265,1458646396,1,439,439,1361037238225,1361037238225,1458619621,1458619621,0
1361037273,1458654456,2,474,237,1361037246677,1361037246741,1458628133,1458628197,64
1361037288,1458669672,3,144,48,1361037286587,1361037286587,1458668259,1458668259,0
1361037296,1458677676,7,1459,208.4285714,1361037285880,1361037291000,1458667556,1458672676,5120
1361037296,1458677716,8,1505,188.125,1361037285839,1361037290959,1458667555,1458672675,5120
1361037296,1458677716,8,1505,188.125,1361037285839,1361037290959,1458667555,1458672675,5120
1361037309,1458690564,2,265,132.5,1361037283432,1361037283496,1458664996,1458665060,64
1361037312,1458693708,4,336,84,1361037308697,1361037308825,1458690405,1458690533,128
1361037312,1458693708,11,5602,509.2727273,1361037288920,1361037304216,1458670628,1458685924,15296
1361037313,1458694532,12,2439,203.25,1361037285128,1361037285640,1458666660,1458667172,512
1361037313,1458694564,6,4218,703,1361037285993,1361037286057,1458667557,1458667621,64
1361037313,1458694572,2,474,237,1361037287134,1361037287198,1458668706,1458668770,64
1361037314,97008936,2,98,49,1361037310125,1361037314093,97005061,97009029,3968
1361037316,97010120,3,144,48,1361037310939,1361037315931,97005059,97010051,4992
1361037349,1458730524,3,1120,373.3333333,1361037323407,1361037323855,1458704931,1458705379,448
1361037352,1458733740,3,144,48,1361037346489,1361037346553,1458728229,1458728293,64
1361037353,1458734632,2,474,237,1361037327138,1361037327202,1458708770,1458708834,64
1361037365,1458746516,2,265,132.5,1361037339544,1361037339608,1458721060,1458721124,64
1361037392,1458773764,2,123,61.5,1361037390173,1361037390173,1458771937,1458771937,0
1361037393,1458774576,2,474,237,1361037367513,1361037367577,1458749089,1458749153,64
1361037421,1458802632,2,265,132.5,1361037394532,1361037394660,1458776164,1458776292,128
1361037424,1458805808,3,144,48,1361037421427,1361037421427,1458803235,1458803235,0
1361037425,1458806556,1,46,46,1361037400174,1361037400174,1458781730,1458781730,0
1361037433,1458814748,2,474,237,1361037407343,1361037407407,1458789091,1458789155,64
1361037440,1458821816,4,205,51.25,1361037438889,1361037438889,1458820705,1458820705,0
1361037473,1458854620,2,474,237,1361037448430,1361037448494,1458830050,1458830114,64
1361037477,1458858644,2,265,132.5,1361037449684,1361037449748,1458831328,1458831392,64
1361037488,1458869900,3,144,48,1361037481364,1361037481364,1458863264,1458863264,0
1361037513,1458894752,2,474,237,1361037488423,1361037488487,1458870175,1458870239,64
1361037529,1458910768,2,265,132.5,1361037504728,1361037504856,1458886496,1458886624,128
1361037536,1458917908,4,312,78,1361037534860,1361037534988,1458916768,1458916896,128
1361037536,1458917948,4,312,78,1361037534821,1361037534949,1458916769,1458916897,128
1361037544,1458925900,2,98,49,1361037532499,1361037538067,1458914399,1458919967,5568
1361037544,1458925944,2,98,49,1361037532456,1361037538024,1458914400,1458919968,5568
1361037548,97242128,3,142,47.33333333,1361037535702,1361037541014,97229830,97235142,5312
1361037552,1458933888,4,891,222.75,1361037549090,1361037549154,1458930978,1458931042,64
1361037552,1458933928,4,478,119.5,1361037543930,1361037543994,1458925858,1458925922,64
1361037553,1458934732,2,474,237,1361037528829,1361037528893,1458910561,1458910625,64
1361037556,97250120,8,7576,947,1361037535709,1361037551005,97229829,97245125,15296
1361037557,1458938772,7,5493,784.7142857,1361037532182,1361037532310,1458913954,1458914082,128
1361037557,1458938812,7,2507,358.1428571,1361037531499,1361037531691,1458913311,1458913503,192
1361037557,1458938820,4,2612,653,1361037532517,1361037532965,1458914337,1458914785,448
1361037557,1458938820,5,3798,759.6,1361037532517,1361037534821,1458914337,1458916641,2304
1361037557,1458938820,7,4110,587.1428571,1361037532517,1361037534693,1458914337,1458916513,2176
1361037560,1458941944,3,144,48,1361037556266,1361037556330,1458938210,1458938274,64
1361037561,1458942744,5,3188,637.6,1361037534641,1361037534833,1458916385,1458916577,192
1361037561,1458942812,3,729,243,1361037534380,1361037534444,1458916192,1458916256,64
1361037585,1458966836,2,265,132.5,1361037559826,1361037559954,1458941662,1458941790,128
1361037593,1458974024,4,215,53.75,1361037576512,1361037585472,1458957536,1458966496,8960
1361037594,1458975004,2,474,237,1361037569427,1361037569555,1458950431,1458950559,128
1361037601,1458982004,3,200,66.66666667,1361037592533,1361037597525,1458973537,1458978529,4992
1361037614,1458995008,6,3802,633.6666667,1361037587345,1361037587409,1458968353,1458968417,64
1361037614,1458995048,13,4315,331.9230769,1361037586152,1361037586856,1458967200,1458967904,704
1361037614,1458995084,1,60,60,1361037588356,1361037588356,1458969440,1458969440,0
1361037617,1458997980,4,190,47.5,1361037616365,1361037616621,1458997345,1458997601,256
1361037617,1458997980,4,190,47.5,1361037616365,1361037616621,1458997345,1458997601,256
1361037617,1458998020,4,190,47.5,1361037616580,1361037616900,1458997600,1458997920,320
1361037617,1458998020,4,190,47.5,1361037616324,1361037616580,1458997344,1458997600,256
1361037618,1458999088,2,92,46,1361037593343,1361037593407,1458974431,1458974495,64
1361037618,1458999104,1,60,60,1361037591919,1361037591919,1458973023,1458973023,0
1361037622,1459003004,2,92,46,1361037594451,1361037594515,1458975455,1458975519,64
1361037622,1459003012,2,92,46,1361037595467,1361037595531,1458976479,1458976543,64
1361037622,1459003084,2,92,46,1361037595460,1361037595524,1458976544,1458976608,64
1361037622,1459003096,1,60,60,1361037597238,1361037597238,1458978334,1458978334,0
1361037625,1459005984,4,190,47.5,1361037616936,1361037617192,1458997920,1458998176,256
1361037625,1459005984,4,190,47.5,1361037618216,1361037618472,1458999200,1458999456,256
1361037625,1459005984,4,190,47.5,1361037617190,1361037617446,1458998174,1458998430,256
1361037625,1459005988,4,190,47.5,1361037617189,1361037617509,1458998177,1458998497,320
1361037625,1459005988,4,190,47.5,1361037618788,1361037619300,1458999776,1459000288,512
1361037625,1459005988,4,190,47.5,1361037618852,1361037619364,1458999840,1459000352,512
1361037625,1459005988,4,190,47.5,1361037619043,1361037619555,1459000031,1459000543,512
1361037625,1459005992,4,190,47.5,1361037617505,1361037617761,1458998497,1458998753,256
1361037625,1459005992,4,190,47.5,1361037619297,1361037619809,1459000289,1459000801,512
1361037625,1459005992,4,190,47.5,1361037619361,1361037619425,1459000353,1459000417,64
1361037625,1459005992,4,190,47.5,1361037619361,1361037619809,1459000353,1459000801,448
1361037625,1459005992,4,190,47.5,1361037619615,1361037619679,1459000607,1459000671,64
1361037625,1459005992,4,190,47.5,1361037619678,1361037619806,1459000670,1459000798,128
1361037625,1459005992,4,190,47.5,1361037619678,1361037619806,1459000670,1459000798,128
1361037625,1459005992,4,190,47.5,1361037619614,1361037619742,1459000606,1459000734,128
1361037625,1459005992,4,190,47.5,1361037617758,1361037620062,1458998750,1459001054,2304
1361037625,1459005996,4,190,47.5,1361037619932,1361037620316,1459000928,1459001312,384
1361037625,1459005996,4,190,47.5,1361037619996,1361037620316,1459000992,1459001312,320
1361037625,1459005996,4,190,47.5,1361037619931,1361037620315,1459000927,1459001311,384
1361037625,1459006000,4,190,47.5,1361037620505,1361037620825,1459001505,1459001825,320
1361037625,1459006000,4,190,47.5,1361037620632,1361037621016,1459001632,1459002016,384
1361037625,1459006000,4,190,47.5,1361037620759,1361037623127,1459001759,1459004127,2368
1361037625,1459006004,4,190,47.5,1361037621010,1361037621394,1459002014,1459002398,384
1361037625,1459006024,4,190,47.5,1361037621377,1361037621761,1459002401,1459002785,384
1361037625,1459006028,4,190,47.5,1361037616570,1361037618938,1458997598,1458999966,2368
1361037625,1459006028,4,190,47.5,1361037617917,1361037618173,1458998945,1458999201,256
1361037625,1459006028,4,190,47.5,1361037616893,1361037617149,1458997921,1458998177,256
1361037625,1459006028,4,190,47.5,1361037618427,1361037618747,1458999455,1458999775,320
1361037625,1459006028,3,144,48,1361037617210,1361037617210,1458998238,1458998238,0
1361037625,1459006032,4,190,47.5,1361037617400,1361037617656,1458998432,1458998688,256
1361037625,1459006032,4,190,47.5,1361037619383,1361037619447,1459000415,1459000479,64
1361037625,1459006032,4,190,47.5,1361037619446,1361037619574,1459000478,1459000606,128
1361037625,1459006032,4,190,47.5,1361037619574,1361037619638,1459000606,1459000670,64
1361037625,1459006032,4,190,47.5,1361037617654,1361037617910,1458998686,1458998942,256
1361037625,1459006036,4,190,47.5,1361037619700,1361037619764,1459000736,1459000800,64
1361037625,1459006036,4,190,47.5,1361037619764,1361037619828,1459000800,1459000864,64
1361037625,1459006036,4,190,47.5,1361037620082,1361037620466,1459001118,1459001502,384
1361037625,1459006036,4,190,47.5,1361037620274,1361037620594,1459001310,1459001630,320
1361037625,1459006068,4,190,47.5,1361037620244,1361037620628,1459001312,1459001696,384
1361037625,1459006068,4,190,47.5,1361037620308,1361037620692,1459001376,1459001760,384
1361037625,1459006068,4,190,47.5,1361037620690,1361037621074,1459001758,1459002142,384
1361037625,1459006072,4,190,47.5,1361037620753,1361037623121,1459001825,1459004193,2368
1361037625,1459006072,4,190,47.5,1361037621071,1361037621455,1459002143,1459002527,384
1361037625,1459006076,4,190,47.5,1361037616266,1361037618634,1458997342,1458999710,2368
1361037626,1459007000,4,190,47.5,1361037616598,1361037616918,1458997598,1458997918,320
1361037628,97322196,2,98,49,1361037620885,1361037624853,97315081,97319049,3968
1361037628,97322204,2,98,49,1361037620876,1361037625868,97315080,97320072,4992
1361037633,1459014048,4,312,78,1361037632169,1361037632233,1459013217,1459013281,64
1361037638,1459019084,6,2186,364.3333333,1361037610178,1361037614338,1458991262,1458995422,4160
1361037638,1459019120,1,60,60,1361037611935,1361037611935,1458993055,1458993055,0
1361037641,1459021984,2,98,49,1361037629160,1361037634984,1459010144,1459015968,5824
1361037641,1459022008,286,421400,1473.426573,1361037632143,1361037638799,1459013151,1459019807,6656
1361037641,1459022024,2,98,49,1361037629120,1361037634944,1459010144,1459015968,5824
1361037641,1459022072,3,144,48,1361037632081,1361037637905,1459013153,1459018977,5824
1361037642,1459023052,1,52,52,1361037617121,1361037617121,1458998173,1458998173,0
1361037642,1459023052,1,52,52,1361037617378,1361037617378,1458998430,1458998430,0
1361037642,1459023064,1,52,52,1361037615192,1361037615192,1458996256,1458996256,0
1361037642,1459023096,2,265,132.5,1361037616633,1361037616697,1458997729,1458997793,64
1361037642,1459023100,1,52,52,1361037617073,1361037617073,1458998173,1458998173,0
1361037642,1459023100,1,52,52,1361037617076,1361037617076,1458998176,1458998176,0
1361037642,1459023132,1,52,52,1361037615061,1361037615061,1458996193,1458996193,0
1361037646,1459027028,1,52,52,1361037618235,1361037618235,1458999263,1458999263,0
1361037646,1459027116,1,48,48,1361037621157,1361037621157,1459002273,1459002273,0
1361037654,1459035116,1,46,46,1361037628835,1361037628835,1459009951,1459009951,0
1361037654,1459035116,8,5338,667.25,1361037628835,1361037632035,1459009951,1459013151,3200
1361037654,1459035116,8,765,95.625,1361037628707,1361037628963,1459009823,1459010079,256
1361037654,1459035116,9,6744,749.3333333,1361037628834,1361037634018,1459009950,1459015134,5184
1361037654,1459035168,8,5702,712.75,1361037628783,1361037628975,1459009951,1459010143,192
1361037654,1459035168,5,484,96.8,1361037629102,1361037629358,1459010270,1459010526,256
1361037657,1459038020,4,309,77.25,1361037655427,1361037655555,1459036447,1459036575,128
1361037658,1459039176,1,645,645,1361037631719,1361037631719,1459012895,1459012895,0
1361037658,1459039180,8,5001,625.125,1361037631777,1361037633953,1459012957,1459015133,2176
1361037673,1459053992,4,292,73,1361037665438,1361037665502,1459046430,1459046494,64
1361037674,1459055064,4,312,78,1361037672727,1361037672791,1459053791,1459053855,64
1361037682,1459063208,2,474,237,1361037654855,1361037654983,1459036063,1459036191,128
1361037689,1459069984,3,200,66.66666667,1361037674277,1361037683301,1459055261,1459064285,9024
1361037697,1459078024,3,144,48,1361037692223,1361037692223,1459073247,1459073247,0
1361037697,1459078136,3,200,66.66666667,1361037688400,1361037693392,1459069536,1459074528,4992
1361037698,1459079184,2,265,132.5,1361037672544,1361037672608,1459053728,1459053792,64
1361037698,1459079188,2,154,77,1361037673114,1361037673370,1459054302,1459054558,256
1361037705,1459086000,3,169,56.33333333,1361037702998,1361037702998,1459083998,1459083998,0
1361037705,1459086076,4,205,51.25,1361037701961,1361037701961,1459083037,1459083037,0
1361037718,1459099196,2,92,46,1361037693266,1361037693266,1459074462,1459074462,0
1361037718,1459099208,2,92,46,1361037691270,1361037691270,1459072478,1459072478,0
1361037718,1459099240,2,92,46,1361037693285,1361037693349,1459074525,1459074589,64
1361037722,1459103172,2,474,237,1361037694315,1361037694379,1459075487,1459075551,64
1361037726,1459107176,1,46,46,1361037700838,1361037700838,1459082014,1459082014,0
1361037746,1459127492,1,77,77,1361037717736,1361037717736,1459099228,1459099228,0
1361037753,1459134020,3,144,48,1361037752192,1361037752256,1459133212,1459133276,64
1361037754,1459135528,2,265,132.5,1361037727558,1361037727686,1459109086,1459109214,128
1361037762,1459143436,2,474,237,1361037733921,1361037733985,1459115357,1459115421,64
1361037769,1459150052,6,366,61,1361037763105,1361037763169,1459144157,1459144221,64
1361037774,1459155472,1,46,46,1361037746557,1361037746557,1459128029,1459128029,0
1361037802,1459183492,2,474,237,1361037774247,1361037774311,1459155739,1459155803,64
1361037810,1459191520,2,265,132.5,1361037783179,1361037783307,1459164699,1459164827,128
1361037830,1459211532,7,1450,207.1428571,1361037803712,1361037804288,1459185244,1459185820,576
1361037833,1459214036,3,144,48,1361037827184,1361037827248,1459208220,1459208284,64
1361037841,1459222056,9,3230,358.8888889,1361037835549,1361037840733,1459216605,1459221789,5184
1361037841,1459222100,2,98,49,1361037835570,1361037840690,1459216670,1459221790,5120
1361037842,1459223600,2,474,237,1361037814524,1361037814652,1459196124,1459196252,128
1361037849,1459230044,4,352,88,1361037842535,1361037842599,1459223579,1459223643,64
1361037849,1459230044,2,98,49,1361037842599,1361037847783,1459223643,1459228827,5184
1361037849,1459230048,34,42544,1251.294118,1361037842594,1361037847906,1459223642,1459228954,5312
1361037849,1459230048,2,98,49,1361037842594,1361037847778,1459223642,1459228826,5184
1361037849,1459230048,2,98,49,1361037842594,1361037847778,1459223642,1459228826,5184
1361037849,1459230048,3,613,204.3333333,1361037842662,1361037842726,1459223710,1459223774,64
1361037849,1459230048,4,312,78,1361037842789,1361037842853,1459223837,1459223901,64
1361037849,1459230048,4,312,78,1361037842661,1361037842789,1459223709,1459223837,128
1361037849,1459230048,4,313,78.25,1361037842916,1361037842980,1459223964,1459224028,64
1361037849,1459230056,2,279,139.5,1361037842011,1361037847771,1459223067,1459228827,5760
1361037849,1459230056,6,1757,292.8333333,1361037842202,1361037847898,1459223258,1459228954,5696
1361037849,1459230056,2,98,49,1361037842202,1361037847770,1459223258,1459228826,5568
1361037849,1459230056,2,98,49,1361037842202,1361037847770,1459223258,1459228826,5568
1361037849,1459230060,4,312,78,1361037842266,1361037842330,1459223326,1459223390,64
1361037849,1459230060,4,312,78,1361037842329,1361037842393,1459223389,1459223453,64
1361037849,1459230060,12,10483,873.5833333,1361037842200,1361037847896,1459223260,1459228956,5696
1361037849,1459230060,4,312,78,1361037842263,1361037842327,1459223323,1459223387,64
1361037849,1459230064,4,312,78,1361037842390,1361037842454,1459223454,1459223518,64
1361037849,1459230084,2,98,49,1361037842431,1361037847743,1459223515,1459228827,5312
1361037849,1459230084,4,313,78.25,1361037842430,1361037842494,1459223514,1459223578,64
1361037849,1459230088,2,98,49,1361037842557,1361037847741,1459223645,1459228829,5184
1361037849,1459230088,2,98,49,1361037842557,1361037847741,1459223645,1459228829,5184
1361037849,1459230088,2,98,49,1361037842557,1361037847741,1459223645,1459228829,5184
1361037849,1459230088,30,37932,1264.4,1361037842557,1361037847869,1459223645,1459228957,5312
1361037849,1459230088,3,140,46.66666667,1361037842621,1361037847741,1459223709,1459228829,5120
1361037849,1459230088,4,312,78,1361037842747,1361037842875,1459223835,1459223963,128
1361037849,1459230088,2,279,139.5,1361037842811,1361037848763,1459223899,1459229851,5952
1361037849,1459230088,4,313,78.25,1361037842810,1361037842938,1459223898,1459224026,128
1361037849,1459230096,4,313,78.25,1361037842035,1361037842099,1459223131,1459223195,64
1361037849,1459230096,6,3020,503.3333333,1361037842163,1361037847859,1459223259,1459228955,5696
1361037849,1459230096,2,98,49,1361037842163,1361037847731,1459223259,1459228827,5568
1361037849,1459230100,3,679,226.3333333,1361037842286,1361037842350,1459223386,1459223450,64
1361037849,1459230124,3,140,46.66666667,1361037842199,1361037847703,1459223323,1459228827,5504
1361037860,97554244,8,544,68,1361037852838,1361037858854,97547082,97553098,6016
1361037862,1459243640,9,5697,633,1361037834835,1361037842067,1459216475,1459223707,7232
1361037862,1459243688,8,767,95.875,1361037834661,1361037834981,1459216349,1459216669,320
1361037862,1459243688,6,4068,678,1361037834789,1361037835173,1459216477,1459216861,384
1361037862,1459243688,8,5702,712.75,1361037834916,1361037835172,1459216604,1459216860,256
1361037862,1459243712,5,484,96.8,1361037835083,1361037835339,1459216795,1459217051,256
1361037865,1459246056,6,1727,287.8333333,1361037842779,1361037857947,1459223835,1459239003,15168
1361037865,1459246064,13,13759,1058.384615,1361037842003,1361037857491,1459223067,1459238555,15488
1361037866,1459247648,3,833,277.6666667,1361037841868,1361037841996,1459223516,1459223644,128
1361037866,1459247656,2,265,132.5,1361037838595,1361037838723,1459220251,1459220379,128
1361037866,1459247688,6,786,131,1361037841635,1361037841827,1459223323,1459223515,192
1361037866,1459247728,3,777,259,1361037841083,1361037841083,1459222811,1459222811,0
1361037866,1459247732,8,5265,658.125,1361037841145,1361037841849,1459222877,1459223581,704
1361037866,1459247756,13,12793,984.0769231,1361037841695,1361037842207,1459223451,1459223963,512
1361037870,1459251692,4,914,228.5,1361037842143,1361037842335,1459223835,1459224027,192
1361037878,1459259644,7,4418,631.1428571,1361037852303,1361037852431,1459233947,1459234075,128
1361037878,1459259644,7,4434,633.4285714,1361037852303,1361037852431,1459233947,1459234075,128
1361037878,1459259676,36,44318,1231.055556,1361037850031,1361037852527,1459231707,1459234203,2496
1361037878,1459259712,9,4425,491.6666667,1361037852237,1361037852365,1459233949,1459234077,128
1361037878,1459259712,6,4042,673.6666667,1361037852237,1361037852365,1459233949,1459234077,128
1361037878,1459259712,7,4546,649.4285714,1361037852237,1361037852365,1459233949,1459234077,128
1361037878,1459259712,7,4354,622,1361037852236,1361037852364,1459233948,1459234076,128
1361037879,97573900,10,8373,837.3,1361037851667,1361037852243,97546567,97547143,576
1361037882,1459263724,2,474,237,1361037855361,1361037855425,1459237085,1459237149,64
1361037897,1459278100,3,200,66.66666667,1361037879983,1361037888943,1459261083,1459270043,8960
1361037905,1459286096,3,144,48,1361037902129,1361037902449,1459283225,1459283545,320
1361037905,1459286104,3,200,66.66666667,1361037894890,1361037899882,1459275994,1459280986,4992
1361037907,1459288008,1,77,77,1361037880074,1361037880074,1459261082,1459261082,0
1361037914,1459295900,7,1836,262.2857143,1361037886093,1361037886477,1459267993,1459268377,384
1361037922,1459303952,2,265,132.5,1361037894170,1361037894234,1459276122,1459276186,64
1361037923,1459303984,2,92,46,1361037895458,1361037895522,1459276442,1459276506,64
1361037923,1459303992,2,474,237,1361037896154,1361037896218,1459277146,1459277210,64
1361037926,1459307940,2,92,46,1361037901541,1361037901541,1459283481,1459283481,0
1361037927,1459307980,2,92,46,1361037901992,1361037902056,1459282972,1459283036,64
1361037929,1459310088,2,123,61.5,1361037926844,1361037926844,1459307932,1459307932,0
1361037929,1459310172,2,123,61.5,1361037925798,1361037925798,1459306970,1459306970,0
1361037930,1459311928,2,92,46,1361037901937,1361037901937,1459283865,1459283865,0
1361037931,1459311980,2,92,46,1361037902887,1361037902887,1459283867,1459283867,0
1361037937,1459318092,12,999,83.25,1361037919094,1361037929398,1459300186,1459310490,10304
1361037937,1459318096,12,999,83.25,1361037919348,1361037929396,1459300444,1459310492,10048
1361037937,1459318100,11,953,86.63636364,1361037919663,1361037929391,1459300763,1459310491,9728
1361037937,1459318140,2,123,61.5,1361037929800,1361037929800,1459310940,1459310940,0
1361037940,97634240,2,98,49,1361037931879,1361037935911,97626119,97630151,4032
1361037940,97634240,2,98,49,1361037931879,1361037934887,97626119,97629127,3008
1361037950,1459331932,1,77,77,1361037924398,1361037924398,1459306330,1459306330,0
1361037963,1459343996,2,474,237,1361037936725,1361037936789,1459317721,1459317785,64
1361037969,1459350124,3,169,56.33333333,1361037968853,1361037968853,1459349977,1459349977,0
1361037969,1459350124,3,169,56.33333333,1361037968853,1361037968853,1459349977,1459349977,0
1361037969,1459350124,4,215,53.75,1361037968853,1361037968853,1459349977,1459349977,0
1361037972,97666276,2,123,61.5,1361037968838,1361037968838,97663114,97663114,0
1361037975,1459355952,1,46,46,1361037950018,1361037950018,1459330970,1459330970,0
1361037975,1459356000,1,46,46,1361037949972,1361037949972,1459330972,1459330972,0
1361037975,1459356000,1,46,46,1361037949972,1361037949972,1459330972,1459330972,0
1361037975,1459356000,1,46,46,1361037949971,1361037949971,1459330971,1459330971,0
1361037977,1459358192,6,366,61,1361037969746,1361037969810,1459350938,1459351002,64
1361037978,1459359912,2,265,132.5,1361037950017,1361037950145,1459331929,1459332057,128
1361037983,1459363980,1,46,46,1361037957990,1361037957990,1459338970,1459338970,0
1361037983,1459364024,1,46,46,1361037956986,1361037956986,1459338010,1459338010,0
1361037983,1459364032,1,46,46,1361037957940,1361037957940,1459338972,1459338972,0
1361037985,1459366160,3,144,48,1361037977073,1361037977073,1459358233,1459358233,0
1361037993,1459374128,2,98,49,1361037991890,1361037991954,1459373018,1459373082,64
1361038001,1459382104,2,98,49,1361037995689,1361038000873,1459376793,1459381977,5184
1361038001,1459382104,4,312,78,1361037995689,1361037995817,1459376793,1459376921,128
1361038001,1459382104,4,312,78,1361037995817,1361037995945,1459376921,1459377049,128
1361038001,1459382104,3,140,46.66666667,1361037995753,1361038000873,1459376857,1459381977,5120
1361038001,1459382108,4,312,78,1361037995943,1361037996007,1459377051,1459377115,64
1361038001,1459382108,4,312,78,1361037996325,1361037996389,1459377433,1459377497,64
1361038001,1459382144,2,279,139.5,1361037995457,1361038000833,1459376601,1459381977,5376
1361038001,1459382148,4,313,78.25,1361037995452,1361037995516,1459376600,1459376664,64
1361038001,1459382148,2,98,49,1361037995648,1361038000832,1459376796,1459381980,5184
1361038001,1459382148,3,144,48,1361037995648,1361038000832,1459376796,1459381980,5184
1361038001,1459382148,4,312,78,1361037995711,1361037995775,1459376859,1459376923,64
1361038001,1459382148,6,2042,340.3333333,1361037995647,1361038000831,1459376795,1459381979,5184
1361038001,1459382148,6,1956,326,1361037995647,1361038000831,1459376795,1459381979,5184
1361038001,1459382148,2,98,49,1361037995647,1361038000831,1459376795,1459381979,5184
1361038001,1459382148,2,98,49,1361037995646,1361038000830,1459376794,1459381978,5184
1361038001,1459382148,2,98,49,1361037995646,1361038000830,1459376794,1459381978,5184
1361038001,1459382148,4,313,78.25,1361037995838,1361037995966,1459376986,1459377114,128
1361038001,1459382148,3,679,226.3333333,1361037995774,1361037995838,1459376922,1459376986,64
1361038001,1459382148,4,312,78,1361037995774,1361037995838,1459376922,1459376986,64
1361038001,1459382152,3,774,258,1361037996155,1361037996347,1459377307,1459377499,192
1361038001,1459382152,4,313,78.25,1361037996347,1361037996411,1459377499,1459377563,64
1361038001,1459382152,4,312,78,1361037996410,1361037996474,1459377562,1459377626,64
1361038003,1459383960,2,474,237,1361037976440,1361037976504,1459357400,1459357464,64
1361038003,1459383968,88,70588,802.1363636,1361037977906,1361037992690,1459358874,1459373658,14784
1361038004,97698280,2,98,49,1361037995842,1361038001794,97690122,97696074,5952
1361038004,97698280,2,98,49,1361037996353,1361038001793,97690633,97696073,5440
1361038009,1459390136,4,205,51.25,1361038002826,1361038002826,1459383962,1459383962,0
1361038009,1459390140,6,2486,414.3333333,1361037995654,1361038000902,1459376794,1459382042,5248
1361038009,1459390144,13,13505,1038.846154,1361037996035,1361038001987,1459377179,1459383131,5952
1361038009,1459390180,3,144,48,1361037995997,1361038001757,1459377177,1459382937,5760
1361038009,1459390180,2,98,49,1361037995805,1361038001757,1459376985,1459382937,5952
1361038017,1459398148,14,14578,1041.285714,1361037995389,1361038010877,1459376537,1459392025,15488
1361038017,1459398152,5,1430,286,1361037996217,1361038011385,1459377369,1459392537,15168
1361038017,1459398156,4,312,78,1361038009719,1361038009847,1459390875,1459391003,128
1361038017,1459398200,4,312,78,1361038009354,1361038009418,1459390554,1459390618,64
1361038017,1459398200,4,312,78,1361038009480,1361038009608,1459390680,1459390808,128
1361038017,1459398204,4,312,78,1361038009606,1361038009670,1459390810,1459390874,64
1361038017,1459398204,4,312,78,1361038009670,1361038009734,1459390874,1459390938,64
1361038017,1459398204,4,312,78,1361038009732,1361038009860,1459390936,1459391064,128
1361038019,1459399976,8,3809,476.125,1361037992106,1361037992362,1459373082,1459373338,256
1361038019,1459400000,5,437,87.4,1361037992592,1361037992656,1459373592,1459373656,64
1361038019,1459400044,21,14315,681.6666667,1361037991911,1361037992039,1459372955,1459373083,128
1361038019,1459400044,6,3230,538.3333333,1361037991910,1361037991974,1459372954,1459373018,64
1361038019,1459400044,6,3350,558.3333333,1361037992037,1361037992229,1459373081,1459373273,192
1361038019,1459400048,6,3350,558.3333333,1361037992160,1361037992288,1459373208,1459373336,128
1361038022,1459403920,4,1392,348,1361037994424,1361037994744,1459376344,1459376664,320
1361038022,1459403924,11,8969,815.3636364,1361037995060,1361037995636,1459376984,1459377560,576
1361038023,1459403968,8,5177,647.125,1361037995569,1361037996145,1459376537,1459377113,576
1361038023,1459403972,4,930,232.5,1361037995887,1361037996143,1459376859,1459377115,256
1361038023,1459403972,4,914,228.5,1361037996397,1361037996589,1459377369,1459377561,192
1361038023,1459403972,4,914,228.5,1361037996396,1361037996652,1459377368,1459377624,256
1361038023,97717972,4,888,222,1361037995151,1361037995471,97690123,97690443,320
1361038023,97718000,23,30409,1322.130435,1361037995632,1361037995696,97690632,97690696,64
1361038031,1459411976,2,265,132.5,1361038006506,1361038006570,1459387482,1459387546,64
1361038034,1459415928,4,2442,610.5,1361038008562,1361038008818,1459390490,1459390746,256
1361038034,1459415932,23,28825,1253.26087,1361038008751,1361038009007,1459390683,1459390939,256
1361038043,1459424056,2,474,237,1361038016985,1361038017113,1459398041,1459398169,128
1361038049,1459430160,4,215,53.75,1361038037170,1361038046130,1459418330,1459427290,8960
1361038057,1459438192,3,200,66.66666667,1361038051791,1361038056783,1459432983,1459437975,4992
1361038057,1459438192,3,144,48,1361038052049,1361038052049,1459433241,1459433241,0
1361038063,1459444048,2,154,77,1361038036255,1361038036511,1459417303,1459417559,256
1361038063,1459444056,1,77,77,1361038037272,1361038037272,1459418328,1459418328,0
1361038063,1459444056,2,154,77,1361038037272,1361038037528,1459418328,1459418584,256
1361038079,1459460036,2,92,46,1361038051438,1361038051566,1459432474,1459432602,128
1361038079,1459460036,2,92,46,1361038051438,1361038051566,1459432474,1459432602,128
1361038083,1459463988,2,92,46,1361038055838,1361038055966,1459436826,1459436954,128
1361038083,1459464028,2,92,46,1361038055925,1361038055989,1459436953,1459437017,64
1361038083,1459464056,2,92,46,1361038055769,1361038055897,1459436825,1459436953,128
1361038083,1459464056,2,92,46,1361038055769,1361038055897,1459436825,1459436953,128
1361038083,1459464064,2,474,237,1361038056912,1361038056976,1459437976,1459438040,64
1361038087,1459468092,2,265,132.5,1361038062451,1361038062579,1459443543,1459443671,128
1361038107,1459488024,1,77,77,1361038081272,1361038081272,1459462296,1459462296,0
1361038107,1459488116,1,77,77,1361038082139,1361038082139,1459463255,1459463255,0
1361038107,1459488116,1,77,77,1361038082203,1361038082203,1459463319,1459463319,0
1361038113,1459494180,3,848,282.6666667,1361038106973,1361038107037,1459488153,1459488217,64
1361038113,1459494180,27,32925,1219.444444,1361038105052,1361038108892,1459486232,1459490072,3840
1361038113,1459494180,4,312,78,1361038105115,1361038105179,1459486295,1459486359,64
1361038113,1459494180,5,820,164,1361038107419,1361038112475,1459488599,1459493655,5056
1361038113,1459494180,4,312,78,1361038107419,1361038107483,1459488599,1459488663,64
1361038113,1459494180,3,502,167.3333333,1361038107355,1361038107355,1459488535,1459488535,0
1361038113,1459494180,4,312,78,1361038107482,1361038107546,1459488662,1459488726,64
1361038113,1459494184,3,575,191.6666667,1361038107609,1361038107673,1459488793,1459488857,64
1361038113,1459494184,4,312,78,1361038107481,1361038107609,1459488665,1459488793,128
1361038113,1459494184,3,144,48,1361038107609,1361038108697,1459488793,1459489881,1088
1361038113,1459494184,4,312,78,1361038107609,1361038107673,1459488793,1459488857,64
1361038113,1459494184,11,9746,886,1361038107609,1361038108761,1459488793,1459489945,1152
1361038113,1459494184,4,312,78,1361038107736,1361038107800,1459488920,1459488984,64
1361038113,1459494184,6,2338,389.6666667,1361038105560,1361038110744,1459486744,1459491928,5184
1361038113,1459494184,42,54728,1303.047619,1361038105560,1361038111768,1459486744,1459492952,6208
1361038113,1459494184,2,98,49,1361038105560,1361038111320,1459486744,1459492504,5760
1361038113,1459494184,2,98,49,1361038105559,1361038111319,1459486743,1459492503,5760
1361038113,1459494184,8,4813,601.625,1361038105559,1361038112791,1459486743,1459493975,7232
1361038113,1459494184,6,1702,283.6666667,1361038105559,1361038110743,1459486743,1459491927,5184
1361038113,1459494184,2,98,49,1361038105559,1361038111319,1459486743,1459492503,5760
1361038113,1459494184,2,98,49,1361038105623,1361038111383,1459486807,1459492567,5760
1361038113,1459494184,2,98,49,1361038105559,1361038111319,1459486743,1459492503,5760
1361038113,1459494184,18,21172,1176.222222,1361038105559,1361038110743,1459486743,1459491927,5184
1361038113,1459494184,3,144,48,1361038105559,1361038111319,1459486743,1459492503,5760
1361038113,1459494184,4,312,78,1361038105623,1361038105687,1459486807,1459486871,64
1361038113,1459494184,4,672,168,1361038105686,1361038105814,1459486870,1459486998,128
1361038113,1459494184,5,1797,359.4,1361038107990,1361038108182,1459489174,1459489366,192
1361038113,1459494188,4,312,78,1361038108050,1361038108114,1459489238,1459489302,64
1361038113,1459494188,4,312,78,1361038108114,1361038108178,1459489302,1459489366,64
1361038113,1459494188,4,312,78,1361038106130,1361038106258,1459487318,1459487446,128
1361038113,1459494192,2,98,49,1361038106448,1361038112336,1459487640,1459493528,5888
1361038113,1459494192,3,795,265,1361038106575,1361038106767,1459487767,1459487959,192
1361038113,1459494196,4,312,78,1361038106638,1361038106702,1459487834,1459487898,64
1361038113,1459494220,2,98,49,1361038106738,1361038112306,1459487958,1459493526,5568
1361038113,1459494224,6,3069,511.5,1361038106734,1361038107246,1459487958,1459488470,512
1361038113,1459494224,3,911,303.6666667,1361038106738,1361038106802,1459487962,1459488026,64
1361038113,1459494224,4,312,78,1361038106993,1361038107057,1459488217,1459488281,64
1361038113,1459494224,3,841,280.3333333,1361038107311,1361038107375,1459488535,1459488599,64
1361038113,1459494224,3,421,140.3333333,1361038107566,1361038107630,1459488790,1459488854,64
1361038113,1459494228,3,575,191.6666667,1361038107566,1361038107630,1459488794,1459488858,64
1361038113,1459494228,4,312,78,1361038107565,1361038107693,1459488793,1459488921,128
1361038113,1459494228,4,352,88,1361038107629,1361038107757,1459488857,1459488985,128
1361038113,1459494228,8,5285,660.625,1361038105516,1361038112748,1459486744,1459493976,7232
1361038113,1459494228,16,17836,1114.75,1361038105516,1361038110700,1459486744,1459491928,5184
1361038113,1459494228,4,312,78,1361038105580,1361038105644,1459486808,1459486872,64
1361038113,1459494228,17,14930,878.2352941,1361038105514,1361038112746,1459486742,1459493974,7232
1361038113,1459494228,9,6404,711.5555556,1361038105514,1361038112682,1459486742,1459493910,7168
1361038113,1459494228,6,1418,236.3333333,1361038105514,1361038110698,1459486742,1459491926,5184
1361038113,1459494228,2,98,49,1361038105514,1361038111274,1459486742,1459492502,5760
1361038113,1459494236,4,312,78,1361038106085,1361038106149,1459487321,1459487385,64
1361038113,1459494260,4,312,78,1361038106510,1361038106638,1459487770,1459487898,128
1361038113,1459494260,2,98,49,1361038106446,1361038112270,1459487706,1459493530,5824
1361038113,1459494260,4,312,78,1361038106445,1361038106573,1459487705,1459487833,128
1361038113,1459494260,19,25289,1331,1361038106508,1361038106636,1459487768,1459487896,128
1361038121,1459502268,2,92,46,1361038107268,1361038113220,1459488536,1459494488,5952
1361038121,1459502268,5,654,130.8,1361038107268,1361038117380,1459488536,1459498648,10112
1361038121,1459502268,2,98,49,1361038107331,1361038113219,1459488599,1459494487,5888
1361038121,1459502268,3,140,46.66666667,1361038107331,1361038113219,1459488599,1459494487,5888
1361038121,1459502268,2,92,46,1361038107523,1361038113219,1459488791,1459494487,5696
1361038121,1459502336,2,98,49,1361038107198,1361038113214,1459488534,1459494550,6016
1361038121,1459502336,2,98,49,1361038107266,1361038113154,1459488602,1459494490,5888
1361038121,1459502336,6,2120,353.3333333,1361038107330,1361038117442,1459488666,1459498778,10112
1361038121,1459502336,3,144,48,1361038107329,1361038113217,1459488665,1459494553,5888
1361038121,1459502336,2,92,46,1361038107457,1361038113153,1459488793,1459494489,5696
1361038121,1459502336,3,140,46.66666667,1361038107456,1361038113152,1459488792,1459494488,5696
1361038123,1459504028,2,474,237,1361038097138,1361038097202,1459478166,1459478230,64
1361038129,1459510252,6,2294,382.3333333,1361038120597,1361038126741,1459501849,1459507993,6144
1361038129,1459510252,6,2038,339.6666667,1361038120594,1361038126674,1459501846,1459507926,6080
1361038129,1459510276,6,366,61,1361038126845,1361038126909,1459508121,1459508185,64
1361038129,1459510276,8,458,57.25,1361038126908,1361038127868,1459508184,1459509144,960
1361038129,1459510284,3,144,48,1361038127988,1361038127988,1459509272,1459509272,0
1361038129,1459510316,6,2404,400.6666667,1361038120532,1361038126612,1459501848,1459507928,6080
1361038129,1459510316,6,1933,322.1666667,1361038120723,1361038126611,1459502039,1459507927,5888
1361038129,1459510320,4,312,78,1361038120785,1361038120977,1459502105,1459502297,192
1361038129,1459510320,6,366,61,1361038125775,1361038125839,1459507095,1459507159,64
1361038131,1459512036,17,20255,1191.470588,1361038105707,1361038106347,1459486743,1459487383,640
1361038131,1459512072,4,1439,359.75,1361038106505,1361038106569,1459487577,1459487641,64
1361038131,1459512072,5,1091,218.2,1361038106696,1361038107592,1459487768,1459488664,896
1361038131,1459512072,3,429,143,1361038106696,1361038107592,1459487768,1459488664,896
1361038131,1459512108,4,439,109.75,1361038105636,1361038105700,1459486744,1459486808,64
1361038131,1459512108,3,966,322,1361038105636,1361038105700,1459486744,1459486808,64
1361038131,1459512120,1,46,46,1361038106393,1361038106393,1459487513,1459487513,0
1361038131,1459512120,1,416,416,1361038106519,1361038106519,1459487639,1459487639,0
1361038131,1459512120,19,23459,1234.684211,1361038106519,1361038106647,1459487639,1459487767,128
1361038131,1459512124,3,300,100,1361038106642,1361038106642,1459487766,1459487766,0
1361038135,1459516056,1,46,46,1361038110487,1361038110487,1459491543,1459491543,0
1361038135,1459516064,4,1616,404,1361038107534,1361038107790,1459488598,1459488854,256
1361038135,1459516068,20,21876,1093.8,1361038107978,1361038108362,1459489046,1459489430,384
1361038136,97830204,1,46,46,1361038111439,1361038111439,97805643,97805643,0
1361038139,1459520068,3,1174,391.3333333,1361038114764,1361038114956,1459495832,1459496024,192
1361038139,1459520072,4,1692,423,1361038114633,1361038114889,1459495705,1459495961,256
1361038140,97834176,1,46,46,1361038112489,1361038112489,97806665,97806665,0
1361038143,1459524064,2,265,132.5,1361038117967,1361038118095,1459499031,1459499159,128
1361038151,1459532036,1,46,46,1361038124717,1361038124717,1459505753,1459505753,0
1361038151,1459532064,1,46,46,1361038125648,1361038125648,1459506712,1459506712,0
1361038163,1459544120,2,474,237,1361038137557,1361038137621,1459518677,1459518741,64
1361038177,1459558376,3,138,46,1361038174357,1361038175125,1459555733,1459556501,768
1361038177,1459558420,4,184,46,1361038173548,1361038175084,1459554968,1459556504,1536
1361038191,1459572168,2,92,46,1361038166566,1361038166630,1459547734,1459547798,64
1361038199,1459580064,5,421,84.2,1361038173200,1361038175440,1459554264,1459556504,2240
1361038203,1459584056,2,474,237,1361038178008,1361038178072,1459559064,1459559128,64
1361038207,1459588108,2,92,46,1361038182562,1361038182562,1459563670,1459563670,0
1361038207,1459588152,2,92,46,1361038180664,1361038180664,1459561816,1459561816,0
1361038207,1459588164,2,92,46,1361038182508,1361038182508,1459563672,1459563672,0
1361038209,1459590344,3,144,48,1361038204216,1361038204280,1459585560,1459585624,64
1361038215,1459596064,10,1906,190.6,1361038187471,1361038187791,1459568535,1459568855,320
1361038225,1459606376,2,92,46,1361038223191,1361038223191,1459604567,1459604567,0
1361038243,1459624156,2,474,237,1361038217713,1361038217777,1459598869,1459598933,64
1361038247,1459628220,1,46,46,1361038222321,1361038222321,1459603541,1459603541,0
1361038247,1459628220,1,46,46,1361038222320,1361038222320,1459603540,1459603540,0
1361038247,1459628268,1,46,46,1361038221248,1361038221248,1459602516,1459602516,0
1361038247,1459628268,1,46,46,1361038221316,1361038221316,1459602584,1459602584,0
1361038247,1459628272,1,46,46,1361038222269,1361038222269,1459603541,1459603541,0
1361038251,1459632160,1,46,46,1361038223406,1361038223406,1459604566,1459604566,0
1361038255,1459636256,2,265,132.5,1361038229007,1361038229135,1459610263,1459610391,128
1361038281,1459662496,3,144,48,1361038276766,1361038276766,1459658262,1459658262,0
1361038283,1459664172,2,474,237,1361038257378,1361038257442,1459638550,1459638614,64
1361038283,1459664180,2,106,53,1361038258072,1361038258072,1459639252,1459639252,0
1361038311,1459692220,2,265,132.5,1361038284850,1361038284978,1459666070,1459666198,128
1361038311,1459692284,2,583,291.5,1361038284337,1361038284401,1459665621,1459665685,64
1361038313,1459694348,3,502,167.3333333,1361038306931,1361038306931,1459688279,1459688279,0
1361038313,1459694348,3,140,46.66666667,1361038306930,1361038312626,1459688278,1459693974,5696
1361038313,1459694352,2,279,139.5,1361038307307,1361038312619,1459688659,1459693971,5312
1361038313,1459694352,4,312,78,1361038307311,1361038307375,1459688663,1459688727,64
1361038313,1459694352,4,312,78,1361038307438,1361038307502,1459688790,1459688854,64
1361038313,1459694352,3,575,191.6666667,1361038307374,1361038307438,1459688726,1459688790,64
1361038313,1459694352,3,575,191.6666667,1361038307374,1361038307822,1459688726,1459689174,448
1361038313,1459694352,5,417,83.4,1361038307628,1361038307756,1459688980,1459689108,128
1361038313,1459694352,4,312,78,1361038307691,1361038307819,1459689043,1459689171,128
1361038313,1459694356,4,312,78,1361038307690,1361038307818,1459689046,1459689174,128
1361038313,1459694356,4,186,46.5,1361038307945,1361038307945,1459689301,1459689301,0
1361038313,1459694356,2,98,49,1361038306216,1361038311656,1459687572,1459693012,5440
1361038313,1459694356,2,98,49,1361038306215,1361038311655,1459687571,1459693011,5440
1361038313,1459694356,4,312,78,1361038308263,1361038308391,1459689619,1459689747,128
1361038313,1459694356,2,98,49,1361038306215,1361038311655,1459687571,1459693011,5440
1361038313,1459694356,2,98,49,1361038306215,1361038311655,1459687571,1459693011,5440
1361038313,1459694360,2,98,49,1361038306215,1361038311655,1459687575,1459693015,5440
1361038313,1459694360,2,98,49,1361038306215,1361038311655,1459687575,1459693015,5440
1361038313,1459694360,2,98,49,1361038306215,1361038311655,1459687575,1459693015,5440
1361038313,1459694360,2,98,49,1361038306214,1361038311654,1459687574,1459693014,5440
1361038313,1459694360,7,3096,442.2857143,1361038306405,1361038306917,1459687765,1459688277,512
1361038313,1459694364,4,352,88,1361038309282,1361038309346,1459690646,1459690710,64
1361038313,1459694388,3,813,271,1361038306889,1361038306889,1459688277,1459688277,0
1361038313,1459694388,2,98,49,1361038306952,1361038312648,1459688340,1459694036,5696
1361038313,1459694392,3,421,140.3333333,1361038307207,1361038307271,1459688599,1459688663,64
1361038313,1459694392,2,98,49,1361038307270,1361038312582,1459688662,1459693974,5312
1361038313,1459694392,3,144,48,1361038307270,1361038312646,1459688662,1459694038,5376
1361038313,1459694392,6,1693,282.1666667,1361038307270,1361038307718,1459688662,1459689110,448
1361038313,1459694392,4,312,78,1361038307334,1361038307398,1459688726,1459688790,64
1361038313,1459694392,2,98,49,1361038307333,1361038312581,1459688725,1459693973,5248
1361038313,1459694392,4,312,78,1361038307459,1361038307587,1459688851,1459688979,128
1361038313,1459694396,4,312,78,1361038307840,1361038307968,1459689236,1459689364,128
1361038313,1459694396,4,312,78,1361038307840,1361038307968,1459689236,1459689364,128
1361038313,1459694396,6,796,132.6666667,1361038307904,1361038308032,1459689300,1459689428,128
1361038313,1459694396,4,472,118,1361038307967,1361038308031,1459689363,1459689427,64
1361038313,1459694396,4,312,78,1361038307967,1361038308031,1459689363,1459689427,64
1361038313,1459694400,4,352,88,1361038308031,1361038308159,1459689431,1459689559,128
1361038313,1459694400,4,352,88,1361038308030,1361038308158,1459689430,1459689558,128
1361038313,1459694400,4,352,88,1361038308157,1361038308221,1459689557,1459689621,64
1361038313,1459694400,6,1848,308,1361038308221,1361038310269,1459689621,1459691669,2048
1361038313,1459694400,2,98,49,1361038306173,1361038311613,1459687573,1459693013,5440
1361038313,1459694400,2,98,49,1361038306173,1361038311613,1459687573,1459693013,5440
1361038313,1459694400,4,312,78,1361038308220,1361038308348,1459689620,1459689748,128
1361038313,1459694400,6,614,102.3333333,1361038306172,1361038311548,1459687572,1459692948,5376
1361038313,1459694400,2,98,49,1361038306172,1361038311612,1459687572,1459693012,5440
1361038313,1459694400,2,98,49,1361038306172,1361038311612,1459687572,1459693012,5440
1361038313,1459694400,2,98,49,1361038306172,1361038311612,1459687572,1459693012,5440
1361038313,1459694400,2,98,49,1361038306172,1361038311612,1459687572,1459693012,5440
1361038313,1459694424,4,312,78,1361038309155,1361038309219,1459690579,1459690643,64
1361038313,1459694424,5,861,172.2,1361038309091,1361038309155,1459690515,1459690579,64
1361038313,1459694428,4,312,78,1361038309154,1361038309218,1459690582,1459690646,64
1361038313,1459694428,4,312,78,1361038309346,1361038309410,1459690774,1459690838,64
1361038321,1459702344,5,654,130.8,1361038306932,1361038317044,1459688276,1459698388,10112
1361038321,1459702348,19,9714,511.2631579,1361038307249,1361038318513,1459688597,1459699861,11264
1361038321,1459702352,3,150,50,1361038307693,1361038313645,1459689045,1459694997,5952
1361038321,1459702352,2,98,49,1361038307884,1361038313644,1459689236,1459694996,5760
1361038321,1459702352,2,92,46,1361038307947,1361038313643,1459689299,1459694995,5696
1361038321,1459702352,2,92,46,1361038307947,1361038313643,1459689299,1459694995,5696
1361038321,1459702356,10,2201,220.1,1361038308075,1361038313387,1459689431,1459694743,5312
1361038321,1459702356,3,144,48,1361038307946,1361038313706,1459689302,1459695062,5760
1361038321,1459702356,2,92,46,1361038308074,1361038313706,1459689430,1459695062,5632
1361038321,1459702356,2,92,46,1361038308138,1361038313706,1459689494,1459695062,5568
1361038321,1459702356,2,98,49,1361038308265,1361038313641,1459689621,1459694997,5376
1361038321,1459702364,5,748,149.6,1361038309153,1361038313569,1459690517,1459694933,4416
1361038321,1459702392,32,12699,396.84375,1361038307587,1361038314307,1459688979,1459695699,6720
1361038321,1459702396,2,98,49,1361038307842,1361038313602,1459689238,1459694998,5760
1361038321,1459702396,2,94,47,1361038307906,1361038313602,1459689302,1459694998,5696
1361038321,1459702396,2,98,49,1361038307906,1361038313602,1459689302,1459694998,5696
1361038321,1459702396,3,144,48,1361038307970,1361038313602,1459689366,1459694998,5632
1361038321,1459702396,3,144,48,1361038307970,1361038313602,1459689366,1459694998,5632
1361038321,1459702396,24,6196,258.1666667,1361038308033,1361038314689,1459689429,1459696085,6656
1361038321,1459702396,12,2293,191.0833333,1361038308033,1361038313281,1459689429,1459694677,5248
1361038321,1459702396,10,2184,218.4,1361038308033,1361038313345,1459689429,1459694741,5312
1361038321,1459702428,3,346,115.3333333,1361038309089,1361038314145,1459690517,1459695573,5056
1361038321,1459702428,5,764,152.8,1361038309089,1361038313505,1459690517,1459694933,4416
1361038323,1459704296,2,474,237,1361038296996,1361038297060,1459678292,1459678356,64
1361038329,1459710364,5,654,130.8,1361038307935,1361038322655,1459689299,1459704019,14720
1361038329,1459710436,8,847,105.875,1361038309272,1361038324440,1459690708,1459705876,15168
1361038331,1459712232,3,514,171.3333333,1361038306405,1361038306469,1459687637,1459687701,64
1361038331,1459712268,27,33039,1223.666667,1361038305666,1361038310210,1459686934,1459691478,4544
1361038331,1459712292,3,556,185.3333333,1361038306152,1361038306280,1459687444,1459687572,128
1361038331,1459712296,4,439,109.75,1361038306279,1361038306279,1459687575,1459687575,0
1361038331,1459712296,4,1320,330,1361038306405,1361038306469,1459687701,1459687765,64
1361038331,1459712296,5,1091,218.2,1361038306469,1361038307173,1459687765,1459688469,704
1361038331,1459712296,4,760,190,1361038306532,1361038307492,1459687828,1459688788,960
1361038332,98026492,7,2552,364.5714286,1361038307888,1361038308144,98002380,98002636,256
1361038335,1459716232,2,434,217,1361038307429,1361038307493,1459688661,1459688725,64
1361038335,1459716232,4,1696,424,1361038307493,1361038307685,1459688725,1459688917,192
1361038335,1459716232,15,18268,1217.866667,1361038307620,1361038308068,1459688852,1459689300,448
1361038335,1459716236,29,38215,1317.758621,1361038308129,1361038308193,1459689365,1459689429,64
1361038335,1459716236,3,1472,490.6666667,1361038308127,1361038308255,1459689363,1459689491,128
1361038335,1459716240,11,7808,709.8181818,1361038308251,1361038309275,1459689491,1459690515,1024
1361038335,1459716276,5,977,195.4,1361038307575,1361038307959,1459688851,1459689235,384
1361038335,1459716280,5,1568,313.6,1361038307957,1361038308277,1459689237,1459689557,320
1361038335,1459716280,4,886,221.5,1361038307957,1361038308021,1459689237,1459689301,64
1361038335,1459716280,7,1174,167.7142857,1361038307956,1361038308788,1459689236,1459690068,832
1361038335,1459716280,5,996,199.2,1361038308020,1361038308148,1459689300,1459689428,128
1361038353,1459734368,4,312,78,1361038351005,1361038351133,1459732373,1459732501,128
1361038353,1459734368,4,312,78,1361038350940,1361038351068,1459732308,1459732436,128
1361038353,1459734372,4,312,78,1361038351319,1361038351447,1459732691,1459732819,128
1361038353,1459734376,4,312,78,1361038351446,1361038351510,1459732822,1459732886,64
1361038353,1459734376,4,312,78,1361038351574,1361038351702,1459732950,1459733078,128
1361038353,1459734376,4,312,78,1361038351828,1361038351892,1459733204,1459733268,64
1361038353,1459734376,3,144,48,1361038351827,1361038351827,1459733203,1459733203,0
1361038353,1459734376,4,312,78,1361038351827,1361038351955,1459733203,1459733331,128
1361038353,1459734380,4,312,78,1361038352210,1361038352338,1459733590,1459733718,128
1361038353,1459734380,4,312,78,1361038352400,1361038352528,1459733780,1459733908,128
1361038353,1459734384,4,392,98,1361038352462,1361038352590,1459733846,1459733974,128
1361038353,1459734404,3,421,140.3333333,1361038350071,1361038350135,1459731475,1459731539,64
1361038353,1459734404,4,312,78,1361038350135,1361038350263,1459731539,1459731667,128
1361038353,1459734404,4,312,78,1361038350199,1361038350327,1459731603,1459731731,128
1361038353,1459734408,4,312,78,1361038350899,1361038350963,1459732307,1459732371,64
1361038353,1459734416,4,312,78,1361038351342,1361038351470,1459732758,1459732886,128
1361038353,1459734416,4,352,88,1361038351468,1361038351532,1459732884,1459732948,64
1361038353,1459734416,4,312,78,1361038351531,1361038351595,1459732947,1459733011,64
1361038353,1459734420,4,512,128,1361038351722,1361038351914,1459733142,1459733334,192
1361038353,1459734420,4,312,78,1361038351914,1361038351978,1459733334,1459733398,64
1361038353,1459734420,4,312,78,1361038352104,1361038352168,1459733524,1459733588,64
1361038353,1459734420,4,312,78,1361038351912,1361038351976,1459733332,1459733396,64
1361038353,1459734424,4,312,78,1361038352102,1361038352230,1459733526,1459733654,128
1361038353,1459734424,4,312,78,1361038352357,1361038352421,1459733781,1459733845,64
1361038353,1459734448,4,312,78,1361038350412,1361038350540,1459731860,1459731988,128
1361038361,1459742364,3,355,118.3333333,1361038350945,1361038356961,1459732309,1459738325,6016
1361038361,1459742368,8,3317,414.625,1361038351325,1361038357789,1459732693,1459739157,6464
1361038361,1459742368,6,1831,305.1666667,1361038351450,1361038358042,1459732818,1459739410,6592
1361038361,1459742372,2,98,49,1361038351896,1361038356952,1459733268,1459738324,5056
1361038361,1459742372,2,98,49,1361038353880,1361038358936,1459735252,1459740308,5056
1361038361,1459742372,3,144,48,1361038351831,1361038356951,1459733203,1459738323,5120
1361038361,1459742384,2,98,49,1361038349902,1361038354894,1459731286,1459736278,4992
1361038361,1459742404,2,98,49,1361038349882,1361038354874,1459731286,1459736278,4992
1361038361,1459742404,2,98,49,1361038349882,1361038354874,1459731286,1459736278,4992
1361038361,1459742404,2,98,49,1361038349882,1361038354874,1459731286,1459736278,4992
1361038361,1459742404,2,98,49,1361038349882,1361038355898,1459731286,1459737302,6016
1361038361,1459742404,3,140,46.66666667,1361038350008,1361038355896,1459731412,1459737300,5888
1361038361,1459742404,3,140,46.66666667,1361038350136,1361038355896,1459731540,1459737300,5760
1361038361,1459742404,3,144,48,1361038350072,1361038355192,1459731476,1459736596,5120
1361038361,1459742404,3,144,48,1361038350199,1361038355895,1459731603,1459737299,5696
1361038361,1459742404,75,98658,1315.44,1361038350391,1361038358007,1459731795,1459739411,7616
1361038361,1459742412,73,97254,1332.246575,1361038351343,1361038359023,1459732755,1459740435,7680
1361038361,1459742416,2,98,49,1361038351470,1361038356910,1459732886,1459738326,5440
1361038361,1459742416,2,98,49,1361038351851,1361038356907,1459733267,1459738323,5056
1361038361,1459742448,2,98,49,1361038349838,1361038354830,1459731286,1459736278,4992
1361038361,1459742448,2,98,49,1361038349773,1361038354829,1459731221,1459736277,5056
1361038361,1459742448,2,98,49,1361038349773,1361038354829,1459731221,1459736277,5056
1361038361,1459742448,6,614,102.3333333,1361038349837,1361038355533,1459731285,1459736981,5696
1361038361,1459742448,2,98,49,1361038349837,1361038355853,1459731285,1459737301,6016
1361038361,1459742448,9,1777,197.4444444,1361038350156,1361038357388,1459731604,1459738836,7232
1361038363,1459744260,2,98,49,1361038350791,1361038356039,1459732051,1459737299,5248
1361038363,1459744356,2,474,237,1361038336873,1361038336937,1459718229,1459718293,64
1361038364,98058400,2,98,49,1361038351050,1361038357066,98045450,98051466,6016
1361038367,1459748252,2,265,132.5,1361038340048,1361038340112,1459721300,1459721364,64
1361038369,1459750408,6,760,126.6666667,1361038350837,1361038366005,1459732245,1459747413,15168
1361038371,1459752276,9,4280,475.5555556,1361038350839,1361038361143,1459732115,1459742419,10304
1361038375,1459756296,25,32987,1319.48,1361038349733,1361038353125,1459731029,1459734421,3392
1361038375,1459756300,1,331,331,1361038350177,1361038350177,1459731477,1459731477,0
1361038375,1459756300,2,843,421.5,1361038350241,1361038350305,1459731541,1459731605,64
1361038375,1459756344,3,1227,409,1361038350003,1361038350003,1459731347,1459731347,0
1361038375,1459756344,1,416,416,1361038350002,1361038350002,1459731346,1459731346,0
1361038375,1459756348,2,662,331,1361038350130,1361038350130,1459731478,1459731478,0
1361038376,98070496,4,3036,759,1361038350955,1361038351211,98045451,98045707,256
1361038379,1459760276,11,13084,1189.454545,1361038350967,1361038351031,1459732243,1459732307,64
1361038379,1459760288,4,653,163.25,1361038351594,1361038351658,1459732882,1459732946,64
1361038379,1459760288,4,468,117,1361038351980,1361038352108,1459733268,1459733396,128
1361038379,1459760288,18,18116,1006.444444,1361038351787,1361038352171,1459733075,1459733459,384
1361038379,1459760292,42,57227,1362.547619,1361038352232,1361038352616,1459733524,1459733908,384
1361038379,1459760316,15,18283,1218.866667,1361038352463,1361038352527,1459733779,1459733843,64
1361038379,1459760360,56,78587,1403.339286,1361038351844,1361038352612,1459733204,1459733972,768
1361038379,1459760360,4,468,117,1361038351907,1361038352099,1459733267,1459733459,192
1361038395,1459776360,2,92,46,1361038367460,1361038367524,1459748820,1459748884,64
1361038401,1459782412,4,205,51.25,1361038399983,1361038399983,1459781395,1459781395,0
1361038403,1459784672,2,474,237,1361038376812,1361038376876,1459758484,1459758548,64
1361038407,1459788316,2,92,46,1361038381647,1361038381647,1459762963,1459762963,0
1361038407,1459788360,2,92,46,1361038380900,1361038380900,1459762260,1459762260,0
1361038407,1459788360,2,92,46,1361038381219,1361038381283,1459762579,1459762643,64
1361038417,1459798412,3,144,48,1361038411822,1361038411822,1459793234,1459793234,0
1361038423,1459804316,2,265,132.5,1361038395792,1361038395856,1459777108,1459777172,64
1361038423,1459804360,1,46,46,1361038396708,1361038396708,1459778068,1459778068,0
1361038423,1459804360,1,46,46,1361038396772,1361038396772,1459778132,1459778132,0
1361038425,1459806408,2,92,46,1361038422964,1361038422964,1459804372,1459804372,0
1361038435,1459816356,2,92,46,1361038409638,1361038409638,1459790994,1459790994,0
1361038439,1459820324,2,92,46,1361038411527,1361038411591,1459792851,1459792915,64
1361038439,1459820376,2,92,46,1361038411476,1361038411540,1459792852,1459792916,64
1361038443,1459824372,2,474,237,1361038417240,1361038417304,1459798612,1459798676,64
1361038447,1459828392,1,46,46,1361038421892,1361038421892,1459803284,1459803284,0
1361038448,98142972,1,46,46,1361038423505,1361038423505,98118477,98118477,0
1361038451,1459832340,1,46,46,1361038422965,1361038422965,1459804305,1459804305,0
1361038451,1459832344,2,92,46,1361038425140,1361038425204,1459806484,1459806548,64
1361038451,1459832356,1,46,46,1361038423976,1361038423976,1459805332,1459805332,0
1361038451,1459832356,1,46,46,1361038423975,1361038423975,1459805331,1459805331,0
1361038451,1459832388,1,46,46,1361038422917,1361038422917,1459804305,1459804305,0
1361038451,1459832392,2,92,46,1361038425092,1361038425156,1459806484,1459806548,64
1361038451,1459832424,1,46,46,1361038423905,1361038423905,1459805329,1459805329,0
1361038451,1459832424,1,46,46,1361038423909,1361038423909,1459805333,1459805333,0
1361038455,1459836396,2,92,46,1361038427965,1361038427965,1459809361,1459809361,0
1361038465,1459846460,8,2777,347.125,1361038456702,1361038461950,1459838162,1459843410,5248
1361038473,1459854456,4,312,78,1361038466818,1361038466882,1459848274,1459848338,64
1361038473,1459854492,4,312,78,1361038465948,1361038466076,1459847440,1459847568,128
1361038473,1459854492,125,176480,1411.84,1361038352030,1361038467934,1459733522,1459849426,115904
1361038473,1459854492,4,312,78,1361038466589,1361038466653,1459848081,1459848145,64
1361038473,1459854496,4,312,78,1361038466588,1361038466652,1459848084,1459848148,64
1361038476,98170428,3,144,48,1361038466930,1361038472306,98161358,98166734,5376
1361038479,1459860376,2,265,132.5,1361038451537,1361038451665,1459832913,1459833041,128
1361038483,1459864420,5,437,87.4,1361038456740,1361038456996,1459838160,1459838416,256
1361038483,1459864420,7,5509,787,1361038456934,1361038457126,1459838354,1459838546,192
1361038483,1459864424,8,3986,498.25,1361038457123,1361038466979,1459838547,1459848403,9856
1361038483,1459864428,2,474,237,1361038457567,1361038457631,1459838995,1459839059,64
1361038483,1459864452,3,1326,442,1361038457671,1361038457735,1459839123,1459839187,64
1361038489,1459870532,3,144,48,1361038486709,1361038486709,1459868241,1459868241,0
1361038491,1459872368,1,46,46,1361038465051,1361038465051,1459846419,1459846419,0
1361038491,1459872368,1,46,46,1361038465050,1361038465050,1459846418,1459846418,0
1361038491,1459872408,8,4778,597.25,1361038464370,1361038466930,1459845778,1459848338,2560
1361038491,1459872408,3,724,241.3333333,1361038464242,1361038464306,1459845650,1459845714,64
1361038492,98186672,1,46,46,1361038465851,1361038465851,98160523,98160523,0
1361038492,98186676,2,1225,612.5,1361038465849,1361038466681,98160525,98161357,832
1361038492,98186700,13,17091,1314.692308,1361038465826,1361038466658,98160526,98161358,832
1361038492,98186700,2,512,256,1361038466656,1361038466848,98161356,98161548,192
1361038495,1459876368,1,46,46,1361038468058,1361038468058,1459849426,1459849426,0
1361038495,1459876368,1,46,46,1361038468057,1361038468057,1459849425,1459849425,0
1361038495,1459876372,1,46,46,1361038468055,1361038468055,1459849427,1459849427,0
1361038495,1459876416,1,46,46,1361038468010,1361038468010,1459849426,1459849426,0
1361038505,1459886588,4,312,78,1361038496959,1361038497023,1459878547,1459878611,64
1361038505,1459886596,4,443,110.75,1361038499576,1361038499640,1459881172,1459881236,64
1361038505,1459886640,3,144,48,1361038502859,1361038503051,1459884499,1459884691,192
1361038505,1459886640,3,144,48,1361038502858,1361038503050,1459884498,1459884690,192
1361038505,1459886672,4,412,103,1361038504680,1361038504808,1459886352,1459886480,128
1361038513,1459894696,3,169,56.33333333,1361038500945,1361038508945,1459882641,1459890641,8000
1361038515,1459896404,11,1973,179.3636364,1361038487543,1361038487991,1459868947,1459869395,448
1361038523,1459904472,2,474,237,1361038497395,1361038497459,1459878867,1459878931,64
1361038524,98218700,15,21140,1409.333333,1361038497122,1361038497314,98191822,98192014,192
1361038529,1459910656,3,200,66.66666667,1361038515898,1361038520890,1459897554,1459902546,4992
1361038531,1459912508,2,265,132.5,1361038506703,1361038506831,1459888211,1459888339,128
1361038543,1459924452,2,92,46,1361038516998,1361038517062,1459898450,1459898514,64
1361038551,1459932484,2,92,46,1361038525987,1361038525987,1459907471,1459907471,0
1361038551,1459932536,2,92,46,1361038526001,1361038526065,1459907537,1459907601,64
1361038563,1459944468,2,474,237,1361038536884,1361038536948,1459918352,1459918416,64
1361038569,1459950644,3,144,48,1361038561606,1361038561606,1459943250,1459943250,0
1361038585,1459966624,3,144,48,1361038578968,1361038584472,1459960592,1459966096,5504
1361038585,1459966624,4,312,78,1361038579032,1361038579096,1459960656,1459960720,64
1361038585,1459966628,8,1286,160.75,1361038579222,1361038579606,1459960850,1459961234,384
1361038585,1459966628,7,3587,512.4285714,1361038579222,1361038584406,1459960850,1459966034,5184
1361038585,1459966628,5,1211,242.2,1361038579222,1361038584406,1459960850,1459966034,5184
1361038585,1459966628,8,5202,650.25,1361038579222,1361038584470,1459960850,1459966098,5248
1361038585,1459966628,5,1603,320.6,1361038579221,1361038584405,1459960849,1459966033,5184
1361038585,1459966628,4,312,78,1361038579349,1361038579477,1459960977,1459961105,128
1361038585,1459966628,4,312,78,1361038579348,1361038579412,1459960976,1459961040,64
1361038585,1459966636,4,312,78,1361038580238,1361038580366,1459961874,1459962002,128
1361038585,1459966636,4,312,78,1361038580430,1361038580494,1459962066,1459962130,64
1361038585,1459966636,4,312,78,1361038580493,1361038580621,1459962129,1459962257,128
1361038585,1459966672,5,1455,291,1361038579178,1361038584426,1459960850,1459966098,5248
1361038585,1459966672,4,312,78,1361038579241,1361038579305,1459960913,1459960977,64
1361038585,1459966672,7,450,64.28571429,1361038579177,1361038579625,1459960849,1459961297,448
1361038585,1459966672,5,1138,227.6,1361038579176,1361038584360,1459960848,1459966032,5184
1361038585,1459966672,4,592,148,1361038579240,1361038579304,1459960912,1459960976,64
1361038585,1459966680,4,312,78,1361038580384,1361038580512,1459962064,1459962192,128
1361038585,1459966684,9,3230,358.8888889,1361038576030,1361038581342,1459957714,1459963026,5312
1361038587,1459968540,2,265,132.5,1361038562540,1361038562668,1459944080,1459944208,128
1361038588,98282416,2,92,46,1361038582910,1361038582910,98277326,98277326,0
1361038588,98282420,2,92,46,1361038582905,1361038582905,98277325,98277325,0
1361038593,1459974632,102,143680,1408.627451,1361038579216,1361038586128,1459960848,1459967760,6912
1361038593,1459974676,38,47925,1261.184211,1361038579171,1361038585443,1459960847,1459967119,6272
1361038593,1459974676,21,23228,1106.095238,1361038579171,1361038585443,1459960847,1459967119,6272
1361038593,1459974676,118,168081,1424.415254,1361038579174,1361038585574,1459960850,1459967250,6400
1361038593,1459974676,6,2198,366.3333333,1361038579174,1361038585574,1459960850,1459967250,6400
1361038599,1459980476,1,46,46,1361038571499,1361038571499,1459952975,1459952975,0
1361038601,1459982612,21,21657,1031.285714,1361038578982,1361038598374,1459960594,1459979986,19392
1361038601,1459982668,8,1370,171.25,1361038580205,1361038600365,1459961873,1459982033,20160
1361038603,1459984488,4,2454,613.5,1361038577249,1361038577377,1459958737,1459958865,128
1361038603,1459984572,5,437,87.4,1361038576141,1361038576397,1459957713,1459957969,256
1361038603,1459984576,9,5616,624,1361038576394,1361038576586,1459957970,1459958162,192
1361038603,1459984580,2,474,237,1361038576709,1361038576773,1459958289,1459958353,64
1361038603,1459984580,6,4080,680,1361038576837,1361038580805,1459958417,1459962385,3968
1361038607,1459988552,1,625,625,1361038578912,1361038578912,1459960464,1459960464,0
1361038607,1459988552,8,5967,745.875,1361038578976,1361038580640,1459960528,1459962192,1664
1361038609,1459990644,4,205,51.25,1361038603396,1361038603396,1459985040,1459985040,0
1361038620,98314416,2,92,46,1361038612924,1361038612924,98307340,98307340,0
1361038625,1460006688,3,144,48,1361038621530,1361038621594,1460003218,1460003282,64
1361038633,1460014640,3,169,56.33333333,1361038620742,1361038628742,1460002382,1460010382,8000
1361038641,1460022676,3,200,66.66666667,1361038635874,1361038640866,1460017550,1460022542,4992
1361038643,1460024604,2,474,237,1361038617515,1361038617643,1459999119,1459999247,128
1361038643,1460024636,2,265,132.5,1361038618253,1361038618381,1459999889,1460000017,128
1361038663,1460044656,2,92,46,1361038637048,1361038637112,1460018704,1460018768,64
1361038667,1460048636,2,92,46,1361038639948,1361038639948,1460021584,1460021584,0
1361038667,1460048640,2,92,46,1361038640070,1361038640134,1460021710,1460021774,64
1361038683,1460064640,2,474,237,1361038658311,1361038658375,1460039951,1460040015,64
1361038697,1460078708,3,144,48,1361038696514,1361038696514,1460078222,1460078222,0
1361038699,1460080640,2,265,132.5,1361038674120,1361038674248,1460055760,1460055888,128
1361038713,1460094712,8,2940,367.5,1361038706686,1361038711806,1460088398,1460093518,5120
1361038713,1460094760,2,98,49,1361038706574,1361038711758,1460088334,1460093518,5184
1361038719,1460100756,72,71727,996.2083333,1361038694354,1361038706706,1460076110,1460088462,12352
1361038719,1460100792,1,46,46,1361038691245,1361038691245,1460073037,1460073037,0
1361038719,1460100832,1,46,46,1361038694216,1361038694216,1460076048,1460076048,0
1361038723,1460104920,2,474,237,1361038698158,1361038698286,1460080078,1460080206,128
1361038729,1460110696,4,312,78,1361038726990,1361038727054,1460108686,1460108750,64
1361038729,1460110696,3,774,258,1361038723086,1361038723214,1460104782,1460104910,128
1361038729,1460110696,4,312,78,1361038723149,1361038723213,1460104845,1460104909,64
1361038729,1460110704,4,312,78,1361038727305,1361038727433,1460109009,1460109137,128
1361038729,1460110704,4,312,78,1361038727431,1361038727495,1460109135,1460109199,64
1361038729,1460110708,5,796,159.2,1361038727556,1361038727620,1460109264,1460109328,64
1361038729,1460110708,4,312,78,1361038725058,1361038725122,1460106766,1460106830,64
1361038729,1460110712,7,2882,411.7142857,1361038722431,1361038728255,1460104143,1460109967,5824
1361038729,1460110712,6,2764,460.6666667,1361038722431,1361038728255,1460104143,1460109967,5824
1361038729,1460110712,2,98,49,1361038722431,1361038728063,1460104143,1460109775,5632
1361038729,1460110712,2,98,49,1361038722495,1361038728063,1460104207,1460109775,5568
1361038729,1460110712,4,312,78,1361038722495,1361038722559,1460104207,1460104271,64
1361038729,1460110712,3,712,237.3333333,1361038722685,1361038722749,1460104397,1460104461,64
1361038729,1460110716,4,313,78.25,1361038722812,1361038722876,1460104528,1460104592,64
1361038729,1460110716,4,312,78,1361038722748,1361038722812,1460104464,1460104528,64
1361038729,1460110716,4,312,78,1361038725884,1361038725948,1460107600,1460107664,64
1361038729,1460110736,4,312,78,1361038728744,1361038728808,1460110480,1460110544,64
1361038729,1460110740,4,313,78.25,1361038723234,1361038723362,1460104974,1460105102,128
1361038729,1460110744,4,312,78,1361038727390,1361038727454,1460109134,1460109198,64
1361038729,1460110748,6,848,141.3333333,1361038727513,1361038727577,1460109261,1460109325,64
1361038729,1460110748,4,312,78,1361038727516,1361038727644,1460109264,1460109392,128
1361038729,1460110748,4,312,78,1361038727516,1361038727644,1460109264,1460109392,128
1361038729,1460110748,15,16265,1084.333333,1361038724954,1361038725402,1460106702,1460107150,448
1361038729,1460110752,4,313,78.25,1361038722261,1361038722325,1460104013,1460104077,64
1361038729,1460110752,6,1830,305,1361038722392,1361038728216,1460104144,1460109968,5824
1361038729,1460110752,6,2624,437.3333333,1361038722392,1361038728472,1460104144,1460110224,6080
1361038729,1460110752,8,3686,460.75,1361038722392,1361038728216,1460104144,1460109968,5824
1361038729,1460110752,6,2016,336,1361038722392,1361038728216,1460104144,1460109968,5824
1361038729,1460110752,2,98,49,1361038722456,1361038728024,1460104208,1460109776,5568
1361038729,1460110752,2,98,49,1361038722456,1361038728024,1460104208,1460109776,5568
1361038729,1460110752,4,312,78,1361038722456,1361038722520,1460104208,1460104272,64
1361038729,1460110768,4,512,128,1361038722501,1361038722629,1460104269,1460104397,128
1361038729,1460110772,3,140,46.66666667,1361038722564,1361038728004,1460104336,1460109776,5440
1361038729,1460110772,4,312,78,1361038725763,1361038725827,1460107535,1460107599,64
1361038729,1460110772,6,1072,178.6666667,1361038722817,1361038722945,1460104589,1460104717,128
1361038729,1460110776,2,92,46,1361038722813,1361038728061,1460104589,1460109837,5248
1361038729,1460110776,2,98,49,1361038722813,1361038727997,1460104589,1460109773,5184
1361038729,1460110776,4,312,78,1361038722880,1361038722944,1460104656,1460104720,64
1361038729,1460110776,5,417,83.4,1361038726846,1361038727038,1460108622,1460108814,192
1361038731,1460112764,4,2025,506.25,1361038706377,1361038706697,1460088141,1460088461,320
1361038731,1460112768,5,437,87.4,1361038706693,1361038706821,1460088461,1460088589,128
1361038731,1460112768,4,2025,506.25,1361038706373,1361038706437,1460088141,1460088205,64
1361038731,1460112816,7,5656,808,1361038706583,1361038706711,1460088399,1460088527,128
1361038732,98426692,2,98,49,1361038723372,1361038729196,98418064,98423888,5824
1361038737,1460118700,3,150,50,1361038726924,1361038732108,1460108624,1460113808,5184
1361038737,1460118700,13,13215,1016.538462,1361038723020,1361038733516,1460104720,1460115216,10496
1361038737,1460118704,2,98,49,1361038727304,1361038733064,1460109008,1460114768,5760
1361038737,1460118704,2,98,49,1361038727303,1361038733063,1460109007,1460114767,5760
1361038737,1460118704,2,98,49,1361038727303,1361038733063,1460109007,1460114767,5760
1361038737,1460118704,3,144,48,1361038727367,1361038733063,1460109071,1460114767,5696
1361038737,1460118708,2,279,139.5,1361038727553,1361038733057,1460109261,1460114765,5504
1361038737,1460118712,18,19261,1070.055556,1361038725437,1361038733501,1460107149,1460115213,8064
1361038737,1460118712,10,7750,775,1361038725440,1361038730560,1460107152,1460112272,5120
1361038737,1460118712,11,9208,837.0909091,1361038725440,1361038730496,1460107152,1460112208,5056
1361038737,1460118712,2,92,46,1361038728064,1361038734080,1460109776,1460115792,6016
1361038737,1460118712,10,8235,823.5,1361038725439,1361038730495,1460107151,1460112207,5056
1361038737,1460118712,2,98,49,1361038725758,1361038731070,1460107470,1460112782,5312
1361038737,1460118712,2,92,46,1361038725885,1361038731069,1460107597,1460112781,5184
1361038737,1460118740,2,98,49,1361038726819,1361038732003,1460108559,1460113743,5184
1361038737,1460118744,13,12845,988.0769231,1361038722976,1361038733472,1460104720,1460115216,10496
1361038737,1460118744,2,279,139.5,1361038723167,1361038729055,1460104911,1460110799,5888
1361038737,1460118748,3,144,48,1361038727259,1361038733019,1460109007,1460114767,5760
1361038737,1460118748,2,98,49,1361038727322,1361038733018,1460109070,1460114766,5696
1361038737,1460118752,2,279,139.5,1361038727512,1361038733016,1460109264,1460114768,5504
1361038737,1460118756,8,5115,639.375,1361038725394,1361038730514,1460107150,1460112270,5120
1361038737,1460118756,20,8942,447.1,1361038728018,1361038733586,1460109774,1460115342,5568
1361038737,1460118756,8,4652,581.5,1361038725394,1361038730514,1460107150,1460112270,5120
1361038737,1460118760,2,98,49,1361038725709,1361038731021,1460107469,1460112781,5312
1361038737,1460118784,2,98,49,1361038726776,1361038731960,1460108560,1460113744,5184
1361038745,1460126716,15,16257,1083.8,1361038722233,1361038737849,1460103949,1460119565,15616
1361038745,1460126748,6,1782,297,1361038723099,1361038738331,1460104847,1460120079,15232
1361038747,1460128940,4,914,228.5,1361038722842,1361038723034,1460104782,1460104974,192
1361038748,1460128988,4,914,228.5,1361038723538,1361038723986,1460104526,1460104974,448
1361038748,1460128988,13,13476,1036.615385,1361038723537,1361038723921,1460104525,1460104909,384
1361038748,1460129032,4,1402,350.5,1361038722727,1361038725479,1460103759,1460106511,2752
1361038748,1460129036,5,982,196.4,1361038723297,1361038727137,1460104333,1460108173,3840
1361038752,1460132944,3,298,99.33333333,1361038726206,1361038726526,1460107150,1460107470,320
1361038752,1460132964,3,1562,520.6666667,1361038726505,1361038727017,1460107469,1460107981,512
1361038752,1460132972,9,5052,561.3333333,1361038727139,1361038727779,1460108111,1460108751,640
1361038752,1460132976,6,3883,647.1666667,1361038727584,1361038727904,1460108560,1460108880,320
1361038752,1460132976,3,498,166,1361038727520,1361038727584,1460108496,1460108560,64
1361038752,1460133012,3,298,99.33333333,1361038726073,1361038726137,1460107085,1460107149,64
1361038752,1460133016,14,16918,1208.428571,1361038726454,1361038726518,1460107470,1460107534,64
1361038752,1460133016,17,20950,1232.352941,1361038726518,1361038726582,1460107534,1460107598,64
1361038752,1460133016,4,2041,510.25,1361038726581,1361038726773,1460107597,1460107789,192
1361038752,1460133044,3,498,166,1361038727450,1361038727514,1460108494,1460108558,64
1361038752,1460133044,17,21342,1255.411765,1361038727514,1361038729050,1460108558,1460110094,1536
1361038752,1460133044,6,3879,646.5,1361038727514,1361038727898,1460108558,1460108942,384
1361038755,1460136928,4,1544,386,1361038727079,1361038727143,1460109007,1460109071,64
1361038755,1460136928,2,265,132.5,1361038729254,1361038729382,1460111182,1460111310,128
1361038755,1460136928,7,3890,555.7142857,1361038727078,1361038727142,1460109006,1460109070,64
1361038755,1460136932,4,907,226.75,1361038727204,1361038727268,1460109136,1460109200,64
1361038756,1460136968,3,353,117.6666667,1361038729448,1361038729512,1460110416,1460110480,64
1361038756,1460136972,7,2898,414,1361038727971,1361038729123,1460108943,1460110095,1152
1361038756,1460136972,5,1528,305.6,1361038727970,1361038728226,1460108942,1460109198,256
1361038756,1460136972,33,43032,1304,1361038728097,1361038728161,1460109069,1460109133,64
1361038756,1460136972,15,16666,1111.066667,1361038728097,1361038728161,1460109069,1460109133,64
1361038756,1460136976,4,907,226.75,1361038728156,1361038728156,1460109132,1460109132,0
1361038756,98450952,4,674,168.5,1361038728232,1361038728744,98423184,98423696,512
1361038761,1460142740,4,215,53.75,1361038751202,1361038759202,1460132942,1460140942,8000
1361038761,1460142748,3,144,48,1361038756506,1361038756506,1460138254,1460138254,0
1361038763,1460144940,2,474,237,1361038738714,1361038738778,1460120654,1460120718,64
1361038769,1460150736,4,312,78,1361038766181,1361038766245,1460147917,1460147981,64
1361038777,1460158736,2,123,61.5,1361038766246,1361038771238,1460147982,1460152974,4992
1361038779,1460160920,1,77,77,1361038751024,1361038751024,1460132944,1460132944,0
1361038784,1460164944,2,96,48,1361038757951,1361038760831,1460138895,1460141775,2880
1361038785,1460166716,9,7293,810.3333333,1361038766139,1361038782139,1460147855,1460163855,16000
1361038785,1460166716,5,1699,339.8,1361038766331,1361038782139,1460148047,1460163855,15808
1361038791,1460172924,13,2540,195.3846154,1361038763881,1361038787753,1460145805,1460169677,23872
1361038792,1460172960,2,92,46,1361038766767,1361038766831,1460147727,1460147791,64
1361038792,1460172960,2,92,46,1361038766764,1361038766828,1460147724,1460147788,64
1361038804,1460185112,2,474,237,1361038779220,1361038779284,1460160332,1460160396,64
1361038808,1460189044,1,46,46,1361038781784,1361038781784,1460162828,1460162828,0
1361038808,1460189048,2,92,46,1361038782932,1361038782932,1460163980,1460163980,0
1361038808,1460189116,2,92,46,1361038782800,1361038782864,1460163916,1460163980,64
1361038808,1460189116,2,92,46,1361038782864,1361038782864,1460163980,1460163980,0
1361038812,1460193060,2,92,46,1361038785930,1361038785930,1460166990,1460166990,0
1361038812,1460193096,2,265,132.5,1361038785445,1361038785509,1460166541,1460166605,64
1361038824,1460205064,1,77,77,1361038796933,1361038796933,1460177997,1460177997,0
1361038825,1460206704,3,144,48,1361038819268,1361038819332,1460200972,1460201036,64
1361038832,1460213060,6,3088,514.6666667,1361038805576,1361038827784,1460186636,1460208844,22208
1361038832,1460213100,7,3737,533.8571429,1361038805343,1361038827679,1460186443,1460208779,22336
1361038844,1460225128,2,474,237,1361038819139,1361038819203,1460200267,1460200331,64
1361038849,1460230800,6,366,61,1361038841188,1361038841188,1460222988,1460222988,0
1361038849,1460230812,3,169,56.33333333,1361038842648,1361038842648,1460224460,1460224460,0
1361038865,1460246816,2,94,47,1361038860244,1361038860244,1460242060,1460242060,0
1361038865,1460246824,4,336,84,1361038858637,1361038858701,1460240461,1460240525,64
1361038865,1460246856,2,98,49,1361038859436,1361038859500,1460241292,1460241356,64
1361038868,1460249104,1,46,46,1361038842332,1361038842332,1460223436,1460223436,0
1361038868,1460249104,1,46,46,1361038842332,1361038842332,1460223436,1460223436,0
1361038868,1460249112,2,265,132.5,1361038840852,1361038840916,1460221964,1460222028,64
1361038868,1460249136,1,46,46,1361038843326,1361038843326,1460224462,1460224462,0
1361038868,1460249136,1,46,46,1361038843326,1361038843326,1460224462,1460224462,0
1361038868,1460249136,1,46,46,1361038843326,1361038843326,1460224462,1460224462,0
1361038868,1460249140,1,46,46,1361038841338,1361038841338,1460222478,1460222478,0
1361038868,1460249152,1,46,46,1361038842285,1361038842285,1460223437,1460223437,0
1361038868,1460249152,1,46,46,1361038842285,1361038842285,1460223437,1460223437,0
1361038868,1460249152,1,46,46,1361038842284,1361038842284,1460223436,1460223436,0
1361038868,1460249180,1,46,46,1361038843279,1361038843279,1460224459,1460224459,0
1361038868,1460249180,1,46,46,1361038843279,1361038843279,1460224459,1460224459,0
1361038868,1460249180,1,46,46,1361038843279,1361038843279,1460224459,1460224459,0
1361038868,1460249180,1,46,46,1361038843279,1361038843279,1460224459,1460224459,0
1361038868,1460249184,1,46,46,1361038843278,1361038843278,1460224462,1460224462,0
1361038868,1460249184,1,46,46,1361038843278,1361038843278,1460224462,1460224462,0
1361038868,1460249184,1,46,46,1361038843278,1361038843278,1460224462,1460224462,0
1361038868,1460249184,1,46,46,1361038843278,1361038843278,1460224462,1460224462,0
1361038868,1460249188,1,46,46,1361038841290,1361038841290,1460222478,1460222478,0
1361038868,98562668,2,98,49,1361038863044,1361038867396,98557712,98562064,4352
1361038868,98562672,2,98,49,1361038862975,1361038866367,98557647,98561039,3392
1361038869,98563196,1,46,46,1361038844377,1361038844377,98538573,98538573,0
1361038872,1460253076,1,46,46,1361038844409,1361038844409,1460225485,1460225485,0
1361038872,1460253128,1,46,46,1361038844358,1361038844358,1460225486,1460225486,0
1361038872,1460253132,1,46,46,1361038845375,1361038845375,1460226507,1460226507,0
1361038880,1460261148,7,448,64,1361038855730,1361038863090,1460236878,1460244238,7360
1361038880,1460261188,7,448,64,1361038854537,1361038862153,1460235725,1460243341,7616
1361038881,1460262864,4,312,78,1361038880805,1361038880869,1460262669,1460262733,64
1361038884,1460265104,6,384,64,1361038856923,1361038862107,1460238027,1460243211,5184
1361038884,1460265108,6,384,64,1361038856857,1361038862105,1460237965,1460243213,5248
1361038884,1460265180,2,474,237,1361038859474,1361038859538,1460240654,1460240718,64
1361038888,1460269096,7,4712,673.1428571,1361038861475,1361038882403,1460242571,1460263499,20928
1361038888,1460269144,58,67383,1161.775862,1361038860916,1361038861748,1460242060,1460242892,832
1361038888,1460269144,6,3198,533,1361038861172,1361038861364,1460242316,1460242508,192
1361038888,1460269148,3,3028,1009.333333,1361038861426,1361038861490,1460242574,1460242638,64
1361038888,1460269148,5,437,87.4,1361038861743,1361038861871,1460242891,1460243019,128
1361038889,1460270832,6,1933,322.1666667,1361038881028,1361038881156,1460262860,1460262988,128
1361038889,1460270832,19,22864,1203.368421,1361038881028,1361038881284,1460262860,1460263116,256
1361038889,1460270832,5,1541,308.2,1361038881028,1361038881412,1460262860,1460263244,384
1361038889,1460270840,2,98,49,1361038881915,1361038887611,1460263755,1460269451,5696
1361038889,1460270848,15,16804,1120.266667,1361038880756,1361038881012,1460262604,1460262860,256
1361038889,1460270872,29,38586,1330.551724,1361038880988,1361038881308,1460262860,1460263180,320
1361038889,1460270872,72,103390,1435.972222,1361038880988,1361038881756,1460262860,1460263628,768
1361038889,1460270872,5,602,120.4,1361038880988,1361038881372,1460262860,1460263244,384
1361038898,1460278976,3,144,48,1361038892252,1361038892252,1460273228,1460273228,0
1361038905,1460286896,4,205,51.25,1361038903622,1361038903622,1460285518,1460285518,0
1361038908,1460289392,3,301,100.3333333,1361038881469,1361038882301,1460262861,1460263693,832
1361038908,1460289396,8,8578,1072.25,1361038881783,1361038882167,1460263179,1460263563,384
1361038908,1460289400,11,13094,1190.363636,1361038881909,1361038882357,1460263309,1460263757,448
1361038908,1460289404,7,3513,501.8571429,1361038882288,1361038882672,1460263692,1460264076,384
1361038908,1460289436,3,723,241,1361038880977,1361038881041,1460262413,1460262477,64
1361038908,1460289488,7,5388,769.7142857,1361038881117,1361038881885,1460262605,1460263373,768
1361038922,1460302956,4,215,53.75,1361038906994,1361038914994,1460287950,1460295950,8000
1361038922,1460303016,3,550,183.3333333,1361038918645,1361038918645,1460299661,1460299661,0
1361038924,1460305404,2,265,132.5,1361038895919,1361038896047,1460277323,1460277451,128
1361038924,1460305440,2,474,237,1361038899211,1361038899275,1460280651,1460280715,64
1361038929,1460310916,2,123,61.5,1361038920046,1361038925038,1460301962,1460306954,4992
1361038932,1460313424,1,77,77,1361038906524,1361038906524,1460287948,1460287948,0
1361038937,1460318888,2,98,49,1361038923917,1361038928973,1460305805,1460310861,5056
1361038937,1460318932,2,98,49,1361038923872,1361038928928,1460305804,1460310860,5056
1361038937,1460318932,2,98,49,1361038923871,1361038928927,1460305803,1460310859,5056
1361038937,1460318932,2,98,49,1361038923935,1361038929887,1460305867,1460311819,5952
1361038944,1460325488,5,3562,712.4,1361038917916,1361038924124,1460299404,1460305612,6208
1361038948,1460329440,3,1973,657.6666667,1361038923853,1361038923917,1460305293,1460305357,64
1361038953,1460334932,3,144,48,1361038951329,1361038951329,1460333261,1460333261,0
1361038956,1460337468,1,46,46,1361038929391,1361038929391,1460310859,1460310859,0
1361038964,1460345500,2,474,237,1361038939534,1361038939598,1460321034,1460321098,64
1361038968,1460349480,2,92,46,1361038941476,1361038941540,1460322956,1460323020,64
1361038976,1460357504,2,265,132.5,1361038951563,1361038951691,1460333067,1460333195,128
1361038976,1460357544,1,77,77,1361038951393,1361038951393,1460332937,1460332937,0
1361039001,1460382928,6,366,61,1361038996003,1361038996067,1460377931,1460377995,64
1361039004,1460385496,2,474,237,1361038978897,1361038978961,1460360393,1460360457,64
1361039008,1460389568,2,92,46,1361038982859,1361038982923,1460364427,1460364491,64
1361039012,1460393496,2,92,46,1361038983954,1361038984018,1460365450,1460365514,64
1361039024,1460405488,1,46,46,1361038996379,1361038996379,1460377867,1460377867,0
1361039024,1460405496,1,46,46,1361038997331,1361038997331,1460378827,1460378827,0
1361039024,1460405564,1,46,46,1361038997262,1361038997262,1460378826,1460378826,0
1361039024,1460405564,1,46,46,1361038997261,1361038997261,1460378825,1460378825,0
1361039032,1460413584,2,265,132.5,1361039007291,1361039007419,1460388875,1460389003,128
1361039034,1460415000,3,144,48,1361039027267,1361039027267,1460408267,1460408267,0
1361039044,1460425584,2,474,237,1361039018875,1361039018939,1460400459,1460400523,64
1361039084,1460465624,2,474,237,1361039058577,1361039058705,1460440201,1460440329,128
1361039088,1460469640,2,265,132.5,1361039063298,1361039063426,1460444938,1460445066,128
1361039090,1460471048,3,144,48,1361039087377,1361039087377,1460468425,1460468425,0
1361039116,1460497604,11,1971,179.1818182,1361039088163,1361039088675,1460469767,1460470279,512
1361039124,1460505664,2,474,237,1361039098601,1361039098665,1460480265,1460480329,64
1361039144,1460525620,2,265,132.5,1361039118419,1361039118547,1460500039,1460500167,128
1361039164,1460545644,2,474,237,1361039138875,1361039138939,1460520519,1460520583,64
1361039178,1460559028,3,144,48,1361039170210,1361039170210,1460551238,1460551238,0
1361039180,98874732,2,98,49,1361039173318,1361039178246,98868050,98872978,4928
1361039180,98874736,2,98,49,1361039173249,1361039177217,98867985,98871953,3968
1361039200,1460581688,2,265,132.5,1361039173903,1361039173967,1460555591,1460555655,64
1361039204,1460585736,2,474,237,1361039179167,1361039179295,1460560903,1460561031,128
1361039210,1460591112,4,205,51.25,1361039204750,1361039204750,1460585862,1460585862,0
1361039242,1460623152,3,144,48,1361039237096,1361039237096,1460618248,1460618248,0
1361039244,1460625912,2,474,237,1361039218605,1361039218669,1460600517,1460600581,64
1361039245,1460626016,1,46,46,1361039220400,1361039220400,1460601416,1460601416,0
1361039256,1460637680,2,265,132.5,1361039229142,1361039229270,1460610822,1460610950,128
1361039272,1460653724,7,1450,207.1428571,1361039244329,1361039244905,1460626053,1460626629,576
1361039284,1460665792,2,474,237,1361039258470,1361039258534,1460640262,1460640326,64
1361039312,1460693772,2,265,132.5,1361039284537,1361039284665,1460666309,1460666437,128
1361039314,1460695216,3,144,48,1361039312037,1361039312037,1460693253,1460693253,0
1361039324,1460705808,2,474,237,1361039298901,1361039299029,1460680709,1460680837,128
1361039362,1460743216,4,205,51.25,1361039360868,1361039360868,1460742084,1460742084,0
1361039364,1460745836,2,474,237,1361039338554,1361039338618,1460720390,1460720454,64
1361039368,1460749824,2,265,132.5,1361039340039,1361039340103,1460721863,1460721927,64
1361039378,1460759200,2,98,49,1361039370102,1361039375798,1460751302,1460756998,5696
1361039378,1460759212,4,312,78,1361039374763,1361039374827,1460755975,1460756039,64
1361039378,1460759252,4,312,78,1361039374336,1361039374400,1460755588,1460755652,64
1361039378,1460759256,4,312,78,1361039374590,1361039374718,1460755846,1460755974,128
1361039386,1460767212,2,98,49,1361039373674,1361039378794,1460754886,1460760006,5120
1361039386,1460767212,3,150,50,1361039373673,1361039378793,1460754885,1460760005,5120
1361039386,1460767212,3,150,50,1361039373673,1361039378793,1460754885,1460760005,5120
1361039386,1460767212,3,150,50,1361039373673,1361039378793,1460754885,1460760005,5120
1361039386,1460767212,3,150,50,1361039373673,1361039378793,1460754885,1460760005,5120
1361039386,1460767212,2,98,49,1361039374056,1361039379752,1460755268,1460760964,5696
1361039386,1460767216,2,94,47,1361039374307,1361039379811,1460755523,1460761027,5504
1361039386,1460767252,2,98,49,1361039373697,1361039378753,1460754949,1460760005,5056
1361039386,1460767256,2,94,47,1361039374206,1361039379774,1460755462,1460761030,5568
1361039394,1460775228,3,144,48,1361039386969,1361039387033,1460768197,1460768261,64
1361039396,1460777844,11,9292,844.7272727,1361039369392,1361039395696,1460751236,1460777540,26304
1361039396,1460777876,15,11822,788.1333333,1361039369103,1361039394319,1460750979,1460776195,25216
1361039396,1460777888,13,10893,837.9230769,1361039369350,1361039395398,1460751238,1460777286,26048
1361039396,1460777888,5,437,87.4,1361039369476,1361039369604,1460751364,1460751492,128
1361039396,1460777892,9,4385,487.2222222,1361039369792,1361039369920,1460751684,1460751812,128
1361039400,1460781824,4,1367,341.75,1361039372803,1361039398915,1460754627,1460780739,26112
1361039400,1460781828,9,6353,705.8888889,1361039372993,1361039399233,1460754821,1460781061,26240
1361039400,1460781828,4,2308,577,1361039373120,1361039373376,1460754948,1460755204,256
1361039400,1460781832,7,7000,1000,1361039373628,1361039373756,1460755460,1460755588,128
1361039400,1460781832,8,2400,300,1361039373947,1361039374011,1460755779,1460755843,64
1361039400,1460781836,35,44873,1282.085714,1361039374010,1361039374138,1460755846,1460755974,128
1361039400,1460781876,4,1755,438.75,1361039373009,1361039373393,1460754885,1460755269,384
1361039400,1460781876,14,13502,964.4285714,1361039373136,1361039373456,1460755012,1460755332,320
1361039400,1460781900,3,426,142,1361039373625,1361039373689,1460755525,1460755589,64
1361039400,1460781900,8,4383,547.875,1361039373752,1361039373880,1460755652,1460755780,128
1361039402,1460783208,8,6953,869.125,1361039400941,1361039401197,1460782149,1460782405,256
1361039402,1460783244,4,312,78,1361039399752,1361039399816,1460780996,1460781060,64
1361039402,1460783248,5,1318,263.6,1361039400262,1361039400390,1460781510,1460781638,128
1361039402,1460783248,7,5007,715.2857143,1361039400326,1361039400518,1460781574,1460781766,192
1361039402,1460783248,5,828,165.6,1361039400198,1361039400326,1460781446,1460781574,128
1361039402,1460783248,5,1447,289.4,1361039400198,1361039400326,1460781446,1460781574,128
1361039402,1460783248,7,5880,840,1361039400198,1361039400390,1460781446,1460781638,192
1361039402,1460783248,4,312,78,1361039400198,1361039400262,1460781446,1460781510,64
1361039402,1460783248,4,312,78,1361039400262,1361039400390,1460781510,1460781638,128
1361039402,1460783248,4,552,138,1361039400390,1361039400454,1460781638,1460781702,64
1361039402,1460783252,23,29789,1295.173913,1361039400833,1361039401217,1460782085,1460782469,384
1361039402,1460783252,5,571,114.2,1361039400833,1361039400961,1460782085,1460782213,128
1361039402,1460783252,6,3416,569.3333333,1361039401024,1361039401152,1460782276,1460782404,128
1361039402,1460783252,3,421,140.3333333,1361039401024,1361039401088,1460782276,1460782340,64
1361039402,1460783252,4,312,78,1361039401024,1361039401152,1460782276,1460782404,128
1361039402,1460783260,4,312,78,1361039401785,1361039401849,1460783045,1460783109,64
1361039402,1460783288,21,26959,1283.761905,1361039399643,1361039400091,1460780931,1460781379,448
1361039402,1460783292,5,1306,261.2,1361039400153,1361039400281,1460781445,1460781573,128
1361039402,1460783292,15,17092,1139.466667,1361039400153,1361039400473,1460781445,1460781765,320
1361039402,1460783292,4,312,78,1361039400153,1361039400217,1460781445,1460781509,64
1361039402,1460783292,66,94321,1429.106061,1361039400153,1361039400729,1460781445,1460782021,576
1361039402,1460783292,7,5060,722.8571429,1361039400281,1361039400473,1460781573,1460781765,192
1361039402,1460783292,7,5021,717.2857143,1361039400281,1361039400473,1460781573,1460781765,192
1361039402,1460783292,5,667,133.4,1361039400345,1361039400473,1460781637,1460781765,128
1361039402,1460783292,5,1544,308.8,1361039400472,1361039400600,1460781764,1460781892,128
1361039402,1460783292,46,63955,1390.326087,1361039400472,1361039400984,1460781764,1460782276,512
1361039405,1460786168,2,474,237,1361039379734,1361039379798,1460760902,1460760966,64
1361039410,1460791212,2,98,49,1361039402280,1361039407784,1460783492,1460788996,5504
1361039410,1460791212,26,31813,1223.576923,1361039402343,1361039403623,1460783555,1460784835,1280
1361039410,1460791216,3,140,46.66666667,1361039401062,1361039406758,1460782278,1460787974,5696
1361039410,1460791248,8,2069,258.625,1361039400132,1361039405700,1460781380,1460786948,5568
1361039410,1460791248,8,2070,258.75,1361039400132,1361039405700,1460781380,1460786948,5568
1361039410,1460791248,7,1600,228.5714286,1361039400131,1361039405699,1460781379,1460786947,5568
1361039410,1460791248,9,2567,285.2222222,1361039400131,1361039405699,1460781379,1460786947,5568
1361039410,1460791248,10,5465,546.5,1361039400131,1361039405699,1460781379,1460786947,5568
1361039410,1460791248,7,1614,230.5714286,1361039400131,1361039405699,1460781379,1460786947,5568
1361039410,1460791252,3,140,46.66666667,1361039400959,1361039406719,1460782211,1460787971,5760
1361039410,1460791292,7,2903,414.7142857,1361039400090,1361039405658,1460781382,1460786950,5568
1361039410,1460791292,6,1157,192.8333333,1361039400090,1361039405658,1460781382,1460786950,5568
1361039410,1460791292,6,1130,188.3333333,1361039400090,1361039405658,1460781382,1460786950,5568
1361039410,1460791292,9,3857,428.5555556,1361039400090,1361039405658,1460781382,1460786950,5568
1361039410,1460791292,8,3822,477.75,1361039400090,1361039405658,1460781382,1460786950,5568
1361039410,1460791292,11,8990,817.2727273,1361039400090,1361039405658,1460781382,1460786950,5568
1361039410,1460791292,3,144,48,1361039400153,1361039405209,1460781445,1460786501,5056
1361039417,1460798084,12,3306,275.5,1361039389287,1361039389735,1460770371,1460770819,448
1361039421,1460802160,2,265,132.5,1361039396446,1361039396574,1460777606,1460777734,128
1361039425,1460806104,9,5548,616.4444444,1361039398100,1361039401556,1460779204,1460782660,3456
1361039425,1460806104,8,6419,802.375,1361039398355,1361039399635,1460779459,1460780739,1280
1361039425,1460806140,37,50562,1366.540541,1361039400240,1361039401968,1460781380,1460783108,1728
1361039425,1460806140,5,1823,364.6,1361039400303,1361039401135,1460781443,1460782275,832
1361039426,1460807264,3,169,56.33333333,1361039415091,1361039423091,1460796355,1460804355,8000
1361039429,1460810132,3,514,171.3333333,1361039400889,1361039400953,1460782021,1460782085,64
1361039429,1460810140,4,2058,514.5,1361039401457,1361039401713,1460782597,1460782853,256
1361039429,1460810144,23,32619,1418.217391,1361039401834,1361039401898,1460782978,1460783042,64
1361039429,1460810184,3,2884,961.3333333,1361039400901,1361039401157,1460782085,1460782341,256
1361039429,1460810184,5,2887,577.4,1361039401028,1361039401796,1460782212,1460782980,768
1361039429,1460810204,12,12711,1059.25,1361039401391,1361039401839,1460782595,1460783043,448
1361039434,1460815240,4,190,47.5,1361039426124,1361039426380,1460807364,1460807620,256
1361039434,1460815244,4,190,47.5,1361039426377,1361039426633,1460807621,1460807877,256
1361039434,1460815244,4,190,47.5,1361039426377,1361039427081,1460807621,1460808325,704
1361039434,1460815244,4,190,47.5,1361039425608,1361039426376,1460806852,1460807620,768
1361039434,1460815248,4,190,47.5,1361039430213,1361039430277,1460811461,1460811525,64
1361039434,1460815248,4,190,47.5,1361039430340,1361039430468,1460811588,1460811716,128
1361039434,1460815248,4,190,47.5,1361039430339,1361039430403,1460811587,1460811651,64
1361039434,1460815248,4,190,47.5,1361039427138,1361039427394,1460808386,1460808642,256
1361039434,1460815248,4,190,47.5,1361039430594,1361039430658,1460811842,1460811906,64
1361039434,1460815252,4,190,47.5,1361039430526,1361039430590,1460811778,1460811842,64
1361039434,1460815252,4,190,47.5,1361039427393,1361039427649,1460808645,1460808901,256
1361039434,1460815252,4,190,47.5,1361039427456,1361039427712,1460808708,1460808964,256
1361039434,1460815252,4,190,47.5,1361039430720,1361039431104,1460811972,1460812356,384
1361039434,1460815252,4,190,47.5,1361039430784,1361039431104,1460812036,1460812356,320
1361039434,1460815252,4,190,47.5,1361039430784,1361039431168,1460812036,1460812420,384
1361039434,1460815252,4,190,47.5,1361039431167,1361039431551,1460812419,1460812803,384
1361039434,1460815252,4,190,47.5,1361039431167,1361039431487,1460812419,1460812739,320
1361039434,1460815252,4,190,47.5,1361039427647,1361039427903,1460808899,1460809155,256
1361039434,1460815252,4,190,47.5,1361039427583,1361039427839,1460808835,1460809091,256
1361039434,1460815256,4,190,47.5,1361039431102,1361039431486,1460812358,1460812742,384
1361039434,1460815256,4,190,47.5,1361039431485,1361039433661,1460812741,1460814917,2176
1361039434,1460815256,4,190,47.5,1361039427837,1361039428093,1460809093,1460809349,256
1361039434,1460815256,4,190,47.5,1361039431484,1361039431804,1460812740,1460813060,320
1361039434,1460815276,4,190,47.5,1361039431846,1361039432230,1460813122,1460813506,384
1361039434,1460815280,4,190,47.5,1361039432166,1361039432550,1460813446,1460813830,384
1361039434,1460815284,4,190,47.5,1361039428898,1361039429410,1460810182,1460810694,512
1361039434,1460815284,4,190,47.5,1361039426144,1361039426400,1460807428,1460807684,256
1361039434,1460815284,4,190,47.5,1361039429407,1361039429855,1460810691,1460811139,448
1361039434,1460815288,4,190,47.5,1361039426397,1361039426653,1460807685,1460807941,256
1361039434,1460815288,4,190,47.5,1361039425564,1361039426332,1460806852,1460807620,768
1361039434,1460815288,4,190,47.5,1361039425564,1361039426396,1460806852,1460807684,832
1361039434,1460815288,4,190,47.5,1361039429851,1361039430299,1460811139,1460811587,448
1361039434,1460815288,4,190,47.5,1361039426651,1361039428827,1460807939,1460810115,2176
1361039434,1460815288,4,190,47.5,1361039426586,1361039426842,1460807874,1460808130,256
1361039434,1460815292,4,190,47.5,1361039430234,1361039430298,1460811526,1460811590,64
1361039434,1460815292,4,190,47.5,1361039430169,1361039430681,1460811461,1460811973,512
1361039434,1460815292,4,190,47.5,1361039426777,1361039427097,1460808069,1460808389,320
1361039434,1460815292,4,190,47.5,1361039430360,1361039430488,1460811652,1460811780,128
1361039434,1460815292,4,190,47.5,1361039430296,1361039430808,1460811588,1460812100,512
1361039434,1460815292,4,190,47.5,1361039426840,1361039427096,1460808132,1460808388,256
1361039434,1460815292,4,190,47.5,1361039430488,1361039430552,1460811780,1460811844,64
1361039434,1460815292,4,190,47.5,1361039430424,1361039430488,1460811716,1460811780,64
1361039434,1460815292,4,190,47.5,1361039430488,1361039430616,1460811780,1460811908,128
1361039434,1460815292,4,190,47.5,1361039427095,1361039427415,1460808387,1460808707,320
1361039434,1460815292,4,190,47.5,1361039427287,1361039427543,1460808579,1460808835,256
1361039434,1460815292,4,190,47.5,1361039430742,1361039431126,1460812034,1460812418,384
1361039434,1460815296,4,190,47.5,1361039431124,1361039431444,1460812420,1460812740,320
1361039434,1460815296,4,190,47.5,1361039427668,1361039427924,1460808964,1460809220,256
1361039434,1460815316,4,190,47.5,1361039427840,1361039428224,1460809156,1460809540,384
1361039434,1460815316,4,190,47.5,1361039427904,1361039430016,1460809220,1460811332,2112
1361039434,1460815316,4,190,47.5,1361039428032,1361039430208,1460809348,1460811524,2176
1361039434,1460815316,4,190,47.5,1361039431423,1361039433599,1460812739,1460814915,2176
1361039434,1460815316,4,190,47.5,1361039431423,1361039431743,1460812739,1460813059,320
1361039434,1460815316,4,190,47.5,1361039428222,1361039430334,1460809538,1460811650,2112
1361039434,1460815320,4,190,47.5,1361039431740,1361039432124,1460813060,1460813444,384
1361039441,1460822140,1,77,77,1361039415215,1361039415215,1460796355,1460796355,0
1361039445,1460826196,2,474,237,1361039419703,1361039419767,1460800899,1460800963,64
1361039453,1460834204,1,52,52,1361039428527,1361039428527,1460809731,1460809731,0
1361039461,1460842164,2,92,46,1361039433366,1361039433430,1460814530,1460814594,64
1361039466,1460847256,3,200,66.66666667,1361039454267,1361039459323,1460835523,1460840579,5056
1361039466,1460847304,3,144,48,1361039461901,1361039461965,1460843205,1460843269,64
1361039477,1460858272,2,265,132.5,1361039451693,1361039451821,1460832965,1460833093,128
1361039485,1460866208,2,92,46,1361039457516,1361039457580,1460838724,1460838788,64
1361039485,1460866248,2,92,46,1361039460290,1361039460354,1460841538,1460841602,64
1361039485,1460866288,2,474,237,1361039459417,1361039459609,1460840705,1460840897,192
1361039485,1460866292,1,77,77,1361039459990,1361039459990,1460841282,1460841282,0
1361039485,1460866296,2,92,46,1361039460435,1361039460499,1460841731,1460841795,64
1361039490,1460871288,3,169,56.33333333,1361039489692,1361039489692,1460870980,1460870980,0
1361039501,1460882256,2,92,46,1361039475961,1361039476025,1460857217,1460857281,64
1361039506,1460887276,6,366,61,1361039504933,1361039504997,1460886209,1460886273,64
1361039506,1460887284,8,544,68,1361039498589,1361039503645,1460879873,1460884929,5056
1361039506,1460887332,2,98,49,1361039498798,1361039504622,1460880130,1460885954,5824
1361039506,1460887332,2,98,49,1361039498798,1361039504622,1460880130,1460885954,5824
1361039506,1460887368,4,205,51.25,1361039504588,1361039504588,1460885956,1460885956,0
1361039513,1460894304,1,46,46,1361039488650,1361039488650,1460869954,1460869954,0
1361039517,1460898372,1,46,46,1361039489605,1361039489605,1460870977,1460870977,0
1361039517,1460898376,1,46,46,1361039489604,1361039489604,1460870980,1460870980,0
1361039517,1460898376,1,46,46,1361039489668,1361039489668,1460871044,1460871044,0
1361039525,1460906304,10,6493,649.3,1361039498635,1361039499595,1460879939,1460880899,960
1361039525,1460906304,10,6493,649.3,1361039498635,1361039499787,1460879939,1460881091,1152
1361039525,1460906384,8,6083,760.375,1361039498488,1361039514296,1460879872,1460895680,15808
1361039525,1460906392,5,484,96.8,1361039498996,1361039499252,1460880388,1460880644,256
1361039525,1460906392,2,474,237,1361039499251,1361039499315,1460880643,1460880707,64
1361039533,1460914396,2,265,132.5,1361039507309,1361039507373,1460888705,1460888769,64
1361039538,1460919428,3,144,48,1361039536844,1361039536972,1460918272,1460918400,128
1361039541,1460922356,1,46,46,1361039516567,1361039516567,1460897923,1460897923,0
1361039541,1460922356,1,46,46,1361039516567,1361039516567,1460897923,1460897923,0
1361039541,1460922364,1,46,46,1361039514572,1361039514572,1460895936,1460895936,0
1361039545,1460926280,1,46,46,1361039517667,1361039517667,1460898947,1460898947,0
1361039545,1460926280,1,46,46,1361039517667,1361039517667,1460898947,1460898947,0
1361039545,1460926332,1,46,46,1361039517612,1361039517612,1460898944,1460898944,0
1361039545,1460926332,1,46,46,1361039517612,1361039517612,1460898944,1460898944,0
1361039554,1460935448,2,123,61.5,1361039543802,1361039551802,1460925250,1460933250,8000
1361039565,1460946636,2,474,237,1361039539263,1361039539327,1460920899,1460920963,64
1361039585,1460966584,2,92,46,1361039559153,1361039559153,1460940737,1460940737,0
1361039585,1460966652,2,92,46,1361039559084,1361039559084,1460940736,1460940736,0
1361039586,1460967408,3,200,66.66666667,1361039574113,1361039579169,1460955521,1460960577,5056
1361039589,1460970596,2,265,132.5,1361039562981,1361039563045,1460944577,1460944641,64
1361039605,1460986648,2,474,237,1361039579250,1361039579314,1460960898,1460960962,64
1361039618,1460999444,3,144,48,1361039611774,1361039611838,1460993218,1460993282,64
1361039641,1461022680,1,46,46,1361039613265,1361039613265,1460994945,1460994945,0
1361039645,1461026756,2,265,132.5,1361039618884,1361039619012,1461000640,1461000768,128
1361039645,1461026760,2,474,237,1361039619519,1361039619583,1461001279,1461001343,64
1361039650,1461031480,245,163955,669.2040816,1361039365017,1361039648857,1460746497,1461030337,283840
1361039658,1461039472,4,312,78,1361039653090,1361039653154,1461034562,1461034626,64
1361039658,1461039512,13,5365,412.6923077,1361039652215,1361039657271,1461033727,1461038783,5056
1361039660,99354816,8,544,68,1361039652595,1361039658099,99347411,99352915,5504
1361039666,1461047500,2,92,46,1361039653062,1361039658438,1461034562,1461039938,5376
1361039666,1461047500,6,1360,226.6666667,1361039652806,1361039658310,1461034306,1461039810,5504
1361039666,1461047544,2,92,46,1361039652953,1361039658393,1461034497,1461039937,5440
1361039674,1461055516,3,144,48,1361039671732,1361039671732,1461053248,1461053248,0
1361039677,1461058696,31,35695,1151.451613,1361039650047,1361039651903,1461031743,1461033599,1856
1361039677,1461058748,6,2467,411.1666667,1361039652747,1361039652939,1461034495,1461034687,192
1361039677,1461058748,7,4466,638,1361039652555,1361039652619,1461034303,1461034367,64
1361039677,1461058748,6,4154,692.3333333,1361039652555,1361039652619,1461034303,1461034367,64
1361039677,1461058824,6,4234,705.6666667,1361039652480,1361039652544,1461034304,1461034368,64
1361039677,1461058824,6,4058,676.3333333,1361039652480,1361039652544,1461034304,1461034368,64
1361039677,1461058824,6,2467,411.1666667,1361039652671,1361039653119,1461034495,1461034943,448
1361039677,1461058828,28,32155,1148.392857,1361039652478,1361039653182,1461034306,1461035010,704
1361039677,1461058828,7,4327,618.1428571,1361039652478,1361039652606,1461034306,1461034434,128
1361039678,99372412,7,4434,633.4285714,1361039652489,1361039653001,99346901,99347413,512
1361039685,1461066736,3,526,175.3333333,1361039659545,1361039659609,1461041281,1461041345,64
1361039693,1461074736,1,46,46,1361039665241,1361039665241,1461046977,1461046977,0
1361039701,1461082720,2,265,132.5,1361039674601,1361039674729,1461056321,1461056449,128
1361039718,1461099076,8,2039,254.875,1361039689835,1361039690219,1461070911,1461071295,384
1361039725,1461106804,2,474,237,1361039700181,1361039700245,1461081985,1461082049,64
1361039730,1461111492,11,953,86.63636364,1361039719179,1361039729035,1461100671,1461110527,9856
1361039730,1461111528,11,953,86.63636364,1361039718889,1361039729001,1461100417,1461110529,10112
1361039730,1461111528,12,999,83.25,1361039719398,1361039728998,1461100926,1461110526,9600
1361039746,1461127508,4,312,78,1361039740539,1361039740667,1461122047,1461122175,128
1361039746,1461127508,4,312,78,1361039740666,1361039740794,1461122174,1461122302,128
1361039746,1461127508,4,312,78,1361039740730,1361039740858,1461122238,1461122366,128
1361039746,1461127564,4,312,78,1361039740610,1361039740674,1461122174,1461122238,64
1361039749,1461130916,2,583,291.5,1361039724516,1361039724772,1461106432,1461106688,256
1361039754,1461135492,3,144,48,1361039746761,1361039746761,1461128253,1461128253,0
1361039757,1461138828,2,265,132.5,1361039730425,1361039730489,1461112253,1461112317,64
1361039761,1461142848,9,861,95.66666667,1361039736678,1361039736870,1461118526,1461118718,192
1361039761,1461142920,12,6151,512.5833333,1361039736222,1361039736542,1461118142,1461118462,320
1361039765,1461146800,9,861,95.66666667,1361039736981,1361039737173,1461118781,1461118973,192
1361039765,1461146844,15,15072,1004.8,1361039740202,1361039740394,1461122046,1461122238,192
1361039765,1461146880,9,861,95.66666667,1361039737221,1361039737349,1461119101,1461119229,128
1361039765,1461146920,3,1147,382.3333333,1361039739934,1361039739998,1461121854,1461121918,64
1361039765,1461146920,2,474,237,1361039739998,1361039740062,1461121918,1461121982,64
1361039770,1461151516,3,169,56.33333333,1361039768369,1361039768369,1461149885,1461149885,0
1361039770,1461151540,3,169,56.33333333,1361039768345,1361039768345,1461149885,1461149885,0
1361039770,1461151540,3,169,56.33333333,1361039768345,1361039768345,1461149885,1461149885,0
1361039770,1461151548,4,205,51.25,1361039769365,1361039769365,1461150913,1461150913,0
1361039770,1461151580,2,123,61.5,1361039768306,1361039768306,1461149886,1461149886,0
1361039770,1461151580,3,169,56.33333333,1361039768306,1361039768306,1461149886,1461149886,0
1361039772,99466960,3,169,56.33333333,1361039768102,1361039768102,99463062,99463062,0
1361039793,1461174856,1,46,46,1361039768221,1361039768221,1461150077,1461150077,0
1361039797,1461178820,1,46,46,1361039769216,1361039769216,1461151036,1461151036,0
1361039805,1461186944,2,474,237,1361039779975,1361039780039,1461161919,1461161983,64
1361039806,1461186964,1,46,46,1361039781209,1361039781209,1461162173,1461162173,0
1361039813,1461194860,2,96,48,1361039786204,1361039789020,1461168064,1461170880,2816
1361039813,1461194860,2,265,132.5,1361039786330,1361039786458,1461168190,1461168318,128
1361039826,1461207516,3,144,48,1361039821683,1361039821747,1461203199,1461203263,64
1361039842,1461223564,4,205,51.25,1361039840384,1361039840384,1461221948,1461221948,0
1361039845,1461226936,2,474,237,1361039820110,1361039820174,1461202046,1461202110,64
1361039869,1461250932,2,265,132.5,1361039841427,1361039841555,1461223359,1461223487,128
1361039882,1461263032,1,46,46,1361039856855,1361039856855,1461237887,1461237887,0
1361039882,1461263112,1,46,46,1361039856772,1361039856772,1461237884,1461237884,0
1361039886,1461267028,2,474,237,1361039861019,1361039861083,1461242047,1461242111,64
1361039898,1461279692,3,144,48,1361039896512,1361039896576,1461278204,1461278268,64
1361039922,1461303696,3,189,63,1361039918653,1361039921661,1461300349,1461303357,3008
1361039926,1461307020,2,265,132.5,1361039898399,1361039898527,1461279419,1461279547,128
1361039926,1461307116,2,474,237,1361039900096,1361039900160,1461281212,1461281276,64
1361039938,1461319676,2,126,63,1361039925710,1361039933774,1461307386,1461315450,8064
1361039946,1461327696,2,126,63,1361039943933,1361039944957,1461325629,1461326653,1024
1361039954,1461335720,2,126,63,1361039946916,1361039950948,1461328636,1461332668,4032
1361039954,1461335760,4,788,197,1361039937147,1361039953531,1461318907,1461335291,16384
1361039966,1461347140,7,2996,428,1361039941033,1361039958377,1461322173,1461339517,17344
1361039978,1461359660,3,189,63,1361039973278,1361039976286,1461354938,1461357946,3008
1361039982,1461363036,5,1095,219,1361039954896,1361039973648,1461335932,1461354684,18752
1361039986,1461367104,1,63,63,1361039959627,1361039959627,1461340731,1461340731,0
1361039994,1461375692,2,126,63,1361039980289,1361039988353,1461361981,1461370045,8064
1361040002,1461383088,2,495,247.5,1361039976093,1361040001053,1461357181,1461382141,24960
1361040018,1461399096,1,219,219,1361039993556,1361039993556,1461374652,1461374652,0
1361040038,1461419116,1,428,428,1361040011328,1361040011328,1461392444,1461392444,0
1361040046,1461427060,1,60,60,1361040018680,1361040018680,1461399740,1461399740,0
1361040050,1461431116,1,60,60,1361040021950,1361040021950,1461403066,1461403066,0
1361040050,1461431704,11,5439,494.4545455,1361040042036,1361040047796,1461423740,1461429500,5760
1361040050,1461431716,8,535,66.875,1361040043816,1361040049832,1461425532,1461431548,6016
1361040050,1461431716,8,535,66.875,1361040043815,1361040049831,1461425531,1461431547,6016
1361040050,1461431720,7,1459,208.4285714,1361040044452,1361040049828,1461426172,1461431548,5376
1361040050,1461431744,4,336,84,1361040049099,1361040049227,1461430843,1461430971,128
1361040050,1461431744,6,1848,308,1361040040907,1361040043019,1461422651,1461424763,2112
1361040050,1461431756,8,535,66.875,1361040043775,1361040049791,1461425531,1461431547,6016
1361040052,99747080,2,98,49,1361040046829,1361040051309,99741909,99746389,4480
1361040052,99747084,2,98,49,1361040046828,1361040050284,99741912,99745368,3456
1361040054,1461435164,1,60,60,1361040026896,1361040026896,1461408060,1461408060,0
1361040058,1461439100,1,219,219,1361040033616,1361040033616,1461414716,1461414716,0
1361040066,1461447404,9,5369,596.5555556,1361040041056,1361040041440,1461422460,1461422844,384
1361040066,1461447476,1,60,60,1361040040152,1361040040152,1461421628,1461421628,0
1361040066,1461447744,5,770,154,1361040060811,1361040061323,1461442555,1461443067,512
1361040066,1461447744,4,312,78,1361040060810,1361040060938,1461442554,1461442682,128
1361040066,1461447788,12,5489,457.4166667,1361040060894,1361040061278,1461442682,1461443066,384
1361040070,1461451400,7,1450,207.1428571,1361040044132,1361040044580,1461425532,1461425980,448
1361040070,1461451400,11,2161,196.4545455,1361040044132,1361040044452,1461425532,1461425852,320
1361040070,1461451408,1,46,46,1361040045340,1361040045340,1461426748,1461426748,0
1361040070,1461451448,1,76,76,1361040042737,1361040042737,1461424185,1461424185,0
1361040070,1461451452,2,98,49,1361040043181,1361040043245,1461424633,1461424697,64
1361040070,1461451484,9,1676,186.2222222,1361040044047,1361040044239,1461425531,1461425723,192
1361040082,1461463712,5,633,126.6,1361040074793,1361040080681,1461456505,1461462393,5888
1361040082,1461463716,4,205,51.25,1361040074852,1361040074852,1461456568,1461456568,0
1361040082,1461463716,3,189,63,1361040075046,1361040078118,1461456762,1461459834,3072
1361040082,1461463760,4,205,51.25,1361040074808,1361040074808,1461456568,1461456568,0
1361040082,1461463760,4,205,51.25,1361040074808,1361040074808,1461456568,1461456568,0
1361040082,1461463760,3,569,189.6666667,1361040075258,1361040078394,1461457018,1461460154,3136
1361040090,1461471428,2,120,60,1361040065670,1361040068678,1461447098,1461450106,3008
1361040090,1461471508,2,120,60,1361040065589,1361040068597,1461447097,1461450105,3008
1361040098,1461479464,2,120,60,1361040070628,1361040073636,1461452092,1461455100,3008
1361040098,1461479716,2,126,63,1361040082148,1361040090148,1461463864,1461471864,8000
1361040106,1461487432,2,120,60,1361040080642,1361040083650,1461462074,1461465082,3008
1361040174,1461555492,1,46,46,1361040148038,1361040148038,1461529530,1461529530,0
1361040178,1461559620,1,46,46,1361040151238,1361040151238,1461532858,1461532858,0
1361040182,1461563596,1,46,46,1361040154718,1361040154718,1461536314,1461536314,0
1361040198,1461579524,1,46,46,1361040169957,1361040169957,1461551481,1461551481,0
1361040347,1461728860,7,2638,376.8571429,1361040346002,1361040346194,1461727862,1461728054,192
1361040363,1461744252,12,999,83.25,1361040346994,1361040358514,1461728246,1461739766,11520
1361040363,1461744252,11,953,86.63636364,1361040347312,1361040358512,1461728564,1461739764,11200
1361040363,1461744300,17,6755,397.3529412,1361040347521,1361040358401,1461728821,1461739701,10880
1361040363,1461744340,21,15623,743.952381,1361040346267,1361040355995,1461727607,1461737335,9728
1361040363,1461744340,16,6372,398.25,1361040346330,1361040358426,1461727670,1461739766,12096
1361040374,1461755924,3,138,46,1361040346130,1361040346194,1461728054,1461728118,64
1361040415,1461795948,9,861,95.66666667,1361040387042,1361040387234,1461767990,1461768182,192
1361040415,1461795952,9,861,95.66666667,1361040387551,1361040387743,1461768503,1461768695,192
1361040415,1461795952,9,861,95.66666667,1361040387804,1361040387996,1461768756,1461768948,192
1361040415,1461795996,9,861,95.66666667,1361040387249,1361040387441,1461768245,1461768437,192
1361040523,1461904456,3,138,46,1361040521250,1361040521314,1461902706,1461902770,64
1361040523,1461904500,3,138,46,1361040521208,1361040521272,1461902708,1461902772,64
1361040523,1461904500,3,138,46,1361040521208,1361040521272,1461902708,1461902772,64
1361040523,1461904500,3,138,46,1361040521207,1361040521271,1461902707,1461902771,64
1361040539,1461920404,11,953,86.63636364,1361040523607,1361040535703,1461905011,1461917107,12096
1361040539,1461920408,12,999,83.25,1361040524177,1361040535697,1461905585,1461917105,11520
1361040539,1461920452,11,953,86.63636364,1361040523817,1361040535657,1461905269,1461917109,11840
1361040539,1461920452,11,953,86.63636364,1361040524390,1361040535654,1461905842,1461917106,11264
1361040635,1462016552,14,6021,430.0714286,1361040620098,1361040632194,1462001650,1462013746,12096
1361040637,100331148,9,7806,867.3333333,1361040620629,1361040632597,100314777,100326745,11968
1361040637,100331156,8,7207,900.875,1361040620621,1361040632589,100314777,100326745,11968
1361040695,1462076584,1,46,46,1361040670559,1361040670559,1462052143,1462052143,0
1361040695,1462076952,1,46,46,1361040670127,1361040670127,1462052079,1462052079,0
1361040696,1462077428,1,46,46,1361040670587,1361040670587,1462052015,1462052015,0
1361040696,1462077436,1,46,46,1361040670645,1361040670645,1462052081,1462052081,0
1361041217,1462598036,2,96,48,1361041189183,1361041192063,1462570219,1462573099,2880
1361041734,1463115388,1,46,46,1361041706196,1361041706196,1463087584,1463087584,0
1361042360,1463741124,14,6751,482.2142857,1361042331924,1361042332500,1463713048,1463713624,576
1361042360,1463741216,12,6151,512.5833333,1361042332536,1361042332856,1463713752,1463714072,320
1361042360,1463741220,8,942,117.75,1361042333044,1361042348212,1463714264,1463729432,15168
1361042392,1463773196,1,162,162,1361042364361,1361042364361,1463745557,1463745557,0
1361042424,1463805232,1,162,162,1361042396455,1361042396455,1463777687,1463777687,0
1361042488,1463869692,1,162,162,1361042460313,1361042460313,1463842005,1463842005,0
1361042629,1464010828,4,252,63,1361042621648,1361042628688,1464003476,1464010516,7040
1361042637,1464018880,3,189,63,1361042630108,1361042633180,1464011988,1464015060,3072
1361042653,1464034864,2,126,63,1361042637229,1361042645229,1464019093,1464027093,8000
1361042665,1464046096,1,63,63,1361042637483,1361042637483,1464018579,1464018579,0
1361042901,1464282568,1,48,48,1361042873872,1361042873872,1464255440,1464255440,0
1361042901,1464282632,1,48,48,1361042876879,1361042876879,1464258511,1464258511,0
1361042905,1464286672,1,48,48,1361042880614,1361042880614,1464262286,1464262286,0
1361042905,1464286684,1,48,48,1361042877596,1361042877596,1464259280,1464259280,0
1361042910,1464290984,1,46,46,1361042883862,1361042883862,1464264846,1464264846,0
1361042910,1464291060,1,48,48,1361042883211,1361042883211,1464264271,1464264271,0
1361042914,1464294992,1,48,48,1361042886222,1361042886222,1464267214,1464267214,0
1361042926,1464307144,1,48,48,1361042901048,1361042901048,1464282192,1464282192,0
1361042930,1464311040,1,48,48,1361042904031,1361042904031,1464285071,1464285071,0
1361043030,1464411516,1,48,48,1361043005184,1361043005184,1464386700,1464386700,0
1361043030,1464411716,1,52,52,1361043003323,1361043003323,1464385039,1464385039,0
1361043050,1464431092,1,46,46,1361043022955,1361043022955,1464404047,1464404047,0
1361043110,1464491024,14,6617,472.6428571,1361043082219,1361043082539,1464463243,1464463563,320
1361043110,1464491032,8,815,101.875,1361043082915,1361043083043,1464463947,1464464075,128
1361043110,1464491108,9,861,95.66666667,1361043082519,1361043082711,1464463627,1464463819,192
1361043110,1464491140,8,815,101.875,1361043083065,1361043083193,1464464205,1464464333,128
1361043318,1464699536,4,252,63,1361043309674,1361043316714,1464691210,1464698250,7040
1361043318,1464699536,4,252,63,1361043309865,1361043316905,1464691401,1464698441,7040
1361043350,1464731424,1,63,63,1361043324887,1361043324887,1464706311,1464706311,0
1361043350,1464731428,1,63,63,1361043325014,1361043325014,1464706442,1464706442,0
1361043415,1464795980,2,126,63,1361043413523,1361043414547,1464794503,1464795527,1024
1361043415,1464796020,2,126,63,1361043413482,1361043414506,1464794502,1464795526,1024
1361043422,1464803880,2,126,63,1361043415697,1361043419729,1464797577,1464801609,4032
1361043422,1464803924,2,126,63,1361043415652,1361043419684,1464797576,1464801608,4032
1361043454,1464835760,1,63,63,1361043427849,1361043427849,1464809609,1464809609,0
1361043454,1464835760,1,63,63,1361043427849,1361043427849,1464809609,1464809609,0
1361043599,1464980332,1,46,46,1361043571440,1361043571440,1464952772,1464952772,0
1361043647,1465028208,17,6755,397.3529412,1361043630251,1361043640427,1465011459,1465021635,10176
1361043647,1465028212,12,999,83.25,1361043630888,1361043640360,1465012100,1465021572,9472
1361043647,1465028260,12,999,83.25,1361043630584,1361043640376,1465011844,1465021636,9792
1361043987,1465368916,1,48,48,1361043959972,1361043959972,1465341888,1465341888,0
1361044444,1465825824,1,46,46,1361044418425,1361044418425,1465800249,1465800249,0
1361045106,1466487076,1,46,46,1361045081050,1361045081050,1466462126,1466462126,0
1361045456,1466837420,17,6755,397.3529412,1361045442876,1361045450300,1466824296,1466831720,7424
1361045456,1466837424,12,999,83.25,1361045443577,1361045450297,1466825001,1466831721,6720
1361045456,1466837464,11,953,86.63636364,1361045443279,1361045450255,1466824743,1466831719,6976
1361045483,1466864064,8,815,101.875,1361045457502,1361045457694,1466838566,1466838758,192
1361045483,1466864072,8,815,101.875,1361045458073,1361045458201,1466839145,1466839273,128
1361045483,1466864148,8,815,101.875,1361045457740,1361045457868,1466838888,1466839016,128
1361045483,1466864152,9,861,95.66666667,1361045458312,1361045458504,1466839464,1466839656,192
1361045688,1467069624,3,189,63,1361045680941,1361045684013,1467062565,1467065637,3072
1361045704,1467085596,2,126,63,1361045688073,1361045696073,1467069669,1467077669,8000
1361045776,1467157668,4,252,63,1361045768705,1361045775745,1467150373,1467157413,7040
1361045800,1467181724,4,252,63,1361045792391,1361045799431,1467174115,1467181155,7040
1361045803,1467184332,2,126,63,1361045798609,1361045799633,1467179941,1467180965,1024
1361045808,1467189756,2,126,63,1361045801254,1361045805286,1467183010,1467187042,4032
1361045811,1467192448,1,63,63,1361045784028,1361045784028,1467165476,1467165476,0
1361045835,1467216432,1,63,63,1361045807788,1361045807788,1467189220,1467189220,0
1361045839,1467220436,1,63,63,1361045813606,1361045813606,1467195042,1467195042,0
1361046220,1467601100,1,46,46,1361046192115,1361046192115,1467573215,1467573215,0
1361046753,1468134368,1,46,46,1361046726428,1361046726428,1468107796,1468107796,0
1361047157,1468538912,1,46,46,1361047132600,1361047132600,1468514512,1468514512,0
1361047274,1468655232,13,6234,479.5384615,1361047249243,1361047249563,1468630475,1468630795,320
1361047274,1468655240,8,815,101.875,1361047249621,1361047249813,1468630861,1468631053,192
1361047278,1468659204,8,815,101.875,1361047249975,1361047250103,1468631179,1468631307,128
1361047278,1468659204,9,861,95.66666667,1361047250233,1361047250361,1468631437,1468631565,128
1361047467,1468848132,2,126,63,1361047465536,1361047466560,1468846668,1468847692,1024
1361047475,1468856040,2,126,63,1361047468633,1361047472665,1468849673,1468853705,4032
1361047506,1468887768,1,63,63,1361047480002,1361047480002,1468861770,1468861770,0
1361047667,1469048140,3,189,63,1361047661812,1361047664820,1469042952,1469045960,3008
1361047667,1469048140,3,189,63,1361047661812,1361047664820,1469042952,1469045960,3008
1361047667,1469048208,3,189,63,1361047661743,1361047664751,1469042951,1469045959,3008
1361047683,1469064136,2,126,63,1361047668855,1361047676919,1469049991,1469058055,8064
1361047683,1469064136,2,126,63,1361047668855,1361047676919,1469049991,1469058055,8064
1361047683,1469064204,2,126,63,1361047668788,1361047676852,1469049992,1469058056,8064
1361047738,1469119908,2,104,52,1361047713136,1361047716080,1469095044,1469097988,2944
1361047742,1469123868,2,104,52,1361047715419,1361047718427,1469097287,1469100295,3008
1361047742,1469123916,2,104,52,1361047714282,1361047717162,1469096198,1469099078,2880
1361047743,1469123948,2,104,52,1361047716336,1361047719280,1469097284,1469100228,2944
1361048889,1470270596,1,46,46,1361048862937,1361048862937,1470244533,1470244533,0
1361048889,1470270604,9,861,95.66666667,1361048864336,1361048864528,1470245940,1470246132,192
1361048889,1470270604,14,6617,472.6428571,1361048863951,1361048864271,1470245555,1470245875,320
1361048889,1470270624,8,815,101.875,1361048864571,1361048864763,1470246195,1470246387,192
1361048893,1470274444,9,861,95.66666667,1361048865007,1361048865199,1470246451,1470246643,192
1361049148,1470529824,2,126,63,1361049145712,1361049146736,1470527536,1470528560,1024
1361049156,1470537860,2,126,63,1361049148683,1361049152715,1470530543,1470534575,4032
1361049172,1470553808,2,126,63,1361049170817,1361049171841,1470552625,1470553649,1024
1361049180,1470561848,2,126,63,1361049173846,1361049177878,1470555694,1470559726,4032
1361049186,1470567352,1,63,63,1361049161286,1361049161286,1470542638,1470542638,0
1361049196,1470577808,3,189,63,1361049190335,1361049193343,1470572143,1470575151,3008
1361049196,1470577856,3,189,63,1361049190350,1361049193358,1470572206,1470575214,3008
1361049212,1470593860,2,126,63,1361049197386,1361049205450,1470579246,1470587310,8064
1361049212,1470593900,2,126,63,1361049197284,1361049205348,1470579184,1470587248,8064
1361049214,1470595312,1,63,63,1361049186479,1361049186479,1470567791,1470567791,0
1361050285,1471666628,12,999,83.25,1361050271780,1361050281700,1471653408,1471663328,9920
1361050285,1471666636,11,953,86.63636364,1361050272409,1361050281689,1471654045,1471663325,9280
1361050285,1471666676,16,6372,398.25,1361050271347,1361050281715,1471653023,1471663391,10368
1361050285,1471666680,12,999,83.25,1361050271983,1361050281647,1471653663,1471663327,9664
1361050381,1471762204,1,46,46,1361050356107,1361050356107,1471737311,1471737311,0
1361050429,1471810384,1,46,46,1361050403605,1361050403605,1471784989,1471784989,0
1361050537,1471918612,3,144,48,1361050509935,1361050518831,1471891547,1471900443,8896
1361052089,1473470668,12,999,83.25,1361052073313,1361052084065,1473454981,1473465733,10752
1361052089,1473470712,12,999,83.25,1361052073522,1361052084018,1473455234,1473465730,10496
1361052089,1473470716,12,999,83.25,1361052073777,1361052084017,1473455493,1473465733,10240
1361053835,1475215940,1,46,46,1361053806430,1361053806430,1475187370,1475187370,0
1361053836,1475216932,1,46,46,1361053806373,1361053806373,1475187305,1475187305,0
1361053836,1475216932,1,46,46,1361053806435,1361053806435,1475187367,1475187367,0
1361053871,1475252328,1,46,46,1361053844185,1361053844185,1475225513,1475225513,0
1361053872,1475253504,1,46,46,1361053844008,1361053844008,1475225512,1475225512,0
1361053872,1475253508,1,46,46,1361053844006,1361053844006,1475225514,1475225514,0
1361054349,1475730464,12,999,83.25,1361054335561,1361054345289,1475717025,1475726753,9728
1361054349,1475730504,12,999,83.25,1361054335009,1361054345249,1475716513,1475726753,10240
1361054349,1475730508,12,999,83.25,1361054335263,1361054345247,1475716771,1475726755,9984
1361054808,1476189640,1,46,46,1361054780370,1361054780370,1476162010,1476162010,0
1361054926,1476307060,12,999,83.25,1361054914965,1361054925013,1476296025,1476306073,10048
1361054926,1476307100,12,999,83.25,1361054915308,1361054924972,1476296408,1476306072,9664
1361054926,1476307136,11,953,86.63636364,1361054915526,1361054924870,1476296662,1476306006,9344
1361055166,1476547484,12,999,83.25,1361055150058,1361055161130,1476531542,1476542614,11072
1361055166,1476547492,12,999,83.25,1361055149535,1361055161119,1476531027,1476542611,11584
1361055166,1476547532,14,6243,445.9285714,1361055149047,1361055161015,1476530579,1476542547,11968
1361055166,1476547560,11,953,86.63636364,1361055149726,1361055161054,1476531286,1476542614,11328
1361055321,1476702724,1,46,46,1361055296310,1361055296310,1476678034,1476678034,0
1361056576,1477957868,1,46,46,1361056548754,1361056548754,1477930622,1477930622,0
1361056617,1477998040,1,46,46,1361056590478,1361056590478,1477971518,1477971518,0
1361056728,1478109332,12,999,83.25,1361056716906,1361056726890,1478098238,1478108222,9984
1361056728,1478109332,11,953,86.63636364,1361056717223,1361056726887,1478098555,1478108219,9664
1361056728,1478109424,16,6372,398.25,1361056716428,1361056726796,1478097852,1478108220,10368
1361056886,1478267340,1,52,52,1361056859677,1361056859677,1478241017,1478241017,0
1361056886,1478267376,1,52,52,1361056859707,1361056859707,1478241083,1478241083,0
1361056887,1478268008,1,52,52,1361056860012,1361056860012,1478241020,1478241020,0
1361056909,1478290736,1,46,46,1361056884625,1361056884625,1478266361,1478266361,0
1361056942,1478323704,1,52,52,1361056914675,1361056914675,1478296379,1478296379,0
1361056943,1478324392,1,52,52,1361056914921,1361056914921,1478296313,1478296313,0
1361056943,1478324416,1,52,52,1361056914832,1361056914832,1478296248,1478296248,0
1361057295,1478675924,1,46,46,1361057269625,1361057269625,1478650549,1478650549,0
1361057298,1478679892,1,46,46,1361057270769,1361057270769,1478652661,1478652661,0
1361057408,1478789744,17,6889,405.2352941,1361057392194,1361057404162,1478773938,1478785906,11968
1361057408,1478789756,12,999,83.25,1361057392952,1361057404216,1478774708,1478785972,11264
1361057408,1478789756,12,999,83.25,1361057393206,1361057404214,1478774962,1478785970,11008
1361057408,1478789796,17,6755,397.3529412,1361057392528,1361057404176,1478774324,1478785972,11648
1361057408,1478789824,12,999,83.25,1361057393458,1361057404146,1478775282,1478785970,10688
1361057747,1479128680,1,46,46,1361057721853,1361057721853,1479103533,1479103533,0
1361057795,1479176800,1,46,46,1361057767875,1361057767875,1479149675,1479149675,0
1361057863,1479244804,1,60,60,1361057837504,1361057837504,1479219308,1479219308,0
1361057867,1479248808,1,60,60,1361057840699,1361057840699,1479222507,1479222507,0
1361057871,1479252800,1,60,60,1361057845508,1361057845508,1479227308,1479227308,0
1361057916,1479297188,1,60,60,1361057890024,1361057890024,1479271212,1479271212,0
1361057920,1479301088,1,60,60,1361057894412,1361057894412,1479275500,1479275500,0
1361057928,1479309144,1,60,60,1361057900180,1361057900180,1479281324,1479281324,0
1361057932,1479313096,2,104,52,1361057905732,1361057908740,1479286828,1479289836,3008
1361057932,1479313132,2,104,52,1361057906784,1361057909792,1479287916,1479290924,3008
1361057932,1479313192,2,104,52,1361057904545,1361057907489,1479285737,1479288681,2944
1361057932,1479313240,2,104,52,1361057906673,1361057909681,1479287913,1479290921,3008
1361057980,1479361268,1,60,60,1361057954328,1361057954328,1479335596,1479335596,0
1361057988,1479369280,1,46,46,1361057961098,1361057961098,1479342378,1479342378,0
1361057988,1479369372,1,60,60,1361057963436,1361057963436,1479344808,1479344808,0
1361058040,1479421292,1,46,46,1361058012028,1361058012028,1479393320,1479393320,0
1361058204,1479585768,2,122,61,1361058177821,1361058180253,1479559589,1479562021,2432
1361059218,1480599448,8,815,101.875,1361059193745,1361059193873,1480575193,1480575321,128
1361059218,1480599496,9,861,95.66666667,1361059193119,1361059193311,1480574615,1480574807,192
1361059218,1480599568,9,861,95.66666667,1361059193367,1361059193495,1480574935,1480575063,128
1361059434,1480815408,2,126,63,1361059432821,1361059433845,1480814229,1480815253,1024
1361059434,1480815460,2,126,63,1361059432769,1361059433793,1480814229,1480815253,1024
1361059463,1480844076,1,63,63,1361059436157,1361059436157,1480817233,1480817233,0
1361059463,1480844096,8,815,101.875,1361059437100,1361059437292,1480818196,1480818388,192
1361059463,1480844144,1,63,63,1361059436089,1361059436089,1480817233,1480817233,0
1361059463,1480844144,14,6617,472.6428571,1361059436157,1361059436413,1480817301,1480817557,256
1361059463,1480844148,9,861,95.66666667,1361059436536,1361059436664,1480817684,1480817812,128
1361059463,1480844148,9,861,95.66666667,1361059436792,1361059436984,1480817940,1480818132,192
1361059466,1480847428,2,126,63,1361059464479,1361059465503,1480845907,1480846931,1024
1361059474,1480855448,2,126,63,1361059467468,1361059471500,1480848916,1480852948,4032
1361059507,1480888132,1,63,63,1361059479880,1361059479880,1480861012,1480861012,0
1361059738,1481119680,3,189,63,1361059733280,1361059736288,1481114960,1481117968,3008
1361059738,1481119680,3,189,63,1361059733407,1361059736415,1481115087,1481118095,3008
1361059738,1481119728,3,189,63,1361059733295,1361059736303,1481115023,1481118031,3008
1361059746,1481127740,4,252,63,1361059736866,1361059743970,1481118606,1481125710,7104
1361059754,1481135660,2,126,63,1361059740340,1361059748404,1481122000,1481130064,8064
1361059754,1481135660,2,126,63,1361059740402,1361059748466,1481122062,1481130126,8064
1361059754,1481135732,2,126,63,1361059740395,1361059748459,1481122127,1481130191,8064
1361059780,1481160884,1,63,63,1361059752826,1361059752826,1481133710,1481133710,0
1361060107,1481488068,17,6755,397.3529412,1361060094527,1361060105215,1481475595,1481486283,10688
1361060107,1481488072,12,999,83.25,1361060095163,1361060105211,1481476235,1481486283,10048
1361060107,1481488072,12,999,83.25,1361060094907,1361060105211,1481475979,1481486283,10304
1361060107,1481488072,11,953,86.63636364,1361060095481,1361060104825,1481476553,1481485897,9344
1361060160,1481541376,1,46,46,1361060135690,1361060135690,1481517066,1481517066,0
1361060171,1481552064,16,6372,398.25,1361060158656,1361060170752,1481539720,1481551816,12096
1361060171,1481552068,12,999,83.25,1361060159037,1361060170749,1481540105,1481551817,11712
1361060171,1481552072,12,999,83.25,1361060159543,1361060170743,1481540615,1481551815,11200
1361060171,1481552136,12,999,83.25,1361060159223,1361060170679,1481540359,1481551815,11456
1361060433,1481814076,1,60,60,1361060408370,1361060408370,1481789446,1481789446,0
1361060437,1481817992,1,60,60,1361060412228,1361060412228,1481793220,1481793220,0
1361060445,1481825956,1,60,60,1361060417831,1361060417831,1481798787,1481798787,0
1361060465,1481846000,1,60,60,1361060439612,1361060439612,1481820612,1481820612,0
1361060469,1481849964,1,60,60,1361060443806,1361060443806,1481824770,1481824770,0
1361060477,1481857964,1,60,60,1361060450337,1361060450337,1481831301,1481831301,0
1361060859,1482240576,16,6372,398.25,1361060843446,1361060855542,1482225022,1482237118,12096
1361060859,1482240628,12,999,83.25,1361060843777,1361060855489,1482225405,1482237117,11712
1361060859,1482240632,12,999,83.25,1361060844095,1361060855487,1482225727,1482237119,11392
1361060859,1482240652,12,999,83.25,1361060844330,1361060855402,1482225982,1482237054,11072
1361061042,1482423264,9,861,95.66666667,1361061014571,1361061014699,1482395835,1482395963,128
1361061042,1482423268,8,815,101.875,1361061015079,1361061015271,1482396347,1482396539,192
1361061042,1482423340,13,6234,479.5384615,1361061014113,1361061014369,1482395453,1482395709,256
1361061042,1482423344,9,861,95.66666667,1361061014746,1361061014938,1482396090,1482396282,192
1361061092,1482473096,11,953,86.63636364,1361061078675,1361061090707,1482459771,1482471803,12032
1361061092,1482473100,11,953,86.63636364,1361061079183,1361061090703,1482460283,1482471803,11520
1361061092,1482473144,12,999,83.25,1361061078882,1361061090658,1482460026,1482471802,11776
1361061092,1482473172,11,953,86.63636364,1361061079366,1361061090630,1482460538,1482471802,11264
1361061110,1482491440,11,3267,297,1361061085624,1361061086264,1482467064,1482467704,640
1361061236,1482617156,2,126,63,1361061234516,1361061235540,1482615672,1482616696,1024
1361061266,1482647864,1,63,63,1361061240271,1361061240271,1482622135,1482622135,0
1361061267,1482647952,1,63,63,1361061241375,1361061241375,1482622327,1482622327,0
1361061371,1482752244,1,63,63,1361061343417,1361061343417,1482724661,1482724661,0
1361061404,1482785236,17,6418,377.5294118,1361061389123,1361061401283,1482770359,1482782519,12160
1361061404,1482785236,12,999,83.25,1361061389570,1361061401282,1482770806,1482782518,11712
1361061404,1482785240,12,999,83.25,1361061390076,1361061401212,1482771316,1482782452,11136
1361061404,1482785304,12,999,83.25,1361061389756,1361061401148,1482771060,1482782452,11392
1361061428,1482809284,2,141,70.5,1361061422608,1361061422608,1482803892,1482803892,0
1361061447,1482828516,11,3267,297,1361061421801,1361061422441,1482803317,1482803957,640
1361061540,1482921364,18,9320,517.7777778,1361061532545,1361061532865,1482913909,1482914229,320
1361061548,1482929420,6,2451,408.5,1361061530504,1361061542408,1482911924,1482923828,11904
1361061556,1482937396,10,5278,527.8,1361061534241,1361061551329,1482915637,1482932725,17088
1361061828,1483209672,4,282,70.5,1361061819975,1361061825671,1483201647,1483207343,5696
1361061856,1483237328,14,6617,472.6428571,1361061829153,1361061829537,1483210481,1483210865,384
1361061856,1483237328,9,861,95.66666667,1361061829598,1361061829790,1483210926,1483211118,192
1361061856,1483237364,12,6151,512.5833333,1361061830333,1361061834685,1483211697,1483216049,4352
1361061856,1483237412,9,861,95.66666667,1361061829771,1361061830091,1483211183,1483211503,320
1361061876,1483257700,11,953,86.63636364,1361061859755,1361061869931,1483241455,1483251631,10176
1361062026,121720256,9,7809,867.6666667,1361062012855,1361062024823,121707111,121719079,11968
1361062026,121720260,8,7207,900.875,1361062012850,1361062024754,121707110,121719014,11904
1361062028,1483409820,12,999,83.25,1361062012015,1361062024111,1483393835,1483405931,12096
1361062028,1483409824,11,953,86.63636364,1361062012843,1361062024043,1483394667,1483405867,11200
1361062028,1483409864,16,7075,442.1875,1361062012100,1361062024132,1483393964,1483405996,12032
1361062028,1483409868,11,953,86.63636364,1361062012482,1361062024002,1483394350,1483405870,11520
1361062028,1483409868,11,953,86.63636364,1361062013057,1361062024001,1483394925,1483405869,10944
1361062069,1483450024,4,252,63,1361062060621,1361062067661,1483441645,1483448685,7040
1361062093,1483473888,2,126,63,1361062089556,1361062090580,1483470444,1483471468,1024
1361062093,1483473936,4,252,63,1361062085285,1361062092325,1483466221,1483473261,7040
1361062100,1483481752,1,63,63,1361062074994,1361062074994,1483456746,1483456746,0
1361062109,1483490056,12,999,83.25,1361062090347,1361062102443,1483471403,1483483499,12096
1361062109,1483490060,12,999,83.25,1361062090855,1361062102375,1483471915,1483483435,11520
1361062109,1483490060,11,953,86.63636364,1361062091110,1361062102374,1483472170,1483483434,11264
1361062109,1483490108,12,999,83.25,1361062090550,1361062102390,1483471658,1483483498,11840
1361062133,1483514068,2,126,63,1361062131679,1361062132703,1483512747,1483513771,1024
1361062141,1483522056,2,126,63,1361062134698,1361062138730,1483515754,1483519786,4032
1361062173,1483553912,1,63,63,1361062146937,1361062146937,1483527849,1483527849,0
1361062237,1483617980,1,48,48,1361062209911,1361062209911,1483590891,1483590891,0
1361062241,1483622100,1,48,48,1361062213755,1361062213755,1483594855,1483594855,0
1361062245,1483626060,1,46,46,1361062217764,1361062217764,1483598824,1483598824,0
1361062273,1483654396,1,48,48,1361062244758,1361062244758,1483626154,1483626154,0
1361062373,1483754448,1,48,48,1361062346718,1361062346718,1483728166,1483728166,0
1361062377,1483758508,1,48,48,1361062350691,1361062350691,1483732199,1483732199,0
1361062726,1484107408,17,6755,397.3529412,1361062709185,1361062719105,1484090593,1484100513,9920
1361062726,1484107412,12,999,83.25,1361062709950,1361062719102,1484091362,1484100514,9152
1361062726,1484107416,12,999,83.25,1361062710714,1361062719098,1484092130,1484100514,8384
1361062838,1484219664,12,999,83.25,1361062822208,1361062834304,1484203872,1484215968,12096
1361062838,1484219668,12,999,83.25,1361062822458,1361062834298,1484204126,1484215966,11840
1361062838,1484219668,12,999,83.25,1361062822717,1361062834237,1484204385,1484215905,11520
1361062838,1484219708,11,953,86.63636364,1361062822931,1361062834195,1484204639,1484215903,11264
1361062855,1484236032,11,3267,297,1361062828281,1361062829049,1484209313,1484210081,768
1361062887,1484268176,1,52,52,1361062862312,1361062862312,1484243488,1484243488,0
1361063067,1484448520,1,46,46,1361063041294,1361063041294,1484422814,1484422814,0
1361063135,1484515892,2,141,70.5,1361063131263,1361063131263,1484512155,1484512155,0
1361063155,1484536668,11,3267,297,1361063129975,1361063130999,1484511643,1484512667,1024
1361063352,1484733132,1,48,48,1361063326349,1361063326349,1484707481,1484707481,0
1361063356,1484737116,1,48,48,1361063330332,1361063330332,1484711448,1484711448,0
1361063447,1484828072,2,141,70.5,1361063443783,1361063443783,1484824855,1484824855,0
1361063468,1484849620,11,3267,297,1361063442466,1361063443298,1484824086,1484824918,832
1361063780,1485161780,11,3267,297,1361063753087,1361063753727,1485134867,1485135507,640
1361063780,1485161788,1,52,52,1361063753719,1361063753719,1485135507,1485135507,0
1361064071,1485452480,2,141,70.5,1361064065637,1361064065637,1485447117,1485447117,0
1361064093,1485474116,12,3372,281,1361064065231,1361064065999,1485446347,1485447115,768
1361064354,1485735220,1,46,46,1361064327718,1361064327718,1485708938,1485708938,0
1361064355,1485735984,1,46,46,1361064327953,1361064327953,1485708937,1485708937,0
1361064355,1485735996,1,46,46,1361064327940,1361064327940,1485708936,1485708936,0
1361064401,1485782452,11,3267,297,1361064376507,1361064377211,1485757959,1485758663,704
1361064405,1485786464,2,141,70.5,1361064377134,1361064377134,1485758598,1485758598,0
1361064431,1485812712,12,999,83.25,1361064416825,1361064428409,1485798537,1485810121,11584
1361064431,1485812764,11,953,86.63636364,1361064417029,1361064428357,1485798793,1485810121,11328
1361064431,1485812784,11,953,86.63636364,1361064417329,1361064428337,1485799113,1485810121,11008
1361064431,1485812796,15,6289,419.2666667,1361064416291,1361064428323,1485798087,1485810119,12032
1361064696,1486077168,2,141,70.5,1361064689940,1361064689940,1486071108,1486071108,0
1361064714,1486095180,11,3267,297,1361064689352,1361064689992,1486070532,1486071172,640
1361065008,1486389712,2,141,70.5,1361065003376,1361065003376,1486385088,1486385088,0
1361065030,1486411608,11,3267,297,1361065002840,1361065003480,1486384448,1486385088,640
1361065054,1486435604,1,60,60,1361065028057,1361065028057,1486409661,1486409661,0
1361065058,1486439736,1,60,60,1361065031126,1361065031126,1486412862,1486412862,0
1361065062,1486443632,1,60,60,1361065035966,1361065035966,1486417598,1486417598,0
1361065082,1486463724,1,60,60,1361065057380,1361065057380,1486439104,1486439104,0
1361065159,1486539928,1,46,46,1361065132413,1361065132413,1486513341,1486513341,0
1361065159,1486540048,1,46,46,1361065131589,1361065131589,1486512637,1486512637,0
1361065159,1486540076,1,46,46,1361065131818,1361065131818,1486512894,1486512894,0
1361065207,1486588020,1,60,60,1361065182559,1361065182559,1486563579,1486563579,0
1361065313,1486694168,2,141,70.5,1361065312268,1361065312268,1486693436,1486693436,0
1361065339,125033096,5,573,114.6,1361065334186,1361065334250,125028282,125028346,64
1361065339,1486720276,11,3267,297,1361065311581,1361065312221,1486692857,1486693497,640
1361065568,1486949092,1,89,89,1361065543573,1361065543573,1486924665,1486924665,0
1361065625,1487006668,2,141,70.5,1361065623379,1361065623379,1487005047,1487005047,0
1361065648,1487029228,11,3267,297,1361065623243,1361065623947,1487004471,1487005175,704
1361065938,1487319072,2,141,70.5,1361065936544,1361065936544,1487317616,1487317616,0
1361065961,1487342168,11,3267,297,1361065935808,1361065936512,1487316976,1487317680,704
1361066234,1487615104,11,953,86.63636364,1361066222206,1361066233726,1487603310,1487614830,11520
1361066234,1487615104,17,6755,397.3529412,1361066222715,1361066233787,1487603819,1487614891,11072
1361066234,1487615144,15,6289,419.2666667,1361066221718,1361066233750,1487602862,1487614894,12032
1361066234,1487615148,12,999,83.25,1361066222417,1361066233745,1487603565,1487614893,11328
1361066258,1487639084,2,141,70.5,1361066251984,1361066251984,1487633068,1487633068,0
1361066262,1487642912,1,46,46,1361066233979,1361066233979,1487614891,1487614891,0
1361066266,1487647168,11,953,86.63636364,1361066252414,1361066261310,1487633582,1487642478,8896
1361066266,1487647168,11,953,86.63636364,1361066252796,1361066261308,1487633964,1487642476,8512
1361066278,1487658932,1,46,46,1361066253161,1361066253161,1487634093,1487634093,0
1361066568,1487949736,1,48,48,1361066539520,1361066539520,1487921256,1487921256,0
1361066570,1487950984,1,48,48,1361066540273,1361066540273,1487921257,1487921257,0
1361066591,1487972056,11,3267,297,1361066563433,1361066564777,1487944489,1487945833,1344
1361066655,1488036200,2,120,60,1361066629653,1361066632661,1488010853,1488013861,3008
1361066663,1488044268,2,120,60,1361066634898,1361066637906,1488016166,1488019174,3008
1361066882,1488263616,2,141,70.5,1361066874354,1361066874354,1488255970,1488255970,0
1361066999,1488380760,1,46,46,1361066973215,1361066973215,1488354975,1488354975,0
1361067216,1488597004,11,3267,297,1361067188753,1361067189393,1488569757,1488570397,640
1361067416,1488797508,1,46,46,1361067389782,1361067389782,1488771290,1488771290,0
1361067499,1488880048,2,141,70.5,1361067494369,1361067494369,1488875417,1488875417,0
1361067520,1488901772,11,3267,297,1361067493071,1361067493775,1488874843,1488875547,704
1361067755,1489136124,2,141,70.5,1361067754513,1361067754513,1489135637,1489135637,0
1361067771,127465708,9,7808,867.5555556,1361067758487,1361067770519,127453195,127465227,12032
1361067771,127465708,8,7207,900.875,1361067758551,1361067770519,127453259,127465227,11968
1361067779,1489160188,14,6021,430.0714286,1361067758865,1361067770897,1489140053,1489152085,12032
1361068091,1489472344,12,999,83.25,1361068072111,1361068082991,1489453455,1489464335,10880
1361068091,1489472388,15,6289,419.2666667,1361068071042,1361068083010,1489452430,1489464398,11968
1361068091,1489472392,12,999,83.25,1361068071554,1361068082946,1489452946,1489464338,11392
1361068091,1489472392,12,999,83.25,1361068071809,1361068082945,1489453201,1489464337,11136
1361068145,1489526716,1,46,46,1361068120763,1361068120763,1489502479,1489502479,0
1361068738,1490119488,1,46,46,1361068712216,1361068712216,1490093704,1490093704,0
1361068774,1490155592,1,48,48,1361068749420,1361068749420,1490131012,1490131012,0
1361069922,1491303636,1,48,48,1361069893618,1361069893618,1491275254,1491275254,0
1361069923,1491304812,1,48,48,1361069893440,1361069893440,1491275252,1491275252,0
1361070137,1491518488,2,120,60,1361070109378,1361070110338,1491490866,1491491826,960
1361070478,1491859616,12,6151,512.5833333,1361070453372,1361070453756,1491834988,1491835372,384
1361070482,1491863312,8,815,101.875,1361070454764,1361070454892,1491836076,1491836204,128
1361070482,1491863388,9,861,95.66666667,1361070454111,1361070454239,1491835499,1491835627,128
1361070482,1491863392,9,861,95.66666667,1361070454363,1361070454555,1491835755,1491835947,192
1361070678,1492059344,4,252,63,1361070670025,1361070677065,1492051369,1492058409,7040
1361070711,1492092272,1,63,63,1361070685199,1361070685199,1492066471,1492066471,0
1361070790,1492171416,3,189,63,1361070784063,1361070787135,1492165479,1492168551,3072
1361070790,1492171448,3,189,63,1361070786270,1361070789342,1492167718,1492170790,3072
1361070790,1492171452,3,189,63,1361070786329,1361070789337,1492167781,1492170789,3008
1361070806,1492187416,2,126,63,1361070793409,1361070801473,1492174825,1492182889,8064
1361070806,1492187452,2,126,63,1361070791131,1361070799131,1492172583,1492180583,8000
1361070806,1492187484,2,126,63,1361070793338,1361070801338,1492174822,1492182822,8000
1361071384,1492764976,1,46,46,1361071376175,1361071376175,1492757151,1492757151,0
1361071727,131421924,1,46,46,1361071699353,1361071699353,131394277,131394277,0
1361071877,1493258864,1,60,60,1361071851437,1361071851437,1493233301,1493233301,0
1361071886,1493266844,1,60,60,1361071858410,1361071858410,1493239254,1493239254,0
1361071974,1493355104,1,46,46,1361071946086,1361071946086,1493327190,1493327190,0
1361072058,1493439400,1,46,46,1361072030139,1361072030139,1493411539,1493411539,0
1361072266,1493647688,9,861,95.66666667,1361072239258,1361072239450,1493620946,1493621138,192
1361072266,1493647700,8,815,101.875,1361072239759,1361072239951,1493621459,1493621651,192
1361072266,1493647768,15,6835,455.6666667,1361072238409,1361072238665,1493620177,1493620433,256
1361072266,1493647772,8,815,101.875,1361072239429,1361072239621,1493621201,1493621393,192
1361072266,1493647772,14,6617,472.6428571,1361072238789,1361072239109,1493620561,1493620881,320
1361072395,1493775964,1,60,60,1361072369387,1361072369387,1493750351,1493750351,0
1361072398,1493779820,1,60,60,1361072370130,1361072370130,1493751950,1493751950,0
1361072495,1493876024,1,76,76,1361072469102,1361072469102,1493850126,1493850126,0
1361072504,1493884892,2,126,63,1361072501426,1361072502450,1493882318,1493883342,1024
1361072512,1493892892,2,126,63,1361072504499,1361072508531,1493885391,1493889423,4032
1361072543,1493924208,1,63,63,1361072516211,1361072516211,1493897419,1493897419,0
1361072576,1493956944,2,126,63,1361072573630,1361072574654,1493954574,1493955598,1024
1361072576,1493956944,2,126,63,1361072573628,1361072574588,1493954572,1493955532,960
1361072576,1493956996,2,126,63,1361072573577,1361072574601,1493954573,1493955597,1024
1361072584,1493964928,2,126,63,1361072576652,1361072580684,1493957580,1493961612,4032
1361072584,1493964976,2,126,63,1361072576604,1361072580636,1493957580,1493961612,4032
1361072584,1493964976,2,126,63,1361072576603,1361072580635,1493957579,1493961611,4032
1361072615,1493996188,1,63,63,1361072588488,1361072588488,1493969676,1493969676,0
1361072615,1493996268,1,63,63,1361072588406,1361072588406,1493969674,1493969674,0
1361072615,1493996272,1,63,63,1361072588402,1361072588402,1493969674,1493969674,0
1361072616,1493997060,2,126,63,1361072613832,1361072614792,1493994892,1493995852,960
1361072624,1494005064,2,126,63,1361072616837,1361072620869,1493997901,1494001933,4032
1361072655,1494036372,1,63,63,1361072628560,1361072628560,1494009932,1494009932,0
1361072888,1494268892,1,48,48,1361072861165,1361072861165,1494242057,1494242057,0
1361073020,1494401268,1,445,445,1361072992818,1361072992818,1494374086,1494374086,0
1361073024,1494405316,1,443,443,1361072996993,1361072996993,1494378309,1494378309,0
1361073253,1494633968,2,92,46,1361073227674,1361073243482,1494608642,1494624450,15808
1361073281,1494662444,1,60,60,1361073255678,1361073255678,1494637122,1494637122,0
1361073281,1494662444,1,60,60,1361073255678,1361073255678,1494637122,1494637122,0
1361073281,1494662444,1,60,60,1361073255678,1361073255678,1494637122,1494637122,0
1361073281,1494662444,1,60,60,1361073255678,1361073255678,1494637122,1494637122,0
1361073281,1494662444,1,60,60,1361073255678,1361073255678,1494637122,1494637122,0
1361073281,1494662468,1,60,60,1361073255653,1361073255653,1494637121,1494637121,0
1361073281,1494662468,1,60,60,1361073255653,1361073255653,1494637121,1494637121,0
1361073281,1494662468,1,60,60,1361073255653,1361073255653,1494637121,1494637121,0
1361073281,1494662632,1,60,60,1361073255490,1361073255490,1494637122,1494637122,0
1361073281,1494662632,1,60,60,1361073255490,1361073255490,1494637122,1494637122,0
1361073281,1494662632,1,60,60,1361073255490,1361073255490,1494637122,1494637122,0
1361073281,1494662632,1,60,60,1361073255490,1361073255490,1494637122,1494637122,0
1361073281,1494662632,1,60,60,1361073255490,1361073255490,1494637122,1494637122,0
1361073281,1494662636,1,60,60,1361073255615,1361073255615,1494637251,1494637251,0
1361073281,1494662640,1,60,60,1361073255480,1361073255480,1494637120,1494637120,0
1361073281,1494662640,1,60,60,1361073255480,1361073255480,1494637120,1494637120,0
1361073289,1494670396,1,60,60,1361073261871,1361073261871,1494643267,1494643267,0
1361073289,1494670396,1,60,60,1361073261871,1361073261871,1494643267,1494643267,0
1361073289,1494670396,1,60,60,1361073261868,1361073261868,1494643264,1494643264,0
1361073289,1494670396,1,60,60,1361073261868,1361073261868,1494643264,1494643264,0
1361073289,1494670396,1,60,60,1361073261868,1361073261868,1494643264,1494643264,0
1361073289,1494670396,1,60,60,1361073261868,1361073261868,1494643264,1494643264,0
1361073289,1494670396,1,60,60,1361073261868,1361073261868,1494643264,1494643264,0
1361073289,1494670604,1,60,60,1361073261662,1361073261662,1494643266,1494643266,0
1361073289,1494670604,1,60,60,1361073261662,1361073261662,1494643266,1494643266,0
1361073289,1494670604,1,60,60,1361073261662,1361073261662,1494643266,1494643266,0
1361073289,1494670604,1,60,60,1361073261662,1361073261662,1494643266,1494643266,0
1361073289,1494670604,1,60,60,1361073261662,1361073261662,1494643266,1494643266,0
1361073289,1494670604,1,60,60,1361073261662,1361073261662,1494643266,1494643266,0
1361073289,1494670608,1,60,60,1361073261658,1361073261658,1494643266,1494643266,0
1361073289,1494670608,1,60,60,1361073261657,1361073261657,1494643265,1494643265,0
1361073289,1494670608,1,60,60,1361073261657,1361073261657,1494643265,1494643265,0
1361073293,1494674448,1,60,60,1361073267834,1361073267834,1494649282,1494649282,0
1361073293,1494674448,1,60,60,1361073267834,1361073267834,1494649282,1494649282,0
1361073293,1494674448,1,60,60,1361073267834,1361073267834,1494649282,1494649282,0
1361073293,1494674448,1,60,60,1361073267834,1361073267834,1494649282,1494649282,0
1361073293,1494674448,1,60,60,1361073267833,1361073267833,1494649281,1494649281,0
1361073293,1494674448,1,60,60,1361073267833,1361073267833,1494649281,1494649281,0
1361073293,1494674448,1,60,60,1361073267833,1361073267833,1494649281,1494649281,0
1361073293,1494674448,1,60,60,1361073267833,1361073267833,1494649281,1494649281,0
1361073293,1494674616,1,60,60,1361073267665,1361073267665,1494649281,1494649281,0
1361073293,1494674616,1,60,60,1361073267665,1361073267665,1494649281,1494649281,0
1361073293,1494674616,1,60,60,1361073267665,1361073267665,1494649281,1494649281,0
1361073293,1494674616,1,60,60,1361073267665,1361073267665,1494649281,1494649281,0
1361073293,1494674648,1,60,60,1361073267635,1361073267635,1494649283,1494649283,0
1361073293,1494674648,1,60,60,1361073267635,1361073267635,1494649283,1494649283,0
1361073293,1494674648,1,60,60,1361073267635,1361073267635,1494649283,1494649283,0
1361073293,1494674648,1,60,60,1361073267635,1361073267635,1494649283,1494649283,0
1361073301,1494682372,1,60,60,1361073273861,1361073273861,1494655233,1494655233,0
1361073301,1494682372,1,60,60,1361073273861,1361073273861,1494655233,1494655233,0
1361073301,1494682372,1,60,60,1361073273861,1361073273861,1494655233,1494655233,0
1361073301,1494682372,1,60,60,1361073273861,1361073273861,1494655233,1494655233,0
1361073301,1494682452,1,187,187,1361073275060,1361073275060,1494656512,1494656512,0
1361073301,1494682576,1,60,60,1361073273658,1361073273658,1494655234,1494655234,0
1361073301,1494682576,1,60,60,1361073273658,1361073273658,1494655234,1494655234,0
1361073301,1494682576,1,60,60,1361073273658,1361073273658,1494655234,1494655234,0
1361073301,1494682576,1,60,60,1361073273722,1361073273722,1494655298,1494655298,0
1361073301,1494682576,1,60,60,1361073273657,1361073273657,1494655233,1494655233,0
1361074055,1495436096,14,6617,472.6428571,1361074029454,1361074029774,1495410550,1495410870,320
1361074055,1495436100,9,861,95.66666667,1361074029834,1361074030026,1495410934,1495411126,192
1361074055,1495436188,8,815,101.875,1361074030067,1361074030195,1495411255,1495411383,128
1361074055,1495436188,9,861,95.66666667,1361074030320,1361074030448,1495411508,1495411636,128
1361074231,1495612396,1,48,48,1361074203614,1361074203614,1495585010,1495585010,0
1361074250,1495631464,4,252,63,1361074241178,1361074248218,1495622642,1495629682,7040
1361074283,1495664568,1,63,63,1361074256178,1361074256178,1495637746,1495637746,0
1361074322,1495703572,4,252,63,1361074313327,1361074320367,1495694899,1495701939,7040
1361074338,1495719552,3,189,63,1361074332800,1361074335808,1495714352,1495717360,3008
1361074338,1495719620,3,189,63,1361074332733,1361074335741,1495714353,1495717361,3008
1361074354,1495735568,2,126,63,1361074339823,1361074347887,1495721391,1495729455,8064
1361074354,1495735620,2,126,63,1361074339775,1361074347775,1495721395,1495729395,8000
1361074355,1495736608,1,63,63,1361074328394,1361074328394,1495710002,1495710002,0
1361075204,1496584864,43,55671,1294.674419,1361075196133,1361075196517,1496576997,1496577381,384
1361075212,1496592860,15,6289,419.2666667,1361075196456,1361075206248,1496577316,1496587108,9792
1361075212,1496592860,12,999,83.25,1361075197415,1361075206247,1496578275,1496587107,8832
1361075212,1496592908,12,999,83.25,1361075196985,1361075206201,1496577893,1496587109,9216
1361077013,1498394276,14,4789,342.0714286,1361077000621,1361077012653,1498381897,1498393929,12032
1361077013,1498394280,12,999,83.25,1361077001064,1361077012648,1498382344,1498393928,11584
1361077013,1498394280,12,999,83.25,1361077001319,1361077012647,1498382599,1498393927,11328
1361077013,1498394284,12,999,83.25,1361077001572,1361077012644,1498382856,1498393928,11072
1361077077,1498458296,11,953,86.63636364,1361077064534,1361077076566,1498445830,1498457862,12032
1361077077,1498458336,11,953,86.63636364,1361077064753,1361077076465,1498446089,1498457801,11712
1361077077,1498458340,11,953,86.63636364,1361077065452,1361077076460,1498446792,1498457800,11008
1361077077,1498458344,11,953,86.63636364,1361077065706,1361077076458,1498447050,1498457802,10752
1361077345,1498726804,1,48,48,1361077316886,1361077316886,1498698690,1498698690,0
1361077429,1498810704,1,92,92,1361077404667,1361077404667,1498786371,1498786371,0
1361077457,1498838760,1,92,92,1361077430722,1361077430722,1498812482,1498812482,0
1361078262,1499643572,1,46,46,1361078236787,1361078236787,1499618359,1499618359,0
1361078314,1499695552,1,46,46,1361078286021,1361078286021,1499667573,1499667573,0
1361078539,1499919832,1,48,48,1361078512787,1361078512787,1499893619,1499893619,0
1361078547,1499927844,1,46,46,1361078522694,1361078522694,1499903538,1499903538,0
1361078855,1500236524,1,46,46,1361078828952,1361078828952,1500210476,1500210476,0
1361078887,1500268636,12,999,83.25,1361078869288,1361078880872,1500250924,1500262508,11584
1361078887,1500268640,12,999,83.25,1361078869542,1361078880870,1500251182,1500262510,11328
1361078887,1500268640,12,999,83.25,1361078869798,1361078880870,1500251438,1500262510,11072
1361078887,1500268676,15,6289,419.2666667,1361078868737,1361078880833,1500250413,1500262509,12096
1361078951,1500332640,16,6372,398.25,1361078934178,1361078946210,1500315818,1500327850,12032
1361078951,1500332640,12,999,83.25,1361078934562,1361078946210,1500316202,1500327850,11648
1361078951,1500332668,11,953,86.63636364,1361078934791,1361078946119,1500316459,1500327787,11328
1361078951,1500332668,12,999,83.25,1361078935047,1361078946119,1500316715,1500327787,11072
1361079015,1500396572,2,96,48,1361078989349,1361078992357,1500370921,1500373929,3008
1361079015,1500396692,2,96,48,1361078989232,1361078992240,1500370924,1500373932,3008
1361080753,1502134652,11,953,86.63636364,1361080739194,1361080750778,1502120846,1502132430,11584
1361080753,1502134656,12,999,83.25,1361080739449,1361080750777,1502121105,1502132433,11328
1361080753,1502134656,11,953,86.63636364,1361080739703,1361080750775,1502121359,1502132431,11072
1361080753,1502134692,15,6289,419.2666667,1361080738707,1361080750803,1502120399,1502132495,12096
1361080817,1502198732,16,6372,398.25,1361080803947,1361080816043,1502185679,1502197775,12096
1361080817,1502198736,12,999,83.25,1361080804584,1361080816040,1502186320,1502197776,11456
1361080817,1502198772,12,999,83.25,1361080804290,1361080816002,1502186062,1502197774,11712
1361080817,1502198776,12,999,83.25,1361080804863,1361080815935,1502186639,1502197711,11072
1361080904,1502285052,1,46,46,1361080879696,1361080879696,1502260748,1502260748,0
1361081982,1503362980,3,144,48,1361081957129,1361081966089,1503338109,1503347069,8960
1361082627,1504008332,12,999,83.25,1361082609630,1361082621278,1503990962,1504002610,11648
1361082627,1504008336,12,999,83.25,1361082610141,1361082621277,1503991477,1504002613,11136
1361082627,1504008372,15,6289,419.2666667,1361082609208,1361082621240,1503990580,1504002612,12032
1361082627,1504008372,12,999,83.25,1361082609847,1361082621239,1503991219,1504002611,11392
1361084429,1505810528,12,999,83.25,1361084414079,1361084425727,1505795607,1505807255,11648
1361084429,1505810532,12,999,83.25,1361084414333,1361084425725,1505795865,1505807257,11392
1361084429,1505810536,15,6289,419.2666667,1361084413623,1361084425719,1505795159,1505807255,12096
1361084429,1505810576,11,953,86.63636364,1361084414545,1361084425681,1505796121,1505807257,11136
1361085094,1506475120,15,6289,419.2666667,1361085074316,1361085086412,1506455436,1506467532,12096
1361085094,1506475120,11,953,86.63636364,1361085075022,1361085086414,1506456142,1506467534,11392
1361085094,1506475160,12,999,83.25,1361085074725,1361085086373,1506455885,1506467533,11648
1361085094,1506475160,13,1045,80.38461538,1361085075237,1361085086757,1506456397,1506467917,11520
1361085190,1506571156,12,999,83.25,1361085171818,1361085182442,1506552974,1506563598,10624
1361085190,1506571168,16,6372,398.25,1361085170908,1361085182428,1506552076,1506563596,11520
1361085190,1506571172,12,999,83.25,1361085171287,1361085182423,1506552459,1506563595,11136
1361085190,1506571172,11,953,86.63636364,1361085171543,1361085182423,1506552715,1506563595,10880
1361085925,1507306680,1,56,56,1361085898579,1361085898579,1507280259,1507280259,0
1361085925,1507306684,1,56,56,1361085899277,1361085899277,1507280961,1507280961,0
1361086025,1507406716,1,56,56,1361086000875,1361086000875,1507382591,1507382591,0
1361086302,1507683080,1,46,46,1361086274467,1361086274467,1507655547,1507655547,0
1361086530,1507911632,1,46,46,1361086505271,1361086505271,1507886903,1507886903,0
1361086992,1508373064,12,999,83.25,1361086976489,1361086987817,1508357553,1508368881,11328
1361086992,1508373068,12,999,83.25,1361086976998,1361086987814,1508358066,1508368882,10816
1361086992,1508373096,15,6289,419.2666667,1361086976074,1361086987786,1508357170,1508368882,11712
1361086992,1508373096,17,6888,405.1764706,1361086975688,1361086987720,1508356784,1508368816,12032
1361086992,1508373100,11,953,86.63636364,1361086976710,1361086987782,1508357810,1508368882,11072
1361087056,1508437096,12,999,83.25,1361087040199,1361087051911,1508421295,1508433007,11712
1361087056,1508437100,16,6372,398.25,1361087039878,1361087051910,1508420978,1508433010,12032
1361087056,1508437100,12,999,83.25,1361087040708,1361087051908,1508421808,1508433008,11200
1361087056,1508437128,12,999,83.25,1361087040424,1361087051880,1508421552,1508433008,11456
1361087103,1508484136,1,48,48,1361087076830,1361087076830,1508457966,1508457966,0
1361087107,1508488156,2,96,48,1361087079754,1361087085706,1508460910,1508466862,5952
1361087139,1508520500,1,46,46,1361087112819,1361087112819,1508494319,1508494319,0
1361087676,1509057336,1,48,48,1361087650256,1361087650256,1509031592,1509031592,0
1361087996,1509377744,1,56,56,1361087968690,1361087968690,1509350434,1509350434,0
1361088370,1509751436,1,46,46,1361088343394,1361088343394,1509724830,1509724830,0
1361088371,1509752272,1,46,46,1361088343491,1361088343491,1509724763,1509724763,0
1361089203,1510583888,1,52,52,1361089177849,1361089177849,1510558737,1510558737,0
1361089267,1510647944,1,46,46,1361089241727,1361089241727,1510622671,1510622671,0
1361089492,1510872848,1,46,46,1361089465562,1361089465562,1510846410,1510846410,0
1361090113,1511494160,1,48,48,1361090087578,1361090087578,1511468738,1511468738,0
1361090530,1511910904,1,48,48,1361090503444,1361090503444,1511884348,1511884348,0
1361090658,1512039368,1,48,48,1361090631042,1361090631042,1512012410,1512012410,0
1361091436,1512816884,1,46,46,1361091408665,1361091408665,1512789549,1512789549,0
1361091454,1512835408,1,48,48,1361091425292,1361091425292,1512806700,1512806700,0
1361091454,1512835412,1,48,48,1361091425289,1361091425289,1512806701,1512806701,0
1361091464,1512844932,1,46,46,1361091438568,1361091438568,1512819500,1512819500,0
1361091496,1512876888,2,96,48,1361091469013,1361091471829,1512849901,1512852717,2816
1361092001,1513382328,1,60,60,1361091974292,1361091974292,1513355620,1513355620,0
1361092005,1513386348,1,60,60,1361091980032,1361091980032,1513361380,1513361380,0
1361092266,1513647276,1,46,46,1361092238919,1361092238919,1513620195,1513620195,0
1361093284,1514665388,1,46,46,1361093258311,1361093258311,1514639699,1514639699,0
1361094955,1516336460,1,46,46,1361094926947,1361094926947,1516308407,1516308407,0
1361094979,1516360492,1,46,46,1361094953029,1361094953029,1516334521,1516334521,0
1361095091,1516472620,1,46,46,1361095063235,1361095063235,1516444855,1516444855,0
1361095147,1516528640,1,46,46,1361095122863,1361095122863,1516504503,1516504503,0
1361095845,1517226604,1,46,46,1361095820169,1361095820169,1517201773,1517201773,0
1361095869,1517250544,1,46,46,1361095841027,1361095841027,1517222571,1517222571,0
1361096787,1518167888,1,439,439,1361096762054,1361096762054,1518142942,1518142942,0
1361098025,1519406536,1,46,46,1361097999976,1361097999976,1519381512,1519381512,0
1361098041,1519422596,3,152,50.66666667,1361098015342,1361098024366,1519396938,1519405962,9024
1361098695,1520076560,1,48,48,1361098667974,1361098667974,1520049534,1520049534,0
1361098807,1520188696,1,52,52,1361098782269,1361098782269,1520163965,1520163965,0
1361099060,1520441540,1,48,48,1361099032279,1361099032279,1520413819,1520413819,0
1361099329,1520710360,1,439,439,1361099304004,1361099304004,1520685364,1520685364,0
1361099762,1521142872,1,48,48,1361099735462,1361099735462,1521116334,1521116334,0
1361100108,1521489684,4,190,47.5,1361100081974,1361100103478,1521463658,1521485162,21504
1361101005,1522386244,6,2158,359.6666667,1361101003554,1361101004066,1522384798,1522385310,512
1361101005,1522386244,3,2365,788.3333333,1361101003810,1361101003938,1522385054,1522385182,128
1361101005,1522386244,1,108,108,1361101003938,1361101003938,1522385182,1522385182,0
1361101005,1522386244,1,108,108,1361101003810,1361101003810,1522385054,1522385054,0
1361101005,1522386244,1,108,108,1361101004066,1361101004066,1522385310,1522385310,0
1361101005,1522386248,8,2004,250.5,1361101004702,1361101004894,1522385950,1522386142,192
1361101012,160706588,4,1448,362,1361101006633,1361101006697,160701221,160701285,64
1361101012,160706588,6,511,85.16666667,1361101005735,1361101005927,160700323,160700515,192
1361101012,160706592,5,451,90.2,1361101011749,1361101011877,160706341,160706469,128
1361101013,1522394248,5,609,121.8,1361101012574,1361101012958,1522393822,1522394206,384
1361101013,1522394248,4,724,181,1361101012637,1361101012701,1522393885,1522393949,64
1361101013,1522394252,8,3492,436.5,1361101009434,1361101010138,1522390686,1522391390,704
1361101013,1522394252,6,798,133,1361101009625,1361101009945,1522390877,1522391197,320
1361101013,1522394256,8,2018,252.25,1361101007126,1361101007318,1522388382,1522388574,192
1361101013,1522394256,8,3492,436.5,1361101007190,1361101008342,1522388446,1522389598,1152
1361101013,1522394256,7,1460,208.5714286,1361101011219,1361101011859,1522392475,1522393115,640
1361101013,1522394256,9,3035,337.2222222,1361101011283,1361101011795,1522392539,1522393051,512
1361101013,1522394256,6,798,133,1361101011091,1361101011283,1522392347,1522392539,192
1361101013,1522394260,9,1913,212.5555556,1361101012049,1361101012241,1522393309,1522393501,192
1361101013,1522394260,11,3294,299.4545455,1361101008592,1361101009360,1522389852,1522390620,768
1361101013,1522394260,5,772,154.4,1361101004751,1361101005135,1522386011,1522386395,384
1361101013,1522394264,6,983,163.8333333,1361101009358,1361101009614,1522390622,1522390878,256
1361101013,1522394264,5,1257,251.4,1361101006283,1361101006347,1522387547,1522387611,64
1361101013,1522394268,11,3294,299.4545455,1361101010314,1361101011082,1522391582,1522392350,768
1361101012,160706592,5,2109,421.8,1361101011813,1361101011877,160706405,160706469,64
1361101020,160714580,5,451,90.2,1361101016753,1361101017457,160711333,160712037,704
1361101020,160714580,5,451,90.2,1361101018544,1361101018672,160713124,160713252,128
1361101020,160714580,5,451,90.2,1361101015216,1361101015344,160709796,160709924,128
1361101020,160714580,5,451,90.2,1361101012912,1361101013808,160707492,160708388,896
1361101021,1522402248,12,4735,394.5833333,1361101020508,1361101020636,1522401756,1522401884,128
1361101021,1522402252,15,8365,557.6666667,1361101016921,1361101017113,1522398173,1522398365,192
1361101021,1522402252,9,1913,212.5555556,1361101014295,1361101014487,1522395547,1522395739,192
1361101021,1522402256,11,4921,447.3636364,1361101017554,1361101018066,1522398810,1522399322,512
1361101021,1522402256,10,3041,304.1,1361101014290,1361101014802,1522395546,1522396058,512
1361101021,1522402256,12,4967,413.9166667,1361101017621,1361101017813,1522398877,1522399069,192
1361101021,1522402256,5,609,121.8,1361101014805,1361101015317,1522396061,1522396573,512
1361101021,1522402256,9,1913,212.5555556,1361101015316,1361101015444,1522396572,1522396700,128
1361101021,1522402256,9,1913,212.5555556,1361101015572,1361101016020,1522396828,1522397276,448
1361101021,1522402260,9,1913,212.5555556,1361101018578,1361101018706,1522399838,1522399966,128
1361101021,1522402260,9,1913,212.5555556,1361101018897,1361101019281,1522400157,1522400541,384
1361101021,1522402260,9,1913,212.5555556,1361101016272,1361101016464,1522397532,1522397724,192
1361101021,1522402260,5,609,121.8,1361101019664,1361101019984,1522400924,1522401244,320
1361101021,1522402260,10,3381,338.1,1361101019856,1361101019984,1522401116,1522401244,128
1361101021,1522402264,7,1877,268.1428571,1361101012814,1361101013454,1522394078,1522394718,640
1361101021,1522402288,5,609,121.8,1361101018163,1361101018611,1522399451,1522399899,448
1361101024,1522405732,5,609,121.8,1361101015865,1361101016249,1522397597,1522397981,384
1361101028,160722580,4,445,111.25,1361101020529,1361101020721,160715109,160715301,192
1361101028,160722580,4,1448,362,1361101023665,1361101023729,160718245,160718309,64
1361101028,160722580,4,445,111.25,1361101019953,1361101020273,160714533,160714853,320
1361101028,160722580,4,445,111.25,1361101020399,1361101020463,160714979,160715043,64
1361101029,1522410252,9,1913,212.5555556,1361101021978,1361101022106,1522403230,1522403358,128
1361101029,1522410252,9,1913,212.5555556,1361101022553,1361101022745,1522403805,1522403997,192
1361101029,1522410252,10,3397,339.7,1361101025752,1361101026968,1522407004,1522408220,1216
1361101029,1522410260,4,715,178.75,1361101028302,1361101028366,1522409562,1522409626,64
1361101029,1522410260,10,1877,187.7,1361101021137,1361101021777,1522402397,1522403037,640
1361101029,1522410264,9,2849,316.5555556,1361101023181,1361101023309,1522404445,1522404573,128
1361101029,1522410264,9,3310,367.7777778,1361101023884,1361101025740,1522405148,1522407004,1856
1361101037,1522418248,11,3096,281.4545455,1361101028574,1361101029342,1522409822,1522410590,768
1361101037,1522418256,14,7501,535.7857143,1361101029330,1361101030098,1522410586,1522411354,768
1361101666,1523047296,1,48,48,1361101639073,1361101639073,1523020369,1523020369,0
1361101798,161492640,1,46,46,1361101773496,1361101773496,161468136,161468136,0
1361101802,161496664,1,52,52,1361101774625,1361101774625,161469289,161469289,0
1361101806,1523187420,1,48,48,1361101779491,1361101779491,1523160911,1523160911,0
1361102448,1523828804,5,250,50,1361102423233,1361102445441,1523804037,1523826245,22208
1361102496,1523876936,1,48,48,1361102469311,1361102469311,1523850247,1523850247,0
1361102524,1523904956,1,48,48,1361102498346,1361102498346,1523879302,1523879302,0
1361103878,1525259276,1,46,46,1361103852947,1361103852947,1525234223,1525234223,0
1361104443,1525824096,1,46,46,1361104418881,1361104418881,1525799977,1525799977,0
1361104874,1526255120,1,48,48,1361104847840,1361104847840,1526228960,1526228960,0
1361104875,1526256308,1,48,48,1361104847655,1361104847655,1526228963,1526228963,0
1361105558,1526939404,1,46,46,1361105530237,1361105530237,1526911641,1526911641,0
1361105691,1527071804,1,46,46,1361105665169,1361105665169,1527045973,1527045973,0
1361105847,1527228160,1,46,46,1361105820972,1361105820972,1527202132,1527202132,0
1361107181,1528562632,2,120,60,1361107156609,1361107159617,1528538241,1528541249,3008
1361107181,1528562648,2,120,60,1361107156590,1361107159534,1528538238,1528541182,2944
1361108953,1530334076,2,230,115,1361108925647,1361108925711,1530306723,1530306787,64
1361109292,1530672792,15,3492,232.8,1361109286504,1361109286888,1530667296,1530667680,384
1361109292,1530672804,14,3446,246.1428571,1361109286554,1361109286938,1530667358,1530667742,384
1361110380,1531761468,8,815,101.875,1361110354866,1361110355058,1531736334,1531736526,192
1361110380,1531761468,8,815,101.875,1361110355185,1361110355377,1531736653,1531736845,192
1361110380,1531761500,12,6151,512.5833333,1361110354131,1361110354515,1531735631,1531736015,384
1361110380,1531761504,9,861,95.66666667,1361110354576,1361110354768,1531736080,1531736272,192
1361110628,1532009708,3,189,63,1361110621182,1361110624190,1532002890,1532005898,3008
1361110628,1532009720,3,189,63,1361110621043,1361110624051,1532002763,1532005771,3008
1361110644,1532025716,2,126,63,1361110641141,1361110642165,1532022857,1532023881,1024
1361110645,1532025732,2,126,63,1361110629072,1361110637136,1532009804,1532017868,8064
1361110645,1532025732,2,126,63,1361110629199,1361110637263,1532009931,1532017995,8064
1361110645,1532025756,2,126,63,1361110642232,1361110643192,1532022988,1532023948,960
1361110653,1532033732,2,126,63,1361110645200,1361110649232,1532025932,1532029964,4032
1361110653,1532033732,2,126,63,1361110645263,1361110649295,1532025995,1532030027,4032
1361110681,1532062288,1,63,63,1361110656804,1361110656804,1532038092,1532038092,0
1361110681,1532062324,1,63,63,1361110656637,1361110656637,1532037961,1532037961,0
1361110901,1532282612,1,52,52,1361110874907,1361110874907,1532256519,1532256519,0
1361111254,1532635148,1,46,46,1361111227559,1361111227559,1532608707,1532608707,0
1361111519,1532899992,3,192,64,1361111494524,1361111496572,1532875516,1532877564,2048
1361111707,1533088572,2,120,60,1361111681144,1361111682168,1533062716,1533063740,1024
1361111711,1533092560,2,120,60,1361111683140,1361111684164,1533064700,1533065724,1024
1361112157,1533538672,17,6755,397.3529412,1361112139852,1361112149452,1533521524,1533531124,9600
1361112157,1533538676,12,999,83.25,1361112140744,1361112149384,1533522420,1533531060,8640
1361112157,1533538688,12,999,83.25,1361112140154,1361112149434,1533521842,1533531122,9280
1361112157,1533538692,11,953,86.63636364,1361112140473,1361112149369,1533522165,1533531061,8896
1361112894,1534275192,27,19529,723.2962963,1361112890529,1361112890849,1534271721,1534272041,320
1361112894,1534275196,5,1353,270.6,1361112891421,1361112891549,1534272617,1534272745,128
1361112894,1534275200,14,6391,456.5,1361112892376,1361112892952,1534273576,1534274152,576
1361112894,1534275204,13,6080,467.6923077,1361112893330,1361112893906,1534274534,1534275110,576
1361112894,1534275284,2,92,46,1361112890371,1361112890435,1534271655,1534271719,64
1361112902,1534283196,17,6807,400.4117647,1361112894045,1361112894621,1534275241,1534275817,576
1361112902,1534283196,7,2448,349.7142857,1361112894301,1361112894621,1534275497,1534275817,320
1361112902,1534283200,6,3014,502.3333333,1361112898714,1361112898906,1534279914,1534280106,192
1361112902,1534283200,5,1413,282.6,1361112898713,1361112899161,1534279913,1534280361,448
1361112902,1534283200,25,17807,712.28,1361112891160,1361112901144,1534272360,1534282344,9984
1361112902,1534283204,15,6184,412.2666667,1361112895826,1361112896210,1534277030,1534277414,384
1361112902,1534283212,14,6502,464.4285714,1361112893325,1361112894285,1534274537,1534275497,960
1361112902,1534283244,16,9302,581.375,1361112895790,1361112896174,1534277034,1534277418,384
1361112902,1534283284,18,9933,551.8333333,1361112893699,1361112894147,1534274983,1534275431,448
1361112902,1534283284,14,6484,463.1428571,1361112893507,1361112894211,1534274791,1534275495,704
1361112903,172597528,4,383,95.75,1361112902513,1361112902705,172597041,172597233,192
1361112910,1534291196,14,6671,476.5,1361112898269,1361112903325,1534279465,1534284521,5056
1361112910,1534291200,16,8143,508.9375,1361112903385,1361112905113,1534284585,1534286313,1728
1361112910,1534291200,15,3313,220.8666667,1361112895832,1361112909656,1534277032,1534290856,13824
1361112910,1534291208,30,8842,294.7333333,1361112892497,1361112909713,1534273705,1534290921,17216
1361112910,1534291212,15,6289,419.2666667,1361112894604,1361112903308,1534275816,1534284520,8704
1361112910,1534291236,12,999,83.25,1361112895794,1361112903282,1534277030,1534284518,7488
1361112910,1534291240,12,999,83.25,1361112896305,1361112903281,1534277545,1534284521,6976
1361112910,1534291240,15,6289,419.2666667,1361112891441,1361112903345,1534272681,1534284585,11904
1361112910,1534291240,14,6671,476.5,1361112905071,1361112905391,1534286311,1534286631,320
1361112910,1534291244,15,3935,262.3333333,1361112892461,1361112903661,1534273705,1534284905,11200
1361112911,172605528,4,914,228.5,1361112898224,1361112909488,172592752,172604016,11264
1361112918,1534299216,6,2492,415.3333333,1361112898506,1361112911306,1534279722,1534292522,12800
1361112918,1534299312,2,104,52,1361112893863,1361112893863,1534275175,1534275175,0
1361113030,1534411344,15,8091,539.4,1361113025350,1361113025862,1534406694,1534407206,512
1361113039,1534419732,12,695,57.91666667,1361113038057,1361113038377,1534418789,1534419109,320
1361113091,1534471828,1,46,46,1361113063113,1361113063113,1534443941,1534443941,0
1361114139,1535519800,1,48,48,1361114111316,1361114111316,1535492116,1535492116,0
1361114140,1535520976,1,48,48,1361114111141,1361114111141,1535492117,1535492117,0
1361114262,1535643044,1,46,46,1361114235038,1361114235038,1535616082,1535616082,0
1361114262,1535643484,1,46,46,1361114234534,1361114234534,1535616018,1535616018,0
1361114710,1536091704,1,46,46,1361114684036,1361114684036,1536065740,1536065740,0
1361114735,1536115728,12,6151,512.5833333,1361114707220,1361114707540,1536087948,1536088268,320
1361114735,1536115732,9,861,95.66666667,1361114707665,1361114707793,1536088397,1536088525,128
1361114735,1536115732,9,861,95.66666667,1361114707920,1361114708112,1536088652,1536088844,192
1361114735,1536115736,9,861,95.66666667,1361114708174,1361114708366,1536088910,1536089102,192
1361114975,1536356352,2,126,63,1361114973087,1361114974111,1536354439,1536355463,1024
1361114975,1536356364,2,126,63,1361114972244,1361114973268,1536353608,1536354632,1024
1361114983,1536364356,3,189,63,1361114979357,1361114982429,1536360713,1536363785,3072
1361114983,1536364360,2,126,63,1361114976154,1361114980186,1536357514,1536361546,4032
1361114983,1536364372,2,126,63,1361114975246,1361114979278,1536356618,1536360650,4032
1361114991,1536372360,3,189,63,1361114985112,1361114988184,1536366472,1536369544,3072
1361114999,1536380428,2,126,63,1361114986324,1361114994388,1536367752,1536375816,8064
1361115007,1536388404,2,126,63,1361114992174,1361115000174,1536373578,1536381578,8000
1361115016,1536396740,1,63,63,1361114987970,1361114987970,1536368710,1536368710,0
1361115016,1536396744,1,63,63,1361114988800,1361114988800,1536369544,1536369544,0
1361115100,1536480848,1,46,46,1361115072150,1361115072150,1536452998,1536452998,0
1361115480,1536861492,1,46,46,1361115455117,1361115455117,1536836609,1536836609,0
1361116037,1537418540,1,46,46,1361116012115,1361116012115,1537393655,1537393655,0
1361116066,1537446824,1,48,48,1361116041502,1361116041502,1537422326,1537422326,0
1361116073,1537454504,1,48,48,1361116046071,1361116046071,1537427575,1537427575,0
1361116350,1537730876,9,861,95.66666667,1361116324648,1361116324840,1537705524,1537705716,192
1361116350,1537730876,8,815,101.875,1361116324392,1361116324584,1537705268,1537705460,192
1361116350,1537730880,9,861,95.66666667,1361116324900,1361116325092,1537705780,1537705972,192
1361116536,1537917452,3,189,63,1361116530212,1361116533284,1537911664,1537914736,3072
1361116552,1537933448,2,126,63,1361116537321,1361116545321,1537918769,1537926769,8000
1361116566,1537947056,8,815,101.875,1361116540274,1361116540466,1537921330,1537921522,192
1361116566,1537947056,9,861,95.66666667,1361116540591,1361116540719,1537921647,1537921775,128
1361116566,1537947096,14,6617,472.6428571,1361116539656,1361116539912,1537920752,1537921008,256
1361116566,1537947112,9,861,95.66666667,1361116539959,1361116540151,1537921071,1537921263,192
1361116632,1538013500,4,252,63,1361116623541,1361116630581,1538005041,1538012081,7040
1361116656,1538037524,3,189,63,1361116651995,1361116655003,1538033519,1538036527,3008
1361116666,1538047388,1,63,63,1361116638753,1361116638753,1538020141,1538020141,0
1361116672,1538053516,2,126,63,1361116659041,1361116667105,1538040557,1538048621,8064
1361116736,1538117488,3,189,63,1361116730813,1361116733885,1538112301,1538115373,3072
1361116752,1538133508,2,126,63,1361116737900,1361116745900,1538119408,1538127408,8000
1361116784,1538165500,4,252,63,1361116776306,1361116783410,1538157806,1538164910,7104
1361116784,1538165500,4,252,63,1361116776305,1361116783345,1538157805,1538164845,7040
1361116784,1538165544,4,252,63,1361116775878,1361116782918,1538157422,1538164462,7040
1361116819,1538199724,1,63,63,1361116791802,1361116791802,1538172526,1538172526,0
1361116819,1538199728,1,63,63,1361116792181,1361116792181,1538172909,1538172909,0
1361116819,1538199728,1,63,63,1361116792181,1361116792181,1538172909,1538172909,0
1361117696,1539077508,1,46,46,1361117671260,1361117671260,1539052768,1539052768,0
1361117773,1539153792,1,46,46,1361117746150,1361117746150,1539126942,1539126942,0
1361118141,1539522396,8,815,101.875,1361118115910,1361118116102,1539497306,1539497498,192
1361118141,1539522432,15,6834,455.6,1361118114850,1361118115106,1539496282,1539496538,256
1361118141,1539522432,14,6617,472.6428571,1361118115233,1361118115553,1539496665,1539496985,320
1361118141,1539522460,9,861,95.66666667,1361118115591,1361118115783,1539497051,1539497243,192
1361118141,1539522464,8,815,101.875,1361118116098,1361118116290,1539497562,1539497754,192
1361118149,1539530392,1,48,48,1361118123338,1361118123338,1539504730,1539504730,0
1361118378,1539758788,4,252,63,1361118370273,1361118377377,1539751061,1539758165,7104
1361118407,1539788092,1,48,48,1361118379378,1361118379378,1539760470,1539760470,0
1361118407,1539788096,1,48,48,1361118379371,1361118379371,1539760467,1539760467,0
1361118410,1539790700,1,63,63,1361118385466,1361118385466,1539766166,1539766166,0
1361118426,1539806860,3,189,63,1361118419866,1361118422874,1539800726,1539803734,3008
1361118442,1539822864,2,126,63,1361118426901,1361118434965,1539807765,1539815829,8064
1361118458,1539838864,3,189,63,1361118454866,1361118457874,1539835730,1539838738,3008
1361118458,1539838864,2,126,63,1361118454930,1361118455890,1539835794,1539836754,960
1361118458,1539838904,3,189,63,1361118454828,1361118457836,1539835732,1539838740,3008
1361118466,1539846868,2,126,63,1361118457935,1361118461967,1539838803,1539842835,4032
1361118474,1539854872,2,126,63,1361118461900,1361118469964,1539842772,1539850836,8064
1361118474,1539854912,2,126,63,1361118461861,1361118469925,1539842773,1539850837,8064
1361118498,1539878804,1,63,63,1361118470097,1361118470097,1539850901,1539850901,0
1361118594,1539974996,43,56199,1306.953488,1361118586829,1361118587149,1539967825,1539968145,320
1361118602,1539982972,17,6755,397.3529412,1361118587942,1361118598502,1539968914,1539979474,10560
1361118602,1539982976,11,953,86.63636364,1361118588643,1361118598435,1539969619,1539979411,9792
1361118602,1539983008,12,999,83.25,1361118588289,1361118598401,1539969297,1539979409,10112
1361118602,1539983012,12,999,83.25,1361118588860,1361118598396,1539969872,1539979408,9536
1361119146,1540527436,8,5308,663.5,1361119138319,1361119143759,1540519755,1540525195,5440
1361119146,1540527436,5,2414,482.8,1361119131341,1361119143373,1540512777,1540524809,12032
1361119146,1540527436,5,2416,483.2,1361119131533,1361119143309,1540512969,1540524745,11776
1361119146,1540527444,12,999,83.25,1361119132677,1361119143365,1540514121,1540524809,10688
1361119146,1540527444,12,999,83.25,1361119132933,1361119143301,1540514377,1540524745,10368
1361119146,1540527448,12,999,83.25,1361119133187,1361119143299,1540514635,1540524747,10112
1361119146,1540527484,16,6335,395.9375,1361119132124,1361119143324,1540513608,1540524808,11200
1361119528,1540909444,11,3267,297,1361119500031,1361119500735,1540881475,1540882179,704
1361119921,1541302496,1,89,89,1361119895941,1361119895941,1541277437,1541277437,0
1361120099,1541480668,19,12181,641.1052632,1361120085975,1361120097943,1541467643,1541479611,11968
1361120105,179799524,8,7207,900.875,1361120086374,1361120098278,179780898,179792802,11904
1361120105,179799528,9,7810,867.7777778,1361120086305,1361120098273,179780833,179792801,11968
1361120113,1541494608,14,2345,167.5,1361120086867,1361120097683,1541468475,1541479291,10816
1361120210,1541590704,5,1885,377,1361120183896,1361120197656,1541564600,1541578360,13760
1361120237,1541618680,1,377,377,1361120211400,1361120211400,1541593080,1541593080,0
1361120266,1541646776,1,377,377,1361120241682,1361120241682,1541622458,1541622458,0
1361120326,1541706792,1,377,377,1361120300478,1361120300478,1541681270,1541681270,0
1361120442,1541823252,1,377,377,1361120417714,1361120417714,1541798966,1541798966,0
1361120963,1542344236,12,6151,512.5833333,1361120937017,1361120937465,1542318253,1542318701,448
1361120963,1542344240,9,861,95.66666667,1361120937525,1361120937717,1542318765,1542318957,192
1361120963,1542344240,8,815,101.875,1361120937780,1361120937972,1542319020,1542319212,192
1361120963,1542344264,8,815,101.875,1361120938078,1361120938206,1542319342,1542319470,128
1361121127,1542508624,1,127,127,1361121100915,1361121100915,1542482539,1542482539,0
1361121152,1542532816,1,127,127,1361121127772,1361121127772,1542508588,1542508588,0
1361121237,1542618264,12,999,83.25,1361121220953,1361121230233,1542602217,1542611497,9280
1361121237,1542618272,11,953,86.63636364,1361121220116,1361121230292,1542601388,1542611564,10176
1361121237,1542618276,12,999,83.25,1361121220623,1361121230223,1542601899,1542611499,9600
1361121237,1542618616,11,953,86.63636364,1361121220024,1361121229880,1542601640,1542611496,9856
1361121253,1542634272,3,189,63,1361121248338,1361121251410,1542629610,1542632682,3072
1361121253,1542634272,3,189,63,1361121248401,1361121251473,1542629673,1542632745,3072
1361121253,1542634320,3,189,63,1361121248483,1361121251491,1542629803,1542632811,3008
1361121253,1542634320,3,189,63,1361121248483,1361121251491,1542629803,1542632811,3008
1361121269,1542650276,2,126,63,1361121255438,1361121263438,1542636714,1542644714,8000
1361121269,1542650276,2,126,63,1361121255565,1361121263629,1542636841,1542644905,8064
1361121269,1542650316,2,126,63,1361121255462,1361121263462,1542636778,1542644778,8000
1361121269,1542650316,2,126,63,1361121255526,1361121263590,1542636842,1542644906,8064
1361121460,1542841376,1,96,96,1361121433574,1361121433574,1542814950,1542814950,0
1361121469,1542850484,12,999,83.25,1361121452985,1361121464697,1542834469,1542846181,11712
1361121469,1542850488,11,953,86.63636364,1361121453301,1361121464693,1542834789,1542846181,11392
1361121469,1542850536,11,953,86.63636364,1361121453575,1361121464647,1542835111,1542846183,11072
1361121469,1542850536,12,999,83.25,1361121452614,1361121464646,1542834150,1542846182,12032
1361121709,1543090632,15,6289,419.2666667,1361121694433,1361121706593,1543076065,1543088225,12160
1361121709,1543090632,11,953,86.63636364,1361121694882,1361121706530,1543076514,1543088162,11648
1361121710,1543090696,12,999,83.25,1361121696073,1361121707465,1543076769,1543088161,11392
1361121710,1543090700,12,999,83.25,1361121696329,1361121707465,1543077029,1543088165,11136
1361122140,181834636,1,46,46,1361122114498,1361122114498,181809134,181809134,0
1361122141,181835116,1,46,46,1361122115016,1361122115016,181809132,181809132,0
1361122475,1543855924,1,46,46,1361122450267,1361122450267,1543831191,1543831191,0
1361123501,1544882604,1,56,56,1361123475301,1361123475301,1544856905,1544856905,0
1361123509,1544890640,3,192,64,1361123484224,1361123485824,1544865864,1544867464,1600
1361123513,1544894628,1,64,64,1361123484939,1361123484939,1544866567,1544866567,0
1361123526,1544906900,9,861,95.66666667,1361123501092,1361123501220,1544881992,1544882120,128
1361123526,1544906900,9,861,95.66666667,1361123500771,1361123500963,1544881671,1544881863,192
1361123526,1544906940,12,6151,512.5833333,1361123500026,1361123500410,1544880966,1544881350,384
1361123526,1544906944,9,861,95.66666667,1361123500470,1361123500662,1544881414,1544881606,192
1361123646,1545026968,3,138,46,1361123618847,1361123628063,1544999815,1545009031,9216
1361123785,1545166296,2,126,63,1361123783060,1361123784020,1545164356,1545165316,960
1361123793,1545174264,4,252,63,1361123783924,1361123791028,1545165188,1545172292,7104
1361123793,1545174300,2,126,63,1361123786063,1361123790095,1545167363,1545171395,4032
1361123809,1545190268,2,126,63,1361123806639,1361123807663,1545187907,1545188931,1024
1361123817,1545198284,2,126,63,1361123809631,1361123813663,1545190915,1545194947,4032
1361123826,1545207076,1,63,63,1361123798381,1361123798381,1545179457,1545179457,0
1361123826,1545207156,1,63,63,1361123799133,1361123799133,1545180289,1545180289,0
1361123846,1545227140,1,63,63,1361123821870,1361123821870,1545203010,1545203010,0
1361123937,1545318388,4,252,63,1361123929334,1361123936438,1545310722,1545317826,7104
1361123970,1545351344,1,63,63,1361123944543,1361123944543,1545325887,1545325887,0
1361124305,1545686624,17,6755,397.3529412,1361124288197,1361124300229,1545669821,1545681853,12032
1361124305,1545686648,12,999,83.25,1361124288556,1361124300204,1545670204,1545681852,11648
1361124305,1545686652,12,999,83.25,1361124289063,1361124300199,1545670715,1545681851,11136
1361124306,1545686696,12,999,83.25,1361124289764,1361124301156,1545670460,1545681852,11392
1361125154,1546535184,12,999,83.25,1361125141104,1361125152816,1546522288,1546534000,11712
1361125154,1546535184,12,999,83.25,1361125141359,1361125152751,1546522543,1546533935,11392
1361125154,1546535184,11,953,86.63636364,1361125141612,1361125152748,1546522796,1546533932,11136
1361125154,1546535224,15,6289,419.2666667,1361125140678,1361125152774,1546521902,1546533998,12096
1361126043,1547423828,12,999,83.25,1361126030339,1361126040131,1547411167,1547420959,9792
1361126043,1547423844,17,6755,397.3529412,1361126029939,1361126040115,1547410783,1547420959,10176
1361126043,1547423876,12,999,83.25,1361126030549,1361126040085,1547411425,1547420961,9536
1361126191,1547572172,1,46,46,1361126164715,1361126164715,1547545887,1547545887,0
1361126191,1547572568,1,46,46,1361126164255,1361126164255,1547545823,1547545823,0
1361126415,1547795840,1,435,435,1361126389109,1361126389109,1547769949,1547769949,0
1361126419,1547799816,1,435,435,1361126390923,1361126390923,1547771739,1547771739,0
1361127196,1548577056,12,999,83.25,1361127182608,1361127194320,1548563664,1548575376,11712
1361127196,1548577056,11,953,86.63636364,1361127182927,1361127194319,1548563983,1548575375,11392
1361127196,1548577096,17,6755,397.3529412,1361127182182,1361127194278,1548563278,1548575374,12096
1361127196,1548577104,11,953,86.63636364,1361127183137,1361127194273,1548564241,1548575377,11136
1361127337,1548718332,8,815,101.875,1361127312312,1361127312440,1548693644,1548693772,128
1361127337,1548718336,9,861,95.66666667,1361127312566,1361127312694,1548693902,1548694030,128
1361127341,1548722232,9,861,95.66666667,1361127312988,1361127313180,1548694220,1548694412,192
1361127341,1548722240,8,815,101.875,1361127313238,1361127313430,1548694478,1548694670,192
1361127372,1548753440,11,953,86.63636364,1361127353357,1361127364621,1548734797,1548746061,11264
1361127372,1548753472,12,999,83.25,1361127352554,1361127364650,1548734026,1548746122,12096
1361127372,1548753472,11,953,86.63636364,1361127352811,1361127364651,1548734283,1548746123,11840
1361127372,1548753476,11,953,86.63636364,1361127353065,1361127364585,1548734541,1548746061,11520
1361127428,1548809552,11,953,86.63636364,1361127411034,1361127422874,1548792586,1548804426,11840
1361127428,1548809600,12,999,83.25,1361127410731,1361127422827,1548792331,1548804427,12096
1361127428,1548809604,12,999,83.25,1361127411303,1361127422823,1548792907,1548804427,11520
1361127428,1548809604,11,953,86.63636364,1361127411558,1361127422758,1548793162,1548804362,11200
1361127548,1548929552,4,252,63,1361127540184,1361127547224,1548921736,1548928776,7040
1361127548,1548929592,4,252,63,1361127540016,1361127547056,1548921608,1548928648,7040
1361127548,1548929600,3,189,63,1361127541802,1361127544874,1548923402,1548926474,3072
1361127564,1548945616,2,126,63,1361127548890,1361127556890,1548930506,1548938506,8000
1361127581,1548962560,1,63,63,1361127555154,1361127555154,1548936714,1548936714,0
1361127581,1548962564,1,63,63,1361127555278,1361127555278,1548936842,1548936842,0
1361127637,1549017692,4,252,63,1361127629365,1361127636405,1549010057,1549017097,7040
1361127669,1549049744,11,953,86.63636364,1361127653183,1361127664447,1549033927,1549045191,11264
1361127669,1549049784,11,953,86.63636364,1361127652311,1361127664407,1549033095,1549045191,12096
1361127669,1549049784,11,953,86.63636364,1361127652822,1361127664406,1549033606,1549045190,11584
1361127669,1549049788,12,999,83.25,1361127652566,1361127664406,1549033354,1549045194,11840
1361127670,1549050704,1,63,63,1361127644456,1361127644456,1549025160,1549025160,0
1361128244,1549625216,1,46,46,1361128217311,1361128217311,1549598527,1549598527,0
1361128245,1549626592,1,46,46,1361128216934,1361128216934,1549598526,1549598526,0
1361128687,1550068364,2,122,61,1361128660613,1361128662917,1550041977,1550044281,2304
1361128840,1550220688,1,46,46,1361128815335,1361128815335,1550196023,1550196023,0
1361129084,1550465172,2,122,61,1361129059520,1361129061696,1550440692,1550442868,2176
1361129224,1550605524,13,6234,479.5384615,1361129198302,1361129198622,1550579826,1550580146,320
1361129224,1550605528,9,861,95.66666667,1361129198680,1361129198872,1550580208,1550580400,192
1361129224,1550605532,9,861,95.66666667,1361129199251,1361129199379,1550580783,1550580911,128
1361129224,1550605604,8,815,101.875,1361129198861,1361129199053,1550580465,1550580657,192
1361129438,1550819000,3,189,63,1361129432486,1361129435494,1550813486,1550816494,3008
1361129454,1550835084,2,126,63,1361129439441,1361129447505,1550820525,1550828589,8064
1361129462,1550843052,3,189,63,1361129456752,1361129459824,1550837804,1550840876,3072
1361129478,1550859012,2,126,63,1361129463896,1361129471960,1550844908,1550852972,8064
1361129486,1550867000,4,252,63,1361129478309,1361129485413,1550859309,1550866413,7104
1361129486,1550867000,4,252,63,1361129478372,1361129485412,1550859372,1550866412,7040
1361129521,1550901984,1,63,63,1361129493427,1361129493427,1550874411,1550874411,0
1361129521,1550902056,1,63,63,1361129493421,1361129493421,1550874477,1550874477,0
1361129553,1550934136,1,46,46,1361129528027,1361129528027,1550909163,1550909163,0
1361129766,1551147260,12,999,83.25,1361129754714,1361129762714,1551135974,1551143974,8000
1361129766,1551147304,11,953,86.63636364,1361129753583,1361129762671,1551134887,1551143975,9088
1361129766,1551147336,11,953,86.63636364,1361129752720,1361129762640,1551134056,1551143976,9920
1361129781,1551162284,14,3460,247.1428571,1361129754562,1361129775234,1551135846,1551156518,20672
1361130174,1551554876,8,815,101.875,1361130146837,1361130147029,1551527713,1551527905,192
1361130174,1551554924,13,6234,479.5384615,1361130145895,1361130146215,1551526819,1551527139,320
1361130174,1551554944,8,815,101.875,1361130146257,1361130146449,1551527201,1551527393,192
1361130174,1551554948,9,861,95.66666667,1361130146510,1361130146702,1551527458,1551527650,192
1361130431,1551811772,3,189,63,1361130424763,1361130427835,1551805535,1551808607,3072
1361130431,1551811848,3,189,63,1361130424688,1361130427760,1551805536,1551808608,3072
1361130431,190125276,1,46,46,1361130405919,1361130405919,190100195,190100195,0
1361130447,1551827748,2,126,63,1361130431888,1361130439888,1551812636,1551820636,8000
1361130447,1551827816,2,126,63,1361130431820,1361130439820,1551812636,1551820636,8000
1361130575,1551955952,3,189,63,1361130569539,1361130572547,1551950491,1551953499,3008
1361130575,1551956024,3,189,63,1361130569466,1361130572474,1551950490,1551953498,3008
1361130591,1551971960,2,126,63,1361130576573,1361130584637,1551957533,1551965597,8064
1361130591,1551972072,2,126,63,1361130576461,1361130584525,1551957533,1551965597,8064
1361130667,1552047668,9,861,95.66666667,1361130640157,1361130640349,1552020825,1552021017,192
1361130667,1552047736,14,6617,472.6428571,1361130639451,1361130639707,1552020187,1552020443,256
1361130667,1552047740,9,861,95.66666667,1361130639829,1361130639957,1552020569,1552020697,128
1361130912,1552292736,4,252,63,1361130902936,1361130909976,1552283672,1552290712,7040
1361130943,1552324564,1,63,63,1361130917146,1361130917146,1552298710,1552298710,0
1361130959,1552340632,8,815,101.875,1361130934743,1361130934871,1552316375,1552316503,128
1361130963,1552344500,8,815,101.875,1361130935131,1361130935323,1552316631,1552316823,192
1361130963,1552344504,8,815,101.875,1361130935383,1361130935575,1552316887,1552317079,192
1361130963,1552344508,9,861,95.66666667,1361130935634,1361130935890,1552317142,1552317398,256
1361130967,1552348576,1,63,63,1361130939343,1361130939343,1552320919,1552320919,0
1361131008,1552388852,2,126,63,1361131006559,1361131007583,1552387411,1552388435,1024
1361131016,1552397040,2,126,63,1361131009447,1361131013479,1552390487,1552394519,4032
1361131048,1552428788,1,63,63,1361131021730,1361131021730,1552402518,1552402518,0
1361131048,1552428972,3,138,46,1361131047721,1361131047785,1552428693,1552428757,64
1361131048,1552428972,3,138,46,1361131047720,1361131047784,1552428692,1552428756,64
1361131048,1552428972,3,138,46,1361131047784,1361131047848,1552428756,1552428820,64
1361131048,1552429020,3,138,46,1361131047735,1361131047799,1552428755,1552428819,64
1361131076,1552456892,9,861,95.66666667,1361131048312,1361131048504,1552429204,1552429396,192
1361131076,1552456896,9,861,95.66666667,1361131048947,1361131049139,1552429843,1552430035,192
1361131076,1552456944,14,6617,472.6428571,1361131047875,1361131048195,1552428819,1552429139,320
1361131076,1552456972,9,861,95.66666667,1361131048489,1361131048809,1552429461,1552429781,320
1361131257,1552637696,2,126,63,1361131255480,1361131256440,1552636176,1552637136,960
1361131264,1552645592,2,126,63,1361131257594,1361131261626,1552639186,1552643218,4032
1361131289,1552669680,2,126,63,1361131286218,1361131287242,1552666898,1552667922,1024
1361131289,1552669700,2,126,63,1361131286708,1361131287732,1552667408,1552668432,1024
1361131296,1552677444,1,63,63,1361131269838,1361131269838,1552651282,1552651282,0
1361131296,1552677640,2,126,63,1361131288330,1361131292362,1552669970,1552674002,4032
1361131296,1552677644,2,126,63,1361131288837,1361131292869,1552670481,1552674513,4032
1361131328,1552709456,1,63,63,1361131300610,1361131300610,1552682066,1552682066,0
1361131328,1552709528,1,63,63,1361131301049,1361131301049,1552682577,1552682577,0
1361131401,1552781932,3,189,63,1361131395467,1361131398475,1552776399,1552779407,3008
1361131417,1552797960,2,126,63,1361131402479,1361131410543,1552783439,1552791503,8064
1361131945,1553326572,17,6755,397.3529412,1361131933253,1361131944773,1553314825,1553326345,11520
1361131945,1553326572,12,999,83.25,1361131933634,1361131944770,1553315206,1553326342,11136
1361131945,1553326648,12,999,83.25,1361131933817,1361131944633,1553315465,1553326281,10816
1361131945,1553326652,11,953,86.63636364,1361131934068,1361131944628,1553315720,1553326280,10560
1361131961,1553342388,1,46,46,1361131933369,1361131933369,1553314757,1553314757,0
1361132166,1553546684,1,46,46,1361132139063,1361132139063,1553519747,1553519747,0
1361132599,1553980116,1,46,46,1361132573442,1361132573442,1553954558,1553954558,0
1361132631,1554012356,1,48,48,1361132606287,1361132606287,1553987643,1553987643,0
1361132631,1554012360,1,48,48,1361132606476,1361132606476,1553987836,1553987836,0
1361133584,193278160,1,46,46,1361133556650,1361133556650,193250810,193250810,0
1361133758,1555138960,14,6783,484.5,1361133733513,1361133733897,1555114473,1555114857,384
1361133762,1555142704,14,6617,472.6428571,1361133734218,1361133734538,1555114922,1555115242,320
1361133762,1555142716,8,815,101.875,1361133734913,1361133735105,1555115629,1555115821,192
1361133762,1555142716,9,861,95.66666667,1361133735165,1361133735357,1555115881,1555116073,192
1361133762,1555142792,9,861,95.66666667,1361133734514,1361133734706,1555115306,1555115498,192
1361133762,1555142832,1,60,60,1361133736139,1361133736139,1555116971,1555116971,0
1361133964,1555344780,2,126,63,1361133962365,1361133963389,1555343145,1555344169,1024
1361133972,1555352772,2,126,63,1361133965378,1361133969410,1555346150,1555350182,4032
1361134002,1555383556,1,63,63,1361133976629,1361133976629,1555358185,1555358185,0
1361134052,1555432756,3,189,63,1361134045523,1361134048531,1555426279,1555429287,3008
1361134052,1555432824,3,189,63,1361134045455,1361134048463,1555426279,1555429287,3008
1361134068,1555448768,2,126,63,1361134052550,1361134060614,1555433318,1555441382,8064
1361134068,1555448840,2,126,63,1361134052478,1361134060542,1555433318,1555441382,8064
1361134076,1555456776,3,189,63,1361134069310,1361134072382,1555450086,1555453158,3072
1361134076,1555456780,3,189,63,1361134069561,1361134072633,1555450341,1555453413,3072
1361134092,1555472796,2,126,63,1361134076394,1361134084458,1555457190,1555465254,8064
1361134092,1555472872,2,126,63,1361134076574,1361134084574,1555457446,1555465446,8000
1361134492,1555872968,12,999,83.25,1361134479289,1361134490681,1555860257,1555871649,11392
1361134492,1555872968,11,953,86.63636364,1361134479608,1361134490680,1555860576,1555871648,11072
1361134492,1555873008,14,4789,342.0714286,1361134478607,1361134490703,1555859615,1555871711,12096
1361134492,1555873012,11,953,86.63636364,1361134478988,1361134490636,1555860000,1555871648,11648
1361134868,1556249540,12,999,83.25,1361134852982,1361134863222,1556234522,1556244762,10240
1361134868,1556249544,12,999,83.25,1361134853233,1361134863217,1556234777,1556244761,9984
1361134868,1556249548,12,999,83.25,1361134853484,1361134863212,1556235032,1556244760,9728
1361135631,1557012328,1,46,46,1361135603389,1361135603389,1556984717,1556984717,0
1361135632,1557012988,1,46,46,1361135603732,1361135603732,1556984720,1556984720,0
1361136184,1557564840,5,250,50,1361136157789,1361136179293,1557538629,1557560133,21504
1361136228,1557609216,1,48,48,1361136203046,1361136203046,1557584262,1557584262,0
1361136260,1557641240,1,48,48,1361136232271,1361136232271,1557613511,1557613511,0
1361136681,1558062440,13,6234,479.5384615,1361136654145,1361136654465,1558035585,1558035905,320
1361136681,1558062544,9,861,95.66666667,1361136654424,1361136654616,1558035968,1558036160,192
1361136681,1558062548,8,815,101.875,1361136654930,1361136655122,1558036478,1558036670,192
1361136681,1558062548,9,861,95.66666667,1361136654674,1361136654866,1558036222,1558036414,192
1361136723,1558103968,1,48,48,1361136694229,1361136694229,1558075197,1558075197,0
1361136724,1558105200,1,48,48,1361136693997,1361136693997,1558075197,1558075197,0
1361136926,1558307116,3,189,63,1361136920128,1361136923200,1558301244,1558304316,3072
1361136942,1558323076,2,126,63,1361136927271,1361136935335,1558308347,1558316411,8064
1361136950,1558331052,4,252,63,1361136942781,1361136949821,1558323833,1558330873,7040
1361136950,1558331084,3,189,63,1361136945120,1361136948128,1558326204,1558329212,3008
1361136950,1558331096,4,252,63,1361136942737,1361136949777,1558323833,1558330873,7040
1361136966,1558347108,2,126,63,1361136952133,1361136960197,1558333241,1558341305,8064
1361136986,1558366816,1,63,63,1361136958120,1361136958120,1558338936,1558338936,0
1361136986,1558366900,1,63,63,1361136958040,1361136958040,1558338940,1558338940,0
1361137423,1558804028,1,68,68,1361137397264,1361137397264,1558778292,1558778292,0
1361137903,1559283912,12,999,83.25,1361137885693,1361137895101,1559266605,1559276013,9408
1361137903,1559283912,12,999,83.25,1361137885947,1361137895099,1559266859,1559276011,9152
1361137903,1559283952,16,6372,398.25,1361137885011,1361137895123,1559265963,1559276075,10112
1361137903,1559283964,12,999,83.25,1361137885386,1361137895050,1559266350,1559276014,9664
1361138359,1559740124,11,953,86.63636364,1361138343519,1361138354591,1559724643,1559735715,11072
1361138359,1559740164,12,999,83.25,1361138342906,1361138354554,1559724070,1559735718,11648
1361138359,1559740168,12,999,83.25,1361138343157,1361138354549,1559724325,1559735717,11392
1361138359,1559740204,16,6372,398.25,1361138342415,1361138354511,1559723619,1559735715,12096
1361139255,1560635684,8,815,101.875,1361139230861,1361139231053,1560611545,1560611737,192
1361139255,1560635732,14,6617,472.6428571,1361139230171,1361139230427,1560610903,1560611159,256
1361139255,1560635840,9,861,95.66666667,1361139230446,1361139230574,1560611286,1560611414,128
1361139480,1560861288,2,126,63,1361139477674,1361139478698,1560858962,1560859986,1024
1361139488,1560869272,2,126,63,1361139480764,1361139484796,1560862036,1560866068,4032
1361139504,1560885232,3,189,63,1361139498276,1361139501284,1560879508,1560882516,3008
1361139504,1560885280,3,189,63,1361139498036,1361139501108,1560879316,1560882388,3072
1361139519,1560900200,1,63,63,1361139492930,1361139492930,1560874130,1560874130,0
1361139520,1560901316,2,126,63,1361139505102,1361139513166,1560886418,1560894482,8064
1361139520,1560901320,2,126,63,1361139505229,1361139513293,1560886549,1560894613,8064
1361139851,1561232600,14,6280,448.5714286,1361139825520,1361139825840,1561207120,1561207440,320
1361139851,1561232600,9,861,95.66666667,1361139825901,1361139826093,1561207501,1561207693,192
1361139851,1561232608,9,861,95.66666667,1361139826151,1361139826343,1561207759,1561207951,192
1361139851,1561232608,8,815,101.875,1361139826471,1361139826663,1561208079,1561208271,192
1361139932,1561313576,1,52,52,1361139904070,1361139904070,1561285646,1561285646,0
1361139988,1561369564,1,52,52,1361139959247,1361139959247,1561340811,1561340811,0
1361140041,1561421744,2,126,63,1361140039555,1361140040579,1561420299,1561421323,1024
1361140049,1561429764,2,126,63,1361140042544,1361140046576,1561423308,1561427340,4032
1361140065,1561445664,4,252,63,1361140056018,1361140063058,1561436682,1561443722,7040
1361140065,1561445716,4,252,63,1361140056031,1361140063071,1561436747,1561443787,7040
1361140073,1561453696,3,189,63,1361140066034,1361140069042,1561446730,1561449738,3008
1361140080,1561460804,1,63,63,1361140054600,1361140054600,1561435404,1561435404,0
1361140089,1561469732,2,126,63,1361140073039,1361140081039,1561453771,1561461771,8000
1361140096,1561476748,1,63,63,1361140071040,1361140071040,1561451788,1561451788,0
1361140096,1561476828,1,63,63,1361140071023,1361140071023,1561451851,1561451851,0
1361140288,1561668884,1,46,46,1361140262004,1361140262004,1561642888,1561642888,0
1361141362,1562743392,11,953,86.63636364,1361141344487,1361141355111,1562725879,1562736503,10624
1361141362,1562743396,12,999,83.25,1361141344740,1361141355108,1562726136,1562736504,10368
1361141362,1562743444,12,999,83.25,1361141344947,1361141354995,1562726391,1562736439,10048
1361141856,1563237356,1,84,84,1361141829701,1361141829701,1563211057,1563211057,0
1361141900,1563281352,1,84,84,1361141872774,1361141872774,1563254126,1563254126,0
1361141948,1563329352,1,84,84,1361141920965,1361141920965,1563302317,1563302317,0
1361143170,1564551548,13,6234,479.5384615,1361143142959,1361143143279,1564524507,1564524827,320
1361143170,1564551552,9,861,95.66666667,1361143143340,1361143143532,1564524892,1564525084,192
1361143170,1564551556,8,815,101.875,1361143143592,1361143143784,1564525148,1564525340,192
1361143171,1564551660,8,815,101.875,1361143144744,1361143144936,1564525404,1564525596,192
1361143349,1564730276,3,189,63,1361143343997,1361143347069,1564725273,1564728345,3072
1361143349,1564730344,2,126,63,1361143347129,1361143348153,1564728473,1564729497,1024
1361143349,1564730356,3,189,63,1361143345389,1361143348397,1564726745,1564729753,3008
1361143365,1564746304,2,126,63,1361143352481,1361143360545,1564733785,1564741849,8064
1361143365,1564746340,2,126,63,1361143351035,1361143359035,1564732375,1564740375,8000
1361143387,1564767984,1,63,63,1361143362590,1361143362590,1564743574,1564743574,0
1361143447,1564827796,2,126,63,1361143442972,1361143443932,1564823768,1564824728,960
1361143453,1564834396,2,126,63,1361143445379,1361143449411,1564826775,1564830807,4032
1361143483,1564864176,1,63,63,1361143457693,1361143457693,1564838869,1564838869,0
1361144046,1565427212,16,6372,398.25,1361144028404,1361144040500,1565409616,1565421712,12096
1361144046,1565427264,12,999,83.25,1361144028732,1361144040444,1565409996,1565421708,11712
1361144046,1565427288,12,999,83.25,1361144028966,1361144040422,1565410254,1565421710,11456
1361144046,1565427288,11,953,86.63636364,1361144029220,1361144040420,1565410508,1565421708,11200
1361145219,1566600360,8,815,101.875,1361145194701,1361145194957,1566576061,1566576317,256
1361145223,1566604296,8,815,101.875,1361145195402,1361145195594,1566576698,1566576890,192
1361145223,1566604372,8,815,101.875,1361145195072,1361145195264,1566576444,1566576636,192
1361145288,1566668964,3,138,46,1361145282967,1361145283031,1566663931,1566663995,64
1361145288,1566668964,3,138,46,1361145282966,1361145283030,1566663930,1566663994,64
1361145288,1566669008,3,138,46,1361145282925,1361145282989,1566663933,1566663997,64
1361145304,1566684924,12,999,83.25,1361145286718,1361145298110,1566667642,1566679034,11392
1361145304,1566684924,11,953,86.63636364,1361145286974,1361145298110,1566667898,1566679034,11136
1361145304,1566684984,11,953,86.63636364,1361145286340,1361145298116,1566667324,1566679100,11776
1361145304,1566684984,11,953,86.63636364,1361145287298,1361145297986,1566668282,1566678970,10688
1361146378,1567759056,13,6234,479.5384615,1361146353706,1361146354154,1567734762,1567735210,448
1361146382,1567763056,9,861,95.66666667,1361146354219,1361146354347,1567735275,1567735403,128
1361146382,1567763060,8,815,101.875,1361146354789,1361146354981,1567735849,1567736041,192
1361146382,1567763144,9,861,95.66666667,1361146354386,1361146354578,1567735530,1567735722,192
1361146569,1567950144,2,126,63,1361146567758,1361146568782,1567948902,1567949926,1024
1361146569,1567950224,2,126,63,1361146565950,1361146566974,1567947174,1567948198,1024
1361146569,1567950228,3,189,63,1361146565693,1361146568701,1567946921,1567949929,3008
1361146577,1567958160,2,126,63,1361146570752,1361146574784,1567951912,1567955944,4032
1361146577,1567958208,2,126,63,1361146568974,1361146573006,1567950182,1567954214,4032
1361146585,1567966288,2,126,63,1361146572670,1361146580734,1567953958,1567962022,8064
1361146607,1567988020,1,63,63,1361146581257,1361146581257,1567962277,1567962277,0
1361146611,1567991908,1,63,63,1361146583099,1361146583099,1567964007,1567964007,0
1361146625,1568006328,4,252,63,1361146617175,1361146624215,1567998503,1568005543,7040
1361146659,1568040128,1,63,63,1361146632478,1361146632478,1568013606,1568013606,0
1361147264,1568645228,9,861,95.66666667,1361147239152,1361147239344,1568620380,1568620572,192
1361147264,1568645304,8,815,101.875,1361147239652,1361147239844,1568620956,1568621148,192
1361147264,1568645336,9,861,95.66666667,1361147239365,1361147239493,1568620701,1568620829,128
1361147541,1568921824,8,815,101.875,1361147516609,1361147516801,1568897433,1568897625,192
1361147541,1568921900,8,815,101.875,1361147516276,1361147516468,1568897176,1568897368,192
1361147545,1568925836,8,815,101.875,1361147516915,1361147517107,1568897751,1568897943,192
1361147546,1568926892,2,126,63,1361147543164,1361147544188,1568924056,1568925080,1024
1361147546,1568926944,2,126,63,1361147543176,1361147544136,1568924120,1568925080,960
1361147554,1568934844,2,126,63,1361147546283,1361147550315,1568927127,1568931159,4032
1361147554,1568934900,2,126,63,1361147546230,1361147550262,1568927130,1568931162,4032
1361147554,1568934924,4,252,63,1361147546589,1361147553629,1568927513,1568934553,7040
1361147585,1568965960,1,63,63,1361147558202,1361147558202,1568939162,1568939162,0
1361147585,1568965960,1,63,63,1361147558265,1361147558265,1568939225,1568939225,0
1361147589,1568969956,1,63,63,1361147561660,1361147561660,1568942616,1568942616,0
1361147738,1569118960,3,189,63,1361147734007,1361147737015,1569114967,1569117975,3008
1361147738,1569119000,3,189,63,1361147732812,1361147735820,1569113812,1569116820,3008
1361147754,1569135044,2,126,63,1361147739807,1361147747871,1569120851,1569128915,8064
1361147754,1569135052,2,126,63,1361147740953,1361147749017,1569122005,1569130069,8064
1361147801,1569182392,9,861,95.66666667,1361147773061,1361147773253,1569154453,1569154645,192
1361147801,1569182396,8,815,101.875,1361147773823,1361147774079,1569155219,1569155475,256
1361147801,1569182472,8,815,101.875,1361147773238,1361147773430,1569154710,1569154902,192
1361147801,1569182472,8,815,101.875,1361147773492,1361147773684,1569154964,1569155156,192
1361147834,1569215132,3,189,63,1361147827015,1361147830087,1569208147,1569211219,3072
1361147850,1569231096,2,126,63,1361147834154,1361147842154,1569215250,1569223250,8000
1361148010,1569391252,3,189,63,1361148002959,1361148005967,1569384211,1569387219,3008
1361148026,1569407264,3,189,63,1361148021571,1361148024579,1569402835,1569405843,3008
1361148026,1569407312,2,126,63,1361148009937,1361148018001,1569391249,1569399313,8064
1361148042,1569423260,2,126,63,1361148028612,1361148036676,1569409872,1569417936,8064
1361148106,1569487372,2,126,63,1361148104787,1361148105811,1569486159,1569487183,1024
1361148106,1569487376,2,126,63,1361148104849,1361148105809,1569486225,1569487185,960
1361148114,1569495300,2,126,63,1361148107869,1361148111901,1569489169,1569493201,4032
1361148114,1569495364,2,126,63,1361148107868,1361148111900,1569489232,1569493264,4032
1361148146,1569527044,1,63,63,1361148120219,1361148120219,1569501263,1569501263,0
1361148146,1569527124,1,63,63,1361148120139,1361148120139,1569501263,1569501263,0
1361148447,1569827888,1,48,48,1361148420147,1361148420147,1569801035,1569801035,0
1361148546,1569926656,1,48,48,1361148518871,1361148518871,1569899527,1569899527,0
1361149589,1570970420,9,861,95.66666667,1361149563983,1361149564175,1570945403,1570945595,192
1361149589,1570970452,8,815,101.875,1361149564463,1361149564655,1570945915,1570946107,192
1361149589,1570970460,15,6840,456,1361149563173,1361149563429,1570944633,1570944889,256
1361149589,1570970492,14,6617,472.6428571,1361149563526,1361149563846,1570945018,1570945338,320
1361149589,1570970536,9,861,95.66666667,1361149564122,1361149564314,1570945658,1570945850,192
1361149796,1571176652,4,252,63,1361149787658,1361149794698,1571168310,1571175350,7040
1361149830,1571211304,1,63,63,1361149802046,1361149802046,1571183350,1571183350,0
1361149844,1571224704,3,189,63,1361149840855,1361149843863,1571221559,1571224567,3008
1361149860,1571240724,2,126,63,1361149847872,1361149855936,1571228596,1571236660,8064
1361149868,1571248660,3,189,63,1361149861185,1361149864193,1571241845,1571244853,3008
1361149868,1571248680,3,189,63,1361149861230,1361149864238,1571241910,1571244918,3008
1361149884,1571264684,2,126,63,1361149868266,1361149876266,1571248950,1571256950,8000
1361149884,1571264756,2,126,63,1361149868194,1361149876258,1571248950,1571257014,8064
1361149996,1571376784,4,252,63,1361149988546,1361149995650,1571369330,1571376434,7104
1361150031,1571411940,1,63,63,1361150003558,1361150003558,1571384498,1571384498,0
1361150392,1571772840,1,46,46,1361150365254,1361150365254,1571746094,1571746094,0
1361151231,1572611676,1,46,46,1361151206044,1361151206044,1572586720,1572586720,0
1361151382,1572762916,12,999,83.25,1361151355947,1361151375787,1572736863,1572756703,19840
1361151382,1572762920,11,953,86.63636364,1361151356196,1361151375716,1572737116,1572756636,19520
1361151406,1572786888,9,861,95.66666667,1361151378951,1361151379143,1572759839,1572760031,192
1361151406,1572786964,8,815,101.875,1361151378619,1361151378811,1572759583,1572759775,192
1361151406,1572786968,9,861,95.66666667,1361151379191,1361151379383,1572760159,1572760351,192
1361151406,1572786968,1,46,46,1361151379189,1361151379189,1572760157,1572760157,0
1361151406,1572786972,9,861,95.66666667,1361151379443,1361151379699,1572760415,1572760671,256
1361151598,1572979368,3,189,63,1361151592161,1361151595169,1572973529,1572976537,3008
1361151614,1572995440,2,126,63,1361151599131,1361151607195,1572980571,1572988635,8064
1361151628,1573009488,1,46,46,1361151600105,1361151600105,1572981593,1572981593,0
1361151654,1573035476,4,252,63,1361151645238,1361151652278,1573026714,1573033754,7040
1361151686,1573067288,1,63,63,1361151660466,1361151660466,1573041754,1573041754,0
1361151694,1573075560,4,252,63,1361151685538,1361151692578,1573067098,1573074138,7040
1361151726,1573107504,1,63,63,1361151700696,1361151700696,1573082200,1573082200,0
1361151738,211432160,5,573,114.6,1361151734750,1361151734814,211428910,211428974,64
1361151743,1573124140,17,6755,397.3529412,1361151725125,1361151735493,1573106265,1573116633,10368
1361151743,1573124140,12,999,83.25,1361151725508,1361151735492,1573106648,1573116632,9984
1361151743,1573124140,11,953,86.63636364,1361151726020,1361151735492,1573107160,1573116632,9472
1361151743,1573124212,11,953,86.63636364,1361151725691,1361151735419,1573106903,1573116631,9728
1361151751,1573132156,2,126,63,1361151749813,1361151750837,1573130969,1573131993,1024
1361151759,1573140104,2,126,63,1361151752870,1361151756902,1573133974,1573138006,4032
1361151791,1573171616,1,63,63,1361151765454,1361151765454,1573146070,1573146070,0
1361152384,1573764984,11,953,86.63636364,1361152371029,1361152381653,1573752013,1573762637,10624
1361152384,1573765024,11,953,86.63636364,1361152371568,1361152381616,1573752592,1573762640,10048
1361152384,1573765072,12,999,83.25,1361152371263,1361152381567,1573752335,1573762639,10304
1361153996,1575376628,9,861,95.66666667,1361153970401,1361153970529,1575351029,1575351157,128
1361153996,1575376696,14,6617,472.6428571,1361153969948,1361153970204,1575350644,1575350900,256
1361153996,1575376732,9,861,95.66666667,1361153970554,1361153970746,1575351286,1575351478,192
1361154162,1575542588,4,252,63,1361154154312,1361154161352,1575534900,1575541940,7040
1361154196,1575577132,1,63,63,1361154168869,1361154168869,1575550001,1575550001,0
1361154209,1575590516,4,252,63,1361154201512,1361154208552,1575583028,1575590068,7040
1361154209,1575590516,3,189,63,1361154204773,1361154207845,1575586289,1575589361,3072
1361154225,1575606480,2,126,63,1361154211914,1361154219914,1575593394,1575601394,8000
1361154244,1575625200,1,63,63,1361154216930,1361154216930,1575598130,1575598130,0
1361154425,1575805624,8,815,101.875,1361154398815,1361154399007,1575779439,1575779631,192
1361154425,1575805704,8,815,101.875,1361154398222,1361154398414,1575778926,1575779118,192
1361154425,1575805708,8,815,101.875,1361154398476,1361154398668,1575779184,1575779376,192
1361154698,1576078748,4,235,58.75,1361154694493,1361154697565,1576075241,1576078313,3072
1361154698,1576078828,4,252,63,1361154690190,1361154697294,1576071018,1576078122,7104
1361154698,1576078840,3,189,63,1361154694402,1361154697410,1576075242,1576078250,3008
1361154725,1576106028,14,6617,472.6428571,1361154698694,1361154698950,1576079722,1576079978,256
1361154725,1576106032,9,861,95.66666667,1361154699075,1361154699267,1576080107,1576080299,192
1361154725,1576106040,9,861,95.66666667,1361154699580,1361154699772,1576080620,1576080812,192
1361154725,1576106124,8,815,101.875,1361154699238,1361154699430,1576080362,1576080554,192
1361154938,1576318964,4,252,63,1361154930245,1361154937285,1576311209,1576318249,7040
1361154954,1576335016,4,252,63,1361154945936,1361154952976,1576326952,1576333992,7040
1361154962,1576343064,4,252,63,1361154953053,1361154960093,1576334117,1576341157,7040
1361154966,1576346616,4,252,63,1361154953437,1361154960541,1576334053,1576341157,7104
1361154970,1576350868,1,63,63,1361154945442,1361154945442,1576326310,1576326310,0
1361154986,1576367228,1,63,63,1361154960825,1361154960825,1576342053,1576342053,0
1361154994,1576375084,1,63,63,1361154968139,1361154968139,1576349223,1576349223,0
1361154994,1576375084,1,63,63,1361154968139,1361154968139,1576349223,1576349223,0
1361155708,1577088868,12,999,83.25,1361155693976,1361155704792,1577074844,1577085660,10816
1361155708,1577088892,12,999,83.25,1361155694529,1361155704705,1577075421,1577085597,10176
1361155708,1577088944,12,999,83.25,1361155694221,1361155704653,1577075165,1577085597,10432
1361155852,1577233044,12,999,83.25,1361155837411,1361155848931,1577218455,1577229975,11520
1361155852,1577233048,15,6289,419.2666667,1361155837665,1361155848929,1577218713,1577229977,11264
1361155852,1577233124,11,953,86.63636364,1361155836820,1361155848916,1577217944,1577230040,12096
1361155852,1577233124,12,999,83.25,1361155837075,1361155848915,1577218199,1577230039,11840
1361155868,1577248860,11,3267,297,1361155839835,1361155840411,1577220695,1577221271,576
1361155876,1577257108,3,205,68.33333333,1361155874467,1361155874915,1577255575,1577256023,448
1361157010,1578390768,11,3267,297,1361156983465,1361156986409,1578364233,1578367177,2944
1361157078,1578459060,2,141,70.5,1361157070914,1361157070914,1578451974,1578451974,0
1361157674,1579055336,9,861,95.66666667,1361157648231,1361157648423,1579029567,1579029759,192
1361157674,1579055412,12,6151,512.5833333,1361157647002,1361157647770,1579028414,1579029182,768
1361157674,1579055420,9,861,95.66666667,1361157647889,1361157648081,1579029309,1579029501,192
1361157674,1579055424,13,2393,184.0769231,1361157648396,1361157663820,1579029820,1579045244,15424
1361157706,1579087292,1,383,383,1361157680017,1361157680017,1579061309,1579061309,0
1361157738,1579119444,1,383,383,1361157711991,1361157711991,1579093435,1579093435,0
1361157803,1579183696,1,383,383,1361157777061,1361157777061,1579157757,1579157757,0
1361157903,1579283976,3,189,63,1361157897161,1361157900169,1579278137,1579281145,3008
1361157919,1579300212,2,126,63,1361157915935,1361157916895,1579297147,1579298107,960
1361157919,1579300212,2,126,63,1361157903965,1361157912029,1579285177,1579293241,8064
1361157919,1579300244,3,189,63,1361157912637,1361157915709,1579293881,1579296953,3072
1361157927,1579308224,2,126,63,1361157918929,1361157922961,1579300153,1579304185,4032
1361157935,1579316384,2,126,63,1361157919599,1361157927599,1579300983,1579308983,8000
1361157959,1579339996,1,63,63,1361157931254,1361157931254,1579312250,1579312250,0
1361159029,1580410208,1,46,46,1361159001679,1361159001679,1580382887,1580382887,0
1361159457,1580837864,17,6755,397.3529412,1361159443040,1361159451552,1580823904,1580832416,8512
1361159457,1580837872,11,953,86.63636364,1361159443420,1361159451484,1580824292,1580832356,8064
1361159457,1580837876,11,953,86.63636364,1361159443735,1361159451479,1580824611,1580832355,7744
1361159482,1580863488,8,815,101.875,1361159457651,1361159457779,1580839139,1580839267,128
1361159486,1580867516,9,861,95.66666667,1361159457877,1361159458005,1580839393,1580839521,128
1361159486,1580867520,8,815,101.875,1361159458130,1361159458322,1580839650,1580839842,192
1361159486,1580867524,8,815,101.875,1361159458383,1361159458575,1580839907,1580840099,192
1361159729,1581109972,4,252,63,1361159720945,1361159727985,1581101917,1581108957,7040
1361159729,1581110060,3,189,63,1361159722139,1361159725211,1581103199,1581106271,3072
1361159729,1581110064,4,252,63,1361159720853,1361159727893,1581101917,1581108957,7040
1361159729,1581110064,4,252,63,1361159720853,1361159727893,1581101917,1581108957,7040
1361159745,1581126080,2,126,63,1361159729220,1361159737220,1581110300,1581118300,8000
1361159763,1581144368,1,63,63,1361159735652,1361159735652,1581117020,1581117020,0
1361159763,1581144368,1,63,63,1361159735652,1361159735652,1581117020,1581117020,0
1361159763,1581144456,1,63,63,1361159735564,1361159735564,1581117020,1581117020,0
1361160578,1581958796,11,953,86.63636364,1361160562069,1361160573525,1581942865,1581954321,11456
1361160578,1581958800,15,6289,419.2666667,1361160561427,1361160573523,1581942227,1581954323,12096
1361160578,1581958812,11,953,86.63636364,1361160562374,1361160573510,1581943186,1581954322,11136
1361160578,1581958820,12,999,83.25,1361160561790,1361160573502,1581942610,1581954322,11712
1361161267,1582648500,17,6755,397.3529412,1361161248906,1361161259978,1582630406,1582641478,11072
1361161267,1582648504,12,999,83.25,1361161249541,1361161259909,1582631045,1582641413,10368
1361161267,1582648556,12,999,83.25,1361161249235,1361161259923,1582630791,1582641479,10688
1361161291,1582672232,2,152,76,1361161263831,1361161278871,1582645063,1582660103,15040
1361161319,1582700300,2,152,76,1361161293841,1361161308881,1582675141,1582690181,15040
1361161351,1582732292,1,76,76,1361161323928,1361161323928,1582705220,1582705220,0
1361162362,1583742936,1,68,68,1361162337071,1361162337071,1583718007,1583718007,0
1361163061,1584442488,44,56507,1284.25,1361163058171,1361163058427,1584439659,1584439915,256
1361163077,1584458504,12,999,83.25,1361163062764,1361163071276,1584444268,1584452780,8512
1361163077,1584458512,17,6755,397.3529412,1361163063201,1361163071265,1584444713,1584452777,8064
1361163077,1584458512,11,953,86.63636364,1361163063586,1361163071266,1584445098,1584452778,7680
1361163088,1584468848,1,46,46,1361163063481,1361163063481,1584444329,1584444329,0
1361163104,1584484904,9,861,95.66666667,1361163079298,1361163079490,1584460202,1584460394,192
1361163104,1584484924,8,815,101.875,1361163079596,1361163079788,1584460520,1584460712,192
1361163108,1584488752,8,815,101.875,1361163080024,1361163080216,1584460776,1584460968,192
1361163108,1584488920,8,815,101.875,1361163080115,1361163080307,1584461035,1584461227,192
1361163294,1584674904,2,126,63,1361163290943,1361163291903,1584671847,1584672807,960
1361163302,1584682872,2,126,63,1361163293984,1361163298016,1584674856,1584678888,4032
1361163326,1584706920,2,126,63,1361163323245,1361163324269,1584704165,1584705189,1024
1361163332,1584713392,1,63,63,1361163305493,1361163305493,1584686885,1584686885,0
1361163334,1584714936,2,126,63,1361163326239,1361163330271,1584707175,1584711207,4032
1361163342,1584722856,2,126,63,1361163340655,1361163341679,1584721511,1584722535,1024
1361163342,1584722908,2,126,63,1361163340668,1361163341628,1584721576,1584722536,960
1361163350,1584730900,2,126,63,1361163343683,1361163347715,1584724583,1584728615,4032
1361163350,1584730952,2,126,63,1361163343629,1361163347661,1584724581,1584728613,4032
1361163364,1584745184,1,63,63,1361163338084,1361163338084,1584719268,1584719268,0
1361163897,1585278212,2,122,61,1361163871620,1361163871748,1585252832,1585252960,128
1361164851,1586232012,1,78,78,1361164823805,1361164823805,1586204817,1586204817,0
1361164887,1586268336,12,999,83.25,1361164872822,1361164883446,1586254158,1586264782,10624
1361164887,1586268340,12,999,83.25,1361164873329,1361164883377,1586254669,1586264717,10048
1361164887,1586268344,12,999,83.25,1361164873073,1361164883377,1586254417,1586264721,10304
1361164887,1586268412,17,6755,397.3529412,1361164872363,1361164883371,1586253775,1586264783,11008
1361166700,1588080560,8,815,101.875,1361166673572,1361166673764,1588054132,1588054324,192
1361166700,1588080564,8,815,101.875,1361166673822,1361166674014,1588054386,1588054578,192
1361166700,1588080600,14,6617,472.6428571,1361166673148,1361166673468,1588053748,1588054068,320
1361167017,1588398164,4,252,63,1361167008067,1361167015107,1588389231,1588396271,7040
1361167017,1588398208,4,252,63,1361167007959,1361167015063,1588389167,1588396271,7104
1361167017,1588398208,4,252,63,1361167007958,1361167015062,1588389166,1588396270,7104
1361167048,1588429476,1,63,63,1361167022857,1361167022857,1588404333,1588404333,0
1361167049,1588429556,1,63,63,1361167023776,1361167023776,1588404332,1588404332,0
1361167049,1588429560,1,63,63,1361167023776,1361167023776,1588404336,1588404336,0
1361167129,1588509852,9,861,95.66666667,1361167103418,1361167103610,1588484270,1588484462,192
1361167129,1588509856,8,815,101.875,1361167103670,1361167103862,1588484526,1588484718,192
1361167129,1588509936,9,861,95.66666667,1361167103910,1361167104102,1588484846,1588485038,192
1361167346,1588726608,2,126,63,1361167344554,1361167345578,1588725162,1588726186,1024
1361167354,1588734656,2,126,63,1361167347579,1361167351611,1588728235,1588732267,4032
1361167370,1588750924,3,189,63,1361167365294,1361167368302,1588746218,1588749226,3008
1361167386,1588766620,1,63,63,1361167359710,1361167359710,1588740330,1588740330,0
1361167386,1588766896,2,126,63,1361167372362,1361167380426,1588753258,1588761322,8064
1361167386,1588766900,3,189,63,1361167380869,1361167383877,1588761769,1588764777,3008
1361167402,1588782812,3,172,57.33333333,1361167387998,1361167396638,1588768810,1588777450,8640
1361167402,1588782812,2,92,46,1361167396636,1361167396636,1588777448,1588777448,0
1361167402,1588782876,2,92,46,1361167396574,1361167396574,1588777450,1588777450,0
1361167426,1588806644,14,6617,472.6428571,1361167399236,1361167399492,1588779880,1588780136,256
1361167426,1588806648,9,861,95.66666667,1361167399617,1361167399809,1588780265,1588780457,192
1361167426,1588806680,8,815,101.875,1361167400095,1361167400287,1588780775,1588780967,192
1361167426,1588806724,9,861,95.66666667,1361167399795,1361167399987,1588780519,1588780711,192
1361167642,1589023520,2,126,63,1361167638932,1361167639956,1589020452,1589021476,1024
1361167650,1589031488,2,126,63,1361167641971,1361167646003,1589023459,1589027491,4032
1361167675,1589055596,3,189,63,1361167668978,1361167671986,1589049574,1589052582,3008
1361167675,1589055596,3,189,63,1361167668977,1361167672049,1589049573,1589052645,3072
1361167683,1589063672,1,63,63,1361167654884,1361167654884,1589035556,1589035556,0
1361167691,1589071612,2,126,63,1361167676001,1361167684065,1589056613,1589064677,8064
1361167691,1589071612,2,126,63,1361167676065,1361167684065,1589056677,1589064677,8000
1361167691,1589071648,3,189,63,1361167686461,1361167689469,1589067109,1589070117,3008
1361167707,1589087564,2,126,63,1361167693584,1361167701648,1589074148,1589082212,8064
1361168009,1589389532,1,46,46,1361167980457,1361167980457,1589360989,1589360989,0
1361168614,1589995180,1,46,46,1361168586394,1361168586394,1589967574,1589967574,0
1361169214,1590595216,9,861,95.66666667,1361169187693,1361169187885,1590568909,1590569101,192
1361169214,1590595232,9,861,95.66666667,1361169187996,1361169188124,1590569228,1590569356,128
1361169214,1590595240,9,861,95.66666667,1361169188246,1361169188374,1590569486,1590569614,128
1361169460,1590841100,3,172,57.33333333,1361169456669,1361169457693,1590837769,1590838793,1024
1361169460,1590841100,3,138,46,1361169456669,1361169456733,1590837769,1590837833,64
1361169483,1590864140,9,861,95.66666667,1361169458422,1361169458614,1590839562,1590839754,192
1361169483,1590864180,2,109,54.5,1361169456589,1361169456589,1590837769,1590837769,0
1361169483,1590864208,9,861,95.66666667,1361169457839,1361169458031,1590839047,1590839239,192
1361169483,1590864216,9,861,95.66666667,1361169458090,1361169458282,1590839306,1590839498,192
1361169487,1590868084,14,6617,472.6428571,1361169458925,1361169459245,1590840009,1590840329,320
1361169543,1590924488,1,46,46,1361169515545,1361169515545,1590897033,1590897033,0
1361169740,1591121212,3,189,63,1361169735657,1361169738729,1591116869,1591119941,3072
1361169740,1591121228,3,189,63,1361169734616,1361169737688,1591115844,1591118916,3072
1361169756,1591137244,2,126,63,1361169742663,1361169750727,1591123907,1591131971,8064
1361169756,1591137288,2,126,63,1361169741597,1361169749661,1591122885,1591130949,8064
1361169788,1591169232,3,189,63,1361169782742,1361169785750,1591163974,1591166982,3008
1361169804,1591185272,2,126,63,1361169789740,1361169797804,1591171012,1591179076,8064
1361169868,1591249292,3,189,63,1361169862678,1361169865686,1591243970,1591246978,3008
1361169884,1591265284,2,126,63,1361169869728,1361169877792,1591251012,1591259076,8064
1361170574,1591954724,1,60,60,1361170547651,1361170547651,1591928375,1591928375,0
1361170574,1591954808,2,120,60,1361170547568,1361170550512,1591928376,1591931320,2944
1361170587,1591967632,1,46,46,1361170560482,1361170560482,1591941114,1591941114,0
1361170587,1591968420,1,46,46,1361170559692,1361170559692,1591941112,1591941112,0
1361170853,1592233956,2,92,46,1361170850327,1361170850327,1592231283,1592231283,0
1361170853,1592233956,2,92,46,1361170850326,1361170850326,1592231282,1592231282,0
1361170853,1592234000,2,92,46,1361170850285,1361170850285,1592231285,1592231285,0
1361170853,1592234000,2,92,46,1361170850284,1361170850284,1592231284,1592231284,0
1361170869,1592249968,16,6372,398.25,1361170851530,1361170863626,1592232498,1592244594,12096
1361170869,1592249968,12,999,83.25,1361170851917,1361170863629,1592232885,1592244597,11712
1361170869,1592249992,12,999,83.25,1361170852149,1361170863605,1592233141,1592244597,11456
1361170869,1592250036,11,953,86.63636364,1361170852424,1361170863560,1592233460,1592244596,11136
1361171765,1593145948,14,6617,472.6428571,1361171737488,1361171737808,1593118436,1593118756,320
1361171765,1593145956,8,815,101.875,1361171738184,1361171738312,1593119140,1593119268,128
1361171765,1593146020,9,861,95.66666667,1361171737864,1361171737992,1593118884,1593119012,128
1361171926,231620168,1,46,46,1361171899674,1361171899674,231593842,231593842,0
1361171958,1593339252,4,252,63,1361171949661,1361171956765,1593330913,1593338017,7104
1361171961,1593342504,2,120,60,1361171934435,1361171937379,1593315939,1593318883,2944
1361171982,1593363252,3,189,63,1361171976544,1361171979552,1593357796,1593360804,3008
1361171982,1593363292,3,189,63,1361171976566,1361171979574,1593357858,1593360866,3008
1361171990,1593370716,3,155,51.66666667,1361171965301,1361171988533,1593346017,1593369249,23232
1361171990,1593371288,5,264,52.8,1361171983545,1361171988025,1593364833,1593369313,4480
1361171990,1593371292,5,264,52.8,1361171983669,1361171988021,1593364961,1593369313,4352
1361172006,1593387284,11,953,86.63636364,1361171990013,1361172001597,1593371297,1593382881,11584
1361172006,1593387324,11,953,86.63636364,1361171989461,1361172001557,1593370785,1593382881,12096
1361172006,1593387328,12,999,83.25,1361171990292,1361172001556,1593371620,1593382884,11264
1361172006,1593387328,12,999,83.25,1361171989716,1361172001556,1593371044,1593382884,11840
1361172322,1593703156,1,46,46,1361172294968,1361172294968,1593676124,1593676124,0
1361172739,1594119608,1,46,46,1361172714648,1361172714648,1594095256,1594095256,0
1361172923,1594303844,1,52,52,1361172895977,1361172895977,1594276821,1594276821,0
1361173220,1594600632,1,46,46,1361173192951,1361173192951,1594573583,1594573583,0
1361173220,1594600684,1,46,46,1361173193668,1361173193668,1594574352,1594574352,0
1361173833,1595214232,8,815,101.875,1361173805975,1361173806167,1595187207,1595187399,192
1361173833,1595214296,14,6617,472.6428571,1361173805527,1361173805847,1595186823,1595187143,320
1361173833,1595214308,8,815,101.875,1361173806155,1361173806347,1595187463,1595187655,192
1361173928,233622012,3,919,306.3333333,1361173927364,1361173927364,233621376,233621376,0
1361173936,233629964,4,478,119.5,1361173928370,1361173928434,233622334,233622398,64
1361173936,233629968,4,971,242.75,1361173933680,1361173934128,233627648,233628096,448
1361173936,1595316892,10,1994,199.4,1361173934312,1361173934440,1595315204,1595315332,128
1361173936,1595316896,10,2818,281.8,1361173934630,1361173934822,1595315526,1595315718,192
1361173936,1595316896,10,2802,280.2,1361173934438,1361173934630,1595315334,1595315526,192
1361173936,1595316896,8,2378,297.25,1361173934884,1361173935012,1595315780,1595315908,128
1361173936,1595316896,8,2386,298.25,1361173934819,1361173934883,1595315715,1595315779,64
1361173936,1595316900,10,1994,199.4,1361173935137,1361173935329,1595316037,1595316229,192
1361173936,1595316900,10,1994,199.4,1361173935392,1361173935584,1595316292,1595316484,192
1361173936,1595316900,8,1890,236.25,1361173935328,1361173935392,1595316228,1595316292,64
1361173936,1595316900,8,1890,236.25,1361173935711,1361173935839,1595316611,1595316739,128
1361173936,1595316900,10,1994,199.4,1361173935583,1361173935711,1595316483,1595316611,128
1361173936,1595316900,8,1424,178,1361173932255,1361173932639,1595313155,1595313539,384
1361173936,1595316932,8,2930,366.25,1361173933890,1361173934082,1595314822,1595315014,192
1361173936,1595316932,8,2634,329.25,1361173934144,1361173934272,1595315076,1595315204,128
1361173936,1595316932,8,2378,297.25,1361173934080,1361173934144,1595315012,1595315076,64
1361173936,1595316940,9,1942,215.7777778,1361173934970,1361173935098,1595315910,1595316038,128
1361173936,1595316944,9,3357,373,1361173927734,1361173928886,1595308678,1595309830,1152
1361173944,233637964,4,478,119.5,1361173943283,1361173943283,233637247,233637247,0
1361173944,1595324900,7,2454,350.5714286,1361173935904,1361173936032,1595316804,1595316932,128
1361173944,1595324900,8,1890,236.25,1361173937375,1361173937503,1595318275,1595318403,128
1361173944,1595324904,8,1890,236.25,1361173937308,1361173937372,1595318212,1595318276,64
1361173944,1595324912,8,2922,365.25,1361173937045,1361173937173,1595317957,1595318085,128
1361173944,1595324912,9,3246,360.6666667,1361173937172,1361173937300,1595318084,1595318212,128
1361173944,1595324912,7,1401,200.1428571,1361173939924,1361173940500,1595320836,1595321412,576
1361173944,1595324916,7,2334,333.4285714,1361173935825,1361173935953,1595316741,1595316869,128
1361173944,1595324916,11,3598,327.0909091,1361173937487,1361173937615,1595318403,1595318531,128
1361173944,1595324920,10,1994,199.4,1361173936010,1361173936202,1595316930,1595317122,192
1361173944,1595324920,12,4008,334,1361173929614,1361173941454,1595310534,1595322374,11840
1361173944,1595324920,10,1994,199.4,1361173937614,1361173937806,1595318534,1595318726,192
1361173944,1595324920,9,1942,215.7777778,1361173937805,1361173938189,1595318725,1595319109,384
1361173944,1595324920,10,2850,285,1361173936205,1361173936333,1595317125,1595317253,128
1361173944,1595324920,7,2326,332.2857143,1361173936332,1361173936460,1595317252,1595317380,128
1361173944,1595324944,10,1994,199.4,1361173936437,1361173936629,1595317381,1595317573,192
1361173944,1595324944,12,3622,301.8333333,1361173938484,1361173941428,1595319428,1595322372,2944
1361173944,1595324944,9,1942,215.7777778,1361173936627,1361173936819,1595317571,1595317763,192
1361173944,1595324948,11,2959,269,1361173930609,1361173941489,1595311557,1595322437,10880
1361173944,1595324948,8,1977,247.125,1361173936816,1361173941424,1595317764,1595322372,4608
1361173944,1595324948,10,4818,481.8,1361173936816,1361173936944,1595317764,1595317892,128
1361173944,1595324948,7,2342,334.5714286,1361173936944,1361173937008,1595317892,1595317956,64
1361173944,1595324948,8,2021,252.625,1361173937071,1361173937135,1595318019,1595318083,64
1361173944,1595324952,6,1811,301.8333333,1361173931566,1361173941358,1595312518,1595322310,9792
1361173961,1595342348,1,108,108,1361173936097,1361173936097,1595317445,1595317445,0
1361173961,1595342416,1,108,108,1361173936156,1361173936156,1595317572,1595317572,0
1361173961,1595342420,1,108,108,1361173936218,1361173936218,1595317638,1595317638,0
1361173969,233663128,1,52,52,1361173941517,1361173941517,233635645,233635645,0
1361174136,1595517020,3,189,63,1361174129188,1361174132196,1595510208,1595513216,3008
1361174136,1595517020,3,189,63,1361174129188,1361174132260,1595510208,1595513280,3072
1361174136,1595517064,3,189,63,1361174129211,1361174132219,1595510275,1595513283,3008
1361174152,1595533016,2,126,63,1361174136295,1361174144359,1595517311,1595525375,8064
1361174152,1595533052,2,126,63,1361174136198,1361174144262,1595517250,1595525314,8064
1361174152,1595533052,2,126,63,1361174136262,1361174144326,1595517314,1595525378,8064
1361174224,1595605084,12,999,83.25,1361174212771,1361174220067,1595593855,1595601151,7296
1361174224,1595605120,11,953,86.63636364,1361174212480,1361174220032,1595593600,1595601152,7552
1361174224,1595605120,12,999,83.25,1361174212991,1361174220031,1595594111,1595601151,7040
1361174224,1595605120,12,999,83.25,1361174213247,1361174220031,1595594367,1595601151,6784
1361176034,1597414636,9,861,95.66666667,1361176008842,1361176009034,1597389478,1597389670,192
1361176034,1597414672,9,861,95.66666667,1361176008550,1361176008742,1597389222,1597389414,192
1361176034,1597414672,13,6234,479.5384615,1361176008166,1361176008486,1597388838,1597389158,320
1361176076,1597457248,1,46,46,1361176045987,1361176045987,1597427235,1597427235,0
1361176076,1597457252,1,46,46,1361176045985,1361176045985,1597427237,1597427237,0
1361176230,1597610528,5,250,50,1361176202676,1361176224628,1597583204,1597605156,21952
1361176259,1597639572,3,138,46,1361176257094,1361176257158,1597637666,1597637730,64
1361176259,1597639572,3,138,46,1361176257158,1361176257222,1597637730,1597637794,64
1361176259,1597639572,3,138,46,1361176257093,1361176257157,1597637665,1597637729,64
1361176274,1597654580,1,48,48,1361176248639,1361176248639,1597629219,1597629219,0
1361176282,1597662636,9,861,95.66666667,1361176257795,1361176257923,1597638431,1597638559,128
1361176286,1597666572,8,815,101.875,1361176258373,1361176258565,1597638945,1597639137,192
1361176286,1597666576,8,815,101.875,1361176258626,1361176258818,1597639202,1597639394,192
1361176286,1597666612,8,815,101.875,1361176258078,1361176258270,1597638690,1597638882,192
1361176302,1597682680,1,48,48,1361176277721,1361176277721,1597658401,1597658401,0
1361176474,1597855028,1,46,46,1361176449467,1361176449467,1597830495,1597830495,0
1361176555,1597935696,4,252,63,1361176547397,1361176554437,1597928093,1597935133,7040
1361176555,1597935696,4,252,63,1361176547397,1361176554437,1597928093,1597935133,7040
1361176555,1597935708,4,252,63,1361176547385,1361176554425,1597928093,1597935133,7040
1361176586,1597967404,1,63,63,1361176561791,1361176561791,1597943195,1597943195,0
1361176586,1597967404,1,63,63,1361176561791,1361176561791,1597943195,1597943195,0
1361176587,1597967696,1,63,63,1361176562502,1361176562502,1597943198,1597943198,0
1361176675,1598055760,3,189,63,1361176668993,1361176672001,1598049753,1598052761,3008
1361176691,1598071856,2,126,63,1361176675938,1361176684002,1598056794,1598064858,8064
1361177822,1599203008,14,6617,472.6428571,1361177796856,1361177797112,1599177864,1599178120,256
1361177822,1599203036,9,861,95.66666667,1361177797726,1361177797918,1599178762,1599178954,192
1361177822,1599203052,1,46,46,1361177796750,1361177796750,1599177802,1599177802,0
1361177822,1599203072,9,861,95.66666667,1361177797178,1361177797306,1599178250,1599178378,128
1361177822,1599203072,8,815,101.875,1361177797433,1361177797625,1599178505,1599178697,192
1361178012,1599392896,4,252,63,1361178004584,1361178011688,1599385480,1599392584,7104
1361178046,1599427508,1,63,63,1361178019074,1361178019074,1599400582,1599400582,0
1361178116,1599496972,2,126,63,1361178114010,1361178115034,1599494982,1599496006,1024
1361178116,1599496972,2,126,63,1361178114010,1361178115034,1599494982,1599496006,1024
1361178124,1599504936,2,126,63,1361178117115,1361178121147,1599498051,1599502083,4032
1361178124,1599504972,2,126,63,1361178117016,1361178121048,1599497988,1599502020,4032
1361178132,1599512960,3,189,63,1361178128549,1361178131557,1599509509,1599512517,3008
1361178148,1599529004,2,126,63,1361178135543,1361178143607,1599516547,1599524611,8064
1361178155,1599535608,1,63,63,1361178129477,1361178129477,1599510085,1599510085,0
1361178155,1599535608,1,63,63,1361178129476,1361178129476,1599510084,1599510084,0
1361178308,1599689180,1,46,46,1361178279750,1361178279750,1599660930,1599660930,0
1361178309,1599690396,1,46,46,1361178279596,1361178279596,1599660992,1599660992,0
1361178684,1600064676,1,438,438,1361178656888,1361178656888,1600037564,1600037564,0
1361178684,1600064708,1,440,440,1361178658201,1361178658201,1600038909,1600038909,0
1361178692,1600073208,17,6755,397.3529412,1361178675876,1361178685604,1600057084,1600066812,9728
1361178692,1600073208,12,999,83.25,1361178676196,1361178685604,1600057404,1600066812,9408
1361178692,1600073212,11,953,86.63636364,1361178676769,1361178685537,1600057981,1600066749,8768
1361178692,1600073248,11,953,86.63636364,1361178676478,1361178685566,1600057726,1600066814,9088
1361178880,1600261232,1,46,46,1361178851976,1361178851976,1600233208,1600233208,0
1361179221,1600601736,1,46,46,1361179196469,1361179196469,1600577205,1600577205,0
1361179225,1600605692,1,64,64,1361179198816,1361179198816,1600579508,1600579508,0
1361179229,1600609728,1,64,64,1361179203325,1361179203325,1600584053,1600584053,0
1361180503,1601884400,9,861,95.66666667,1361180478215,1361180478407,1601859615,1601859807,192
1361180503,1601884408,8,815,101.875,1361180478720,1361180478912,1601860128,1601860320,192
1361180503,1601884444,9,861,95.66666667,1361180478430,1361180478622,1601859874,1601860066,192
1361180589,1601969900,1,46,46,1361180563644,1361180563644,1601944544,1601944544,0
1361180590,1601970676,1,46,46,1361180563868,1361180563868,1601944544,1601944544,0
1361180605,1601985992,1,48,48,1361180577696,1361180577696,1601958688,1601958688,0
1361180606,1601986884,1,48,48,1361180577804,1361180577804,1601958688,1601958688,0
1361180671,1602051716,3,138,46,1361180669362,1361180669426,1602050078,1602050142,64
1361180671,1602051716,3,138,46,1361180669362,1361180669490,1602050078,1602050206,128
1361180696,1602076860,9,861,95.66666667,1361180671839,1361180672031,1602052699,1602052891,192
1361180696,1602077192,14,6617,472.6428571,1361180670613,1361180670933,1602051805,1602052125,320
1361180696,1602077200,8,815,101.875,1361180670991,1361180671119,1602052191,1602052319,128
1361180696,1602077200,3,155,51.66666667,1361180668684,1361180668876,1602049884,1602050076,192
1361180696,1602077204,9,861,95.66666667,1361180671243,1361180671435,1602052447,1602052639,192
1361180863,1602243816,3,189,63,1361180856908,1361180859916,1602237724,1602240732,3008
1361180863,1602243824,3,189,63,1361180856385,1361180859457,1602237209,1602240281,3072
1361180879,1602259832,2,126,63,1361180863418,1361180871482,1602244250,1602252314,8064
1361180879,1602259856,2,126,63,1361180863908,1361180871972,1602244764,1602252828,8064
1361180903,1602283844,4,252,63,1361180894640,1361180901680,1602275484,1602282524,7040
1361180936,1602317108,1,63,63,1361180909476,1361180909476,1602290584,1602290584,0
1361180999,1602379868,3,189,63,1361180992853,1361180995861,1602373721,1602376729,3008
1361181015,1602395908,2,126,63,1361180999854,1361181007918,1602380762,1602388826,8064
1361181093,1602473528,1,46,46,1361181065641,1361181065641,1602446169,1602446169,0
1361181505,1602885936,1,46,46,1361181479947,1361181479947,1602860883,1602860883,0
1361182299,1603680056,14,6617,472.6428571,1361182272644,1361182272964,1603653700,1603654020,320
1361182299,1603680092,8,815,101.875,1361182272992,1361182273184,1603654084,1603654276,192
1361182299,1603680096,9,861,95.66666667,1361182273246,1361182273438,1603654342,1603654534,192
1361182528,1603909032,3,138,46,1361182522585,1361182522649,1603903617,1603903681,64
1361182528,1603909032,3,138,46,1361182522585,1361182522649,1603903617,1603903681,64
1361182528,1603909044,3,138,46,1361182522576,1361182522640,1603903620,1603903684,64
1361182552,1603932916,9,861,95.66666667,1361182524556,1361182524684,1603905472,1603905600,128
1361182552,1603932920,9,861,95.66666667,1361182524811,1361182525003,1603905731,1603905923,192
1361182552,1603932920,9,861,95.66666667,1361182525065,1361182525257,1603905985,1603906177,192
1361182552,1603932920,9,861,95.66666667,1361182525320,1361182525512,1603906240,1603906432,192
1361182744,1604125216,4,252,63,1361182736156,1361182743196,1604117372,1604124412,7040
1361182760,1604141244,3,189,63,1361182755331,1361182758339,1604136575,1604139583,3008
1361182776,1604157084,1,63,63,1361182751392,1361182751392,1604132476,1604132476,0
1361182776,1604157228,2,126,63,1361182762386,1361182770386,1604143614,1604151614,8000
1361182808,1604189296,3,189,63,1361182801676,1361182804684,1604182972,1604185980,3008
1361182824,1604205320,2,126,63,1361182808692,1361182816756,1604190012,1604198076,8064
1361182848,1604229312,3,189,63,1361182841852,1361182844860,1604223164,1604226172,3008
1361182864,1604245380,2,126,63,1361182848825,1361182856889,1604230205,1604238269,8064
1361183589,1604970464,1,48,48,1361183562138,1361183562138,1604943602,1604943602,0
1361183598,1604978512,2,96,48,1361183572178,1361183575442,1604952690,1604955954,3264
1361184073,1605453984,2,92,46,1361184065648,1361184065648,1605446632,1605446632,0
1361184073,1605453992,2,92,46,1361184065643,1361184065643,1605446635,1605446635,0
1361184073,1605453992,2,92,46,1361184065643,1361184065643,1605446635,1605446635,0
1361184091,1605471588,1,46,46,1361184065980,1361184065980,1605446568,1605446568,0
1361184091,1605471600,14,6617,472.6428571,1361184066802,1361184067122,1605447402,1605447722,320
1361184095,1605475560,8,815,101.875,1361184067226,1361184067418,1605447786,1605447978,192
1361184095,1605475564,9,861,95.66666667,1361184067798,1361184067926,1605448362,1605448490,128
1361184095,1605475600,9,861,95.66666667,1361184067441,1361184067633,1605448041,1605448233,192
1361184313,1605694260,3,189,63,1361184309080,1361184312088,1605690340,1605693348,3008
1361184329,1605710220,2,126,63,1361184316161,1361184324225,1605697381,1605705445,8064
1361184329,1605710228,2,126,63,1361184326715,1361184327739,1605707943,1605708967,1024
1361184329,1605710228,2,126,63,1361184326715,1361184327739,1605707943,1605708967,1024
1361184337,1605718224,3,189,63,1361184331902,1361184334910,1605713126,1605716134,3008
1361184337,1605718240,2,126,63,1361184329711,1361184333743,1605710951,1605714983,4032
1361184337,1605718240,2,126,63,1361184329711,1361184333743,1605710951,1605714983,4032
1361184353,1605734232,2,126,63,1361184338933,1361184346997,1605720165,1605728229,8064
1361184367,1605748172,1,63,63,1361184341874,1361184341874,1605723046,1605723046,0
1361184367,1605748212,1,63,63,1361184341832,1361184341832,1605723044,1605723044,0
1361184881,1606261524,3,138,46,1361184855411,1361184864627,1606235935,1606245151,9216
1361184933,1606313920,3,144,48,1361184906149,1361184915237,1606287069,1606296157,9088
1361185105,1606486340,1,46,46,1361185078142,1361185078142,1606459482,1606459482,0
1361185197,1606578392,8,815,101.875,1361185172551,1361185172743,1606553943,1606554135,192
1361185197,1606578392,9,861,95.66666667,1361185172809,1361185173001,1606554201,1606554393,192
1361185197,1606578424,9,861,95.66666667,1361185172266,1361185172458,1606553690,1606553882,192
1361185201,1606582416,8,815,101.875,1361185173042,1361185173234,1606554458,1606554650,192
1361185410,1606790972,2,126,63,1361185407147,1361185408171,1606788119,1606789143,1024
1361185410,1606790980,2,126,63,1361185407009,1361185408033,1606787989,1606789013,1024
1361185418,1606798980,2,126,63,1361185410018,1361185414050,1606790998,1606795030,4032
1361185418,1606798980,2,126,63,1361185410146,1361185414178,1606791126,1606795158,4032
1361185418,1606798992,4,252,63,1361185410772,1361185417812,1606791764,1606798804,7040
1361185418,1606798996,2,126,63,1361185415696,1361185416720,1606796692,1606797716,1024
1361185426,1606806984,2,126,63,1361185418781,1361185422813,1606799765,1606803797,4032
1361185450,1606830664,1,63,63,1361185422428,1361185422428,1606803092,1606803092,0
1361185450,1606830664,1,63,63,1361185422555,1361185422555,1606803219,1606803219,0
1361185454,1606834692,1,63,63,1361185426112,1361185426112,1606806804,1606806804,0
1361185458,1606838728,1,63,63,1361185431070,1361185431070,1606811798,1606811798,0
1361185530,1606910832,1,92,92,1361185504243,1361185504243,1606885075,1606885075,0
1361185787,1607168312,1,48,48,1361185759825,1361185759825,1607141137,1607141137,0
1361185787,1607168316,1,48,48,1361185759884,1361185759884,1607141200,1607141200,0
1361185787,1607168328,1,48,48,1361185760062,1361185760062,1607141390,1607141390,0
1361186091,1607472120,1,46,46,1361186064521,1361186064521,1607445641,1607445641,0
1361186107,1607487484,16,6372,398.25,1361186094407,1361186104007,1607474891,1607484491,9600
1361186107,1607487484,12,999,83.25,1361186094790,1361186104006,1607475274,1607484490,9216
1361186107,1607487488,12,999,83.25,1361186095045,1361186104005,1607475533,1607484493,8960
1361186107,1607487488,11,953,86.63636364,1361186095300,1361186103940,1607475788,1607484428,8640
1361186127,1607508128,1,46,46,1361186101506,1361186101506,1607482634,1607482634,0
1361186460,1607840708,1,46,46,1361186433504,1361186433504,1607814212,1607814212,0
1361186656,1608037284,1,46,46,1361186628509,1361186628509,1608009793,1608009793,0
1361186707,1608088452,11,953,86.63636364,1361186691574,1361186701750,1608073026,1608083202,10176
1361186707,1608088460,12,999,83.25,1361186691053,1361186701741,1608072513,1608083201,10688
1361186707,1608088464,11,953,86.63636364,1361186691304,1361186701736,1608072768,1608083200,10432
1361186993,1608373736,4,244,61,1361186965247,1361186975807,1608345983,1608356543,10560
1361187188,1608569076,17,6755,397.3529412,1361187177382,1361187187494,1608558458,1608568570,10112
1361187188,1608569080,12,999,83.25,1361187177700,1361187187492,1608558780,1608568572,9792
1361187241,1608622232,1,52,52,1361187213130,1361187213130,1608594362,1608594362,0
1361187264,246958240,1,46,46,1361187239027,1361187239027,246933267,246933267,0
1361187308,1608689216,11,953,86.63636364,1361187289432,1361187301528,1608670648,1608682744,12096
1361187308,1608689220,11,953,86.63636364,1361187290262,1361187301462,1608671482,1608682682,11200
1361187308,1608689224,12,999,83.25,1361187289679,1361187301519,1608670903,1608682743,11840
1361187308,1608689228,11,953,86.63636364,1361187289934,1361187301454,1608671162,1608682682,11520
1361187404,1608785264,6,2158,359.6666667,1361187403622,1361187403878,1608784886,1608785142,256
1361187405,1608785816,1,108,108,1361187404073,1361187404073,1608784889,1608784889,0
1361187405,1608785816,1,108,108,1361187404137,1361187404137,1608784953,1608784953,0
1361187406,1608786704,3,2365,788.3333333,1361187404185,1361187404249,1608784889,1608784953,64
1361187406,1608786704,2,216,108,1361187404313,1361187404441,1608785017,1608785145,128
1361187411,247105556,5,451,90.2,1361187405818,1361187405946,247100374,247100502,128
1361187411,247105556,4,1448,362,1361187406457,1361187406521,247101013,247101077,64
1361187412,1608793268,32,41637,1301.15625,1361187405667,1361187406115,1608786935,1608787383,448
1361187412,1608793272,5,1257,251.4,1361187406048,1361187406112,1608787320,1608787384,64
1361187412,1608793276,11,3294,299.4545455,1361187407771,1361187408539,1608789047,1608789815,768
1361187412,1608793280,8,3492,436.5,1361187408601,1361187409305,1608789881,1608790585,704
1361187412,1608793280,6,798,133,1361187408792,1361187409112,1608790072,1608790392,320
1361187412,1608793280,11,3294,299.4545455,1361187409496,1361187410264,1608790776,1608791544,768
1361187412,1608793284,6,798,133,1361187410260,1361187410452,1608791544,1608791736,192
1361187412,1608793284,7,1460,208.5714286,1361187410324,1361187410900,1608791608,1608792184,576
1361187412,1608793284,5,772,154.4,1361187404628,1361187405140,1608785912,1608786424,512
1361187412,1608793284,9,3035,337.2222222,1361187410387,1361187410899,1608791671,1608792183,512
1361187412,1608793284,8,3492,436.5,1361187406675,1361187407379,1608787959,1608788663,704
1361187412,1608793308,4,724,181,1361187411644,1361187411708,1608792952,1608793016,64
1361187412,1608793308,9,1913,212.5555556,1361187411579,1361187411771,1608792887,1608793079,192
1361187412,1608793308,6,983,163.8333333,1361187408506,1361187408762,1608789814,1608790070,256
1361187416,247110392,5,2109,421.8,1361187411232,1361187411232,247105624,247105624,0
1361187419,247113564,5,451,90.2,1361187412787,1361187414003,247107351,247108567,1216
1361187419,247113564,5,451,90.2,1361187417396,1361187417972,247111960,247112536,576
1361187419,247113568,5,451,90.2,1361187415151,1361187416367,247109719,247110935,1216
1361187419,247113568,5,451,90.2,1361187410991,1361187411567,247105559,247106135,576
1361187420,1608801272,12,4967,413.9166667,1361187418014,1361187418334,1608799286,1608799606,320
1361187420,1608801272,10,1965,196.5,1361187414045,1361187414621,1608795317,1608795893,576
1361187420,1608801276,5,609,121.8,1361187418652,1361187419100,1608799928,1608800376,448
1361187420,1608801276,5,609,121.8,1361187414747,1361187415131,1608796023,1608796407,384
1361187420,1608801276,9,1913,212.5555556,1361187415066,1361187415258,1608796342,1608796534,192
1361187420,1608801276,12,4735,394.5833333,1361187419098,1361187419290,1608800374,1608800566,192
1361187420,1608801280,15,8365,557.6666667,1361187415705,1361187415833,1608796985,1608797113,128
1361187420,1608801280,11,4921,447.3636364,1361187416279,1361187416855,1608797559,1608798135,576
1361187420,1608801284,9,1913,212.5555556,1361187413397,1361187413589,1608794681,1608794873,192
1361187420,1608801284,5,609,121.8,1361187412243,1361187412691,1608793527,1608793975,448
1361187420,1608801284,10,1965,196.5,1361187414033,1361187414289,1608795317,1608795573,256
1361187420,1608801288,12,4927,410.5833333,1361187418253,1361187418637,1608799541,1608799925,384
1361187420,1608801312,9,1913,212.5555556,1361187416312,1361187416440,1608797624,1608797752,128
1361187422,1608802680,5,609,121.8,1361187417454,1361187417902,1608798134,1608798582,448
1361187422,1608802680,9,1913,212.5555556,1361187417902,1361187418094,1608798582,1608798774,192
1361187427,247121564,4,445,111.25,1361187421554,1361187421746,247116118,247116310,192
1361187427,247121564,5,451,90.2,1361187419185,1361187420273,247113749,247114837,1088
1361187427,247121568,4,445,111.25,1361187421871,1361187421999,247116439,247116567,128
1361187427,247121568,4,445,111.25,1361187421999,1361187422255,247116567,247116823,256
1361187427,247121568,4,1448,362,1361187423023,1361187423087,247117591,247117655,64
1361187428,1608809252,9,1913,212.5555556,1361187420274,1361187420530,1608801526,1608801782,256
1361187428,1608809256,9,2849,316.5555556,1361187422448,1361187422576,1608803704,1608803832,128
1361187428,1608809256,5,609,121.8,1361187420974,1361187421358,1608802230,1608802614,384
1361187428,1608809264,9,1913,212.5555556,1361187421799,1361187421991,1608803063,1608803255,192
1361187428,1608809268,9,3310,367.7777778,1361187423140,1361187425188,1608804408,1608806456,2048
1361187428,1608809268,9,1913,212.5555556,1361187421156,1361187421284,1608802424,1608802552,128
1361187428,1608809292,4,715,178.75,1361187427212,1361187427212,1608808504,1608808504,0
1361187428,1608809292,10,1877,187.7,1361187419786,1361187421002,1608801078,1608802294,1216
1361187430,1608810736,8,3293,411.625,1361187425720,1361187426360,1608806456,1608807096,640
1361187436,1608817272,11,3096,281.4545455,1361187427421,1361187428061,1608808693,1608809333,640
1361187436,1608817276,14,7501,535.7857143,1361187428122,1361187428762,1608809398,1608810038,640
1361187438,1608818808,7,1877,268.1428571,1361187412333,1361187412973,1608793141,1608793781,640
1361187622,1609002968,1,46,46,1361187597387,1361187597387,1608978355,1608978355,0
1361187646,1609026944,1,46,46,1361187618020,1361187618020,1608998964,1608998964,0
1361187709,1609089548,15,6289,419.2666667,1361187696366,1361187708462,1609076914,1609089010,12096
1361187709,1609089552,12,999,83.25,1361187696748,1361187708460,1609077300,1609089012,11712
1361187709,1609089552,12,999,83.25,1361187697003,1361187708459,1609077555,1609089011,11456
1361187709,1609089552,12,999,83.25,1361187697259,1361187708459,1609077811,1609089011,11200
1361187735,1609115916,1,46,46,1361187708797,1361187708797,1609089713,1609089713,0
1361187736,1609116572,1,46,46,1361187709143,1361187709143,1609089715,1609089715,0
1361187736,1609116600,1,46,46,1361187709112,1361187709112,1609089712,1609089712,0
1361187736,1609116608,1,46,46,1361187709234,1361187709234,1609089842,1609089842,0
1361187750,1609131168,8,815,101.875,1361187725442,1361187725570,1609106610,1609106738,128
1361187750,1609131200,9,861,95.66666667,1361187725090,1361187725282,1609106290,1609106482,192
1361187750,1609131204,9,861,95.66666667,1361187725661,1361187725789,1609106865,1609106993,128
1361187754,1609135180,8,815,101.875,1361187725943,1361187726135,1609107123,1609107315,192
1361187893,1609273600,3,138,46,1361187887290,1361187888314,1609267890,1609268914,1024
1361187893,1609273600,3,138,46,1361187887289,1361187888313,1609267889,1609268913,1024
1361187893,1609273612,3,138,46,1361187887277,1361187888301,1609267889,1609268913,1024
1361187909,1609289592,12,999,83.25,1361187891198,1361187902910,1609271790,1609283502,11712
1361187909,1609289596,12,999,83.25,1361187891963,1361187902907,1609272559,1609283503,10944
1361187909,1609289604,14,4789,342.0714286,1361187890805,1361187902901,1609271409,1609283505,12096
1361187909,1609289604,17,6755,397.3529412,1361187891571,1361187902899,1609272175,1609283503,11328
1361187914,1609295384,1,46,46,1361187886503,1361187886503,1609267887,1609267887,0
1361187941,1609321932,3,189,63,1361187936042,1361187939050,1609316974,1609319982,3008
1361187957,1609337912,2,126,63,1361187943101,1361187951165,1609324013,1609332077,8064
1361188067,1609447832,1,46,46,1361188041485,1361188041485,1609422317,1609422317,0
1361188115,1609495924,1,46,46,1361188088178,1361188088178,1609469102,1609469102,0
1361188159,1609539972,1,46,46,1361188133183,1361188133183,1609514155,1609514155,0
1361188207,1609588276,1,46,46,1361188181965,1361188181965,1609563241,1609563241,0
1361188243,1609624292,3,138,46,1361188215550,1361188215934,1609596842,1609597226,384
1361188357,1609738200,141,202373,1435.269504,1361188354072,1361188354456,1609735272,1609735656,384
1361188365,1609746192,18,6801,377.8333333,1361188353183,1361188364063,1609734375,1609745255,10880
1361188365,1609746192,12,999,83.25,1361188353567,1361188364063,1609734759,1609745255,10496
1361188365,1609746196,12,999,83.25,1361188353822,1361188363998,1609735018,1609745194,10176
1361188596,1609976848,5,230,46,1361188571638,1361188578742,1609952486,1609959590,7104
1361188664,1610044844,1,46,46,1361188637049,1361188637049,1610017893,1610017893,0
1361188792,1610173244,1,46,46,1361188764196,1361188764196,1610145440,1610145440,0
1361188812,1610193228,1,48,48,1361188787381,1361188787381,1610168609,1610168609,0
1361189126,1610506580,12,999,83.25,1361189115000,1361189124984,1610495580,1610505564,9984
1361189126,1610506592,17,6755,397.3529412,1361189114541,1361189124973,1610495133,1610505565,10432
1361189126,1610506596,11,953,86.63636364,1361189115242,1361189124970,1610495838,1610505566,9728
1361189201,1610581652,1,46,46,1361189174192,1361189174192,1610554844,1610554844,0
1361189814,1611194488,1,46,46,1361189786892,1361189786892,1611167380,1611167380,0
1361189922,1611302908,1,46,46,1361189896359,1361189896359,1611277267,1611277267,0
1361190227,1611607748,1,52,52,1361190224703,1361190224703,1611605451,1611605451,0
1361190230,1611611272,27,33089,1225.518519,1361190225334,1361190226614,1611606606,1611607886,1280
1361190236,249930212,2,98,49,1361190229541,1361190235109,249923753,249929321,5568
1361190238,1611619272,4,190,47.5,1361190234548,1361190234676,1611615820,1611615948,128
1361190238,1611619272,4,190,47.5,1361190234484,1361190234612,1611615756,1611615884,128
1361190238,1611619272,4,190,47.5,1361190234676,1361190234740,1611615948,1611616012,64
1361190238,1611619272,8,535,66.875,1361190230836,1361190236468,1611612108,1611617740,5632
1361190238,1611619272,12,5071,422.5833333,1361190231028,1361190236468,1611612300,1611617740,5440
1361190238,1611619272,4,190,47.5,1361190231155,1361190231923,1611612427,1611613195,768
1361190238,1611619272,4,190,47.5,1361190234931,1361190235251,1611616203,1611616523,320
1361190238,1611619272,4,190,47.5,1361190231155,1361190231987,1611612427,1611613259,832
1361190238,1611619272,4,190,47.5,1361190234995,1361190235315,1611616267,1611616587,320
1361190238,1611619272,8,544,68,1361190231602,1361190237426,1611612874,1611618698,5824
1361190238,1611619272,4,190,47.5,1361190231666,1361190236850,1611612938,1611618122,5184
1361190238,1611619272,4,190,47.5,1361190235314,1361190235634,1611616586,1611616906,320
1361190238,1611619276,4,190,47.5,1361190231794,1361190232050,1611613070,1611613326,256
1361190238,1611619276,2,98,49,1361190231858,1361190237426,1611613134,1611618702,5568
1361190238,1611619276,4,190,47.5,1361190235442,1361190235762,1611616718,1611617038,320
1361190238,1611619276,3,144,48,1361190231602,1361190237490,1611612878,1611618766,5888
1361190238,1611619276,12,6490,540.8333333,1361190231985,1361190237425,1611613261,1611618701,5440
1361190238,1611619276,4,190,47.5,1361190231985,1361190232241,1611613261,1611613517,256
1361190238,1611619276,4,190,47.5,1361190235313,1361190235697,1611616589,1611616973,384
1361190238,1611619276,4,190,47.5,1361190235633,1361190235953,1611616909,1611617229,320
1361190238,1611619276,4,190,47.5,1361190235569,1361190235953,1611616845,1611617229,384
1361190238,1611619276,4,190,47.5,1361190232560,1361190232816,1611613836,1611614092,256
1361190238,1611619276,4,190,47.5,1361190232880,1361190233136,1611614156,1611614412,256
1361190238,1611619276,4,190,47.5,1361190232496,1361190232752,1611613772,1611614028,256
1361190238,1611619276,4,190,47.5,1361190233071,1361190235375,1611614347,1611616651,2304
1361190238,1611619276,4,190,47.5,1361190232751,1361190233071,1611614027,1611614347,320
1361190238,1611619276,4,190,47.5,1361190233199,1361190233711,1611614475,1611614987,512
1361190238,1611619276,4,190,47.5,1361190233007,1361190233263,1611614283,1611614539,256
1361190238,1611619280,4,190,47.5,1361190234158,1361190234286,1611615438,1611615566,128
1361190238,1611619280,4,190,47.5,1361190234221,1361190234669,1611615501,1611615949,448
1361190238,1611619280,4,190,47.5,1361190234475,1361190234539,1611615755,1611615819,64
1361190238,1611619280,4,190,47.5,1361190234603,1361190234667,1611615883,1611615947,64
1361190238,1611619280,4,190,47.5,1361190231018,1361190231594,1611612298,1611612874,576
1361190238,1611619280,4,190,47.5,1361190234666,1361190234794,1611615946,1611616074,128
1361190238,1611619280,4,190,47.5,1361190234730,1361190234858,1611616010,1611616138,128
1361190238,1611619284,4,190,47.5,1361190231210,1361190232042,1611612494,1611613326,832
1361190238,1611619284,3,144,48,1361190231657,1361190237481,1611612941,1611618765,5824
1361190238,1611619284,4,190,47.5,1361190231657,1361190231913,1611612941,1611613197,256
1361190238,1611619284,4,190,47.5,1361190231721,1361190231977,1611613005,1611613261,256
1361190238,1611619284,4,190,47.5,1361190231912,1361190232168,1611613196,1611613452,256
1361190238,1611619284,4,190,47.5,1361190235240,1361190235560,1611616524,1611616844,320
1361190238,1611619284,2,98,49,1361190231848,1361190237416,1611613132,1611618700,5568
1361190238,1611619284,4,190,47.5,1361190232168,1361190232488,1611613452,1611613772,320
1361190238,1611619284,4,190,47.5,1361190232296,1361190232552,1611613580,1611613836,256
1361190238,1611619284,4,190,47.5,1361190232040,1361190232296,1611613324,1611613580,256
1361190238,1611619284,4,190,47.5,1361190232104,1361190232360,1611613388,1611613644,256
1361190238,1611619284,4,190,47.5,1361190232360,1361190232616,1611613644,1611613900,256
1361190238,1611619284,4,190,47.5,1361190232231,1361190232487,1611613515,1611613771,256
1361190238,1611619284,4,190,47.5,1361190235751,1361190236071,1611617035,1611617355,320
1361190238,1611619284,4,190,47.5,1361190235687,1361190236007,1611616971,1611617291,320
1361190238,1611619284,4,190,47.5,1361190232487,1361190232743,1611613771,1611614027,256
1361190238,1611619284,4,190,47.5,1361190232679,1361190232935,1611613963,1611614219,256
1361190238,1611619284,4,190,47.5,1361190236071,1361190236391,1611617355,1611617675,320
1361190238,1611619284,4,190,47.5,1361190232743,1361190232999,1611614027,1611614283,256
1361190238,1611619284,4,190,47.5,1361190232935,1361190235239,1611614219,1611616523,2304
1361190238,1611619284,4,190,47.5,1361190236006,1361190236326,1611617290,1611617610,320
1361190238,1611619288,4,190,47.5,1361190233382,1361190233830,1611614670,1611615118,448
1361190238,1611619288,4,190,47.5,1361190236326,1361190236710,1611617614,1611617998,384
1361190238,1611619288,4,190,47.5,1361190233701,1361190234213,1611614989,1611615501,512
1361190238,1611619288,4,190,47.5,1361190233893,1361190234405,1611615181,1611615693,512
1361190238,1611619308,5,1797,359.4,1361190236688,1361190236816,1611617996,1611618124,128
1361190238,1611619308,4,190,47.5,1361190234255,1361190234319,1611615563,1611615627,64
1361190238,1611619308,4,190,47.5,1361190234319,1361190234447,1611615627,1611615755,128
1361190238,1611619312,6,404,67.33333333,1361190229134,1361190234254,1611610446,1611615566,5120
1361190239,1611619756,13,5365,412.6923077,1361190230073,1361190235961,1611610829,1611616717,5888
1361190244,249938200,2,98,49,1361190238258,1361190243506,249932458,249937706,5248
1361190244,249938204,2,98,49,1361190229547,1361190236139,249923751,249930343,6592
1361190244,249938208,9,729,81,1361190231976,1361190237864,249926184,249932072,5888
1361190246,1611627288,3,144,48,1361190232994,1361190238434,1611614282,1611619722,5440
1361190246,1611627292,14,5411,386.5,1361190232990,1361190244638,1611614282,1611625930,11648
1361190246,1611627292,2,98,49,1361190233378,1361190238434,1611614670,1611619726,5056
1361190246,1611627292,2,98,49,1361190233441,1361190239457,1611614733,1611620749,6016
1361190246,1611627296,11,6050,550,1361190226330,1361190241690,1611607626,1611622986,15360
1361190246,1611627300,4,448,112,1361190239769,1361190239897,1611621069,1611621197,128
1361190246,1611627300,4,190,47.5,1361190235928,1361190238296,1611617228,1611619596,2368
1361190246,1611627300,2,98,49,1361190232983,1361190238423,1611614283,1611619723,5440
1361190246,1611627300,4,190,47.5,1361190235927,1361190238295,1611617227,1611619595,2368
1361190246,1611627300,2,98,49,1361190232983,1361190238423,1611614283,1611619723,5440
1361190246,1611627328,11,5602,509.2727273,1361190226107,1361190241467,1611607435,1611622795,15360
1361190246,1611627328,66,89342,1353.666667,1361190226363,1361190241979,1611607691,1611623307,15616
1361190252,249946208,2,98,49,1361190238312,1361190244456,249932520,249938664,6144
1361190252,249946392,4,640,160,1361190226097,1361190226929,249920489,249921321,832
1361190254,1611635284,4,686,171.5,1361190246505,1361190246569,1611627789,1611627853,64
1361190254,1611635284,4,312,78,1361190250919,1361190250983,1611632203,1611632267,64
1361190254,1611635288,4,312,78,1361190251106,1361190251170,1611632394,1611632458,64
1361190254,1611635288,4,312,78,1361190249315,1361190249379,1611630603,1611630667,64
1361190254,1611635292,4,312,78,1361190249886,1361190250014,1611631178,1611631306,128
1361190254,1611635292,4,312,78,1361190250592,1361190250720,1611631884,1611632012,128
1361190254,1611635292,4,312,78,1361190251040,1361190251104,1611632332,1611632396,64
1361190254,1611635296,4,312,78,1361190249627,1361190249691,1611630923,1611630987,64
1361190255,1611635784,4,1304,326,1361190227932,1361190229084,1611608716,1611609868,1152
1361190255,1611635788,11,2873,261.1818182,1361190228888,1361190229720,1611609676,1611610508,832
1361190255,1611635788,10,9136,913.6,1361190229463,1361190233879,1611610251,1611614667,4416
1361190255,1611635788,7,6108,872.5714286,1361190229462,1361190233558,1611610250,1611614346,4096
1361190255,1611635824,2,98,49,1361190228019,1361190228083,1611608843,1611608907,64
1361190255,1611635828,7,2540,362.8571429,1361190228975,1361190229231,1611609803,1611610059,256
1361190255,1611635832,10,9136,913.6,1361190229421,1361190233517,1611610253,1611614349,4096
1361190255,1611635832,12,5569,464.0833333,1361190229292,1361190230060,1611610124,1611610892,768
1361190255,1611635832,7,6108,872.5714286,1361190229420,1361190233708,1611610252,1611614540,4288
1361190255,1611635832,22,21511,977.7727273,1361190229931,1361190233899,1611610763,1611614731,3968
1361190256,249950624,10,8390,839,1361190231562,1361190231882,249926186,249926506,320
1361190256,249950628,8,4725,590.625,1361190229382,1361190232198,249924010,249926826,2816
1361190256,249950640,24,24587,1024.458333,1361190231031,1361190231863,249925671,249926503,832
1361190256,249950640,24,26834,1118.083333,1361190231542,1361190232246,249926182,249926886,704
1361190259,1611639756,93,124282,1336.365591,1361190231223,1361190233335,1611611979,1611614091,2112
1361190259,1611639756,27,32413,1200.481481,1361190231478,1361190231734,1611612234,1611612490,256
1361190259,1611639756,19,20162,1061.157895,1361190231478,1361190231670,1611612234,1611612426,192
1361190259,1611639760,15,14946,996.4,1361190231474,1361190232178,1611612234,1611612938,704
1361190259,1611639760,6,1364,227.3333333,1361190232114,1361190232370,1611612874,1611613130,256
1361190259,1611639760,6,907,151.1666667,1361190232114,1361190233522,1611612874,1611614282,1408
1361190259,1611639764,3,514,171.3333333,1361190232369,1361190232369,1611613133,1611613133,0
1361190259,1611639764,13,13306,1023.538462,1361190232369,1361190233841,1611613133,1611614605,1472
1361190259,1611639764,12,5950,495.8333333,1361190232753,1361190233521,1611613517,1611614285,768
1361190259,1611639764,11,4917,447,1361190233072,1361190233840,1611613836,1611614604,768
1361190259,1611639764,18,5141,285.6111111,1361190233072,1361190234096,1611613836,1611614860,1024
1361190259,1611639764,4,500,125,1361190233518,1361190233774,1611614282,1611614538,256
1361190259,1611639768,3,189,63,1361190234029,1361190234093,1611614797,1611614861,64
1361190259,1611639768,3,808,269.3333333,1361190233900,1361190233964,1611614668,1611614732,64
1361190259,1611639768,9,3247,360.7777778,1361190234156,1361190234220,1611614924,1611614988,64
1361190259,1611639784,18,8212,456.2222222,1361190231194,1361190234010,1611611978,1611614794,2816
1361190259,1611639788,57,72720,1275.789474,1361190231193,1361190232729,1611611981,1611613517,1536
1361190259,1611639788,12,9734,811.1666667,1361190231321,1361190232985,1611612109,1611613773,1664
1361190259,1611639788,13,11573,890.2307692,1361190231321,1361190233177,1611612109,1611613965,1856
1361190259,1611639788,22,18147,824.8636364,1361190231384,1361190234136,1611612172,1611614924,2752
1361190259,1611639788,6,3278,546.3333333,1361190231384,1361190231512,1611612172,1611612300,128
1361190259,1611639788,13,11253,865.6153846,1361190231384,1361190233176,1611612172,1611613964,1792
1361190259,1611639788,33,41683,1263.121212,1361190231448,1361190231704,1611612236,1611612492,256
1361190259,1611639792,37,42644,1152.540541,1361190232404,1361190239060,1611613196,1611619852,6656
1361190259,1611639796,11,2470,224.5454545,1361190233041,1361190233809,1611613837,1611614605,768
1361190259,1611639796,6,1529,254.8333333,1361190233041,1361190233873,1611613837,1611614669,832
1361190259,1611639800,11,3532,321.0909091,1361190234188,1361190234444,1611614988,1611615244,256
1361190256,249950644,10,8006,800.6,1361190231542,1361190231606,249926186,249926250,64
1361190262,1611643296,4,312,78,1361190256859,1361190256987,1611638155,1611638283,128
1361190262,1611643296,4,312,78,1361190256987,1361190257051,1611638283,1611638347,64
1361190262,1611643296,4,312,78,1361190256858,1361190256922,1611638154,1611638218,64
1361190262,1611643296,4,312,78,1361190256922,1361190257050,1611638218,1611638346,128
1361190262,1611643312,4,312,78,1361190256718,1361190256846,1611638030,1611638158,128
1361190262,1611643328,6,622,103.6666667,1361190256765,1361190260157,1611638093,1611641485,3392
1361190262,1611643332,4,312,78,1361190257017,1361190257081,1611638349,1611638413,64
1361190263,1611643824,8,5032,629,1361190236979,1361190237363,1611617803,1611618187,384
1361190267,1611647772,1,46,46,1361190240742,1361190240742,1611621514,1611621514,0
1361190271,1611651796,1,46,46,1361190246736,1361190246736,1611627532,1611627532,0
1361190271,1611651800,1,46,46,1361190244427,1361190244427,1611625227,1611625227,0
1361190275,1611655812,4,1762,440.5,1361190249728,1361190249728,1611630540,1611630540,0
1361190284,249978612,6,1164,194,1361190256726,1361190256982,249951338,249951594,256
1361190286,1611667292,5,292,58.4,1361190274016,1361190282400,1611655308,1611663692,8384
1361190286,1611667316,4,312,78,1361190279878,1361190279942,1611661194,1611661258,64
1361190299,1611679848,2,154,77,1361190274459,1361190274715,1611655307,1611655563,256
1361190302,1611683288,2,123,61.5,1361190298529,1361190298529,1611679817,1611679817,0
1361190303,1611684104,2,472,236,1361190277211,1361190277275,1611658315,1611658379,64
1361190303,1611684132,2,154,77,1361190278592,1361190278784,1611659724,1611659916,192
1361190307,1611687844,2,265,132.5,1361190280289,1361190280353,1611661133,1611661197,64
1361190312,250006640,1,46,46,1361190286522,1361190286522,249981162,249981162,0
1361190315,1611695824,2,92,46,1361190288371,1361190288435,1611669195,1611669259,64
1361190319,1611699828,2,92,46,1361190293168,1361190293808,1611673996,1611674636,640
1361190319,1611699828,2,92,46,1361190293167,1361190293167,1611673995,1611673995,0
1361190319,1611699832,2,92,46,1361190293804,1361190293868,1611674636,1611674700,64
1361190319,1611699864,2,92,46,1361190293065,1361190293129,1611673929,1611673993,64
1361190319,1611699868,2,92,46,1361190293128,1361190293128,1611673996,1611673996,0
1361190342,1611723420,4,309,77.25,1361190340896,1361190341024,1611722316,1611722444,128
1361190342,1611723420,4,469,117.25,1361190337119,1361190337183,1611718539,1611718603,64
1361190343,1611723864,1,77,77,1361190318795,1361190318795,1611699659,1611699659,0
1361190343,1611723872,2,472,236,1361190317314,1361190317378,1611698186,1611698250,64
1361190348,250042224,3,169,56.33333333,1361190347671,1361190347671,250041895,250041895,0
1361190348,250042224,3,169,56.33333333,1361190347675,1361190347675,250041899,250041899,0
1361190348,250042224,3,169,56.33333333,1361190347675,1361190347675,250041899,250041899,0
1361190348,250042228,3,169,56.33333333,1361190347667,1361190347667,250041895,250041895,0
1361190348,250042228,3,169,56.33333333,1361190347667,1361190347667,250041895,250041895,0
1361190350,1611731432,3,169,56.33333333,1361190347155,1361190347155,1611728587,1611728587,0
1361190350,1611731432,4,205,51.25,1361190347155,1361190347155,1611728587,1611728587,0
1361190350,1611731432,4,205,51.25,1361190347155,1361190347155,1611728587,1611728587,0
1361190350,1611731436,3,169,56.33333333,1361190348112,1361190348112,1611729548,1611729548,0
1361190350,1611731436,3,169,56.33333333,1361190348112,1361190348112,1611729548,1611729548,0
1361190350,1611731440,3,169,56.33333333,1361190349128,1361190349128,1611730568,1611730568,0
1361190350,1611731440,3,169,56.33333333,1361190349128,1361190349128,1611730568,1611730568,0
1361190350,1611731440,4,205,51.25,1361190349132,1361190349132,1611730572,1611730572,0
1361190350,1611731440,4,205,51.25,1361190349132,1361190349132,1611730572,1611730572,0
1361190350,1611731440,4,205,51.25,1361190349132,1361190349132,1611730572,1611730572,0
1361190350,1611731444,3,169,56.33333333,1361190347144,1361190347144,1611728588,1611728588,0
1361190350,1611731444,4,205,51.25,1361190347143,1361190347143,1611728587,1611728587,0
1361190350,1611731444,4,205,51.25,1361190348102,1361190348102,1611729546,1611729546,0
1361190350,1611731448,3,169,56.33333333,1361190348096,1361190348096,1611729544,1611729544,0
1361190350,1611731448,4,205,51.25,1361190348096,1361190348096,1611729544,1611729544,0
1361190351,1611731468,4,205,51.25,1361190350101,1361190350101,1611730569,1611730569,0
1361190351,1611731468,4,205,51.25,1361190350101,1361190350101,1611730569,1611730569,0
1361190351,1611731468,4,205,51.25,1361190350167,1361190350167,1611730635,1611730635,0
1361190351,1611731468,3,169,56.33333333,1361190347094,1361190347094,1611727562,1611727562,0
1361190351,1611731884,2,154,77,1361190323768,1361190324024,1611704652,1611704908,256
1361190363,1611743876,2,265,132.5,1361190335614,1361190335678,1611716490,1611716554,64
1361190366,1611747444,5,320,64,1361190363141,1361190363205,1611744585,1611744649,64
1361190371,1611751880,1,46,46,1361190345657,1361190345657,1611726537,1611726537,0
1361190371,1611751924,1,46,46,1361190346512,1361190346512,1611727436,1611727436,0
1361190374,1611755456,5,320,64,1361190368123,1361190368123,1611749579,1611749579,0
1361190375,1611755488,262,374722,1430.236641,1361190250370,1361190367042,1611630858,1611747530,116672
1361190375,1611755896,1,46,46,1361190348648,1361190348648,1611729544,1611729544,0
1361190375,1611755896,1,46,46,1361190348648,1361190348648,1611729544,1611729544,0
1361190375,1611755900,1,46,46,1361190349669,1361190349669,1611730569,1611730569,0
1361190375,1611755924,1,46,46,1361190347597,1361190347597,1611728521,1611728521,0
1361190375,1611755928,1,46,46,1361190348617,1361190348617,1611729545,1611729545,0
1361190375,1611755932,1,46,46,1361190349638,1361190349638,1611730570,1611730570,0
1361190383,1611763936,2,472,236,1361190356867,1361190356931,1611737803,1611737867,64
1361190387,1611767940,1,46,46,1361190359484,1361190359484,1611740424,1611740424,0
1361190391,1611771956,1,46,46,1361190365613,1361190365613,1611746569,1611746569,0
1361190404,250098668,1,46,46,1361190376670,1361190376670,250071338,250071338,0
1361190407,1611787480,16,9503,593.9375,1361190402569,1361190403017,1611783049,1611783497,448
1361190419,1611800052,2,265,132.5,1361190391373,1361190391501,1611772425,1611772553,128
1361190423,1611804056,2,472,236,1361190397450,1361190397514,1611778506,1611778570,64
1361190463,1611844128,2,472,236,1361190437119,1361190437183,1611818247,1611818311,64
1361190471,1611851536,4,312,78,1361190468048,1361190468112,1611848584,1611848648,64
1361190471,1611851536,4,312,78,1361190468239,1361190468303,1611848775,1611848839,64
1361190471,1611851540,4,312,78,1361190468622,1361190468750,1611849162,1611849290,128
1361190471,1611852132,2,265,132.5,1361190446524,1361190446588,1611827656,1611827720,64
1361190479,1611859520,3,144,48,1361190468001,1361190473057,1611848521,1611853577,5056
1361190479,1611859532,3,144,48,1361190468053,1361190474069,1611848585,1611854601,6016
1361190479,1611859532,2,98,49,1361190468180,1361190474004,1611848712,1611854536,5824
1361190487,1611867544,4,314,78.5,1361190480073,1361190480201,1611860617,1611860745,128
1361190495,1611875536,2,98,49,1361190481426,1361190487058,1611861962,1611867594,5632
1361190495,1611876140,7,1936,276.5714286,1361190467379,1361190484083,1611848519,1611865223,16704
1361190495,1611876140,6,2210,368.3333333,1361190467571,1361190484147,1611848711,1611865287,16576
1361190495,1611876144,4,1282,320.5,1361190467952,1361190468208,1611849096,1611849352,256
1361190503,1611884164,2,472,236,1361190477338,1361190477466,1611858502,1611858630,128
1361190507,1611888148,22,28905,1313.863636,1361190479467,1361190483947,1611860615,1611865095,4480
1361190507,1611888152,68,94433,1388.720588,1361190480042,1361190484522,1611861194,1611865674,4480
1361190507,1611888152,4,504,126,1361190480615,1361190480871,1611861767,1611862023,256
1361190507,1611888152,4,504,126,1361190480615,1361190480871,1611861767,1611862023,256
1361190507,1611888192,4,501,125.25,1361190480001,1361190480577,1611861193,1611861769,576
1361190507,1611888192,17,20626,1213.294118,1361190480063,1361190484351,1611861255,1611865543,4288
1361190507,1611888196,4,504,126,1361190480574,1361190480830,1611861770,1611862026,256
1361190519,1611899564,4,312,78,1361190517106,1361190517170,1611897670,1611897734,64
1361190519,1611899572,4,312,78,1361190513707,1361190513771,1611894279,1611894343,64
1361190519,1611900252,1,46,46,1361190493636,1361190493636,1611874888,1611874888,0
1361190527,1611907572,4,312,78,1361190520299,1361190520363,1611900871,1611900935,64
1361190527,1611907572,4,312,78,1361190520362,1361190520426,1611900934,1611900998,64
1361190527,1611907612,8,544,68,1361190513794,1361190519810,1611894406,1611900422,6016
1361190527,1611908232,2,265,132.5,1361190502105,1361190502297,1611883337,1611883529,192
1361190535,1611916228,65,72162,1110.184615,1361190510108,1361190513500,1611891336,1611894728,3392
1361190539,1611920216,9,4913,545.8888889,1361190513001,1361190513513,1611894217,1611894729,512
1361190539,1611920216,9,4756,528.4444444,1361190513000,1361190520296,1611894216,1611901512,7296
1361190539,1611920260,7,5656,808,1361190512889,1361190513145,1611894149,1611894405,256
1361190539,1611920260,5,484,96.8,1361190513467,1361190513723,1611894727,1611894983,256
1361190540,250234280,5,580,116,1361190519907,1361190535011,250214187,250229291,15104
1361190540,250234280,5,585,117,1361190519971,1361190535075,250214251,250229355,15104
1361190540,250234284,10,7519,751.9,1361190519902,1361190535198,250214186,250229482,15296
1361190543,1611923692,4,336,84,1361190536818,1361190536946,1611917510,1611917638,128
1361190543,1611924212,3,728,242.6666667,1361190516396,1361190516460,1611897608,1611897672,64
1361190543,1611924212,4,1307,326.75,1361190516715,1361190526315,1611897927,1611907527,9600
1361190543,1611924256,7,5484,783.4285714,1361190516735,1361190519807,1611897991,1611901063,3072
1361190548,250242280,2,98,49,1361190542882,1361190546850,250237162,250241130,3968
1361190548,250242280,2,98,49,1361190539553,1361190542753,250233833,250237033,3200
1361190548,250242284,2,98,49,1361190542941,1361190547805,250237225,250242089,4864
1361190548,250242288,2,98,49,1361190539548,1361190543772,250233836,250238060,4224
1361190563,1611944240,1,46,46,1361190538639,1361190538639,1611919879,1611919879,0
1361190575,1611955720,3,200,66.66666667,1361190558873,1361190567897,1611939593,1611948617,9024
1361190583,1611963748,2,123,61.5,1361190572667,1361190577659,1611953415,1611958407,4992
1361190583,1611964288,2,154,77,1361190558303,1361190558559,1611939591,1611939847,256
1361190583,1611964304,2,265,132.5,1361190557392,1361190557520,1611938696,1611938824,128
1361190591,1611971724,4,312,78,1361190587027,1361190587091,1611967751,1611967815,64
1361190591,1611972280,2,472,236,1361190565992,1361190566056,1611947272,1611947336,64
1361190599,1611980324,2,92,46,1361190572666,1361190572666,1611953990,1611953990,0
1361190607,1611987724,2,92,46,1361190599954,1361190599954,1611980678,1611980678,0
1361190607,1611987764,45,56845,1263.222222,1361190586795,1361190603115,1611967559,1611983879,16320
1361190607,1611988316,2,92,46,1361190579140,1361190579140,1611960456,1611960456,0
1361190607,1611988320,2,92,46,1361190579646,1361190579646,1611960966,1611960966,0
1361190611,1611992352,6,2598,433,1361190586334,1361190586334,1611967686,1611967686,0
1361190619,1612000280,1,46,46,1361190590311,1361190590311,1611971591,1611971591,0
1361190623,1612004272,1,46,46,1361190596398,1361190596398,1611977670,1611977670,0
1361190623,1612004272,1,46,46,1361190596398,1361190596398,1611977670,1611977670,0
1361190623,1612004308,1,46,46,1361190596361,1361190596361,1611977669,1611977669,0
1361190623,1612004312,1,46,46,1361190596356,1361190596356,1611977668,1611977668,0
1361190627,1612008272,1,46,46,1361190599343,1361190599343,1611980615,1611980615,0
1361190627,1612008276,1,46,46,1361190600298,1361190600298,1611981574,1611981574,0
1361190627,1612008308,1,46,46,1361190599304,1361190599304,1611980612,1611980612,0
1361190631,1612012292,1,77,77,1361190603225,1361190603225,1611984517,1611984517,0
1361190635,1612016300,2,472,236,1361190606352,1361190606416,1611987652,1611987716,64
1361190639,1612020356,2,265,132.5,1361190612954,1361190613082,1611994310,1611994438,128
1361190655,1612035748,5,320,64,1361190648696,1361190648760,1612029444,1612029508,64
1361190659,1612040360,1,46,46,1361190632277,1361190632277,1612013637,1612013637,0
1361190675,1612056432,5,2252,450.4,1361190646924,1361190648076,1612028356,1612029508,1152
1361190687,1612068396,1,48,48,1361190661235,1361190661235,1612042631,1612042631,0
1361190696,1612076568,2,265,132.5,1361190669229,1361190669357,1612049797,1612049925,128
1361190716,1612096568,2,472,236,1361190688365,1361190688429,1612068933,1612068997,64
1361190719,1612099816,9,3798,422,1361190706931,1361190713011,1612087747,1612093827,6080
1361190720,1612100584,1,76,76,1361190695389,1361190695389,1612075973,1612075973,0
1361190724,1612104544,2,122,61,1361190696453,1361190698885,1612076997,1612079429,2432
1361190728,1612108644,1,46,46,1361190702943,1361190702943,1612083587,1612083587,0
1361190736,1612116568,1,46,46,1361190708395,1361190708395,1612088963,1612088963,0
1361190752,1612132672,2,265,132.5,1361190725061,1361190725189,1612105733,1612105861,128
1361190756,1612136608,2,472,236,1361190729091,1361190729155,1612109699,1612109763,64
1361190760,1612140624,2,122,61,1361190733491,1361190735859,1612114115,1612116483,2368
1361190796,1612176600,2,472,236,1361190769098,1361190769162,1612149698,1612149762,64
1361190808,1612188844,2,265,132.5,1361190780568,1361190780632,1612161412,1612161476,64
1361190823,1612203872,3,144,48,1361190818490,1361190818682,1612199362,1612199554,192
1361190823,1612203908,3,144,48,1361190818456,1361190818648,1612199364,1612199556,192
1361190831,1612211884,152,130276,857.0789474,1361190228911,1361190829871,1611609795,1612210755,600960
1361190836,1612216848,2,472,236,1361190809618,1361190809682,1612190466,1612190530,64
1361190860,1612240900,9,1819,202.1111111,1361190835101,1361190835549,1612216001,1612216449,448
1361190860,1612240940,1,46,46,1361190834421,1361190834421,1612215361,1612215361,0
1361190860,250554368,2,98,49,1361190849484,1361190854220,250543852,250548588,4736
1361190860,250554372,2,98,49,1361190849417,1361190853193,250543789,250547565,3776
1361190864,1612244944,2,265,132.5,1361190836275,1361190836403,1612217219,1612217347,128
1361190876,1612256952,2,472,236,1361190849067,1361190849131,1612230019,1612230083,64
1361190916,1612296972,2,472,236,1361190889237,1361190889301,1612270209,1612270273,64
1361190916,1612296996,2,265,132.5,1361190891644,1361190891708,1612272640,1612272704,64
1361190927,1612307924,12,999,83.25,1361190913157,1361190923461,1612294081,1612304385,10304
1361190927,1612307936,17,6755,397.3529412,1361190912759,1361190923447,1612293695,1612304383,10688
1361190927,1612307936,12,999,83.25,1361190913402,1361190923450,1612294338,1612304386,10048
1361190956,1612337020,6,3252,542,1361190929637,1361190933029,1612310657,1612314049,3392
1361190959,1612339956,4,205,51.25,1361190951141,1361190951141,1612332097,1612332097,0
1361190960,1612341368,9,3171,352.3333333,1361190932682,1361190933258,1612314050,1612314626,576
1361190972,1612353248,2,265,132.5,1361190946879,1361190947007,1612328127,1612328255,128
1361191000,1612381244,2,472,236,1361190972867,1361190972995,1612354111,1612354239,128
1361191028,1612409292,2,265,132.5,1361191002131,1361191002259,1612383423,1612383551,128
1361191040,1612421300,2,472,236,1361191012557,1361191012621,1612393857,1612393921,64
1361191055,1612436028,4,205,51.25,1361191049052,1361191049052,1612430080,1612430080,0
1361191081,1612461568,2,472,236,1361191053351,1361191053415,1612433919,1612433983,64
1361191085,1612465516,2,265,132.5,1361191058395,1361191058523,1612438911,1612439039,128
1361191119,1612500044,11,5698,518,1361191100618,1361191115914,1612481662,1612496958,15296
1361191119,1612500048,3,144,48,1361191118021,1361191118085,1612499069,1612499133,64
1361191121,1612501748,2,472,236,1361191093490,1361191093554,1612474238,1612474302,64
1361191135,1612516044,148,199493,1347.925676,1361191121163,1361191134155,1612502207,1612515199,12992
1361191141,1612521796,2,265,132.5,1361191113794,1361191113922,1612494590,1612494718,128
1361191143,1612524044,68,78506,1154.5,1361191136713,1361191138953,1612517757,1612519997,2240
1361191143,1612524052,105,131651,1253.819048,1361191134274,1361191136642,1612515326,1612517694,2368
1361191143,1612524056,8,1505,188.125,1361191136384,1361191141504,1612517440,1612522560,5120
1361191143,1612524060,137,184914,1349.737226,1361191139128,1361191142712,1612520188,1612523772,3584
1361191143,1612524064,3,144,48,1361191136308,1361191136436,1612517372,1612517500,128
1361191143,1612524064,8,1505,188.125,1361191136372,1361191141492,1612517436,1612522556,5120
1361191143,1612524064,8,1505,188.125,1361191136372,1361191141492,1612517436,1612522556,5120
1361191143,1612524064,8,1505,188.125,1361191136376,1361191141496,1612517440,1612522560,5120
1361191151,1612532052,300,389611,1298.703333,1361191142784,1361191145472,1612523836,1612526524,2688
1361191161,1612541864,11,2328,211.6363636,1361191135677,1361191136125,1612516541,1612516989,448
1361191161,1612541896,2,472,236,1361191133212,1361191133276,1612514108,1612514172,64
1361191164,250858452,2,98,49,1361191158076,1361191162684,250852528,250857136,4608
1361191164,250858452,2,98,49,1361191158012,1361191161660,250852464,250856112,3648
1361191167,1612548052,513,715842,1395.403509,1361191145667,1361191159683,1612526719,1612540735,14016
1361191167,1612548052,158,216871,1372.601266,1361191159745,1361191164161,1612540797,1612545213,4416
1361191167,1612548060,23,10646,462.8695652,1361191164859,1361191166651,1612545919,1612547711,1792
1361191175,1612556084,57,61395,1077.105263,1361191166689,1361191168481,1612547773,1612549565,1792
1361191183,1612564076,3,144,48,1361191175466,1361191175530,1612556542,1612556606,64
1361191197,1612577856,2,265,132.5,1361191169350,1361191169670,1612550206,1612550526,320
1361191197,1612577908,2,472,236,1361191172882,1361191172882,1612553790,1612553790,0
1361191221,1612601892,2,583,291.5,1361191194146,1361191194338,1612575038,1612575230,192
1361191241,1612621916,2,472,236,1361191212938,1361191213066,1612593854,1612593982,128
1361191249,1612629936,2,265,132.5,1361191224822,1361191224950,1612605758,1612605886,128
1361191255,1612636112,3,144,48,1361191250435,1361191250499,1612631547,1612631611,64
1361191263,1612644108,18,5971,331.7222222,1361191261065,1361191261833,1612642173,1612642941,768
1361191263,1612644116,5,808,161.6,1361191260863,1361191261823,1612641979,1612642939,960
1361191263,1612644116,4,312,78,1361191260926,1361191260990,1612642042,1612642106,64
1361191281,1612662120,2,472,236,1361191253370,1361191253434,1612634490,1612634554,64
1361191295,1612676180,4,891,222.75,1361191292095,1361191292223,1612673275,1612673403,128
1361191305,1612686208,2,265,132.5,1361191280613,1361191280677,1612661821,1612661885,64
1361191311,1612692136,4,205,51.25,1361191309483,1361191309483,1612690619,1612690619,0
1361191321,1612702228,2,472,236,1361191293391,1361191293455,1612674619,1612674683,64
1361191327,1612708148,3,144,48,1361191325409,1361191325473,1612706557,1612706621,64
1361191357,1612738244,2,472,236,1361191332608,1361191332672,1612713852,1612713916,64
1361191361,1612742236,2,265,132.5,1361191335944,1361191336072,1612717180,1612717308,128
1361191397,1612778256,2,472,236,1361191372660,1361191372724,1612753916,1612753980,64
1361191407,1612788196,3,144,48,1361191400428,1361191400428,1612781624,1612781624,0
1361191417,1612798256,2,96,48,1361191389233,1361191392177,1612770489,1612773433,2944
1361191417,1612798256,2,265,132.5,1361191391089,1361191391153,1612772345,1612772409,64
1361191438,1612818580,2,472,236,1361191413588,1361191413716,1612794168,1612794296,128
1361191442,1612822604,2,96,48,1361191414205,1361191417213,1612794809,1612797817,3008
1361191447,1612828288,7,1406,200.8571429,1361191436625,1361191441873,1612817913,1612823161,5248
1361191462,1612842624,12,4241,353.4166667,1361191436519,1361191436967,1612817143,1612817591,448
1361191471,1612852272,4,336,84,1361191468001,1361191468129,1612849273,1612849401,128
1361191474,1612854576,2,265,132.5,1361191447129,1361191447257,1612827705,1612827833,128
1361191474,251168024,2,98,49,1361191468521,1361191471721,251162545,251165745,3200
1361191476,251170548,2,98,49,1361191468062,1361191472222,251162610,251166770,4160
1361191478,1612858580,2,472,236,1361191453204,1361191453268,1612833784,1612833848,64
1361191479,1612860276,3,144,48,1361191475291,1361191475291,1612856567,1612856567,0
1361191498,1612878592,3,144,48,1361191484935,1361191489991,1612865527,1612870583,5056
1361191503,1612884268,2,98,49,1361191491366,1361191496870,1612872634,1612878138,5504
1361191503,1612884268,2,98,49,1361191491813,1361191496869,1612873081,1612878137,5056
1361191503,1612884276,3,144,48,1361191491292,1361191496860,1612872568,1612878136,5568
1361191510,1612890620,7,2507,358.1428571,1361191483950,1361191484078,1612864570,1612864698,128
1361191510,1612890628,6,2211,368.5,1361191485158,1361191492134,1612865786,1612872762,6976
1361191518,1612898628,2,472,236,1361191493860,1361191493924,1612874488,1612874552,64
1361191518,1612898668,10,12291,1229.1,1361191491453,1361191491773,1612872121,1612872441,320
1361191518,1612898668,3,514,171.3333333,1361191491899,1361191491963,1612872567,1612872631,64
1361191518,1612898668,9,10372,1152.444444,1361191491963,1361191492347,1612872631,1612873015,384
1361191530,1612910620,2,265,132.5,1361191502700,1361191502828,1612883320,1612883448,128
1361191543,1612924296,4,246,61.5,1361191528327,1361191537351,1612909623,1612918647,9024
1361191551,1612932360,3,144,48,1361191550216,1361191550216,1612931576,1612931576,0
1361191558,1612938680,2,472,236,1361191533679,1361191533807,1612914359,1612914487,128
1361191559,1612940356,4,205,51.25,1361191551819,1361191551819,1612933175,1612933175,0
1361191567,1612948364,5,1256,251.2,1361191561092,1361191561284,1612942456,1612942648,192
1361191567,1612948372,4,312,78,1361191561147,1361191561275,1612942519,1612942647,128
1361191578,1612958680,2,92,46,1361191551406,1361191551406,1612932086,1612932086,0
1361191586,1612967000,2,265,132.5,1361191558000,1361191558064,1612939000,1612939064,64
1361191598,1612978692,2,472,236,1361191573220,1361191573284,1612953912,1612953976,64
1361191607,1612988408,2,92,46,1361191606807,1361191606807,1612988215,1612988215,0
1361191631,1613012400,3,144,48,1361191625184,1361191625184,1613006584,1613006584,0
1361191634,1613014768,1,46,46,1361191607382,1361191607382,1612988150,1612988150,0
1361191634,1613014768,1,46,46,1361191607382,1361191607382,1612988150,1612988150,0
1361191638,1613018748,2,472,236,1361191613161,1361191613225,1612993909,1612993973,64
1361191642,1613022760,2,265,132.5,1361191614302,1361191614430,1612995062,1612995190,128
1361191678,1613058776,2,472,236,1361191653709,1361191653773,1613034485,1613034549,64
1361191698,1613078816,2,265,132.5,1361191670310,1361191670438,1613051126,1613051254,128
1361191702,1613082792,7,1450,207.1428571,1361191674557,1361191675133,1613055349,1613055925,576
1361191704,1613084460,3,144,48,1361191701129,1361191701129,1613081589,1613081589,0
1361191718,1613098836,2,472,236,1361191693264,1361191693328,1613074100,1613074164,64
1361191744,1613124524,8,1505,188.125,1361191738121,1361191743177,1613118645,1613123701,5056
1361191750,1613130932,2,92,46,1361191722161,1361191737329,1613103093,1613118261,15168
1361191750,1613130948,2,265,132.5,1361191725475,1361191725603,1613106423,1613106551,128
1361191758,1613138920,2,472,236,1361191732860,1361191732988,1613113780,1613113908,128
1361191762,1613142992,6,1809,301.5,1361191736630,1361191737334,1613117622,1613118326,704
1361191768,1613148548,3,144,48,1361191763505,1361191763505,1613144053,1613144053,0
1361191788,251482560,2,98,49,1361191778707,1361191782035,251473267,251476595,3328
1361191788,251482560,2,98,49,1361191778769,1361191783057,251473329,251477617,4288
1361191798,1613178956,2,472,236,1361191772887,1361191772951,1613153843,1613153907,64
1361191806,1613187008,2,265,132.5,1361191781348,1361191781476,1613162356,1613162484,128
1361191838,1613219036,2,472,236,1361191813513,1361191813577,1613194549,1613194613,64
1361191840,1613220596,3,144,48,1361191835968,1361191836032,1613216564,1613216628,64
1361191856,1613236596,4,205,51.25,1361191853182,1361191853182,1613233778,1613233778,0
1361191862,1613243024,2,265,132.5,1361191837140,1361191837204,1613218164,1613218228,64
1361191878,1613259084,2,472,236,1361191853401,1361191853465,1613234485,1613234549,64
1361191912,1613292688,3,144,48,1361191910884,1361191910884,1613291572,1613291572,0
1361191918,1613299160,2,265,132.5,1361191892363,1361191892491,1613273523,1613273651,128
1361191918,1613299164,2,472,236,1361191893063,1361191893127,1613274227,1613274291,64
1361191958,1613339300,2,472,236,1361191932477,1361191932541,1613313777,1613313841,64
1361191974,1613355304,2,265,132.5,1361191947896,1361191948024,1613329200,1613329328,128
1361191992,1613372712,3,144,48,1361191985867,1361191985867,1613366579,1613366579,0
1361191998,1613379264,2,472,236,1361191973282,1361191973346,1613354546,1613354610,64
1361192030,1613411336,2,265,132.5,1361192003928,1361192004056,1613385264,1613385392,128
1361192038,1613419340,2,472,236,1361192012502,1361192012566,1613393842,1613393906,64
1361192040,1613420704,4,292,73,1361192032913,1361192032977,1613413617,1613413681,64
1361192040,1613420740,4,411,102.75,1361192037997,1361192038125,1613418737,1613418865,128
1361192040,1613420740,3,144,48,1361192038125,1361192038317,1613418865,1613419057,192
1361192044,251738628,8,544,68,1361192034961,1361192040145,251729589,251734773,5184
1361192048,1613428712,4,190,47.5,1361192042760,1361192043272,1613423472,1613423984,512
1361192048,1613428712,4,190,47.5,1361192040199,1361192040583,1613420911,1613421295,384
1361192048,1613428712,4,190,47.5,1361192043271,1361192043783,1613423983,1613424495,512
1361192048,1613428716,4,190,47.5,1361192040389,1361192040837,1613421105,1613421553,448
1361192048,1613428716,4,190,47.5,1361192039237,1361192040005,1613419953,1613420721,768
1361192048,1613428716,4,190,47.5,1361192043843,1361192044291,1613424559,1613425007,448
1361192048,1613428716,4,190,47.5,1361192039811,1361192042243,1613420527,1613422959,2432
1361192048,1613428716,4,190,47.5,1361192040579,1361192041027,1613421295,1613421743,448
1361192048,1613428720,4,190,47.5,1361192040830,1361192041214,1613421550,1613421934,384
1361192048,1613428720,4,190,47.5,1361192044354,1361192044802,1613425074,1613425522,448
1361192048,1613428720,4,190,47.5,1361192041026,1361192041410,1613421746,1613422130,384
1361192048,1613428720,4,190,47.5,1361192041025,1361192041409,1613421745,1613422129,384
1361192048,1613428720,4,190,47.5,1361192044545,1361192044673,1613425265,1613425393,128
1361192048,1613428720,4,190,47.5,1361192044736,1361192044800,1613425456,1613425520,64
1361192048,1613428720,4,190,47.5,1361192041407,1361192041855,1613422127,1613422575,448
1361192048,1613428720,4,190,47.5,1361192044799,1361192044927,1613425519,1613425647,128
1361192048,1613428720,4,190,47.5,1361192044863,1361192044991,1613425583,1613425711,128
1361192048,1613428724,4,190,47.5,1361192041850,1361192042234,1613422574,1613422958,384
1361192048,1613428724,4,190,47.5,1361192042042,1361192042426,1613422766,1613423150,384
1361192048,1613428724,4,190,47.5,1361192045050,1361192045434,1613425774,1613426158,384
1361192048,1613428724,4,190,47.5,1361192045182,1361192045502,1613425906,1613426226,320
1361192048,1613428724,4,190,47.5,1361192042238,1361192044670,1613422962,1613425394,2432
1361192048,1613428724,4,190,47.5,1361192045437,1361192045757,1613426161,1613426481,320
1361192048,1613428724,4,190,47.5,1361192042237,1361192044669,1613422961,1613425393,2432
1361192048,1613428724,4,190,47.5,1361192045756,1361192046076,1613426480,1613426800,320
1361192048,1613428724,4,190,47.5,1361192042428,1361192044860,1613423152,1613425584,2432
1361192048,1613428724,4,190,47.5,1361192045820,1361192046140,1613426544,1613426864,320
1361192048,1613428724,4,190,47.5,1361192046076,1361192046460,1613426800,1613427184,384
1361192048,1613428724,4,190,47.5,1361192039995,1361192040379,1613420719,1613421103,384
1361192048,1613428724,4,190,47.5,1361192039995,1361192040827,1613420719,1613421551,832
1361192048,1613428728,4,190,47.5,1361192039161,1361192039929,1613419889,1613420657,768
1361192048,1613428728,4,190,47.5,1361192039289,1361192040313,1613420017,1613421041,1024
1361192048,1613428728,4,190,47.5,1361192039225,1361192040057,1613419953,1613420785,832
1361192048,1613428728,4,190,47.5,1361192040567,1361192041015,1613421295,1613421743,448
1361192048,1613428728,4,190,47.5,1361192039799,1361192040183,1613420527,1613420911,384
1361192048,1613428728,4,190,47.5,1361192044599,1361192044663,1613425327,1613425391,64
1361192048,1613428728,4,190,47.5,1361192044663,1361192044727,1613425391,1613425455,64
1361192048,1613428728,6,630,105,1361192044023,1361192044151,1613424751,1613424879,128
1361192048,1613428728,4,190,47.5,1361192044726,1361192044790,1613425454,1613425518,64
1361192048,1613428748,4,190,47.5,1361192044770,1361192044834,1613425518,1613425582,64
1361192048,1613428748,4,190,47.5,1361192041186,1361192041570,1613421934,1613422318,384
1361192048,1613428748,4,190,47.5,1361192044834,1361192044898,1613425582,1613425646,64
1361192048,1613428748,4,190,47.5,1361192041571,1361192042019,1613422319,1613422767,448
1361192048,1613428752,4,190,47.5,1361192041374,1361192041822,1613422126,1613422574,448
1361192048,1613428752,4,190,47.5,1361192044702,1361192044830,1613425454,1613425582,128
1361192048,1613428752,4,190,47.5,1361192044702,1361192045214,1613425454,1613425966,512
1361192048,1613428752,4,190,47.5,1361192045345,1361192045729,1613426097,1613426481,384
1361192048,1613428752,4,190,47.5,1361192045409,1361192045793,1613426161,1613426545,384
1361192048,1613428752,4,190,47.5,1361192045025,1361192045345,1613425777,1613426097,320
1361192048,1613428752,4,190,47.5,1361192045089,1361192045409,1613425841,1613426161,320
1361192048,1613428752,4,190,47.5,1361192041825,1361192042209,1613422577,1613422961,384
1361192048,1613428752,4,190,47.5,1361192042207,1361192042591,1613422959,1613423343,384
1361192048,1613428752,4,190,47.5,1361192045471,1361192045855,1613426223,1613426607,384
1361192048,1613428752,4,190,47.5,1361192045727,1361192046047,1613426479,1613426799,320
1361192048,1613428752,4,190,47.5,1361192045855,1361192046175,1613426607,1613426927,320
1361192050,1613431336,4,190,47.5,1361192045462,1361192045782,1613426798,1613427118,320
1361192050,1613431336,4,190,47.5,1361192045526,1361192045846,1613426862,1613427182,320
1361192058,1613439384,33,30266,917.1515152,1361192032999,1361192037159,1613414383,1613418543,4160
1361192062,1613443356,6,3994,665.6666667,1361192034949,1361192035013,1613416305,1613416369,64
1361192062,1613443356,6,4122,687,1361192034949,1361192035013,1613416305,1613416369,64
1361192062,1613443356,7,4418,631.1428571,1361192034948,1361192035012,1613416304,1613416368,64
1361192062,1613443388,6,4074,679,1361192034915,1361192034979,1613416303,1613416367,64
1361192062,1613443388,7,4375,625,1361192034914,1361192034978,1613416302,1613416366,64
1361192062,1613443388,7,4338,619.7142857,1361192034914,1361192034978,1613416302,1613416366,64
1361192063,251756980,11,8097,736.0909091,1361192035416,1361192035800,251729396,251729780,384
1361192064,1613444740,4,572,143,1361192056109,1361192056173,1613436849,1613436913,64
1361192064,1613444748,3,144,48,1361192060834,1361192060834,1613441582,1613441582,0
1361192072,1613452744,3,144,48,1361192068328,1361192068520,1613449072,1613449264,192
1361192078,1613459432,2,472,236,1361192053177,1361192053241,1613434609,1613434673,64
1361192080,1613460764,4,376,94,1361192074195,1361192074259,1613454959,1613455023,64
1361192080,1613460796,4,310,77.5,1361192074163,1361192074227,1613454959,1613455023,64
1361192087,1613467884,2,265,132.5,1361192060378,1361192060442,1613441262,1613441326,64
1361192092,251786624,2,98,49,1361192087893,1361192091413,251782517,251786037,3520
1361192096,1613476736,4,412,103,1361192088303,1361192088367,1613469039,1613469103,64
1361192100,251794628,2,98,49,1361192087890,1361192092434,251782518,251787062,4544
1361192104,1613484748,4,376,94,1361192102370,1361192102498,1613483118,1613483246,128
1361192104,1613484752,4,460,115,1361192096350,1361192096414,1613477102,1613477166,64
1361192119,1613499912,2,472,236,1361192093120,1361192093184,1613474032,1613474096,64
1361192120,1613500760,4,628,157,1361192112470,1361192112534,1613493230,1613493294,64
1361192120,1613500760,4,310,77.5,1361192112469,1361192112533,1613493229,1613493293,64
1361192136,1613516740,4,292,73,1361192134570,1361192134698,1613515310,1613515438,128
1361192136,1613516744,3,144,48,1361192135782,1361192135846,1613516526,1613516590,64
1361192136,1613516752,4,310,77.5,1361192134560,1361192134688,1613515312,1613515440,128
1361192143,1613523912,2,265,132.5,1361192116158,1361192116222,1613497070,1613497134,64
1361192144,1613524744,4,460,115,1361192142630,1361192142694,1613523374,1613523438,64
1361192152,1613532756,4,628,157,1361192148697,1361192148825,1613529453,1613529581,128
1361192152,1613532764,3,169,56.33333333,1361192150675,1361192150675,1613531439,1613531439,0
1361192152,1613532764,3,169,56.33333333,1361192150675,1361192150675,1613531439,1613531439,0
1361192152,1613532764,3,169,56.33333333,1361192150675,1361192150675,1613531439,1613531439,0
1361192152,1613532796,3,169,56.33333333,1361192150641,1361192150641,1613531437,1613531437,0
1361192152,1613532796,3,169,56.33333333,1361192150641,1361192150641,1613531437,1613531437,0
1361192155,1613535912,3,169,56.33333333,1361192150525,1361192150525,1613531437,1613531437,0
1361192156,251850628,3,169,56.33333333,1361192150160,1361192150160,251844788,251844788,0
1361192159,1613539900,2,472,236,1361192133194,1361192133258,1613514094,1613514158,64
1361192160,1613540752,4,205,51.25,1361192153693,1361192153693,1613534445,1613534445,0
1361192160,1613540760,4,310,77.5,1361192158742,1361192158806,1613539502,1613539566,64
1361192168,1613548768,4,432,108,1361192160718,1361192160846,1613541486,1613541614,128
1361192168,1613548772,4,312,78,1361192162696,1361192162760,1613543468,1613543532,64
1361192168,1613548776,4,312,78,1361192162824,1361192162888,1613543600,1613543664,64
1361192168,1613548776,4,312,78,1361192162760,1361192162824,1613543536,1613543600,64
1361192168,1613548784,4,292,73,1361192164735,1361192164799,1613545519,1613545583,64
1361192168,1613548816,4,312,78,1361192162783,1361192162911,1613543599,1613543727,128
1361192179,1613559984,7,1450,207.1428571,1361192154741,1361192155317,1613535725,1613536301,576
1361192184,1613564756,4,310,77.5,1361192176857,1361192176921,1613557613,1613557677,64
1361192187,1613567964,3,1082,360.6666667,1361192162377,1361192162377,1613543341,1613543341,0
1361192187,1613568004,25,30339,1213.56,1361192162400,1361192162592,1613543404,1613543596,192
1361192199,1613579976,2,265,132.5,1361192172029,1361192172157,1613553005,1613553133,128
1361192199,1613579980,2,472,236,1361192172857,1361192172857,1613553837,1613553837,0
1361192200,1613580756,5,978,195.6,1361192196953,1361192197081,1613577709,1613577837,128
1361192208,1613588808,4,292,73,1361192202919,1361192203047,1613583727,1613583855,128
1361192216,1613596764,4,376,94,1361192209040,1361192209104,1613589804,1613589868,64
1361192216,1613596800,4,310,77.5,1361192209006,1361192209070,1613589806,1613589870,64
1361192216,1613596808,3,144,48,1361192210791,1361192210791,1613591599,1613591599,0
1361192224,1613604772,4,376,94,1361192217099,1361192217163,1613597871,1613597935,64
1361192227,1613607992,4,460,115,1361192222894,1361192222958,1613603886,1613603950,64
1361192239,1613620064,2,472,236,1361192212964,1361192213028,1613594028,1613594092,64
1361192248,1613628792,6,1872,312,1361192240821,1361192246645,1613621613,1613627437,5824
1361192248,1613628792,26,32394,1245.923077,1361192240885,1361192244981,1613621677,1613625773,4096
1361192248,1613628792,4,312,78,1361192241012,1361192241076,1613621804,1613621868,64
1361192248,1613628792,2,98,49,1361192240883,1361192246067,1613621675,1613626859,5184
1361192248,1613628792,2,98,49,1361192240883,1361192246067,1613621675,1613626859,5184
1361192248,1613628792,3,144,48,1361192240883,1361192246067,1613621675,1613626859,5184
1361192248,1613628796,4,312,78,1361192240943,1361192241007,1613621739,1613621803,64
1361192248,1613628796,3,140,46.66666667,1361192241011,1361192246067,1613621807,1613626863,5056
1361192248,1613628796,4,312,78,1361192241395,1361192241459,1613622191,1613622255,64
1361192248,1613628796,3,615,205,1361192241202,1361192241266,1613621998,1613622062,64
1361192248,1613628796,4,311,77.75,1361192241202,1361192241266,1613621998,1613622062,64
1361192248,1613628796,4,312,78,1361192241202,1361192241330,1613621998,1613622126,128
1361192248,1613628796,6,938,156.3333333,1361192241522,1361192246642,1613622318,1613627438,5120
1361192248,1613628796,2,98,49,1361192241586,1361192247026,1613622382,1613627822,5440
1361192248,1613628796,4,312,78,1361192241586,1361192241714,1613622382,1613622510,128
1361192248,1613628796,2,279,139.5,1361192241714,1361192247090,1613622510,1613627886,5376
1361192248,1613628796,4,313,78.25,1361192241841,1361192241905,1613622637,1613622701,64
1361192248,1613628796,6,938,156.3333333,1361192241521,1361192246705,1613622317,1613627501,5184
1361192248,1613628796,4,312,78,1361192241585,1361192241713,1613622381,1613622509,128
1361192248,1613628800,2,98,49,1361192238252,1361192244076,1613619052,1613624876,5824
1361192248,1613628808,6,2026,337.6666667,1361192240807,1361192246631,1613621615,1613627439,5824
1361192248,1613628808,2,98,49,1361192240871,1361192246055,1613621679,1613626863,5184
1361192248,1613628808,2,279,139.5,1361192240679,1361192246055,1613621487,1613626863,5376
1361192248,1613628808,4,313,78.25,1361192240678,1361192240806,1613621486,1613621614,128
1361192248,1613628808,4,313,78.25,1361192241190,1361192241254,1613621998,1613622062,64
1361192248,1613628808,4,312,78,1361192240870,1361192240998,1613621678,1613621806,128
1361192248,1613628832,3,140,46.66666667,1361192241165,1361192246989,1613621997,1613627821,5824
1361192248,1613628832,3,144,48,1361192241165,1361192247053,1613621997,1613627885,5888
1361192248,1613628832,4,313,78.25,1361192241676,1361192241804,1613622508,1613622636,128
1361192248,1613628832,3,774,258,1361192241611,1361192241675,1613622443,1613622507,64
1361192248,1613628836,4,312,78,1361192241675,1361192241739,1613622511,1613622575,64
1361192248,1613628836,4,544,136,1361192243144,1361192243272,1613623980,1613624108,128
1361192248,1613628840,2,98,49,1361192238211,1361192244035,1613619051,1613624875,5824
1361192248,1613628840,2,98,49,1361192238275,1361192244035,1613619115,1613624875,5760
1361192252,251946688,2,98,49,1361192241172,1361192246484,251935860,251941172,5312
1361192255,1613636112,78,73192,938.3589744,1361192226932,1361192237876,1613608044,1613618988,10944
1361192255,1613636116,2,265,132.5,1361192227378,1361192227442,1613608494,1613608558,64
1361192256,1613636772,4,544,136,1361192251275,1361192251339,1613632047,1613632111,64
1361192263,1613644128,9,5262,584.6666667,1361192237925,1361192241061,1613619053,1613622189,3136
1361192263,1613644128,6,3586,597.6666667,1361192237925,1361192238309,1613619053,1613619437,384
1361192263,1613644168,7,5656,808,1361192237630,1361192237822,1613618798,1613618990,192
1361192263,1613644168,4,1747,436.75,1361192237886,1361192238014,1613619054,1613619182,128
1361192263,1613644168,5,484,96.8,1361192237822,1361192238078,1613618990,1613619246,256
1361192264,1613644780,13,11725,901.9230769,1361192240704,1361192256256,1613621484,1613637036,15552
1361192264,1613644784,6,1785,297.5,1361192241724,1361192256892,1613622508,1613637676,15168
1361192267,1613648116,3,740,246.6666667,1361192240175,1361192240239,1613621291,1613621355,64
1361192267,1613648120,8,5163,645.375,1361192240300,1361192241004,1613621420,1613622124,704
1361192267,1613648124,4,930,232.5,1361192240683,1361192241003,1613621807,1613622127,320
1361192267,1613648124,4,914,228.5,1361192241001,1361192241513,1613622125,1613622637,512
1361192267,1613648160,13,12631,971.6153846,1361192240963,1361192241411,1613622123,1613622571,448
1361192272,1613652824,4,205,51.25,1361192271059,1361192271059,1613651883,1613651883,0
1361192279,1613660156,2,472,236,1361192252936,1361192253000,1613634092,1613634156,64
1361192288,1613668800,3,144,48,1361192285805,1361192285805,1613666605,1613666605,0
1361192296,1613676836,3,200,66.66666667,1361192283144,1361192292040,1613663980,1613672876,8896
1361192303,1613684172,1,46,46,1361192277687,1361192277687,1613658859,1613658859,0
1361192303,1613684216,1,46,46,1361192277646,1361192277646,1613658862,1613658862,0
1361192304,1613684784,4,412,103,1361192299579,1361192299643,1613680363,1613680427,64
1361192304,1613684784,4,412,103,1361192299579,1361192299643,1613680363,1613680427,64
1361192304,1613684792,3,200,66.66666667,1361192297396,1361192302388,1613678188,1613683180,4992
1361192307,1613688228,2,265,132.5,1361192282495,1361192282623,1613663723,1613663851,128
1361192311,1613692160,2,154,77,1361192282822,1361192283078,1613663982,1613664238,256
1361192312,1613692780,4,310,77.5,1361192311616,1361192311744,1613692396,1613692524,128
1361192312,1613692780,4,413,103.25,1361192307648,1361192307712,1613688428,1613688492,64
1361192319,1613700180,2,472,236,1361192293425,1361192293489,1613674605,1613674669,64
1361192320,1613700796,6,910,151.6666667,1361192317678,1361192317742,1613698474,1613698538,64
1361192320,1613700796,4,310,77.5,1361192317678,1361192317742,1613698474,1613698538,64
1361192323,1613704204,2,92,46,1361192297049,1361192297049,1613678253,1613678253,0
1361192323,1613704244,2,92,46,1361192297967,1361192298031,1613679211,1613679275,64
1361192327,1613708176,2,92,46,1361192300276,1361192300340,1613681452,1613681516,64
1361192327,1613708208,2,92,46,1361192299924,1361192299988,1613681132,1613681196,64
1361192327,1613708208,2,92,46,1361192300052,1361192300052,1613681260,1613681260,0
1361192327,1613708216,2,92,46,1361192301262,1361192301262,1613682478,1613682478,0
1361192328,1613708792,4,412,103,1361192323700,1361192323764,1613704492,1613704556,64
1361192328,1613708800,4,452,113,1361192325739,1361192325803,1613706539,1613706603,64
1361192335,1613716224,4,1282,320.5,1361192307139,1361192307459,1613688363,1613688683,320
1361192335,1613716272,3,790,263.3333333,1361192309653,1361192309717,1613690925,1613690989,64
1361192336,1613716812,4,412,103,1361192329761,1361192329825,1613710573,1613710637,64
1361192339,1613720256,1,46,46,1361192312164,1361192312164,1613693420,1613693420,0
1361192344,1613724872,4,515,128.75,1361192337701,1361192337829,1613718573,1613718701,128
1361192352,1613732812,4,311,77.75,1361192345823,1361192345887,1613726635,1613726699,64
1361192352,1613732816,8,1505,188.125,1361192338971,1361192344795,1613719787,1613725611,5824
1361192352,1613732848,8,1505,188.125,1361192338941,1361192344765,1613719789,1613725613,5824
1361192352,1613732848,4,311,77.75,1361192349820,1361192349884,1613730668,1613730732,64
1361192355,1613736256,1,77,77,1361192327586,1361192327586,1613708842,1613708842,0
1361192359,1613740248,2,472,236,1361192333869,1361192333933,1613715117,1613715181,64
1361192360,1613740832,4,311,77.75,1361192353869,1361192354061,1613734701,1613734893,192
1361192363,1613744228,10,2143,214.3,1361192337341,1361192337853,1613718569,1613719081,512
1361192363,1613744268,2,265,132.5,1361192337879,1361192337943,1613719147,1613719211,64
1361192368,1613748840,3,144,48,1361192360706,1361192360770,1613741546,1613741610,64
1361192376,1613756824,6,366,61,1361192372946,1361192373010,1613753770,1613753834,64
1361192376,1613756836,4,619,154.75,1361192372297,1361192372425,1613753133,1613753261,128
1361192376,1613756836,5,1538,307.6,1361192372296,1361192372488,1613753132,1613753324,192
1361192383,1613764300,1,46,46,1361192355320,1361192355320,1613736620,1613736620,0
1361192383,1613764304,1,46,46,1361192356339,1361192356339,1613737643,1613737643,0
1361192384,1613764844,4,544,136,1361192377984,1361192378048,1613758828,1613758892,64
1361192384,1613764848,4,414,103.5,1361192375996,1361192376060,1613756844,1613756908,64
1361192392,1613772868,4,310,77.5,1361192383974,1361192384102,1613764842,1613764970,128
1361192395,1613776296,2,92,46,1361192366969,1361192366969,1613748265,1613748265,0
1361192395,1613776304,2,92,46,1361192368884,1361192368884,1613750188,1613750188,0
1361192400,1613780556,2,472,236,1361192374238,1361192374302,1613754794,1613754858,64
1361192400,1613780856,4,617,154.25,1361192392052,1361192392180,1613772908,1613773036,128
1361192404,252098680,2,98,49,1361192397854,1361192401950,252092534,252096630,4096
1361192404,252098680,2,98,49,1361192397790,1361192400926,252092470,252095606,3136
1361192408,1613788840,4,413,103.25,1361192400129,1361192400193,1613780969,1613781033,64
1361192408,1613788856,4,414,103.5,1361192404146,1361192404210,1613785002,1613785066,64
1361192416,1613796848,3,144,48,1361192405692,1361192410748,1613786540,1613791596,5056
1361192416,1613796876,5,1218,243.6,1361192410141,1361192410269,1613791017,1613791145,128
1361192416,1613796880,4,414,103.5,1361192414171,1361192414235,1613795051,1613795115,64
1361192420,1613800616,2,265,132.5,1361192393827,1361192393955,1613774443,1613774571,128
1361192424,1613804872,4,620,155,1361192420196,1361192420324,1613801068,1613801196,128
1361192424,1613804872,3,144,48,1361192412897,1361192418529,1613793769,1613799401,5632
1361192432,1613812664,5,1529,305.8,1361192405873,1361192413297,1613786537,1613793961,7424
1361192432,1613812856,4,632,158,1361192429362,1361192429490,1613810218,1613810346,128
1361192432,1613812860,4,311,77.75,1361192426284,1361192426348,1613807144,1613807208,64
1361192432,1613812868,4,311,77.75,1361192429351,1361192429479,1613810219,1613810347,128
1361192440,1613820608,14,17681,1262.928571,1361192412777,1361192413097,1613793385,1613793705,320
1361192440,1613820612,9,9577,1064.111111,1361192413223,1361192413543,1613793835,1613794155,320
1361192440,1613820648,4,930,232.5,1361192413120,1361192413440,1613793768,1613794088,320
1361192440,1613820656,2,472,236,1361192414460,1361192414524,1613795116,1613795180,64
1361192440,1613820888,3,144,48,1361192435666,1361192435730,1613816554,1613816618,64
1361192456,1613836872,4,205,51.25,1361192453540,1361192453540,1613834412,1613834412,0
1361192476,1613856620,2,265,132.5,1361192449375,1361192449439,1613829995,1613830059,64
1361192480,1613860644,2,472,236,1361192454279,1361192454407,1613834923,1613835051,128
1361192500,1613880684,2,92,46,1361192472477,1361192472477,1613853161,1613853161,0
1361192512,1613892908,3,144,48,1361192510652,1361192510716,1613891560,1613891624,64
1361192520,1613900688,2,472,236,1361192494746,1361192494810,1613875434,1613875498,64
1361192525,1613905836,1,46,46,1361192497542,1361192497542,1613878378,1613878378,0
1361192525,1613905860,1,46,46,1361192497517,1361192497517,1613878377,1613878377,0
1361192532,1613912748,2,265,132.5,1361192504606,1361192504734,1613885354,1613885482,128
1361192536,1613916912,2,92,46,1361192528634,1361192528634,1613909546,1613909546,0
1361192556,1613937016,1,46,46,1361192528463,1361192528463,1613909479,1613909479,0
1361192556,1613937060,1,46,46,1361192528420,1361192528420,1613909480,1613909480,0
1361192560,1613941024,2,472,236,1361192533767,1361192533831,1613914791,1613914855,64
1361192568,1613948916,2,98,49,1361192557811,1361192563827,1613938727,1613944743,6016
1361192568,1613948920,60,67131,1118.85,1361192563120,1361192565424,1613944040,1613946344,2304
1361192568,1613948920,4,312,78,1361192563184,1361192563248,1613944104,1613944168,64
1361192568,1613948952,9,3230,358.8888889,1361192557520,1361192562768,1613938472,1613943720,5248
1361192568,1613948952,10,478,47.8,1361192557775,1361192564815,1613938727,1613945767,7040
1361192580,1613961060,61,66746,1094.196721,1361192552803,1361192558179,1613933863,1613939239,5376
1361192584,1613965056,8,3599,449.875,1361192557607,1361192558119,1613938663,1613939175,512
1361192584,1613965060,5,484,96.8,1361192558180,1361192558436,1613939240,1613939496,256
1361192584,1613965092,7,3260,465.7142857,1361192557506,1361192557890,1613938598,1613938982,384
1361192584,1613965096,8,6068,758.5,1361192557633,1361192565249,1613938729,1613946345,7616
1361192584,1613965096,5,3198,639.6,1361192557633,1361192558081,1613938729,1613939177,448
1361192588,1613969044,3,715,238.3333333,1361192562483,1361192562547,1613943527,1613943591,64
1361192588,1613969044,12,8982,748.5,1361192562611,1361192564659,1613943655,1613945703,2048
1361192588,1613969048,9,6567,729.6666667,1361192563758,1361192565294,1613944806,1613946342,1536
1361192588,1613969052,6,3574,595.6666667,1361192563758,1361192564846,1613944810,1613945898,1088
1361192588,1613969072,2,265,132.5,1361192560150,1361192560278,1613941222,1613941350,128
1361192588,1613969088,10,3154,315.4,1361192562953,1361192564809,1613944041,1613945897,1856
1361192588,1613969088,6,3593,598.8333333,1361192563718,1361192564806,1613944806,1613945894,1088
1361192592,1613972924,8,5431,678.875,1361192563885,1361192565101,1613944809,1613946025,1216
1361192592,1613972968,3,144,48,1361192585599,1361192585663,1613966567,1613966631,64
1361192592,1613973092,5,3208,641.6,1361192564741,1361192564933,1613945833,1613946025,192
1361192592,1613973092,4,1624,406,1361192564741,1361192564869,1613945833,1613945961,128
1361192592,1613973092,7,5363,766.1428571,1361192564741,1361192564869,1613945833,1613945961,128
1361192592,1613973092,6,2474,412.3333333,1361192564740,1361192565188,1613945832,1613946280,448
1361192596,1613977104,1,95,95,1361192569849,1361192569849,1613950953,1613950953,0
1361192600,1613981120,2,472,236,1361192573992,1361192574056,1613955112,1613955176,64
1361192616,1613996960,3,200,66.66666667,1361192602696,1361192611720,1613983656,1613992680,9024
1361192620,1614001136,2,92,46,1361192594777,1361192594841,1613975913,1613975977,64
1361192620,1614001136,2,92,46,1361192594774,1361192594838,1613975910,1613975974,64
1361192620,1614001136,2,92,46,1361192594774,1361192594838,1613975910,1613975974,64
1361192620,1614001168,2,92,46,1361192594680,1361192594808,1613975848,1613975976,128
1361192620,1614001168,2,92,46,1361192594743,1361192594807,1613975911,1613975975,64
1361192620,1614001168,2,92,46,1361192594679,1361192594807,1613975847,1613975975,128
1361192620,1614001168,2,92,46,1361192594743,1361192594807,1613975911,1613975975,64
1361192620,1614001168,2,92,46,1361192594743,1361192594807,1613975911,1613975975,64
1361192620,1614001200,2,92,46,1361192595157,1361192595221,1613976357,1613976421,64
1361192624,1614004944,3,200,66.66666667,1361192617112,1361192622104,1613998056,1614003048,4992
1361192628,1614009180,1,77,77,1361192602604,1361192602604,1613983784,1613983784,0
1361192628,1614009180,1,77,77,1361192602475,1361192602475,1613983655,1613983655,0
1361192640,1614021196,2,265,132.5,1361192615386,1361192615450,1613996582,1613996646,64
1361192640,1614021208,2,472,236,1361192614480,1361192614544,1613995688,1613995752,64
1361192644,1614025184,2,92,46,1361192617766,1361192617830,1613998950,1613999014,64
1361192648,1614029016,8,1505,188.125,1361192639054,1361192644174,1614020070,1614025190,5120
1361192648,1614029216,2,92,46,1361192622855,1361192622855,1614004071,1614004071,0
1361192652,1614033204,2,92,46,1361192624721,1361192624785,1614005925,1614005989,64
1361192660,1614041228,13,3180,244.6153846,1361192634940,1361192638588,1614016168,1614019816,3648
1361192664,1614044964,3,144,48,1361192660610,1361192660610,1614041574,1614041574,0
1361192668,1614049180,1,46,46,1361192639977,1361192639977,1614021157,1614021157,0
1361192672,1614053228,1,77,77,1361192647353,1361192647353,1614028581,1614028581,0
1361192672,1614053272,1,77,77,1361192647438,1361192647438,1614028710,1614028710,0
1361192680,1614061264,2,472,236,1361192654998,1361192655062,1614036262,1614036326,64
1361192688,1614069000,3,144,48,1361192679774,1361192679966,1614060774,1614060966,192
1361192688,1614069204,3,144,48,1361192679569,1361192679761,1614060773,1614060965,192
1361192696,1614076972,5,320,64,1361192692668,1361192692860,1614073640,1614073832,192
1361192696,1614076972,5,320,64,1361192692604,1361192692604,1614073576,1614073576,0
1361192696,1614077260,2,265,132.5,1361192671385,1361192671449,1614052645,1614052709,64
1361192704,1614085232,1,46,46,1361192677944,1361192677944,1614059176,1614059176,0
1361192717,252410828,2,98,49,1361192708723,1361192713139,252402551,252406967,4416
1361192717,252410836,2,98,49,1361192708718,1361192712110,252402554,252405946,3392
1361192721,1614101492,2,472,236,1361192695452,1361192695516,1614075944,1614076008,64
1361192736,1614116996,3,144,48,1361192735586,1361192735586,1614116582,1614116582,0
1361192741,1614121520,14,6617,472.6428571,1361192714176,1361192714496,1614094696,1614095016,320
1361192753,1614133532,2,265,132.5,1361192728048,1361192728112,1614108580,1614108644,64
1361192760,1614140984,4,205,51.25,1361192754221,1361192754221,1614135205,1614135205,0
1361192761,1614141488,2,472,236,1361192736158,1361192736222,1614116646,1614116710,64
1361192800,1614181016,3,144,48,1361192795532,1361192795596,1614176548,1614176612,64
1361192801,1614181664,2,472,236,1361192776619,1361192776683,1614157283,1614157347,64
1361192809,1614189648,2,265,132.5,1361192783741,1361192783869,1614164389,1614164517,128
1361192841,1614221648,2,472,236,1361192816509,1361192816573,1614197157,1614197221,64
1361192865,1614245696,2,265,132.5,1361192839437,1361192839565,1614220133,1614220261,128
1361192872,1614253112,3,144,48,1361192870445,1361192870509,1614251557,1614251621,64
1361192881,1614261888,2,472,236,1361192856717,1361192856781,1614237605,1614237669,64
1361192921,1614301912,2,472,236,1361192896754,1361192896818,1614277666,1614277730,64
1361192921,1614301920,2,265,132.5,1361192895084,1361192895148,1614276004,1614276068,64
1361192952,1614333148,3,144,48,1361192945413,1361192945477,1614326561,1614326625,64
1361192952,1614333152,8,544,68,1361192945668,1361192950660,1614326820,1614331812,4992
1361192952,1614333152,8,544,68,1361192945668,1361192951684,1614326820,1614332836,6016
1361192952,1614333180,8,1505,188.125,1361192939303,1361192944423,1614320483,1614325603,5120
1361192957,252650900,8,544,68,1361192946284,1361192952300,252640184,252646200,6016
1361192957,252650904,8,544,68,1361192946280,1361192952296,252640184,252646200,6016
1361192965,1614345996,2,472,236,1361192937184,1361192937248,1614318180,1614318244,64
1361192965,1614346008,7,1006,143.7142857,1361192939667,1361192940243,1614320675,1614321251,576
1361192965,1614346032,31,22837,736.6774194,1361192938617,1361192946041,1614319649,1614327073,7424
1361192972,252666252,11,9430,857.2727273,1361192945934,1361192945998,252640186,252640250,64
1361192973,1614354136,6,1934,322.3333333,1361192945681,1361192945745,1614326817,1614326881,64
1361192976,1614357168,3,189,63,1361192969971,1361192973043,1614351139,1614354211,3072
1361192977,1614358112,2,265,132.5,1361192950379,1361192950443,1614331491,1614331555,64
1361192992,1614373156,2,126,63,1361192977084,1361192985148,1614358240,1614366304,8064
1361192992,1614373156,12,999,83.25,1361192977917,1361192988925,1614359073,1614370081,11008
1361192992,1614373160,11,953,86.63636364,1361192978170,1361192988858,1614359330,1614370018,10688
1361192992,1614373172,12,999,83.25,1361192978414,1361192988846,1614359586,1614370018,10432
1361192992,1614373192,12,999,83.25,1361192978650,1361192988826,1614359842,1614370018,10176
1361193005,1614386132,2,472,236,1361192977044,1361192977108,1614358176,1614358240,64
1361193024,1614405184,3,144,48,1361193022753,1361193022817,1614403937,1614404001,64
1361193029,252722904,2,98,49,1361193018665,1361193021865,252712569,252715769,3200
1361193029,252722908,2,98,49,1361193018661,1361193022885,252712569,252716793,4224
1361193033,1614414344,2,265,132.5,1361193005695,1361193005759,1614387039,1614387103,64
1361193041,1614422392,2,472,236,1361193016591,1361193016655,1614397983,1614398047,64
1361193056,1614437200,4,205,51.25,1361193055696,1361193055696,1614436896,1614436896,0
1361193056,1614437232,11,5602,509.2727273,1361193035631,1361193050927,1614416863,1614432159,15296
1361193064,1614445192,4,205,51.25,1361193061658,1361193061658,1614442850,1614442850,0
1361193064,1614445192,3,169,56.33333333,1361193061657,1361193061657,1614442849,1614442849,0
1361193069,252762916,3,169,56.33333333,1361193062302,1361193062302,252756218,252756218,0
1361193082,1614462480,2,472,236,1361193057761,1361193057825,1614438241,1614438305,64
1361193089,1614470428,2,265,132.5,1361193061420,1361193061548,1614442848,1614442976,128
1361193096,1614477240,3,144,48,1361193095335,1361193095335,1614476575,1614476575,0
1361193121,1614502452,2,472,236,1361193096658,1361193096722,1614478110,1614478174,64
1361193134,1614514468,1,46,46,1361193107565,1361193107565,1614488033,1614488033,0
1361193142,1614522496,2,265,132.5,1361193117712,1361193117776,1614498208,1614498272,64
1361193142,1614522532,7,1450,207.1428571,1361193116013,1361193116589,1614496545,1614497121,576
1361193160,1614541316,3,144,48,1361193155291,1361193155291,1614536607,1614536607,0
1361193166,1614546532,2,472,236,1361193138092,1361193138156,1614518624,1614518688,64
1361193176,1614557296,4,442,110.5,1361193170609,1361193170673,1614551905,1614551969,64
1361193198,1614578876,2,265,132.5,1361193172756,1361193172884,1614553632,1614553760,128
1361193206,1614586884,2,472,236,1361193178124,1361193178188,1614559008,1614559072,64
1361193232,1614613408,4,205,51.25,1361193231231,1361193231231,1614612639,1614612639,0
1361193232,1614613436,3,144,48,1361193230113,1361193230177,1614611549,1614611613,64
1361193246,1614626912,2,472,236,1361193218349,1361193218413,1614599261,1614599325,64
1361193254,1614634924,2,265,132.5,1361193228257,1361193228385,1614609181,1614609309,128
1361193266,1614646888,10,2072,207.2,1361193239366,1361193239686,1614620254,1614620574,320
1361193286,1614666944,2,472,236,1361193257934,1361193257998,1614638878,1614638942,64
1361193310,1614691024,2,265,132.5,1361193283324,1361193283388,1614664348,1614664412,64
1361193313,1614693500,3,144,48,1361193306056,1361193306056,1614686556,1614686556,0
1361193326,1614706996,2,472,236,1361193298201,1361193298265,1614679197,1614679261,64
1361193341,253034956,2,98,49,1361193330296,1361193334776,253024252,253028732,4480
1361193341,253034960,2,98,49,1361193330292,1361193333748,253024252,253027708,3456
1361193354,1614735316,1,60,60,1361193326806,1361193326806,1614708122,1614708122,0
1361193361,1614741476,4,205,51.25,1361193355808,1361193355808,1614736284,1614736284,0
1361193366,1614747312,2,472,236,1361193338140,1361193338204,1614719452,1614719516,64
1361193366,1614747316,2,265,132.5,1361193338967,1361193339031,1614720283,1614720347,64
1361193369,1614749520,3,144,48,1361193366066,1361193366066,1614746586,1614746586,0
1361193402,1614783372,2,472,236,1361193377374,1361193377438,1614758746,1614758810,64
1361193422,1614803424,2,265,132.5,1361193394729,1361193394857,1614776153,1614776281,128
1361193441,1614821824,3,144,48,1361193440770,1361193440770,1614821594,1614821594,0
1361193442,1614823396,2,472,236,1361193417606,1361193417670,1614799002,1614799066,64
1361193478,1614859452,2,265,132.5,1361193450638,1361193450702,1614832090,1614832154,64
1361193483,1614863560,2,472,236,1361193458571,1361193458699,1614839131,1614839259,128
1361193521,1614901852,3,144,48,1361193515751,1361193515751,1614896603,1614896603,0
1361193523,1614903712,2,472,236,1361193498546,1361193498610,1614879258,1614879322,64
1361193535,1614915692,2,265,132.5,1361193507399,1361193507527,1614888091,1614888219,128
1361193563,1614943768,2,472,236,1361193538297,1361193538361,1614919065,1614919129,64
1361193567,1614947824,10,1891,189.1,1361193539842,1361193540290,1614920666,1614921114,448
1361193587,1614967804,2,265,132.5,1361193562710,1361193562774,1614943514,1614943578,64
1361193593,1614973924,3,144,48,1361193590620,1361193590684,1614971544,1614971608,64
1361193603,1614983824,2,472,236,1361193577985,1361193578049,1614958809,1614958873,64
1361193623,1615003836,3,1120,373.3333333,1361193596086,1361193596598,1614976922,1614977434,512
1361193643,1615023896,2,472,236,1361193618745,1361193618809,1614999641,1614999705,64
1361193643,1615023932,2,265,132.5,1361193618130,1361193618258,1614999062,1614999190,128
1361193645,253339088,2,98,49,1361193640758,1361193644342,253334846,253338430,3584
1361193649,1615029956,4,336,84,1361193643837,1361193643901,1615024793,1615024857,64
1361193653,253347048,2,98,49,1361193640800,1361193645408,253334848,253339456,4608
1361193673,1615054012,3,144,48,1361193665540,1361193666628,1615046552,1615047640,1088
1361193687,1615068200,2,472,236,1361193659205,1361193659269,1615040405,1615040469,64
1361193699,1615080192,2,265,132.5,1361193673358,1361193673486,1615054550,1615054678,128
1361193713,1615094068,4,205,51.25,1361193711626,1361193711626,1615092694,1615092694,0
1361193723,1615104296,2,472,236,1361193698791,1361193698855,1615080087,1615080151,64
1361193745,1615126072,3,144,48,1361193740485,1361193740549,1615121557,1615121621,64
1361193755,1615136272,2,265,132.5,1361193729150,1361193729278,1615110422,1615110550,128
1361193767,1615148308,2,472,236,1361193739354,1361193739418,1615120662,1615120726,64
1361193808,1615188636,2,472,236,1361193780152,1361193780216,1615160788,1615160852,64
1361193812,1615192616,2,265,132.5,1361193785164,1361193785228,1615165780,1615165844,64
1361193817,1615198080,3,144,48,1361193815484,1361193815484,1615196564,1615196564,0
1361193825,1615206108,4,891,222.75,1361193821281,1361193821345,1615202389,1615202453,64
1361193841,1615222112,13,5365,412.6923077,1361193835164,1361193840412,1615216276,1615221524,5248
1361193848,1615228660,2,472,236,1361193820192,1361193820256,1615200852,1615200916,64
1361193849,1615230088,4,190,47.5,1361193848438,1361193848694,1615229526,1615229782,256
1361193849,1615230088,4,190,47.5,1361193848566,1361193848822,1615229654,1615229910,256
1361193849,1615230092,4,190,47.5,1361193847153,1361193847409,1615228245,1615228501,256
1361193849,1615230092,4,190,47.5,1361193847025,1361193847729,1615228117,1615228821,704
1361193849,1615230092,5,236,47.2,1361193847409,1361193848433,1615228501,1615229525,1024
1361193849,1615230092,6,282,47,1361193847217,1361193848113,1615228309,1615229205,896
1361193849,1615230092,4,190,47.5,1361193847600,1361193848560,1615228692,1615229652,960
1361193849,1615230124,4,190,47.5,1361193846351,1361193847119,1615227475,1615228243,768
1361193849,1615230128,4,190,47.5,1361193846414,1361193847374,1615227542,1615228502,960
1361193849,1615230128,3,144,48,1361193846286,1361193846926,1615227414,1615228054,640
1361193849,1615230128,4,190,47.5,1361193846414,1361193847182,1615227542,1615228310,768
1361193849,1615230128,4,190,47.5,1361193846926,1361193847182,1615228054,1615228310,256
1361193849,1615230128,4,190,47.5,1361193846862,1361193847118,1615227990,1615228246,256
1361193849,1615230128,4,190,47.5,1361193847054,1361193847310,1615228182,1615228438,256
1361193849,1615230128,8,374,46.75,1361193847309,1361193848397,1615228437,1615229525,1088
1361193857,1615238084,4,190,47.5,1361193851705,1361193852025,1615232789,1615233109,320
1361193857,1615238084,4,190,47.5,1361193849081,1361193849337,1615230165,1615230421,256
1361193857,1615238084,4,190,47.5,1361193851961,1361193852281,1615233045,1615233365,320
1361193857,1615238084,4,190,47.5,1361193851960,1361193852344,1615233044,1615233428,384
1361193857,1615238084,4,190,47.5,1361193852152,1361193852472,1615233236,1615233556,320
1361193857,1615238084,4,190,47.5,1361193852024,1361193852344,1615233108,1615233428,320
1361193857,1615238084,4,190,47.5,1361193849527,1361193849783,1615230611,1615230867,256
1361193857,1615238088,4,190,47.5,1361193852470,1361193852790,1615233558,1615233878,320
1361193857,1615238088,4,190,47.5,1361193852597,1361193852981,1615233685,1615234069,384
1361193857,1615238088,4,190,47.5,1361193849780,1361193852084,1615230868,1615233172,2304
1361193857,1615238088,4,190,47.5,1361193849907,1361193850419,1615230995,1615231507,512
1361193857,1615238092,4,190,47.5,1361193848817,1361193849073,1615229909,1615230165,256
1361193857,1615238092,4,190,47.5,1361193850672,1361193850800,1615231764,1615231892,128
1361193857,1615238092,4,190,47.5,1361193850736,1361193851184,1615231828,1615232276,448
1361193857,1615238092,4,190,47.5,1361193850864,1361193850992,1615231956,1615232084,128
1361193857,1615238092,4,190,47.5,1361193850992,1361193851056,1615232084,1615232148,64
1361193857,1615238092,4,190,47.5,1361193851119,1361193851183,1615232211,1615232275,64
1361193857,1615238092,4,190,47.5,1361193850927,1361193850991,1615232019,1615232083,64
1361193857,1615238092,4,190,47.5,1361193850991,1361193851119,1615232083,1615232211,128
1361193857,1615238096,4,190,47.5,1361193851246,1361193851630,1615232342,1615232726,384
1361193857,1615238096,4,190,47.5,1361193851310,1361193851694,1615232406,1615232790,384
1361193857,1615238096,4,190,47.5,1361193848941,1361193849197,1615230037,1615230293,256
1361193857,1615238096,5,236,47.2,1361193847468,1361193849772,1615228564,1615230868,2304
1361193857,1615238096,4,190,47.5,1361193847468,1361193850604,1615228564,1615231700,3136
1361193857,1615238096,4,190,47.5,1361193851564,1361193851948,1615232660,1615233044,384
1361193857,1615238096,4,190,47.5,1361193851628,1361193851948,1615232724,1615233044,320
1361193857,1615238096,4,190,47.5,1361193849195,1361193849451,1615230291,1615230547,256
1361193857,1615238100,4,190,47.5,1361193849318,1361193849638,1615230418,1615230738,320
1361193857,1615238100,4,190,47.5,1361193852266,1361193852586,1615233366,1615233686,320
1361193857,1615238100,4,190,47.5,1361193852330,1361193854634,1615233430,1615235734,2304
1361193857,1615238100,4,190,47.5,1361193852329,1361193852713,1615233429,1615233813,384
1361193857,1615238100,4,190,47.5,1361193849641,1361193849897,1615230741,1615230997,256
1361193857,1615238124,4,190,47.5,1361193848657,1361193848913,1615229781,1615230037,256
1361193857,1615238124,4,190,47.5,1361193850001,1361193850449,1615231125,1615231573,448
1361193857,1615238124,4,190,47.5,1361193850383,1361193850831,1615231507,1615231955,448
1361193857,1615238124,4,190,47.5,1361193850511,1361193851023,1615231635,1615232147,512
1361193857,1615238128,4,190,47.5,1361193850766,1361193850830,1615231894,1615231958,64
1361193857,1615238128,4,190,47.5,1361193850766,1361193850894,1615231894,1615232022,128
1361193857,1615238128,4,190,47.5,1361193851022,1361193851086,1615232150,1615232214,64
1361193857,1615238128,4,190,47.5,1361193850957,1361193851085,1615232085,1615232213,128
1361193857,1615238128,4,190,47.5,1361193851212,1361193851532,1615232340,1615232660,320
1361193860,1615240648,35,30784,879.5428571,1361193833836,1361193841132,1615214484,1615221780,7296
1361193864,1615244576,10,7871,787.1,1361193835893,1361193836085,1615216469,1615216661,192
1361193864,1615244628,6,3871,645.1666667,1361193835966,1361193836094,1615216594,1615216722,128
1361193864,1615244628,6,3610,601.6666667,1361193835966,1361193836094,1615216594,1615216722,128
1361193864,1615244628,7,4290,612.8571429,1361193835966,1361193836094,1615216594,1615216722,128
1361193864,1615244640,6,4058,676.3333333,1361193835956,1361193836020,1615216596,1615216660,64
1361193864,1615244640,6,3663,610.5,1361193835956,1361193836084,1615216596,1615216724,128
1361193864,1615244640,35,42381,1210.885714,1361193835956,1361193836404,1615216596,1615217044,448
1361193864,1615244640,6,2467,411.1666667,1361193836020,1361193836084,1615216660,1615216724,64
1361193864,1615244640,6,2467,411.1666667,1361193836019,1361193836147,1615216659,1615216787,128
1361193868,1615248700,2,265,132.5,1361193840824,1361193840888,1615221524,1615221588,64
1361193876,1615256696,1,46,46,1361193850749,1361193850749,1615231445,1615231445,0
1361193881,1615262068,3,144,48,1361193875528,1361193875528,1615256596,1615256596,0
1361193888,1615268712,2,472,236,1361193860268,1361193860332,1615240980,1615241044,64
1361193897,1615278128,4,312,78,1361193895691,1361193895819,1615276819,1615276947,128
1361193901,1615281896,1,48,48,1361193873779,1361193873779,1615254675,1615254675,0
1361193902,1615283136,1,48,48,1361193873541,1361193873541,1615254677,1615254677,0
1361193924,1615304776,2,265,132.5,1361193895979,1361193896107,1615276755,1615276883,128
1361193928,1615308724,2,472,236,1361193900255,1361193900319,1615280979,1615281043,64
1361193953,1615334396,6,1746,291,1361193947582,1361193947774,1615328978,1615329170,192
1361193953,1615334396,4,312,78,1361193947646,1361193947774,1615329042,1615329170,128
1361193953,1615334404,3,144,48,1361193950133,1361193950197,1615331537,1615331601,64
1361193953,1615334408,3,169,56.33333333,1361193951091,1361193951091,1615332499,1615332499,0
1361193953,1615334408,2,123,61.5,1361193951091,1361193951091,1615332499,1615332499,0
1361193953,1615334408,3,169,56.33333333,1361193951091,1361193951091,1615332499,1615332499,0
1361193953,1615334408,3,144,48,1361193947570,1361193952754,1615328978,1615334162,5184
1361193953,1615334440,3,169,56.33333333,1361193951061,1361193951061,1615332501,1615332501,0
1361193953,1615334440,3,169,56.33333333,1361193951061,1361193951061,1615332501,1615332501,0
1361193953,1615334440,3,169,56.33333333,1361193951061,1361193951061,1615332501,1615332501,0
1361193953,1615334440,4,205,51.25,1361193951124,1361193951124,1615332564,1615332564,0
1361193957,253651140,2,98,49,1361193950980,1361193954756,253645120,253648896,3776
1361193957,253651144,2,98,49,1361193951039,1361193955775,253645183,253649919,4736
1361193961,1615342404,9,2578,286.4444444,1361193947446,1361193960246,1615328850,1615341650,12800
1361193961,1615342404,9,2578,286.4444444,1361193947446,1361193959222,1615328850,1615340626,11776
1361193961,1615342404,9,2570,285.5555556,1361193947446,1361193958262,1615328850,1615339666,10816
1361193961,1615342416,19,14362,755.8947368,1361193947177,1361193958249,1615328593,1615339665,11072
1361193961,1615342420,8,5067,633.375,1361193947367,1361193953127,1615328787,1615334547,5760
1361193961,1615342420,10,2689,268.9,1361193947367,1361193958247,1615328787,1615339667,10880
1361193961,1615342420,10,3196,319.6,1361193947431,1361193959207,1615328851,1615340627,11776
1361193961,1615342424,4,205,51.25,1361193956132,1361193956132,1615337556,1615337556,0
1361193964,1615345056,7,2602,371.7142857,1361193939859,1361193948307,1615320915,1615329363,8448
1361193969,1615350424,76,101739,1338.671053,1361193946211,1361193962339,1615327635,1615343763,16128
1361193972,1615353148,5,2421,484.2,1361193946552,1361193946552,1615327700,1615327700,0
1361193976,1615357180,2,265,132.5,1361193950806,1361193950934,1615331986,1615332114,128
1361193976,1615357184,1,46,46,1361193951315,1361193951315,1615332499,1615332499,0
1361193984,1615365064,1,46,46,1361193956937,1361193956937,1615338001,1615338001,0
1361194016,1615397176,2,472,236,1361193988443,1361193988507,1615369619,1615369683,64
1361194032,1615413232,2,265,132.5,1361194005922,1361194005986,1615387154,1615387218,64
1361194034,1615414468,3,144,48,1361194026077,1361194026141,1615406545,1615406609,64
1361194056,1615437180,2,472,236,1361194029398,1361194029462,1615410578,1615410642,64
1361194066,1615446480,4,312,78,1361194064016,1361194064144,1615444496,1615444624,128
1361194066,1615446480,4,312,78,1361194064208,1361194064272,1615444688,1615444752,64
1361194066,1615446520,4,312,78,1361194063915,1361194063979,1615444435,1615444499,64
1361194066,1615446520,4,312,78,1361194064107,1361194064171,1615444627,1615444691,64
1361194066,1615446520,4,312,78,1361194064235,1361194064299,1615444755,1615444819,64
1361194088,1615469236,1,46,46,1361194062299,1361194062299,1615443535,1615443535,0
1361194088,1615469264,3,1076,358.6666667,1361194063105,1361194063169,1615444369,1615444433,64
1361194088,1615469280,2,265,132.5,1361194061106,1361194061234,1615442386,1615442514,128
1361194088,1615469316,22,26028,1183.090909,1361194063179,1361194063371,1615444495,1615444687,192
1361194090,1615470496,3,144,48,1361194086080,1361194086080,1615466576,1615466576,0
1361194096,1615477280,2,472,236,1361194068848,1361194068912,1615450128,1615450192,64
1361194104,1615485236,6,913,152.1666667,1361194076124,1361194076508,1615457360,1615457744,384
1361194137,1615517580,2,472,236,1361194109867,1361194109931,1615490447,1615490511,64
1361194145,1615525532,2,265,132.5,1361194116956,1361194117084,1615497488,1615497616,128
1361194162,1615542516,3,144,48,1361194161067,1361194161067,1615541583,1615541583,0
1361194169,1615549624,5,1679,335.8,1361194141249,1361194141569,1615521873,1615522193,320
1361194177,1615557556,2,472,236,1361194149637,1361194149765,1615530193,1615530321,128
1361194197,1615577676,2,265,132.5,1361194172619,1361194172683,1615553295,1615553359,64
1361194201,1615581620,1,46,46,1361194173379,1361194173379,1615553999,1615553999,0
1361194205,1615585620,1,46,46,1361194179778,1361194179778,1615560398,1615560398,0
1361194205,1615585668,1,46,46,1361194179730,1361194179730,1615560398,1615560398,0
1361194217,1615597632,2,472,236,1361194189750,1361194189814,1615570382,1615570446,64
1361194226,1615606556,3,144,48,1361194220994,1361194221058,1615601550,1615601614,64
1361194253,1615633728,2,265,132.5,1361194228118,1361194228246,1615608846,1615608974,128
1361194257,1615637636,2,472,236,1361194230065,1361194230129,1615610701,1615610765,64
1361194258,1615638632,4,205,51.25,1361194256823,1361194256823,1615637455,1615637455,0
1361194269,253963244,2,98,49,1361194261085,1361194265053,253955329,253959297,3968
1361194269,253963252,2,98,49,1361194261078,1361194266070,253955330,253960322,4992
1361194297,1615678004,2,472,236,1361194270466,1361194270530,1615651470,1615651534,64
1361194306,1615686612,3,144,48,1361194298312,1361194298376,1615678924,1615678988,64
1361194309,1615690096,2,265,132.5,1361194283111,1361194283239,1615664207,1615664335,128
1361194337,1615718084,2,472,236,1361194310259,1361194310323,1615691343,1615691407,64
1361194362,1615742668,3,144,48,1361194355921,1361194355921,1615736589,1615736589,0
1361194365,1615746248,1,46,46,1361194338253,1361194338253,1615719501,1615719501,0
1361194365,1615746252,2,265,132.5,1361194338826,1361194338954,1615720078,1615720206,128
1361194377,1615758260,2,472,236,1361194350079,1361194350143,1615731339,1615731403,64
1361194417,1615798248,2,472,236,1361194390219,1361194390283,1615771467,1615771531,64
1361194421,1615802252,2,265,132.5,1361194394697,1361194394761,1615775949,1615776013,64
1361194434,1615814736,3,144,48,1361194430860,1361194430860,1615811596,1615811596,0
1361194457,1615838416,2,472,236,1361194429668,1361194429732,1615811084,1615811148,64
1361194466,1615846500,11,2296,208.7272727,1361194441784,1361194442232,1615822284,1615822732,448
1361194478,1615858488,2,265,132.5,1361194451140,1361194451268,1615831628,1615831756,128
1361194498,1615878540,2,472,236,1361194470224,1361194470288,1615850764,1615850828,64
1361194498,1615878720,16,7829,489.3125,1361194477723,1361194495067,1615858443,1615875787,17344
1361194498,1615878772,29,33730,1163.103448,1361194480167,1361194495591,1615860939,1615876363,15424
1361194506,1615886524,9,5063,562.5555556,1361194478558,1361194479774,1615859082,1615860298,1216
1361194506,1615886536,2,287,143.5,1361194480338,1361194481106,1615860874,1615861642,768
1361194506,1615886736,3,144,48,1361194505867,1361194505867,1615886603,1615886603,0
1361194538,1615918656,2,472,236,1361194510682,1361194510746,1615891338,1615891402,64
1361194546,1615926812,2,123,61.5,1361194539263,1361194539263,1615920075,1615920075,0
1361194562,1615942648,2,265,132.5,1361194536866,1361194536994,1615917514,1615917642,128
1361194562,1615942768,4,205,51.25,1361194557099,1361194557099,1615937867,1615937867,0
1361194570,1615950804,3,144,48,1361194565767,1361194565767,1615946571,1615946571,0
1361194574,1615954628,1,46,46,1361194547575,1361194547575,1615928203,1615928203,0
1361194574,1615954628,1,46,46,1361194547638,1361194547638,1615928266,1615928266,0
1361194574,1615954700,1,46,46,1361194547564,1361194547564,1615928264,1615928264,0
1361194578,1615958660,2,472,236,1361194550293,1361194550357,1615930953,1615931017,64
1361194581,254275388,2,98,49,1361194570960,1361194574096,254265348,254268484,3136
1361194581,254275396,2,98,49,1361194570954,1361194575114,254265350,254269510,4160
1361194582,1615962720,7,1450,207.1428571,1361194557209,1361194557849,1615937929,1615938569,640
1361194618,1615998936,2,472,236,1361194590017,1361194590081,1615970953,1615971017,64
1361194618,1615998972,2,265,132.5,1361194591708,1361194591772,1615972680,1615972744,64
1361194634,1616014928,4,336,84,1361194633546,1361194633610,1616014474,1616014538,64
1361194642,1616022816,3,144,48,1361194640760,1361194640760,1616021576,1616021576,0
1361194658,1616039036,2,472,236,1361194630429,1361194630557,1616011465,1616011593,128
1361194674,1616054884,4,205,51.25,1361194672565,1361194672565,1616053449,1616053449,0
1361194674,1616055152,2,265,132.5,1361194646952,1361194647080,1616028104,1616028232,128
1361194698,1616079072,2,472,236,1361194670070,1361194670134,1616051142,1616051206,64
1361194722,1616102896,3,144,48,1361194715685,1361194715685,1616096581,1616096581,0
1361194730,1616111092,2,265,132.5,1361194703138,1361194703202,1616084230,1616084294,64
1361194734,1616115140,2,472,236,1361194709684,1361194709748,1616090824,1616090888,64
1361194766,1616147452,9,2029,225.4444444,1361194741435,1361194741883,1616122887,1616123335,448
1361194778,1616159344,2,472,236,1361194750309,1361194750373,1616131653,1616131717,64
1361194786,1616167356,2,265,132.5,1361194758235,1361194758363,1616139591,1616139719,128
1361194794,1616174932,11,953,86.63636364,1361194778881,1361194788801,1616159813,1616169733,9920
1361194794,1616174936,17,6755,397.3529412,1361194778239,1361194788863,1616159175,1616169799,10624
1361194794,1616174948,12,999,83.25,1361194778609,1361194788849,1616159557,1616169797,10240
1361194794,1616174972,3,144,48,1361194790618,1361194790618,1616171590,1616171590,0
1361194818,1616199412,2,472,236,1361194790947,1361194791011,1616172359,1616172423,64
1361194843,1616223492,5,793,158.6,1361194815031,1361194838839,1616195523,1616219331,23808
1361194858,1616238968,3,144,48,1361194850588,1361194850588,1616231556,1616231556,0
1361194858,1616238972,15,7282,485.4666667,1361194835161,1361194852249,1616216133,1616233221,17088
1361194858,1616238980,29,33746,1163.655172,1361194837584,1361194852944,1616218564,1616233924,15360
1361194858,1616239020,4,205,51.25,1361194857897,1361194857897,1616238917,1616238917,0
1361194859,1616239468,2,472,236,1361194831314,1361194831378,1616211782,1616211846,64
1361194863,1616243448,11,4852,441.0909091,1361194836389,1361194837285,1616216837,1616217733,896
1361194866,1616247040,4,292,73,1361194860886,1361194861014,1616241926,1616242054,128
1361194893,254587532,2,98,49,1361194881794,1361194886018,254576326,254580550,4224
1361194893,254587532,2,98,49,1361194881730,1361194884994,254576262,254579526,3264
1361194898,1616279076,2,123,61.5,1361194896624,1361194896624,1616277700,1616277700,0
1361194899,1616279576,6,2176,362.6666667,1361194871908,1361194876004,1616252484,1616256580,4096
1361194919,1616299880,2,265,132.5,1361194894325,1361194894389,1616275205,1616275269,64
1361194930,1616311144,3,144,48,1361194927788,1361194927852,1616308932,1616308996,64
1361194935,1616315832,1,46,46,1361194907492,1361194907492,1616288324,1616288324,0
1361194935,1616315832,1,46,46,1361194907428,1361194907428,1616288260,1616288260,0
1361194935,1616315884,1,46,46,1361194907441,1361194907441,1616288325,1616288325,0
1361194943,1616323896,2,472,236,1361194915490,1361194915554,1616296386,1616296450,64
1361194975,1616355932,2,265,132.5,1361194949886,1361194950014,1616330818,1616330946,128
1361194983,1616363876,2,472,236,1361194955638,1361194955766,1616336514,1616336642,128
1361194986,1616367156,3,144,48,1361194985440,1361194985440,1616366596,1616366596,0
1361195018,1616399152,15,7282,485.4666667,1361194998883,1361195016099,1616380035,1616397251,17216
1361195018,1616399208,29,33730,1163.103448,1361195001195,1361195016491,1616382403,1616397699,15296
1361195023,1616404100,2,472,236,1361194995285,1361194995349,1616376385,1616376449,64
1361195027,1616408136,10,4806,480.6,1361194999476,1361195000564,1616380612,1616381700,1088
1361195027,1616408172,2,287,143.5,1361195001167,1361195001871,1616382339,1616383043,704
1361195059,1616440308,2,472,236,1361195034439,1361195034503,1616415747,1616415811,64
1361195063,1616444304,13,3284,252.6153846,1361195037193,1361195042697,1616418497,1616424001,5504
1361195066,1616447176,15,7282,485.4666667,1361195044682,1361195061258,1616425858,1616442434,16576
1361195066,1616447204,29,33730,1163.103448,1361195046509,1361195061869,1616427713,1616443073,15360
1361195066,1616447212,3,144,48,1361195060325,1361195060389,1616441537,1616441601,64
1361195071,1616452248,1,46,46,1361195044609,1361195044609,1616425857,1616425857,0
1361195071,1616452328,7,631,90.14285714,1361195044979,1361195045555,1616426307,1616426883,576
1361195071,1616452352,1,46,46,1361195046361,1361195046361,1616427713,1616427713,0
1361195071,1616452356,2,287,143.5,1361195046039,1361195046999,1616427395,1616428355,960
1361195099,1616480356,2,472,236,1361195074582,1361195074646,1616455938,1616456002,64
1361195107,1616487460,2,123,61.5,1361195106454,1361195106454,1616486914,1616486914,0
1361195127,1616508424,2,265,132.5,1361195102544,1361195102672,1616483968,1616484096,128
1361195139,1616519536,3,144,48,1361195136072,1361195136072,1616516608,1616516608,0
1361195143,1616524332,2,472,236,1361195115309,1361195115373,1616496641,1616496705,64
1361195147,1616527500,3,144,48,1361195141166,1361195141358,1616521666,1616521858,192
1361195147,1616527504,3,144,48,1361195143208,1361195143336,1616523712,1616523840,128
1361195163,1616543544,4,205,51.25,1361195158274,1361195158274,1616538818,1616538818,0
1361195163,1616543544,4,292,73,1361195161409,1361195161473,1616541953,1616542017,64
1361195175,1616556340,1,46,46,1361195146979,1361195146979,1616528319,1616528319,0
1361195183,1616564376,2,472,236,1361195155841,1361195155905,1616537217,1616537281,64
1361195184,1616564484,2,265,132.5,1361195159162,1361195159290,1616539646,1616539774,128
1361195197,254891592,2,98,49,1361195191175,1361195194503,254885767,254889095,3328
1361195197,254891592,2,98,49,1361195191239,1361195195527,254885831,254890119,4288
1361195219,1616599584,3,144,48,1361195210967,1361195211031,1616591551,1616591615,64
1361195224,1616604672,2,472,236,1361195196289,1361195196353,1616576961,1616577025,64
1361195240,1616620720,4,552,138,1361195214673,1361195224977,1616595393,1616605697,10304
1361195243,1616623636,29,33730,1163.103448,1361195224354,1361195239714,1616604990,1616620350,15360
1361195243,1616623684,15,7282,485.4666667,1361195222069,1361195239093,1616602753,1616619777,17024
1361195248,1616628800,12,5201,433.4166667,1361195222848,1361195223744,1616603648,1616604544,896
1361195264,1616644792,2,472,236,1361195236361,1361195236425,1616617153,1616617217,64
1361195291,1616671704,3,144,48,1361195285855,1361195285919,1616666559,1616666623,64
1361195291,1616671740,2,123,61.5,1361195283577,1361195283577,1616664317,1616664317,0
1361195304,1616684852,2,472,236,1361195276044,1361195276108,1616656896,1616656960,64
1361195308,1616688856,2,265,132.5,1361195279877,1361195280005,1616660733,1616660861,128
1361195344,1616724936,2,472,236,1361195316535,1361195316599,1616697471,1616697535,64
1361195352,1616732972,1,46,46,1361195327378,1361195327378,1616708350,1616708350,0
1361195360,1616740976,2,265,132.5,1361195335823,1361195335951,1616716799,1616716927,128
1361195363,1616743748,3,144,48,1361195360816,1361195360880,1616741564,1616741628,64
1361195368,1616749064,10,1885,188.5,1361195342709,1361195343221,1616723773,1616724285,512
1361195384,1616765160,2,472,236,1361195356308,1361195356372,1616737468,1616737532,64
1361195416,1616797296,2,265,132.5,1361195391502,1361195391630,1616772798,1616772926,128
1361195424,1616805316,2,472,236,1361195396216,1361195396344,1616777532,1616777660,128
1361195428,1616809320,1,46,46,1361195402165,1361195402165,1616783485,1616783485,0
1361195443,1616823772,3,144,48,1361195435800,1361195435800,1616816572,1616816572,0
1361195464,1616845320,2,472,236,1361195436404,1361195436468,1616817724,1616817788,64
1361195467,1616847832,4,205,51.25,1361195459037,1361195459037,1616839869,1616839869,0
1361195472,1616853376,2,265,132.5,1361195447357,1361195447485,1616828733,1616828861,128
1361195499,1616879828,3,144,48,1361195495775,1361195495775,1616876603,1616876603,0
1361195504,1616885368,2,472,236,1361195476421,1361195476485,1616857789,1616857853,64
1361195509,255203620,2,98,49,1361195501230,1361195504750,255195850,255199370,3520
1361195509,255203632,2,98,49,1361195501219,1361195505763,255195851,255200395,4544
1361195529,1616909700,2,265,132.5,1361195503905,1361195503969,1616884605,1616884669,64
1361195545,1616925608,7,1450,207.1428571,1361195518201,1361195518777,1616898809,1616899385,576
1361195545,1616925676,2,472,236,1361195517879,1361195517943,1616898555,1616898619,64
1361195579,1616959884,3,144,48,1361195573029,1361195573093,1616953913,1616953977,64
1361195585,1616965724,2,265,132.5,1361195559751,1361195559879,1616940475,1616940603,128
1361195585,1616965736,2,472,236,1361195557689,1361195557817,1616938425,1616938553,128
1361195625,1617005788,2,472,236,1361195597317,1361195597381,1616978105,1616978169,64
1361195635,1617015916,4,205,51.25,1361195633543,1361195633543,1617014459,1617014459,0
1361195635,1617015956,3,144,48,1361195630622,1361195630686,1617011578,1617011642,64
1361195641,1617021812,2,265,132.5,1361195615339,1361195615403,1616996151,1616996215,64
1361195643,1617023908,8,1505,188.125,1361195636492,1361195642508,1617017400,1617023416,6016
1361195643,1617023944,13,5365,412.6923077,1361195636202,1361195641514,1617017146,1617022458,5312
1361195643,1617023948,7,1406,200.8571429,1361195636455,1361195642471,1617017403,1617023419,6016
1361195645,255339652,7,1459,208.4285714,1361195635793,1361195641105,255330445,255335757,5312
1361195645,255339660,7,1459,208.4285714,1361195635784,1361195641096,255330444,255335756,5312
1361195645,255339660,7,2400,342.8571429,1361195635784,1361195641096,255330444,255335756,5312
1361195659,1617039936,4,190,47.5,1361195656879,1361195657199,1617037815,1617038135,320
1361195659,1617039936,4,190,47.5,1361195656943,1361195657199,1617037879,1617038135,256
1361195659,1617039936,4,190,47.5,1361195657200,1361195657456,1617038136,1617038392,256
1361195659,1617039940,4,190,47.5,1361195657390,1361195657710,1617038330,1617038650,320
1361195659,1617039940,4,190,47.5,1361195657708,1361195657964,1617038648,1617038904,256
1361195659,1617039944,4,190,47.5,1361195655208,1361195656168,1617036152,1617037112,960
1361195659,1617039948,4,190,47.5,1361195655718,1361195655974,1617036666,1617036922,256
1361195659,1617039948,4,190,47.5,1361195655846,1361195656102,1617036794,1617037050,256
1361195659,1617039948,4,190,47.5,1361195655973,1361195656229,1617036921,1617037177,256
1361195659,1617039948,4,190,47.5,1361195656229,1361195656485,1617037177,1617037433,256
1361195659,1617039948,4,190,47.5,1361195656357,1361195656613,1617037305,1617037561,256
1361195659,1617039948,4,190,47.5,1361195656548,1361195658852,1617037496,1617039800,2304
1361195659,1617039948,4,190,47.5,1361195656612,1361195656868,1617037560,1617037816,256
1361195659,1617039972,4,190,47.5,1361195657164,1361195657420,1617038136,1617038392,256
1361195659,1617039976,4,190,47.5,1361195657419,1361195657675,1617038395,1617038651,256
1361195659,1617039976,4,190,47.5,1361195657418,1361195657674,1617038394,1617038650,256
1361195659,1617039980,4,190,47.5,1361195657927,1361195658183,1617038907,1617039163,256
1361195659,1617039980,4,190,47.5,1361195658308,1361195658820,1617039288,1617039800,512
1361195659,1617039984,4,190,47.5,1361195655106,1361195655810,1617036090,1617036794,704
1361195659,1617039984,4,190,47.5,1361195655170,1361195656002,1617036154,1617036986,832
1361195659,1617039984,4,190,47.5,1361195655808,1361195656576,1617036792,1617037560,768
1361195659,1617039988,4,190,47.5,1361195656062,1361195656318,1617037050,1617037306,256
1361195659,1617039988,4,190,47.5,1361195656317,1361195656637,1617037305,1617037625,320
1361195659,1617039988,4,190,47.5,1361195656637,1361195656893,1617037625,1617037881,256
1361195661,1617041740,33,32148,974.1818182,1361195633718,1361195643958,1617014458,1617024698,10240
1361195661,1617041776,7,4450,635.7142857,1361195636623,1361195636751,1617017399,1617017527,128
1361195661,1617041780,6,4143,690.5,1361195636621,1361195636749,1617017401,1617017529,128
1361195661,1617041828,15,12653,843.5333333,1361195636638,1361195636766,1617017466,1617017594,128
1361195661,1617041828,7,4498,642.5714286,1361195636571,1361195636699,1617017399,1617017527,128
1361195661,1617041828,7,4354,622,1361195636571,1361195636699,1617017399,1617017527,128
1361195664,255358092,6,3578,596.3333333,1361195636353,1361195636737,255330445,255330829,384
1361195664,255358092,7,4450,635.7142857,1361195636353,1361195636737,255330445,255330829,384
1361195664,255358124,8,5360,670,1361195636319,1361195636767,255330443,255330891,448
1361195664,255358124,7,4770,681.4285714,1361195636319,1361195636703,255330443,255330827,384
1361195664,255358124,7,4626,660.8571429,1361195636319,1361195636703,255330443,255330827,384
1361195664,255358124,6,3802,633.6666667,1361195636319,1361195636703,255330443,255330827,384
1361195665,1617045780,3,524,174.6666667,1361195636939,1361195637771,1617017719,1617018551,832
1361195667,1617047936,4,190,47.5,1361195660848,1361195661168,1617041784,1617042104,320
1361195667,1617047936,4,190,47.5,1361195658992,1361195659440,1617039928,1617040376,448
1361195667,1617047936,4,190,47.5,1361195660911,1361195661295,1617041847,1617042231,384
1361195667,1617047940,4,190,47.5,1361195661165,1361195661549,1617042105,1617042489,384
1361195667,1617047940,4,190,47.5,1361195659371,1361195659883,1617040311,1617040823,512
1361195667,1617047944,4,190,47.5,1361195657705,1361195660009,1617038649,1617040953,2304
1361195667,1617047944,4,190,47.5,1361195659753,1361195659817,1617040697,1617040761,64
1361195667,1617047944,4,190,47.5,1361195659625,1361195659753,1617040569,1617040697,128
1361195667,1617047944,4,190,47.5,1361195659753,1361195659817,1617040697,1617040761,64
1361195667,1617047944,4,190,47.5,1361195659816,1361195659944,1617040760,1617040888,128
1361195667,1617047948,4,190,47.5,1361195659942,1361195660006,1617040890,1617040954,64
1361195667,1617047948,4,190,47.5,1361195659942,1361195660006,1617040890,1617040954,64
1361195667,1617047948,4,190,47.5,1361195660006,1361195660134,1617040954,1617041082,128
1361195667,1617047948,4,190,47.5,1361195660134,1361195660518,1617041082,1617041466,384
1361195667,1617047948,4,190,47.5,1361195660261,1361195660581,1617041209,1617041529,320
1361195667,1617047948,4,190,47.5,1361195660515,1361195660835,1617041463,1617041783,320
1361195667,1617047956,4,190,47.5,1361195658846,1361195659294,1617039802,1617040250,448
1361195667,1617047976,4,190,47.5,1361195660809,1361195661129,1617041785,1617042105,320
1361195667,1617047976,4,190,47.5,1361195660809,1361195663177,1617041785,1617044153,2368
1361195667,1617047976,4,190,47.5,1361195661191,1361195661511,1617042167,1617042487,320
1361195667,1617047980,4,190,47.5,1361195661254,1361195661574,1617042234,1617042554,320
1361195667,1617047980,4,190,47.5,1361195659396,1361195659908,1617040376,1617040888,512
1361195667,1617047980,4,190,47.5,1361195657667,1361195659971,1617038647,1617040951,2304
1361195667,1617047984,4,190,47.5,1361195659906,1361195659970,1617040890,1617040954,64
1361195667,1617047984,4,190,47.5,1361195659906,1361195659970,1617040890,1617040954,64
1361195667,1617047984,4,190,47.5,1361195659777,1361195659905,1617040761,1617040889,128
1361195667,1617047984,4,190,47.5,1361195660096,1361195660480,1617041080,1617041464,384
1361195667,1617047984,4,190,47.5,1361195660095,1361195660479,1617041079,1617041463,384
1361195667,1617047988,4,190,47.5,1361195660542,1361195660862,1617041530,1617041850,320
1361195667,1617047988,4,190,47.5,1361195660477,1361195660797,1617041465,1617041785,320
1361195667,1617047988,4,190,47.5,1361195660477,1361195660797,1617041465,1617041785,320
1361195676,255370264,1,46,46,1361195651603,1361195651603,255345867,255345867,0
1361195677,1617057768,1,46,46,1361195649114,1361195649114,1617029882,1617029882,0
1361195681,1617061788,2,98,49,1361195655237,1361195661445,1617036025,1617042233,6208
1361195683,1617063936,29,33730,1163.103448,1361195661103,1361195676463,1617042039,1617057399,15360
1361195683,1617063948,16,7829,489.3125,1361195658723,1361195675939,1617039671,1617056887,17216
1361195685,1617066060,10,5109,510.9,1361195659251,1361195660531,1617040311,1617041591,1280
1361195685,1617066104,2,287,143.5,1361195660872,1361195661640,1617041976,1617042744,768
1361195705,1617086100,2,472,236,1361195676942,1361195677006,1617058042,1617058106,64
1361195707,1617087980,3,144,48,1361195705602,1361195705602,1617086582,1617086582,0
1361195723,1617103984,2,123,61.5,1361195720384,1361195720384,1617101368,1617101368,0
1361195741,1617122152,2,265,132.5,1361195716887,1361195716951,1617098039,1617098103,64
1361195741,1617122156,2,472,236,1361195716882,1361195716946,1617098038,1617098102,64
1361195755,1617135968,3,169,56.33333333,1361195752464,1361195752464,1617133432,1617133432,0
1361195755,1617135968,3,169,56.33333333,1361195752464,1361195752464,1617133432,1617133432,0
1361195755,1617135968,3,169,56.33333333,1361195752463,1361195752463,1617133431,1617133431,0
1361195755,1617136008,3,169,56.33333333,1361195752425,1361195752425,1617133433,1617133433,0
1361195755,1617136008,4,205,51.25,1361195752425,1361195752425,1617133433,1617133433,0
1361195757,1617138176,3,144,48,1361195732160,1361195741184,1617113336,1617122360,9024
1361195757,255451644,4,215,53.75,1361195752153,1361195752153,255446797,255446797,0
1361195757,255451644,3,169,56.33333333,1361195752153,1361195752153,255446797,255446797,0
1361195757,255451644,3,169,56.33333333,1361195752153,1361195752153,255446797,255446797,0
1361195757,255451644,3,169,56.33333333,1361195752153,1361195752153,255446797,255446797,0
1361195757,255451648,3,169,56.33333333,1361195752147,1361195752147,255446795,255446795,0
1361195757,255451648,3,169,56.33333333,1361195752147,1361195752147,255446795,255446795,0
1361195763,1617143992,4,205,51.25,1361195759478,1361195759478,1617140470,1617140470,0
1361195773,1617154128,1,46,46,1361195747309,1361195747309,1617128437,1617128437,0
1361195781,1617162180,2,472,236,1361195756602,1361195756666,1617137782,1617137846,64
1361195785,1617166184,1,46,46,1361195759093,1361195759093,1617140277,1617140277,0
1361195787,1617168020,3,144,48,1361195780571,1361195780571,1617161591,1617161591,0
1361195795,1617176012,4,312,78,1361195788833,1361195788897,1617169845,1617169909,64
1361195795,1617176052,4,312,78,1361195788602,1361195788730,1617169654,1617169782,128
1361195795,1617176052,4,312,78,1361195788730,1361195788794,1617169782,1617169846,64
1361195795,1617176052,4,312,78,1361195788730,1361195788858,1617169782,1617169910,128
1361195797,1617178236,2,265,132.5,1361195772417,1361195772545,1617153653,1617153781,128
1361195811,1617192028,4,336,84,1361195810577,1361195810641,1617191605,1617191669,64
1361195813,1617194216,3,1079,359.6666667,1361195788247,1361195788311,1617169463,1617169527,64
1361195813,1617194260,26,30933,1189.730769,1361195788332,1361195788588,1617169592,1617169848,256
1361195821,255515668,2,98,49,1361195812863,1361195816703,255507531,255511371,3840
1361195821,255515668,2,98,49,1361195812863,1361195817727,255507531,255512395,4864
1361195825,1617206184,2,472,236,1361195797368,1361195797432,1617178552,1617178616,64
1361195851,1617232060,11,5602,509.2727273,1361195828209,1361195843505,1617209269,1617224565,15296
1361195853,1617234216,2,265,132.5,1361195828055,1361195828119,1617209271,1617209335,64
1361195859,1617240004,3,144,48,1361195855594,1361195855594,1617236598,1617236598,0
1361195861,1617242276,2,472,236,1361195836828,1361195836892,1617218104,1617218168,64
1361195905,1617286284,2,472,236,1361195877327,1361195877391,1617258611,1617258675,64
1361195909,1617290292,2,265,132.5,1361195883403,1361195883467,1617264695,1617264759,64
1361195929,1617310264,1,46,46,1361195904230,1361195904230,1617285494,1617285494,0
1361195929,1617310264,1,46,46,1361195904230,1361195904230,1617285494,1617285494,0
1361195931,1617312040,3,144,48,1361195930500,1361195930564,1617311540,1617311604,64
1361195945,1617326308,2,472,236,1361195918330,1361195918394,1617299638,1617299702,64
1361195965,1617346372,2,265,132.5,1361195938551,1361195938679,1617319923,1617320051,128
1361195969,1617350376,10,2110,211,1361195943414,1361195943926,1617324790,1617325302,512
1361195985,1617366316,2,472,236,1361195958703,1361195958767,1617340019,1617340083,64
1361196011,1617392128,3,144,48,1361196005545,1361196005545,1617386673,1617386673,0
1361196021,1617402348,2,265,132.5,1361195994127,1361195994255,1617375475,1617375603,128
1361196025,1617406336,3,1120,373.3333333,1361195997850,1361195998362,1617379186,1617379698,512
1361196025,1617406344,2,472,236,1361195999250,1361195999314,1617380594,1617380658,64
1361196065,1617446412,2,472,236,1361196038413,1361196038477,1617419825,1617419889,64
1361196077,1617458368,2,265,132.5,1361196050105,1361196050169,1617431473,1617431537,64
1361196083,1617464164,3,144,48,1361196080456,1361196080456,1617461620,1617461620,0
1361196105,1617486384,2,472,236,1361196078760,1361196078824,1617460144,1617460208,64
1361196123,1617504168,3,159,53,1361196115843,1361196115843,1617497011,1617497011,0
1361196134,1617514444,2,265,132.5,1361196106581,1361196106709,1617487025,1617487153,128
1361196134,255827824,2,98,49,1361196123725,1361196127821,255817549,255821645,4096
1361196134,255827832,3,144,48,1361196123717,1361196126853,255817549,255820685,3136
1361196145,1617526404,2,472,236,1361196118679,1361196118743,1617500083,1617500147,64
1361196147,1617528152,3,144,48,1361196140434,1361196140434,1617521586,1617521586,0
1361196185,1617566424,2,472,236,1361196159167,1361196159231,1617540591,1617540655,64
1361196190,1617570464,2,265,132.5,1361196162241,1361196162369,1617542705,1617542833,128
1361196219,1617600236,3,144,48,1361196217725,1361196217789,1617598961,1617599025,64
1361196226,1617606472,2,472,236,1361196201017,1361196201081,1617581489,1617581553,64
1361196242,1617622480,2,265,132.5,1361196217326,1361196217454,1617597806,1617597934,128
1361196266,1617646552,2,472,236,1361196240937,1361196241001,1617621489,1617621553,64
1361196270,1617650528,11,2213,201.1818182,1361196244799,1361196245311,1617625327,1617625839,512
1361196291,1617672244,3,144,48,1361196290357,1361196290357,1617671601,1617671601,0
1361196298,1617678536,2,265,132.5,1361196273014,1361196273142,1617653550,1617653678,128
1361196306,1617686576,2,472,236,1361196280782,1361196280846,1617661358,1617661422,64
1361196346,1617726636,2,472,236,1361196320594,1361196320658,1617701230,1617701294,64
1361196354,1617734636,4,552,138,1361196328787,1361196339603,1617709423,1617720239,10816
1361196355,1617736268,29,33730,1163.103448,1361196338203,1361196353627,1617719471,1617734895,15424
1361196355,1617736316,16,7829,489.3125,1361196336169,1361196353001,1617717485,1617734317,16832
1361196362,1617742652,11,5155,468.6363636,1361196337409,1361196338369,1617718061,1617719021,960
1361196363,1617744360,4,205,51.25,1361196360061,1361196360061,1617741421,1617741421,0
1361196371,1617752320,3,144,48,1361196365224,1361196365288,1617746544,1617746608,64
1361196386,1617766632,2,472,236,1361196360789,1361196360853,1617741421,1617741485,64
1361196403,1617784344,2,123,61.5,1361196397453,1361196397453,1617778797,1617778797,0
1361196422,1617802676,4,552,138,1361196395367,1361196421031,1617776043,1617801707,25664
1361196426,1617806748,2,472,236,1361196400993,1361196401057,1617781741,1617781805,64
1361196434,1617814728,1,46,46,1361196407923,1361196407923,1617788651,1617788651,0
1361196434,1617814728,1,46,46,1361196407923,1361196407923,1617788651,1617788651,0
1361196434,1617814772,1,46,46,1361196407815,1361196407815,1617788587,1617788587,0
1361196435,1617816372,16,7829,489.3125,1361196416627,1361196434419,1617797999,1617815791,17792
1361196438,256131912,2,98,49,1361196433784,1361196437688,256127696,256131600,3904
1361196443,1617824376,29,33730,1163.103448,1361196419630,1361196434990,1617801006,1617816366,15360
1361196444,1617824496,3,144,48,1361196441051,1361196441115,1617821547,1617821611,64
1361196446,256139920,2,98,49,1361196433839,1361196438639,256127759,256132559,4800
1361196446,1617826764,12,5207,433.9166667,1361196418769,1361196419793,1617799533,1617800557,1024
1361196466,1617846852,2,472,236,1361196441463,1361196441527,1617822315,1617822379,64
1361196483,1617864400,30,33776,1125.866667,1361196465621,1361196481109,1617847021,1617862509,15488
1361196483,1617864436,15,7282,485.4666667,1361196463727,1361196480303,1617845163,1617861739,16576
1361196490,1617870804,1,46,46,1361196464358,1361196464358,1617845162,1617845162,0
1361196490,1617870808,8,677,84.625,1361196464741,1361196465317,1617845549,1617846125,576
1361196494,1617874796,2,287,143.5,1361196465905,1361196467057,1617846701,1617847853,1152
1361196494,1617874800,1,46,46,1361196466222,1361196466222,1617847022,1617847022,0
1361196506,1617886848,7,1450,207.1428571,1361196478653,1361196479229,1617859501,1617860077,576
1361196506,1617886856,2,472,236,1361196480948,1361196481012,1617861804,1617861868,64
1361196523,1617904428,3,144,48,1361196515128,1361196515192,1617896556,1617896620,64
1361196531,1617912416,3,169,56.33333333,1361196524676,1361196527236,1617906092,1617908652,2560
1361196546,1617927016,2,472,236,1361196520978,1361196521106,1617901994,1617902122,128
1361196550,1617930988,2,265,132.5,1361196522287,1361196522415,1617903275,1617903403,128
1361196554,1617935032,1,46,46,1361196527617,1361196527617,1617908649,1617908649,0
1361196554,1617935032,1,46,46,1361196527617,1361196527617,1617908649,1617908649,0
1361196570,1617951032,6,2069,344.8333333,1361196544900,1361196545604,1617925932,1617926636,704
1361196586,1617967032,2,472,236,1361196561154,1361196561282,1617942186,1617942314,128
1361196596,1617976456,3,144,48,1361196591105,1361196591169,1617971561,1617971625,64
1361196606,1617987052,2,265,132.5,1361196578351,1361196578415,1617959403,1617959467,64
1361196620,1618000476,15,7288,485.8666667,1361196595502,1361196612654,1617975978,1617993130,17152
1361196622,1618003092,12,5201,433.4166667,1361196595400,1361196596680,1617976492,1617977772,1280
1361196626,1618007096,2,472,236,1361196600834,1361196600898,1617981930,1617981994,64
1361196652,1618032528,29,33730,1163.103448,1361196635064,1361196650488,1618015592,1618031016,15424
1361196660,1618040504,2,123,61.5,1361196657040,1361196657040,1618037544,1618037544,0
1361196662,1618043156,4,552,138,1361196634245,1361196635205,1618015401,1618016361,960
1361196666,1618047192,2,472,236,1361196640802,1361196640866,1618021994,1618022058,64
1361196668,1618048492,4,205,51.25,1361196661084,1361196661084,1618041576,1618041576,0
1361196668,1618048540,3,144,48,1361196666028,1361196666028,1618046568,1618046568,0
1361196707,1618087556,2,472,236,1361196681822,1361196681886,1618062378,1618062442,64
1361196719,1618099560,2,265,132.5,1361196690967,1361196691031,1618071527,1618071591,64
1361196732,1618112496,3,144,48,1361196726105,1361196726105,1618106601,1618106601,0
1361196735,1618115544,1,46,46,1361196708137,1361196708137,1618088681,1618088681,0
1361196735,1618115584,1,46,46,1361196708094,1361196708094,1618088678,1618088678,0
1361196747,1618127652,2,472,236,1361196721662,1361196721726,1618102314,1618102378,64
1361196748,1618128572,4,336,84,1361196742666,1361196742794,1618123238,1618123366,128
1361196750,256443988,2,98,49,1361196743853,1361196747437,256437841,256441425,3584
1361196750,256443996,2,98,49,1361196743845,1361196748453,256437841,256442449,4608
1361196771,1618151596,2,265,132.5,1361196746356,1361196746484,1618126952,1618127080,128
1361196787,1618167640,2,472,236,1361196761992,1361196762056,1618142632,1618142696,64
1361196804,1618184556,3,144,48,1361196801050,1361196801050,1618181606,1618181606,0
1361196827,1618207676,4,552,138,1361196802148,1361196808996,1618182824,1618189672,6848
1361196827,1618207680,2,472,236,1361196802783,1361196802911,1618183463,1618183591,128
1361196828,1618208612,29,33730,1163.103448,1361196808354,1361196823714,1618188966,1618204326,15360
1361196828,1618208616,16,7829,489.3125,1361196805793,1361196823137,1618186409,1618203753,17344
1361196831,1618211716,12,5201,433.4166667,1361196806266,1361196807866,1618186982,1618188582,1600
1361196839,1618219744,9,861,95.66666667,1361196814685,1361196814877,1618195429,1618195621,192
1361196843,1618223916,9,861,95.66666667,1361196814771,1361196814963,1618195687,1618195879,192
1361196843,1618223920,8,815,101.875,1361196815406,1361196815534,1618196326,1618196454,128
1361196843,1618224000,8,815,101.875,1361196815006,1361196815198,1618196006,1618196198,192
1361196867,1618247900,2,472,236,1361196842180,1361196842244,1618223080,1618223144,64
1361196871,1618251964,9,1832,203.5555556,1361196845444,1361196845956,1618226408,1618226920,512
1361196876,1618256564,15,7282,485.4666667,1361196851921,1361196868305,1618232485,1618248869,16384
1361196879,1618259880,6,579,96.5,1361196852055,1361196852375,1618232935,1618233255,320
1361196879,1618259924,1,46,46,1361196851561,1361196851561,1618232485,1618232485,0
1361196884,1618264576,3,144,48,1361196878405,1361196878405,1618258981,1618258981,0
1361196884,1618264608,29,33724,1162.896552,1361196864485,1361196879845,1618245093,1618260453,15360
1361196891,1618271952,4,552,138,1361196863951,1361196864719,1618244903,1618245671,768
1361196891,1618271952,1,46,46,1361196864141,1361196864141,1618245093,1618245093,0
1361196907,1618287984,2,472,236,1361196882604,1361196882668,1618263588,1618263652,64
1361196911,1618291928,1,46,46,1361196886244,1361196886244,1618267172,1618267172,0
1361196916,1618296616,2,123,61.5,1361196912607,1361196912607,1618293223,1618293223,0
1361196947,1618327976,2,265,132.5,1361196919798,1361196919862,1618300774,1618300838,64
1361196951,1618331944,2,472,236,1361196923155,1361196923219,1618304099,1618304163,64
1361196956,1618336608,3,144,48,1361196950949,1361196951013,1618331557,1618331621,64
1361196975,1618356016,1,46,46,1361196947660,1361196947660,1618328676,1618328676,0
1361196987,1618367980,2,583,291.5,1361196958960,1361196959152,1618339940,1618340132,192
1361196988,1618368632,17,8013,471.3529412,1361196969422,1361196986830,1618350054,1618367462,17408
1361196991,1618372028,2,472,236,1361196963713,1361196963777,1618344741,1618344805,64
1361196995,1618376016,19,5523,290.6842105,1361196969547,1361196970955,1618350563,1618351971,1408
1361196996,1618376636,29,33730,1163.103448,1361196976200,1361196991816,1618356836,1618372452,15616
1361197003,1618384068,4,552,138,1361196975577,1361196976729,1618356645,1618357797,1152
1361197028,1618408684,3,144,48,1361197025880,1361197025880,1618406564,1618406564,0
1361197031,1618412052,2,472,236,1361197003942,1361197004006,1618384994,1618385058,64
1361197044,1618424664,2,126,63,1361197042477,1361197043501,1618423141,1618424165,1024
1361197052,1618432692,20,8106,405.3,1361197028497,1361197048913,1618409189,1618429605,20416
1361197052,1618432692,2,126,63,1361197045519,1361197049551,1618426211,1618430243,4032
1361197052,1618432700,34,34078,1002.294118,1361197029961,1361197049673,1618410661,1618430373,19712
1361197055,1618436092,1,46,46,1361197028097,1361197028097,1618409189,1618409189,0
1361197055,1618436092,8,677,84.625,1361197028479,1361197028927,1618409571,1618410019,448
1361197055,1618436100,2,287,143.5,1361197029497,1361197030073,1618410597,1618411173,576
1361197055,1618436168,1,46,46,1361197029493,1361197029493,1618410661,1618410661,0
1361197062,256756076,3,144,48,1361197054744,1361197059352,256748820,256753428,4608
1361197062,256756084,2,98,49,1361197054736,1361197058384,256748820,256752468,3648
1361197071,1618452124,6,2176,362.6666667,1361197043999,1361197048287,1618425123,1618429411,4288
1361197076,1618456688,3,189,63,1361197070034,1361197073042,1618450722,1618453730,3008
1361197076,1618456716,4,205,51.25,1361197074805,1361197074805,1618455521,1618455521,0
1361197083,1618464128,1,63,63,1361197057114,1361197057114,1618438242,1618438242,0
1361197092,1618472676,2,126,63,1361197077086,1361197085150,1618457762,1618465826,8064
1361197092,1618472688,2,126,63,1361197090452,1361197091476,1618471140,1618472164,1024
1361197092,1618472724,2,126,63,1361197090416,1361197091376,1618471140,1618472100,960
1361197100,1618480744,2,126,63,1361197093404,1361197097436,1618474148,1618478180,4032
1361197100,1618480744,2,126,63,1361197093404,1361197097436,1618474148,1618478180,4032
1361197108,1618488732,15,7288,485.8666667,1361197088037,1361197105125,1618468769,1618485857,17088
1361197108,1618488736,3,144,48,1361197100835,1361197100835,1618481571,1618481571,0
1361197111,1618492148,2,265,132.5,1361197085831,1361197085959,1618466979,1618467107,128
1361197115,1618496140,1,46,46,1361197087632,1361197087632,1618468772,1618468772,0
1361197115,1618496140,2,472,236,1361197087759,1361197087823,1618468899,1618468963,64
1361197115,1618496184,8,677,84.625,1361197088033,1361197089121,1618469217,1618470305,1088
1361197131,1618512156,1,63,63,1361197105084,1361197105084,1618486240,1618486240,0
1361197131,1618512304,1,63,63,1361197104937,1361197104937,1618486241,1618486241,0
1361197155,1618536168,2,472,236,1361197128242,1361197128306,1618509410,1618509474,64
1361197155,1618536204,1,46,46,1361197127567,1361197127567,1618508771,1618508771,0
1361197156,1618536852,16,6372,398.25,1361197143407,1361197153711,1618524259,1618534563,10304
1361197156,1618536852,12,999,83.25,1361197143853,1361197153709,1618524705,1618534561,9856
1361197156,1618536860,2,123,61.5,1361197149477,1361197149477,1618530337,1618530337,0
1361197164,1618544796,29,33730,1163.103448,1361197142310,1361197157606,1618523106,1618538402,15296
1361197167,1618548232,4,552,138,1361197141680,1361197142576,1618522912,1618523808,896
1361197171,1618552188,10,1905,190.5,1361197145822,1361197146270,1618527010,1618527458,448
1361197180,1618560808,3,144,48,1361197175769,1361197175769,1618556577,1618556577,0
1361197195,1618576236,2,472,236,1361197167916,1361197167980,1618549152,1618549216,64
1361197215,1618596284,1,46,46,1361197187453,1361197187453,1618568737,1618568737,0
1361197223,1618604248,2,265,132.5,1361197197599,1361197197727,1618578847,1618578975,128
1361197235,1618616280,2,472,236,1361197207487,1361197207551,1618588767,1618588831,64
1361197236,1618616856,3,144,48,1361197235688,1361197235752,1618616544,1618616608,64
1361197247,1618628392,14,7706,550.4285714,1361197221457,1361197234385,1618602849,1618615777,12928
1361197252,1618632848,2,123,61.5,1361197249710,1361197249710,1618630558,1618630558,0
1361197252,1618632872,29,33730,1163.103448,1361197234777,1361197250201,1618615649,1618631073,15424
1361197259,1618640392,11,4852,441.0909091,1361197232142,1361197233678,1618613534,1618615070,1536
1361197259,1618640432,2,287,143.5,1361197234153,1361197234985,1618615585,1618616417,832
1361197268,1618648904,4,205,51.25,1361197262138,1361197262138,1618643042,1618643042,0
1361197275,1618656360,2,472,236,1361197248048,1361197248112,1618629408,1618629472,64
1361197300,1618680880,2,123,61.5,1361197294225,1361197294225,1618675105,1618675105,0
1361197315,1618696452,2,472,236,1361197287636,1361197287700,1618669088,1618669152,64
1361197315,1618696484,2,265,132.5,1361197290035,1361197290163,1618671519,1618671647,128
1361197316,1618696960,3,144,48,1361197310590,1361197310654,1618691550,1618691614,64
1361197336,1618716464,1,46,46,1361197308334,1361197308334,1618688798,1618688798,0
1361197336,1618716464,1,46,46,1361197308334,1361197308334,1618688798,1618688798,0
1361197336,1618716464,1,46,46,1361197308334,1361197308334,1618688798,1618688798,0
1361197356,1618736596,2,472,236,1361197328554,1361197328618,1618709150,1618709214,64
1361197372,1618752612,2,265,132.5,1361197346202,1361197346330,1618726814,1618726942,128
1361197374,257068168,2,98,49,1361197364670,1361197368638,257058838,257062806,3968
1361197374,257068176,2,98,49,1361197364661,1361197369653,257058837,257063829,4992
1361197388,1618768920,3,144,48,1361197385638,1361197385702,1618766558,1618766622,64
1361197396,1618776616,2,472,236,1361197368918,1361197368982,1618749534,1618749598,64
1361197428,1618808660,2,265,132.5,1361197401451,1361197401579,1618782111,1618782239,128
1361197428,1618808996,4,891,222.75,1361197421531,1361197421595,1618802527,1618802591,64
1361197436,1618816676,2,472,236,1361197408411,1361197408475,1618789087,1618789151,64
1361197436,1618816932,4,292,73,1361197431899,1361197432027,1618812831,1618812959,128
1361197436,1618816936,4,471,117.75,1361197432470,1361197432534,1618813406,1618813470,64
1361197436,1618816940,4,292,73,1361197433105,1361197433169,1618814045,1618814109,64
1361197436,1618816940,4,394,98.5,1361197433232,1361197433296,1618814172,1618814236,64
1361197436,1618816944,4,292,73,1361197433359,1361197433423,1618814303,1618814367,64
1361197436,1618816944,4,441,110.25,1361197433486,1361197433550,1618814430,1618814494,64
1361197436,1618816972,4,480,120,1361197434480,1361197434608,1618815452,1618815580,128
1361197436,1618816976,4,480,120,1361197434603,1361197434667,1618815579,1618815643,64
1361197436,1618816976,4,488,122,1361197434671,1361197434799,1618815647,1618815775,128
1361197436,1618816976,4,292,73,1361197431725,1361197431853,1618812701,1618812829,128
1361197436,1618816980,4,292,73,1361197432297,1361197432361,1618813277,1618813341,64
1361197436,1618816980,4,477,119.25,1361197432552,1361197432680,1618813532,1618813660,128
1361197436,1618816980,4,292,73,1361197432488,1361197432552,1618813468,1618813532,64
1361197436,1618816984,4,472,118,1361197432678,1361197432806,1618813662,1618813790,128
1361197436,1618817008,4,425,106.25,1361197433485,1361197433613,1618814493,1618814621,128
1361197436,1618817012,4,456,114,1361197433611,1361197433739,1618814623,1618814751,128
1361197436,1618817012,4,292,73,1361197433674,1361197433738,1618814686,1618814750,64
1361197436,1618817012,4,453,113.25,1361197433802,1361197433866,1618814814,1618814878,64
1361197436,1618817012,5,236,47.2,1361197434056,1361197434440,1618815068,1618815452,384
1361197436,1618817016,4,292,73,1361197431111,1361197431175,1618812127,1618812191,64
1361197436,1618817016,4,292,73,1361197431366,1361197431430,1618812382,1618812446,64
1361197436,1618817016,4,488,122,1361197433926,1361197434054,1618814942,1618815070,128
1361197436,1618817016,4,292,73,1361197431493,1361197431621,1618812509,1618812637,128
1361197444,1618824944,4,442,110.5,1361197439823,1361197439887,1618820767,1618820831,64
1361197444,1618824944,4,463,115.75,1361197439886,1361197440014,1618820830,1618820958,128
1361197444,1618824944,4,443,110.75,1361197440014,1361197440078,1618820958,1618821022,64
1361197444,1618824944,4,292,73,1361197436429,1361197436493,1618817373,1618817437,64
1361197444,1618824948,4,292,73,1361197440776,1361197440840,1618821724,1618821788,64
1361197444,1618824948,4,728,182,1361197440968,1361197441032,1618821916,1618821980,64
1361197444,1618824948,4,292,73,1361197441032,1361197441096,1618821980,1618822044,64
1361197444,1618824948,4,476,119,1361197440839,1361197440967,1618821787,1618821915,128
1361197444,1618824948,4,292,73,1361197437575,1361197437639,1618818523,1618818587,64
1361197444,1618824952,4,292,73,1361197437894,1361197438022,1618818846,1618818974,128
1361197444,1618824952,4,461,115.25,1361197441605,1361197441669,1618822557,1618822621,64
1361197444,1618824956,4,292,73,1361197438914,1361197438978,1618819870,1618819934,64
1361197444,1618824956,4,414,103.5,1361197442050,1361197442178,1618823006,1618823134,128
1361197444,1618824956,4,464,116,1361197438977,1361197439105,1618819933,1618820061,128
1361197444,1618824956,4,292,73,1361197439168,1361197439296,1618820124,1618820252,128
1361197444,1618824984,4,461,115.25,1361197442660,1361197442788,1618823644,1618823772,128
1361197444,1618824984,4,292,73,1361197442852,1361197442980,1618823836,1618823964,128
1361197444,1618824988,8,544,68,1361197435361,1361197440545,1618816349,1618821533,5184
1361197444,1618824988,8,544,68,1361197435360,1361197440544,1618816348,1618821532,5184
1361197444,1618824988,13,5365,412.6923077,1361197435360,1361197440544,1618816348,1618821532,5184
1361197444,1618824988,8,535,66.875,1361197435424,1361197440608,1618816412,1618821596,5184
1361197444,1618824988,4,292,73,1361197439647,1361197439775,1618820635,1618820763,128
1361197444,1618824992,4,292,73,1361197436125,1361197436253,1618817117,1618817245,128
1361197444,1618824996,4,292,73,1361197436762,1361197436890,1618817758,1618817886,128
1361197444,1618825000,4,292,73,1361197437267,1361197437395,1618818267,1618818395,128
1361197444,1618825000,4,480,120,1361197437399,1361197437463,1618818399,1618818463,64
1361197444,1618825000,4,292,73,1361197441109,1361197441173,1618822109,1618822173,64
1361197444,1618825000,4,460,115,1361197441173,1361197441301,1618822173,1618822301,128
1361197444,1618825000,4,292,73,1361197441236,1361197441300,1618822236,1618822300,64
1361197444,1618825000,4,292,73,1361197441492,1361197441556,1618822492,1618822556,64
1361197444,1618825004,4,292,73,1361197438095,1361197438159,1618819099,1618819163,64
1361197444,1618825004,4,292,73,1361197438354,1361197438418,1618819358,1618819422,64
1361197444,1618825024,4,292,73,1361197438651,1361197438715,1618819675,1618819739,64
1361197444,1618825028,4,292,73,1361197441850,1361197441914,1618822878,1618822942,64
1361197444,1618825032,4,292,73,1361197439411,1361197439475,1618820443,1618820507,64
1361197444,1618825032,4,292,73,1361197443125,1361197443189,1618824157,1618824221,64
1361197444,1618825032,4,292,73,1361197442485,1361197442613,1618823517,1618823645,128
1361197444,1618825032,4,292,73,1361197443379,1361197443443,1618824411,1618824475,64
1361197452,1618832956,4,386,96.5,1361197444544,1361197444608,1618825500,1618825564,64
1361197452,1618832960,4,190,47.5,1361197448701,1361197449021,1618829661,1618829981,320
1361197452,1618832996,4,292,73,1361197451031,1361197451095,1618832027,1618832091,64
1361197452,1618833000,4,292,73,1361197448277,1361197448341,1618829277,1618829341,64
1361197452,1618833028,4,292,73,1361197450360,1361197450488,1618831388,1618831516,128
1361197460,1618840688,42,36831,876.9285714,1361197433805,1361197447437,1618814493,1618828125,13632
1361197460,1618840716,21,22262,1060.095238,1361197435248,1361197435760,1618815964,1618816476,512
1361197460,1618840716,9,6999,777.6666667,1361197435311,1361197435695,1618816027,1618816411,384
1361197460,1618840720,6,3294,549,1361197435630,1361197435694,1618816350,1618816414,64
1361197460,1618840720,12,8084,673.6666667,1361197435630,1361197435758,1618816350,1618816478,128
1361197460,1618840768,7,3995,570.7142857,1361197435580,1361197435644,1618816348,1618816412,64
1361197460,1618840772,6,3310,551.6666667,1361197435578,1361197435642,1618816350,1618816414,64
1361197468,1618848992,4,190,47.5,1361197464094,1361197464350,1618845086,1618845342,256
1361197468,1618848992,4,190,47.5,1361197464030,1361197466334,1618845022,1618847326,2304
1361197468,1618848992,4,190,47.5,1361197464156,1361197464412,1618845148,1618845404,256
1361197468,1618848996,4,190,47.5,1361197464600,1361197464856,1618845596,1618845852,256
1361197468,1618849000,4,190,47.5,1361197464854,1361197465174,1618845854,1618846174,320
1361197468,1618849000,4,190,47.5,1361197465172,1361197465428,1618846172,1618846428,256
1361197468,1618849000,4,190,47.5,1361197465171,1361197465491,1618846171,1618846491,320
1361197468,1618849008,4,190,47.5,1361197465934,1361197466190,1618846942,1618847198,256
1361197468,1618849028,4,190,47.5,1361197463353,1361197463929,1618844381,1618844957,576
1361197468,1618849028,4,190,47.5,1361197463417,1361197464249,1618844445,1618845277,832
1361197468,1618849028,4,190,47.5,1361197466232,1361197466488,1618847260,1618847516,256
1361197468,1618849028,4,190,47.5,1361197466424,1361197466872,1618847452,1618847900,448
1361197468,1618849032,4,190,47.5,1361197466547,1361197466995,1618847579,1618848027,448
1361197468,1618849032,4,190,47.5,1361197466934,1361197467382,1618847966,1618848414,448
1361197468,1618849032,4,190,47.5,1361197466934,1361197467062,1618847966,1618848094,128
1361197468,1618849032,4,190,47.5,1361197466998,1361197467126,1618848030,1618848158,128
1361197468,1618849032,4,190,47.5,1361197466870,1361197466934,1618847902,1618847966,64
1361197468,1618849032,4,190,47.5,1361197467254,1361197467638,1618848286,1618848670,384
1361197468,1618849032,4,190,47.5,1361197467318,1361197467638,1618848350,1618848670,320
1361197468,1618849032,4,190,47.5,1361197467125,1361197467189,1618848157,1618848221,64
1361197468,1618849036,3,144,48,1361197460528,1361197460528,1618841564,1618841564,0
1361197468,1618849036,4,190,47.5,1361197464304,1361197464560,1618845340,1618845596,256
1361197468,1618849036,4,190,47.5,1361197464367,1361197464623,1618845403,1618845659,256
1361197468,1618849040,4,190,47.5,1361197464622,1361197464878,1618845662,1618845918,256
1361197468,1618849040,4,190,47.5,1361197464875,1361197465131,1618845915,1618846171,256
1361197468,1618849064,4,190,47.5,1361197465364,1361197465620,1618846428,1618846684,256
1361197468,1618849064,4,190,47.5,1361197465620,1361197465876,1618846684,1618846940,256
1361197468,1618849064,4,190,47.5,1361197465428,1361197465684,1618846492,1618846748,256
1361197468,1618849068,4,190,47.5,1361197465874,1361197466194,1618846942,1618847262,320
1361197468,1618849068,4,190,47.5,1361197465680,1361197465936,1618846748,1618847004,256
1361197468,1618849072,4,190,47.5,1361197463438,1361197464334,1618844510,1618845406,896
1361197468,1618849072,4,190,47.5,1361197463438,1361197464398,1618844510,1618845470,960
1361197468,1618849072,4,190,47.5,1361197465933,1361197466189,1618847005,1618847261,256
1361197468,1618849072,4,190,47.5,1361197466124,1361197466380,1618847196,1618847452,256
1361197468,1618849072,4,190,47.5,1361197466188,1361197466444,1618847260,1618847516,256
1361197468,1618849072,4,190,47.5,1361197466507,1361197467019,1618847579,1618848091,512
1361197468,1618849072,4,190,47.5,1361197466571,1361197467083,1618847643,1618848155,512
1361197468,1618849076,4,190,47.5,1361197466762,1361197466890,1618847838,1618847966,128
1361197468,1618849076,4,190,47.5,1361197466890,1361197466954,1618847966,1618848030,64
1361197468,1618849076,4,190,47.5,1361197467018,1361197467082,1618848094,1618848158,64
1361197468,1618849076,4,190,47.5,1361197466890,1361197466954,1618847966,1618848030,64
1361197468,1618849076,4,190,47.5,1361197466954,1361197467082,1618848030,1618848158,128
1361197468,1618849076,4,190,47.5,1361197467082,1361197467146,1618848158,1618848222,64
1361197468,1618849076,4,190,47.5,1361197467274,1361197467594,1618848350,1618848670,320
1361197468,1618849076,4,190,47.5,1361197467273,1361197467593,1618848349,1618848669,320
1361197476,1618856700,1,46,46,1361197449730,1361197449730,1618830430,1618830430,0
1361197476,1618856736,2,472,236,1361197448094,1361197448158,1618828830,1618828894,64
1361197476,1618856772,1,46,46,1361197450169,1361197450169,1618830941,1618830941,0
1361197476,1618856980,4,190,47.5,1361197468072,1361197468392,1618849052,1618849372,320
1361197476,1618856984,4,190,47.5,1361197468390,1361197468710,1618849374,1618849694,320
1361197476,1618857024,4,190,47.5,1361197467645,1361197467965,1618848669,1618848989,320
1361197476,1618857024,4,190,47.5,1361197467644,1361197468028,1618848668,1618849052,384
1361197476,1618857024,4,190,47.5,1361197467708,1361197468028,1618848732,1618849052,320
1361197476,1618857024,4,190,47.5,1361197467964,1361197468284,1618848988,1618849308,320
1361197476,1618857024,4,190,47.5,1361197467644,1361197468028,1618848668,1618849052,384
1361197476,1618857024,4,190,47.5,1361197468028,1361197468348,1618849052,1618849372,320
1361197476,1618857024,4,190,47.5,1361197468028,1361197468348,1618849052,1618849372,320
1361197476,1618857028,4,190,47.5,1361197468346,1361197468666,1618849374,1618849694,320
1361197476,1618857028,4,190,47.5,1361197468345,1361197468665,1618849373,1618849693,320
1361197484,1618864748,2,265,132.5,1361197456529,1361197456593,1618837277,1618837341,64
1361197492,1618872784,1,52,52,1361197467245,1361197467245,1618848029,1618848029,0
1361197508,1618889156,4,312,78,1361197500919,1361197500983,1618882075,1618882139,64
1361197508,1618889280,4,312,78,1361197500796,1361197500860,1618882076,1618882140,64
1361197508,1618889280,4,392,98,1361197500923,1361197500987,1618882203,1618882267,64
1361197516,1618896712,2,472,236,1361197488949,1361197489077,1618869661,1618869789,128
1361197516,1618897140,4,312,78,1361197511814,1361197511878,1618892954,1618893018,64
1361197524,1618904744,3,1197,399,1361197498836,1361197498836,1618879580,1618879580,0
1361197524,1618904808,15,16074,1071.6,1361197498900,1361197499348,1618879708,1618880156,448
1361197540,1618920780,2,265,132.5,1361197512046,1361197512174,1618892826,1618892954,128
1361197540,1618921180,3,144,48,1361197535390,1361197535390,1618916570,1618916570,0
1361197556,1618936800,2,472,236,1361197528987,1361197529051,1618909787,1618909851,64
1361197556,1618937176,3,169,56.33333333,1361197550370,1361197550434,1618931546,1618931610,64
1361197556,1618937180,3,169,56.33333333,1361197550433,1361197550433,1618931613,1618931613,0
1361197556,1618937180,4,205,51.25,1361197550433,1361197550433,1618931613,1618931613,0
1361197556,1618937180,3,169,56.33333333,1361197550433,1361197550433,1618931613,1618931613,0
1361197556,1618937224,3,169,56.33333333,1361197550385,1361197550385,1618931609,1618931609,0
1361197556,1618937224,4,205,51.25,1361197550389,1361197550389,1618931613,1618931613,0
1361197564,1618945324,13,6429,494.5384615,1361197543054,1361197558670,1618924378,1618939994,15616
1361197564,1618945324,4,205,51.25,1361197562318,1361197562318,1618943642,1618943642,0
1361197584,1618964784,1,46,46,1361197558377,1361197558377,1618939161,1618939161,0
1361197588,1618968808,1,46,46,1361197560401,1361197560401,1618941209,1618941209,0
1361197596,1618976816,2,265,132.5,1361197567946,1361197568010,1618948762,1618948826,64
1361197596,1618976824,2,472,236,1361197569153,1361197569217,1618949977,1618950041,64
1361197612,1618993324,3,144,48,1361197610256,1361197610256,1618991580,1618991580,0
1361197636,1619016824,2,472,236,1361197608833,1361197608961,1618989657,1618989785,128
1361197636,1619016864,1,46,46,1361197607962,1361197607962,1618988826,1618988826,0
1361197640,1619020880,1,46,46,1361197614667,1361197614667,1618995547,1618995547,0
1361197640,1619020928,1,46,46,1361197614619,1361197614619,1618995547,1618995547,0
1361197648,1619028928,2,265,132.5,1361197623384,1361197623512,1619004312,1619004440,128
1361197676,1619056912,2,472,236,1361197649001,1361197649065,1619029913,1619029977,64
1361197677,1619057448,4,336,84,1361197672440,1361197672568,1619052888,1619053016,128
1361197686,257380252,2,98,49,1361197675563,1361197680427,257369815,257374679,4864
1361197686,257380264,2,98,49,1361197675552,1361197681440,257369816,257375704,5888
1361197693,1619073440,3,144,48,1361197686143,1361197686143,1619066583,1619066583,0
1361197701,1619081504,29,34050,1174.137931,1361197679811,1361197695171,1619060315,1619075675,15360
1361197704,1619084948,4,552,138,1361197679172,1361197680132,1619060120,1619061080,960
1361197716,1619096920,2,472,236,1361197689057,1361197689121,1619069977,1619070041,64
1361197724,1619105416,15,7288,485.8666667,1361197704303,1361197721775,1619085719,1619103191,17472
1361197725,1619105444,29,33740,1163.448276,1361197707902,1361197723262,1619088346,1619103706,15360
1361197732,1619112944,1,46,46,1361197707401,1361197707401,1619088345,1619088345,0
1361197732,1619112956,12,5207,433.9166667,1361197705339,1361197706939,1619086295,1619087895,1600
1361197732,1619112992,2,287,143.5,1361197707289,1361197707865,1619088281,1619088857,576
1361197749,1619129460,3,144,48,1361197746092,1361197746156,1619126552,1619126616,64
1361197756,1619136920,2,472,236,1361197729376,1361197729504,1619110296,1619110424,128
1361197765,1619145464,16,7829,489.3125,1361197746024,1361197762664,1619126488,1619143128,16640
1361197772,1619152944,8,671,83.875,1361197745929,1361197746697,1619126873,1619127641,768
1361197772,1619152988,1,46,46,1361197745502,1361197745502,1619126490,1619126490,0
1361197772,1619153016,11,2304,209.4545455,1361197747137,1361197747649,1619128153,1619128665,512
1361197781,1619161564,29,33746,1163.655172,1361197763652,1361197779012,1619144216,1619159576,15360
1361197788,1619169000,1,46,46,1361197763214,1361197763214,1619144214,1619144214,0
1361197788,1619169048,4,552,138,1361197762976,1361197763872,1619144024,1619144920,896
1361197796,1619177012,2,472,236,1361197769283,1361197769347,1619150295,1619150359,64
1361197813,1619193576,2,123,61.5,1361197807032,1361197807032,1619187608,1619187608,0
1361197829,1619209512,3,144,48,1361197821049,1361197821049,1619201561,1619201561,0
1361197836,1619217052,2,472,236,1361197809369,1361197809433,1619190421,1619190485,64
1361197844,1619225320,2,265,132.5,1361197818704,1361197818768,1619200024,1619200088,64
1361197869,1619249624,4,205,51.25,1361197863622,1361197863622,1619244246,1619244246,0
1361197872,1619253352,1,46,46,1361197847534,1361197847534,1619228886,1619228886,0
1361197876,1619257380,2,472,236,1361197849169,1361197849233,1619230549,1619230613,64
1361197900,1619281356,2,265,132.5,1361197874283,1361197874347,1619255639,1619255703,64
1361197901,1619281656,3,144,48,1361197895974,1361197895974,1619276630,1619276630,0
1361197916,1619297380,2,472,236,1361197888913,1361197888977,1619270293,1619270357,64
1361197933,1619313684,16,7829,489.3125,1361197911883,1361197928715,1619292567,1619309399,16832
1361197936,1619317440,9,5063,562.5555556,1361197911703,1361197912727,1619293143,1619294167,1024
1361197944,1619325428,7,1450,207.1428571,1361197919136,1361197919712,1619300564,1619301140,576
1361197949,1619329708,29,33740,1163.448276,1361197930931,1361197946291,1619311639,1619326999,15360
1361197956,1619337420,2,472,236,1361197928424,1361197928488,1619309844,1619309908,64
1361197957,1619337504,4,552,138,1361197930942,1361197931774,1619311446,1619312278,832
1361197973,1619353796,3,144,48,1361197970779,1361197970779,1619351575,1619351575,0
1361197981,1619361748,2,123,61.5,1361197973195,1361197973195,1619353943,1619353943,0
1361197990,257684252,2,98,49,1361197985582,1361197989614,257679834,257683866,4032
1361197997,1619377484,2,472,236,1361197969874,1361197969938,1619350358,1619350422,64
1361197998,257692276,2,98,49,1361197985559,1361197990615,257679835,257684891,5056
1361198013,1619393852,2,265,132.5,1361197986657,1361197986721,1619367509,1619367573,64
1361198037,1619417732,2,472,236,1361198009688,1361198009752,1619390420,1619390484,64
1361198037,1619417956,4,205,51.25,1361198035639,1361198035639,1619416595,1619416595,0
1361198053,1619433768,1,46,46,1361198028083,1361198028083,1619408851,1619408851,0
1361198053,1619433948,3,144,48,1361198045632,1361198045632,1619426580,1619426580,0
1361198069,1619449760,2,265,132.5,1361198042236,1361198042300,1619422996,1619423060,64
1361198069,1619450024,13,6413,493.3076923,1361198051762,1361198067442,1619432786,1619448466,15680
1361198073,1619453836,10,2112,211.2,1361198047856,1361198048368,1619428692,1619429204,512
1361198077,1619457800,2,472,236,1361198049044,1361198049108,1619429844,1619429908,64
1361198101,1619481892,1,46,46,1361198076534,1361198076534,1619457426,1619457426,0
1361198101,1619481896,17,8013,471.3529412,1361198076533,1361198098485,1619457429,1619479381,21952
1361198101,1619482108,29,33730,1163.103448,1361198083489,1361198098849,1619464597,1619479957,15360
1361198109,1619489876,9,5063,562.5555556,1361198082248,1361198083144,1619463124,1619464020,896
1361198109,1619489912,2,287,143.5,1361198083490,1361198084386,1619464402,1619465298,896
1361198109,1619490100,11,5666,515.0909091,1361198086950,1361198102694,1619468050,1619483794,15744
1361198113,1619493988,1,52,52,1361198087894,1361198087894,1619468882,1619468882,0
1361198117,1619497932,2,472,236,1361198089487,1361198089551,1619470419,1619470483,64
1361198125,1619506056,3,144,48,1361198122900,1361198122900,1619503956,1619503956,0
1361198149,1619530076,3,169,56.33333333,1361198142718,1361198147838,1619523794,1619528914,5120
1361198157,1619538208,2,472,236,1361198128761,1361198128825,1619509969,1619510033,64
1361198165,1619546200,2,265,132.5,1361198139457,1361198139585,1619520657,1619520785,128
1361198165,1619546352,4,205,51.25,1361198163434,1361198163434,1619544786,1619544786,0
1361198173,1619554232,1,46,46,1361198147682,1361198147682,1619528914,1619528914,0
1361198173,1619554232,1,46,46,1361198147680,1361198147680,1619528912,1619528912,0
1361198173,1619554272,1,46,46,1361198147641,1361198147641,1619528913,1619528913,0
1361198182,1619562484,3,144,48,1361198181133,1361198181133,1619561617,1619561617,0
1361198197,1619578200,2,472,236,1361198169411,1361198169475,1619550611,1619550675,64
1361198221,1619602212,2,265,132.5,1361198195443,1361198195571,1619576655,1619576783,128
1361198237,1619618220,2,472,236,1361198210286,1361198210350,1619591506,1619591570,64
1361198262,1619642584,3,144,48,1361198255978,1361198255978,1619636562,1619636562,0
1361198277,1619658232,2,472,236,1361198249887,1361198249951,1619631119,1619631183,64
1361198277,1619658236,2,265,132.5,1361198250910,1361198250974,1619632146,1619632210,64
1361198302,257996448,2,98,49,1361198296300,1361198300844,257990748,257995292,4544
1361198302,257996448,2,98,49,1361198296299,1361198299883,257990747,257994331,3584
1361198317,1619698220,2,472,236,1361198290475,1361198290539,1619671695,1619671759,64
1361198318,1619698648,3,144,48,1361198315945,1361198315945,1619696593,1619696593,0
1361198333,1619714272,2,265,132.5,1361198306104,1361198306232,1619687376,1619687504,128
1361198357,1619738292,2,472,236,1361198331042,1361198331106,1619712334,1619712398,64
1361198373,1619754380,10,2107,210.7,1361198347977,1361198348297,1619729357,1619729677,320
1361198389,1619770384,2,265,132.5,1361198361350,1361198361414,1619742734,1619742798,64
1361198397,1619778356,2,472,236,1361198370404,1361198370468,1619751760,1619751824,64
1361198398,1619778604,3,144,48,1361198390932,1361198390996,1619771536,1619771600,64
1361198406,1619786652,86,107570,1250.813953,1361198393890,1361198404642,1619774542,1619785294,10752
1361198414,1619794664,3,144,48,1361198406741,1361198406933,1619787405,1619787597,192
1361198414,1619794700,122,165218,1354.245902,1361198404785,1361198408689,1619785485,1619789389,3904
1361198422,1619802764,129,168944,1309.643411,1361198408754,1361198419314,1619789518,1619800078,10560
1361198426,1619806448,2,583,291.5,1361198400560,1361198400560,1619781008,1619781008,0
1361198430,1619810752,110,139830,1271.181818,1361198420156,1361198423228,1619800908,1619803980,3072
1361198438,1619818452,2,472,236,1361198411304,1361198411368,1619791756,1619791820,64
1361198445,1619826396,2,265,132.5,1361198417083,1361198417147,1619798479,1619798543,64
1361198470,1619850708,3,144,48,1361198465832,1361198465896,1619846540,1619846604,64
1361198478,1619858504,2,472,236,1361198452150,1361198452214,1619832654,1619832718,64
1361198498,1619878560,2,265,132.5,1361198473534,1361198473598,1619854094,1619854158,64
1361198518,1619898528,2,472,236,1361198492829,1361198492893,1619873357,1619873421,64
1361198518,1619898780,4,205,51.25,1361198515618,1361198515618,1619896398,1619896398,0
1361198542,1619922828,3,144,48,1361198540719,1361198541871,1619921547,1619922699,1152
1361198554,1619934588,2,265,132.5,1361198528992,1361198529056,1619909580,1619909644,64
1361198558,1619938636,2,472,236,1361198532465,1361198532529,1619913101,1619913165,64
1361198570,1619950612,1,46,46,1361198545094,1361198545094,1619925706,1619925706,0
1361198598,1619978688,2,472,236,1361198572923,1361198572987,1619953611,1619953675,64
1361198610,1619990640,4,552,138,1361198584683,1361198594411,1619965323,1619975051,9728
1361198614,1619994860,31,33853,1092.032258,1361198593488,1361198609424,1619974348,1619990284,15936
1361198614,1619994860,3,144,48,1361198612751,1361198612815,1619993611,1619993675,64
1361198614,1619994872,17,6803,400.1764706,1361198591171,1361198609923,1619972043,1619990795,18752
1361198614,1619994904,4,336,84,1361198613604,1361198613732,1619994508,1619994636,128
1361198618,1619998692,13,5253,404.0769231,1361198591927,1361198592951,1619972619,1619973643,1024
1361198622,258316652,2,98,49,1361198618148,1361198621412,258312800,258316064,3264
1361198630,258324660,2,98,49,1361198618138,1361198622426,258312798,258317086,4288
1361198638,1620018632,2,472,236,1361198612276,1361198612340,1619992908,1619992972,64
1361198654,1620034912,2,123,61.5,1361198652506,1361198652506,1620033418,1620033418,0
1361198674,1620054960,11,2329,211.7272727,1361198648811,1361198649259,1620029771,1620030219,448
1361198678,1620058876,2,265,132.5,1361198650046,1361198650174,1620030922,1620031050,128
1361198678,1620058972,2,472,236,1361198652703,1361198652767,1620033675,1620033739,64
1361198678,1620059068,3,144,48,1361198675516,1361198675516,1620056584,1620056584,0
1361198702,1620083052,16,7829,489.3125,1361198682444,1361198701196,1620063496,1620082248,18752
1361198702,1620083096,29,33746,1163.655172,1361198686306,1361198701666,1620067402,1620082762,15360
1361198710,1620090908,1,46,46,1361198682588,1361198682588,1620063496,1620063496,0
1361198710,1620090912,1,46,46,1361198683033,1361198683033,1620063945,1620063945,0
1361198710,1620090984,13,5253,404.0769231,1361198684305,1361198685969,1620065289,1620066953,1664
1361198714,1620094904,2,287,143.5,1361198686433,1361198687073,1620067337,1620067977,640
1361198714,1620094944,1,46,46,1361198686458,1361198686458,1620067402,1620067402,0
1361198718,1620098964,2,472,236,1361198693479,1361198693607,1620074443,1620074571,128
1361198750,1620131236,3,169,56.33333333,1361198745493,1361198747861,1620126729,1620129097,2368
1361198758,1620139168,2,472,236,1361198733463,1361198733527,1620114631,1620114695,64
1361198758,1620139356,3,144,48,1361198752541,1361198752605,1620133897,1620133961,64
1361198766,1620147188,4,205,51.25,1361198764614,1361198764614,1620145802,1620145802,0
1361198770,1620151012,2,265,132.5,1361198742709,1361198742773,1620123721,1620123785,64
1361198774,1620155044,1,46,46,1361198747987,1361198747987,1620129031,1620129031,0
1361198774,1620155148,1,46,46,1361198747883,1361198747883,1620129031,1620129031,0
1361198782,1620163176,18,8065,448.0555556,1361198757521,1361198775249,1620138697,1620156425,17728
1361198786,1620167072,12,5207,433.9166667,1361198758841,1361198760057,1620139913,1620141129,1216
1361198802,1620183040,2,472,236,1361198774232,1361198774296,1620155272,1620155336,64
1361198815,1620195584,29,33724,1162.896552,1361198799136,1361198814496,1620179720,1620195080,15360
1361198815,1620195628,3,144,48,1361198810933,1361198810997,1620191561,1620191625,64
1361198822,1620203364,2,123,61.5,1361198819541,1361198819541,1620200905,1620200905,0
1361198823,1620203516,5,250,50,1361198798245,1361198819301,1620178761,1620199817,21056
1361198826,1620207396,4,552,138,1361198798132,1361198798900,1620179528,1620180296,768
1361198839,1620219512,2,472,236,1361198814758,1361198814822,1620195270,1620195334,64
1361198879,1620259552,2,472,236,1361198854397,1361198854461,1620234949,1620235013,64
1361198883,1620263476,2,265,132.5,1361198855755,1361198855883,1620236231,1620236359,128
1361198886,1620267348,3,144,48,1361198885218,1361198885218,1620266566,1620266566,0
1361198895,1620275496,1,46,46,1361198868598,1361198868598,1620249094,1620249094,0
1361198895,1620275564,1,46,46,1361198868466,1361198868466,1620249030,1620249030,0
1361198907,1620287544,7,1450,207.1428571,1361198880520,1361198881096,1620261064,1620261640,576
1361198919,1620299532,2,472,236,1361198894356,1361198894420,1620274888,1620274952,64
1361198926,258620676,2,98,49,1361198918924,1361198922380,258613600,258617056,3456
1361198926,258620676,2,98,49,1361198918988,1361198923340,258613664,258618016,4352
1361198939,1620319572,4,703,175.75,1361198911659,1361198913195,1620292231,1620293767,1536
1361198950,1620331388,3,144,48,1361198945209,1361198945209,1620326597,1620326597,0
1361198963,1620343556,2,472,236,1361198934715,1361198934779,1620315271,1620315335,64
1361198966,1620347364,12,999,83.25,1361198949776,1361198960656,1620331140,1620342020,10880
1361198966,1620347388,11,953,86.63636364,1361198950011,1361198960635,1620331399,1620342023,10624
1361198966,1620347400,15,6289,419.2666667,1361198948655,1361198960623,1620330055,1620342023,11968
1361198966,1620347424,12,999,83.25,1361198949462,1361198960598,1620330886,1620342022,11136
1361198975,1620355852,6,1643,273.8333333,1361198949457,1361198950161,1620330309,1620331013,704
1361198995,1620375800,4,552,138,1361198968453,1361198990021,1620349253,1620370821,21568
1361198999,1620379836,2,472,236,1361198974051,1361198974115,1620354887,1620354951,64
1361199014,1620395356,96,130329,1357.59375,1361198988826,1361199011098,1620370182,1620392454,22272
1361199014,1620395392,26,11023,423.9615385,1361198987957,1361199010997,1620369349,1620392389,23040
1361199022,1620403396,3,144,48,1361199020145,1361199020209,1620401541,1620401605,64
1361199023,1620403852,4,574,143.5,1361198995665,1361198997009,1620376517,1620377861,1344
1361199031,1620411828,11,3267,297,1361199003625,1361199004649,1620384453,1620385477,1024
1361199039,1620419876,2,472,236,1361199014839,1361199014903,1620395715,1620395779,64
1361199062,1620443432,2,141,70.5,1361199055116,1361199055116,1620436548,1620436548,0
1361199070,1620451424,4,205,51.25,1361199064723,1361199064723,1620446147,1620446147,0
1361199079,1620459876,83,112680,1357.590361,1361199052279,1361199071223,1620433155,1620452099,18944
1361199079,1620459920,1,46,46,1361199052234,1361199052234,1620433154,1620433154,0
1361199079,1620459924,6,861,143.5,1361199052106,1361199071242,1620433030,1620452166,19136
1361199083,1620463952,2,472,236,1361199055723,1361199055787,1620436675,1620436739,64
1361199086,1620467408,3,144,48,1361199080164,1361199080164,1620461572,1620461572,0
1361199086,1620467432,2,123,61.5,1361199085323,1361199085323,1620466755,1620466755,0
1361199087,1620467892,1,46,46,1361199061160,1361199061160,1620442052,1620442052,0
1361199087,1620467956,29,13682,471.7931034,1361199061094,1361199084390,1620442050,1620465346,23296
1361199087,1620467960,27,8732,323.4074074,1361199061794,1361199082850,1620442754,1620463810,21056
1361199119,1620499496,29,34162,1178,1361199098801,1361199114161,1620479297,1620494657,15360
1361199119,1620499968,7,928,132.5714286,1361199094106,1361199098778,1620475074,1620479746,4672
1361199119,1620500016,10,3623,362.3,1361199093866,1361199109994,1620474882,1620491010,16128
1361199123,1620503952,2,287,143.5,1361199096235,1361199099051,1620477187,1620480003,2816
1361199123,1620503980,1,46,46,1361199098320,1361199098320,1620479300,1620479300,0
1361199123,1620503992,2,472,236,1361199096387,1361199096451,1620477379,1620477443,64
1361199126,1620507424,2,123,61.5,1361199124628,1361199124628,1620506052,1620506052,0
1361199159,1620539548,3,144,48,1361199156030,1361199156030,1620536578,1620536578,0
1361199163,1620544296,2,472,236,1361199135444,1361199135508,1620516740,1620516804,64
1361199167,1620547544,2,123,61.5,1361199159169,1361199159169,1620539713,1620539713,0
1361199179,1620560332,1,46,46,1361199154862,1361199154862,1620536194,1620536194,0
1361199179,1620560332,69,92593,1341.927536,1361199154862,1361199166638,1620536194,1620547970,11776
1361199179,1620560372,7,1080,154.2857143,1361199154632,1361199166664,1620536004,1620548036,12032
1361199183,1620563536,18,8017,445.3888889,1361199156043,1361199182347,1620536579,1620562883,26304
1361199183,1620563552,2,123,61.5,1361199182203,1361199182203,1620562755,1620562755,0
1361199183,1620564268,1,46,46,1361199155309,1361199155309,1620536577,1620536577,0
1361199191,1620571576,4,312,78,1361199189473,1361199189537,1620570049,1620570113,64
1361199191,1620571576,4,312,78,1361199189537,1361199189665,1620570113,1620570241,128
1361199191,1620571580,4,312,78,1361199189536,1361199189600,1620570116,1620570180,64
1361199191,1620571616,4,312,78,1361199189243,1361199189307,1620569859,1620569923,64
1361199191,1620571616,4,312,78,1361199189305,1361199189433,1620569921,1620570049,128
1361199195,1620576332,1,46,46,1361199167789,1361199167789,1620549121,1620549121,0
1361199203,1620584324,2,472,236,1361199175415,1361199175479,1620556739,1620556803,64
1361199215,1620596300,4,2044,511,1361199188495,1361199188751,1620569795,1620570051,256
1361199215,1620596300,21,24243,1154.428571,1361199188622,1361199188814,1620569922,1620570114,192
1361199219,1620600300,1,46,46,1361199193934,1361199193934,1620575234,1620575234,0
1361199223,1620603604,3,144,48,1361199215942,1361199216006,1620596546,1620596610,64
1361199237,258931264,2,98,49,1361199228650,1361199233578,258922914,258927842,4928
1361199238,258932704,2,98,49,1361199228212,1361199232116,258922916,258926820,3904
1361199239,1620619600,4,312,78,1361199236360,1361199236424,1620616960,1620617024,64
1361199239,1620619640,4,312,78,1361199236320,1361199236384,1620616960,1620617024,64
1361199243,1620624424,2,472,236,1361199215567,1361199215631,1620596991,1620597055,64
1361199247,1620627584,2,92,46,1361199236504,1361199242200,1620617088,1620622784,5696
1361199247,1620627620,13,5365,412.6923077,1361199235764,1361199241012,1620616384,1620621632,5248
1361199247,1620627628,2,92,46,1361199236334,1361199242158,1620616962,1620622786,5824
1361199247,1620628300,2,265,132.5,1361199222541,1361199222605,1620603841,1620603905,64
1361199255,1620636328,1,46,46,1361199227824,1361199227824,1620609152,1620609152,0
1361199255,1620636328,1,46,46,1361199227824,1361199227824,1620609152,1620609152,0
1361199259,1620640400,39,35396,907.5897436,1361199233192,1361199249768,1620614592,1620631168,16576
1361199263,1620644356,27,30358,1124.37037,1361199235350,1361199235926,1620616706,1620617282,576
1361199263,1620644360,7,5251,750.1428571,1361199236303,1361199236431,1620617663,1620617791,128
1361199263,1620644360,9,7240,804.4444444,1361199236303,1361199236431,1620617663,1620617791,128
1361199263,1620644364,6,3702,617,1361199236299,1361199236427,1620617663,1620617791,128
1361199264,1620644436,6,2467,411.1666667,1361199236461,1361199236653,1620616897,1620617089,192
1361199264,1620644436,6,2467,411.1666667,1361199236461,1361199236653,1620616897,1620617089,192
1361199264,1620644444,7,4451,635.8571429,1361199237219,1361199237347,1620617663,1620617791,128
1361199264,1620644444,9,7560,840,1361199237222,1361199237350,1620617666,1620617794,128
1361199264,1620644444,7,4734,676.2857143,1361199237222,1361199237350,1620617666,1620617794,128
1361199271,1620651588,4,312,78,1361199270038,1361199270166,1620650626,1620650754,128
1361199271,1620651588,10,5584,558.4,1361199266710,1361199270486,1620647298,1620651074,3776
1361199271,1620651588,4,190,47.5,1361199270293,1361199270549,1620650881,1620651137,256
1361199271,1620651608,4,190,47.5,1361199270530,1361199270786,1620651138,1620651394,256
1361199271,1620651620,4,312,78,1361199264947,1361199265011,1620645567,1620645631,64
1361199271,1620651620,11,5977,543.3636364,1361199265015,1361199265207,1620645635,1620645827,192
1361199271,1620651624,4,190,47.5,1361199269362,1361199270002,1620649986,1620650626,640
1361199271,1620651624,4,190,47.5,1361199269426,1361199270194,1620650050,1620650818,768
1361199271,1620651624,4,190,47.5,1361199269489,1361199270449,1620650113,1620651073,960
1361199271,1620651624,4,190,47.5,1361199269999,1361199270255,1620650623,1620650879,256
1361199271,1620651624,4,190,47.5,1361199269999,1361199270703,1620650623,1620651327,704
1361199271,1620651628,4,190,47.5,1361199270509,1361199270765,1620651137,1620651393,256
1361199276,1620656476,1,46,46,1361199251079,1361199251079,1620631555,1620631555,0
1361199279,1620659580,4,312,78,1361199272219,1361199272283,1620652799,1620652863,64
1361199279,1620659584,2,98,49,1361199272154,1361199278042,1620652738,1620658626,5888
1361199279,1620659584,4,190,47.5,1361199276058,1361199276378,1620656642,1620656962,320
1361199279,1620659584,4,190,47.5,1361199272473,1361199272729,1620653057,1620653313,256
1361199279,1620659584,4,190,47.5,1361199272727,1361199272983,1620653311,1620653567,256
1361199279,1620659588,4,190,47.5,1361199273236,1361199273492,1620653824,1620654080,256
1361199279,1620659588,4,190,47.5,1361199273427,1361199273683,1620654015,1620654271,256
1361199279,1620659588,4,190,47.5,1361199273491,1361199273747,1620654079,1620654335,256
1361199279,1620659592,4,190,47.5,1361199273682,1361199273938,1620654274,1620654530,256
1361199279,1620659592,4,190,47.5,1361199274065,1361199274513,1620654657,1620655105,448
1361199279,1620659616,4,190,47.5,1361199274682,1361199275194,1620655298,1620655810,512
1361199279,1620659616,4,190,47.5,1361199274810,1361199274938,1620655426,1620655554,128
1361199279,1620659616,4,190,47.5,1361199274874,1361199274938,1620655490,1620655554,64
1361199279,1620659616,4,190,47.5,1361199274810,1361199274874,1620655426,1620655490,64
1361199279,1620659616,4,190,47.5,1361199275065,1361199275193,1620655681,1620655809,128
1361199279,1620659616,4,190,47.5,1361199275064,1361199275128,1620655680,1620655744,64
1361199279,1620659616,4,190,47.5,1361199275320,1361199275640,1620655936,1620656256,320
1361199279,1620659620,4,190,47.5,1361199270774,1361199273142,1620651394,1620653762,2368
1361199279,1620659620,4,312,78,1361199270837,1361199270965,1620651457,1620651585,128
1361199279,1620659620,4,190,47.5,1361199275637,1361199276021,1620656257,1620656641,384
1361199279,1620659620,4,190,47.5,1361199275701,1361199276021,1620656321,1620656641,320
1361199279,1620659620,9,2354,261.5555556,1361199271733,1361199276981,1620652353,1620657601,5248
1361199279,1620659624,4,190,47.5,1361199276018,1361199276338,1620656642,1620656962,320
1361199279,1620659624,4,190,47.5,1361199275954,1361199276274,1620656578,1620656898,320
1361199279,1620659624,4,190,47.5,1361199272241,1361199274609,1620652865,1620655233,2368
1361199279,1620659624,4,190,47.5,1361199276080,1361199276464,1620656704,1620657088,384
1361199279,1620659624,4,312,78,1361199272496,1361199272560,1620653120,1620653184,64
1361199279,1620659624,4,190,47.5,1361199276335,1361199276655,1620656959,1620657279,320
1361199279,1620659624,4,190,47.5,1361199276335,1361199276719,1620656959,1620657343,384
1361199279,1620659628,4,190,47.5,1361199276334,1361199276654,1620656962,1620657282,320
1361199279,1620659628,4,190,47.5,1361199276461,1361199276781,1620657089,1620657409,320
1361199279,1620659628,4,190,47.5,1361199276652,1361199276972,1620657280,1620657600,320
1361199279,1620659628,4,190,47.5,1361199272940,1361199273196,1620653568,1620653824,256
1361199279,1620659628,4,190,47.5,1361199273067,1361199273323,1620653695,1620653951,256
1361199279,1620659632,4,190,47.5,1361199273131,1361199273387,1620653763,1620654019,256
1361199279,1620659632,4,190,47.5,1361199273322,1361199273642,1620653954,1620654274,320
1361199279,1620659632,4,190,47.5,1361199273640,1361199273896,1620654272,1620654528,256
1361199279,1620659632,4,190,47.5,1361199273768,1361199276072,1620654400,1620656704,2304
1361199279,1620659652,4,190,47.5,1361199269459,1361199271699,1620650111,1620652351,2240
1361199279,1620659656,4,190,47.5,1361199273939,1361199274451,1620654595,1620655107,512
1361199279,1620659656,4,190,47.5,1361199269904,1361199272208,1620650560,1620652864,2304
1361199279,1620659656,4,190,47.5,1361199270031,1361199272399,1620650687,1620653055,2368
1361199279,1620659660,4,190,47.5,1361199274446,1361199274958,1620655106,1620655618,512
1361199279,1620659660,4,190,47.5,1361199274510,1361199275022,1620655170,1620655682,512
1361199279,1620659660,12,8956,746.3333333,1361199270414,1361199271246,1620651074,1620651906,832
1361199279,1620659660,4,190,47.5,1361199274893,1361199274957,1620655553,1620655617,64
1361199279,1620659660,4,190,47.5,1361199274957,1361199275021,1620655617,1620655681,64
1361199279,1620659660,4,190,47.5,1361199275212,1361199275596,1620655872,1620656256,384
1361199279,1620659660,4,190,47.5,1361199275276,1361199275596,1620655936,1620656256,320
1361199279,1620659660,4,190,47.5,1361199274892,1361199275020,1620655552,1620655680,128
1361199279,1620659660,4,190,47.5,1361199274956,1361199275084,1620655616,1620655744,128
1361199279,1620659660,4,190,47.5,1361199275083,1361199275147,1620655743,1620655807,64
1361199279,1620659664,4,190,47.5,1361199275595,1361199275915,1620656259,1620656579,320
1361199279,1620659664,4,190,47.5,1361199270729,1361199273033,1620651393,1620653697,2304
1361199284,1620664708,2,472,236,1361199256990,1361199257054,1620637698,1620637762,64
1361199287,1620667596,3,169,56.33333333,1361199279822,1361199280014,1620660418,1620660610,192
1361199287,1620667676,9,621,69,1361199274300,1361199280252,1620654976,1620660928,5952
1361199287,1620667680,2,123,61.5,1361199283705,1361199283705,1620664385,1620664385,0
1361199287,1620667680,2,123,61.5,1361199283704,1361199283704,1620664384,1620664384,0
1361199292,1620672828,11,7494,681.2727273,1361199266213,1361199266405,1620647041,1620647233,192
1361199295,1620675584,2,123,61.5,1361199287831,1361199287831,1620668415,1620668415,0
1361199295,1620675584,2,123,61.5,1361199287831,1361199287831,1620668415,1620668415,0
1361199295,1620675632,2,123,61.5,1361199287785,1361199287785,1620668417,1620668417,0
1361199295,1620675660,3,144,48,1361199290894,1361199290958,1620671554,1620671618,64
1361199296,1620676708,9,7126,791.7777778,1361199271839,1361199271903,1620652547,1620652611,64
1361199296,1620676752,13,12440,956.9230769,1361199271537,1361199271793,1620652289,1620652545,256
1361199296,1620676756,11,10433,948.4545455,1361199271790,1361199271854,1620652546,1620652610,64
1361199296,1620676788,40,52349,1308.725,1361199271372,1361199271692,1620652160,1620652480,320
1361199296,1620676820,16,7510,469.375,1361199269740,1361199270892,1620650560,1620651712,1152
1361199296,1620676828,6,2610,435,1361199270628,1361199270756,1620651456,1620651584,128
1361199300,1620680764,4,1845,461.25,1361199271971,1361199272035,1620652735,1620652799,64
1361199300,1620680792,4,1675,418.75,1361199272264,1361199272328,1620653056,1620653120,64
1361199304,1620684824,2,265,132.5,1361199278441,1361199278569,1620659265,1620659393,128
1361199324,1620704916,2,472,236,1361199297548,1361199297612,1620678464,1620678528,64
1361199327,1620707612,8,4835,604.375,1361199319997,1361199325501,1620700609,1620706113,5504
1361199327,1620707616,8,4996,624.5,1361199320506,1361199320954,1620701122,1620701570,448
1361199327,1620707616,8,4996,624.5,1361199320505,1361199321017,1620701121,1620701633,512
1361199327,1620707616,15,11674,778.2666667,1361199319415,1361199319863,1620700031,1620700479,448
1361199327,1620707620,13,7618,586,1361199319924,1361199320436,1620700544,1620701056,512
1361199327,1620707624,10,6424,642.4,1361199319920,1361199320432,1620700544,1620701056,512
1361199327,1620707624,8,4835,604.375,1361199319920,1361199325488,1620700544,1620706112,5568
1361199327,1620707660,8,4996,624.5,1361199320398,1361199320782,1620701058,1620701442,384
1361199328,1620708740,1,46,46,1361199303869,1361199303869,1620684609,1620684609,0
1361199328,1620708740,1,46,46,1361199303869,1361199303869,1620684609,1620684609,0
1361199328,1620708832,1,46,46,1361199303776,1361199303776,1620684608,1620684608,0
1361199328,1620708856,1,46,46,1361199303751,1361199303751,1620684607,1620684607,0
1361199328,1620708856,1,46,46,1361199303751,1361199303751,1620684607,1620684607,0
1361199332,1620712768,1,46,46,1361199304802,1361199304802,1620685570,1620685570,0
1361199332,1620712840,1,46,46,1361199304727,1361199304727,1620685567,1620685567,0
1361199344,1620724780,3,1793,597.6666667,1361199319827,1361199322259,1620700607,1620703039,2432
1361199348,1620728784,7,4644,663.4285714,1361199320272,1361199323664,1620701056,1620704448,3392
1361199348,1620728800,6,3290,548.3333333,1361199321790,1361199323774,1620702590,1620704574,1984
1361199348,1620728800,74,93752,1266.918919,1361199321920,1361199323008,1620702720,1620703808,1088
1361199348,1620728800,11,5530,502.7272727,1361199321920,1361199324480,1620702720,1620705280,2560
1361199348,1620728800,7,3418,488.2857143,1361199321984,1361199324288,1620702784,1620705088,2304
1361199348,1620728800,9,5046,560.6666667,1361199321984,1361199322048,1620702784,1620702848,64
1361199348,1620728800,7,1908,272.5714286,1361199321984,1361199324352,1620702784,1620705152,2368
1361199348,1620728832,4,3970,992.5,1361199320223,1361199320671,1620701055,1620701503,448
1361199348,1620728860,11,9264,842.1818182,1361199320709,1361199321093,1620701569,1620701953,384
1361199348,1620728864,49,51415,1049.285714,1361199321086,1361199324414,1620701950,1620705278,3328
1361199348,1620728868,37,50963,1377.378378,1361199321851,1361199322235,1620702719,1620703103,384
1361199348,1620728868,22,14347,652.1363636,1361199321851,1361199322043,1620702719,1620702911,192
1361199352,1620732864,97,92719,955.8659794,1361199324159,1361199325375,1620705023,1620706239,1216
1361199359,1620739672,4,205,51.25,1361199352447,1361199352447,1620733119,1620733119,0
1361199360,1620740904,2,265,132.5,1361199334488,1361199334552,1620715392,1620715456,64
1361199364,1620744876,2,472,236,1361199337845,1361199337909,1620718721,1620718785,64
1361199375,1620755780,3,144,48,1361199368149,1361199368213,1620748929,1620748993,64
1361199380,1620760788,1,46,46,1361199352461,1361199352461,1620733249,1620733249,0
1361199380,1620760788,1,46,46,1361199352461,1361199352461,1620733249,1620733249,0
1361199380,1620760864,8,5716,714.5,1361199353214,1361199367294,1620734078,1620748158,14080
1361199382,259076744,8,501,62.625,1361199375114,1361199380682,259069858,259075426,5568
1361199383,1620763660,4,312,78,1361199375498,1361199375562,1620756158,1620756222,64
1361199383,1620763668,4,312,78,1361199375749,1361199375813,1620756417,1620756481,64
1361199383,1620763704,4,312,78,1361199375072,1361199375200,1620755776,1620755904,128
1361199383,1620763704,5,1049,209.8,1361199375390,1361199375710,1620756094,1620756414,320
1361199383,1620763708,5,1088,217.6,1361199375642,1361199375706,1620756350,1620756414,64
1361199384,1620764868,1,190,190,1361199359226,1361199359226,1620740094,1620740094,0
1361199388,1620768888,2,583,291.5,1361199360615,1361199360807,1620741503,1620741695,192
1361199388,1620768892,1,46,46,1361199360868,1361199360868,1620741760,1620741760,0
1361199391,259084800,63,57213,908.1428571,1361199381819,1361199388027,259075619,259081827,6208
1361199391,259084804,106,120812,1139.735849,1361199376054,1361199386806,259069858,259080610,10752
1361199391,259084812,66,61102,925.7878788,1361199381807,1361199386799,259075619,259080611,4992
1361199391,259084812,307,397008,1293.185668,1361199381807,1361199387759,259075619,259081571,5952
1361199391,259084824,236,277031,1173.860169,1361199375459,1361199386787,259069283,259080611,11328
1361199391,1620771724,3,169,56.33333333,1361199387338,1361199387338,1620768062,1620768062,0
1361199391,1620771724,3,169,56.33333333,1361199387338,1361199387338,1620768062,1620768062,0
1361199391,1620771776,3,169,56.33333333,1361199387289,1361199387289,1620768065,1620768065,0
1361199400,1620780864,9,7983,887,1361199375745,1361199394753,1620756609,1620775617,19008
1361199404,1620784948,2,472,236,1361199378219,1361199378283,1620759167,1620759231,64
1361199408,1620788852,4,1674,418.5,1361199383819,1361199384395,1620764671,1620765247,576
1361199408,1620788864,2,92,46,1361199383359,1361199383359,1620764223,1620764223,0
1361199408,1620788896,2,92,46,1361199381149,1361199381213,1620762045,1620762109,64
1361199409,259103316,62,52030,839.1935484,1361199381303,1361199386295,259075619,259080611,4992
1361199412,1620792964,1,46,46,1361199386204,1361199386204,1620767168,1620767168,0
1361199412,1620792964,1,46,46,1361199386204,1361199386204,1620767168,1620767168,0
1361199413,259107272,33,31123,943.1212121,1361199386340,1361199404324,259080612,259098596,17984
1361199413,259107272,10,3746,374.6,1361199386403,1361199404323,259080675,259098595,17920
1361199413,259107272,18,11761,653.3888889,1361199386786,1361199404322,259081058,259098594,17536
1361199413,259107312,12,7525,627.0833333,1361199386364,1361199404284,259080676,259098596,17920
1361199413,259107320,66,78419,1188.166667,1361199387827,1361199404403,259082147,259098723,16576
1361199415,1620795696,3,138,46,1361199404647,1361199410663,1620785343,1620791359,6016
1361199416,1620796936,2,265,132.5,1361199390136,1361199390264,1620771072,1620771200,128
1361199424,1620804992,12,3356,279.6666667,1361199396095,1361199396991,1620777087,1620777983,896
1361199431,1620811756,3,144,48,1361199425834,1361199425898,1620806590,1620806654,64
1361199432,1620812964,2,324,162,1361199404124,1361199422620,1620785088,1620803584,18496
1361199439,1620819716,2,92,46,1361199436372,1361199436372,1620817088,1620817088,0
1361199439,1620819728,3,169,56.33333333,1361199437319,1361199437319,1620818047,1620818047,0
1361199439,1620819760,3,169,56.33333333,1361199438312,1361199438312,1620819072,1620819072,0
1361199439,1620819764,2,92,46,1361199436322,1361199436322,1620817086,1620817086,0
1361199439,1620819772,2,123,61.5,1361199437274,1361199437274,1620818046,1620818046,0
1361199439,1620819792,161,226100,1404.347826,1361199321926,1361199438278,1620702718,1620819070,116352
1361199439,1620819792,123,168624,1370.926829,1361199321990,1361199438278,1620702782,1620819070,116288
1361199439,1620819800,3,169,56.33333333,1361199438270,1361199438270,1620819070,1620819070,0
1361199444,1620825236,2,472,236,1361199417801,1361199417865,1620799037,1620799101,64
1361199447,1620827728,2,92,46,1361199440327,1361199440327,1620821055,1620821055,0
1361199447,1620827728,2,92,46,1361199440327,1361199440327,1620821055,1620821055,0
1361199447,1620827744,249,350303,1406.839357,1361199322040,1361199439288,1620702784,1620820032,117248
1361199447,1620827808,2,92,46,1361199440246,1361199440246,1620821054,1620821054,0
1361199472,1620853180,1,134,134,1361199443906,1361199443906,1620825086,1620825086,0
1361199472,1620853228,2,265,132.5,1361199445905,1361199446033,1620827133,1620827261,128
1361199472,1620853236,2,92,46,1361199443979,1361199444043,1620825215,1620825279,64
1361199479,1620859720,4,205,51.25,1361199476366,1361199476366,1620857086,1620857086,0
1361199484,1620865232,2,472,236,1361199458382,1361199458446,1620839614,1620839678,64
1361199487,1620867760,3,144,48,1361199485799,1361199485799,1620866559,1620866559,0
1361199487,1620867828,2,92,46,1361199483234,1361199483234,1620864062,1620864062,0
1361199508,1620889340,2,324,162,1361199483810,1361199485986,1620865150,1620867326,2176
1361199511,1620891736,3,193,64.33333333,1361199510334,1361199510334,1620891070,1620891070,0
1361199524,1620905356,2,472,236,1361199498834,1361199498898,1620880190,1620880254,64
1361199526,259220784,3,138,46,1361199519587,1361199519587,259214371,259214371,0
1361199526,259220784,3,138,46,1361199519587,1361199519587,259214371,259214371,0
1361199526,259220784,3,138,46,1361199519590,1361199519590,259214374,259214374,0
1361199527,259220792,206,232396,1128.135922,1361199386884,1361199523588,259080676,259217380,136704
1361199527,259220804,3,138,46,1361199520568,1361199520568,259214372,259214372,0
1361199527,259220804,3,138,46,1361199520568,1361199520568,259214372,259214372,0
1361199528,1620909356,2,265,132.5,1361199501523,1361199501651,1620882879,1620883007,128
1361199549,1620929468,1,134,134,1361199524681,1361199524681,1620905149,1620905149,0
1361199551,1620931796,4,336,84,1361199544896,1361199545024,1620925692,1620925820,128
1361199559,259252816,2,98,49,1361199549101,1361199552877,259242917,259246693,3776
1361199559,259252816,2,98,49,1361199549100,1361199553836,259242916,259247652,4736
1361199565,1620945452,6,2176,362.6666667,1361199539610,1361199543770,1620920062,1620924222,4160
1361199567,1620947780,3,144,48,1361199560785,1361199560785,1620941565,1620941565,0
1361199567,1620947824,2,92,46,1361199558822,1361199564582,1620939646,1620945406,5760
1361199578,1620958924,2,324,162,1361199550143,1361199564223,1620931067,1620945147,14080
1361199579,1620960304,10,2105,210.5,1361199549958,1361199550470,1620931262,1620931774,512
1361199585,1620965512,2,265,132.5,1361199558108,1361199558236,1620938620,1620938748,128
1361199585,1620965520,4,2713,678.25,1361199559123,1361199559187,1620939643,1620939707,64
1361199585,259279536,40,17229,430.725,1361199557211,1361199579419,259251747,259273955,22208
1361199607,1620987764,4,312,78,1361199601184,1361199601312,1620981948,1620982076,128
1361199609,1620989688,2,472,236,1361199583659,1361199583723,1620964347,1620964411,64
1361199629,1621009612,5,3947,789.4,1361199601273,1361199601337,1620981885,1620981949,64
1361199629,1621009736,2,324,162,1361199604413,1361199614141,1620985149,1620994877,9728
1361199639,1621019888,3,144,48,1361199635681,1361199635681,1621016569,1621016569,0
1361199641,1621021636,2,265,132.5,1361199613664,1361199613728,1620994300,1620994364,64
1361199645,1621025720,2,92,46,1361199618314,1361199618378,1620999034,1620999098,64
1361199647,1621027856,3,286,95.33333333,1361199644293,1361199644357,1621025149,1621025213,64
1361199649,1621029628,2,472,236,1361199623592,1361199623720,1621004220,1621004348,128
1361199669,1621049772,8,1703,212.875,1361199644504,1361199644632,1621025276,1621025404,128
1361199671,1621051864,2,98,49,1361199658043,1361199663931,1621038907,1621044795,5888
1361199671,1621051892,4,205,51.25,1361199666911,1361199666911,1621047803,1621047803,0
1361199685,1621065732,7,1908,272.5714286,1361199658045,1361199658877,1621038777,1621039609,832
1361199689,1621069712,2,472,236,1361199663188,1361199663252,1621043900,1621043964,64
1361199697,1621077660,2,265,132.5,1361199669573,1361199669637,1621050233,1621050297,64
1361199703,1621083836,3,144,48,1361199695701,1361199695765,1621076537,1621076601,64
1361199705,1621085768,1,190,190,1361199677724,1361199677724,1621058492,1621058492,0
1361199709,1621089804,4,2713,678.25,1361199684149,1361199684405,1621064953,1621065209,256
1361199710,259403936,26,16446,632.5384615,1361199683510,1361199693174,259377446,259387110,9664
1361199718,259411840,11,3569,324.4545455,1361199691415,1361199693335,259385255,259387175,1920
1361199718,259411888,15,7946,529.7333333,1361199691367,1361199693351,259385255,259387239,1984
1361199718,259411888,11,6147,558.8181818,1361199691367,1361199693223,259385255,259387111,1856
1361199718,259411908,7,1374,196.2857143,1361199693139,1361199693267,259387047,259387175,128
1361199727,1621107864,2,98,49,1361199720121,1361199726137,1621100985,1621107001,6016
1361199729,1621109704,2,472,236,1361199703259,1361199703323,1621083963,1621084027,64
1361199749,1621129748,2,324,162,1361199724524,1361199742444,1621105272,1621123192,17920
1361199749,1621129828,2,265,132.5,1361199724509,1361199724573,1621105337,1621105401,64
1361199753,1621134060,18,21567,1198.166667,1361199728117,1361199730805,1621109177,1621111865,2688
1361199762,259455836,34,9377,275.7941176,1361199734680,1361199737624,259428516,259431460,2944
1361199762,259455840,14,2612,186.5714286,1361199734679,1361199735831,259428519,259429671,1152
1361199762,259455884,14,2615,186.7857143,1361199734634,1361199735786,259428518,259429670,1152
1361199762,259455884,21,6257,297.952381,1361199734633,1361199736233,259428517,259430117,1600
1361199769,1621149760,2,92,46,1361199744289,1361199744289,1621125049,1621125049,0
1361199769,1621149768,2,472,236,1361199743002,1361199743066,1621123770,1621123834,64
1361199775,1621155896,3,144,48,1361199770648,1361199770712,1621151544,1621151608,64
1361199789,1621169776,1,134,134,1361199764495,1361199764495,1621145271,1621145271,0
1361199805,1621185884,2,265,132.5,1361199780262,1361199780390,1621161146,1621161274,128
1361199809,1621189756,2,472,236,1361199783014,1361199783078,1621163770,1621163834,64
1361199823,1621203940,14,6603,471.6428571,1361199798762,1361199815658,1621179702,1621196598,16896
1361199825,1621205828,9,5063,562.5555556,1361199799581,1361199800541,1621180409,1621181369,960
1361199829,1621209876,9,4507,500.7777778,1361199804395,1361199821931,1621185271,1621202807,17536
1361199831,1621211920,3,144,48,1361199830657,1361199830657,1621211577,1621211577,0
1361199849,1621229784,6,4969,828.1666667,1361199823114,1361199823178,1621203898,1621203962,64
1361199849,1621229796,2,472,236,1361199823612,1361199823676,1621204408,1621204472,64
1361199849,1621229828,9,4962,551.3333333,1361199822046,1361199822110,1621202874,1621202938,64
1361199855,259548896,3,138,46,1361199851358,1361199851358,259545254,259545254,0
1361199855,259548900,3,138,46,1361199853401,1361199853401,259547301,259547301,0
1361199855,259548916,3,138,46,1361199851339,1361199851339,259545255,259545255,0
1361199855,259548916,3,138,46,1361199851338,1361199851338,259545254,259545254,0
1361199855,259548920,2,98,49,1361199849863,1361199854343,259543783,259548263,4480
1361199855,259548920,2,98,49,1361199849798,1361199853382,259543718,259547302,3584
1361199855,1621236088,29,33762,1164.206897,1361199835926,1361199851286,1621217014,1621232374,15360
1361199861,1621241836,4,552,138,1361199835989,1361199836885,1621216825,1621217721,896
1361199863,259556892,443,534244,1205.968397,1361199691364,1361199855396,259385256,259549288,164032
1361199863,1621244068,2,123,61.5,1361199860077,1361199860077,1621241145,1621241145,0
1361199869,1621249868,1,134,134,1361199844403,1361199844403,1621225271,1621225271,0
1361199873,1621253816,13,2848,219.0769231,1361199845097,1361199851241,1621225913,1621232057,6144
1361199889,1621269928,2,472,236,1361199863671,1361199863735,1621244599,1621244663,64
1361199895,1621276104,3,144,48,1361199890438,1361199890502,1621271542,1621271606,64
1361199897,1621277924,6,3653,608.8333333,1361199869499,1361199884411,1621250423,1621265335,14912
1361199901,1621281920,6,4964,827.3333333,1361199873597,1361199873661,1621254517,1621254581,64
1361199913,1621293892,1,46,46,1361199888283,1361199888283,1621269175,1621269175,0
1361199917,1621297972,2,265,132.5,1361199892619,1361199892683,1621273591,1621273655,64
1361199929,1621309948,2,472,236,1361199903267,1361199903395,1621284215,1621284343,128
1361199943,1621324120,3,169,56.33333333,1361199937783,1361199937783,1621318903,1621318903,0
1361199949,1621330020,2,324,162,1361199924314,1361199939354,1621305334,1621320374,15040
1361199967,1621348104,3,144,48,1361199965446,1361199965510,1621346550,1621346614,64
1361199967,1621348140,5,408,81.6,1361199964193,1361199964257,1621345333,1621345397,64
1361199969,1621350016,2,472,236,1361199943456,1361199943520,1621324472,1621324536,64
1361199973,1621354036,4,552,138,1361199948425,1361199953225,1621329461,1621334261,4800
1361199975,1621356068,4,205,51.25,1361199966953,1361199966953,1621348021,1621348021,0
1361199975,1621356112,30,33408,1113.6,1361199952444,1361199967868,1621333556,1621348980,15424
1361199989,1621370128,5,1443,288.6,1361199964268,1361199964396,1621345396,1621345524,128
1361199999,1621380112,11,5602,509.2727273,1361199980541,1361199996221,1621361653,1621377333,15680
1361200007,1621388096,4,312,78,1361200001100,1361200001164,1621382196,1621382260,64
1361200007,1621388104,4,312,78,1361200001734,1361200001798,1621382838,1621382902,64
1361200007,1621388112,2,98,49,1361199998718,1361200004670,1621379830,1621385782,5952
1361200007,1621388112,2,98,49,1361199998718,1361200004670,1621379830,1621385782,5952
1361200007,1621388140,4,312,78,1361200001058,1361200001122,1621382198,1621382262,64
1361200007,1621388144,4,312,78,1361200001502,1361200001566,1621382646,1621382710,64
1361200007,1621388144,14,16191,1156.5,1361200001628,1361200001884,1621382772,1621383028,256
1361200009,1621390036,2,472,236,1361199983435,1361199983499,1621364471,1621364535,64
1361200015,1621396148,4,196,49,1361200001624,1361200007640,1621382772,1621388788,6016
1361200015,1621396184,2,98,49,1361200002421,1361200007605,1621383605,1621388789,5184
1361200017,1621398148,80,73816,922.7,1361199991770,1361199998874,1621372918,1621380022,7104
1361200017,1621398192,1,46,46,1361199988910,1361199988910,1621370102,1621370102,0
1361200025,1621406108,7,2540,362.8571429,1361199998978,1361199999106,1621380086,1621380214,128
1361200025,1621406232,14,8824,630.2857143,1361199998596,1361200002436,1621379828,1621383668,3840
1361200025,1621406236,8,5686,710.75,1361199998529,1361199998785,1621379765,1621380021,256
1361200025,1621406236,8,5520,690,1361199998593,1361200001793,1621379829,1621383029,3200
1361200029,1621410140,8,5426,678.25,1361200001570,1361200002338,1621382710,1621383478,768
1361200029,1621410144,5,703,140.6,1361200001886,1361200002398,1621383030,1621383542,512
1361200029,1621410144,9,10168,1129.777778,1361200001949,1361200002397,1621383093,1621383541,448
1361200029,1621410144,11,12876,1170.545455,1361200002075,1361200002395,1621383219,1621383539,320
1361200029,1621410148,38,52157,1372.552632,1361200002139,1361200002523,1621383287,1621383671,384
1361200029,1621410172,1,190,190,1361200003264,1361200003264,1621384436,1621384436,0
1361200029,1621410220,3,720,240,1361200001361,1361200001425,1621382581,1621382645,64
1361200029,1621410228,4,504,126,1361200001994,1361200002570,1621383222,1621383798,576
1361200031,1621412116,3,144,48,1361200025466,1361200025466,1621406582,1621406582,0
1361200037,1621418224,2,265,132.5,1361200008908,1361200009036,1621390132,1621390260,128
1361200034,259728296,116,141578,1220.5,1361199734226,1361199735890,259428522,259430186,1664
1361200049,1621430228,2,472,236,1361200022602,1361200022666,1621403830,1621403894,64
1361200055,1621436204,3,169,56.33333333,1361200043361,1361200051361,1621424565,1621432565,8000
1361200069,1621450168,1,77,77,1361200043395,1361200043395,1621424563,1621424563,0
1361200069,1621450256,3,436,145.3333333,1361200044141,1361200066925,1621425397,1621448181,22784
1361200071,1621452156,3,200,66.66666667,1361200058386,1361200063378,1621439542,1621444534,4992
1361200087,1621468144,3,144,48,1361200085403,1361200085467,1621466547,1621466611,64
1361200089,1621470108,2,92,46,1361200061120,1361200061120,1621442228,1621442228,0
1361200089,1621470112,2,472,236,1361200063355,1361200063419,1621444467,1621444531,64
1361200089,1621470116,2,92,46,1361200061433,1361200061433,1621442549,1621442549,0
1361200089,1621470200,2,92,46,1361200061987,1361200062051,1621443187,1621443251,64
1361200089,1621470240,2,265,132.5,1361200064702,1361200064766,1621445942,1621446006,64
1361200110,1621490552,1,134,134,1361200084842,1361200084842,1621465394,1621465394,0
1361200114,1621494468,1,77,77,1361200089088,1361200089088,1621469556,1621469556,0
1361200119,1621500112,14,6597,471.2142857,1361200099132,1361200118396,1621480244,1621499508,19264
1361200126,1621506472,1,46,46,1361200101500,1361200101500,1621481972,1621481972,0
1361200126,1621506512,9,5063,562.5555556,1361200100306,1361200103506,1621480818,1621484018,3200
1361200130,1621510500,2,472,236,1361200104033,1361200104161,1621484533,1621484661,128
1361200135,1621516140,6,366,61,1361200133408,1361200133472,1621514548,1621514612,64
1361200142,1621522484,1,46,46,1361200114289,1361200114289,1621494773,1621494773,0
1361200142,1621522524,1,46,46,1361200117254,1361200117254,1621497778,1621497778,0
1361200143,1621524176,29,33756,1164,1361200120253,1361200135613,1621501429,1621516789,15360
1361200146,1621526448,1,46,46,1361200118293,1361200118293,1621498741,1621498741,0
1361200146,1621526448,1,46,46,1361200118357,1361200118357,1621498805,1621498805,0
1361200146,1621526448,1,46,46,1361200118292,1361200118292,1621498740,1621498740,0
1361200146,1621526524,1,46,46,1361200118217,1361200118217,1621498741,1621498741,0
1361200146,1621526524,1,46,46,1361200118280,1361200118280,1621498804,1621498804,0
1361200146,1621526532,4,552,138,1361200120703,1361200121535,1621501235,1621502067,832
1361200150,1621530480,2,324,162,1361200124914,1361200132146,1621505394,1621512626,7232
1361200167,259860968,2,98,49,1361200160792,1361200165592,259854760,259859560,4800
1361200167,259860988,2,98,49,1361200160771,1361200164547,259854759,259858535,3776
1361200167,1621548200,2,123,61.5,1361200162596,1361200162596,1621543796,1621543796,0
1361200167,1621548232,3,144,48,1361200160322,1361200160386,1621541554,1621541618,64
1361200170,1621550476,2,472,236,1361200144055,1361200144119,1621524531,1621524595,64
1361200182,1621562588,10,2124,212.4,1361200155590,1361200156038,1621536178,1621536626,448
1361200190,1621570564,1,134,134,1361200164832,1361200164832,1621545396,1621545396,0
1361200202,1621582672,2,265,132.5,1361200176881,1361200177009,1621557553,1621557681,128
1361200210,1621590568,2,472,236,1361200183452,1361200183516,1621564020,1621564084,64
1361200214,1621594628,1,46,46,1361200188575,1361200188575,1621569203,1621569203,0
1361200214,1621594628,1,46,46,1361200188574,1361200188574,1621569202,1621569202,0
1361200215,1621596284,14,6597,471.2142857,1361200191376,1361200208016,1621572660,1621589300,16640
1361200218,1621598536,10,5115,511.5,1361200192635,1361200193467,1621573171,1621574003,832
1361200223,1621604312,3,144,48,1361200220274,1361200220274,1621601586,1621601586,0
1361200226,1621606544,1,190,190,1361200198194,1361200198194,1621578738,1621578738,0
1361200246,1621626576,1,46,46,1361200221395,1361200221395,1621601971,1621601971,0
1361200250,1621630632,2,472,236,1361200223386,1361200223450,1621604018,1621604082,64
1361200255,1621636336,2,123,61.5,1361200252442,1361200252442,1621633778,1621633778,0
1361200255,1621636376,29,33756,1164,1361200232368,1361200247728,1621613744,1621629104,15360
1361200258,1621638952,4,552,138,1361200232602,1361200233370,1621613554,1621614322,768
1361200270,1621651016,1,134,134,1361200244443,1361200244443,1621625459,1621625459,0
1361200271,1621652388,4,205,51.25,1361200270822,1361200270822,1621652210,1621652210,0
1361200290,1621671040,2,472,236,1361200262720,1361200262784,1621643760,1621643824,64
1361200303,1621684392,3,144,48,1361200295136,1361200295200,1621676528,1621676592,64
1361200310,1621691028,1,190,190,1361200282510,1361200282510,1621663538,1621663538,0
1361200314,1621695064,2,265,132.5,1361200288423,1361200288551,1621669487,1621669615,128
1361200327,1621708424,3,286,95.33333333,1361200324034,1361200324098,1621705458,1621705522,64
1361200330,1621710980,2,472,236,1361200302972,1361200303036,1621683952,1621684016,64
1361200334,1621715004,1,46,46,1361200308197,1361200308197,1621689201,1621689201,0
1361200350,1621731008,12,7312,609.3333333,1361200324511,1361200326431,1621705519,1621707439,1920
1361200350,1621731020,6,913,152.1666667,1361200325138,1361200325458,1621706158,1621706478,320
1361200351,1621732348,30,33786,1126.2,1361200329996,1361200349516,1621711344,1621730864,19520
1361200352,1621732432,17,7875,463.2352941,1361200329057,1361200349025,1621709489,1621729457,19968
1361200354,1621735100,10,5109,510.9,1361200328965,1361200349125,1621710065,1621730225,20160
1361200358,1621738988,4,574,143.5,1361200330229,1361200350517,1621711217,1621731505,20288
1361200359,1621740424,3,144,48,1361200355199,1361200355263,1621736623,1621736687,64
1361200366,1621746980,3,1384,461.3333333,1361200338429,1361200362813,1621719409,1621743793,24384
1361200367,1621748348,30,33792,1126.4,1361200349516,1361200364876,1621730864,1621746224,15360
1361200367,1621748388,15,7288,485.8666667,1361200348066,1361200364578,1621729454,1621745966,16512
1361200368,1621748432,4,292,73,1361200361377,1361200361505,1621741809,1621741937,128
1361200370,1621751016,2,472,236,1361200343447,1361200343511,1621724463,1621724527,64
1361200375,1621756388,4,292,73,1361200371875,1361200372003,1621753263,1621753391,128
1361200390,1621771068,1,134,134,1361200364387,1361200364387,1621745455,1621745455,0
1361200394,1621775104,3,3834,1278,1361200366207,1361200385023,1621747311,1621766127,18816
1361200410,1621791344,2,472,236,1361200382670,1361200382734,1621764014,1621764078,64
1361200416,1621796464,2,123,61.5,1361200409726,1361200409726,1621790190,1621790190,0
1361200418,1621799320,2,324,162,1361200391206,1361200404198,1621772526,1621785518,12992
1361200430,1621811328,2,265,132.5,1361200405790,1361200405854,1621787118,1621787182,64
1361200431,1621812388,3,144,48,1361200430178,1361200430178,1621811566,1621811566,0
1361200448,1621828472,4,205,51.25,1361200441080,1361200441080,1621821552,1621821552,0
1361200450,1621831440,2,472,236,1361200422703,1361200422767,1621804143,1621804207,64
1361200455,1621835468,1,46,46,1361200428730,1361200428730,1621809198,1621809198,0
1361200470,1621851436,2,324,162,1361200444081,1361200455921,1621825517,1621837357,11840
1361200472,1621852476,4,336,84,1361200471665,1361200471729,1621852141,1621852205,64
1361200479,260172864,2,98,49,1361200470916,1361200474308,260164780,260168172,3392
1361200479,260173080,2,98,49,1361200470699,1361200475115,260164779,260169195,4416
1361200482,1621863424,10,1925,192.5,1361200455360,1361200455808,1621836784,1621837232,448
1361200487,1621867468,5,922,184.4,1361200462140,1361200465916,1621842608,1621846384,3776
1361200491,1621871508,4,1324,331,1361200463696,1361200464592,1621844204,1621845100,896
1361200496,1621876448,3,144,48,1361200491086,1361200492302,1621871534,1621872750,1216
1361200510,1621891464,1,134,134,1361200484053,1361200484053,1621865517,1621865517,0
1361200530,1621911460,2,472,236,1361200503576,1361200503640,1621885036,1621885100,64
1361200547,1621927516,1,190,190,1361200521227,1361200521227,1621901743,1621901743,0
1361200547,1621927604,2,265,132.5,1361200521395,1361200521459,1621901999,1621902063,64
1361200551,1621932464,3,144,48,1361200550102,1361200550102,1621931566,1621931566,0
1361200571,1621951872,2,472,236,1361200543974,1361200544038,1621924846,1621924910,64
1361200576,1621956560,4,442,110.5,1361200575006,1361200575070,1621955566,1621955630,64
1361200576,1621956568,4,205,51.25,1361200572244,1361200572244,1621952812,1621952812,0
1361200579,1621959900,1,56,56,1361200552521,1361200552521,1621933421,1621933421,0
1361200591,1621972224,2,324,162,1361200564293,1361200584261,1621945517,1621965485,19968
1361200603,1621983820,2,265,132.5,1361200577242,1361200577370,1621958062,1621958190,128
1361200611,1621991796,2,472,236,1361200584497,1361200584561,1621965293,1621965357,64
1361200616,1621996556,3,144,48,1361200613344,1361200613344,1621993900,1621993900,0
1361200624,1622004564,4,313,78.25,1361200618647,1361200618711,1621999211,1621999275,64
1361200624,1622004568,2,98,49,1361200613717,1361200619349,1621994285,1621999917,5632
1361200624,1622004568,2,98,49,1361200613717,1361200619349,1621994285,1621999917,5632
1361200624,1622004616,2,98,49,1361200613667,1361200619299,1621994283,1621999915,5632
1361200627,1622007944,64,66160,1033.75,1361200602718,1361200612190,1621983662,1621993134,9472
1361200631,1622011816,1,134,134,1361200604765,1361200604765,1621985581,1621985581,0
1361200632,1622012588,93,130831,1406.784946,1361200619008,1361200625152,1621999596,1622005740,6144
1361200632,1622012588,20,20217,1010.85,1361200619008,1361200625088,1621999596,1622005676,6080
1361200632,1622012628,38,41245,1085.394737,1361200618520,1361200624856,1621999148,1622005484,6336
1361200632,1622012628,34,41492,1220.352941,1361200618518,1361200624726,1621999146,1622005354,6208
1361200632,1622012632,19,18625,980.2631579,1361200618964,1361200624788,1621999596,1622005420,5824
1361200632,1622012632,30,36975,1232.5,1361200618964,1361200624788,1621999596,1622005420,5824
1361200639,1622019868,8,5059,632.375,1361200613417,1361200619689,1621994285,1622000557,6272
1361200639,1622019868,8,5783,722.875,1361200613417,1361200637865,1621994285,1622018733,24448
1361200639,1622019908,9,5654,628.2222222,1361200611967,1361200612287,1621992875,1621993195,320
1361200639,1622019912,5,437,87.4,1361200612222,1361200612350,1621993134,1621993262,128
1361200640,1622020584,4,312,78,1361200636674,1361200636738,1622017258,1622017322,64
1361200643,1622023936,3,736,245.3333333,1361200617570,1361200617634,1621998506,1621998570,64
1361200643,1622023936,11,8468,769.8181818,1361200617699,1361200637283,1621998635,1622018219,19584
1361200648,1622028544,5,408,81.6,1361200645037,1361200645037,1622025581,1622025581,0
1361200651,1622031908,2,472,236,1361200624321,1361200624449,1622005229,1622005357,128
1361200656,1622036612,5,818,163.6,1361200636582,1361200651750,1622017194,1622032362,15168
1361200659,1622039948,2,265,132.5,1361200632665,1361200632793,1622013613,1622013741,128
1361200663,1622043868,22,23369,1062.227273,1361200636712,1361200637352,1622017580,1622018220,640
1361200663,1622043888,3,474,158,1361200637204,1361200637268,1622018092,1622018156,64
1361200663,1622043976,4,1383,345.75,1361200637114,1361200637178,1622018090,1622018154,64
1361200671,1622051976,10,1954,195.4,1361200644666,1361200648314,1622025642,1622029290,3648
1361200672,1622052628,4,215,53.75,1361200656982,1361200665942,1622037610,1622046570,8960
1361200672,1622052644,3,144,48,1361200670920,1361200670920,1622051564,1622051564,0
1361200680,1622060612,3,200,66.66666667,1361200671911,1361200676903,1622052523,1622057515,4992
1361200683,1622063912,1,77,77,1361200656701,1361200656701,1622037613,1622037613,0
1361200691,1622071996,2,472,236,1361200664358,1361200664422,1622045354,1622045418,64
1361200695,1622075896,2,92,46,1361200667277,1361200667341,1622048173,1622048237,64
1361200695,1622075972,2,92,46,1361200667197,1361200667261,1622048169,1622048233,64
1361200695,1622075972,2,92,46,1361200667201,1361200667265,1622048173,1622048237,64
1361200707,1622087916,2,92,46,1361200679029,1361200679029,1622059945,1622059945,0
1361200711,1622091932,1,134,134,1361200684648,1361200684648,1622065580,1622065580,0
1361200715,1622096004,2,265,132.5,1361200688287,1361200688351,1622069291,1622069355,64
1361200723,1622104260,2,92,46,1361200696671,1361200696735,1622077931,1622077995,64
1361200723,1622104316,2,92,46,1361200696230,1361200696230,1622077546,1622077546,0
1361200727,1622108252,1,77,77,1361200701349,1361200701349,1622082601,1622082601,0
1361200731,1622112320,2,472,236,1361200703459,1361200703523,1622084779,1622084843,64
1361200739,1622120296,2,324,162,1361200711546,1361200724282,1622092842,1622105578,12736
1361200751,1622132300,1,46,46,1361200726327,1361200726327,1622107627,1622107627,0
1361200752,1622132572,11,953,86.63636364,1361200739983,1361200751311,1622120555,1622131883,11328
1361200752,1622132572,12,999,83.25,1361200740237,1361200751309,1622120809,1622131881,11072
1361200752,1622132588,3,144,48,1361200745980,1361200745980,1622126568,1622126568,0
1361200752,1622132612,5,320,64,1361200746982,1361200747046,1622127594,1622127658,64
1361200752,1622132616,12,999,83.25,1361200739618,1361200751266,1622120234,1622131882,11648
1361200752,1622132656,15,6289,419.2666667,1361200739129,1361200751225,1622119785,1622131881,12096
1361200759,1622140356,1,46,46,1361200732284,1361200732284,1622113640,1622113640,0
1361200760,1622140580,2,98,49,1361200753925,1361200759557,1622134505,1622140137,5632
1361200760,1622140580,4,312,78,1361200754053,1361200754117,1622134633,1622134697,64
1361200760,1622140648,4,313,78.25,1361200753538,1361200753602,1622134186,1622134250,64
1361200760,1622140652,4,312,78,1361200753920,1361200754048,1622134572,1622134700,128
1361200768,1622148628,12,10603,883.5833333,1361200753495,1361200764311,1622134123,1622144939,10816
1361200772,1622152496,2,472,236,1361200744217,1361200744281,1622124713,1622124777,64
1361200772,1622152500,2,265,132.5,1361200743957,1361200744085,1622124457,1622124585,128
1361200780,1622160536,4,2703,675.75,1361200753971,1361200754099,1622134507,1622134635,128
1361200780,1622160540,4,1278,319.5,1361200754156,1361200754540,1622134696,1622135080,384
1361200780,1622160608,4,498,124.5,1361200753769,1361200753961,1622134377,1622134569,192
1361200780,1622160608,4,2530,632.5,1361200753896,1361200754088,1622134504,1622134696,192
1361200780,1622160612,4,930,232.5,1361200753895,1361200753959,1622134507,1622134571,64
1361200784,1622164496,11,2206,200.5454545,1361200756824,1361200757272,1622137320,1622137768,448
1361200791,260485424,2,98,49,1361200781333,1361200786261,260475757,260480685,4928
1361200791,260485424,2,98,49,1361200781332,1361200785300,260475756,260479724,3968
1361200792,1622172508,2,324,162,1361200765131,1361200776459,1622145639,1622156967,11328
1361200800,1622180792,6,3776,629.3333333,1361200799538,1361200799666,1622180330,1622180458,128
1361200800,1622180792,4,312,78,1361200799729,1361200799793,1622180521,1622180585,64
1361200800,1622180800,9,2876,319.5555556,1361200788649,1361200793833,1622169449,1622174633,5184
1361200800,1622180800,4,312,78,1361200799592,1361200799656,1622180392,1622180456,64
1361200800,1622180836,4,190,47.5,1361200790534,1361200795846,1622171370,1622176682,5312
1361200807,260501428,3,144,48,1361200800976,1361200806672,260495404,260501100,5696
1361200808,1622188768,5,1010,202,1361200799753,1361200801801,1622180521,1622182569,2048
1361200808,1622188768,7,3705,529.2857143,1361200799753,1361200801801,1622180521,1622182569,2048
1361200808,1622188768,2,98,49,1361200799816,1361200805832,1622180584,1622186600,6016
1361200808,1622188772,5,1104,220.8,1361200800454,1361200801798,1622181226,1622182570,1344
1361200808,1622188772,4,670,167.5,1361200800454,1361200801798,1622181226,1622182570,1344
1361200808,1622188772,4,577,144.25,1361200800454,1361200801798,1622181226,1622182570,1344
1361200808,1622188772,3,642,214,1361200800772,1361200800836,1622181544,1622181608,64
1361200808,1622188776,4,312,78,1361200800835,1361200800899,1622181611,1622181675,64
1361200808,1622188776,2,98,49,1361200800962,1361200806850,1622181738,1622187626,5888
1361200808,1622188776,4,312,78,1361200800962,1361200801090,1622181738,1622181866,128
1361200808,1622188776,4,1580,395,1361200801217,1361200801281,1622181993,1622182057,64
1361200808,1622188816,3,140,46.66666667,1361200799640,1361200804760,1622180456,1622185576,5120
1361200808,1622188820,4,312,78,1361200799699,1361200799827,1622180519,1622180647,128
1361200808,1622188820,4,312,78,1361200799767,1361200799895,1622180587,1622180715,128
1361200808,1622188820,4,670,167.5,1361200800404,1361200801748,1622181224,1622182568,1344
1361200808,1622188824,5,3365,673,1361200800723,1361200800851,1622181547,1622181675,128
1361200808,1622188824,4,312,78,1361200800786,1361200800850,1622181610,1622181674,64
1361200808,1622188848,4,312,78,1361200801211,1361200801275,1622182059,1622182123,64
1361200808,1622188848,3,140,46.66666667,1361200801210,1361200806714,1622182058,1622187562,5504
1361200808,1622188856,3,144,48,1361200805682,1361200805746,1622186538,1622186602,64
1361200808,1622188864,3,144,48,1361200799467,1361200804715,1622180331,1622185579,5248
1361200812,1622192628,2,472,236,1361200784725,1361200784789,1622165353,1622165417,64
1361200816,1622196540,12,8742,728.5,1361200789037,1361200792045,1622169577,1622172585,3008
1361200816,1622196568,4,2454,613.5,1361200789905,1361200790097,1622170473,1622170665,192
1361200816,1622196576,10,8236,823.6,1361200790983,1361200800903,1622171559,1622181479,9920
1361200816,1622196612,5,437,87.4,1361200788837,1361200789029,1622169449,1622169641,192
1361200816,1622196652,7,4303,614.7142857,1361200789823,1361200801663,1622170475,1622182315,11840
1361200816,1622196820,5,894,178.8,1361200800853,1361200810965,1622181673,1622191785,10112
1361200824,1622204584,3,755,251.6666667,1361200798721,1361200798721,1622179305,1622179305,0
1361200824,1622204672,2,265,132.5,1361200798954,1361200799018,1622179626,1622179690,64
1361200828,1622208652,5,701,140.2,1361200799804,1361200800060,1622180456,1622180712,256
1361200828,1622208656,1,416,416,1361200799930,1361200799930,1622180586,1622180586,0
1361200828,1622208656,16,13463,841.4375,1361200799930,1361200801146,1622180586,1622181802,1216
1361200832,1622212540,1,134,134,1361200805100,1361200805100,1622185640,1622185640,0
1361200832,1622212660,2,583,291.5,1361200805939,1361200806131,1622186599,1622186791,192
1361200848,1622228780,3,169,56.33333333,1361200833789,1361200841789,1622214569,1622222569,8000
1361200852,1622232560,2,472,236,1361200824858,1361200824922,1622205418,1622205482,64
1361200864,1622244828,3,200,66.66666667,1361200851213,1361200856205,1622232041,1622237033,4992
1361200868,1622248676,1,190,190,1361200841509,1361200841509,1622222185,1622222185,0
1361200872,1622252856,29,33362,1150.413793,1361200854769,1361200870129,1622235625,1622250985,15360
1361200876,1622256652,2,92,46,1361200849275,1361200849339,1622229927,1622229991,64
1361200880,1622260716,2,287,143.5,1361200854843,1361200855547,1622235559,1622236263,704
1361200884,1622264752,2,92,46,1361200859801,1361200859801,1622240553,1622240553,0
1361200888,1622268772,2,92,46,1361200861124,1361200861188,1622241896,1622241960,64
1361200888,1622268952,3,144,48,1361200880591,1361200880655,1622261543,1622261607,64
1361200892,1622272768,2,472,236,1361200864646,1361200864710,1622245414,1622245478,64
1361200896,1622276700,1,46,46,1361200869898,1361200869898,1622250598,1622250598,0
1361200896,1622276784,1,46,46,1361200868790,1361200868790,1622249574,1622249574,0
1361200896,1622276864,1,46,46,1361200869735,1361200869735,1622250599,1622250599,0
1361200912,1622292720,2,324,162,1361200884919,1361200905271,1622265639,1622285991,20352
1361200928,1622308988,4,312,78,1361200920107,1361200920171,1622301095,1622301159,64
1361200928,1622308988,4,312,78,1361200920234,1361200920362,1622301222,1622301350,128
1361200928,1622308996,4,205,51.25,1361200921634,1361200921634,1622302630,1622302630,0
1361200928,1622309040,4,312,78,1361200920247,1361200920311,1622301287,1622301351,64
1361200928,1622309040,4,312,78,1361200920311,1361200920439,1622301351,1622301479,128
1361200928,1622309040,4,312,78,1361200920374,1361200920438,1622301414,1622301478,64
1361200932,1622312796,2,472,236,1361200904554,1361200904618,1622285350,1622285414,64
1361200936,1622316844,2,265,132.5,1361200910586,1361200910714,1622291430,1622291558,128
1361200940,1622320836,1,46,46,1361200914756,1361200914756,1622295592,1622295592,0
1361200940,1622320908,1,46,46,1361200913659,1361200913659,1622294567,1622294567,0
1361200940,1622320948,1,46,46,1361200915605,1361200915605,1622296553,1622296553,0
1361200944,1622324804,1,46,46,1361200916771,1361200916771,1622297575,1622297575,0
1361200948,1622328804,19,21557,1134.578947,1361200920226,1361200920610,1622301030,1622301414,384
1361200948,1622328884,3,1192,397.3333333,1361200920020,1361200920084,1622300904,1622300968,64
1361200952,1622332892,1,134,134,1361200924810,1361200924810,1622305702,1622305702,0
1361200960,1622341100,3,144,48,1361200955450,1361200955450,1622336550,1622336550,0
1361200968,1622349108,5,408,81.6,1361200964595,1361200964595,1622345703,1622345703,0
1361200972,1622352912,2,472,236,1361200943863,1361200943927,1622324775,1622324839,64
1361200976,1622356952,1,46,46,1361200950030,1361200950030,1622330982,1622330982,0
1361200992,1622372864,2,265,132.5,1361200966567,1361200966631,1622347431,1622347495,64
1361200992,1622372908,10,1954,195.4,1361200964796,1361200968636,1622345704,1622349544,3840
1361201012,1622392912,2,472,236,1361200984119,1361200984183,1622365031,1622365095,64
1361201016,1622397260,3,144,48,1361201015323,1361201015323,1622396583,1622396583,0
1361201024,1622405232,4,891,222.75,1361201021300,1361201021428,1622402532,1622402660,128
1361201032,1622412904,1,134,134,1361201004796,1361201004796,1622385700,1622385700,0
1361201048,1622429240,2,265,132.5,1361201021741,1361201021805,1622402981,1622403045,64
1361201052,1622433244,2,472,236,1361201024232,1361201024296,1622405476,1622405540,64
1361201060,1622441232,1,46,46,1361201035507,1361201035507,1622416739,1622416739,0
1361201060,1622441256,2,324,162,1361201031838,1361201044446,1622413094,1622425702,12608
1361201060,1622441340,1,46,46,1361201035402,1361201035402,1622416742,1622416742,0
1361201080,1622461408,4,190,47.5,1361201076550,1361201077382,1622457958,1622458790,832
1361201080,1622461416,4,190,47.5,1361201077115,1361201079355,1622458531,1622460771,2240
1361201080,1622461416,4,190,47.5,1361201077119,1361201077375,1622458535,1622458791,256
1361201080,1622461416,4,190,47.5,1361201077435,1361201077691,1622458851,1622459107,256
1361201081,1622461444,4,190,47.5,1361201079946,1361201080202,1622460390,1622460646,256
1361201081,1622461452,4,190,47.5,1361201077377,1361201077953,1622457829,1622458405,576
1361201081,1622461452,4,190,47.5,1361201077504,1361201078400,1622457956,1622458852,896
1361201081,1622461452,4,190,47.5,1361201077567,1361201078463,1622458019,1622458915,896
1361201081,1622461480,4,190,47.5,1361201078115,1361201078371,1622458595,1622458851,256
1361201081,1622461480,4,190,47.5,1361201078309,1361201078629,1622458789,1622459109,320
1361201084,1622465308,13,4245,326.5384615,1361201056615,1361201057127,1622437923,1622438435,512
1361201088,1622469400,4,190,47.5,1361201083915,1361201086091,1622465315,1622467491,2176
1361201088,1622469404,4,190,47.5,1361201083975,1361201086087,1622465379,1622467491,2112
1361201088,1622469420,4,190,47.5,1361201077690,1361201083002,1622459110,1622464422,5312
1361201088,1622469420,4,190,47.5,1361201085882,1361201086330,1622467302,1622467750,448
1361201089,1622469440,4,190,47.5,1361201078668,1361201083916,1622459108,1622464356,5248
1361201089,1622469444,4,190,47.5,1361201087115,1361201087243,1622467559,1622467687,128
1361201089,1622469444,4,190,47.5,1361201087497,1361201087561,1622467941,1622468005,64
1361201089,1622469444,4,190,47.5,1361201087432,1361201087496,1622467876,1622467940,64
1361201089,1622469444,4,190,47.5,1361201087495,1361201087623,1622467939,1622468067,128
1361201089,1622469448,4,190,47.5,1361201087683,1361201088067,1622468131,1622468515,384
1361201089,1622469448,4,190,47.5,1361201084611,1361201086723,1622465059,1622467171,2112
1361201089,1622469448,4,190,47.5,1361201088070,1361201088390,1622468518,1622468838,320
1361201089,1622469448,4,190,47.5,1361201088134,1361201088454,1622468582,1622468902,320
1361201089,1622469448,4,190,47.5,1361201088389,1361201088709,1622468837,1622469157,320
1361201089,1622469448,4,190,47.5,1361201088389,1361201088709,1622468837,1622469157,320
1361201089,1622469448,4,190,47.5,1361201088453,1361201088773,1622468901,1622469221,320
1361201089,1622469484,4,190,47.5,1361201086688,1361201087136,1622467172,1622467620,448
1361201089,1622469488,4,190,47.5,1361201087069,1361201087581,1622467557,1622468069,512
1361201089,1622469488,4,190,47.5,1361201087133,1361201087645,1622467621,1622468133,512
1361201089,1622469488,4,190,47.5,1361201087132,1361201087644,1622467620,1622468132,512
1361201089,1622469488,4,190,47.5,1361201084315,1361201084571,1622464803,1622465059,256
1361201089,1622469488,4,190,47.5,1361201087195,1361201087259,1622467683,1622467747,64
1361201089,1622469488,4,190,47.5,1361201087451,1361201087515,1622467939,1622468003,64
1361201089,1622469492,4,190,47.5,1361201087259,1361201087387,1622467751,1622467879,128
1361201089,1622469492,4,190,47.5,1361201087386,1361201087450,1622467878,1622467942,64
1361201089,1622469492,4,190,47.5,1361201087514,1361201087578,1622468006,1622468070,64
1361201089,1622469492,4,190,47.5,1361201087450,1361201087514,1622467942,1622468006,64
1361201089,1622469492,4,190,47.5,1361201087706,1361201088026,1622468198,1622468518,320
1361201089,1622469492,4,190,47.5,1361201084441,1361201086553,1622464933,1622467045,2112
1361201089,1622469492,4,190,47.5,1361201087705,1361201088089,1622468197,1622468581,384
1361201089,1622469492,4,190,47.5,1361201080153,1361201086169,1622460645,1622466661,6016
1361201089,1622469492,4,190,47.5,1361201087641,1361201087961,1622468133,1622468453,320
1361201089,1622469492,4,190,47.5,1361201088024,1361201088344,1622468516,1622468836,320
1361201089,1622469492,4,190,47.5,1361201088344,1361201088728,1622468836,1622469220,384
1361201089,1622469492,4,190,47.5,1361201088024,1361201088344,1622468516,1622468836,320
1361201092,1622473232,2,472,236,1361201064374,1361201064438,1622445606,1622445670,64
1361201096,260789932,2,98,49,1361201088577,1361201091585,260782509,260785517,3008
1361201096,260789932,2,98,49,1361201088576,1361201092608,260782508,260786540,4032
1361201097,1622477440,3,144,48,1361201091084,1361201091148,1622471524,1622471588,64
1361201097,1622477476,4,190,47.5,1361201088681,1361201089001,1622469157,1622469477,320
1361201097,1622477476,4,190,47.5,1361201088744,1361201089064,1622469220,1622469540,320
1361201097,1622477476,4,190,47.5,1361201088680,1361201089064,1622469156,1622469540,384
1361201104,1622485332,3,144,48,1361201079441,1361201082577,1622460773,1622463909,3136
1361201105,1622485436,2,265,132.5,1361201078031,1361201078159,1622458467,1622458595,128
1361201108,1622489248,2,104,52,1361201080163,1361201086179,1622461411,1622467427,6016
1361201108,1622489368,1,52,52,1361201082988,1361201082988,1622464356,1622464356,0
1361201108,1622489372,1,52,52,1361201082985,1361201082985,1622464357,1622464357,0
1361201112,1622493256,2,324,162,1361201084444,1361201096988,1622465700,1622478244,12544
1361201112,1622493256,1,52,52,1361201084508,1361201084508,1622465764,1622465764,0
1361201112,1622493264,1,52,52,1361201085074,1361201085074,1622466338,1622466338,0
1361201112,1622493336,1,52,52,1361201084556,1361201084556,1622465892,1622465892,0
1361201112,1622493340,1,52,52,1361201084999,1361201084999,1622466339,1622466339,0
1361201132,1622513264,2,472,236,1361201104978,1361201105042,1622486242,1622486306,64
1361201137,1622517484,4,312,78,1361201133662,1361201133726,1622514146,1622514210,64
1361201152,1622533276,1,134,134,1361201124490,1361201124490,1622505766,1622505766,0
1361201153,1622533596,3,144,48,1361201150960,1361201150960,1622531556,1622531556,0
1361201160,1622541284,2,265,132.5,1361201132799,1361201132863,1622514083,1622514147,64
1361201172,1622553316,2,472,236,1361201144862,1361201144990,1622526178,1622526306,128
1361201177,1622557664,4,205,51.25,1361201173356,1361201173356,1622554020,1622554020,0
1361201189,1622569428,1,190,190,1361201161496,1361201161496,1622541924,1622541924,0
1361201213,1622593716,2,472,236,1361201185398,1361201185462,1622566114,1622566178,64
1361201217,1622597828,2,265,132.5,1361201188934,1361201189062,1622569762,1622569890,128
1361201233,1622613680,3,144,48,1361201228188,1361201228252,1622608868,1622608932,64
1361201233,1622613912,2,324,162,1361201204851,1361201227635,1622585763,1622608547,22784
1361201253,1622633916,2,472,236,1361201225646,1361201225710,1622606562,1622606626,64
1361201269,1622649912,2,265,132.5,1361201244593,1361201244721,1622625505,1622625633,128
1361201273,1622653952,1,134,134,1361201244808,1361201244808,1622625760,1622625760,0
1361201289,1622669692,3,144,48,1361201285902,1361201285902,1622666594,1622666594,0
1361201289,1622669736,3,286,95.33333333,1361201285090,1361201285090,1622665826,1622665826,0
1361201293,1622673916,2,472,236,1361201265453,1361201265517,1622646369,1622646433,64
1361201313,1622694012,14,8000,571.4285714,1361201284815,1361201291791,1622665827,1622672803,6976
1361201313,1622694020,7,1450,207.1428571,1361201285891,1361201286403,1622666911,1622667423,512
1361201325,1622705964,2,265,132.5,1361201300412,1361201300540,1622681376,1622681504,128
1361201333,1622713916,2,472,236,1361201305068,1361201305132,1622685984,1622686048,64
1361201344,261037960,8,1505,188.125,1361201336230,1361201341414,261030190,261035374,5184
1361201344,261037964,8,544,68,1361201336741,1361201342437,261030705,261036401,5696
1361201345,1622725720,6,2682,447,1361201339760,1361201339888,1622720480,1622720608,128
1361201345,1622725748,7,1459,208.4285714,1361201336148,1361201341268,1622716896,1622722016,5120
1361201345,1622725748,9,581,64.55555556,1361201336595,1361201342291,1622717343,1622723039,5696
1361201345,1622725784,8,535,66.875,1361201334193,1361201339249,1622714977,1622720033,5056
1361201345,1622725788,11,3737,339.7272727,1361201339755,1361201339883,1622720543,1622720671,128
1361201345,1622725792,4,313,78.25,1361201339754,1361201339946,1622720546,1622720738,192
1361201345,1622725824,8,535,66.875,1361201336522,1361201342218,1622717346,1622723042,5696
1361201345,1622725824,8,544,68,1361201336522,1361201342218,1622717346,1622723042,5696
1361201349,1622730244,1,134,134,1361201324581,1361201324581,1622705825,1622705825,0
1361201352,261045964,8,1505,188.125,1361201339619,1361201345443,261033583,261039407,5824
1361201352,261045984,8,1505,188.125,1361201339598,1361201345422,261033582,261039406,5824
1361201352,261045988,8,1505,188.125,1361201339597,1361201345421,261033585,261039409,5824
1361201361,1622741756,3,144,48,1361201360780,1361201360844,1622741536,1622741600,64
1361201361,1622742136,10,7094,709.4,1361201333839,1361201336207,1622714975,1622717343,2368
1361201361,1622742136,11,7694,699.4545455,1361201333839,1361201336207,1622714975,1622717343,2368
1361201361,1622742136,8,4657,582.125,1361201333839,1361201336207,1622714975,1622717343,2368
1361201361,1622742172,27,30750,1138.888889,1361201335725,1361201336301,1622716897,1622717473,576
1361201361,1622742212,7,1006,143.7142857,1361201333507,1361201333955,1622714719,1622715167,448
1361201361,1622742216,55,59269,1077.618182,1361201333503,1361201357631,1622714719,1622738847,24128
1361201361,1622742216,12,11109,925.75,1361201333761,1361201336129,1622714977,1622717345,2368
1361201361,1622742216,10,7494,749.4,1361201333761,1361201336129,1622714977,1622717345,2368
1361201361,1622742216,10,7611,761.1,1361201333761,1361201336193,1622714977,1622717409,2432
1361201361,1622742216,8,4162,520.25,1361201333761,1361201333825,1622714977,1622715041,64
1361201361,1622742256,7,3698,528.2857143,1361201335640,1361201336280,1622716896,1622717536,640
1361201361,1622742256,21,22901,1090.52381,1361201335704,1361201336216,1622716960,1622717472,512
1361201364,261058108,6,2462,410.3333333,1361201336594,1361201336658,261030702,261030766,64
1361201364,261058108,6,3203,533.8333333,1361201336598,1361201336854,261030706,261030962,256
1361201364,261058136,7,5058,722.5714286,1361201339446,1361201339510,261033582,261033646,64
1361201364,261058144,6,3119,519.8333333,1361201335986,1361201336306,261030130,261030450,320
1361201364,261058144,11,8739,794.4545455,1361201335985,1361201336561,261030129,261030705,576
1361201364,261058144,6,2078,346.3333333,1361201336559,1361201336623,261030703,261030767,64
1361201364,261058144,6,3011,501.8333333,1361201336559,1361201336815,261030703,261030959,256
1361201364,261058144,6,1902,317,1361201336559,1361201336623,261030703,261030767,64
1361201364,261058184,10,8802,880.2,1361201339401,1361201339465,261033585,261033649,64
1361201364,261058184,11,10338,939.8181818,1361201339401,1361201339465,261033585,261033649,64
1361201365,1622746188,16,3535,220.9375,1361201339163,1361201339419,1622720351,1622720607,256
1361201365,1622746188,8,4086,510.75,1361201339227,1361201339547,1622720415,1622720735,320
1361201369,1622750204,2,472,236,1361201344716,1361201344780,1622725920,1622725984,64
1361201377,1622757844,11,5666,515.0909091,1361201360050,1361201375410,1622740894,1622756254,15360
1361201377,1622758156,1,46,46,1361201349499,1361201349499,1622730655,1622730655,0
1361201377,1622758224,1,46,46,1361201348918,1361201348918,1622730142,1622730142,0
1361201381,1622762204,2,265,132.5,1361201356173,1361201356301,1622737377,1622737505,128
1361201381,1622762272,1,190,190,1361201355273,1361201355273,1622736545,1622736545,0
1361201408,261102260,3,144,48,1361201398206,1361201402302,261092466,261096562,4096
1361201408,261102264,2,98,49,1361201398202,1361201401274,261092466,261095538,3072
1361201409,1622789800,2,123,61.5,1361201399521,1361201404577,1622780321,1622785377,5056
1361201409,1622790340,2,154,77,1361201384260,1361201384516,1622765600,1622765856,256
1361201413,1622794208,2,472,236,1361201384905,1361201384969,1622766113,1622766177,64
1361201429,1622810296,2,324,162,1361201404528,1361201420400,1622785824,1622801696,15872
1361201437,1622818360,2,265,132.5,1361201411886,1361201412014,1622793246,1622793374,128
1361201441,1622821740,2,123,61.5,1361201434650,1361201434650,1622815390,1622815390,0
1361201441,1622821740,2,123,61.5,1361201434649,1361201434649,1622815389,1622815389,0
1361201441,1622821788,2,123,61.5,1361201434602,1361201434602,1622815390,1622815390,0
1361201441,1622821804,2,123,61.5,1361201434586,1361201434586,1622815390,1622815390,0
1361201441,1622821812,3,144,48,1361201435733,1361201435797,1622816545,1622816609,64
1361201453,1622834312,2,472,236,1361201424993,1361201425057,1622806305,1622806369,64
1361201456,261150192,3,169,56.33333333,1361201452226,1361201452226,261146418,261146418,0
1361201456,261150192,3,169,56.33333333,1361201452225,1361201452225,261146417,261146417,0
1361201456,261150200,3,169,56.33333333,1361201451257,1361201451257,261145457,261145457,0
1361201456,261150200,2,123,61.5,1361201455288,1361201455288,261149488,261149488,0
1361201456,261150200,3,169,56.33333333,1361201455287,1361201455287,261149487,261149487,0
1361201456,261150204,3,169,56.33333333,1361201452213,1361201452213,261146417,261146417,0
1361201456,261150204,3,169,56.33333333,1361201452213,1361201452213,261146417,261146417,0
1361201456,261150204,3,169,56.33333333,1361201452213,1361201452213,261146417,261146417,0
1361201456,261150204,2,123,61.5,1361201452213,1361201452213,261146417,261146417,0
1361201456,261150228,3,169,56.33333333,1361201455262,1361201455262,261149490,261149490,0
1361201457,1622837756,4,205,51.25,1361201449353,1361201449353,1622830109,1622830109,0
1361201457,1622837772,3,169,56.33333333,1361201452281,1361201452281,1622833053,1622833053,0
1361201457,1622837772,4,205,51.25,1361201452345,1361201452345,1622833117,1622833117,0
1361201457,1622837808,4,205,51.25,1361201449303,1361201449303,1622830111,1622830111,0
1361201457,1622837840,2,123,61.5,1361201452213,1361201452213,1622833053,1622833053,0
1361201457,1622837844,3,169,56.33333333,1361201452212,1361201452212,1622833056,1622833056,0
1361201457,1622837844,4,205,51.25,1361201452276,1361201452276,1622833120,1622833120,0
1361201457,1622838312,1,77,77,1361201429278,1361201429278,1622810590,1622810590,0
1361201469,1622850372,1,134,134,1361201444451,1361201444451,1622825823,1622825823,0
1361201473,1622854300,1,46,46,1361201447785,1361201447785,1622829085,1622829085,0
1361201473,1622854300,1,46,46,1361201447785,1361201447785,1622829085,1622829085,0
1361201473,1622854304,1,46,46,1361201447781,1361201447781,1622829085,1622829085,0
1361201473,1622854380,1,46,46,1361201447705,1361201447705,1622829085,1622829085,0
1361201473,1622854388,1,46,46,1361201447699,1361201447699,1622829087,1622829087,0
1361201481,1622861752,4,205,51.25,1361201473360,1361201473360,1622854112,1622854112,0
1361201481,1622861768,5,320,64,1361201474877,1361201474877,1622855645,1622855645,0
1361201485,1622866380,1,46,46,1361201458648,1361201458648,1622840028,1622840028,0
1361201485,1622866384,1,46,46,1361201459094,1361201459094,1622840478,1622840478,0
1361201489,1622870340,2,472,236,1361201464644,1361201464708,1622845984,1622846048,64
1361201493,1622874300,2,265,132.5,1361201467626,1361201467690,1622848926,1622848990,64
1361201510,1622890700,1,190,190,1361201484674,1361201484674,1622865374,1622865374,0
1361201513,1622893796,4,336,84,1361201506658,1361201506786,1622887454,1622887582,128
1361201513,1622893796,3,144,48,1361201510752,1361201510816,1622891548,1622891612,64
1361201530,1622910676,2,472,236,1361201505369,1361201505433,1622886045,1622886109,64
1361201550,1622930744,2,265,132.5,1361201524183,1361201524375,1622904927,1622905119,192
1361201550,1622930752,2,324,162,1361201525134,1361201548046,1622905886,1622928798,22912
1361201570,1622950664,2,472,236,1361201545639,1361201545703,1622926303,1622926367,64
1361201577,1622957864,3,144,48,1361201570717,1361201570717,1622951581,1622951581,0
1361201590,1622970820,1,134,134,1361201565065,1361201565065,1622945885,1622945885,0
1361201606,1622986812,2,265,132.5,1361201579985,1361201580113,1622960797,1622960925,128
1361201609,1622989912,3,286,95.33333333,1361201604974,1361201605038,1622985886,1622985950,64
1361201610,1622990788,2,472,236,1361201585256,1361201585320,1622966044,1622966108,64
1361201630,1623010784,9,1893,210.3333333,1361201605165,1361201612077,1622985949,1622992861,6912
1361201633,1623013840,3,144,48,1361201630709,1361201630773,1623011549,1623011613,64
1361201650,1623030816,2,472,236,1361201625484,1361201625548,1623006300,1623006364,64
1361201662,1623043096,2,265,132.5,1361201635509,1361201635637,1623016605,1623016733,128
1361201665,1623045852,7,1406,200.8571429,1361201658984,1361201664104,1623039836,1623044956,5120
1361201665,1623045852,7,1406,200.8571429,1361201658984,1361201664104,1623039836,1623044956,5120
1361201665,1623045896,7,1406,200.8571429,1361201658938,1361201664058,1623039834,1623044954,5120
1361201665,1623045924,7,1406,200.8571429,1361201658913,1361201664033,1623039837,1623044957,5120
1361201665,1623045924,8,1505,188.125,1361201658913,1361201664033,1623039837,1623044957,5120
1361201670,1623051100,1,134,134,1361201644848,1361201644848,1623025948,1623025948,0
1361201682,1623063068,10,2252,225.2,1361201657807,1361201658319,1623038875,1623039387,512
1361201690,1623071124,2,472,236,1361201664983,1361201665047,1623046107,1623046171,64
1361201694,1623075108,22,9990,454.0909091,1361201668774,1361201693286,1623049882,1623074394,24512
1361201694,1623075184,11,5458,496.1818182,1361201669149,1361201677597,1623050333,1623058781,8448
1361201697,1623077884,4,292,73,1361201692742,1361201692806,1623073626,1623073690,64
1361201697,1623077948,50,63098,1261.96,1361201671049,1361201693577,1623051997,1623074525,22528
1361201698,1623079152,4,574,143.5,1361201670779,1361201678587,1623051931,1623059739,7808
1361201702,1623083164,1,190,190,1361201675249,1361201675249,1623056413,1623056413,0
1361201705,1623085932,4,714,178.5,1361201696854,1361201696918,1623077786,1623077850,64
1361201713,1623093904,3,144,48,1361201705650,1361201705650,1623086554,1623086554,0
1361201720,261414252,2,98,49,1361201708294,1361201713158,261402546,261407410,4864
1361201720,261414252,2,98,49,1361201708293,1361201712133,261402545,261406385,3840
1361201729,1623109860,4,480,120,1361201726942,1361201727006,1623107802,1623107866,64
1361201729,1623109868,4,292,73,1361201724504,1361201724568,1623105372,1623105436,64
1361201730,1623111176,2,472,236,1361201704546,1361201704610,1623085722,1623085786,64
1361201745,1623125964,2,123,61.5,1361201737782,1361201737782,1623118746,1623118746,0
1361201750,1623131220,2,324,162,1361201724727,1361201739575,1623105947,1623120795,14848
1361201750,1623131224,1,46,46,1361201725236,1361201725236,1623106460,1623106460,0
1361201762,1623143164,4,552,138,1361201733997,1361201755565,1623115161,1623136729,21568
1361201769,1623150004,3,144,48,1361201765646,1361201765646,1623146650,1623146650,0
1361201770,1623151168,2,472,236,1361201745451,1361201745515,1623126619,1623126683,64
1361201774,1623155200,1,46,46,1361201748235,1361201748235,1623129435,1623129435,0
1361201774,1623155224,1,46,46,1361201748146,1361201748146,1623129370,1623129370,0
1361201774,1623155276,1,46,46,1361201748158,1361201748158,1623129434,1623129434,0
1361201777,1623157956,29,33362,1150.413793,1361201755135,1361201770495,1623136091,1623151451,15360
1361201777,1623157992,12,5872,489.3333333,1361201757912,1361201774936,1623138904,1623155928,17024
1361201790,1623171224,1,134,134,1361201764722,1361201764722,1623145946,1623145946,0
1361201794,1623175248,3,1120,373.3333333,1361201766043,1361201766491,1623147291,1623147739,448
1361201814,1623195248,2,472,236,1361201786202,1361201786266,1623167450,1623167514,64
1361201831,1623211492,1,190,190,1361201804046,1361201804046,1623184538,1623184538,0
1361201833,1623213968,29,33714,1162.551724,1361201811440,1361201826800,1623192408,1623207768,15360
1361201839,1623219492,6,839,139.8333333,1361201811725,1361201837133,1623192217,1623217625,25408
1361201839,1623219560,1,46,46,1361201811848,1361201811848,1623192408,1623192408,0
1361201849,1623230016,3,144,48,1361201842882,1361201842946,1623223898,1623223962,64
1361201851,1623231520,2,472,236,1361201826227,1361201826291,1623206747,1623206811,64
1361201863,1623243480,1,46,46,1361201835223,1361201835223,1623215703,1623215703,0
1361201863,1623243484,23,10096,438.9565217,1361201835222,1361201862294,1623215706,1623242778,27072
1361201863,1623243488,1,46,46,1361201836240,1361201836240,1623216728,1623216728,0
1361201863,1623243488,92,123812,1345.782609,1361201836240,1361201862352,1623216728,1623242840,26112
1361201871,1623251552,4,574,143.5,1361201846610,1361201847698,1623227162,1623228250,1088
1361201871,1623251592,2,324,162,1361201845418,1361201867818,1623226010,1623248410,22400
1361201887,1623267492,1,46,46,1361201859915,1361201859915,1623240407,1623240407,0
1361201889,1623270028,12,999,83.25,1361201874675,1361201886387,1623255703,1623267415,11712
1361201889,1623270040,4,205,51.25,1361201881897,1361201881961,1623262937,1623263001,64
1361201889,1623270072,16,6372,398.25,1361201874249,1361201886345,1623255321,1623267417,12096
1361201889,1623270108,12,999,83.25,1361201874917,1361201886309,1623256025,1623267417,11392
1361201889,1623270116,12,999,83.25,1361201875229,1361201886301,1623256345,1623267417,11072
1361201895,1623275512,2,472,236,1361201866999,1361201867063,1623247511,1623247575,64
1361201905,1623286048,3,144,48,1361201900511,1361201900511,1623281559,1623281559,0
1361201911,1623291584,1,134,134,1361201885424,1361201885424,1623266008,1623266008,0
1361201927,1623307616,2,265,132.5,1361201902735,1361201902863,1623283351,1623283479,128
1361201929,1623310140,5,408,81.6,1361201924869,1361201924869,1623306009,1623306009,0
1361201935,1623315604,2,472,236,1361201906845,1361201906973,1623287449,1623287577,128
1361201951,1623331656,9,1893,210.3333333,1361201925416,1361201931432,1623306072,1623312088,6016
1361201961,1623342108,3,144,48,1361201960421,1361201960485,1623341529,1623341593,64
1361201969,1623350080,6,1360,226.6666667,1361201959297,1361201964417,1623340377,1623345497,5120
1361201969,1623350148,7,1406,200.8571429,1361201959226,1361201964346,1623340374,1623345494,5120
1361201971,1623351640,2,472,236,1361201946745,1361201946809,1623327385,1623327449,64
1361201983,1623363632,2,265,132.5,1361201958206,1361201958270,1623338838,1623338902,64
1361201987,1623367588,10,1937,193.7,1361201958890,1361201959402,1623339478,1623339990,512
1361201991,1623371632,1,134,134,1361201965375,1361201965375,1623346007,1623346007,0
1361202001,1623382080,14,6603,471.6428571,1361201978879,1361201995455,1623359959,1623376535,16576
1361202007,1623387684,8,4714,589.25,1361201979722,1361201980362,1623360406,1623361046,640
1361202011,1623391620,2,472,236,1361201986506,1361201986570,1623367126,1623367190,64
1361202023,1623403660,1,190,190,1361201995619,1361201995619,1623376279,1623376279,0
1361202024,261718232,2,98,49,1361202018203,1361202021979,261712435,261716211,3776
1361202024,261718244,2,98,49,1361202018257,1361202022929,261712501,261717173,4672
1361202033,1623414308,29,33746,1163.655172,1361202014489,1361202029849,1623395797,1623411157,15360
1361202039,1623419724,6,990,165,1361202013281,1361202015649,1623394005,1623396373,2368
1361202041,1623422268,2,123,61.5,1361202039810,1361202039810,1623421078,1623421078,0
1361202041,1623422312,3,144,48,1361202035220,1361202035284,1623416532,1623416596,64
1361202051,1623431732,2,472,236,1361202026201,1361202026265,1623406933,1623406997,64
1361202071,1623451680,2,324,162,1361202045389,1361202059789,1623426069,1623440469,14400
1361202075,1623455708,1,46,46,1361202048755,1361202048755,1623429463,1623429463,0
1361202075,1623455792,1,46,46,1361202048607,1361202048607,1623429399,1623429399,0
1361202081,1623462332,4,205,51.25,1361202074240,1361202074240,1623455572,1623455572,0
1361202091,1623471692,2,472,236,1361202066753,1361202066817,1623447445,1623447509,64
1361202097,1623478316,3,144,48,1361202095248,1361202095248,1623476564,1623476564,0
1361202099,1623479672,2,265,132.5,1361202071507,1361202071635,1623452179,1623452307,128
1361202111,1623491708,1,134,134,1361202085362,1361202085362,1623466070,1623466070,0
1361202131,1623511676,2,472,236,1361202106896,1361202106960,1623487572,1623487636,64
1361202151,1623531760,1,190,190,1361202123259,1361202123259,1623504019,1623504019,0
1361202155,1623535696,2,265,132.5,1361202127420,1361202127548,1623508116,1623508244,128
1361202171,1623551740,2,472,236,1361202146001,1361202146129,1623526741,1623526869,128
1361202177,1623558396,3,144,48,1361202170176,1361202170176,1623551572,1623551572,0
1361202179,1623559728,1,46,46,1361202153949,1361202153949,1623534677,1623534677,0
1361202183,1623563732,11,5458,496.1818182,1361202155543,1361202178263,1623536275,1623558995,22720
1361202183,1623563776,25,11471,458.84,1361202154859,1361202179243,1623535635,1623560019,24384
1361202183,1623563808,4,574,143.5,1361202156683,1361202172171,1623537491,1623552979,15488
1361202183,1623563812,50,63295,1265.9,1361202156808,1361202172040,1623537620,1623552852,15232
1361202191,1623571772,2,324,162,1361202165296,1361202187184,1623546068,1623567956,21888
1361202193,1623574400,2,123,61.5,1361202186426,1361202186426,1623567826,1623567826,0
1361202211,1623591752,2,472,236,1361202186369,1361202186433,1623567121,1623567185,64
1361202215,1623595868,12,4306,358.8333333,1361202190673,1361202207121,1623571541,1623587989,16448
1361202225,1623606368,29,34066,1174.689655,1361202206553,1361202221913,1623587921,1623603281,15360
1361202225,1623606412,3,169,56.33333333,1361202221552,1361202222192,1623602964,1623603604,640
1361202227,1623607832,2,287,143.5,1361202202738,1361202207794,1623583570,1623588626,5056
1361202231,1623611868,1,134,134,1361202205263,1361202205263,1623586131,1623586131,0
1361202235,1623615796,1,46,46,1361202207126,1361202207126,1623587922,1623587922,0
1361202247,1623627896,21,9891,471,1361202222708,1361202246388,1623603604,1623627284,23680
1361202249,1623630376,5,408,81.6,1361202244755,1361202244755,1623626131,1623626131,0
1361202249,1623630380,3,144,48,1361202245200,1361202245200,1623626580,1623626580,0
1361202249,1623630388,31,33838,1091.548387,1361202230534,1361202245958,1623611922,1623627346,15424
1361202251,1623631860,2,472,236,1361202226071,1361202226135,1623606931,1623606995,64
1361202255,1623635896,4,790,197.5,1361202230066,1361202251954,1623610962,1623632850,21888
1361202259,1623639784,6,861,143.5,1361202231076,1361202253860,1623611860,1623634644,22784
1361202259,1623639832,1,46,46,1361202231090,1361202231090,1623611922,1623611922,0
1361202271,1623651816,50,63396,1267.92,1361202246530,1361202268610,1623627346,1623649426,22080
1361202271,1623651856,12,7312,609.3333333,1361202245275,1361202251355,1623626131,1623632211,6080
1361202271,1623651888,14,3122,223,1361202246713,1361202259833,1623627601,1623640721,13120
1361202273,1623654324,8,2284,285.5,1361202251014,1361202268038,1623632338,1623649362,17024
1361202287,1623667852,7,4455,636.4285714,1361202260063,1361202260127,1623640915,1623640979,64
1361202291,1623671860,2,472,236,1361202265943,1361202266071,1623646803,1623646931,128
1361202305,1623686388,17,6418,377.5294118,1361202292804,1361202303172,1623674192,1623684560,10368
1361202305,1623686396,12,999,83.25,1361202293758,1361202303166,1623675154,1623684562,9408
1361202306,1623686444,12,999,83.25,1361202294134,1361202304118,1623674578,1623684562,9984
1361202306,1623686444,11,953,86.63636364,1361202294453,1361202304117,1623674897,1623684561,9664
1361202311,1623691796,1,134,134,1361202285334,1361202285334,1623666130,1623666130,0
1361202313,1623694364,3,144,48,1361202305181,1361202305245,1623686545,1623686609,64
1361202313,1623694376,2,123,61.5,1361202311440,1361202311440,1623692816,1623692816,0
1361202331,1623711880,2,472,236,1361202306368,1361202306432,1623687248,1623687312,64
1361202335,1623715908,2,265,132.5,1361202308774,1361202308902,1623689682,1623689810,128
1361202336,262030348,2,98,49,1361202328170,1361202331818,262022518,262026166,3648
1361202336,262030348,2,98,49,1361202328169,1361202332777,262022517,262027125,4608
1361202343,1623723896,1,190,190,1361202315377,1361202315377,1623696273,1623696273,0
1361202361,1623742408,13,6413,493.3076923,1361202344432,1361202360048,1623725840,1623741456,15616
1361202361,1623742420,29,33740,1163.448276,1361202345188,1361202360548,1623726608,1623741968,15360
1361202371,1623751856,2,287,143.5,1361202345624,1361202346264,1623726480,1623727120,640
1361202371,1623751940,2,472,236,1361202346309,1361202346373,1623727249,1623727313,64
1361202375,1623755876,1,46,46,1361202348548,1361202348548,1623729424,1623729424,0
1361202377,1623758428,4,205,51.25,1361202374491,1361202374491,1623755919,1623755919,0
1361202378,1623758472,3,169,56.33333333,1361202376472,1361202376472,1623756944,1623756944,0
1361202386,1623766444,3,144,48,1361202381109,1361202381109,1623761553,1623761553,0
1361202391,1623771900,2,324,162,1361202365292,1361202379052,1623746192,1623759952,13760
1361202402,1623782472,20,8764,438.2,1361202376025,1361202401305,1623756497,1623781777,25280
1361202403,1623783936,1,46,46,1361202375560,1361202375560,1623756496,1623756496,0
1361202403,1623784020,11,5458,496.1818182,1361202376053,1361202384629,1623757073,1623765649,8576
1361202411,1623792040,2,472,236,1361202386464,1361202386528,1623767504,1623767568,64
1361202424,1623805340,1,46,46,1361202396404,1361202396404,1623777744,1623777744,0
1361202424,1623805368,1,46,46,1361202396439,1361202396439,1623777807,1623777807,0
1361202427,1623807976,6,839,139.8333333,1361202402142,1361202416158,1623783118,1623797134,14016
1361202427,1623807976,1,46,46,1361202402334,1361202402334,1623783310,1623783310,0
1361202427,1623808088,48,62927,1310.979167,1361202402225,1361202415921,1623783313,1623797009,13696
1361202431,1623812016,1,134,134,1361202405174,1361202405174,1623786190,1623786190,0
1361202433,1623814432,2,123,61.5,1361202430486,1361202430486,1623811918,1623811918,0
1361202433,1623814432,13,6413,493.3076923,1361202414614,1361202430230,1623796046,1623811662,15616
1361202443,1623823940,1,46,46,1361202415108,1361202415108,1623796048,1623796048,0
1361202449,1623830468,3,144,48,1361202440051,1361202441331,1623821519,1623822799,1280
1361202449,1623830512,2,123,61.5,1361202444167,1361202444167,1623825679,1623825679,0
1361202451,1623832036,2,472,236,1361202425634,1361202425698,1623806670,1623806734,64
1361202467,1623847960,1,190,190,1361202442481,1361202442481,1623823441,1623823441,0
1361202491,1623872120,2,472,236,1361202466320,1361202466384,1623847440,1623847504,64
1361202495,1623876040,1,46,46,1361202468383,1361202468383,1623849423,1623849423,0
1361202499,1623880060,2,265,132.5,1361202471884,1361202471948,1623852944,1623853008,64
1361202506,1623886616,3,144,48,1361202503238,1361202503302,1623883854,1623883918,64
1361202511,1623892064,2,324,162,1361202485126,1361202505862,1623866190,1623886926,20736
1361202531,1623912148,2,472,236,1361202505777,1361202505841,1623886925,1623886989,64
1361202551,1623932072,1,134,134,1361202525118,1361202525118,1623906190,1623906190,0
1361202555,1623936132,2,265,132.5,1361202527043,1361202527235,1623908175,1623908367,192
1361202562,1623942584,3,144,48,1361202560999,1361202560999,1623941583,1623941583,0
1361202570,1623950588,3,286,95.33333333,1361202565664,1361202565664,1623946252,1623946252,0
1361202570,1623950648,7,1406,200.8571429,1361202560806,1361202565926,1623941454,1623946574,5120
1361202571,1623952072,2,472,236,1361202546175,1361202546239,1623927247,1623927311,64
1361202587,1623968176,11,1971,179.1818182,1361202559381,1361202559829,1623940557,1623941005,448
1361202591,1623972104,10,1954,195.4,1361202565149,1361202569373,1623946253,1623950477,4224
1361202607,1623988216,2,265,132.5,1361202582508,1361202582572,1623963724,1623963788,64
1361202611,1623992236,2,472,236,1361202586328,1361202586392,1623967564,1623967628,64
1361202626,1624006656,3,144,48,1361202624925,1361202625117,1624005581,1624005773,192
1361202626,1624006676,4,292,73,1361202622152,1361202622216,1624002828,1624002892,64
1361202626,1624006720,3,144,48,1361202624861,1361202625053,1624005581,1624005773,192
1361202631,1624012216,6,3835,639.1666667,1361202605035,1361202629547,1623986251,1624010763,24512
1361202642,1624022656,3,144,48,1361202635867,1361202635931,1624016523,1624016587,64
1361202642,1624022732,4,292,73,1361202637135,1361202637199,1624017867,1624017931,64
1361202648,262342388,2,98,49,1361202638084,1361202642948,262332472,262337336,4864
1361202648,262342388,2,98,49,1361202638084,1361202641924,262332472,262336312,3840
1361202650,1624030704,4,336,84,1361202642731,1361202642859,1624023435,1624023563,128
1361202655,1624036164,2,472,236,1361202627489,1361202627553,1624008653,1624008717,64
1361202655,1624036204,13,8674,667.2307692,1361202629752,1361202637048,1624010956,1624018252,7296
1361202658,1624038664,4,312,78,1361202650837,1361202650901,1624031501,1624031565,64
1361202658,1624038664,4,312,78,1361202650900,1361202651028,1624031564,1624031692,128
1361202658,1624038708,4,312,78,1361202650665,1361202650793,1624031373,1624031501,128
1361202658,1624038708,4,312,78,1361202650856,1361202650920,1624031564,1624031628,64
1361202659,1624040192,12,6920,576.6666667,1361202633027,1361202645059,1624014219,1624026251,12032
1361202664,1624044456,8,1126,140.75,1361202638500,1361202656356,1624018956,1624036812,17856
1361202674,1624054664,16,7318,457.375,1361202648213,1361202667157,1624028877,1624047821,18944
1361202674,1624054740,71,92194,1298.507042,1361202648838,1361202670790,1624029578,1624051530,21952
1361202675,1624056440,3,1079,359.6666667,1361202649738,1361202649802,1624031178,1624031242,64
1361202675,1624056440,16,18524,1157.75,1361202649931,1361202650123,1624031371,1624031563,192
1361202682,1624062724,4,205,51.25,1361202675542,1361202675542,1624056266,1624056266,0
1361202696,1624076540,2,472,236,1361202668750,1361202668814,1624049290,1624049354,64
1361202698,1624078720,3,144,48,1361202695899,1361202695899,1624076619,1624076619,0
1361202712,1624092568,2,324,162,1361202685746,1361202699570,1624066314,1624080138,13824
1361202736,1624116572,2,265,132.5,1361202711662,1361202711726,1624092234,1624092298,64
1361202736,1624116600,2,472,236,1361202708563,1361202708627,1624089163,1624089227,64
1361202752,1624132596,6,913,152.1666667,1361202727384,1361202727704,1624107980,1624108300,320
1361202752,1624132640,1,134,134,1361202725673,1361202725673,1624106313,1624106313,0
1361202754,1624134804,2,92,46,1361202753222,1361202753222,1624134026,1624134026,0
1361202776,1624156624,2,472,236,1361202748219,1361202748283,1624128843,1624128907,64
1361202778,1624158828,3,144,48,1361202770734,1361202770734,1624151562,1624151562,0
1361202788,1624168636,1,190,190,1361202763376,1361202763376,1624144012,1624144012,0
1361202792,1624172700,1,46,46,1361202766382,1361202766382,1624147082,1624147082,0
1361202792,1624172708,2,265,132.5,1361202766951,1361202767079,1624147659,1624147787,128
1361202792,1624172776,1,46,46,1361202766304,1361202766304,1624147080,1624147080,0
1361202816,1624196652,2,472,236,1361202788447,1361202788511,1624169099,1624169163,64
1361202832,1624212960,2,324,162,1361202805354,1361202826858,1624186314,1624207818,21504
1361202848,1624228920,2,265,132.5,1361202822096,1361202822224,1624203016,1624203144,128
1361202850,1624230812,4,205,51.25,1361202843262,1361202843262,1624224074,1624224074,0
1361202850,1624230816,3,144,48,1361202845755,1361202845755,1624226571,1624226571,0
1361202856,1624236932,2,472,236,1361202828484,1361202828548,1624209416,1624209480,64
1361202872,1624252904,1,134,134,1361202845410,1361202845410,1624226314,1624226314,0
1361202874,1624254876,8,1505,188.125,1361202861119,1361202866239,1624241995,1624247115,5120
1361202888,1624268968,12,3538,294.8333333,1361202860128,1361202860640,1624241096,1624241608,512
1361202890,1624270852,3,286,95.33333333,1361202885526,1361202885526,1624266378,1624266378,0
1361202890,1624270852,4,190,47.5,1361202888918,1361202889430,1624269770,1624270282,512
1361202890,1624270852,4,190,47.5,1361202888980,1361202889748,1624269832,1624270600,768
1361202890,1624270852,4,190,47.5,1361202889043,1361202889875,1624269895,1624270727,832
1361202890,1624270880,4,190,47.5,1361202889530,1361202889850,1624270410,1624270730,320
1361202890,1624270928,4,190,47.5,1361202888970,1361202889802,1624269898,1624270730,832
1361202896,1624277028,2,472,236,1361202868452,1361202868516,1624249480,1624249544,64
1361202898,1624278828,4,190,47.5,1361202889966,1361202890222,1624270794,1624271050,256
1361202898,1624278828,4,190,47.5,1361202896045,1361202896365,1624276873,1624277193,320
1361202898,1624278828,4,190,47.5,1361202896044,1361202896364,1624276872,1624277192,320
1361202898,1624278828,4,190,47.5,1361202896108,1361202896428,1624276936,1624277256,320
1361202898,1624278832,4,190,47.5,1361202896360,1361202896680,1624277192,1624277512,320
1361202898,1624278832,4,190,47.5,1361202890216,1361202892328,1624271048,1624273160,2112
1361202898,1624278832,4,190,47.5,1361202896360,1361202896680,1624277192,1624277512,320
1361202898,1624278832,4,190,47.5,1361202896423,1361202896743,1624277255,1624277575,320
1361202898,1624278832,4,190,47.5,1361202896423,1361202896743,1624277255,1624277575,320
1361202898,1624278836,4,190,47.5,1361202892643,1361202892899,1624273479,1624273735,256
1361202898,1624278836,4,190,47.5,1361202892710,1361202892966,1624273546,1624273802,256
1361202898,1624278840,4,190,47.5,1361202892962,1361202895074,1624273802,1624275914,2112
1361202898,1624278840,4,190,47.5,1361202893089,1361202895265,1624273929,1624276105,2176
1361202898,1624278868,4,190,47.5,1361202891589,1361202891909,1624272457,1624272777,320
1361202898,1624278872,4,190,47.5,1361202889474,1361202891586,1624270346,1624272458,2112
1361202898,1624278872,4,190,47.5,1361202891905,1361202892161,1624272777,1624273033,256
1361202898,1624278872,4,190,47.5,1361202889600,1361202891712,1624270472,1624272584,2112
1361202898,1624278872,4,190,47.5,1361202894464,1361202894912,1624275336,1624275784,448
1361202898,1624278876,4,190,47.5,1361202894910,1361202895422,1624275786,1624276298,512
1361202898,1624278876,4,190,47.5,1361202895101,1361202895613,1624275977,1624276489,512
1361202898,1624278876,4,190,47.5,1361202895165,1361202895229,1624276041,1624276105,64
1361202898,1624278876,4,190,47.5,1361202895165,1361202895677,1624276041,1624276553,512
1361202898,1624278876,4,190,47.5,1361202895420,1361202895484,1624276296,1624276360,64
1361202898,1624278880,4,190,47.5,1361202895607,1361202895991,1624276487,1624276871,384
1361202898,1624278880,4,190,47.5,1361202895223,1361202895287,1624276103,1624276167,64
1361202898,1624278880,4,190,47.5,1361202895674,1361202895994,1624276554,1624276874,320
1361202898,1624278880,4,190,47.5,1361202895481,1361202895545,1624276361,1624276425,64
1361202898,1624278880,4,190,47.5,1361202895481,1361202895545,1624276361,1624276425,64
1361202898,1624278880,4,190,47.5,1361202892151,1361202892407,1624273031,1624273287,256
1361202898,1624278884,4,190,47.5,1361202892277,1361202892533,1624273161,1624273417,256
1361202898,1624278884,4,190,47.5,1361202892405,1361202892661,1624273289,1624273545,256
1361202898,1624278884,4,190,47.5,1361202892277,1361202892597,1624273161,1624273481,320
1361202898,1624278884,4,190,47.5,1361202890101,1361202892277,1624270985,1624273161,2176
1361202898,1624278884,4,190,47.5,1361202892531,1361202892787,1624273415,1624273671,256
1361202898,1624278900,4,190,47.5,1361202892772,1361202893028,1624273672,1624273928,256
1361202898,1624278900,4,190,47.5,1361202892835,1361202894947,1624273735,1624275847,2112
1361202898,1624278900,4,190,47.5,1361202896611,1361202896995,1624277511,1624277895,384
1361202898,1624278904,4,190,47.5,1361202896608,1361202896992,1624277512,1624277896,384
1361202898,1624278904,4,190,47.5,1361202896672,1361202896992,1624277576,1624277896,320
1361202898,1624278912,4,190,47.5,1361202893914,1361202894426,1624274826,1624275338,512
1361202898,1624278912,4,190,47.5,1361202889432,1361202890072,1624270344,1624270984,640
1361202898,1624278912,4,190,47.5,1361202891672,1361202893784,1624272584,1624274696,2112
1361202898,1624278916,4,190,47.5,1361202889813,1361202890069,1624270729,1624270985,256
1361202898,1624278948,4,190,47.5,1361202895157,1361202895221,1624276105,1624276169,64
1361202898,1624278948,4,190,47.5,1361202895221,1361202895349,1624276169,1624276297,128
1361202898,1624278948,4,190,47.5,1361202895220,1361202895284,1624276168,1624276232,64
1361202898,1624278948,4,190,47.5,1361202895283,1361202895411,1624276231,1624276359,128
1361202898,1624278952,4,190,47.5,1361202895343,1361202895407,1624276295,1624276359,64
1361202898,1624278952,4,190,47.5,1361202895538,1361202895922,1624276490,1624276874,384
1361202898,1624278952,4,190,47.5,1361202895601,1361202895921,1624276553,1624276873,320
1361202898,1624278952,4,190,47.5,1361202895921,1361202896241,1624276873,1624277193,320
1361202904,1624285060,2,265,132.5,1361202877189,1361202877317,1624258249,1624258377,128
1361202906,1624286896,3,144,48,1361202905642,1361202905706,1624286538,1624286602,64
1361202912,1624292976,9,1893,210.3333333,1361202885402,1361202891866,1624266378,1624272842,6464
1361202932,1624313108,2,472,236,1361202907602,1361202907666,1624288710,1624288774,64
1361202952,1624333096,1,134,134,1361202925281,1361202925281,1624306377,1624306377,0
1361202952,262646496,2,98,49,1361202948185,1361202951321,262642681,262645817,3136
1361202954,1624334920,15,7288,485.8666667,1361202934544,1361202951312,1624315464,1624332232,16768
1361202954,1624334932,30,33776,1125.866667,1361202936452,1361202952196,1624317384,1624333128,15744
1361202960,262654456,2,98,49,1361202948226,1361202952322,262642682,262646778,4096
1361202960,1624341180,4,552,138,1361202932940,1361202937292,1624314120,1624318472,4352
1361202960,1624341220,8,4714,589.25,1361202934820,1361202935588,1624316040,1624316808,768
1361202977,1624357424,2,472,236,1361202949057,1361202949121,1624329481,1624329545,64
1361202978,1624358880,4,205,51.25,1361202976568,1361202976568,1624357448,1624357448,0
1361202981,1624361480,2,324,162,1361202955721,1361202965897,1624336201,1624346377,10176
1361202986,1624366924,3,144,48,1361202980617,1361202980681,1624361541,1624361605,64
1361203002,1624382996,2,123,61.5,1361202995780,1361202995780,1624376776,1624376776,0
1361203016,1624397372,2,472,236,1361202988169,1361202988233,1624369541,1624369605,64
1361203021,1624401456,2,265,132.5,1361202993119,1361202993183,1624373575,1624373639,64
1361203033,1624413452,2,324,162,1361203005921,1361203019425,1624386373,1624399877,13504
1361203036,1624417376,1,46,46,1361203008133,1361203008133,1624389509,1624389509,0
1361203037,1624417452,1,46,46,1361203009057,1361203009057,1624389509,1624389509,0
1361203037,1624417452,1,46,46,1361203009060,1361203009060,1624389512,1624389512,0
1361203042,1624422968,3,144,48,1361203040606,1361203040606,1624421574,1624421574,0
1361203053,1624433436,2,472,236,1361203028658,1361203028722,1624409094,1624409158,64
1361203073,1624453428,1,134,134,1361203046010,1361203046010,1624426438,1624426438,0
1361203076,1624457416,2,265,132.5,1361203048029,1361203048157,1624429445,1624429573,128
1361203093,1624473576,2,472,236,1361203068197,1361203068261,1624448773,1624448837,64
1361203109,1624489520,2,817,408.5,1361203083229,1361203086109,1624463749,1624466629,2880
1361203122,1624502952,3,144,48,1361203117931,1361203117995,1624498883,1624498947,64
1361203129,1624509592,4,552,138,1361203104340,1361203115412,1624484932,1624496004,11072
1361203130,1624510968,29,33730,1163.103448,1361203114331,1361203129819,1624495299,1624510787,15488
1361203130,1624511004,15,7288,485.8666667,1361203112186,1361203129210,1624493190,1624510214,17024
1361203137,1624517464,2,472,236,1361203109012,1361203109076,1624489476,1624489540,64
1361203141,1624521480,9,4760,528.8888889,1361203113411,1361203114243,1624493891,1624494723,832
1361203153,1624533484,2,324,162,1361203125952,1361203146816,1624506436,1624527300,20864
1361203170,1624551068,7,1406,200.8571429,1361203161465,1361203166649,1624542533,1624547717,5184
1361203173,1624553568,2,472,236,1361203148140,1361203148204,1624528708,1624528772,64
1361203178,1624559016,2,123,61.5,1361203173740,1361203173740,1624554756,1624554756,0
1361203178,1624559100,3,144,48,1361203175448,1361203175512,1624556548,1624556612,64
1361203189,1624569544,11,1987,180.6363636,1361203161158,1361203161606,1624541702,1624542150,448
1361203193,1624573540,1,134,134,1361203165897,1361203165897,1624546437,1624546437,0
1361203193,1624573584,2,122,61,1361203168540,1361203170908,1624549124,1624551492,2368
1361203197,1624577560,2,265,132.5,1361203171060,1361203171188,1624551620,1624551748,128
1361203213,1624593676,2,472,236,1361203188222,1361203188286,1624568898,1624568962,64
1361203217,1624597544,1,46,46,1361203188997,1361203188997,1624569541,1624569541,0
1361203217,1624597592,1,46,46,1361203188946,1361203188946,1624569538,1624569538,0
1361203217,1624597592,1,46,46,1361203188946,1361203188946,1624569538,1624569538,0
1361203218,1624599008,10,4155,415.5,1361203202869,1361203211061,1624583877,1624592069,8192
1361203229,1624609604,21,17247,821.2857143,1361203203462,1361203211974,1624584066,1624592578,8512
1361203233,1624613616,3,1120,373.3333333,1361203207803,1361203208251,1624588419,1624588867,448
1361203237,1624617700,10,7167,716.7,1361203212072,1361203212200,1624592772,1624592900,128
1361203242,1624623016,14,6603,471.6428571,1361203218027,1361203235307,1624599043,1624616323,17280
1361203242,1624623020,29,33724,1162.896552,1361203226342,1361203241638,1624607362,1624622658,15296
1361203242,1624623112,3,144,48,1361203235465,1361203235465,1624616577,1624616577,0
1361203245,1624625848,8,4714,589.25,1361203219156,1361203219860,1624600004,1624600708,704
1361203253,1624633628,4,552,138,1361203226480,1361203227248,1624607108,1624607876,768
1361203253,1624633744,2,472,236,1361203228026,1361203228090,1624608770,1624608834,64
1361203264,262958564,2,98,49,1361203258138,1361203262170,262952702,262956734,4032
1361203264,262958564,2,98,49,1361203258202,1361203263130,262952766,262957694,4928
1361203273,1624653740,1,134,134,1361203245760,1361203245760,1624626500,1624626500,0
1361203282,1624663048,29,33730,1163.103448,1361203265035,1361203280395,1624646083,1624661443,15360
1361203282,1624663088,14,6603,471.6428571,1361203263523,1361203279715,1624644611,1624660803,16192
1361203289,1624669868,1,46,46,1361203263743,1361203263743,1624644611,1624644611,0
1361203289,1624669872,2,395,197.5,1361203264124,1361203264380,1624644996,1624645252,256
1361203293,1624673836,2,287,143.5,1361203264925,1361203265949,1624645761,1624646785,1024
1361203293,1624673844,1,46,46,1361203265237,1361203265237,1624646081,1624646081,0
1361203293,1624673892,2,472,236,1361203268261,1361203268325,1624649153,1624649217,64
1361203298,1624679144,3,144,48,1361203295402,1361203295466,1624676546,1624676610,64
1361203305,1624685856,1,190,190,1361203278284,1361203278284,1624659140,1624659140,0
1361203330,1624711088,2,123,61.5,1361203324128,1361203324128,1624705216,1624705216,0
1361203330,1624711092,2,92,46,1361203327708,1361203327708,1624708800,1624708800,0
1361203330,1624711128,4,205,51.25,1361203322680,1361203322680,1624703808,1624703808,0
1361203333,1624713932,2,472,236,1361203307902,1361203307966,1624688834,1624688898,64
1361203349,1624729908,2,265,132.5,1361203320982,1361203321110,1624701890,1624702018,128
1361203353,1624733832,2,324,162,1361203325666,1361203342946,1624706498,1624723778,17280
1361203373,1624754012,2,472,236,1361203348527,1361203348591,1624729539,1624729603,64
1361203378,1624759104,3,144,48,1361203370447,1361203370447,1624751551,1624751551,0
1361203393,1624773944,1,46,46,1361203368563,1361203368563,1624749507,1624749507,0
1361203393,1624773952,1,134,134,1361203365543,1361203365543,1624746495,1624746495,0
1361203401,1624781888,2,265,132.5,1361203376553,1361203376617,1624757441,1624757505,64
1361203413,1624793988,2,472,236,1361203388166,1361203388230,1624769154,1624769218,64
1361203433,1624813892,2,324,162,1361203405668,1361203406372,1624786560,1624787264,704
1361203442,1624823208,7,1406,200.8571429,1361203435752,1361203441576,1624816960,1624822784,5824
1361203442,1624823212,8,535,66.875,1361203436133,1361203441573,1624817345,1624822785,5440
1361203442,1624823264,13,5365,412.6923077,1361203435634,1361203441522,1624816898,1624822786,5888
1361203442,1624823264,7,1406,200.8571429,1361203435697,1361203441521,1624816961,1624822785,5824
1361203442,1624823264,8,1505,188.125,1361203435697,1361203441521,1624816961,1624822785,5824
1361203442,1624823284,4,312,78,1361203436251,1361203436315,1624817535,1624817599,64
1361203442,1624823284,4,312,78,1361203436188,1361203436252,1624817472,1624817536,64
1361203445,1624825908,2,122,61,1361203417043,1361203419539,1624797951,1624800447,2496
1361203448,263142532,8,1505,188.125,1361203435512,1361203440568,263130044,263135100,5056
1361203450,1624831236,3,144,48,1361203445324,1361203445324,1624826560,1624826560,0
1361203453,1624834056,2,472,236,1361203428546,1361203428610,1624809602,1624809666,64
1361203457,1624837944,2,265,132.5,1361203432048,1361203432176,1624812992,1624813120,128
1361203461,1624841944,15,13553,903.5333333,1361203435950,1361203436526,1624816894,1624817470,576
1361203461,1624841948,13,10517,809,1361203436396,1361203436524,1624817344,1624817472,128
1361203461,1624841948,8,5848,731,1361203436396,1361203436524,1624817344,1624817472,128
1361203461,1624841948,8,6538,817.25,1361203436396,1361203436588,1624817344,1624817536,192
1361203461,1624841948,12,11846,987.1666667,1361203436396,1361203436588,1624817344,1624817536,192
1361203461,1624841948,10,7816,781.6,1361203436394,1361203436522,1624817342,1624817470,128
1361203461,1624841952,6,2467,411.1666667,1361203436458,1361203436586,1624817410,1624817538,128
1361203461,1624841988,42,48291,1149.785714,1361203433734,1361203436614,1624814722,1624817602,2880
1361203461,1624842016,44,57423,1305.068182,1361203435881,1361203436393,1624816897,1624817409,512
1361203461,1624842016,10,6904,690.4,1361203436326,1361203436454,1624817342,1624817470,128
1361203461,1624842016,9,6043,671.4444444,1361203436326,1361203436390,1624817342,1624817406,64
1361203461,1624842020,6,2467,411.1666667,1361203436386,1361203436450,1624817406,1624817470,64
1361203461,1624842020,6,4218,703,1361203436326,1361203436518,1624817346,1624817538,192
1361203461,1624842020,86,119650,1391.27907,1361203436389,1361203436965,1624817409,1624817985,576
1361203463,263157304,9,8162,906.8888889,1361203435740,1361203435868,263130044,263130172,128
1361203463,263157304,8,5836,729.5,1361203436000,1361203436640,263130304,263130944,640
1361203463,263157308,8,5037,629.625,1361203435995,1361203437019,263130303,263131327,1024
1361203463,263157308,6,2432,405.3333333,1361203435995,1361203436507,263130303,263130815,512
1361203463,263157340,6,2799,466.5,1361203435706,1361203436026,263130046,263130366,320
1361203463,263157340,8,5935,741.875,1361203435961,1361203436409,263130301,263130749,448
1361203463,263157352,8,6252,781.5,1361203435951,1361203436655,263130303,263131007,704
1361203463,263157352,6,3855,642.5,1361203435951,1361203436399,263130303,263130751,448
1361203473,1624853992,2,324,162,1361203445567,1361203470399,1624826559,1624851391,24832
1361203477,1624858224,1,46,46,1361203451095,1361203451095,1624832319,1624832319,0
1361203477,1624858224,1,46,46,1361203451159,1361203451159,1624832383,1624832383,0
1361203489,1624870192,8,2152,269,1361203461048,1361203461432,1624842240,1624842624,384
1361203497,1624878260,2,472,236,1361203468915,1361203468979,1624850175,1624850239,64
1361203506,1624887296,3,144,48,1361203505231,1361203505295,1624886527,1624886591,64
1361203513,1624894300,1,134,134,1361203485260,1361203485260,1624866560,1624866560,0
1361203513,1624894348,2,265,132.5,1361203487388,1361203487516,1624868736,1624868864,128
1361203530,1624911304,5,408,81.6,1361203525254,1361203525382,1624906558,1624906686,128
1361203533,1624914292,2,472,236,1361203508435,1361203508499,1624889727,1624889791,64
1361203552,263246664,3,169,56.33333333,1361203551415,1361203551415,263246079,263246079,0
1361203552,263246664,4,215,53.75,1361203551414,1361203551414,263246078,263246078,0
1361203552,263246664,3,169,56.33333333,1361203551414,1361203551414,263246078,263246078,0
1361203552,263246664,3,169,56.33333333,1361203551414,1361203551414,263246078,263246078,0
1361203552,263246684,3,169,56.33333333,1361203551394,1361203551394,263246078,263246078,0
1361203552,263246684,3,169,56.33333333,1361203551393,1361203551393,263246077,263246077,0
1361203552,263246684,3,169,56.33333333,1361203551393,1361203551393,263246077,263246077,0
1361203553,1624934356,9,1893,210.3333333,1361203525330,1361203533842,1624906686,1624915198,8512
1361203554,1624935312,3,169,56.33333333,1361203551424,1361203551424,1624932736,1624932736,0
1361203554,1624935312,3,169,56.33333333,1361203551424,1361203551424,1624932736,1624932736,0
1361203554,1624935312,2,123,61.5,1361203551421,1361203551421,1624932733,1624932733,0
1361203554,1624935312,3,169,56.33333333,1361203551421,1361203551421,1624932733,1624932733,0
1361203554,1624935312,3,169,56.33333333,1361203551421,1361203551421,1624932733,1624932733,0
1361203554,1624935312,3,169,56.33333333,1361203551421,1361203551421,1624932733,1624932733,0
1361203554,1624935312,4,205,51.25,1361203551421,1361203551421,1624932733,1624932733,0
1361203554,1624935320,4,205,51.25,1361203552440,1361203552440,1624933760,1624933760,0
1361203554,1624935368,3,169,56.33333333,1361203551366,1361203551366,1624932734,1624932734,0
1361203554,1624935368,3,169,56.33333333,1361203551366,1361203551366,1624932734,1624932734,0
1361203554,1624935368,3,169,56.33333333,1361203551365,1361203551365,1624932733,1624932733,0
1361203560,263254668,4,215,53.75,1361203552369,1361203552369,263247037,263247037,0
1361203569,1624950348,4,552,138,1361203543132,1361203556124,1624924480,1624937472,12992
1361203570,1624951260,3,144,48,1361203565298,1361203565298,1624946558,1624946558,0
1361203577,1624958312,2,472,236,1361203548928,1361203548992,1624930240,1624930304,64
1361203578,1624958432,1,46,46,1361203552303,1361203552303,1624932735,1624932735,0
1361203578,1624958432,1,46,46,1361203552302,1361203552302,1624932734,1624932734,0
1361203578,1624959276,29,33356,1150.206897,1361203555620,1361203571044,1624936896,1624952320,15424
1361203578,1624959384,4,205,51.25,1361203576376,1361203576376,1624957760,1624957760,0
1361203585,1624966380,1,46,46,1361203560633,1361203560633,1624942013,1624942013,0
1361203589,1624970352,1,46,46,1361203562390,1361203562390,1624943742,1624943742,0
1361203594,1624974424,1,134,134,1361203566133,1361203566133,1624946557,1624946557,0
1361203617,1624998392,2,472,236,1361203589038,1361203589102,1624970430,1624970494,64
1361203626,1625006496,1,190,190,1361203598830,1361203598830,1624979326,1624979326,0
1361203627,1625007448,3,144,48,1361203626143,1361203626143,1625006591,1625006591,0
1361203638,1625018720,2,265,132.5,1361203611980,1361203612108,1624992700,1624992828,128
1361203654,1625034688,2,472,236,1361203629740,1361203629868,1625010428,1625010556,128
1361203674,1625054596,2,324,162,1361203646023,1361203662343,1625026619,1625042939,16320
1361203694,1625074636,2,265,132.5,1361203667808,1361203667872,1625048444,1625048508,64
1361203694,1625074672,2,472,236,1361203669501,1361203669565,1625050173,1625050237,64
1361203707,1625087520,3,144,48,1361203701010,1361203701074,1625081530,1625081594,64
1361203714,1625094704,1,134,134,1361203685914,1361203685914,1625066618,1625066618,0
1361203714,1625094756,7,1450,207.1428571,1361203687974,1361203688550,1625068730,1625069306,576
1361203734,1625114688,2,472,236,1361203709034,1361203709098,1625089722,1625089786,64
1361203750,1625130660,2,265,132.5,1361203723014,1361203723078,1625103674,1625103738,64
1361203750,1625130792,1,190,190,1361203725701,1361203725701,1625106493,1625106493,0
1361203771,1625151472,3,144,48,1361203763715,1361203763779,1625144187,1625144251,64
1361203778,1625158676,2,472,236,1361203749943,1361203750071,1625130619,1625130747,128
1361203790,1625171064,7,1724,246.2857143,1361203761650,1361203762290,1625142714,1625143354,640
1361203794,1625174688,2,324,162,1361203765994,1361203790122,1625146682,1625170810,24128
1361203806,1625186788,2,265,132.5,1361203778504,1361203778568,1625159292,1625159356,64
1361203818,1625198716,2,472,236,1361203790671,1361203790735,1625171387,1625171451,64
1361203830,1625210812,1,134,134,1361203805870,1361203805870,1625186682,1625186682,0
1361203843,1625223596,3,144,48,1361203835974,1361203835974,1625216570,1625216570,0
1361203851,1625231548,3,286,95.33333333,1361203846134,1361203846198,1625226682,1625226746,64
1361203858,1625238944,2,472,236,1361203830121,1361203830185,1625211065,1625211129,64
1361203858,1625239028,2,265,132.5,1361203833429,1361203833557,1625214457,1625214585,128
1361203874,1625254856,10,1954,195.4,1361203845890,1361203853506,1625226746,1625234362,7616
1361203875,1625255548,12,5679,473.25,1361203857910,1361203873910,1625238458,1625254458,16000
1361203883,1625263496,4,205,51.25,1361203878315,1361203878315,1625258811,1625258811,0
1361203883,1625263556,3,200,66.66666667,1361203874990,1361203877422,1625255546,1625257978,2432
1361203883,1625263576,4,336,84,1361203882394,1361203882458,1625262970,1625263034,64
1361203888,263582744,3,144,48,1361203882984,1361203886312,263577728,263581056,3328
1361203888,263582744,2,98,49,1361203883048,1361203887336,263577792,263582080,4288
1361203898,1625279076,2,472,236,1361203869862,1361203869926,1625250938,1625251002,64
1361203899,1625279596,3,144,48,1361203895940,1361203896004,1625276536,1625276600,64
1361203910,1625291092,1,134,134,1361203885589,1361203885589,1625266681,1625266681,0
1361203914,1625294960,2,265,132.5,1361203888923,1361203889051,1625269883,1625270011,128
1361203938,1625319012,2,472,236,1361203910246,1361203910310,1625291258,1625291322,64
1361203942,1625323052,1,190,190,1361203917054,1361203917054,1625298106,1625298106,0
1361203963,1625343544,3,144,48,1361203956025,1361203956025,1625336569,1625336569,0
1361203970,1625351056,2,265,132.5,1361203944822,1361203944950,1625325878,1625326006,128
1361203978,1625358924,2,472,236,1361203950202,1361203950266,1625331126,1625331190,64
1361203990,1625371112,2,324,162,1361203965632,1361203980480,1625346744,1625361592,14848
1361203994,1625375080,1,46,46,1361203968544,1361203968544,1625349624,1625349624,0
1361204018,1625399028,2,472,236,1361203990354,1361203990418,1625371382,1625371446,64
1361204019,1625399604,3,144,48,1361204015931,1361204015995,1625396535,1625396599,64
1361204026,1625407000,2,265,132.5,1361204000750,1361204000878,1625381750,1625381878,128
1361204030,1625411076,1,134,134,1361204005668,1361204005668,1625386744,1625386744,0
1361204058,1625439000,2,472,236,1361204029933,1361204029997,1625410933,1625410997,64
1361204070,1625451160,1,190,190,1361204044367,1361204044367,1625425527,1625425527,0
1361204082,1625463184,2,265,132.5,1361204055928,1361204056056,1625437112,1625437240,128
1361204090,1625471056,10,1908,190.8,1361204062134,1361204062646,1625443190,1625443702,512
1361204094,1625475244,2,472,236,1361204069561,1361204069625,1625450805,1625450869,64
1361204099,1625479556,3,144,48,1361204090986,1361204091050,1625471542,1625471606,64
1361204099,1625479688,11,953,86.63636364,1361204089574,1361204098790,1625470262,1625479478,9216
1361204107,1625487636,17,6755,397.3529412,1361204089242,1361204098906,1625469878,1625479542,9664
1361204110,1625491244,2,324,162,1361204085497,1361204107961,1625466741,1625489205,22464
1361204126,1625507164,1,46,46,1361204098377,1361204098377,1625479541,1625479541,0
1361204130,1625511216,8,815,101.875,1361204105493,1361204105685,1625486709,1625486901,192
1361204134,1625515340,8,815,101.875,1361204105626,1361204105818,1625486966,1625487158,192
1361204134,1625515340,9,861,95.66666667,1361204106138,1361204106394,1625487478,1625487734,256
1361204135,1625515432,2,472,236,1361204110757,1361204110885,1625491189,1625491317,128
1361204135,1625515436,8,815,101.875,1361204106785,1361204106977,1625487221,1625487413,192
1361204139,1625519424,2,265,132.5,1361204112301,1361204112365,1625492725,1625492789,64
1361204139,1625519580,7,1924,274.8571429,1361204138769,1361204138897,1625519349,1625519477,128
1361204139,1625519580,7,2183,311.8571429,1361204138769,1361204138897,1625519349,1625519477,128
1361204139,1625519580,7,1915,273.5714286,1361204138833,1361204138897,1625519413,1625519477,64
1361204139,1625519584,5,759,151.8,1361204131277,1361204131341,1625511861,1625511925,64
1361204139,1625519584,4,312,78,1361204131276,1361204131404,1625511860,1625511988,128
1361204139,1625519588,26,33074,1272.076923,1361204131594,1361204131914,1625512182,1625512502,320
1361204139,1625519588,26,33696,1296,1361204131848,1361204132488,1625512436,1625513076,640
1361204139,1625519588,3,144,48,1361204131848,1361204137288,1625512436,1625517876,5440
1361204139,1625519588,3,144,48,1361204131912,1361204137288,1625512500,1625517876,5376
1361204139,1625519592,3,144,48,1361204131907,1361204137283,1625512499,1625517875,5376
1361204139,1625519592,5,364,72.8,1361204131907,1361204135043,1625512499,1625515635,3136
1361204139,1625519592,3,144,48,1361204131911,1361204137287,1625512503,1625517879,5376
1361204139,1625519592,2,98,49,1361204131911,1361204137287,1625512503,1625517879,5376
1361204139,1625519592,2,98,49,1361204131911,1361204137287,1625512503,1625517879,5376
1361204139,1625519592,301,446639,1483.850498,1361204131975,1361204133639,1625512567,1625514231,1664
1361204139,1625519592,2,98,49,1361204131911,1361204137287,1625512503,1625517879,5376
1361204139,1625519592,3,150,50,1361204131911,1361204138311,1625512503,1625518903,6400
1361204139,1625519592,4,352,88,1361204131911,1361204132039,1625512503,1625512631,128
1361204139,1625519592,3,144,48,1361204131975,1361204137287,1625512567,1625517879,5312
1361204139,1625519592,5,971,194.2,1361204131974,1361204132102,1625512566,1625512694,128
1361204139,1625519592,54,76591,1418.351852,1361204131974,1361204132294,1625512566,1625512886,320
1361204139,1625519592,5,1102,220.4,1361204131974,1361204132102,1625512566,1625512694,128
1361204139,1625519592,36,48497,1347.138889,1361204132102,1361204132358,1625512694,1625512950,256
1361204139,1625519592,80,115261,1440.7625,1361204132101,1361204132485,1625512693,1625513077,384
1361204139,1625519592,89,127048,1427.505618,1361204132101,1361204132933,1625512693,1625513525,832
1361204139,1625519592,63,89894,1426.888889,1361204132165,1361204132613,1625512757,1625513205,448
1361204139,1625519592,2,98,49,1361204132165,1361204137285,1625512757,1625517877,5120
1361204139,1625519592,21,27049,1288.047619,1361204132229,1361204132485,1625512821,1625513077,256
1361204139,1625519592,3,144,48,1361204132228,1361204137284,1625512820,1625517876,5056
1361204139,1625519592,8,7182,897.75,1361204132228,1361204132356,1625512820,1625512948,128
1361204139,1625519592,5,1514,302.8,1361204132292,1361204132420,1625512884,1625513012,128
1361204139,1625519596,4,352,88,1361204132355,1361204132483,1625512951,1625513079,128
1361204139,1625519620,6,2149,358.1666667,1361204132776,1361204133032,1625513396,1625513652,256
1361204139,1625519620,6,2523,420.5,1361204132776,1361204133032,1625513396,1625513652,256
1361204139,1625519620,5,1655,331,1361204132776,1361204133096,1625513396,1625513716,320
1361204139,1625519620,6,2946,491,1361204132776,1361204136296,1625513396,1625516916,3520
1361204139,1625519620,5,1516,303.2,1361204133033,1361204133161,1625513653,1625513781,128
1361204139,1625519620,6,2971,495.1666667,1361204133033,1361204133097,1625513653,1625513717,64
1361204139,1625519620,6,3534,589,1361204133096,1361204133480,1625513716,1625514100,384
1361204139,1625519624,4,312,78,1361204133155,1361204133219,1625513779,1625513843,64
1361204139,1625519624,2,98,49,1361204133155,1361204138211,1625513779,1625518835,5056
1361204139,1625519624,2,98,49,1361204133155,1361204138211,1625513779,1625518835,5056
1361204139,1625519624,6,2876,479.3333333,1361204133155,1361204133219,1625513779,1625513843,64
1361204139,1625519624,6,2170,361.6666667,1361204133155,1361204133219,1625513779,1625513843,64
1361204139,1625519624,2,92,46,1361204133222,1361204138278,1625513846,1625518902,5056
1361204139,1625519624,4,312,78,1361204133349,1361204133413,1625513973,1625514037,64
1361204139,1625519624,6,2564,427.3333333,1361204133349,1361204133413,1625513973,1625514037,64
1361204139,1625519624,4,312,78,1361204133413,1361204133477,1625514037,1625514101,64
1361204139,1625519624,4,312,78,1361204133604,1361204133668,1625514228,1625514292,64
1361204139,1625519632,6,433,72.16666667,1361204138333,1361204138397,1625518965,1625519029,64
1361204139,1625519632,9,6331,703.4444444,1361204138333,1361204138397,1625518965,1625519029,64
1361204139,1625519632,6,427,71.16666667,1361204138332,1361204138396,1625518964,1625519028,64
1361204139,1625519632,7,1924,274.8571429,1361204138332,1361204138396,1625518964,1625519028,64
1361204139,1625519632,7,4228,604,1361204138396,1361204138460,1625519028,1625519092,64
1361204139,1625519636,330,489540,1483.454545,1361204134743,1361204137431,1625515379,1625518067,2688
1361204139,1625519636,6,1703,283.8333333,1361204138715,1361204138843,1625519351,1625519479,128
1361204139,1625519636,6,1596,266,1361204138778,1361204138842,1625519414,1625519478,64
1361204139,1625519636,7,1789,255.5714286,1361204138778,1361204138842,1625519414,1625519478,64
1361204139,1625519656,5,1488,297.6,1361204138820,1361204138820,1625519476,1625519476,0
1361204139,1625519656,6,1942,323.6666667,1361204138820,1361204138884,1625519476,1625519540,64
1361204139,1625519664,330,489542,1483.460606,1361204131772,1361204134716,1625512436,1625515380,2944
1361204139,1625519664,25,30944,1237.76,1361204131772,1361204132028,1625512436,1625512692,256
1361204139,1625519664,11,10956,996,1361204131772,1361204131900,1625512436,1625512564,128
1361204139,1625519664,40,54365,1359.125,1361204131772,1361204132668,1625512436,1625513332,896
1361204139,1625519664,291,430791,1480.381443,1361204131772,1361204134588,1625512436,1625515252,2816
1361204139,1625519664,3,150,50,1361204131836,1361204137212,1625512500,1625517876,5376
1361204139,1625519664,2,98,49,1361204131836,1361204137212,1625512500,1625517876,5376
1361204139,1625519664,2,98,49,1361204131836,1361204137212,1625512500,1625517876,5376
1361204139,1625519664,3,144,48,1361204131836,1361204137212,1625512500,1625517876,5376
1361204139,1625519664,2,98,49,1361204131836,1361204137212,1625512500,1625517876,5376
1361204139,1625519664,3,150,50,1361204131836,1361204138236,1625512500,1625518900,6400
1361204139,1625519668,3,144,48,1361204131895,1361204137207,1625512563,1625517875,5312
1361204139,1625519668,3,144,48,1361204131831,1361204137207,1625512499,1625517875,5376
1361204139,1625519668,3,150,50,1361204131831,1361204137207,1625512499,1625517875,5376
1361204139,1625519668,3,144,48,1361204131895,1361204137207,1625512563,1625517875,5312
1361204139,1625519668,5,1118,223.6,1361204131962,1361204132090,1625512630,1625512758,128
1361204139,1625519668,5,1365,273,1361204132026,1361204132090,1625512694,1625512758,64
1361204139,1625519668,6,2256,376,1361204132026,1361204132090,1625512694,1625512758,64
1361204139,1625519668,4,313,78.25,1361204132089,1361204132153,1625512757,1625512821,64
1361204139,1625519668,37,50285,1359.054054,1361204132089,1361204132409,1625512757,1625513077,320
1361204139,1625519668,2,98,49,1361204132089,1361204137209,1625512757,1625517877,5120
1361204139,1625519668,25,30407,1216.28,1361204132153,1361204132409,1625512821,1625513077,256
1361204139,1625519668,2,98,49,1361204132153,1361204137209,1625512821,1625517877,5056
1361204139,1625519668,2,98,49,1361204132152,1361204137208,1625512820,1625517876,5056
1361204139,1625519668,4,312,78,1361204132152,1361204132280,1625512820,1625512948,128
1361204139,1625519672,36,46792,1299.777778,1361204136115,1361204138291,1625516787,1625518963,2176
1361204139,1625519672,5,1651,330.2,1361204132724,1361204132980,1625513396,1625513652,256
1361204139,1625519672,163,237844,1459.165644,1361204132724,1361204135540,1625513396,1625516212,2816
1361204139,1625519676,6,2067,344.5,1361204132979,1361204133107,1625513655,1625513783,128
1361204139,1625519676,2,98,49,1361204133042,1361204138226,1625513718,1625518902,5184
1361204139,1625519676,2,98,49,1361204133042,1361204138226,1625513718,1625518902,5184
1361204139,1625519676,2,98,49,1361204133106,1361204138162,1625513782,1625518838,5056
1361204139,1625519676,6,2104,350.6666667,1361204133106,1361204133170,1625513782,1625513846,64
1361204139,1625519676,5,3498,699.6,1361204133042,1361204133170,1625513718,1625513846,128
1361204139,1625519676,3,144,48,1361204133106,1361204138162,1625513782,1625518838,5056
1361204139,1625519676,4,392,98,1361204133169,1361204133297,1625513845,1625513973,128
1361204139,1625519676,6,1788,298,1361204133169,1361204133233,1625513845,1625513909,64
1361204139,1625519676,6,4203,700.5,1361204133169,1361204133233,1625513845,1625513909,64
1361204139,1625519676,5,380,76,1361204133169,1361204133233,1625513845,1625513909,64
1361204139,1625519696,296,439138,1483.574324,1361204133532,1361204134876,1625514228,1625515572,1344
1361204139,1625519708,35,45416,1297.6,1361204138255,1361204138639,1625518963,1625519347,384
1361204142,1625523340,28,36124,1290.142857,1361204137627,1361204137947,1625518967,1625519287,320
1361204142,1625523340,7,1920,274.2857143,1361204137691,1361204137755,1625519031,1625519095,64
1361204144,263838760,2,98,49,1361204131224,1361204136472,263825984,263831232,5248
1361204144,263838760,2,98,49,1361204131228,1361204136476,263825988,263831236,5248
1361204145,263838792,2,98,49,1361204132193,1361204137441,263825985,263831233,5248
1361204147,1625527612,7,2230,318.5714286,1361204138930,1361204138994,1625519542,1625519606,64
1361204147,1625527612,7,1870,267.1428571,1361204138930,1361204138994,1625519542,1625519606,64
1361204147,1625527612,6,1589,264.8333333,1361204138930,1361204138994,1625519542,1625519606,64
1361204147,1625527612,7,1931,275.8571429,1361204138991,1361204139055,1625519603,1625519667,64
1361204147,1625527616,238,349184,1467.159664,1361204138991,1361204140911,1625519607,1625521527,1920
1361204147,1625527616,7,1796,256.5714286,1361204138862,1361204138926,1625519478,1625519542,64
1361204147,1625527616,30,38157,1271.9,1361204138861,1361204139053,1625519477,1625519669,192
1361204147,1625527620,64,88807,1387.609375,1361204143211,1361204143723,1625523831,1625524343,512
1361204147,1625527652,25,30950,1238,1361204141255,1361204141575,1625521907,1625522227,320
1361204147,1625527652,6,432,72,1361204141259,1361204141323,1625521911,1625521975,64
1361204147,1625527652,17,18401,1082.411765,1361204141259,1361204141451,1625521911,1625522103,192
1361204147,1625527652,8,5146,643.25,1361204141450,1361204141514,1625522102,1625522166,64
1361204147,1625527652,13,13146,1011.230769,1361204141257,1361204141385,1625521909,1625522037,128
1361204147,1625527652,59,82157,1392.491525,1361204141321,1361204141897,1625521973,1625522549,576
1361204147,1625527652,6,432,72,1361204141576,1361204141640,1625522228,1625522292,64
1361204147,1625527652,7,2589,369.8571429,1361204141576,1361204141704,1625522228,1625522356,128
1361204147,1625527656,6,1698,283,1361204141635,1361204141699,1625522291,1625522355,64
1361204147,1625527656,7,3699,528.4285714,1361204141703,1361204141767,1625522359,1625522423,64
1361204147,1625527656,7,4206,600.8571429,1361204141956,1361204142084,1625522612,1625522740,128
1361204147,1625527656,2,98,49,1361204133508,1361204139204,1625514164,1625519860,5696
1361204147,1625527660,7,3952,564.5714286,1361204142147,1361204142275,1625522807,1625522935,128
1361204147,1625527660,11,9841,894.6363636,1361204142147,1361204142275,1625522807,1625522935,128
1361204147,1625527660,4,313,78.25,1361204142210,1361204142274,1625522870,1625522934,64
1361204147,1625527668,6,1680,280,1361204138937,1361204139001,1625519605,1625519669,64
1361204147,1625527692,6,3988,664.6666667,1361204146722,1361204146786,1625527414,1625527478,64
1361204147,1625527692,28,35365,1263.035714,1361204138785,1361204138977,1625519477,1625519669,192
1361204147,1625527692,33,43375,1314.393939,1361204138784,1361204140064,1625519476,1625520756,1280
1361204147,1625527708,43,57346,1333.627907,1361204140817,1361204141201,1625521525,1625521909,384
1361204147,1625527712,12,11008,917.3333333,1361204141199,1361204141263,1625521911,1625521975,64
1361204147,1625527712,37,48528,1311.567568,1361204141199,1361204141455,1625521911,1625522167,256
1361204147,1625527712,10,7779,777.9,1361204141262,1361204141326,1625521974,1625522038,64
1361204147,1625527712,7,2829,404.1428571,1361204141326,1361204141454,1625522038,1625522166,128
1361204147,1625527712,6,431,71.83333333,1361204141326,1361204141454,1625522038,1625522166,128
1361204147,1625527712,4,1574,393.5,1361204141453,1361204141517,1625522165,1625522229,64
1361204147,1625527728,22,26512,1205.090909,1361204141502,1361204141822,1625522230,1625522550,320
1361204147,1625527728,7,2575,367.8571429,1361204141502,1361204141630,1625522230,1625522358,128
1361204147,1625527728,7,1839,262.7142857,1361204141502,1361204141630,1625522230,1625522358,128
1361204147,1625527728,8,5690,711.25,1361204141629,1361204141693,1625522357,1625522421,64
1361204147,1625527728,7,2000,285.7142857,1361204141629,1361204141693,1625522357,1625522421,64
1361204147,1625527728,6,1612,268.6666667,1361204141629,1361204141757,1625522357,1625522485,128
1361204147,1625527728,6,1674,279,1361204141692,1361204141756,1625522420,1625522484,64
1361204147,1625527728,7,1994,284.8571429,1361204141692,1361204141756,1625522420,1625522484,64
1361204147,1625527728,9,6248,694.2222222,1361204141692,1361204141820,1625522420,1625522548,128
1361204147,1625527732,28,35985,1285.178571,1361204142074,1361204142330,1625522806,1625523062,256
1361204147,1625527732,11,9873,897.5454545,1361204142073,1361204142201,1625522805,1625522933,128
1361204147,1625527736,6,1538,256.3333333,1361204145588,1361204145652,1625526324,1625526388,64
1361204151,1625531428,1,134,134,1361204126378,1361204126378,1625506806,1625506806,0
1361204153,263846780,8,544,68,1361204142894,1361204148142,263836674,263841922,5248
1361204155,1625535652,8,535,66.875,1361204142665,1361204147913,1625523317,1625528565,5248
1361204155,1625535668,8,4994,624.25,1361204152378,1361204152506,1625533046,1625533174,128
1361204155,1625535668,34,42816,1259.294118,1361204148857,1361204149433,1625529525,1625530101,576
1361204155,1625535692,9,6449,716.5555556,1361204149408,1361204149536,1625530100,1625530228,128
1361204155,1625535692,8,5648,706,1361204149408,1361204149536,1625530100,1625530228,128
1361204155,1625535692,7,4625,660.7142857,1361204149408,1361204149664,1625530100,1625530356,256
1361204155,1625535696,8,4827,603.375,1361204149659,1361204149723,1625530355,1625530419,64
1361204155,1625535696,10,8428,842.8,1361204149659,1361204149723,1625530355,1625530419,64
1361204155,1625535696,8,5628,703.5,1361204149663,1361204149727,1625530359,1625530423,64
1361204155,1625535696,8,4976,622,1361204149727,1361204149855,1625530423,1625530551,128
1361204155,1625535696,7,4067,581,1361204149727,1361204149855,1625530423,1625530551,128
1361204155,1625535696,7,4542,648.8571429,1361204149727,1361204149855,1625530423,1625530551,128
1361204155,1625535696,7,3652,521.7142857,1361204149727,1361204149919,1625530423,1625530615,192
1361204155,1625535696,7,3530,504.2857143,1361204149918,1361204150046,1625530614,1625530742,128
1361204155,1625535696,8,3309,413.625,1361204150043,1361204150427,1625530739,1625531123,384
1361204155,1625535732,63,88602,1406.380952,1361204147896,1361204148408,1625528628,1625529140,512
1361204155,1625535736,33,42798,1296.909091,1361204151734,1361204152246,1625532470,1625532982,512
1361204155,1625535740,8,6066,758.25,1361204149360,1361204149616,1625530100,1625530356,256
1361204155,1625535740,8,4994,624.25,1361204149360,1361204149616,1625530100,1625530356,256
1361204155,1625535740,8,5646,705.75,1361204149360,1361204149616,1625530100,1625530356,256
1361204155,1625535744,10,7757,775.7,1361204149483,1361204149611,1625530227,1625530355,128
1361204155,1625535744,9,6711,745.6666667,1361204149614,1361204149678,1625530358,1625530422,64
1361204155,1625535744,8,5617,702.125,1361204149614,1361204149678,1625530358,1625530422,64
1361204155,1625535744,7,3549,507,1361204149869,1361204149997,1625530613,1625530741,128
1361204155,1625535776,8,6157,769.625,1361204149646,1361204149838,1625530422,1625530614,192
1361204155,1625535776,7,4126,589.4285714,1361204149646,1361204149838,1625530422,1625530614,192
1361204155,1625535776,43,55834,1298.465116,1361204149773,1361204150477,1625530549,1625531253,704
1361204155,1625535776,7,3263,466.1428571,1361204149773,1361204149965,1625530549,1625530741,192
1361204155,1625535776,7,3550,507.1428571,1361204149837,1361204149965,1625530613,1625530741,128
1361204155,1625535776,7,3492,498.8571429,1361204149837,1361204149965,1625530613,1625530741,128
1361204155,1625535780,72,101190,1405.416667,1361204150411,1361204151115,1625531191,1625531895,704
1361204155,1625535780,65,90890,1398.307692,1361204153354,1361204153802,1625534134,1625534582,448
1361204156,263850304,6,3712,618.6666667,1361204131682,1361204132066,263825986,263826370,384
1361204156,263850332,5,3662,732.4,1361204131653,1361204131781,263825985,263826113,128
1361204156,263850332,4,2923,730.75,1361204131653,1361204131781,263825985,263826113,128
1361204158,1625539368,5,4202,840.4,1361204131133,1361204131133,1625512501,1625512501,0
1361204158,1625539368,6,4905,817.5,1361204131133,1361204131133,1625512501,1625512501,0
1361204158,1625539368,16,20486,1280.375,1361204131133,1361204131773,1625512501,1625513141,640
1361204158,1625539368,14,17516,1251.142857,1361204131133,1361204131261,1625512501,1625512629,128
1361204158,1625539368,9,9317,1035.222222,1361204131133,1361204131261,1625512501,1625512629,128
1361204158,1625539368,9,9922,1102.444444,1361204131133,1361204131261,1625512501,1625512629,128
1361204158,1625539368,15,14450,963.3333333,1361204131133,1361204131837,1625512501,1625513205,704
1361204158,1625539368,9,7808,867.5555556,1361204131133,1361204131709,1625512501,1625513077,576
1361204158,1625539368,18,23656,1314.222222,1361204131133,1361204131325,1625512501,1625512693,192
1361204158,1625539368,15,18157,1210.466667,1361204131133,1361204131261,1625512501,1625512629,128
1361204158,1625539372,14,15761,1125.785714,1361204131451,1361204131515,1625512823,1625512887,64
1361204158,1625539372,6,4722,787,1361204131451,1361204131451,1625512823,1625512823,0
1361204158,1625539392,8,8740,1092.5,1361204131430,1361204131878,1625512822,1625513270,448
1361204158,1625539396,6,1762,293.6666667,1361204131938,1361204140898,1625513334,1625522294,8960
1361204158,1625539396,14,17074,1219.571429,1361204132002,1361204132322,1625513398,1625513718,320
1361204158,1625539400,5,3741,748.2,1361204132318,1361204132382,1625513718,1625513782,64
1361204158,1625539400,5,3940,788,1361204132318,1361204132510,1625513718,1625513910,192
1361204158,1625539400,14,17088,1220.571429,1361204132318,1361204132382,1625513718,1625513782,64
1361204158,1625539404,4,3054,763.5,1361204132761,1361204134681,1625514165,1625516085,1920
1361204159,1625539444,5,3841,768.2,1361204132056,1361204132056,1625512500,1625512500,0
1361204159,1625539444,54,75550,1399.074074,1361204131992,1361204132440,1625512436,1625512884,448
1361204159,1625539444,5,3570,714,1361204132056,1361204132056,1625512500,1625512500,0
1361204159,1625539444,33,46335,1404.090909,1361204132056,1361204132824,1625512500,1625513268,768
1361204159,1625539444,8,6950,868.75,1361204132055,1361204132631,1625512499,1625513075,576
1361204159,1625539444,14,16699,1192.785714,1361204132055,1361204132119,1625512499,1625512563,64
1361204159,1625539444,7,5806,829.4285714,1361204132055,1361204132439,1625512499,1625512883,384
1361204159,1625539444,9,9252,1028,1361204132055,1361204132119,1625512499,1625512563,64
1361204159,1625539444,6,4784,797.3333333,1361204132055,1361204132119,1625512499,1625512563,64
1361204159,1625539448,8,8930,1116.25,1361204132051,1361204132627,1625512499,1625513075,576
1361204159,1625539448,6,5970,995,1361204132055,1361204132119,1625512503,1625512567,64
1361204159,1625539448,26,35446,1363.307692,1361204132055,1361204132823,1625512503,1625513271,768
1361204159,1625539476,5,4414,882.8,1361204133242,1361204133306,1625513718,1625513782,64
1361204159,1625539476,10,6981,698.1,1361204133369,1361204142329,1625513845,1625522805,8960
1361204159,1625539476,25,32584,1303.36,1361204133432,1361204133560,1625513908,1625514036,128
1361204163,1625543632,65,91368,1405.661538,1361204156829,1361204157149,1625537461,1625537781,320
1361204163,1625543656,33,42762,1295.818182,1361204157639,1361204157895,1625538295,1625538551,256
1361204163,1625543688,31,40517,1307,1361204155301,1361204155685,1625535989,1625536373,384
1361204163,1625543692,76,106869,1406.171053,1361204158943,1361204160351,1625539635,1625541043,1408
1361204166,1625547348,1,46,46,1361204138192,1361204138192,1625519540,1625519540,0
1361204166,1625547396,1,46,46,1361204141023,1361204141023,1625522419,1625522419,0
1361204166,1625547400,9,1912,212.4444444,1361204141468,1361204165340,1625522868,1625546740,23872
1361204167,1625547424,1,46,46,1361204139119,1361204139119,1625519543,1625519543,0
1361204167,1625547480,1,46,46,1361204142006,1361204142006,1625522486,1625522486,0
1361204167,1625547484,9,1913,212.5555556,1361204142322,1361204163506,1625522806,1625543990,21184
1361204167,1625547484,78,76550,981.4102564,1361204142512,1361204166576,1625522996,1625547060,24064
1361204168,263862324,30,38509,1283.633333,1361204142349,1361204142477,263836673,263836801,128
1361204171,1625551428,7,974,139.1428571,1361204142888,1361204143208,1625523316,1625523636,320
1361204171,1625551512,1,46,46,1361204146454,1361204146454,1625526966,1625526966,0
1361204171,1625551604,74,104077,1406.445946,1361204167033,1361204167353,1625547637,1625547957,320
1361204171,1625551612,33,42759,1295.727273,1361204167794,1361204168114,1625548406,1625548726,320
1361204171,1625551656,33,42779,1296.333333,1361204169990,1361204170246,1625550646,1625550902,256
1361204171,1625551680,33,42719,1294.515152,1361204159150,1361204163054,1625539830,1625543734,3904
1361204171,1625551680,59,81485,1381.101695,1361204164140,1361204164716,1625544820,1625545396,576
1361204171,1625551680,33,42678,1293.272727,1361204164204,1361204165868,1625544884,1625546548,1664
1361204171,1625551692,3,144,48,1361204165921,1361204165921,1625546613,1625546613,0
1361204171,1625551692,3,286,95.33333333,1361204166111,1361204166175,1625546803,1625546867,64
1361204171,1625551720,62,86581,1396.467742,1361204169092,1361204169604,1625549812,1625550324,512
1361204174,1625555380,1,46,46,1361204146674,1361204146674,1625528054,1625528054,0
1361204175,1625555460,1,46,46,1361204147081,1361204147081,1625527541,1625527541,0
1361204175,1625555536,2,472,236,1361204150526,1361204150718,1625531062,1625531254,192
1361204179,1625559636,63,87295,1385.634921,1361204171416,1361204172056,1625552052,1625552692,640
1361204179,1625559644,33,42768,1296,1361204172178,1361204172498,1625552822,1625553142,320
1361204179,1625559648,7,3976,568,1361204176332,1361204176396,1625556980,1625557044,64
1361204179,1625559684,7,4110,587.1428571,1361204174378,1361204174442,1625555062,1625555126,64
1361204179,1625559712,75,105282,1403.76,1361204175502,1361204176078,1625556214,1625556790,576
1361204179,1625559720,88,123986,1408.931818,1361204173572,1361204174468,1625554292,1625555188,896
1361204179,1625559756,56,77613,1385.946429,1361204177313,1361204177761,1625558069,1625558517,448
1361204179,1625559760,33,42857,1298.69697,1361204178140,1361204178396,1625558900,1625559156,256
1361204183,1625563436,1,46,46,1361204158559,1361204158559,1625538995,1625538995,0
1361204187,1625567664,31,40436,1304.387097,1361204181309,1361204181757,1625561973,1625562421,448
1361204187,1625567664,7,3090,441.4285714,1361204181756,1361204181884,1625562420,1625562548,128
1361204187,1625567668,7,3868,552.5714286,1361204181753,1361204181881,1625562421,1625562549,128
1361204187,1625567704,71,100012,1408.619718,1361204179539,1361204180371,1625560243,1625561075,832
1361204191,1625571540,13,7373,567.1538462,1361204166394,1361204172474,1625546934,1625553014,6080
1361204194,1625575412,10,2335,233.5,1361204167441,1361204189969,1625548853,1625571381,22528
1361204194,1625575412,85,82693,972.8588235,1361204167568,1361204193424,1625548980,1625574836,25856
1361204195,1625575432,6,913,152.1666667,1361204168676,1361204168996,1625549108,1625549428,320
1361204195,1625575476,10,2362,236.2,1361204170618,1361204193978,1625551094,1625574454,23360
1361204195,1625575488,2,265,132.5,1361204167662,1361204167726,1625548150,1625548214,64
1361204195,1625575660,56,76956,1374.214286,1361204191488,1361204192320,1625572148,1625572980,832
1361204195,1625575696,33,42768,1296,1361204192923,1361204193563,1625573619,1625574259,640
1361204195,1625575704,77,108921,1414.558442,1361204182803,1361204192723,1625563507,1625573427,9920
1361204195,1625575768,33,42813,1297.363636,1361204189907,1361204190291,1625570675,1625571059,384
1361204199,1625579428,7,322,46,1361204171815,1361204196519,1625552243,1625576947,24704
1361204201,263894856,2,98,49,1361204194403,1361204197859,263888259,263891715,3456
1361204201,263894856,2,98,49,1361204194339,1361204199331,263888195,263893187,4992
1361204203,1625583660,64,90151,1408.609375,1361204199232,1361204199808,1625579892,1625580468,576
1361204203,1625583668,33,42819,1297.545455,1361204199993,1361204200313,1625580661,1625580981,320
1361204203,1625583688,33,42796,1296.848485,1361204197731,1361204198115,1625578419,1625578803,384
1361204203,1625583696,68,95012,1397.235294,1361204201372,1361204201884,1625582068,1625582580,512
1361204203,1625583708,7,4043,577.5714286,1361204195473,1361204195537,1625576181,1625576245,64
1361204203,1625583736,79,112224,1420.556962,1361204196597,1361204197109,1625577333,1625577845,512
1361204203,1625583748,8,4988,623.5,1361204198058,1361204198698,1625578806,1625579446,640
1361204203,1625583776,72,101234,1406.027778,1361204193165,1361204195213,1625573941,1625575989,2048
1361204203,1625583776,7,3791,541.5714286,1361204202061,1361204202189,1625582837,1625582965,128
1361204211,1625591684,31,40367,1302.16129,1361204203304,1361204203560,1625583988,1625584244,256
1361204211,1625591728,7,3790,541.4285714,1361204206014,1361204206078,1625586742,1625586806,64
1361204211,1625591736,31,40367,1302.16129,1361204207092,1361204207412,1625587828,1625588148,320
1361204211,1625591760,7,3796,542.2857143,1361204204059,1361204204443,1625584819,1625585203,384
1361204211,1625591772,31,40367,1302.16129,1361204205138,1361204205458,1625585910,1625586230,320
1361204219,1625599436,2,472,236,1361204191137,1361204191201,1625571573,1625571637,64
1361204219,1625599664,2,92,46,1361204194557,1361204194557,1625575221,1625575221,0
1361204219,1625599796,72,101190,1405.416667,1361204215606,1361204217270,1625596402,1625598066,1664
1361204223,1625603460,65,64340,989.8461538,1361204195976,1361204216584,1625576436,1625597044,20608
1361204223,1625603496,6,1397,232.8333333,1361204198435,1361204206435,1625578931,1625586931,8000
1361204223,1625603536,8,1872,234,1361204195772,1361204216124,1625576308,1625596660,20352
1361204227,1625607500,2,92,46,1361204201504,1361204201568,1625582004,1625582068,64
1361204227,1625607836,3,144,48,1361204225745,1361204225809,1625606581,1625606645,64
1361204231,1625611620,1,134,134,1361204206183,1361204206183,1625586803,1625586803,0
1361204243,1625623476,1,416,416,1361204215481,1361204215481,1625595957,1625595957,0
1361204243,1625623504,4,2367,591.75,1361204216667,1361204216859,1625597171,1625597363,192
1361204251,1625631476,2,265,132.5,1361204223545,1361204223609,1625604021,1625604085,64
1361204251,1625631728,2,92,46,1361204247931,1361204247931,1625628659,1625628659,0
1361204251,1625631796,2,92,46,1361204247865,1361204247865,1625628661,1625628661,0
1361204251,1625631796,2,92,46,1361204247864,1361204247864,1625628660,1625628660,0
1361204251,1625631796,2,92,46,1361204247864,1361204247864,1625628660,1625628660,0
1361204259,1625639480,2,472,236,1361204231091,1361204231155,1625611571,1625611635,64
1361204259,1625639768,4,205,51.25,1361204257877,1361204257877,1625638645,1625638645,0
1361204263,1625643524,4,1674,418.5,1361204237064,1361204237192,1625617588,1625617716,128
1361204263,1625643572,2,324,162,1361204236183,1361204246231,1625616755,1625626803,10048
1361204265,263958868,2,123,61.5,1361204258134,1361204258134,263952002,263952002,0
1361204272,263966332,1,46,46,1361204247689,1361204247689,263942021,263942021,0
1361204272,263966372,1,46,46,1361204247648,1361204247648,263942020,263942020,0
1361204272,263966372,1,46,46,1361204247649,1361204247649,263942021,263942021,0
1361204275,1625655500,1,46,46,1361204247134,1361204247134,1625627634,1625627634,0
1361204275,1625655500,1,46,46,1361204247134,1361204247134,1625627634,1625627634,0
1361204275,1625655500,1,46,46,1361204247134,1361204247134,1625627634,1625627634,0
1361204275,1625655500,1,46,46,1361204247133,1361204247133,1625627633,1625627633,0
1361204275,1625655500,1,46,46,1361204247133,1361204247133,1625627633,1625627633,0
1361204275,1625655512,1,46,46,1361204248148,1361204248148,1625628660,1625628660,0
1361204275,1625655512,1,46,46,1361204248148,1361204248148,1625628660,1625628660,0
1361204275,1625655512,1,46,46,1361204248148,1361204248148,1625628660,1625628660,0
1361204275,1625655512,1,46,46,1361204248148,1361204248148,1625628660,1625628660,0
1361204275,1625655512,1,46,46,1361204248148,1361204248148,1625628660,1625628660,0
1361204275,1625655512,1,46,46,1361204248148,1361204248148,1625628660,1625628660,0
1361204275,1625655512,1,46,46,1361204248148,1361204248148,1625628660,1625628660,0
1361204275,1625655512,1,46,46,1361204248148,1361204248148,1625628660,1625628660,0
1361204275,1625655536,1,46,46,1361204249210,1361204249210,1625629746,1625629746,0
1361204275,1625655612,1,46,46,1361204247024,1361204247024,1625627636,1625627636,0
1361204275,1625655612,1,46,46,1361204247024,1361204247024,1625627636,1625627636,0
1361204275,1625655612,1,46,46,1361204247024,1361204247024,1625627636,1625627636,0
1361204275,1625655612,1,46,46,1361204247024,1361204247024,1625627636,1625627636,0
1361204275,1625655612,1,46,46,1361204247024,1361204247024,1625627636,1625627636,0
1361204275,1625655620,1,46,46,1361204248038,1361204248038,1625628658,1625628658,0
1361204275,1625655620,1,46,46,1361204248038,1361204248038,1625628658,1625628658,0
1361204275,1625655620,1,46,46,1361204248038,1361204248038,1625628658,1625628658,0
1361204275,1625655652,1,46,46,1361204249096,1361204249096,1625629748,1625629748,0
1361204275,1625655652,1,46,46,1361204249096,1361204249096,1625629748,1625629748,0
1361204275,1625655652,1,46,46,1361204249096,1361204249096,1625629748,1625629748,0
1361204275,1625655652,1,46,46,1361204249096,1361204249096,1625629748,1625629748,0
1361204275,1625655652,1,46,46,1361204249096,1361204249096,1625629748,1625629748,0
1361204283,1625663532,1,46,46,1361204257470,1361204257470,1625638002,1625638002,0
1361204283,1625663584,1,46,46,1361204255690,1361204255690,1625636274,1625636274,0
1361204283,1625663620,1,46,46,1361204257382,1361204257382,1625638002,1625638002,0
1361204287,1625667508,1,46,46,1361204259094,1361204259094,1625639602,1625639602,0
1361204291,1625672148,3,144,48,1361204285526,1361204285526,1625666674,1625666674,0
1361204291,1625672192,4,205,51.25,1361204283499,1361204283499,1625664691,1625664691,0
1361204295,1625675936,1,46,46,1361204267564,1361204267564,1625648500,1625648500,0
1361204299,1625680168,2,472,236,1361204271425,1361204271489,1625652593,1625652657,64
1361204303,1625683844,2,92,46,1361204276166,1361204276230,1625657010,1625657074,64
1361204307,1625688056,2,265,132.5,1361204278709,1361204278773,1625659765,1625659829,64
1361204311,1625692068,2,324,162,1361204285734,1361204302118,1625666802,1625683186,16384
1361204323,1625704020,3,189,63,1361204317141,1361204320213,1625698161,1625701233,3072
1361204323,1625704048,2,92,46,1361204321658,1361204321658,1625702706,1625702706,0
1361204323,1625704052,3,189,63,1361204318200,1361204321208,1625699252,1625702260,3008
1361204323,1625704112,2,92,46,1361204296060,1361204296124,1625677172,1625677236,64
1361204339,1625719928,2,92,46,1361204331761,1361204331761,1625712689,1625712689,0
1361204339,1625719928,4,205,51.25,1361204331761,1361204331761,1625712689,1625712689,0
1361204339,1625720004,2,126,63,1361204324200,1361204332264,1625705204,1625713268,8064
1361204339,1625720012,2,126,63,1361204325278,1361204333342,1625706290,1625714354,8064
1361204339,1625720156,2,472,236,1361204311693,1361204311757,1625692849,1625692913,64
1361204347,1625727988,4,312,78,1361204346484,1361204346612,1625727472,1625727600,128
1361204347,1625727988,4,312,78,1361204346616,1361204346744,1625727604,1625727732,128
1361204347,1625727988,4,312,78,1361204346615,1361204346679,1625727603,1625727667,64
1361204347,1625727988,4,312,78,1361204346679,1361204346807,1625727667,1625727795,128
1361204347,1625728060,3,144,48,1361204345519,1361204345519,1625726579,1625726579,0
1361204347,1625728060,4,312,78,1361204346285,1361204346349,1625727345,1625727409,64
1361204351,1625731936,1,134,134,1361204325931,1361204325931,1625706867,1625706867,0
1361204355,1625735960,3,189,63,1361204348371,1361204351379,1625729331,1625732339,3008
1361204355,1625736300,1,46,46,1361204330367,1361204330367,1625711667,1625711667,0
1361204359,1625740052,2,265,132.5,1361204334580,1361204334708,1625715632,1625715760,128
1361204371,1625751876,7,1406,200.8571429,1361204363813,1361204368933,1625744689,1625749809,5120
1361204371,1625751876,7,1406,200.8571429,1361204363813,1361204368933,1625744689,1625749809,5120
1361204371,1625751992,2,126,63,1361204355379,1361204363443,1625736371,1625744435,8064
1361204371,1625751996,7,1406,200.8571429,1361204363696,1361204368816,1625744692,1625749812,5120
1361204371,1625752148,3,1071,357,1361204346134,1361204346198,1625727282,1625727346,64
1361204371,1625752152,16,18078,1129.875,1361204346259,1361204346515,1625727411,1625727667,256
1361204379,1625760128,2,472,236,1361204351787,1361204351851,1625732915,1625732979,64
1361204387,1625768268,12,2286,190.5,1361204362525,1361204363037,1625743793,1625744305,512
1361204391,1625772204,1,190,190,1361204365662,1361204365662,1625746866,1625746866,0
1361204403,1625783948,4,252,63,1361204394655,1361204401695,1625775603,1625782643,7040
1361204415,1625796232,2,265,132.5,1361204390400,1361204390528,1625771632,1625771760,128
1361204419,1625800244,2,472,236,1361204392117,1361204392181,1625773361,1625773425,64
1361204427,1625808120,3,144,48,1361204422768,1361204422768,1625803888,1625803888,0
1361204431,1625812156,2,324,162,1361204405709,1361204430349,1625786865,1625811505,24640
1361204435,1625816300,1,63,63,1361204409406,1361204409406,1625790706,1625790706,0
1361204459,1625840336,2,472,236,1361204432088,1361204432152,1625813424,1625813488,64
1361204472,1625852428,1,134,134,1361204446438,1361204446438,1625826866,1625826866,0
1361204472,1625852508,2,265,132.5,1361204446293,1361204446357,1625826801,1625826865,64
1361204481,1625861416,1,48,48,1361204453872,1361204453872,1625834288,1625834288,0
1361204481,1625862376,1,48,48,1361204453041,1361204453041,1625834417,1625834417,0
1361204483,1625863984,4,205,51.25,1361204478841,1361204478841,1625859825,1625859825,0
1361204487,1625868400,1,46,46,1361204461401,1361204461401,1625842801,1625842801,0
1361204488,1625868480,1,46,46,1361204462319,1361204462319,1625842799,1625842799,0
1361204491,1625871968,4,347,86.75,1361204485960,1361204485960,1625866928,1625866928,0
1361204500,1625880444,2,472,236,1361204472914,1361204472978,1625853358,1625853422,64
1361204507,1625888024,3,144,48,1361204499535,1361204499535,1625880559,1625880559,0
1361204512,1625892520,13,2524,194.1538462,1361204486407,1361204502215,1625866927,1625882735,15808
1361204513,264206876,2,98,49,1361204504850,1361204508434,264198726,264202310,3584
1361204513,264206896,2,98,49,1361204504827,1361204509435,264198723,264203331,4608
1361204528,1625908456,2,265,132.5,1361204501832,1361204501896,1625882288,1625882352,64
1361204540,1625920568,2,472,236,1361204512599,1361204512663,1625893167,1625893231,64
1361204552,1625932620,1,134,134,1361204526308,1361204526308,1625906928,1625906928,0
1361204556,1625936632,18,8641,480.0555556,1361204530582,1361204547542,1625911214,1625928174,16960
1361204556,1625936636,17,5734,337.2941176,1361204531155,1361204547283,1625911791,1625927919,16128
1361204560,1625940516,4,574,143.5,1361204532747,1361204548299,1625913263,1625928815,15552
1361204560,1625940516,48,62911,1310.645833,1361204532810,1361204548170,1625913326,1625928686,15360
1361204563,1625943952,3,144,48,1361204555606,1361204555606,1625936558,1625936558,0
1361204563,1625944004,2,123,61.5,1361204562209,1361204562209,1625943213,1625943213,0
1361204563,1625944008,2,123,61.5,1361204562592,1361204562592,1625943600,1625943600,0
1361204579,1625960056,4,184,46,1361204573423,1361204573423,1625954479,1625954479,0
1361204580,1625960516,2,472,236,1361204552714,1361204552778,1625933230,1625933294,64
1361204584,1625964600,1,190,190,1361204559733,1361204559733,1625940333,1625940333,0
1361204600,1625980652,37,15534,419.8378378,1361204573826,1361204593602,1625954478,1625974254,19776
1361204600,1625980660,8,1148,143.5,1361204574840,1361204594232,1625955500,1625974892,19392
1361204600,1625980748,1,46,46,1361204575010,1361204575010,1625955758,1625955758,0
1361204611,1625992036,2,123,61.5,1361204606594,1361204606594,1625987630,1625987630,0
1361204611,1625992040,188,264660,1407.765957,1361204574719,1361204608319,1625955759,1625989359,33600
1361204611,1625992076,2,123,61.5,1361204608155,1361204608155,1625989231,1625989231,0
1361204620,1626000704,2,472,236,1361204592078,1361204592142,1625972782,1625972846,64
1361204627,1626008084,4,891,222.75,1361204621584,1361204621648,1626002668,1626002732,64
1361204632,1626012752,2,324,162,1361204606175,1361204624031,1625986927,1626004783,17856
1361204635,1626016012,4,292,73,1361204632731,1361204632859,1626013743,1626013871,128
1361204635,1626016016,4,292,73,1361204633175,1361204633239,1626014191,1626014255,64
1361204635,1626016016,4,476,119,1361204633366,1361204633430,1626014382,1626014446,64
1361204635,1626016040,4,460,115,1361204633536,1361204633600,1626014576,1626014640,64
1361204635,1626016044,4,469,117.25,1361204633850,1361204633914,1626014894,1626014958,64
1361204635,1626016044,3,144,48,1361204630521,1361204630521,1626011565,1626011565,0
1361204635,1626016048,16,7318,457.375,1361204614518,1361204631222,1625995566,1626012270,16704
1361204635,1626016048,4,292,73,1361204631477,1361204631605,1626012525,1626012653,128
1361204635,1626016056,4,292,73,1361204631791,1361204631983,1626012847,1626013039,192
1361204635,1626016080,4,292,73,1361204632086,1361204632150,1626013166,1626013230,64
1361204635,1626016084,4,292,73,1361204632275,1361204632403,1626013359,1626013487,128
1361204635,1626016092,4,461,115.25,1361204633226,1361204633290,1626014318,1626014382,64
1361204635,1626016096,4,728,182,1361204633352,1361204633480,1626014448,1626014576,128
1361204635,1626016096,4,461,115.25,1361204633670,1361204633798,1626014766,1626014894,128
1361204635,1626016116,4,414,103.5,1361204633585,1361204633649,1626014701,1626014765,64
1361204635,1626016124,4,292,73,1361204631019,1361204631083,1626012143,1626012207,64
1361204635,1626016124,50,63306,1266.12,1361204615210,1361204631146,1625996334,1626012270,15936
1361204635,1626016128,4,386,96.5,1361204634343,1361204634471,1626015471,1626015599,128
1361204640,1626020752,1,46,46,1361204614814,1361204614814,1625995566,1625995566,0
1361204640,1626020760,4,574,143.5,1361204615446,1361204616790,1625996206,1625997550,1344
1361204640,1626020844,1,46,46,1361204615490,1361204615490,1625996334,1625996334,0
1361204643,1626024096,3,144,48,1361204636294,1361204636486,1626017390,1626017582,192
1361204651,1626032036,4,292,73,1361204650241,1361204650369,1626031277,1626031405,128
1361204656,1626036724,1,46,46,1361204628923,1361204628923,1626009647,1626009647,0
1361204660,1626040804,2,472,236,1361204632297,1361204632425,1626013101,1626013229,128
1361204672,1626052856,1,134,134,1361204646070,1361204646070,1626026926,1626026926,0
1361204675,1626056024,8,1505,188.125,1361204664332,1361204669388,1626045356,1626050412,5056
1361204675,1626056100,8,1505,188.125,1361204664258,1361204669314,1626045358,1626050414,5056
1361204676,1626056800,14,5380,384.2857143,1361204648750,1361204664174,1626029550,1626044974,15424
1361204691,1626072172,3,144,48,1361204690360,1361204690424,1626071532,1626071596,64
1361204699,1626080036,4,190,47.5,1361204697215,1361204698047,1626078251,1626079083,832
1361204699,1626080064,4,190,47.5,1361204698150,1361204698406,1626079214,1626079470,256
1361204699,1626080108,4,190,47.5,1361204697656,1361204698104,1626078764,1626079212,448
1361204699,1626080112,4,190,47.5,1361204697847,1361204698487,1626078959,1626079599,640
1361204699,1626080140,4,190,47.5,1361204698329,1361204698585,1626079469,1626079725,256
1361204700,1626080768,2,265,132.5,1361204671948,1361204672012,1626052716,1626052780,64
1361204700,1626080880,2,472,236,1361204672733,1361204672797,1626053613,1626053677,64
1361204707,1626088032,4,190,47.5,1361204698949,1361204699205,1626079981,1626080237,256
1361204707,1626088032,4,190,47.5,1361204698948,1361204699204,1626079980,1626080236,256
1361204707,1626088032,4,190,47.5,1361204699716,1361204699972,1626080748,1626081004,256
1361204707,1626088032,4,190,47.5,1361204699012,1361204701188,1626080044,1626082220,2176
1361204707,1626088032,4,190,47.5,1361204703875,1361204704195,1626084907,1626085227,320
1361204707,1626088032,4,190,47.5,1361204703875,1361204704195,1626084907,1626085227,320
1361204707,1626088036,4,190,47.5,1361204699968,1361204700224,1626081004,1626081260,256
1361204707,1626088036,4,190,47.5,1361204699200,1361204699456,1626080236,1626080492,256
1361204707,1626088036,4,190,47.5,1361204704192,1361204704512,1626085228,1626085548,320
1361204707,1626088036,4,190,47.5,1361204699199,1361204699455,1626080235,1626080491,256
1361204707,1626088036,4,190,47.5,1361204704191,1361204704575,1626085227,1626085611,384
1361204707,1626088040,4,190,47.5,1361204700539,1361204702715,1626081579,1626083755,2176
1361204707,1626088044,4,190,47.5,1361204699514,1361204699770,1626080558,1626080814,256
1361204707,1626088072,4,190,47.5,1361204697180,1361204699292,1626078252,1626080364,2112
1361204707,1626088076,4,190,47.5,1361204702168,1361204702680,1626083244,1626083756,512
1361204707,1626088080,4,190,47.5,1361204702549,1361204702613,1626083629,1626083693,64
1361204707,1626088080,4,190,47.5,1361204702677,1361204702741,1626083757,1626083821,64
1361204707,1626088080,4,190,47.5,1361204702740,1361204703252,1626083820,1626084332,512
1361204707,1626088080,4,190,47.5,1361204698387,1361204700499,1626079467,1626081579,2112
1361204707,1626088084,4,190,47.5,1361204702930,1361204702994,1626084014,1626084078,64
1361204707,1626088084,4,190,47.5,1361204702802,1361204702930,1626083886,1626084014,128
1361204707,1626088084,4,190,47.5,1361204702930,1361204702994,1626084014,1626084078,64
1361204707,1626088084,4,190,47.5,1361204703120,1361204703504,1626084204,1626084588,384
1361204707,1626088084,4,190,47.5,1361204703439,1361204703823,1626084523,1626084907,384
1361204707,1626088084,4,190,47.5,1361204703503,1361204703823,1626084587,1626084907,320
1361204707,1626088088,4,190,47.5,1361204699726,1361204699982,1626080814,1626081070,256
1361204707,1626088088,4,190,47.5,1361204703758,1361204704142,1626084846,1626085230,384
1361204707,1626088088,4,190,47.5,1361204703821,1361204704141,1626084909,1626085229,320
1361204707,1626088088,4,190,47.5,1361204699980,1361204700236,1626081068,1626081324,256
1361204707,1626088088,4,190,47.5,1361204704139,1361204704459,1626085227,1626085547,320
1361204707,1626088092,4,190,47.5,1361204700167,1361204700487,1626081259,1626081579,320
1361204707,1626088112,4,190,47.5,1361204700214,1361204700470,1626081326,1626081582,256
1361204707,1626088112,4,190,47.5,1361204700468,1361204702580,1626081580,1626083692,2112
1361204707,1626088112,4,190,47.5,1361204699380,1361204699636,1626080492,1626080748,256
1361204707,1626088112,4,190,47.5,1361204700467,1361204702579,1626081579,1626083691,2112
1361204707,1626088120,4,190,47.5,1361204701166,1361204701678,1626082286,1626082798,512
1361204707,1626088120,4,190,47.5,1361204697067,1361204699179,1626078187,1626080299,2112
1361204707,1626088124,4,190,47.5,1361204701674,1361204702122,1626082798,1626083246,448
1361204707,1626088152,4,190,47.5,1361204702476,1361204702604,1626083628,1626083756,128
1361204707,1626088152,4,190,47.5,1361204702539,1361204702667,1626083691,1626083819,128
1361204707,1626088152,4,190,47.5,1361204702667,1361204702731,1626083819,1626083883,64
1361204707,1626088156,4,190,47.5,1361204702602,1361204703114,1626083758,1626084270,512
1361204707,1626088156,4,190,47.5,1361204702730,1361204702858,1626083886,1626084014,128
1361204707,1626088156,4,190,47.5,1361204702666,1361204702730,1626083822,1626083886,64
1361204707,1626088156,4,190,47.5,1361204698569,1361204698825,1626079725,1626079981,256
1361204707,1626088156,4,190,47.5,1361204703048,1361204703368,1626084204,1626084524,320
1361204707,1626088156,4,190,47.5,1361204703048,1361204703368,1626084204,1626084524,320
1361204707,1626088156,4,190,47.5,1361204703048,1361204703368,1626084204,1626084524,320
1361204707,1626088160,4,190,47.5,1361204703366,1361204703686,1626084526,1626084846,320
1361204707,1626088160,4,190,47.5,1361204703366,1361204703750,1626084526,1626084910,384
1361204712,1626092840,2,324,162,1361204686150,1361204687558,1626066990,1626068398,1408
1361204716,1626096796,1,46,46,1361204688880,1361204688880,1626069676,1626069676,0
1361204716,1626096900,1,46,46,1361204688777,1361204688777,1626069677,1626069677,0
1361204728,1626108796,1,52,52,1361204700271,1361204700271,1626081067,1626081067,0
1361204740,1626120916,2,472,236,1361204713207,1361204713271,1626094123,1626094187,64
1361204752,1626132840,2,265,132.5,1361204727108,1361204727236,1626107948,1626108076,128
1361204752,1626132912,2,324,162,1361204726076,1361204751548,1626106988,1626132460,25472
1361204755,1626136112,3,144,48,1361204750450,1361204750450,1626131562,1626131562,0
1361204780,1626160976,2,472,236,1361204752827,1361204752891,1626133803,1626133867,64
1361204787,1626168100,4,211,52.75,1361204779393,1361204779649,1626160493,1626160749,256
1361204787,1626168136,4,312,78,1361204782042,1361204782170,1626163178,1626163306,128
1361204792,1626172964,1,134,134,1361204766023,1361204766023,1626146987,1626146987,0
1361204808,1626188976,4,552,138,1361204782139,1361204795259,1626163115,1626176235,13120
1361204811,1626192108,15,7288,485.8666667,1361204792631,1361204809207,1626173739,1626190315,16576
1361204811,1626192128,9,839,93.22222222,1361204805857,1361204809761,1626186985,1626190889,3904
1361204811,1626192220,29,33730,1163.103448,1361204794248,1361204809672,1626175468,1626190892,15424
1361204819,1626200092,4,336,84,1361204812293,1361204812357,1626193385,1626193449,64
1361204820,1626200932,13,5253,404.0769231,1361204793255,1361204794215,1626174187,1626175147,960
1361204820,1626201020,2,472,236,1361204793165,1361204793229,1626174185,1626174249,64
1361204825,264519336,2,98,49,1361204814472,1361204818952,264508808,264513288,4480
1361204825,264519336,2,98,49,1361204814407,1361204817927,264508743,264512263,3520
1361204827,1626208132,3,144,48,1361204825440,1361204825440,1626206572,1626206572,0
1361204836,1626216964,9,1893,210.3333333,1361204809928,1361204815112,1626190892,1626196076,5184
1361204859,1626240204,2,123,61.5,1361204853719,1361204853719,1626234923,1626234923,0
1361204860,1626240964,2,472,236,1361204833096,1361204833160,1626214060,1626214124,64
1361204872,1626253068,1,134,134,1361204845982,1361204845982,1626227050,1626227050,0
1361204876,1626257112,2,265,132.5,1361204851060,1361204851124,1626232172,1626232236,64
1361204891,1626272236,3,144,48,1361204885302,1361204885302,1626266538,1626266538,0
1361204896,1626277064,1,46,46,1361204868640,1361204868640,1626249704,1626249704,0
1361204896,1626277140,1,46,46,1361204868500,1361204868500,1626249640,1626249640,0
1361204896,1626277144,1,46,46,1361204868560,1361204868560,1626249704,1626249704,0
1361204900,1626281104,2,472,236,1361204872827,1361204872891,1626253931,1626253995,64
1361204904,1626285236,2,814,407,1361204879031,1361204885815,1626260267,1626267051,6784
1361204932,1626313180,2,265,132.5,1361204906605,1361204906733,1626287785,1626287913,128
1361204940,1626321124,2,472,236,1361204912614,1361204912678,1626293738,1626293802,64
1361204952,1626333180,2,324,162,1361204925867,1361204943211,1626307047,1626324391,17344
1361204963,1626344168,3,144,48,1361204960378,1361204960378,1626341546,1626341546,0
1361204963,1626344284,14,6603,471.6428571,1361204938757,1361204956357,1626320041,1626337641,17600
1361204964,1626345260,12,4904,408.6666667,1361204939485,1361204940637,1626320745,1626321897,1152
1361204979,1626360368,29,33746,1163.655172,1361204962033,1361204977457,1626343401,1626358825,15424
1361204980,1626361296,2,472,236,1361204952824,1361204952888,1626334120,1626334184,64
1361204988,1626369244,4,552,138,1361204961966,1361204962990,1626343210,1626344234,1024
1361204988,1626369312,11,1981,180.0909091,1361204963751,1361204964263,1626345063,1626345575,512
1361204992,1626373232,1,134,134,1361204965816,1361204965816,1626347048,1626347048,0
1361205003,1626384348,2,123,61.5,1361205000516,1361205000516,1626381864,1626381864,0
1361205020,1626401256,2,472,236,1361204992799,1361204992863,1626374055,1626374119,64
1361205027,1626408372,3,144,48,1361205023147,1361205023211,1626404519,1626404583,64
1361205032,1626413352,2,324,162,1361205005696,1361205006656,1626387048,1626388008,960
1361205044,1626425412,2,265,132.5,1361205018692,1361205018820,1626400104,1626400232,128
1361205060,1626441360,2,472,236,1361205032888,1361205032952,1626414248,1626414312,64
1361205072,1626453404,2,324,162,1361205045705,1361205070473,1626427109,1626451877,24768
1361205076,1626457292,1,46,46,1361205048380,1361205048380,1626429672,1626429672,0
1361205084,1626464508,4,205,51.25,1361205080649,1361205080649,1626461157,1626461157,0
1361205100,1626480424,3,144,48,1361205098462,1361205098526,1626478886,1626478950,64
1361205100,1626481360,2,472,236,1361205073141,1361205073205,1626454501,1626454565,64
1361205100,1626481372,2,265,132.5,1361205073898,1361205074026,1626455270,1626455398,128
1361205113,1626493528,1,134,134,1361205086581,1361205086581,1626467109,1626467109,0
1361205129,264823328,2,98,49,1361205124433,1361205128337,264818761,264822665,3904
1361205131,1626512396,3,286,95.33333333,1361205125715,1361205125779,1626507111,1626507175,64
1361205137,264831312,2,98,49,1361205124448,1361205130016,264818760,264824328,5568
1361205141,1626521536,2,472,236,1361205113710,1361205113774,1626494246,1626494310,64
1361205149,1626529524,1,48,48,1361205123833,1361205123833,1626504357,1626504357,0
1361205153,1626533492,13,7358,566,1361205127770,1361205134938,1626508262,1626515430,7168
1361205157,1626537468,7,1450,207.1428571,1361205129456,1361205130032,1626509924,1626510500,576
1361205157,1626537492,2,265,132.5,1361205130009,1361205130137,1626510501,1626510629,128
1361205172,1626552452,3,144,48,1361205171072,1361205171136,1626551524,1626551588,64
1361205181,1626561508,2,472,236,1361205153672,1361205153736,1626534180,1626534244,64
1361205193,1626573536,1,134,134,1361205166575,1361205166575,1626547111,1626547111,0
1361205213,1626593588,2,265,132.5,1361205185722,1361205185786,1626566310,1626566374,64
1361205221,1626601680,2,472,236,1361205193628,1361205193692,1626574308,1626574372,64
1361205225,1626605584,1,190,190,1361205198587,1361205198587,1626579171,1626579171,0
1361205236,1626616512,3,144,48,1361205231045,1361205231045,1626611557,1626611557,0
1361205252,1626632504,4,205,51.25,1361205244810,1361205244810,1626625314,1626625314,0
1361205258,1626638636,1,46,46,1361205229512,1361205229512,1626610148,1626610148,0
1361205259,1626639544,2,472,236,1361205233186,1361205233250,1626613730,1626613794,64
1361205259,1626639708,1,46,46,1361205229503,1361205229503,1626610211,1626610211,0
1361205265,1626646064,2,265,132.5,1361205240414,1361205240542,1626621478,1626621606,128
1361205273,1626653972,2,324,162,1361205246201,1361205261753,1626627173,1626642725,15552
1361205276,1626656524,8,1505,188.125,1361205265976,1361205271096,1626646500,1626651620,5120
1361205276,1626656596,8,1505,188.125,1361205265905,1361205271025,1626646501,1626651621,5120
1361205289,1626670044,11,2010,182.7272727,1361205264625,1361205265073,1626645669,1626646117,448
1361205297,1626678060,2,472,236,1361205272673,1361205272737,1626653733,1626653797,64
1361205308,1626688620,3,144,48,1361205305943,1361205305943,1626686563,1626686563,0
1361205313,1626694056,1,134,134,1361205286116,1361205286116,1626667172,1626667172,0
1361205321,1626702024,2,265,132.5,1361205295681,1361205295809,1626676705,1626676833,128
1361205337,1626718128,2,472,236,1361205312602,1361205312666,1626693730,1626693794,64
1361205353,1626734044,2,324,162,1361205326125,1361205326253,1626707169,1626707297,128
1361205372,1626752712,3,144,48,1361205365820,1361205367100,1626746532,1626747812,1280
1361205377,1626758068,2,265,132.5,1361205351511,1361205351639,1626732579,1626732707,128
1361205381,1626762028,2,472,236,1361205353407,1361205353471,1626734435,1626734499,64
1361205388,1626768736,4,205,51.25,1361205380899,1361205380899,1626761635,1626761635,0
1361205393,1626774048,1,134,134,1361205366123,1361205366123,1626747171,1626747171,0
1361205418,1626798624,2,472,236,1361205393680,1361205393744,1626774304,1626774368,64
1361205430,1626810464,1,190,190,1361205402034,1361205402034,1626782498,1626782498,0
1361205434,1626814504,2,265,132.5,1361205407882,1361205407946,1626788386,1626788450,64
1361205436,1626816788,11,5762,523.8181818,1361205418539,1361205433835,1626799327,1626814623,15296
1361205441,265135316,2,98,49,1361205435486,1361205440414,265129802,265134730,4928
1361205441,265135316,2,98,49,1361205435422,1361205439390,265129738,265133706,3968
1361205444,1626824680,3,144,48,1361205440857,1361205440921,1626821537,1626821601,64
1361205452,1626832652,3,286,95.33333333,1361205446581,1361205446581,1626827233,1626827233,0
1361205458,1626838428,2,472,236,1361205433491,1361205433619,1626813919,1626814047,128
1361205474,1626854568,9,1893,210.3333333,1361205446727,1361205465671,1626827295,1626846239,18944
1361205490,1626870432,2,265,132.5,1361205463568,1361205463696,1626844000,1626844128,128
1361205498,1626878512,2,472,236,1361205473791,1361205473855,1626854303,1626854367,64
1361205498,1626878528,1,46,46,1361205471025,1361205471025,1626851553,1626851553,0
1361205508,1626888760,3,144,48,1361205500810,1361205500810,1626881570,1626881570,0
1361205514,1626894544,1,134,134,1361205486689,1361205486689,1626867233,1626867233,0
1361205538,1626918644,2,472,236,1361205513339,1361205513403,1626893983,1626894047,64
1361205546,1626926568,2,265,132.5,1361205519112,1361205519240,1626899680,1626899808,128
1361205548,1626928724,9,581,64.55555556,1361205536555,1361205547819,1626917279,1626928543,11264
1361205548,1626928776,8,544,68,1361205536502,1361205542006,1626917278,1626922782,5504
1361205554,1626934572,2,324,162,1361205526660,1361205529348,1626907232,1626909920,2688
1361205562,1626942540,7,3851,550.1428571,1361205536741,1361205536741,1626917281,1626917281,0
1361205562,1626942540,10,8771,877.1,1361205536741,1361205536805,1626917281,1626917345,64
1361205562,1626942540,32,39140,1223.125,1361205536292,1361205536804,1626916832,1626917344,512
1361205562,1626942544,6,3166,527.6666667,1361205536737,1361205536737,1626917281,1626917281,0
1361205562,1626942572,42,47141,1122.404762,1361205534210,1361205536770,1626914782,1626917342,2560
1361205562,1626942620,8,7023,877.875,1361205536212,1361205536660,1626916832,1626917280,448
1361205562,1626942624,7,4123,589,1361205536656,1361205536656,1626917280,1626917280,0
1361205580,1626960812,3,144,48,1361205575761,1361205575761,1626956573,1626956573,0
1361205582,1626962524,2,472,236,1361205554100,1361205554164,1626934624,1626934688,64
1361205590,1626970600,7,1853,264.7142857,1361205565605,1361205565797,1626946205,1626946397,192
1361205594,1626974520,2,324,162,1361205566773,1361205593205,1626947293,1626973725,26432
1361205602,1626982608,2,265,132.5,1361205575134,1361205575198,1626955742,1626955806,64
1361205622,1627002652,2,472,236,1361205594100,1361205594164,1626974752,1626974816,64
1361205634,1627014584,1,134,134,1361205606709,1361205606709,1626987293,1626987293,0
1361205634,1627014656,2,583,291.5,1361205609712,1361205609776,1626990368,1626990432,64
1361205636,1627016788,15,7288,485.8666667,1361205613099,1361205630123,1626993887,1627010911,17024
1361205636,1627016788,29,33730,1163.103448,1361205615211,1361205630571,1626995999,1627011359,15360
1361205636,1627016796,3,144,48,1361205635745,1361205635745,1627016541,1627016541,0
1361205638,1627018616,11,4852,441.0909091,1361205613717,1361205614613,1626994333,1626995229,896
1361205642,1627022780,2,287,143.5,1361205615155,1361205615987,1626995935,1626996767,832
1361205652,1627032804,81,102863,1269.91358,1361205638361,1361205649689,1627019165,1627030493,11328
1361205652,1627032820,3,144,48,1361205651594,1361205651786,1627032414,1627032606,192
1361205660,1627040724,3,169,56.33333333,1361205652074,1361205652074,1627032798,1627032798,0
1361205660,1627040724,3,169,56.33333333,1361205652074,1361205652074,1627032798,1627032798,0
1361205660,1627040776,139,188877,1358.827338,1361205649847,1361205652983,1627030623,1627033759,3136
1361205660,1627040776,3,169,56.33333333,1361205652022,1361205652022,1627032798,1627032798,0
1361205660,1627040776,3,169,56.33333333,1361205652022,1361205652022,1627032798,1627032798,0
1361205660,1627040776,3,169,56.33333333,1361205652022,1361205652022,1627032798,1627032798,0
1361205660,1627040776,4,205,51.25,1361205652086,1361205652086,1627032862,1627032862,0
1361205662,1627042688,2,472,236,1361205634190,1361205634254,1627014878,1627014942,64
1361205668,1627048828,50,61595,1231.9,1361205662464,1361205664448,1627043292,1627045276,1984
1361205668,1627048832,144,193513,1343.840278,1361205653053,1361205662077,1627033885,1627042909,9024
1361205674,1627054620,2,324,162,1361205646675,1361205657299,1627027295,1627037919,10624
1361205676,1627056816,2,123,61.5,1361205674382,1361205674382,1627055198,1627055198,0
1361205690,1627070624,1,46,46,1361205662540,1361205662540,1627043164,1627043164,0
1361205698,1627078828,2,265,132.5,1361205671680,1361205671744,1627052508,1627052572,64
1361205700,1627080852,3,144,48,1361205695720,1361205695720,1627076572,1627076572,0
1361205702,1627082740,2,472,236,1361205674073,1361205674137,1627054813,1627054877,64
1361205710,1627090772,1,46,46,1361205685114,1361205685114,1627065886,1627065886,0
1361205714,1627094644,1,134,134,1361205686648,1361205686648,1627067292,1627067292,0
1361205732,1627112920,4,205,51.25,1361205724965,1361205724965,1627105885,1627105885,0
1361205734,1627114736,1,46,46,1361205708957,1361205708957,1627089693,1627089693,0
1361205742,1627122764,2,472,236,1361205714113,1361205714177,1627094877,1627094941,64
1361205746,1627126728,1,190,190,1361205720932,1361205720932,1627101660,1627101660,0
1361205748,1627128816,4,336,84,1361205745870,1361205745998,1627126686,1627126814,128
1361205753,265447384,2,98,49,1361205745374,1361205748958,265439758,265443342,3584
1361205753,265447408,2,98,49,1361205745350,1361205749894,265439758,265444302,4544
1361205754,1627134824,2,265,132.5,1361205726787,1361205726851,1627107611,1627107675,64
1361205756,1627136816,3,144,48,1361205755723,1361205755787,1627136539,1627136603,64
1361205772,1627152780,3,286,95.33333333,1361205766574,1361205766574,1627147354,1627147354,0
1361205782,1627162728,2,472,236,1361205754468,1361205754532,1627135196,1627135260,64
1361205794,1627174688,10,1954,195.4,1361205766668,1361205784652,1627147356,1627165340,17984
1361205810,1627190744,2,265,132.5,1361205782162,1361205782290,1627162906,1627163034,128
1361205820,1627200792,3,144,48,1361205815779,1361205815779,1627196571,1627196571,0
1361205822,1627202760,2,472,236,1361205794754,1361205794818,1627175514,1627175578,64
1361205834,1627214844,1,134,134,1361205806509,1361205806509,1627187353,1627187353,0
1361205862,1627242876,2,472,236,1361205834637,1361205834701,1627215513,1627215577,64
1361205866,1627246780,2,265,132.5,1361205837935,1361205838063,1627218715,1627218843,128
1361205874,1627254828,2,324,162,1361205846526,1361205848190,1627227354,1627229018,1664
1361205876,1627256848,3,144,48,1361205875691,1361205875755,1627256539,1627256603,64
1361205876,1627256876,8,1505,188.125,1361205866574,1361205871630,1627247450,1627252506,5056
1361205890,1627270916,11,2188,198.9090909,1361205865574,1361205866086,1627246490,1627247002,512
1361205902,1627282912,2,472,236,1361205874664,1361205874728,1627255576,1627255640,64
1361205914,1627295000,2,324,162,1361205886352,1361205911632,1627267352,1627292632,25280
1361205916,1627296816,11,953,86.63636364,1361205899082,1361205909066,1627279898,1627289882,9984
1361205916,1627296888,11,953,86.63636364,1361205898434,1361205908994,1627279322,1627289882,10560
1361205916,1627296892,12,999,83.25,1361205898686,1361205908990,1627279578,1627289882,10304
1361205918,1627299144,2,265,132.5,1361205892803,1361205892867,1627273947,1627274011,64
1361205942,1627323200,2,472,236,1361205914633,1361205914697,1627295833,1627295897,64
1361205954,1627335116,1,134,134,1361205926300,1361205926300,1627307416,1627307416,0
1361205956,1627336876,3,144,48,1361205950670,1361205950670,1627331546,1627331546,0
1361205974,1627355196,2,265,132.5,1361205948749,1361205948813,1627329945,1627330009,64
1361205982,1627363284,2,472,236,1361205955315,1361205955379,1627336599,1627336663,64
1361205988,1627368960,4,205,51.25,1361205981560,1361205981560,1627362520,1627362520,0
1361205994,1627375172,2,324,162,1361205966246,1361205975654,1627347418,1627356826,9408
1361206012,1627392928,3,144,48,1361206010646,1361206010646,1627391574,1627391574,0
1361206022,1627403200,2,472,236,1361205996361,1361205996425,1627377561,1627377625,64
1361206030,1627411264,2,265,132.5,1361206004422,1361206004550,1627385686,1627385814,128
1361206034,1627415264,1,134,134,1361206006153,1361206006153,1627387417,1627387417,0
1361206062,1627443304,2,472,236,1361206036190,1361206036254,1627417494,1627417558,64
1361206065,265759560,2,98,49,1361206056173,1361206060333,265750733,265754893,4160
1361206065,265759560,2,98,49,1361206056173,1361206059373,265750733,265753933,3200
1361206066,1627447288,1,190,190,1361206039153,1361206039153,1627420441,1627420441,0
1361206068,1627449012,4,312,78,1361206064514,1361206064642,1627445526,1627445654,128
1361206068,1627449016,4,312,78,1361206064765,1361206064829,1627445781,1627445845,64
1361206068,1627449016,4,312,78,1361206064705,1361206064769,1627445721,1627445785,64
1361206068,1627449084,4,312,78,1361206064699,1361206064827,1627445783,1627445911,128
1361206076,1627457020,3,144,48,1361206070525,1361206070589,1627451545,1627451609,64
1361206087,1627467612,2,265,132.5,1361206061013,1361206061077,1627441625,1627441689,64
1361206091,1627471564,12,12979,1081.583333,1361206064901,1361206065221,1627445465,1627445785,320
1361206091,1627471644,3,1041,347,1361206064757,1361206064757,1627445401,1627445401,0
1361206092,1627472968,3,286,95.33333333,1361206086510,1361206086510,1627467478,1627467478,0
1361206092,1627473092,4,312,78,1361206089844,1361206089972,1627470936,1627471064,128
1361206100,1627481024,3,150,50,1361206090169,1361206095545,1627471193,1627476569,5376
1361206100,1627481024,3,150,50,1361206090169,1361206095545,1627471193,1627476569,5376
1361206100,1627481024,3,150,50,1361206090167,1361206095543,1627471191,1627476567,5376
1361206100,1627481024,3,150,50,1361206090167,1361206095543,1627471191,1627476567,5376
1361206100,1627481024,3,150,50,1361206090167,1361206095543,1627471191,1627476567,5376
1361206100,1627481024,3,150,50,1361206090167,1361206095543,1627471191,1627476567,5376
1361206100,1627481100,3,150,50,1361206090091,1361206095467,1627471191,1627476567,5376
1361206100,1627481100,3,150,50,1361206090091,1361206095467,1627471191,1627476567,5376
1361206100,1627481100,3,150,50,1361206090091,1361206095467,1627471191,1627476567,5376
1361206100,1627481100,3,150,50,1361206090091,1361206095467,1627471191,1627476567,5376
1361206100,1627481100,3,150,50,1361206090091,1361206095467,1627471191,1627476567,5376
1361206100,1627481100,3,150,50,1361206090091,1361206095467,1627471191,1627476567,5376
1361206100,1627481100,2,98,49,1361206090218,1361206095466,1627471318,1627476566,5248
1361206103,1627483584,2,472,236,1361206076269,1361206076333,1627456853,1627456917,64
1361206107,1627487620,1,48,48,1361206080716,1361206080716,1627461336,1627461336,0
1361206115,1627495552,13,7373,567.1538462,1361206086928,1361206103376,1627467480,1627483928,16448
1361206115,1627495680,7,1450,207.1428571,1361206089807,1361206090383,1627470487,1627471063,576
1361206115,1627495684,20,21342,1067.1,1361206090187,1361206109771,1627470871,1627490455,19584
1361206143,1627523628,2,265,132.5,1361206116227,1361206116355,1627496855,1627496983,128
1361206143,1627523668,2,472,236,1361206116634,1361206116698,1627497302,1627497366,64
1361206148,1627529088,3,144,48,1361206145460,1361206145460,1627526548,1627526548,0
1361206155,1627535528,1,134,134,1361206126950,1361206126950,1627507478,1627507478,0
1361206180,1627561064,7,1406,200.8571429,1361206166861,1361206171981,1627547925,1627553045,5120
1361206183,1627563660,2,472,236,1361206156835,1361206156899,1627537495,1627537559,64
1361206183,1627563700,6,276,46,1361206156410,1361206176250,1627537110,1627556950,19840
1361206191,1627571700,2,324,162,1361206166778,1361206166906,1627547478,1627547606,128
1361206191,1627571768,7,1674,239.1428571,1361206166324,1361206166964,1627547092,1627547732,640
1361206199,1627579748,2,265,132.5,1361206171210,1361206171338,1627551958,1627552086,128
1361206207,1627587672,1,46,46,1361206180311,1361206180311,1627560983,1627560983,0
1361206207,1627587720,1,46,46,1361206180261,1361206180261,1627560981,1627560981,0
1361206212,1627593120,3,144,48,1361206205460,1361206205460,1627586580,1627586580,0
1361206223,1627603748,2,472,236,1361206196488,1361206196552,1627577236,1627577300,64
1361206227,1627607724,1,46,46,1361206201247,1361206206495,1627581971,1627587219,5248
1361206231,1627612036,2,324,162,1361206206442,1361206230378,1627587478,1627611414,23936
1361206251,1627632124,2,265,132.5,1361206225935,1361206226063,1627607059,1627607187,128
1361206263,1627644092,2,472,236,1361206236463,1361206236527,1627617555,1627617619,64
1361206271,1627652044,1,134,134,1361206246495,1361206246495,1627627539,1627627539,0
1361206276,1627657184,29,33362,1150.413793,1361206257043,1361206272531,1627638227,1627653715,15488
1361206283,1627664220,2,287,143.5,1361206256944,1361206257712,1627638164,1627638932,768
1361206284,1627665168,3,144,48,1361206280356,1361206280420,1627661524,1627661588,64
1361206284,1627665244,4,205,51.25,1361206281818,1361206281818,1627663062,1627663062,0
1361206303,1627684236,2,472,236,1361206276830,1361206276894,1627658066,1627658130,64
1361206311,1627692264,2,324,162,1361206286276,1361206293764,1627667540,1627675028,7488
1361206339,1627720200,2,265,132.5,1361206313347,1361206313411,1627694547,1627694611,64
1361206343,1627724296,2,472,236,1361206317090,1361206317154,1627698386,1627698450,64
1361206348,1627729236,3,144,48,1361206340319,1361206341599,1627721555,1627722835,1280
1361206351,1627732276,1,134,134,1361206326263,1361206326263,1627707539,1627707539,0
1361206377,266071620,2,98,49,1361206366134,1361206370998,266060754,266065618,4864
1361206377,266071620,2,98,49,1361206366070,1361206370038,266060690,266064658,3968
1361206383,1627764404,6,2176,362.6666667,1361206356855,1361206361015,1627738259,1627742419,4160
1361206384,1627764508,3,570,190,1361206358518,1361206361910,1627739026,1627742418,3392
1361206396,1627776540,2,265,132.5,1361206369686,1361206369814,1627750226,1627750354,128
1361206412,1627793376,3,286,95.33333333,1361206406226,1361206406226,1627787602,1627787602,0
1361206420,1627801308,3,144,48,1361206417559,1361206417559,1627798867,1627798867,0
1361206428,1627808508,2,472,236,1361206401333,1361206401461,1627781841,1627781969,128
1361206432,1627812560,10,1954,195.4,1361206407041,1361206422465,1627787601,1627803025,15424
1361206452,1627832592,2,265,132.5,1361206424994,1361206425122,1627805586,1627805714,128
1361206468,1627848628,2,472,236,1361206441854,1361206441918,1627822482,1627822546,64
1361206472,1627852720,1,134,134,1361206446880,1361206446880,1627827600,1627827600,0
1361206476,1627857320,3,144,48,1361206475211,1361206475275,1627856531,1627856595,64
1361206476,1627857320,7,1406,200.8571429,1361206467337,1361206473289,1627848657,1627854609,5952
1361206492,1627872660,12,3321,276.75,1361206466974,1361206467486,1627847634,1627848146,512
1361206496,1627876672,6,3754,625.6666667,1361206467986,1361206468050,1627848658,1627848722,64
1361206508,1627888624,2,265,132.5,1361206480897,1361206480961,1627861521,1627861585,64
1361206508,1627888712,2,472,236,1361206481193,1361206481257,1627861905,1627861969,64
1361206508,1627889336,4,190,47.5,1361206507255,1361206507575,1627888591,1627888911,320
1361206508,1627889340,4,190,47.5,1361206507572,1361206507828,1627888912,1627889168,256
1361206508,1627889340,4,190,47.5,1361206507571,1361206507827,1627888911,1627889167,256
1361206508,1627889348,4,190,47.5,1361206504557,1361206505325,1627885905,1627886673,768
1361206508,1627889352,4,190,47.5,1361206505128,1361206507240,1627886480,1627888592,2112
1361206508,1627889380,4,190,47.5,1361206505421,1361206507533,1627886801,1627888913,2112
1361206508,1627889384,4,190,47.5,1361206505863,1361206506183,1627887247,1627887567,320
1361206508,1627889388,4,190,47.5,1361206506182,1361206506438,1627887570,1627887826,256
1361206509,1627889420,4,190,47.5,1361206505549,1361206506317,1627885969,1627886737,768
1361206509,1627889420,4,190,47.5,1361206505549,1361206506381,1627885969,1627886801,832
1361206509,1627889424,4,190,47.5,1361206506056,1361206506312,1627886480,1627886736,256
1361206509,1627889424,4,190,47.5,1361206506183,1361206506759,1627886607,1627887183,576
1361206509,1627889432,4,190,47.5,1361206506562,1361206506818,1627886994,1627887250,256
1361206509,1627889464,4,190,47.5,1361206507489,1361206507745,1627887953,1627888209,256
1361206512,1627892668,1,190,190,1361206485907,1361206485907,1627866575,1627866575,0
1361206516,1627897332,4,190,47.5,1361206511228,1361206511548,1627892560,1627892880,320
1361206516,1627897332,4,190,47.5,1361206511292,1361206511740,1627892624,1627893072,448
1361206516,1627897336,4,190,47.5,1361206508089,1361206508409,1627889425,1627889745,320
1361206516,1627897336,4,190,47.5,1361206511544,1361206511864,1627892880,1627893200,320
1361206516,1627897340,4,190,47.5,1361206511734,1361206512118,1627893074,1627893458,384
1361206516,1627897340,4,190,47.5,1361206508406,1361206510518,1627889746,1627891858,2112
1361206516,1627897340,4,190,47.5,1361206508342,1361206508598,1627889682,1627889938,256
1361206516,1627897340,4,190,47.5,1361206507827,1361206508083,1627889167,1627889423,256
1361206516,1627897344,4,190,47.5,1361206512241,1361206512689,1627893585,1627894033,448
1361206516,1627897344,4,190,47.5,1361206508975,1361206509487,1627890319,1627890831,512
1361206516,1627897348,4,190,47.5,1361206509102,1361206509550,1627890450,1627890898,448
1361206516,1627897348,4,190,47.5,1361206509611,1361206510123,1627890959,1627891471,512
1361206516,1627897372,4,190,47.5,1361206509843,1361206511955,1627891215,1627893327,2112
1361206516,1627897380,4,190,47.5,1361206510414,1361206510478,1627891794,1627891858,64
1361206516,1627897380,4,190,47.5,1361206510478,1361206510606,1627891858,1627891986,128
1361206516,1627897380,4,190,47.5,1361206510668,1361206510732,1627892048,1627892112,64
1361206516,1627897380,4,190,47.5,1361206510860,1361206511244,1627892240,1627892624,384
1361206516,1627897380,4,190,47.5,1361206511050,1361206511434,1627892430,1627892814,384
1361206516,1627897384,4,190,47.5,1361206506440,1361206508552,1627887824,1627889936,2112
1361206516,1627897388,4,190,47.5,1361206506819,1361206508931,1627888207,1627890319,2112
1361206516,1627897392,4,190,47.5,1361206511422,1361206511742,1627892814,1627893134,320
1361206516,1627897392,4,190,47.5,1361206508034,1361206508290,1627889426,1627889682,256
1361206516,1627897392,4,190,47.5,1361206511743,1361206512127,1627893135,1627893519,384
1361206516,1627897396,4,190,47.5,1361206511806,1361206512190,1627893202,1627893586,384
1361206517,1627897412,4,190,47.5,1361206513043,1361206513363,1627893455,1627893775,320
1361206517,1627897412,4,190,47.5,1361206512979,1361206513363,1627893391,1627893775,384
1361206517,1627897412,4,190,47.5,1361206508755,1361206509011,1627889167,1627889423,256
1361206517,1627897412,4,190,47.5,1361206513107,1361206513491,1627893519,1627893903,384
1361206517,1627897416,4,190,47.5,1361206509522,1361206509778,1627889938,1627890194,256
1361206517,1627897416,4,190,47.5,1361206509522,1361206509842,1627889938,1627890258,320
1361206517,1627897416,4,190,47.5,1361206513361,1361206513809,1627893777,1627894225,448
1361206517,1627897416,4,190,47.5,1361206509776,1361206511952,1627890192,1627892368,2176
1361206517,1627897420,4,190,47.5,1361206510413,1361206510861,1627890833,1627891281,448
1361206517,1627897420,4,190,47.5,1361206510858,1361206511370,1627891278,1627891790,512
1361206517,1627897424,4,190,47.5,1361206511176,1361206511240,1627891600,1627891664,64
1361206517,1627897424,4,190,47.5,1361206511303,1361206511367,1627891727,1627891791,64
1361206517,1627897424,4,190,47.5,1361206511431,1361206511495,1627891855,1627891919,64
1361206517,1627897424,4,190,47.5,1361206511367,1361206511431,1627891791,1627891855,64
1361206517,1627897428,4,190,47.5,1361206511558,1361206511622,1627891986,1627892050,64
1361206517,1627897428,4,190,47.5,1361206511558,1361206511622,1627891986,1627892050,64
1361206517,1627897428,4,190,47.5,1361206511749,1361206512133,1627892177,1627892561,384
1361206532,1627912724,3,144,48,1361206505053,1361206508317,1627885777,1627889041,3264
1361206548,1627928936,2,472,236,1361206521674,1361206521802,1627902610,1627902738,128
1361206552,1627933032,2,324,162,1361206526567,1361206549863,1627907599,1627930895,23296
1361206556,1627937400,3,144,48,1361206550135,1361206550199,1627931535,1627931599,64
1361206560,1627940984,2,265,132.5,1361206535703,1361206535767,1627916687,1627916751,64
1361206588,1627969004,2,472,236,1361206562242,1361206562306,1627943246,1627943310,64
1361206589,1627969484,3,169,56.33333333,1361206584137,1361206584137,1627964621,1627964621,0
1361206592,1627973084,1,134,134,1361206566514,1361206566514,1627947598,1627947598,0
1361206596,1627976992,3,1120,373.3333333,1361206569999,1361206570447,1627950991,1627951439,448
1361206616,1627997120,2,265,132.5,1361206591438,1361206591502,1627972558,1627972622,64
1361206628,1628009016,2,472,236,1361206602423,1361206602487,1627983439,1627983503,64
1361206629,1628009548,3,144,48,1361206625994,1361206626058,1628006542,1628006606,64
1361206632,1628013072,2,324,162,1361206606590,1361206613374,1627987662,1627994446,6784
1361206668,1628049132,2,472,236,1361206642176,1361206642240,1628023308,1628023372,64
1361206672,1628053096,1,134,134,1361206646566,1361206646566,1628027662,1628027662,0
1361206672,1628053100,2,265,132.5,1361206647073,1361206647201,1628028173,1628028301,128
1361206685,1628065556,4,336,84,1361206678145,1361206678273,1628058701,1628058829,128
1361206689,266383764,2,98,49,1361206677670,1361206681382,266372434,266376146,3712
1361206689,266383764,2,98,49,1361206677733,1361206682341,266372497,266377105,4608
1361206692,1628073100,1,56,56,1361206666467,1361206666467,1628047567,1628047567,0
1361206693,1628073640,3,144,48,1361206685934,1361206685934,1628066574,1628066574,0
1361206693,1628073644,4,205,51.25,1361206685995,1361206685995,1628066639,1628066639,0
1361206705,1628085460,2,814,407,1361206677794,1361206687202,1628058254,1628067662,9408
1361206709,1628089408,2,472,236,1361206682519,1361206682583,1628062927,1628062991,64
1361206729,1628109460,2,265,132.5,1361206703776,1361206703840,1628084236,1628084300,64
1361206733,1628113776,3,286,95.33333333,1361206726883,1361206726947,1628107659,1628107723,64
1361206749,1628129504,2,472,236,1361206722678,1361206722742,1628103182,1628103246,64
1361206749,1628129712,3,144,48,1361206745829,1361206745829,1628126541,1628126541,0
1361206753,1628133456,9,1893,210.3333333,1361206727267,1361206741411,1628107723,1628121867,14144
1361206785,1628165548,2,265,132.5,1361206758985,1361206759113,1628139533,1628139661,128
1361206789,1628169616,2,472,236,1361206762308,1361206762372,1628142924,1628142988,64
1361206793,1628173556,1,134,134,1361206767169,1361206767169,1628147725,1628147725,0
1361206793,1628173560,11,2139,194.4545455,1361206767676,1361206768188,1628148236,1628148748,512
1361206797,1628177424,6,3567,594.5,1361206768901,1361206768965,1628149325,1628149389,64
1361206813,1628193812,3,144,48,1361206805759,1361206805823,1628186571,1628186635,64
1361206821,1628201840,43,55063,1280.534884,1361206817956,1361206818276,1628198796,1628199116,320
1361206829,1628209492,2,472,236,1361206803071,1361206803135,1628183563,1628183627,64
1361206833,1628213508,1,190,190,1361206807022,1361206807022,1628187530,1628187530,0
1361206837,1628217776,15,6289,419.2666667,1361206818082,1361206829474,1628198858,1628210250,11392
1361206837,1628217808,17,6755,397.3529412,1361206818882,1361206829442,1628199690,1628210250,10560
1361206837,1628217812,12,999,83.25,1361206819264,1361206829440,1628200076,1628210252,10176
1361206837,1628217860,12,999,83.25,1361206818577,1361206829393,1628199437,1628210253,10816
1361206841,1628221576,2,265,132.5,1361206814635,1361206814699,1628195211,1628195275,64
1361206869,1628249980,2,472,236,1361206842712,1361206842776,1628223692,1628223756,64
1361206873,1628253876,2,324,162,1361206846847,1361206870591,1628227723,1628251467,23744
1361206885,1628266072,3,144,48,1361206880505,1361206880505,1628261577,1628261577,0
1361206885,1628266148,4,205,51.25,1361206883118,1361206883118,1628264266,1628264266,0
1361206885,1628266152,3,169,56.33333333,1361206884138,1361206884138,1628265290,1628265290,0
1361206897,1628277916,2,265,132.5,1361206870296,1361206870360,1628251212,1628251276,64
1361206909,1628289868,2,472,236,1361206883269,1361206883333,1628264137,1628264201,64
1361206913,1628293876,1,134,134,1361206886847,1361206886847,1628267723,1628267723,0
1361206941,1628322280,3,144,48,1361206940264,1361206940392,1628321544,1628321672,128
1361206949,1628330036,2,472,236,1361206922846,1361206922910,1628303882,1628303946,64
1361206953,1628334008,2,265,132.5,1361206925944,1361206926072,1628306952,1628307080,128
1361206953,1628334036,2,324,162,1361206926685,1361206934109,1628307721,1628315145,7424
1361206989,1628370092,2,472,236,1361206963431,1361206963495,1628344523,1628344587,64
1361206993,1628374280,1,134,134,1361206966506,1361206966506,1628347786,1628347786,0
1361206994,266687788,2,98,49,1361206988666,1361206992954,266682454,266686742,4288
1361206994,266687800,2,98,49,1361206988652,1361206991980,266682452,266685780,3328
1361207005,1628386372,3,144,48,1361207000204,1361207000204,1628381576,1628381576,0
1361207009,1628390128,2,265,132.5,1361206981698,1361206981762,1628362826,1628362890,64
1361207025,1628406300,1,190,190,1361206997587,1361206997587,1628378887,1628378887,0
1361207030,1628410628,2,472,236,1361207003446,1361207003510,1628384074,1628384138,64
1361207054,1628434460,4,347,86.75,1361207047325,1361207047325,1628427785,1628427785,0
1361207066,1628446496,2,265,132.5,1361207038008,1361207038136,1628418504,1628418632,128
1361207070,1628450752,2,472,236,1361207043769,1361207043897,1628424521,1628424649,128
1361207074,1628454504,12,7312,609.3333333,1361207047342,1361207061870,1628427846,1628442374,14528
1361207078,1628458432,8,1505,188.125,1361207069238,1361207074294,1628449670,1628454726,5056
1361207078,1628458564,14,3374,241,1361207050741,1361207068853,1628431305,1628449417,18112
1361207086,1628466480,3,144,48,1361207078408,1361207078728,1628458888,1628459208,320
1361207094,1628474684,6,4170,695,1361207068986,1361207069050,1628449670,1628449734,64
1361207110,1628490612,2,472,236,1361207084867,1361207084931,1628465479,1628465543,64
1361207114,1628494604,1,134,134,1361207087180,1361207087180,1628467784,1628467784,0
1361207118,1628498656,2,265,132.5,1361207093784,1361207093848,1628474440,1628474504,64
1361207141,1628522344,2,98,49,1361207135208,1361207137320,1628516552,1628518664,2112
1361207150,1628530608,1,190,190,1361207125896,1361207125896,1628506504,1628506504,0
1361207150,1628530660,2,472,236,1361207124628,1361207124692,1628505288,1628505352,64
1361207158,1628538644,28,12466,445.2142857,1361207130915,1361207157667,1628511559,1628538311,26752
1361207158,1628538680,11,1676,152.3636364,1361207132285,1361207157757,1628512965,1628538437,25472
1361207189,1628570392,4,205,51.25,1361207183414,1361207183414,1628564806,1628564806,0
1361207190,1628570488,3,169,56.33333333,1361207185278,1361207185278,1628565766,1628565766,0
1361207190,1628570492,164,221774,1352.280488,1361207132538,1361207184058,1628513030,1628564550,51520
1361207190,1628570828,6,2161,360.1666667,1361207162024,1361207181544,1628542852,1628562372,19520
1361207190,1628570864,2,472,236,1361207164036,1361207164100,1628544900,1628544964,64
1361207190,1628570912,3,333,111,1361207162391,1361207169047,1628543303,1628549959,6656
1361207194,1628574828,2,324,162,1361207167019,1361207189419,1628547847,1628570247,22400
1361207197,1628578360,2,98,49,1361207195221,1361207196117,1628576581,1628577477,896
1361207197,1628578364,2,123,61.5,1361207195985,1361207195985,1628577349,1628577349,0
1361207222,1628602432,11,5075,461.3636364,1361207199221,1361207218741,1628579653,1628599173,19520
1361207222,1628602940,1,46,46,1361207194937,1361207194937,1628575877,1628575877,0
1361207226,1628606852,1,46,46,1361207198738,1361207198738,1628579590,1628579590,0
1361207230,1628610984,2,472,236,1361207204430,1361207204494,1628585414,1628585478,64
1361207234,1628614936,1,134,134,1361207206908,1361207206908,1628587844,1628587844,0
1361207246,1628626888,30,12963,432.1,1361207218285,1361207240045,1628599173,1628620933,21760
1361207246,1628626924,6,861,143.5,1361207220298,1361207231498,1628601222,1628612422,11200
1361207246,1628626924,1,46,46,1361207220360,1361207220360,1628601284,1628601284,0
1361207246,1628626924,70,93055,1329.357143,1361207220360,1361207231432,1628601284,1628612356,11072
1361207246,1628626972,15,6248,416.5333333,1361207218777,1361207236313,1628599749,1628617285,17536
1361207254,1628634460,2,123,61.5,1361207246682,1361207246682,1628627142,1628627142,0
1361207262,1628642428,2,123,61.5,1361207255480,1361207255480,1628635908,1628635908,0
1361207262,1628642432,3,144,48,1361207256115,1361207256115,1628636547,1628636547,0
1361207270,1628650932,2,472,236,1361207244354,1361207244418,1628625286,1628625350,64
1361207274,1628654884,2,324,162,1361207246959,1361207253423,1628627843,1628634307,6464
1361207302,1628682452,2,123,61.5,1361207296799,1361207296799,1628677251,1628677251,0
1361207306,266999896,2,98,49,1361207298830,1361207302222,266992726,266996118,3392
1361207306,266999896,2,98,49,1361207298829,1361207303181,266992725,266997077,4352
1361207310,1628691004,2,472,236,1361207284152,1361207284216,1628665156,1628665220,64
1361207314,1628694964,38,43807,1152.815789,1361207286751,1361207311391,1628667715,1628692355,24640
1361207314,1628694968,4,536,134,1361207286877,1361207294493,1628667845,1628675461,7616
1361207314,1628695128,8,1516,189.5,1361207286397,1361207296573,1628667525,1628677701,10176
1361207314,1628695128,1,46,46,1361207286587,1361207286587,1628667715,1628667715,0
1361207334,1628714468,3,144,48,1361207331087,1361207331087,1628711555,1628711555,0
1361207343,1628723420,2,819,409.5,1361207317697,1361207318145,1628698117,1628698565,448
1361207346,267039876,8,544,68,1361207336932,1361207342116,267030808,267035992,5184
1361207350,1628730508,8,535,66.875,1361207336937,1361207342121,1628717445,1628722629,5184
1361207350,1628730584,9,581,64.55555556,1361207336858,1361207348826,1628717442,1628729410,11968
1361207350,1628730584,9,581,64.55555556,1361207336858,1361207348634,1628717442,1628729218,11776
1361207350,1628731300,2,472,236,1361207324113,1361207324177,1628705413,1628705477,64
1361207354,1628735308,1,46,46,1361207328456,1361207328456,1628709764,1628709764,0
1361207358,1628739284,39,43799,1123.051282,1361207333536,1361207336224,1628714820,1628717508,2688
1361207359,1628739412,10,8042,804.2,1361207333191,1361207336327,1628713603,1628716739,3136
1361207361,267054880,34,44516,1309.294118,1361207336478,1361207336990,267030358,267030870,512
1361207361,267054924,6,3215,535.8333333,1361207336305,1361207336625,267030229,267030549,320
1361207362,1628743316,52,69368,1334,1361207335679,1361207336319,1628716995,1628717635,640
1361207362,1628743320,6,3326,554.3333333,1361207336061,1361207336125,1628717381,1628717445,64
1361207362,1628743320,7,3355,479.2857143,1361207336060,1361207336124,1628717380,1628717444,64
1361207362,1628743320,7,3574,510.5714286,1361207336124,1361207336124,1628717444,1628717444,0
1361207362,1628743396,13,10913,839.4615385,1361207335598,1361207336046,1628716994,1628717442,448
1361207362,1628743396,19,19086,1004.526316,1361207335598,1361207336110,1628716994,1628717506,512
1361207362,1628743400,20,20151,1007.55,1361207335593,1361207336105,1628716993,1628717505,512
1361207362,1628743400,6,3070,511.6666667,1361207335978,1361207336042,1628717378,1628717442,64
1361207362,1628743400,6,3326,554.3333333,1361207335978,1361207336042,1628717378,1628717442,64
1361207374,1628754604,5,408,81.6,1361207367304,1361207367304,1628747908,1628747908,0
1361207378,1628759312,2,265,132.5,1361207352131,1361207352323,1628733443,1628733635,192
1361207391,1628771420,3,524,174.6666667,1361207364416,1361207364480,1628744836,1628744900,64
1361207394,1628775356,7,2114,302,1361207367896,1361207368088,1628749252,1628749444,192
1361207394,1628775360,3,3309,1103,1361207368466,1361207368466,1628749826,1628749826,0
1361207394,1628775396,10,2445,244.5,1361207366510,1361207381870,1628747906,1628763266,15360
1361207398,1628778592,3,144,48,1361207390931,1361207390995,1628771523,1628771587,64
1361207422,1628803396,10,8043,804.3,1361207396974,1361207397102,1628778370,1628778498,128
1361207431,1628811484,2,472,236,1361207404606,1361207404670,1628785090,1628785154,64
1361207434,1628815372,1,134,134,1361207406534,1361207406534,1628787906,1628787906,0
1361207434,1628815400,8,1126,140.75,1361207407594,1361207423082,1628788994,1628804482,15488
1361207443,1628823424,93,123570,1328.709677,1361207417339,1361207440827,1628797763,1628821251,23488
1361207443,1628823480,31,13660,440.6451613,1361207416514,1361207440834,1628796994,1628821314,24320
1361207454,1628834584,3,144,48,1361207451099,1361207451099,1628831683,1628831683,0
1361207454,1628834620,3,169,56.33333333,1361207452726,1361207452726,1628833346,1628833346,0
1361207454,1628834620,3,169,56.33333333,1361207452726,1361207452726,1628833346,1628833346,0
1361207454,1628834620,4,205,51.25,1361207452789,1361207452789,1628833409,1628833409,0
1361207454,1628834620,4,205,51.25,1361207452789,1361207452789,1628833409,1628833409,0
1361207454,1628834672,3,169,56.33333333,1361207452673,1361207452673,1628833345,1628833345,0
1361207454,1628834672,3,169,56.33333333,1361207452673,1361207452673,1628833345,1628833345,0
1361207454,1628834672,2,123,61.5,1361207452737,1361207452737,1628833409,1628833409,0
1361207454,1628834692,4,205,51.25,1361207452716,1361207452716,1628833408,1628833408,0
1361207458,267151944,3,169,56.33333333,1361207452831,1361207452831,267146775,267146775,0
1361207458,267151964,3,169,56.33333333,1361207451789,1361207451789,267145753,267145753,0
1361207459,1628839528,12,5504,458.6666667,1361207434194,1361207445010,1628814722,1628825538,10816
1361207462,1628842672,29,34162,1178,1361207440579,1361207455939,1628821251,1628836611,15360
1361207467,1628847428,2,287,143.5,1361207439413,1361207441461,1628819841,1628821889,2048
1361207471,1628851452,2,472,236,1361207444510,1361207444574,1628824962,1628825026,64
1361207471,1628851492,1,190,190,1361207446326,1361207446326,1628826818,1628826818,0
1361207471,1628851536,8,2268,283.5,1361207444554,1361207470730,1628825090,1628851266,26176
1361207486,1628866624,4,205,51.25,1361207484784,1361207484784,1628865408,1628865408,0
1361207486,1628866680,3,169,56.33333333,1361207484665,1361207484665,1628865345,1628865345,0
1361207487,1628867792,1,46,46,1361207462474,1361207462474,1628843266,1628843266,0
1361207491,1628871788,1,46,46,1361207463823,1361207463823,1628844611,1628844611,0
1361207510,1628890628,3,169,56.33333333,1361207504878,1361207509166,1628885506,1628889794,4288
1361207511,1628891844,2,472,236,1361207484820,1361207484884,1628865664,1628865728,64
1361207515,1628895760,2,324,162,1361207487209,1361207511593,1628867969,1628892353,24384
1361207518,1628898648,29,33762,1164.206897,1361207497432,1361207512792,1628878080,1628893440,15360
1361207518,1628898696,3,144,48,1361207510888,1361207510952,1628891584,1628891648,64
1361207518,1628898720,2,92,46,1361207513617,1361207513617,1628894337,1628894337,0
1361207523,1628903816,4,552,138,1361207497074,1361207498034,1628877890,1628878850,960
1361207523,1628903816,1,46,46,1361207497263,1361207497263,1628878079,1628878079,0
1361207551,1628931928,2,472,236,1361207525056,1361207525120,1628905984,1628906048,64
1361207555,1628935876,1,134,134,1361207527092,1361207527092,1628907968,1628907968,0
1361207555,1628935928,7,1450,207.1428571,1361207530687,1361207531199,1628911615,1628912127,512
1361207579,1628959892,2,265,132.5,1361207553382,1361207553510,1628934274,1628934402,128
1361207590,1628970772,3,144,48,1361207585754,1361207585818,1628966526,1628966590,64
1361207591,1628971888,2,472,236,1361207565159,1361207565351,1628946047,1628946239,192
1361207595,1628975884,1,46,46,1361207568939,1361207568939,1628949823,1628949823,0
1361207595,1628975916,2,324,162,1361207567050,1361207574986,1628947966,1628955902,7936
1361207618,267311976,2,98,49,1361207608834,1361207612994,267302810,267306970,4160
1361207618,267311976,3,144,48,1361207608834,1361207612034,267302810,267306010,3200
1361207631,1629011948,2,472,236,1361207605481,1361207605545,1628986429,1628986493,64
1361207635,1629015916,1,134,134,1361207607049,1361207607049,1628987965,1628987965,0
1361207635,1629016112,2,265,132.5,1361207608902,1361207608966,1628990014,1628990078,64
1361207654,1629034736,4,205,51.25,1361207646974,1361207646974,1629027710,1629027710,0
1361207654,1629034772,11,5602,509.2727273,1361207634268,1361207649628,1629015040,1629030400,15360
1361207662,1629042764,3,144,48,1361207660769,1361207660833,1629041533,1629041597,64
1361207663,1629044192,1,190,190,1361207638263,1361207638263,1629019455,1629019455,0
1361207671,1629052276,2,472,236,1361207644964,1361207645028,1629026240,1629026304,64
1361207692,1629072420,2,265,132.5,1361207664954,1361207665018,1629045374,1629045438,64
1361207694,1629074832,3,286,95.33333333,1361207687199,1361207687199,1629068031,1629068031,0
1361207696,1629076444,11,1946,176.9090909,1361207669088,1361207669536,1629049532,1629049980,448
1361207711,1629092364,9,1893,210.3333333,1361207686666,1361207701706,1629068030,1629083070,15040
1361207712,1629092536,2,472,236,1361207685639,1361207685703,1629066175,1629066239,64
1361207726,1629106796,3,144,48,1361207723074,1361207723074,1629103870,1629103870,0
1361207747,1629128324,3,506,168.6666667,1361207719281,1361207746353,1629100605,1629127677,27072
1361207751,1629132368,1,134,134,1361207726662,1361207726662,1629108030,1629108030,0
1361207752,1629132452,2,472,236,1361207725656,1361207725720,1629106108,1629106172,64
1361207766,1629146832,16,7334,458.375,1361207744733,1361207764125,1629125565,1629144957,19392
1361207766,1629146880,29,33724,1162.896552,1361207746861,1361207762221,1629127741,1629143101,15360
1361207772,1629152472,17,5734,337.2941176,1361207745539,1361207765827,1629126011,1629146299,20288
1361207776,1629156408,1,46,46,1361207747907,1361207747907,1629128315,1629128315,0
1361207782,1629162828,15,7288,485.8666667,1361207764130,1361207781090,1629144958,1629161918,16960
1361207790,1629170756,4,205,51.25,1361207784361,1361207784361,1629165117,1629165117,0
1361207792,1629172436,2,472,236,1361207765546,1361207765610,1629145982,1629146046,64
1361207792,1629172468,1,190,190,1361207766791,1361207766791,1629147259,1629147259,0
1361207798,1629178768,3,144,48,1361207795805,1361207795805,1629176573,1629176573,0
1361207822,1629202820,16,7829,489.3125,1361207801896,1361207818664,1629182716,1629199484,16768
1361207822,1629202912,29,33730,1163.103448,1361207803531,1361207818891,1629184443,1629199803,15360
1361207828,1629208812,1,46,46,1361207801902,1361207801902,1629182714,1629182714,0
1361207828,1629208856,4,552,138,1361207803267,1361207804611,1629184123,1629185467,1344
1361207828,1629208860,1,46,46,1361207803583,1361207803583,1629184443,1629184443,0
1361207828,1629208932,6,579,96.5,1361207802231,1361207802615,1629183163,1629183547,384
1361207832,1629212816,1,134,134,1361207807210,1361207807210,1629188026,1629188026,0
1361207832,1629212820,2,472,236,1361207805350,1361207805478,1629186170,1629186298,128
1361207860,1629240812,2,324,162,1361207833008,1361207847280,1629213820,1629228092,14272
1361207862,1629242824,3,144,48,1361207855717,1361207855717,1629236541,1629236541,0
1361207864,1629244872,1,46,46,1361207837298,1361207837298,1629218170,1629218170,0
1361207864,1629244872,14,7179,512.7857143,1361207837298,1361207849842,1629218170,1629230714,12544
1361207870,1629250808,3,169,56.33333333,1361207862708,1361207869044,1629243516,1629249852,6336
1361207870,1629250808,4,312,78,1361207865074,1361207865138,1629245882,1629245946,64
1361207870,1629250808,4,312,78,1361207865266,1361207865330,1629246074,1629246138,64
1361207870,1629250840,30,33744,1124.8,1361207850067,1361207865491,1629230907,1629246331,15424
1361207870,1629250884,2,123,61.5,1361207864871,1361207864871,1629245755,1629245755,0
1361207870,1629250888,4,312,78,1361207865061,1361207865189,1629245949,1629246077,128
1361207870,1629250888,4,312,78,1361207865124,1361207865188,1629246012,1629246076,64
1361207870,1629250888,4,312,78,1361207865187,1361207865315,1629246075,1629246203,128
1361207872,1629252980,2,472,236,1361207845574,1361207845638,1629226554,1629226618,64
1361207876,1629256872,2,287,143.5,1361207849969,1361207850801,1629230841,1629231673,832
1361207876,1629256876,1,46,46,1361207850032,1361207850032,1629230908,1629230908,0
1361207892,1629272860,14,14127,1009.071429,1361207864958,1361207865214,1629245818,1629246074,256
1361207892,1629272940,3,1199,399.6666667,1361207864751,1361207864815,1629245691,1629245755,64
1361207912,1629292944,2,324,162,1361207887145,1361207896617,1629268089,1629277561,9472
1361207912,1629293016,2,472,236,1361207886497,1361207886561,1629267513,1629267577,64
1361207930,267624036,2,98,49,1361207918728,1361207923208,267612764,267617244,4480
1361207930,267624056,2,98,49,1361207918642,1361207922162,267612698,267616218,3520
1361207932,1629313052,2,265,132.5,1361207906367,1361207906495,1629287419,1629287547,128
1361207934,1629314868,3,144,48,1361207930679,1361207930743,1629311547,1629311611,64
1361207952,1629333112,1,134,134,1361207926977,1361207926977,1629308089,1629308089,0
1361207952,1629333160,2,472,236,1361207925906,1361207925970,1629307066,1629307130,64
1361207982,1629362964,7,1459,208.4285714,1361207970004,1361207975124,1629350968,1629356088,5120
1361207988,1629369140,2,265,132.5,1361207961956,1361207962020,1629343096,1629343160,64
1361207988,1629369188,1,190,190,1361207960309,1361207960309,1629341497,1629341497,0
1361207990,1629370852,4,336,84,1361207982982,1361207983110,1629363834,1629363962,128
1361207992,1629373264,2,472,236,1361207966250,1361207966314,1629347514,1629347578,64
1361207996,1629377172,10,1905,190.5,1361207968901,1361207969413,1629350073,1629350585,512
1361208006,1629386980,3,144,48,1361208005571,1361208005571,1629386551,1629386551,0
1361208008,1629389172,1,46,46,1361207979908,1361207979908,1629361080,1629361080,0
1361208008,1629389260,1,46,46,1361207979820,1361207979820,1629361080,1629361080,0
1361208014,1629394992,5,408,81.6,1361208007097,1361208007161,1629388089,1629388153,64
1361208032,1629413256,2,472,236,1361208005681,1361208005745,1629386937,1629387001,64
1361208032,1629413312,13,7373,567.1538462,1361208006839,1361208023991,1629388151,1629405303,17152
1361208036,1629417268,1,46,46,1361208008294,1361208008294,1629389562,1629389562,0
1361208036,1629417304,2,583,291.5,1361208010623,1361208010815,1629391927,1629392119,192
1361208044,1629425316,2,265,132.5,1361208017779,1361208017843,1629399095,1629399159,64
1361208072,1629453256,1,134,134,1361208046896,1361208046896,1629428152,1629428152,0
1361208072,1629453336,2,472,236,1361208046367,1361208046431,1629427703,1629427767,64
1361208078,1629458980,29,33362,1150.413793,1361208057988,1361208073348,1629438968,1629454328,15360
1361208084,1629465276,2,287,143.5,1361208057562,1361208058394,1629438838,1629439670,832
1361208086,1629466968,3,144,48,1361208080593,1361208080593,1629461561,1629461561,0
1361208113,1629493520,2,472,236,1361208087441,1361208087505,1629467961,1629468025,64
1361208113,1629493620,2,324,162,1361208087530,1361208089642,1629468150,1629470262,2112
1361208134,1629514992,4,205,51.25,1361208126265,1361208126265,1629507257,1629507257,0
1361208141,1629521556,2,265,132.5,1361208114475,1361208114603,1629495031,1629495159,128
1361208153,1629533696,2,472,236,1361208127392,1361208127456,1629508088,1629508152,64
1361208153,1629533720,1,134,134,1361208127432,1361208127432,1629508152,1629508152,0
1361208158,1629539076,3,144,48,1361208155490,1361208155810,1629536566,1629536886,320
1361208181,1629561592,2,324,162,1361208153863,1361208167559,1629534455,1629548151,13696
1361208193,1629573624,2,472,236,1361208167270,1361208167334,1629547894,1629547958,64
1361208197,1629577720,2,265,132.5,1361208169669,1361208169797,1629550389,1629550517,128
1361208222,1629603156,4,891,222.75,1361208221586,1361208221714,1629602742,1629602870,128
1361208222,1629603184,3,144,48,1361208215350,1361208215734,1629596534,1629596918,384
1361208233,1629613684,2,472,236,1361208207722,1361208207786,1629588406,1629588470,64
1361208233,1629613768,2,324,162,1361208207445,1361208217237,1629588213,1629598005,9792
1361208234,267928204,2,98,49,1361208228513,1361208233185,267922717,267927389,4672
1361208234,267928204,3,144,48,1361208228512,1361208232224,267922716,267926428,3712
1361208253,1629633776,2,265,132.5,1361208225167,1361208225295,1629605943,1629606071,128
1361208273,1629654036,2,472,236,1361208247048,1361208247112,1629628084,1629628148,64
1361208273,1629654040,1,134,134,1361208247172,1361208247172,1629628212,1629628212,0
1361208277,1629658100,7,322,46,1361208251015,1361208275847,1629632115,1629656947,24832
1361208278,1629659092,7,1406,200.8571429,1361208270864,1361208276624,1629651956,1629657716,5760
1361208278,1629659120,3,144,48,1361208275444,1361208275444,1629656564,1629656564,0
1361208297,1629678052,14,4302,307.2857143,1361208269626,1361208270394,1629650678,1629651446,768
1361208305,1629686060,2,265,132.5,1361208280368,1361208280496,1629661428,1629661556,128
1361208305,1629686140,1,190,190,1361208280416,1361208280416,1629661556,1629661556,0
1361208313,1629694048,2,472,236,1361208286781,1361208286845,1629667829,1629667893,64
1361208318,1629699120,4,190,47.5,1361208313203,1361208313715,1629694323,1629694835,512
1361208318,1629699124,4,190,47.5,1361208313394,1361208314162,1629694518,1629695286,768
1361208318,1629699124,4,190,47.5,1361208313393,1361208314161,1629694517,1629695285,768
1361208318,1629699124,4,190,47.5,1361208317104,1361208317616,1629698228,1629698740,512
1361208318,1629699128,3,144,48,1361208313773,1361208314349,1629694901,1629695477,576
1361208318,1629699128,4,190,47.5,1361208313836,1361208314092,1629694964,1629695220,256
1361208318,1629699128,4,190,47.5,1361208313899,1361208314155,1629695027,1629695283,256
1361208318,1629699128,4,190,47.5,1361208313899,1361208314155,1629695027,1629695283,256
1361208318,1629699132,4,190,47.5,1361208317545,1361208317673,1629698677,1629698805,128
1361208318,1629699132,4,190,47.5,1361208314216,1361208314472,1629695348,1629695604,256
1361208318,1629699136,4,190,47.5,1361208317666,1361208317730,1629698802,1629698866,64
1361208318,1629699136,4,190,47.5,1361208314469,1361208314725,1629695605,1629695861,256
1361208318,1629699136,4,190,47.5,1361208317732,1361208317860,1629698868,1629698996,128
1361208318,1629699152,4,190,47.5,1361208314709,1361208314965,1629695861,1629696117,256
1361208318,1629699152,4,190,47.5,1361208314709,1361208314965,1629695861,1629696117,256
1361208318,1629699156,4,190,47.5,1361208314962,1361208315218,1629696118,1629696374,256
1361208318,1629699160,4,190,47.5,1361208315214,1361208315470,1629696374,1629696630,256
1361208318,1629699160,4,190,47.5,1361208315467,1361208317643,1629696627,1629698803,2176
1361208318,1629699196,4,190,47.5,1361208313258,1361208314026,1629694454,1629695222,768
1361208318,1629699196,4,190,47.5,1361208317095,1361208317607,1629698291,1629698803,512
1361208318,1629699200,4,190,47.5,1361208317411,1361208317475,1629698611,1629698675,64
1361208318,1629699204,4,190,47.5,1361208317537,1361208317601,1629698741,1629698805,64
1361208318,1629699204,4,190,47.5,1361208314016,1361208314272,1629695220,1629695476,256
1361208318,1629699204,4,190,47.5,1361208317600,1361208317664,1629698804,1629698868,64
1361208318,1629699204,4,190,47.5,1361208314080,1361208314400,1629695284,1629695604,320
1361208318,1629699204,4,190,47.5,1361208314079,1361208314399,1629695283,1629695603,320
1361208318,1629699204,4,190,47.5,1361208317663,1361208317791,1629698867,1629698995,128
1361208318,1629699204,4,190,47.5,1361208314271,1361208316447,1629695475,1629697651,2176
1361208318,1629699208,4,190,47.5,1361208314398,1361208314654,1629695606,1629695862,256
1361208318,1629699208,4,190,47.5,1361208314398,1361208316510,1629695606,1629697718,2112
1361208318,1629699212,4,190,47.5,1361208314905,1361208315161,1629696117,1629696373,256
1361208318,1629699240,4,190,47.5,1361208315131,1361208315451,1629696371,1629696691,320
1361208318,1629699248,4,190,47.5,1361208315446,1361208315702,1629696694,1629696950,256
1361208318,1629699248,4,190,47.5,1361208315701,1361208315957,1629696949,1629697205,256
1361208318,1629699248,4,190,47.5,1361208316467,1361208316979,1629697715,1629698227,512
1361208318,1629699248,4,190,47.5,1361208316595,1361208317043,1629697843,1629698291,448
1361208326,1629707104,4,190,47.5,1361208318083,1361208318467,1629699187,1629699571,384
1361208326,1629707104,4,190,47.5,1361208318083,1361208318467,1629699187,1629699571,384
1361208326,1629707108,4,190,47.5,1361208318146,1361208318530,1629699254,1629699638,384
1361208326,1629707112,4,190,47.5,1361208318461,1361208318845,1629699573,1629699957,384
1361208326,1629707116,4,190,47.5,1361208317623,1361208318071,1629698739,1629699187,448
1361208326,1629707116,4,190,47.5,1361208318775,1361208319159,1629699891,1629700275,384
1361208326,1629707144,4,190,47.5,1361208319195,1361208319515,1629700339,1629700659,320
1361208326,1629707144,4,190,47.5,1361208319131,1361208319515,1629700275,1629700659,384
1361208326,1629707156,4,190,47.5,1361208316047,1361208318159,1629697203,1629699315,2112
1361208326,1629707188,4,190,47.5,1361208318192,1361208318512,1629699380,1629699700,320
1361208326,1629707192,4,190,47.5,1361208318381,1361208318701,1629699573,1629699893,320
1361208326,1629707196,4,190,47.5,1361208318439,1361208318759,1629699635,1629699955,320
1361208326,1629707196,4,190,47.5,1361208318569,1361208318953,1629699765,1629700149,384
1361208326,1629707200,4,190,47.5,1361208318694,1361208319078,1629699894,1629700278,384
1361208326,1629707200,4,190,47.5,1361208318757,1361208319141,1629699957,1629700341,384
1361208326,1629707200,4,190,47.5,1361208317797,1361208317861,1629698997,1629699061,64
1361208326,1629707200,4,190,47.5,1361208317796,1361208317860,1629698996,1629699060,64
1361208326,1629707200,4,190,47.5,1361208317796,1361208317924,1629698996,1629699124,128
1361208326,1629707200,4,190,47.5,1361208318948,1361208319332,1629700148,1629700532,384
1361208326,1629707200,4,190,47.5,1361208319075,1361208319395,1629700275,1629700595,320
1361208334,1629715128,5,408,81.6,1361208327084,1361208327148,1629708212,1629708276,64
1361208350,1629731256,11,5698,518,1361208331436,1361208346732,1629712692,1629727988,15296
1361208353,1629734120,2,472,236,1361208327412,1361208327476,1629708532,1629708596,64
1361208353,1629734228,10,1954,195.4,1361208327047,1361208344071,1629708275,1629725299,17024
1361208358,1629739256,3,144,48,1361208352620,1361208352620,1629733876,1629733876,0
1361208361,1629742212,2,265,132.5,1361208335449,1361208335577,1629716661,1629716789,128
1361208390,1629771308,4,205,51.25,1361208386039,1361208386039,1629767347,1629767347,0
1361208393,1629774128,1,134,134,1361208367147,1361208367147,1629748275,1629748275,0
1361208393,1629774136,2,472,236,1361208367460,1361208367588,1629748596,1629748724,128
1361208398,1629779328,4,312,78,1361208391395,1361208391459,1629772723,1629772787,64
1361208417,1629798240,2,265,132.5,1361208391420,1361208391484,1629772660,1629772724,64
1361208430,1629810544,1,74,74,1361208405493,1361208405493,1629786037,1629786037,0
1361208430,1629811276,3,144,48,1361208425305,1361208425305,1629806581,1629806581,0
1361208434,1629814580,2,324,162,1361208407693,1361208409165,1629788273,1629789745,1472
1361208434,1629814584,2,472,236,1361208408267,1361208408331,1629788851,1629788915,64
1361208474,1629854500,2,265,132.5,1361208447836,1361208447964,1629828336,1629828464,128
1361208474,1629854504,2,472,236,1361208448219,1361208448283,1629828723,1629828787,64
1361208474,1629854612,2,324,162,1361208447661,1361208472813,1629828273,1629853425,25152
1361208494,1629875296,4,196,49,1361208488258,1361208491266,1629869554,1629872562,3008
1361208514,1629894592,2,761,380.5,1361208487683,1361208487683,1629868275,1629868275,0
1361208514,1629894596,2,472,236,1361208488188,1361208488252,1629868784,1629868848,64
1361208518,1629898604,6,913,152.1666667,1361208491636,1361208492084,1629872240,1629872688,448
1361208527,1629908020,1,48,48,1361208500435,1361208500435,1629881455,1629881455,0
1361208529,1629909412,1,48,48,1361208501043,1361208501043,1629881455,1629881455,0
1361208530,1629910724,4,552,138,1361208503228,1361208526140,1629883952,1629906864,22912
1361208543,1629923712,13,6701,515.4615385,1361208523465,1361208540169,1629904177,1629920881,16704
1361208543,1629923744,29,33730,1163.103448,1361208525480,1361208540840,1629906224,1629921584,15360
1361208546,1629926608,1,74,74,1361208520370,1361208520370,1629900978,1629900978,0
1361208546,268240300,2,98,49,1361208538946,1361208543298,268233246,268237598,4352
1361208546,268240312,2,98,49,1361208538871,1361208542327,268233183,268236639,3456
1361208550,1629930616,12,5201,433.4166667,1361208524136,1361208525160,1629904752,1629905776,1024
1361208554,1629934656,6,2176,362.6666667,1361208528447,1361208532607,1629909103,1629913263,4160
1361208554,1629934716,2,324,162,1361208527557,1361208537221,1629908273,1629917937,9664
1361208567,1629947664,3,144,48,1361208563962,1361208563962,1629944626,1629944626,0
1361208594,1629974848,1,46,46,1361208567041,1361208567041,1629947889,1629947889,0
1361208594,1629975068,1,134,134,1361208567268,1361208567268,1629948336,1629948336,0
1361208598,1629978876,2,472,236,1361208572067,1361208572131,1629952943,1629953007,64
1361208598,1629978956,6,1574,262.3333333,1361208570581,1361208570901,1629951537,1629951857,320
1361208599,1629979752,17,7284,428.4705882,1361208575136,1361208592352,1629955888,1629973104,17216
1361208599,1629979800,29,33730,1163.103448,1361208581551,1361208596975,1629962351,1629977775,15424
1361208602,1629982968,1,46,46,1361208574921,1361208574921,1629955889,1629955889,0
1361208602,1629982976,19,1480,77.89473684,1361208575361,1361208592897,1629956337,1629973873,17536
1361208606,1629987008,4,552,138,1361208581215,1361208582111,1629962223,1629963119,896
1361208606,1629987036,1,46,46,1361208581315,1361208581315,1629962351,1629962351,0
1361208615,1629995720,15,7288,485.8666667,1361208592386,1361208608706,1629973106,1629989426,16320
1361208626,1630006908,1,190,190,1361208600643,1361208600643,1629981551,1629981551,0
1361208631,1630011752,16,6372,398.25,1361208612702,1361208624798,1629993454,1630005550,12096
1361208631,1630011756,12,999,83.25,1361208613084,1361208624796,1629993840,1630005552,11712
1361208631,1630011832,12,999,83.25,1361208613265,1361208624721,1629994097,1630005553,11456
1361208631,1630011836,12,999,83.25,1361208613516,1361208624652,1629994352,1630005488,11136
1361208638,1630018988,2,472,236,1361208612276,1361208612404,1629993264,1629993392,128
1361208639,1630019712,3,144,48,1361208635847,1361208635847,1630016559,1630016559,0
1361208655,1630035724,3,286,95.33333333,1361208647612,1361208647612,1630028336,1630028336,0
1361208655,1630035768,2,123,61.5,1361208653073,1361208653073,1630033841,1630033841,0
1361208655,1630035792,29,33730,1163.103448,1361208638391,1361208653751,1630019183,1630034543,15360
1361208666,1630046892,1,46,46,1361208638293,1361208638293,1630019185,1630019185,0
1361208666,1630046968,4,552,138,1361208638022,1361208638790,1630018990,1630019758,768
1361208674,1630054892,10,1954,195.4,1361208647507,1361208664403,1630028399,1630045295,16896
1361208678,1630059012,2,472,236,1361208652379,1361208652443,1630033391,1630033455,64
1361208687,1630067808,4,205,51.25,1361208686630,1361208686630,1630067438,1630067438,0
1361208711,1630092016,3,144,48,1361208710487,1361208710551,1630091503,1630091567,64
1361208714,1630095004,1,134,134,1361208687330,1361208687330,1630068334,1630068334,0
1361208718,1630099032,2,472,236,1361208692102,1361208692166,1630073134,1630073198,64
1361208719,1630100132,16,7829,489.3125,1361208699363,1361208716899,1630080495,1630098031,17536
1361208722,1630102992,2,265,132.5,1361208694061,1361208694189,1630075053,1630075181,128
1361208726,1630107136,1,46,46,1361208699742,1361208699742,1630080878,1630080878,0
1361208726,1630107140,12,4898,408.1666667,1361208699932,1361208701404,1630081072,1630082544,1472
1361208734,1630115396,1,46,46,1361208708569,1361208708569,1630089965,1630089965,0
1361208754,1630135000,2,324,162,1361208727397,1361208727973,1630108397,1630108973,576
1361208758,1630139044,2,472,236,1361208732473,1361208732537,1630113517,1630113581,64
1361208767,1630148116,29,33746,1163.655172,1361208750003,1361208765363,1630131119,1630146479,15360
1361208767,1630148164,2,123,61.5,1361208761344,1361208761344,1630142508,1630142508,0
1361208774,1630155028,4,552,138,1361208749897,1361208750793,1630130925,1630131821,896
1361208791,1630172184,3,144,48,1361208785388,1361208785388,1630166572,1630166572,0
1361208794,1630175092,1,46,46,1361208768904,1361208768904,1630149996,1630149996,0
1361208794,1630175136,2,324,162,1361208767260,1361208791516,1630148396,1630172652,24256
1361208794,1630175184,1,46,46,1361208768813,1361208768813,1630149997,1630149997,0
1361208798,1630179084,2,472,236,1361208771858,1361208771922,1630152942,1630153006,64
1361208834,1630215076,1,134,134,1361208807320,1361208807320,1630188396,1630188396,0
1361208834,1630215156,2,265,132.5,1361208806344,1361208806472,1630187500,1630187628,128
1361208838,1630219124,2,472,236,1361208812329,1361208812393,1630193453,1630193517,64
1361208858,268552668,2,98,49,1361208849622,1361208853846,268544290,268548514,4224
1361208858,268552688,2,98,49,1361208849536,1361208852800,268544224,268547488,3264
1361208863,1630244096,3,144,48,1361208860419,1361208860483,1630241515,1630241579,64
1361208874,1630255220,2,324,162,1361208847176,1361208855176,1630228396,1630236396,8000
1361208878,1630259156,2,472,236,1361208852296,1361208852360,1630233452,1630233516,64
1361208890,1630271268,2,265,132.5,1361208862232,1361208862360,1630243500,1630243628,128
1361208898,1630279280,11,1988,180.7272727,1361208870667,1361208871179,1630251947,1630252459,512
1361208914,1630295216,1,134,134,1361208887179,1361208887179,1630268395,1630268395,0
1361208918,1630299228,2,472,236,1361208892159,1361208892223,1630273387,1630273451,64
1361208943,1630324216,3,144,48,1361208935308,1361208935628,1630316524,1630316844,320
1361208946,1630327308,2,265,132.5,1361208918256,1361208918320,1630299564,1630299628,64
1361208946,1630327344,1,190,190,1361208920777,1361208920777,1630302121,1630302121,0
1361208958,1630339256,2,472,236,1361208932194,1361208932258,1630313450,1630313514,64
1361208975,1630356144,29,33362,1150.413793,1361208958224,1361208973648,1630339368,1630354792,15424
1361208975,1630356148,3,286,95.33333333,1361208967309,1361208967309,1630348457,1630348457,0
1361208986,1630367320,2,287,143.5,1361208957987,1361208958755,1630339307,1630340075,768
1361208994,1630375364,12,7312,609.3333333,1361208967092,1361208984628,1630348456,1630365992,17536
1361208998,1630379392,2,472,236,1361208972187,1361208972251,1630353579,1630353643,64
1361208999,1630379440,3,1120,373.3333333,1361208972307,1361208972819,1630352747,1630353259,512
1361208999,1630380212,3,144,48,1361208997775,1361208997775,1630378987,1630378987,0
1361209034,1630415400,1,134,134,1361209007059,1361209007059,1630388459,1630388459,0
1361209039,1630419516,2,472,236,1361209013253,1361209013317,1630393769,1630393833,64
1361209043,1630423496,2,265,132.5,1361209015321,1361209015449,1630395817,1630395945,128
1361209063,1630444388,3,144,48,1361209055197,1361209055197,1630436585,1630436585,0
1361209075,1630455528,2,324,162,1361209047928,1361209049016,1630428456,1630429544,1088
1361209079,1630459716,2,472,236,1361209053563,1361209053627,1630434279,1630434343,64
1361209095,1630475672,2,265,132.5,1361209070249,1361209070377,1630450921,1630451049,128
1361209095,1630476372,4,205,51.25,1361209087213,1361209087213,1630468585,1630468585,0
1361209115,1630495636,2,324,162,1361209087883,1361209112395,1630468519,1630493031,24512
1361209119,1630499796,2,472,236,1361209093610,1361209093674,1630474406,1630474470,64
1361209135,1630516288,3,144,48,1361209130240,1361209130304,1630511528,1630511592,64
1361209143,1630524308,8,535,66.875,1361209136169,1361209141609,1630517477,1630522917,5440
1361209146,268840572,7,498,71.14285714,1361209136247,1361209141687,268830819,268836259,5440
1361209151,1630531676,2,265,132.5,1361209125730,1361209125794,1630506406,1630506470,64
1361209155,1630535644,1,134,134,1361209127874,1361209127874,1630508518,1630508518,0
1361209159,1630539696,2,472,236,1361209133070,1361209133134,1630513766,1630513830,64
1361209159,1630539812,39,44094,1130.615385,1361209134042,1361209136730,1630514854,1630517542,2688
1361209163,1630543684,8,6943,867.875,1361209136795,1361209136923,1630517479,1630517607,128
1361209163,1630543688,10,7956,795.6,1361209136793,1361209136921,1630517481,1630517609,128
1361209163,1630543688,10,8255,825.5,1361209136793,1361209136921,1630517481,1630517609,128
1361209163,1630543744,19,20331,1070.052632,1361209136222,1361209136734,1630516966,1630517478,512
1361209163,1630543768,9,7495,832.7777778,1361209136710,1361209136838,1630517478,1630517606,128
1361209163,1630543768,10,7540,754,1361209136710,1361209136838,1630517478,1630517606,128
1361209163,1630543768,6,4186,697.6666667,1361209136710,1361209136774,1630517478,1630517542,64
1361209163,268857380,25,30023,1200.92,1361209135989,1361209136501,268830369,268830881,512
1361209170,268864588,3,144,48,1361209160230,1361209164646,268854818,268859234,4416
1361209170,268864600,2,98,49,1361209160220,1361209163612,268854820,268858212,3392
1361209179,1630559744,1,46,46,1361209150814,1361209150814,1630531558,1630531558,0
1361209195,1630575680,2,324,162,1361209167840,1361209176672,1630548520,1630557352,8832
1361209199,1630579768,9,2202,244.6666667,1361209171847,1361209172039,1630552615,1630552807,192
1361209199,1630579812,2,472,236,1361209173787,1361209173851,1630554599,1630554663,64
1361209207,1630587704,2,265,132.5,1361209180998,1361209181126,1630561702,1630561830,128
1361209208,1630588432,3,144,48,1361209206101,1361209206165,1630586533,1630586597,64
1361209235,1630616100,1,134,134,1361209207419,1361209207419,1630588519,1630588519,0
1361209239,1630619800,2,472,236,1361209214628,1361209214820,1630595428,1630595620,192
1361209255,1630636332,3,169,56.33333333,1361209251600,1361209251600,1630632932,1630632932,0
1361209255,1630636332,3,169,56.33333333,1361209251600,1361209251600,1630632932,1630632932,0
1361209256,1630636404,3,169,56.33333333,1361209252531,1361209252531,1630632935,1630632935,0
1361209256,1630636404,4,205,51.25,1361209252530,1361209252530,1630632934,1630632934,0
1361209256,1630636404,3,169,56.33333333,1361209252530,1361209252530,1630632934,1630632934,0
1361209256,1630636404,3,169,56.33333333,1361209252530,1361209252530,1630632934,1630632934,0
1361209256,1630636404,3,169,56.33333333,1361209252530,1361209252530,1630632934,1630632934,0
1361209258,268952584,2,123,61.5,1361209251693,1361209251693,268946277,268946277,0
1361209263,1630643784,2,265,132.5,1361209236727,1361209236791,1630617511,1630617575,64
1361209263,1630644372,5,770,154,1361209260777,1361209261673,1630642149,1630643045,896
1361209263,1630644372,4,312,78,1361209260840,1361209260904,1630642212,1630642276,64
1361209264,1630644456,14,5581,398.6428571,1361209261822,1361209262590,1630642278,1630643046,768
1361209267,1630647920,1,190,190,1361209239983,1361209239983,1630620903,1630620903,0
1361209272,1630652408,3,144,48,1361209266159,1361209266159,1630646567,1630646567,0
1361209279,1630659852,2,472,236,1361209254450,1361209254514,1630635302,1630635366,64
1361209287,1630667832,1,46,46,1361209259591,1361209259591,1630640423,1630640423,0
1361209287,1630668372,4,205,51.25,1361209286633,1361209286633,1630668005,1630668005,0
1361209295,1630676344,5,408,81.6,1361209287237,1361209287237,1630668581,1630668581,0
1361209315,1630695908,9,1893,210.3333333,1361209287674,1361209305402,1630668582,1630686310,17728
1361209319,1630699832,2,265,132.5,1361209292163,1361209292227,1630672995,1630673059,64
1361209319,1630699948,2,472,236,1361209293904,1361209293968,1630674852,1630674916,64
1361209328,1630708508,3,144,48,1361209326022,1361209326086,1630706530,1630706594,64
1361209355,1630735860,1,134,134,1361209327721,1361209327721,1630708581,1630708581,0
1361209359,1630739984,2,472,236,1361209333933,1361209333997,1630714917,1630714981,64
1361209375,1630755852,2,265,132.5,1361209348142,1361209348206,1630728994,1630729058,64
1361209395,1630775904,2,324,162,1361209367677,1361209369149,1630748581,1630750053,1472
1361209399,1630780032,2,472,236,1361209373693,1361209373821,1630754725,1630754853,128
1361209408,1630788556,3,144,48,1361209400982,1361209400982,1630781538,1630781538,0
1361209431,1630812008,2,265,132.5,1361209403541,1361209403669,1630784549,1630784677,128
1361209435,1630815988,2,324,162,1361209407654,1361209432678,1630788642,1630813666,25024
1361209439,1630819976,2,472,236,1361209414642,1361209414706,1630795618,1630795682,64
1361209472,1630852820,4,336,84,1361209469327,1361209469391,1630850147,1630850211,64
1361209475,1630855960,1,134,134,1361209447684,1361209447684,1630828644,1630828644,0
1361209479,1630859968,14,3381,241.5,1361209452089,1361209472569,1630833057,1630853537,20480
1361209480,1630860780,3,144,48,1361209475765,1361209476085,1630856545,1630856865,320
1361209482,269176672,2,98,49,1361209470548,1361209475412,269165220,269170084,4864
1361209482,269176672,2,98,49,1361209470547,1361209474387,269165219,269169059,3840
1361209483,1630864028,2,472,236,1361209455168,1361209455232,1630836196,1630836260,64
1361209487,1630867944,6,1141,190.1666667,1361209459409,1361209464785,1630840353,1630845729,5376
1361209499,1630880080,8,4336,542,1361209472584,1361209472776,1630853664,1630853856,192
1361209515,1630896104,2,324,162,1361209487539,1361209496051,1630868643,1630877155,8512
1361209523,1630903976,2,472,236,1361209494961,1361209495025,1630875937,1630876001,64
1361209536,1630916848,2,123,61.5,1361209530611,1361209530611,1630911459,1630911459,0
1361209547,1630928000,2,265,132.5,1361209519897,1361209520025,1630900897,1630901025,128
1361209876,1631256968,3,144,48,1361209850739,1361209859763,1631231707,1631240731,9024
1361210061,1631441844,1,46,46,1361210036268,1361210036268,1631417112,1631417112,0
1361210433,1631814244,11,953,86.63636364,1361210415128,1361210426840,1631796372,1631808084,11712
1361210433,1631814248,12,999,83.25,1361210415700,1361210426836,1631796948,1631808084,11136
1361210433,1631814316,17,6755,397.3529412,1361210414671,1361210426767,1631795987,1631808083,12096
1361210433,1631814324,12,999,83.25,1361210415367,1361210426759,1631796691,1631808083,11392
1361210438,1631818888,11,3267,297,1361210412156,1361210412796,1631793044,1631793684,640
1361210730,1632110508,2,141,70.5,1361210724850,1361210724850,1632105358,1632105358,0
1361210751,1632131688,13,6197,476.6923077,1361210723774,1361210724094,1632104462,1632104782,320
1361210751,1632131692,9,861,95.66666667,1361210724153,1361210724409,1632104845,1632105101,256
1361210751,1632131776,11,3267,297,1361210723942,1361210724582,1632104718,1632105358,640
1361210751,1632131780,9,861,95.66666667,1361210724384,1361210724576,1632105164,1632105356,192
1361210751,1632131804,9,861,95.66666667,1361210724681,1361210724873,1632105485,1632105677,192
1361210946,1632326824,3,138,46,1361210939250,1361210939314,1632320074,1632320138,64
1361210946,1632326824,3,138,46,1361210939250,1361210939314,1632320074,1632320138,64
1361210963,1632344324,3,155,51.66666667,1361210937726,1361210938750,1632319050,1632320074,1024
1361210964,1632344444,2,109,54.5,1361210939630,1361210939630,1632320074,1632320074,0
1361211106,1632487136,2,141,70.5,1361211099895,1361211099895,1632481031,1632481031,0
1361211128,1632508752,14,6617,472.6428571,1361211101432,1361211101752,1632482184,1632482504,320
1361211128,1632508760,8,815,101.875,1361211102320,1361211102512,1632483080,1632483272,192
1361211128,1632508832,15,6833,455.5333333,1361211100969,1361211101225,1632481801,1632482057,256
1361211128,1632508840,9,861,95.66666667,1361211101728,1361211101920,1632482568,1632482760,192
1361211128,1632508844,9,861,95.66666667,1361211101981,1361211102173,1632482825,1632483017,192
1361211323,1632703416,5,281,56.2,1361211313927,1361211320007,1632694343,1632700423,6080
1361211323,1632703424,3,138,46,1361211319997,1361211320061,1632700421,1632700485,64
1361211323,1632703532,3,138,46,1361211319888,1361211319952,1632700420,1632700484,64
1361211345,1632725396,2,109,54.5,1361211320025,1361211320025,1632700421,1632700421,0
1361211345,1632725508,1,63,63,1361211319851,1361211319851,1632700359,1632700359,0
1361211427,1632807504,16,6372,398.25,1361211407852,1361211419948,1632788356,1632800452,12096
1361211427,1632807508,12,999,83.25,1361211408490,1361211419882,1632788998,1632800390,11392
1361211427,1632807508,12,999,83.25,1361211408233,1361211419881,1632788741,1632800389,11648
1361211427,1632807508,11,953,86.63636364,1361211408809,1361211419881,1632789317,1632800389,11072
1361212014,1633394904,14,6617,472.6428571,1361211988562,1361211988882,1633369466,1633369786,320
1361212014,1633395016,8,815,101.875,1361211988834,1361211989026,1633369850,1633370042,192
1361212014,1633395020,9,861,95.66666667,1361211989088,1361211989280,1633370108,1633370300,192
1361212235,1633616132,3,189,63,1361212230379,1361212233387,1633611511,1633614519,3008
1361212251,1633632256,2,126,63,1361212237295,1361212245359,1633618551,1633626615,8064
1361212307,1633688188,4,252,63,1361212299058,1361212306098,1633680246,1633687286,7040
1361212307,1633688280,4,252,63,1361212298903,1361212305943,1633680183,1633687223,7040
1361212339,1633719824,1,63,63,1361212314524,1361212314524,1633695348,1633695348,0
1361212339,1633719912,1,63,63,1361212314309,1361212314309,1633695221,1633695221,0
1361212459,1633840284,9,861,95.66666667,1361212431249,1361212431441,1633812533,1633812725,192
1361212460,1633840464,9,861,95.66666667,1361212431812,1361212432004,1633812276,1633812468,192
1361212460,1633840472,9,861,95.66666667,1361212432317,1361212432509,1633812789,1633812981,192
1361212628,1634009012,4,252,63,1361212620127,1361212627167,1634001139,1634008179,7040
1361212652,1634033232,3,155,51.66666667,1361212635008,1361212645504,1634016240,1634026736,10496
1361212652,1634033276,4,184,46,1361212645462,1361212648470,1634026738,1634029746,3008
1361212669,1634049584,4,235,58.75,1361212646152,1361212665608,1634026736,1634046192,19456
1361212676,1634056888,9,861,95.66666667,1361212648474,1361212648666,1634029362,1634029554,192
1361212676,1634057056,13,6234,479.5384615,1361212647921,1361212648241,1634028977,1634029297,320
1361212676,1634057060,9,861,95.66666667,1361212648556,1361212648748,1634029616,1634029808,192
1361212676,1634057092,9,861,95.66666667,1361212648846,1361212649038,1634029938,1634030130,192
1361212684,1634065196,2,126,63,1361212669029,1361212677093,1634050225,1634058289,8064
1361212869,1634249676,2,126,63,1361212867627,1361212868651,1634248303,1634249327,1024
1361212877,1634257576,2,126,63,1361212870732,1361212874764,1634251308,1634255340,4032
1361212910,1634290388,1,63,63,1361212883019,1361212883019,1634263407,1634263407,0
1361212911,1634292264,1,48,48,1361212883357,1361212883357,1634264621,1634264621,0
1361212918,1634298388,3,189,63,1361212913994,1361212917066,1634294382,1634297454,3072
1361212926,1634306484,3,189,63,1361212920362,1361212923434,1634300846,1634303918,3072
1361212934,1634314412,2,126,63,1361212921009,1361212929073,1634301421,1634309485,8064
1361212942,1634322388,2,126,63,1361212927560,1361212935560,1634307948,1634315948,8000
1361212966,1634346436,3,189,63,1361212961754,1361212964762,1634342190,1634345198,3008
1361212981,1634362368,2,126,63,1361212967860,1361212975924,1634349228,1634357292,8064
1361213215,1634596288,1,46,46,1361213185728,1361213185728,1634567016,1634567016,0
1361214071,1635451888,12,999,83.25,1361214053506,1361214064002,1635434394,1635444890,10496
1361214071,1635451972,12,999,83.25,1361214053168,1361214063984,1635434140,1635444956,10816
1361214071,1635451972,11,953,86.63636364,1361214053679,1361214063919,1635434651,1635444891,10240
1361214184,1635565356,1,48,48,1361214158059,1361214158059,1635539415,1635539415,0
1361215133,1636514112,1,46,46,1361215106705,1361215106705,1636487817,1636487817,0
1361215185,1636566248,11,953,86.63636364,1361215170313,1361215181449,1636551561,1636562697,11136
1361215185,1636566328,15,6289,419.2666667,1361215169275,1361215181371,1636550603,1636562699,12096
1361215185,1636566332,11,953,86.63636364,1361215169718,1361215181366,1636551050,1636562698,11648
1361215185,1636566332,12,999,83.25,1361215169973,1361215181365,1636551305,1636562697,11392
1361216998,1638379212,13,6234,479.5384615,1361216971539,1361216971859,1638352751,1638353071,320
1361216998,1638379216,9,861,95.66666667,1361216971916,1361216972108,1638353132,1638353324,192
1361216998,1638379216,8,815,101.875,1361216972172,1361216972364,1638353388,1638353580,192
1361216998,1638379224,8,815,101.875,1361216972487,1361216972615,1638353711,1638353839,128
1361217251,1638632000,4,252,63,1361217241953,1361217249057,1638622953,1638630057,7104
1361217251,1638632004,4,252,63,1361217241884,1361217248924,1638622888,1638629928,7040
1361217251,1638632084,4,252,63,1361217241998,1361217249038,1638623082,1638630122,7040
1361217283,1638663740,1,63,63,1361217257315,1361217257315,1638638055,1638638055,0
1361217283,1638663740,1,63,63,1361217257446,1361217257446,1638638186,1638638186,0
1361217283,1638663828,1,63,63,1361217257165,1361217257165,1638637993,1638637993,0
1361217395,1638776360,3,189,63,1361217389430,1361217392438,1638770790,1638773798,3008
1361217412,1638792436,2,126,63,1361217397394,1361217405458,1638777830,1638785894,8064
1361217604,1638984772,1,46,46,1361217579009,1361217579009,1638959781,1638959781,0
1361217877,1639257764,17,6755,397.3529412,1361217857092,1361217869188,1639237856,1639249952,12096
1361217877,1639257768,12,999,83.25,1361217857408,1361217869120,1639238176,1639249888,11712
1361217877,1639257852,12,999,83.25,1361217857645,1361217869037,1639238497,1639249889,11392
1361217877,1639257852,11,953,86.63636364,1361217857900,1361217869036,1639238752,1639249888,11136
1361218057,1639437636,3,144,48,1361218032002,1361218040962,1639412638,1639421598,8960
1361218061,1639441664,3,144,48,1361218033571,1361218042531,1639414235,1639423195,8960
1361218770,1640151224,8,815,101.875,1361218743848,1361218744040,1640125072,1640125264,192
1361218770,1640151224,9,861,95.66666667,1361218744171,1361218744363,1640125395,1640125587,192
1361218770,1640151304,14,6617,472.6428571,1361218743388,1361218743708,1640124692,1640125012,320
1361219047,1640428072,4,252,63,1361219039742,1361219046846,1640420814,1640427918,7104
1361219047,1640428148,4,252,63,1361219039731,1361219046771,1640420879,1640427919,7040
1361219055,1640436168,4,252,63,1361219046748,1361219053788,1640427916,1640434956,7040
1361219083,1640463532,1,63,63,1361219055449,1361219055449,1640435981,1640435981,0
1361219083,1640463624,1,63,63,1361219055291,1361219055291,1640435915,1640435915,0
1361219087,1640467760,1,63,63,1361219062262,1361219062262,1640443022,1640443022,0
1361219107,1640487592,8,815,101.875,1361219080157,1361219080349,1640460749,1640460941,192
1361219107,1640487704,8,815,101.875,1361219080301,1361219080493,1640461005,1640461197,192
1361219107,1640487704,8,815,101.875,1361219080556,1361219080748,1640461260,1640461452,192
1361219264,1640644468,3,138,46,1361219261462,1361219262486,1640641930,1640642954,1024
1361219287,1640668212,1,46,46,1361219260782,1361219260782,1640641994,1640641994,0
1361219291,1640672148,8,815,101.875,1361219263660,1361219263852,1640644808,1640645000,192
1361219291,1640672232,8,815,101.875,1361219263067,1361219263195,1640644299,1640644427,128
1361219291,1640672236,9,861,95.66666667,1361219263316,1361219263444,1640644552,1640644680,128
1361219291,1640672264,1,46,46,1361219263737,1361219263737,1640645001,1640645001,0
1361219291,1640672268,8,815,101.875,1361219263864,1361219263992,1640645132,1640645260,128
1361219408,1640788820,2,126,63,1361219405877,1361219406837,1640786697,1640787657,960
1361219416,1640796720,2,126,63,1361219408985,1361219413017,1640789705,1640793737,4032
1361219416,1640796844,2,126,63,1361219414364,1361219415388,1640795208,1640796232,1024
1361219424,1640804852,2,126,63,1361219417364,1361219421396,1640798216,1640802248,4032
1361219448,1640828576,1,63,63,1361219421223,1361219421223,1640801799,1640801799,0
1361219456,1640836608,1,63,63,1361219429704,1361219429704,1640810312,1640810312,0
1361219512,1640892836,4,252,63,1361219504801,1361219511841,1640885637,1640892677,7040
1361219512,1640892916,4,252,63,1361219504723,1361219511763,1640885639,1640892679,7040
1361219536,1640916976,3,189,63,1361219529816,1361219532824,1640910792,1640913800,3008
1361219548,1640928512,1,63,63,1361219520231,1361219520231,1640900743,1640900743,0
1361219548,1640928600,1,63,63,1361219520144,1361219520144,1640900744,1640900744,0
1361219552,1640932972,2,126,63,1361219536857,1361219544921,1640917829,1640925893,8064
1361219552,1640933012,2,126,63,1361219550515,1361219551539,1640931527,1640932551,1024
1361219560,1640940892,2,126,63,1361219553707,1361219557739,1640934599,1640938631,4032
1361219592,1640972596,1,63,63,1361219566033,1361219566033,1640946629,1640946629,0
1361219756,1641136876,2,122,61,1361219731512,1361219733560,1641112388,1641114436,2048
1361220141,1641522068,1,60,60,1361220114866,1361220114866,1641495934,1641495934,0
1361220895,1642276012,13,6234,479.5384615,1361220867358,1361220867678,1642248370,1642248690,320
1361220895,1642276016,9,861,95.66666667,1361220867802,1361220867994,1642248818,1642249010,192
1361220895,1642276020,9,861,95.66666667,1361220868055,1361220868247,1642249075,1642249267,192
1361220895,1642276124,8,815,101.875,1361220868207,1361220868399,1642249331,1642249523,192
1361221084,1642464932,3,189,63,1361221080491,1361221083499,1642461423,1642464431,3008
1361221084,1642464932,3,189,63,1361221080682,1361221083690,1642461614,1642464622,3008
1361221100,1642481144,2,126,63,1361221087510,1361221095574,1642468654,1642476718,8064
1361221100,1642481236,2,126,63,1361221087228,1361221095292,1642468464,1642476528,8064
1361221100,1642481300,3,189,63,1361221094523,1361221097531,1642475823,1642478831,3008
1361221116,1642497120,4,201,50.25,1361221111342,1361221111406,1642492462,1642492526,64
1361221116,1642497164,6,327,54.5,1361221101697,1361221111425,1642482861,1642492589,9728
1361221116,1642497192,4,201,50.25,1361221111204,1361221111268,1642492396,1642492460,64
1361221136,1642516928,2,109,54.5,1361221111534,1361221111534,1642492462,1642492462,0
1361221140,1642520860,9,861,95.66666667,1361221114608,1361221114736,1642495468,1642495596,128
1361221140,1642521012,8,815,101.875,1361221114202,1361221114330,1642495214,1642495342,128
1361221140,1642521032,8,815,101.875,1361221114694,1361221114886,1642495726,1642495918,192
1361221140,1642521032,8,815,101.875,1361221114948,1361221115140,1642495980,1642496172,192
1361221308,1642689284,3,189,63,1361221303174,1361221306182,1642684458,1642687466,3008
1361221325,1642705460,2,126,63,1361221311039,1361221319103,1642691499,1642699563,8064
1361221340,1642721344,4,252,63,1361221332617,1361221339721,1642713961,1642721065,7104
1361221373,1642753704,1,63,63,1361221348361,1361221348361,1642729065,1642729065,0
1361221452,1642833300,4,252,63,1361221444469,1361221451509,1642825769,1642832809,7040
1361221452,1642833360,4,252,63,1361221444343,1361221451383,1642825703,1642832743,7040
1361221485,1642865828,1,63,63,1361221459982,1361221459982,1642840810,1642840810,0
1361221485,1642865832,1,63,63,1361221460042,1361221460042,1642840874,1642840874,0
1361222315,1643696192,1,46,46,1361222286100,1361222286100,1643667292,1643667292,0
1361222687,1644067444,9,861,95.66666667,1361222658939,1361222659067,1644039383,1644039511,128
1361222687,1644067452,8,815,101.875,1361222659187,1361222659379,1644039639,1644039831,192
1361222878,1644258496,3,138,46,1361222875203,1361222875267,1644255699,1644255763,64
1361222878,1644258496,4,184,46,1361222875267,1361222875715,1644255763,1644256211,448
1361222903,1644283772,8,815,101.875,1361222877487,1361222877679,1644258259,1644258451,192
1361222903,1644283856,9,861,95.66666667,1361222876569,1361222876761,1644257425,1644257617,192
1361222903,1644283880,9,861,95.66666667,1361222876803,1361222876995,1644257683,1644257875,192
1361222903,1644283880,8,815,101.875,1361222877123,1361222877251,1644258003,1644258131,128
1361223134,1644514628,3,189,63,1361223128121,1361223131129,1644508749,1644511757,3008
1361223134,1644514628,3,189,63,1361223128060,1361223131068,1644508688,1644511696,3008
1361223150,1644530664,2,126,63,1361223135127,1361223143191,1644515791,1644523855,8064
1361223150,1644530736,2,126,63,1361223134990,1361223143054,1644515726,1644523790,8064
1361223158,1644538644,3,189,63,1361223152554,1361223155562,1644533198,1644536206,3008
1361223174,1644554712,2,126,63,1361223159525,1361223167589,1644540237,1644548301,8064
1361223182,1644562832,4,252,63,1361223173676,1361223180780,1644554508,1644561612,7104
1361223216,1644596436,1,63,63,1361223189178,1361223189178,1644569614,1644569614,0
1361224479,1645859632,14,6617,472.6428571,1361224453793,1361224454113,1645834425,1645834745,320
1361224479,1645859632,9,861,95.66666667,1361224454177,1361224454369,1645834809,1645835001,192
1361224479,1645859660,9,861,95.66666667,1361224454406,1361224454598,1645835066,1645835258,192
1361224720,1646100452,4,184,46,1361224717780,1361224718228,1646098232,1646098680,448
1361224743,1646124180,8,815,101.875,1361224718200,1361224718392,1646099380,1646099572,192
1361224743,1646124252,2,109,54.5,1361224716977,1361224716977,1646098229,1646098229,0
1361224743,1646124252,2,109,54.5,1361224716977,1361224716977,1646098229,1646098229,0
1361224743,1646124288,9,861,95.66666667,1361224718348,1361224718540,1646099636,1646099828,192
1361224747,1646128040,8,815,101.875,1361224718854,1361224719046,1646099894,1646100086,192
1361224747,1646128044,8,815,101.875,1361224719170,1361224719362,1646100214,1646100406,192
1361224952,1646332828,2,126,63,1361224949591,1361224950615,1646330419,1646331443,1024
1361224952,1646332920,2,126,63,1361224950139,1361224951163,1646331059,1646332083,1024
1361224960,1646340908,2,126,63,1361224952519,1361224956551,1646333427,1646337459,4032
1361224960,1646340912,2,126,63,1361224953156,1361224957188,1646334068,1646338100,4032
1361224968,1646348836,3,189,63,1361224962316,1361224965324,1646343152,1646346160,3008
1361224968,1646348920,3,189,63,1361224962235,1361224965243,1646343155,1646346163,3008
1361224984,1646364852,2,126,63,1361224969341,1361224977405,1646350193,1646358257,8064
1361224984,1646364932,2,126,63,1361224969261,1361224977325,1646350193,1646358257,8064
1361224992,1646372528,1,63,63,1361224965635,1361224965635,1646346163,1646346163,0
1361224992,1646372612,1,63,63,1361224964908,1361224964908,1646345520,1646345520,0
1361226271,1647651584,14,6617,472.6428571,1361226243448,1361226243704,1647624032,1647624288,256
1361226271,1647651588,9,861,95.66666667,1361226243826,1361226243954,1647624414,1647624542,128
1361226271,1647651592,9,861,95.66666667,1361226244080,1361226244208,1647624672,1647624800,128
1361226271,1647651616,9,861,95.66666667,1361226244309,1361226244501,1647624925,1647625117,192
1361226484,1647864596,3,138,46,1361226483557,1361226483621,1647864153,1647864217,64
1361226484,1647864596,3,138,46,1361226483621,1361226483685,1647864217,1647864281,64
1361226484,1647864600,3,138,46,1361226483556,1361226483620,1647864156,1647864220,64
1361226484,1647864600,3,138,46,1361226483556,1361226483620,1647864156,1647864220,64
1361226512,1647892388,11,4651,422.8181818,1361226485364,1361226485684,1647865752,1647866072,320
1361226512,1647892484,9,861,95.66666667,1361226485656,1361226485848,1647866140,1647866332,192
1361226512,1647892484,9,861,95.66666667,1361226485910,1361226486102,1647866394,1647866586,192
1361226512,1647892488,9,861,95.66666667,1361226486162,1361226486354,1647866650,1647866842,192
1361226612,1647992932,1,48,48,1361226587414,1361226587414,1647968346,1647968346,0
1361226756,1648136628,3,189,63,1361226750977,1361226753985,1648131605,1648134613,3008
1361226772,1648152596,3,189,63,1361226765538,1361226768610,1648146134,1648149206,3072
1361226772,1648152600,2,126,63,1361226758047,1361226766111,1648138647,1648146711,8064
1361226780,1648160532,2,126,63,1361226776929,1361226777953,1648157461,1648158485,1024
1361226788,1648168524,2,126,63,1361226772715,1361226780715,1648153239,1648161239,8000
1361226788,1648168524,2,126,63,1361226780009,1361226784041,1648160533,1648164565,4032
1361226804,1648184588,3,189,63,1361226797098,1361226800106,1648177686,1648180694,3008
1361226817,1648197544,1,63,63,1361226792023,1361226792023,1648172567,1648172567,0
1361226820,1648200600,2,126,63,1361226804126,1361226812190,1648184726,1648192790,8064
1361226891,1648271372,1,46,46,1361226864063,1361226864063,1648244435,1648244435,0
1361227145,1648526336,1,60,60,1361227117623,1361227117623,1648498959,1648498959,0
1361227238,1648618536,3,144,48,1361227212182,1361227221142,1648592718,1648601678,8960
1361227272,1648652900,1,46,46,1361227243626,1361227243626,1648624526,1648624526,0
1361227379,1648760140,1,48,48,1361227352697,1361227352697,1648733837,1648733837,0
1361228020,1649401236,17,6755,397.3529412,1361228005709,1361228016909,1649386945,1649398145,11200
1361228020,1649401240,12,999,83.25,1361228006091,1361228016843,1649387331,1649398083,10752
1361228020,1649401240,11,953,86.63636364,1361228006345,1361228016841,1649387585,1649398081,10496
1361228020,1649401328,11,953,86.63636364,1361228006581,1361228016757,1649387909,1649398085,10176
1361228153,1649533764,1,46,46,1361228127588,1361228127588,1649508352,1649508352,0
1361229844,1651224472,12,6151,512.5833333,1361229816239,1361229816623,1651196711,1651197095,384
1361229844,1651224476,9,861,95.66666667,1361229816745,1361229816937,1651197221,1651197413,192
1361229844,1651224480,9,861,95.66666667,1361229816998,1361229817190,1651197478,1651197670,192
1361229844,1651224588,8,815,101.875,1361229817147,1361229817339,1651197735,1651197927,192
1361230007,1651387596,2,92,46,1361230006769,1361230006769,1651387365,1651387365,0
1361230015,1651395452,3,138,46,1361230006913,1361230006977,1651387365,1651387429,64
1361230015,1651395496,3,138,46,1361230006867,1361230006931,1651387363,1651387427,64
1361230015,1651395496,3,138,46,1361230006867,1361230006931,1651387363,1651387427,64
1361230023,1651403480,12,999,83.25,1361230010085,1361230021797,1651390565,1651402277,11712
1361230023,1651403500,12,999,83.25,1361230010319,1361230021775,1651390819,1651402275,11456
1361230023,1651403544,16,6372,398.25,1361230009635,1361230021731,1651390179,1651402275,12096
1361230023,1651403552,12,999,83.25,1361230010587,1361230021723,1651391139,1651402275,11136
1361230032,1651412948,1,46,46,1361230006479,1361230006479,1651387427,1651387427,0
1361230367,1651747968,12,999,83.25,1361230352821,1361230364533,1651733789,1651745501,11712
1361230367,1651747972,11,953,86.63636364,1361230353074,1361230364466,1651734046,1651745438,11392
1361230367,1651747976,13,1045,80.38461538,1361230353328,1361230364912,1651734304,1651745888,11584
1361230367,1651748016,17,6418,377.5294118,1361230352392,1361230364488,1651733408,1651745504,12096
1361230377,1651757960,11,3267,297,1361230349439,1361230349951,1651730399,1651730911,512
1361230782,1652162368,1,89,89,1361230753929,1361230753929,1652134297,1652134297,0
1361230896,1652276780,4,319,79.75,1361230894763,1361230895467,1652275543,1652276247,704
1361230904,1652284776,3,267,89,1361230896496,1361230902384,1652277272,1652283160,5888
1361230928,1652308752,2,178,89,1361230910344,1361230926152,1652291096,1652306904,15808
1361230982,1652363064,1,89,89,1361230957452,1361230957452,1652338516,1652338516,0
1361231014,1652395124,11,4651,422.8181818,1361230989392,1361230990224,1652370516,1652371348,832
1361231018,1652399092,9,861,95.66666667,1361230990959,1361230991663,1652372051,1652372755,704
1361231018,1652399172,9,861,95.66666667,1361230990303,1361230990495,1652371475,1652371667,192
1361231018,1652399176,8,815,101.875,1361230990557,1361230990749,1652371733,1652371925,192
1361231216,1652597032,3,189,63,1361231210153,1361231213225,1652591185,1652594257,3072
1361231216,1652597080,3,189,63,1361231209979,1361231212987,1652591059,1652594067,3008
1361231232,1652613108,2,126,63,1361231217181,1361231225245,1652598289,1652606353,8064
1361231232,1652613108,2,126,63,1361231216988,1361231225052,1652598096,1652606160,8064
1361231240,1652621068,2,126,63,1361231237061,1361231238085,1652618129,1652619153,1024
1361231248,1652629084,2,126,63,1361231240118,1361231244150,1652621202,1652625234,4032
1361231264,1652645076,3,189,63,1361231260603,1361231263675,1652641679,1652644751,3072
1361231279,1652659372,1,63,63,1361231252926,1361231252926,1652633298,1652633298,0
1361231280,1652661128,2,126,63,1361231267657,1361231275657,1652648785,1652656785,8000
1361231304,1652685104,2,92,46,1361231301473,1361231301473,1652682577,1652682577,0
1361231304,1652685104,2,92,46,1361231301473,1361231301473,1652682577,1652682577,0
1361231304,1652685180,2,92,46,1361231301396,1361231301396,1652682576,1652682576,0
1361231304,1652685180,2,92,46,1361231301396,1361231301396,1652682576,1652682576,0
1361231320,1652701112,18,6801,377.8333333,1361231302488,1361231314584,1652683600,1652695696,12096
1361231320,1652701144,12,999,83.25,1361231302970,1361231314554,1652684114,1652695698,11584
1361231320,1652701148,12,999,83.25,1361231303284,1361231314484,1652684432,1652695632,11200
1361231320,1652701152,12,999,83.25,1361231303536,1361231314480,1652684688,1652695632,10944
1361231647,1653027792,2,92,46,1361231622481,1361231625553,1653003273,1653006345,3072
1361231663,1653043836,1,446,446,1361231635945,1361231635945,1653016781,1653016781,0
1361231705,1653085616,16,6372,398.25,1361231693056,1361231702720,1653073672,1653083336,9664
1361231705,1653085696,12,999,83.25,1361231693361,1361231702641,1653074057,1653083337,9280
1361231705,1653085696,13,1045,80.38461538,1361231693617,1361231703025,1653074313,1653083721,9408
1361231729,1653109480,11,953,86.63636364,1361231715146,1361231725642,1653095626,1653106122,10496
1361231729,1653109540,11,953,86.63636364,1361231715407,1361231725583,1653095947,1653106123,10176
1361231729,1653109540,11,953,86.63636364,1361231715661,1361231725581,1653096201,1653106121,9920
1361231771,1653151760,11,3267,297,1361231743344,1361231743920,1653124104,1653124680,576
1361231777,1653157904,3,193,64.33333333,1361231771619,1361231771619,1653152523,1653152523,0
1361231793,1653173520,6,3996,666,1361231785442,1361231785762,1653165962,1653166282,320
1361231793,1653173520,6,3996,666,1361231785568,1361231787168,1653166088,1653167688,1600
1361231793,1653173560,7,2448,349.7142857,1361231789561,1361231789689,1653170121,1653170249,128
1361231801,1653181564,11,5422,492.9090909,1361231787123,1361231797363,1653167687,1653177927,10240
1361231801,1653181592,10,4714,471.4,1361231785755,1361231797403,1653166347,1653177995,11648
1361231801,1653181592,24,16267,677.7916667,1361231788056,1361231799128,1653168648,1653179720,11072
1361231801,291495620,18,21892,1216.222222,1361231786459,1361231798427,291481079,291493047,11968
1361231811,1653192088,24,10524,438.5,1361231786601,1361231809001,1653167689,1653190089,22400
1361231817,1653197560,6,3996,666,1361231811770,1361231812026,1653192330,1653192586,256
1361231817,1653197600,12,3199,266.5833333,1361231797648,1361231809424,1653178248,1653190024,11776
1361231817,1653197632,12,4818,401.5,1361231811951,1361231815343,1653192583,1653195975,3392
1361233532,1654913180,12,999,83.25,1361233519796,1361233530804,1654900976,1654911984,11008
1361233532,1654913220,15,6289,419.2666667,1361233518665,1361233530761,1654899885,1654911981,12096
1361233532,1654913224,12,999,83.25,1361233519240,1361233530760,1654900464,1654911984,11520
1361233532,1654913224,12,999,83.25,1361233519495,1361233530759,1654900719,1654911983,11264
1361234195,1655576272,1,46,46,1361234166860,1361234166860,1655548132,1655548132,0
1361234990,1656370956,17,6755,397.3529412,1361234978043,1361234988731,1656358999,1656369687,10688
1361234990,1656370960,12,999,83.25,1361234978424,1361234988728,1656359384,1656369688,10304
1361234990,1656370960,12,999,83.25,1361234978679,1361234988663,1656359639,1656369623,9984
1361236800,1658180992,17,6755,397.3529412,1361236783996,1361236794556,1658164988,1658175548,10560
1361236800,1658181000,12,999,83.25,1361236784310,1361236794486,1658165310,1658175486,10176
1361236800,1658181004,11,953,86.63636364,1361236784625,1361236794481,1658165629,1658175485,9856
1361236827,1658207728,9,861,95.66666667,1361236802243,1361236802435,1658182971,1658183163,192
1361236827,1658207828,8,815,101.875,1361236802402,1361236802594,1658183230,1658183422,192
1361236831,1658211656,8,815,101.875,1361236802894,1361236803022,1658183550,1658183678,128
1361236831,1658211740,8,815,101.875,1361236803064,1361236803192,1658183804,1658183932,128
1361236928,1658309220,3,138,46,1361236923222,1361236923286,1658304442,1658304506,64
1361236928,1658309288,3,138,46,1361236923091,1361236923219,1658304379,1658304507,128
1361236928,1658309288,3,138,46,1361236923091,1361236923155,1658304379,1658304443,64
1361236936,1658317248,6,613,102.1666667,1361236923001,1361236929209,1658304249,1658310457,6208
1361236936,1658317252,17,6418,377.5294118,1361236923128,1361236935224,1658304380,1658316476,12096
1361236936,1658317256,12,999,83.25,1361236923509,1361236935221,1658304765,1658316477,11712
1361236936,1658317256,11,953,86.63636364,1361236923763,1361236935219,1658305019,1658316475,11456
1361237137,1658517372,1,48,48,1361237108133,1361237108133,1658488505,1658488505,0
1361238138,1659519172,17,6418,377.5294118,1361238123510,1361238133750,1659504682,1659514922,10240
1361238138,1659519200,12,999,83.25,1361238125016,1361238133720,1659506216,1659514920,8704
1361238138,1659519204,12,999,83.25,1361238125334,1361238133718,1659506538,1659514922,8384
1361238138,1659519204,11,953,86.63636364,1361238125651,1361238133651,1659506855,1659514855,8000
1361238139,297833464,5,573,114.6,1361238138271,1361238138335,297832735,297832799,64
1361239582,1660962764,1,46,46,1361239555125,1361239555125,1660935889,1660935889,0
1361239948,1661328656,12,999,83.25,1361239937181,1361239945181,1661317837,1661325837,8000
1361239948,1661328660,11,953,86.63636364,1361239937690,1361239945178,1661318350,1661325838,7488
1361239948,1661328732,11,953,86.63636364,1361239937362,1361239945106,1661318094,1661325838,7744
1361239966,1661347148,1,46,46,1361239938480,1361239938480,1661319628,1661319628,0
1361239978,1661359196,8,815,101.875,1361239952001,1361239952193,1661333197,1661333389,192
1361239978,1661359280,9,861,95.66666667,1361239951406,1361239951598,1661332686,1661332878,192
1361239978,1661359280,8,815,101.875,1361239951659,1361239951851,1661332939,1661333131,192
1361239978,1661359308,8,815,101.875,1361239952209,1361239952401,1661333517,1661333709,192
1361240172,1661552864,3,189,63,1361240167243,1361240170315,1661548107,1661551179,3072
1361240172,1661552868,3,189,63,1361240167685,1361240170693,1661548553,1661551561,3008
1361240180,1661560884,3,189,63,1361240173813,1361240176885,1661554697,1661557769,3072
1361240188,1661568924,2,126,63,1361240174670,1361240182734,1661555594,1661563658,8064
1361240188,1661568976,2,126,63,1361240174171,1361240182235,1661555147,1661563211,8064
1361240196,1661576940,2,126,63,1361240180862,1361240188862,1661561802,1661569802,8000
1361240292,1661673056,3,189,63,1361240288648,1361240291656,1661669704,1661672712,3008
1361240308,1661689020,2,126,63,1361240295722,1361240303722,1661676742,1661684742,8000
1361241770,1663150428,9,861,95.66666667,1361241744102,1361241744294,1663124530,1663124722,192
1361241770,1663150516,11,4651,422.8181818,1361241743311,1361241743695,1663123827,1663124211,384
1361241770,1663150536,8,815,101.875,1361241743737,1361241743929,1663124273,1663124465,192
1361241770,1663150544,9,861,95.66666667,1361241744242,1361241744434,1663124786,1663124978,192
1361241959,1663339312,2,126,63,1361241956119,1361241957143,1663336431,1663337455,1024
1361241959,1663339312,2,126,63,1361241956373,1361241957397,1663336685,1663337709,1024
1361241967,1663347336,2,126,63,1361241959166,1361241963198,1663339502,1663343534,4032
1361241967,1663347416,2,126,63,1361241959278,1361241963310,1663339694,1663343726,4032
1361241975,1663355492,2,126,63,1361241972323,1361241973283,1663352815,1663353775,960
1361241983,1663363524,2,126,63,1361241975297,1361241979329,1663355821,1663359853,4032
1361241991,1663371704,3,189,63,1361241985804,1361241988812,1663366508,1663369516,3008
1361241999,1663379396,3,155,51.66666667,1361241971201,1361241998337,1663351597,1663378733,27136
1361241999,1663379400,3,155,51.66666667,1361241971391,1361241998335,1663351791,1663378735,26944
1361241999,1663379612,5,264,52.8,1361241992936,1361241998120,1663373548,1663378732,5184
1361241999,1663379680,5,264,52.8,1361241987238,1361241998118,1663367918,1663378798,10880
1361242027,1663407532,8,815,101.875,1361242000440,1361242000632,1663380972,1663381164,192
1361242027,1663407536,8,815,101.875,1361242000694,1361242000886,1663381230,1663381422,192
1361242027,1663407624,8,815,101.875,1361242000092,1361242000284,1663380716,1663380908,192
1361242027,1663407652,8,815,101.875,1361242000833,1361242001025,1663381485,1663381677,192
1361242207,1663587888,4,252,63,1361242199122,1361242206162,1663580010,1663587050,7040
1361242207,1663587924,2,126,63,1361242204333,1361242205357,1663585257,1663586281,1024
1361242215,1663595748,2,126,63,1361242207519,1361242211551,1663588267,1663592299,4032
1361242223,1663603744,2,126,63,1361242221602,1361242222626,1663602346,1663603370,1024
1361242231,1663611704,2,126,63,1361242224650,1361242228746,1663605354,1663609450,4096
1361242239,1663620080,1,63,63,1361242214036,1361242214036,1663595116,1663595116,0
1361242247,1663628072,1,63,63,1361242219291,1361242219291,1663600363,1663600363,0
1361242263,1663644212,1,63,63,1361242236239,1361242236239,1663617451,1663617451,0
1361242335,1663715816,3,189,63,1361242331673,1361242334681,1663712489,1663715497,3008
1361242351,1663731780,2,126,63,1361242338748,1361242346812,1663719528,1663727592,8064
1361242896,1664277068,11,3267,297,1361242867988,1361242868628,1664249056,1664249696,640
1361243176,1664556468,2,141,70.5,1361243174761,1361243174761,1664555229,1664555229,0
1361243202,1664582396,11,3267,297,1361243174385,1361243174961,1664554781,1664555357,576
1361243334,1664714528,1,46,46,1361243306536,1361243306536,1664687064,1664687064,0
1361243334,1664714640,1,46,46,1361243306106,1361243306106,1664686746,1664686746,0
1361243374,1664754736,8,4958,619.75,1361243346137,1361243370137,1664726873,1664750873,24000
1361243488,1664868592,2,141,70.5,1361243487654,1361243487654,1664868246,1664868246,0
1361243512,1664892644,5,2537,507.4,1361243497140,1361243509108,1664877784,1664889752,11968
1361243514,1664894868,1,89,89,1361243487634,1361243487634,1664868502,1664868502,0
1361243514,1664894988,11,3279,298.0909091,1361243486361,1361243487769,1664867349,1664868757,1408
1361243824,1665204740,5,2535,507,1361243808526,1361243820494,1665189266,1665201234,11968
1361244107,1665487988,1,89,89,1361244080593,1361244080593,1665461581,1665461581,0
1361244120,1665501208,6,497,82.83333333,1361244112246,1361244116342,1665493454,1665497550,4096
1361244137,1665517304,2,178,89,1361244121663,1361244130431,1665501967,1665510735,8768
1361244175,1665556036,1,89,89,1361244147297,1361244147297,1665528333,1665528333,0
1361244207,1665588256,1,89,89,1361244182275,1361244182275,1665563531,1665563531,0
1361244331,1665712252,2,122,61,1361244305863,1361244307911,1665687115,1665689163,2048
1361244595,1665975564,1,46,46,1361244564980,1361244564980,1665945544,1665945544,0
1361244696,1666077168,12,6151,512.5833333,1361244671380,1361244671700,1666052548,1666052868,320
1361244700,1666080980,8,815,101.875,1361244672274,1361244672466,1666053254,1666053446,192
1361244700,1666081068,9,861,95.66666667,1361244671929,1361244672121,1666052997,1666053189,192
1361244700,1666081096,8,815,101.875,1361244672414,1361244672606,1666053510,1666053702,192
1361244724,1666105256,1,46,46,1361244698364,1361244698364,1666079620,1666079620,0
1361244857,1666237992,2,126,63,1361244854082,1361244855106,1666235074,1666236098,1024
1361244857,1666238072,2,126,63,1361244855154,1361244856178,1666236226,1666237250,1024
1361244865,1666245956,2,126,63,1361244857127,1361244861223,1666238083,1666242179,4096
1361244865,1666245964,2,126,63,1361244858333,1361244862365,1666239297,1666243329,4032
1361244882,1666262972,1,46,46,1361244853012,1361244853012,1666233984,1666233984,0
1361244897,1666277512,1,63,63,1361244869664,1361244869664,1666250176,1666250176,0
1361244897,1666277544,1,63,63,1361244870785,1361244870785,1666251329,1666251329,0
1361245002,1666382900,2,126,63,1361244999260,1361245000284,1666380160,1666381184,1024
1361245002,1666382900,2,126,63,1361244999259,1361245000283,1666380159,1666381183,1024
1361245010,1666390760,2,126,63,1361245002407,1361245006439,1666383167,1666387199,4032
1361245010,1666390760,2,126,63,1361245002471,1361245006503,1666383231,1666387263,4032
1361245041,1666421604,1,63,63,1361245014725,1361245014725,1666395329,1666395329,0
1361245041,1666421608,1,63,63,1361245014654,1361245014654,1666395262,1666395262,0
1361245285,1666666220,1,60,60,1361245258135,1361245258135,1666639355,1666639355,0
1361245394,1666775116,11,953,86.63636364,1361245381056,1361245389888,1666762172,1666771004,8832
1361245394,1666775140,11,953,86.63636364,1361245381349,1361245389797,1666762489,1666770937,8448
1361245410,1666791068,14,3460,247.1428571,1361245386414,1361245406574,1666767482,1666787642,20160
1361245803,1667183708,9,861,95.66666667,1361245778703,1361245778895,1667159411,1667159603,192
1361245807,1667187628,9,861,95.66666667,1361245779295,1361245779487,1667159923,1667160115,192
1361245807,1667187716,8,815,101.875,1361245778953,1361245779145,1667159669,1667159861,192
1361245807,1667187744,9,861,95.66666667,1361245779499,1361245779627,1667160243,1667160371,128
1361245963,1667344276,2,126,63,1361245960212,1361245961236,1667341488,1667342512,1024
1361245971,1667352112,2,126,63,1361245963385,1361245967417,1667344497,1667348529,4032
1361246003,1667383856,1,63,63,1361245975738,1361245975738,1667356594,1667356594,0
1361246092,1667472284,3,189,63,1361246088627,1361246091699,1667468911,1667471983,3072
1361246092,1667472292,3,189,63,1361246085804,1361246088812,1667466096,1667469104,3008
1361246100,1667480364,2,126,63,1361246097123,1361246098147,1667477487,1667478511,1024
1361246108,1667488296,2,126,63,1361246095719,1361246103719,1667476015,1667484015,8000
1361246108,1667488300,2,126,63,1361246100258,1361246104290,1667480558,1667484590,4032
1361246108,1667488308,2,126,63,1361246092825,1361246100889,1667473133,1667481197,8064
1361246139,1667520132,1,63,63,1361246111521,1361246111521,1667492653,1667492653,0
1361246296,1667676364,14,6617,472.6428571,1361246269215,1361246269535,1667649579,1667649899,320
1361246296,1667676480,8,815,101.875,1361246269483,1361246269675,1667649963,1667650155,192
1361246353,1667733516,1,46,46,1361246327304,1361246327304,1667707820,1667707820,0
1361246573,1667953304,3,189,63,1361246566552,1361246569560,1667946856,1667949864,3008
1361246573,1667953376,3,189,63,1361246566480,1361246569488,1667946856,1667949864,3008
1361246581,1667961300,5,264,52.8,1361246573596,1361246575708,1667953896,1667956008,2112
1361246581,1667961376,5,264,52.8,1361246573520,1361246575568,1667953896,1667955944,2048
1361246604,1667984736,9,861,95.66666667,1361246578216,1361246578344,1667958952,1667959080,128
1361246604,1667984744,9,861,95.66666667,1361246578720,1361246578848,1667959464,1667959592,128
1361246604,1667984852,8,815,101.875,1361246577780,1361246577972,1667958632,1667958824,192
1361246604,1667984860,8,815,101.875,1361246578348,1361246578476,1667959208,1667959336,128
1361246773,1668153400,4,252,63,1361246765557,1361246772597,1668145957,1668152997,7040
1361246805,1668185468,3,189,63,1361246801008,1361246804016,1668181476,1668184484,3008
1361246808,1668189140,1,63,63,1361246779920,1361246779920,1668161060,1668161060,0
1361246813,1668193480,4,252,63,1361246805412,1361246812452,1668185892,1668192932,7040
1361246813,1668193552,4,252,63,1361246805406,1361246812446,1668185958,1668192998,7040
1361246821,1668201516,2,126,63,1361246808000,1361246816064,1668188516,1668196580,8064
1361246848,1668229132,1,63,63,1361246819864,1361246819864,1668200996,1668200996,0
1361246848,1668229132,1,63,63,1361246819927,1361246819927,1668201059,1668201059,0
1361248092,1669472760,14,6617,472.6428571,1361248064186,1361248064506,1669444946,1669445266,320
1361248092,1669472768,9,861,95.66666667,1361248064561,1361248064753,1669445329,1669445521,192
1361248092,1669472772,8,815,101.875,1361248064814,1361248065006,1669445586,1669445778,192
1361248092,1669472888,8,815,101.875,1361248065017,1361248065145,1669445905,1669446033,128
1361248368,1669749256,2,126,63,1361248366150,1361248367174,1669747406,1669748430,1024
1361248368,1669749256,2,126,63,1361248366150,1361248367174,1669747406,1669748430,1024
1361248376,1669757168,2,126,63,1361248369308,1361248373340,1669750476,1669754508,4032
1361248376,1669757240,2,126,63,1361248369235,1361248373267,1669750475,1669754507,4032
1361248384,1669765204,3,189,63,1361248379063,1361248382071,1669760267,1669763275,3008
1361248384,1669765208,3,189,63,1361248379062,1361248382134,1669760270,1669763342,3072
1361248400,1669781276,2,126,63,1361248386032,1361248394096,1669767308,1669775372,8064
1361248401,1669781352,2,126,63,1361248386957,1361248395021,1669767309,1669775373,8064
1361248409,1669790008,1,63,63,1361248381502,1361248381502,1669762510,1669762510,0
1361248409,1669790008,1,63,63,1361248381565,1361248381565,1669762573,1669762573,0
1361249423,1670803996,2,122,61,1361249396986,1361249399290,1670777982,1670780286,2304
1361249652,1671032292,14,6617,472.6428571,1361249624563,1361249624883,1671004855,1671005175,320
1361249652,1671032436,9,861,95.66666667,1361249624804,1361249624996,1671005240,1671005432,192
1361249858,1671238604,3,189,63,1361249852859,1361249855931,1671233463,1671236535,3072
1361249874,1671254628,2,126,63,1361249859938,1361249867938,1671240566,1671248566,8000
1361249946,1671326844,2,126,63,1361249937351,1361249938375,1671318195,1671319219,1024
1361249964,1671345176,9,861,95.66666667,1361249939387,1361249939579,1671320563,1671320755,192
1361249964,1671345180,9,861,95.66666667,1361249939703,1361249939895,1671320883,1671321075,192
1361249964,1671345264,9,861,95.66666667,1361249938790,1361249938982,1671320054,1671320246,192
1361249965,1671345288,8,815,101.875,1361249940020,1361249940212,1671320308,1671320500,192
1361250170,1671551268,2,126,63,1361250168157,1361250169181,1671549425,1671550449,1024
1361250178,1671558904,2,126,63,1361250171531,1361250175563,1671552435,1671556467,4032
1361250178,1671558972,3,189,63,1361250171077,1361250174149,1671552049,1671555121,3072
1361250194,1671574944,2,126,63,1361250178207,1361250186207,1671559151,1671567151,8000
1361250194,1671574972,4,252,63,1361250185796,1361250192836,1671566768,1671573808,7040
1361250209,1671589756,1,63,63,1361250183774,1361250183774,1671564530,1671564530,0
1361250229,1671609704,1,63,63,1361250201106,1361250201106,1671581810,1671581810,0
1361250234,1671614900,3,189,63,1361250229646,1361250232718,1671610546,1671613618,3072
1361250250,1671630964,2,126,63,1361250236682,1361250244682,1671617646,1671625646,8000
1361250947,1672327864,5,250,50,1361250920485,1361250942117,1672301349,1672322981,21632
1361250991,1672371840,1,48,48,1361250966205,1361250966205,1672347045,1672347045,0
1361251023,1672403832,1,48,48,1361250995398,1361250995398,1672376230,1672376230,0
1361251416,1672796832,2,112,56,1361251391357,1361251391421,1672772189,1672772253,64
1361251420,1672801144,44,56779,1290.431818,1361251417349,1361251417733,1672798493,1672798877,384
1361251444,1672824788,11,4651,422.8181818,1361251418728,1361251419048,1672799516,1672799836,320
1361251444,1672824808,1,46,46,1361251418838,1361251418838,1672799646,1672799646,0
1361251444,1672824816,9,861,95.66666667,1361251419727,1361251419855,1672800543,1672800671,128
1361251444,1672824976,9,861,95.66666667,1361251418928,1361251419184,1672799904,1672800160,256
1361251444,1672824976,9,861,95.66666667,1361251419246,1361251419438,1672800222,1672800414,192
1361251613,1672993456,3,189,63,1361251607157,1361251610229,1672987613,1672990685,3072
1361251629,1673009584,2,126,63,1361251614131,1361251622131,1672994715,1673002715,8000
1361251637,1673017524,3,189,63,1361251630704,1361251633712,1673011228,1673014236,3008
1361251645,1673025620,2,126,63,1361251642064,1361251643088,1673022684,1673023708,1024
1361251653,1673033708,2,126,63,1361251645047,1361251649015,1673025755,1673029723,3968
1361251653,1673033708,2,126,63,1361251637557,1361251645621,1673018265,1673026329,8064
1361251685,1673065500,1,63,63,1361251657288,1361251657288,1673037788,1673037788,0
1361251757,1673137948,4,252,63,1361251749446,1361251756550,1673130394,1673137498,7104
1361251785,1673165688,1,46,46,1361251760072,1361251760072,1673140760,1673140760,0
1361251793,1673173636,1,63,63,1361251764860,1361251764860,1673145496,1673145496,0
1361252243,1673623368,1,78,78,1361252216833,1361252216833,1673597201,1673597201,0
1361253125,1674505636,9,861,95.66666667,1361253099305,1361253099497,1674479941,1674480133,192
1361253125,1674505640,8,815,101.875,1361253099557,1361253099749,1674480197,1674480389,192
1361253125,1674505716,14,6617,472.6428571,1361253098842,1361253099162,1674479558,1674479878,320
1361253287,1674667496,3,189,63,1361253283504,1361253286512,1674664000,1674667008,3008
1361253287,1674667540,3,189,63,1361253283652,1361253286724,1674664192,1674667264,3072
1361253303,1674683484,2,126,63,1361253290749,1361253298813,1674671233,1674679297,8064
1361253303,1674683544,2,126,63,1361253290496,1361253298560,1674671040,1674679104,8064
1361253327,1674707576,2,126,63,1361253323938,1361253324898,1674704514,1674705474,960
1361253335,1674715524,2,126,63,1361253326996,1361253331028,1674707520,1674711552,4032
1361253366,1674746324,1,63,63,1361253339294,1361253339294,1674719618,1674719618,0
1361253415,1674795552,2,92,46,1361253411256,1361253411256,1674791808,1674791808,0
1361253415,1674795552,2,92,46,1361253411320,1361253411320,1674791872,1674791872,0
1361253415,1674795624,2,92,46,1361253411184,1361253411184,1674791808,1674791808,0
1361253438,1674818560,8,815,101.875,1361253412401,1361253412593,1674792961,1674793153,192
1361253438,1674818564,8,815,101.875,1361253412716,1361253412844,1674793280,1674793408,128
1361253438,1674818648,8,815,101.875,1361253412886,1361253413078,1674793534,1674793726,192
1361253438,1674818676,9,861,95.66666667,1361253413114,1361253413306,1674793790,1674793982,192
1361253554,1674935032,5,250,50,1361253528213,1361253549397,1674909245,1674930429,21184
1361253598,1674979028,1,48,48,1361253573402,1361253573402,1674954430,1674954430,0
1361253630,1675010956,1,48,48,1361253602527,1361253602527,1674983483,1674983483,0
1361253679,1675059740,2,126,63,1361253676665,1361253677689,1675057405,1675058429,1024
1361253687,1675067840,2,126,63,1361253679570,1361253683602,1675060410,1675064442,4032
1361253695,1675075836,3,189,63,1361253687896,1361253690904,1675068732,1675071740,3008
1361253695,1675075868,2,126,63,1361253692282,1361253693306,1675073150,1675074174,1024
1361253695,1675075868,2,126,63,1361253692281,1361253693305,1675073149,1675074173,1024
1361253703,1675083780,2,126,63,1361253695377,1361253699409,1675076157,1675080189,4032
1361253703,1675083780,2,126,63,1361253695376,1361253699472,1675076156,1675080252,4096
1361253711,1675091836,2,126,63,1361253694937,1361253703001,1675075773,1675083837,8064
1361253718,1675099196,1,63,63,1361253691310,1361253691310,1675072506,1675072506,0
1361253734,1675115232,1,63,63,1361253707019,1361253707019,1675088251,1675088251,0
1361253734,1675115232,1,63,63,1361253707018,1361253707018,1675088250,1675088250,0
1361254913,1676293568,13,6234,479.5384615,1361254887953,1361254888209,1676268521,1676268777,256
1361254913,1676293572,13,6234,479.5384615,1361254888333,1361254888653,1676268905,1676269225,320
1361254913,1676293676,9,861,95.66666667,1361254888613,1361254888805,1676269289,1676269481,192
1361254917,1676297604,9,861,95.66666667,1361254889004,1361254889196,1676269608,1676269800,192
1361255121,1676502104,4,252,63,1361255112437,1361255119477,1676493541,1676500581,7040
1361255129,1676510112,3,189,63,1361255122604,1361255125676,1676503716,1676506788,3072
1361255145,1676526112,2,126,63,1361255129711,1361255137775,1676510823,1676518887,8064
1361255153,1676533944,1,63,63,1361255127702,1361255127702,1676508646,1676508646,0
1361255153,1676534136,3,189,63,1361255148055,1361255151127,1676529191,1676532263,3072
1361255169,1676550096,2,126,63,1361255155198,1361255163198,1676536294,1676544294,8000
1361255177,1676558100,4,252,63,1361255168889,1361255175993,1676549989,1676557093,7104
1361255210,1676590336,1,63,63,1361255184819,1361255184819,1676565155,1676565155,0
1361255278,1676659028,1,46,46,1361255252734,1361255252734,1676633762,1676633762,0
1361256692,1678072448,17,6896,405.6470588,1361256677806,1361256689838,1678058254,1678070286,12032
1361256692,1678072452,16,6372,398.25,1361256678121,1361256689961,1678058573,1678070413,11840
1361256692,1678072456,11,953,86.63636364,1361256678504,1361256689960,1678058960,1678070416,11456
1361256692,1678072456,12,999,83.25,1361256678758,1361256689894,1678059214,1678070350,11136
1361256692,1678072456,12,999,83.25,1361256679078,1361256689894,1678059534,1678070350,10816
1361257268,1678648816,17,6418,377.5294118,1361257252277,1361257264373,1678633093,1678645189,12096
1361257268,1678648824,12,999,83.25,1361257252715,1361257264363,1678633539,1678645187,11648
1361257268,1678648824,12,999,83.25,1361257252973,1361257264365,1678633797,1678645189,11392
1361257268,1678648872,11,953,86.63636364,1361257253180,1361257264316,1678634052,1678645188,11136
1361257835,1679216136,1,46,46,1361257807659,1361257807659,1679188795,1679188795,0
1361257980,1679360356,1,46,46,1361257953014,1361257953014,1679333370,1679333370,0
1361258164,1679544644,13,6234,479.5384615,1361258138577,1361258138897,1679519221,1679519541,320
1361258164,1679544648,9,861,95.66666667,1361258138958,1361258139150,1679519606,1679519798,192
1361258164,1679544652,8,815,101.875,1361258139277,1361258139405,1679519929,1679520057,128
1361258164,1679544676,9,861,95.66666667,1361258139509,1361258139701,1679520185,1679520377,192
1361258389,1679769608,2,126,63,1361258387062,1361258388022,1679767670,1679768630,960
1361258389,1679769648,2,126,63,1361258386956,1361258387980,1679767604,1679768628,1024
1361258397,1679777600,3,189,63,1361258392062,1361258395070,1679772662,1679775670,3008
1361258397,1679777628,2,126,63,1361258390047,1361258394079,1679770675,1679774707,4032
1361258397,1679777628,2,126,63,1361258390047,1361258394079,1679770675,1679774707,4032
1361258413,1679793596,2,126,63,1361258399103,1361258407167,1679779699,1679787763,8064
1361258428,1679809156,1,63,63,1361258401553,1361258401553,1679782709,1679782709,0
1361258428,1679809156,1,63,63,1361258401552,1361258401552,1679782708,1679782708,0
1361258437,1679817724,3,189,63,1361258431040,1361258434112,1679811764,1679814836,3072
1361258453,1679833588,2,126,63,1361258438277,1361258446277,1679818865,1679826865,8000
1361259070,1680450348,17,6755,397.3529412,1361259059756,1361259069548,1680440104,1680449896,9792
1361259070,1680450352,12,999,83.25,1361259060138,1361259069546,1680440490,1680449898,9408
1361259070,1680450352,12,999,83.25,1361259060394,1361259069482,1680440746,1680449834,9088
1361259070,1680450388,11,953,86.63636364,1361259060612,1361259069444,1680441000,1680449832,8832
1361259495,1680875452,3,144,48,1361259468160,1361259477248,1680848612,1680857700,9088
1361260068,1681448560,1,46,46,1361260043401,1361260043401,1681423961,1681423961,0
1361260076,1681456548,1,56,56,1361260050262,1361260050262,1681430810,1681430810,0
1361260889,1682270036,8,815,101.875,1361260864480,1361260864608,1682245516,1682245644,128
1361260889,1682270040,9,861,95.66666667,1361260864733,1361260864925,1682245773,1682245965,192
1361261182,1682562544,9,861,95.66666667,1361261156168,1361261156296,1682536712,1682536840,128
1361261182,1682562548,9,861,95.66666667,1361261156934,1361261157062,1682537482,1682537610,128
1361261182,1682562608,8,815,101.875,1361261156360,1361261156488,1682536968,1682537096,128
1361261182,1682562612,9,861,95.66666667,1361261156613,1361261156741,1682537225,1682537353,128
1361261295,1682676140,3,189,63,1361261291444,1361261294452,1682672584,1682675592,3008
1361261295,1682676180,4,252,63,1361261287818,1361261294858,1682668998,1682676038,7040
1361261311,1682692168,2,126,63,1361261298456,1361261306456,1682679624,1682687624,8000
1361261330,1682710936,1,63,63,1361261303167,1361261303167,1682684103,1682684103,0
1361261408,1682788280,3,189,63,1361261402638,1361261405646,1682782918,1682785926,3008
1361261416,1682796236,3,189,63,1361261408954,1361261411962,1682789190,1682792198,3008
1361261424,1682804240,2,126,63,1361261409716,1361261417780,1682789956,1682798020,8064
1361261432,1682812252,2,126,63,1361261415979,1361261424043,1682796231,1682804295,8064
1361261488,1682868256,2,126,63,1361261485795,1361261486819,1682866051,1682867075,1024
1361261496,1682876300,2,126,63,1361261488762,1361261492794,1682869062,1682873094,4032
1361261520,1682900524,3,189,63,1361261514714,1361261517722,1682895238,1682898246,3008
1361261526,1682907216,1,63,63,1361261499941,1361261499941,1682881157,1682881157,0
1361261536,1682916284,2,126,63,1361261521994,1361261530058,1682902278,1682910342,8064
1361261795,1683175788,2,96,48,1361261768268,1361261771212,1683149056,1683152000,2944
1361262685,1684065844,9,861,95.66666667,1361262657925,1361262658117,1684038769,1684038961,192
1361262685,1684065880,14,6617,472.6428571,1361262657507,1361262657827,1684038387,1684038707,320
1361262685,1684065884,8,815,101.875,1361262658143,1361262658335,1684039027,1684039219,192
1361262685,1684065884,8,815,101.875,1361262658397,1361262658589,1684039281,1684039473,192
1361262977,1684357604,2,126,63,1361262974385,1361262975409,1684354989,1684356013,1024
1361262977,1684357604,2,126,63,1361262974449,1361262975473,1684355053,1684356077,1024
1361262985,1684365608,2,126,63,1361262977388,1361262981420,1684357996,1684362028,4032
1361262985,1684365624,2,126,63,1361262977439,1361262981471,1684358063,1684362095,4032
1361262993,1684373620,3,189,63,1361262986720,1361262989728,1684367340,1684370348,3008
1361262993,1684373636,3,189,63,1361262986706,1361262989714,1684367342,1684370350,3008
1361263009,1684389924,2,126,63,1361262993459,1361263001523,1684374383,1684382447,8064
1361263009,1684389956,2,126,63,1361262993424,1361263001488,1684374380,1684382444,8064
1361263014,1684394800,1,63,63,1361262989294,1361262989294,1684370094,1684370094,0
1361263014,1684394800,1,63,63,1361262989358,1361262989358,1684370158,1684370158,0
1361264365,1685746028,14,6617,472.6428571,1361264336948,1361264337268,1685717976,1685718296,320
1361264365,1685746032,9,861,95.66666667,1361264337841,1361264338033,1685718873,1685719065,192
1361264365,1685746032,9,861,95.66666667,1361264337328,1361264337456,1685718360,1685718488,128
1361264365,1685746072,9,861,95.66666667,1361264337545,1361264337737,1685718617,1685718809,192
1361264370,1685751048,1,46,46,1361264345057,1361264345057,1685726105,1685726105,0
1361264538,1685918808,4,252,63,1361264530446,1361264537550,1685911254,1685918358,7104
1361264546,1685926804,3,189,63,1361264542483,1361264545555,1685923287,1685926359,3072
1361264562,1685942800,2,126,63,1361264549590,1361264557590,1685930390,1685938390,8000
1361264570,1685950544,1,63,63,1361264545814,1361264545814,1685926358,1685926358,0
1361264586,1685966844,3,189,63,1361264581610,1361264584618,1685962454,1685965462,3008
1361264602,1685982848,2,126,63,1361264588644,1361264596708,1685969492,1685977556,8064
1361264674,1686054904,3,189,63,1361264668526,1361264671598,1686049430,1686052502,3072
1361264690,1686070904,2,126,63,1361264675628,1361264683692,1686056532,1686064596,8064
1361265212,1686592328,3,176,58.66666667,1361265184036,1361265192996,1686564364,1686573324,8960
1361265248,1686628388,9,861,95.66666667,1361265222887,1361265223079,1686603275,1686603467,192
1361265248,1686628388,9,861,95.66666667,1361265223143,1361265223335,1686603531,1686603723,192
1361265248,1686628428,14,6617,472.6428571,1361265222465,1361265222785,1686602893,1686603213,320
1361265248,1686628532,8,815,101.875,1361265223254,1361265223446,1686603786,1686603978,192
1361265491,1686871340,2,126,63,1361265488338,1361265489362,1686868678,1686869702,1024
1361265499,1686879328,2,126,63,1361265491358,1361265495390,1686871686,1686875718,4032
1361265507,1686887320,2,126,63,1361265505129,1361265506153,1686885449,1686886473,1024
1361265515,1686895336,2,126,63,1361265508183,1361265512215,1686888519,1686892551,4032
1361265515,1686895336,3,189,63,1361265511511,1361265514583,1686891847,1686894919,3072
1361265515,1686895368,3,189,63,1361265511479,1361265514551,1686891847,1686894919,3072
1361265529,1686909256,1,63,63,1361265503528,1361265503528,1686883784,1686883784,0
1361265531,1686911308,2,126,63,1361265518642,1361265526642,1686898950,1686906950,8000
1361265531,1686911320,2,126,63,1361265518630,1361265526630,1686898950,1686906950,8000
1361265545,1686925320,1,63,63,1361265520230,1361265520230,1686900550,1686900550,0
1361266133,1687514200,14,6617,472.6428571,1361266107885,1361266108205,1687489085,1687489405,320
1361266134,1687514240,8,815,101.875,1361266109487,1361266109679,1687489727,1687489919,192
1361266134,1687514280,9,861,95.66666667,1361266109191,1361266109383,1687489471,1687489663,192
1361266387,1687767968,3,138,46,1361266381840,1361266381904,1687762808,1687762872,64
1361266387,1687767980,3,138,46,1361266381829,1361266381957,1687762809,1687762937,128
1361266410,1687790676,2,109,54.5,1361266382134,1361266382134,1687762810,1687762810,0
1361266410,1687790684,8,815,101.875,1361266383981,1361266384237,1687764665,1687764921,256
1361266410,1687790728,9,861,95.66666667,1361266383680,1361266383872,1687764408,1687764600,192
1361266410,1687790728,9,861,95.66666667,1361266384257,1361266384449,1687764985,1687765177,192
1361266410,1687790728,9,861,95.66666667,1361266384576,1361266384704,1687765304,1687765432,128
1361266635,1688016176,3,189,63,1361266629502,1361266632510,1688010678,1688013686,3008
1361266652,1688032268,2,126,63,1361266637451,1361266645515,1688017719,1688025783,8064
1361266708,1688088332,4,252,63,1361266699337,1361266706377,1688079669,1688086709,7040
1361266716,1688096340,2,126,63,1361266713664,1361266714688,1688094004,1688095028,1024
1361266716,1688096348,3,189,63,1361266712760,1361266715768,1688093108,1688096116,3008
1361266724,1688104352,2,126,63,1361266716660,1361266720692,1688097012,1688101044,4032
1361266732,1688112356,2,126,63,1361266719791,1361266727855,1688100147,1688108211,8064
1361266739,1688119292,1,63,63,1361266714479,1361266714479,1688094771,1688094771,0
1361266755,1688135296,1,63,63,1361266728812,1361266728812,1688109108,1688109108,0
1361267039,1688420068,9,861,95.66666667,1361267012069,1361267012261,1688393137,1688393329,192
1361267039,1688420100,14,6617,472.6428571,1361267011653,1361267011973,1688392753,1688393073,320
1361267039,1688420104,8,815,101.875,1361267012287,1361267012479,1688393391,1688393583,192
1361267039,1688420104,9,861,95.66666667,1361267012543,1361267012735,1688393647,1688393839,192
1361267276,1688656796,3,189,63,1361267270704,1361267273712,1688651500,1688654508,3008
1361267276,1688656796,3,189,63,1361267270832,1361267273840,1688651628,1688654636,3008
1361267292,1688672824,2,126,63,1361267277845,1361267285909,1688658669,1688666733,8064
1361267292,1688672832,2,126,63,1361267277709,1361267285709,1688658541,1688666541,8000
1361267324,1688704824,3,189,63,1361267319379,1361267322387,1688700203,1688703211,3008
1361267340,1688720860,2,126,63,1361267326384,1361267334448,1688707244,1688715308,8064
1361267364,1688744856,3,189,63,1361267359665,1361267362737,1688740521,1688743593,3072
1361267380,1688760876,2,126,63,1361267366687,1361267374751,1688747563,1688755627,8064
1361268836,1690217024,14,6617,472.6428571,1361268808883,1361268809203,1690189907,1690190227,320
1361268836,1690217028,9,861,95.66666667,1361268809264,1361268809456,1690190292,1690190484,192
1361268836,1690217028,9,861,95.66666667,1361268809583,1361268809711,1690190611,1690190739,128
1361269029,1690410112,3,189,63,1361269024856,1361269027864,1690405968,1690408976,3008
1361269045,1690426184,2,126,63,1361269031827,1361269039891,1690413011,1690421075,8064
1361269149,1690530204,2,126,63,1361269145917,1361269146941,1690527121,1690528145,1024
1361269149,1690530208,3,189,63,1361269144630,1361269147702,1690525838,1690528910,3072
1361269157,1690538180,2,126,63,1361269148949,1361269152981,1690530129,1690534161,4032
1361269166,1690546532,2,126,63,1361269152347,1361269160411,1690532879,1690540943,8064
1361269189,1690569668,1,63,63,1361269161556,1361269161556,1690542224,1690542224,0
1361269213,1690593852,2,96,48,1361269185372,1361269188380,1690566224,1690569232,3008
1361269522,1690902828,14,6617,472.6428571,1361269496750,1361269497070,1690877578,1690877898,320
1361269522,1690902828,9,861,95.66666667,1361269497133,1361269497325,1690877961,1690878153,192
1361269526,1690906368,9,861,95.66666667,1361269497914,1361269498618,1690878282,1690878986,704
1361269526,1690906796,9,861,95.66666667,1361269498319,1361269498511,1690879115,1690879307,192
1361269734,1691114540,3,189,63,1361269730188,1361269733260,1691110728,1691113800,3072
1361269742,1691122516,2,126,63,1361269740900,1361269741860,1691121416,1691122376,960
1361269750,1691130512,2,126,63,1361269743910,1361269747942,1691124422,1691128454,4032
1361269750,1691130536,2,126,63,1361269737296,1361269745296,1691117832,1691125832,8000
1361269758,1691138484,2,126,63,1361269756865,1361269757825,1691137349,1691138309,960
1361269766,1691146488,2,126,63,1361269759872,1361269763904,1691140360,1691144392,4032
1361269782,1691162508,3,189,63,1361269777129,1361269780137,1691157637,1691160645,3008
1361269783,1691163404,1,63,63,1361269756114,1361269756114,1691136518,1691136518,0
1361269798,1691178504,2,126,63,1361269784173,1361269792237,1691164677,1691172741,8064
1361269799,1691179404,1,63,63,1361269772052,1361269772052,1691152456,1691152456,0
1361270152,1691532636,1,48,48,1361270124771,1361270124771,1691505407,1691505407,0
1361271183,1692563472,3,180,60,1361271158457,1361271167545,1692538929,1692548017,9088
1361271315,1692695776,14,6617,472.6428571,1361271289221,1361271289605,1692669997,1692670381,384
1361271315,1692695780,9,861,95.66666667,1361271289922,1361271290114,1692670702,1692670894,192
1361271315,1692695840,9,861,95.66666667,1361271289541,1361271289733,1692670381,1692670573,192
1361271551,1692931448,4,252,63,1361271543497,1361271550601,1692923945,1692931049,7104
1361271559,1692939500,3,189,63,1361271555416,1361271558488,1692935916,1692938988,3072
1361271559,1692940056,8,815,101.875,1361271533418,1361271533610,1692914474,1692914666,192
1361271559,1692940060,8,815,101.875,1361271533160,1361271533352,1692914220,1692914412,192
1361271559,1692940060,8,815,101.875,1361271533669,1361271533861,1692914729,1692914921,192
1361271559,1692940184,9,861,95.66666667,1361271533868,1361271533996,1692915052,1692915180,128
1361271575,1692955496,2,126,63,1361271562524,1361271570524,1692943020,1692951020,8000
1361271575,1692955504,3,189,63,1361271568532,1361271571604,1692949036,1692952108,3072
1361271583,1692964088,1,63,63,1361271558025,1361271558025,1692939113,1692939113,0
1361271591,1692971488,2,126,63,1361271575650,1361271583714,1692956138,1692964202,8064
1361271799,1693179704,3,189,63,1361271795081,1361271798153,1693175785,1693178857,3072
1361271799,1693179740,3,189,63,1361271795044,1361271798116,1693175784,1693178856,3072
1361271815,1693195680,3,189,63,1361271809568,1361271812576,1693190248,1693193256,3008
1361271815,1693195680,2,126,63,1361271802207,1361271810207,1693182887,1693190887,8000
1361271815,1693195712,2,126,63,1361271802175,1361271810175,1693182887,1693190887,8000
1361271831,1693211692,2,126,63,1361271816596,1361271824660,1693197288,1693205352,8064
1361271831,1693211716,2,126,63,1361271829817,1361271830841,1693210533,1693211557,1024
1361271839,1693219700,2,126,63,1361271832908,1361271836940,1693213608,1693217640,4032
1361271872,1693252568,1,63,63,1361271845068,1361271845068,1693225636,1693225636,0
1361271948,1693328948,2,122,61,1361271922960,1361271925008,1693303908,1693305956,2048
1361272080,1693461076,1,46,46,1361272054800,1361272054800,1693435876,1693435876,0
1361272345,1693726084,1,46,46,1361272317377,1361272317377,1693698461,1693698461,0
1361272442,1693822304,1,46,46,1361272417357,1361272417357,1693797661,1693797661,0
1361272878,1694258904,1,46,46,1361272853679,1361272853679,1694234583,1694234583,0
1361273103,1694483516,8,815,101.875,1361273078831,1361273079023,1694459347,1694459539,192
1361273103,1694483532,14,6617,472.6428571,1361273077921,1361273078241,1694458453,1694458773,320
1361273103,1694483532,9,861,95.66666667,1361273078560,1361273078752,1694459092,1694459284,192
1361273103,1694483568,9,861,95.66666667,1361273078265,1361273078457,1694458833,1694459025,192
1361273171,1694551804,5,2454,490.8,1361273142735,1361273165007,1694523539,1694545811,22272
1361273215,1694595884,1,599,599,1361273188925,1361273188925,1694569809,1694569809,0
1361273296,1694677060,2,126,63,1361273293006,1361273294030,1694674066,1694675090,1024
1361273304,1694684884,2,126,63,1361273296189,1361273300221,1694677073,1694681105,4032
1361273336,1694716236,1,63,63,1361273308930,1361273308930,1694689166,1694689166,0
1361273344,1694724992,2,126,63,1361273342798,1361273343822,1694723790,1694724814,1024
1361273352,1694733088,2,126,63,1361273345713,1361273349745,1694726801,1694730833,4032
1361273352,1694733092,3,189,63,1361273347882,1361273350954,1694728974,1694732046,3072
1361273352,1694733092,3,189,63,1361273348010,1361273351018,1694729102,1694732110,3008
1361273368,1694749072,2,126,63,1361273355070,1361273363134,1694736142,1694744206,8064
1361273368,1694749116,2,126,63,1361273354899,1361273362963,1694736015,1694744079,8064
1361273384,1694764276,1,63,63,1361273358621,1361273358621,1694738897,1694738897,0
1361273416,1694796288,2,92,46,1361273388494,1361273389006,1694768782,1694769294,512
1361274787,1696167596,14,6617,472.6428571,1361274762311,1361274762631,1696142907,1696143227,320
1361274787,1696167640,8,815,101.875,1361274762651,1361274762843,1696143291,1696143483,192
1361274791,1696171572,9,861,95.66666667,1361274762972,1361274763164,1696143544,1696143736,192
1361274791,1696171612,8,815,101.875,1361274763252,1361274763444,1696143864,1696144056,192
1361275041,1696422064,4,252,63,1361275032110,1361275039150,1696413174,1696420214,7040
1361275041,1696422076,4,252,63,1361275031968,1361275039008,1696413044,1696420084,7040
1361275041,1696422076,4,252,63,1361275032096,1361275039136,1696413172,1696420212,7040
1361275041,1696422104,4,252,63,1361275032580,1361275039684,1696413684,1696420788,7104
1361275075,1696456172,1,63,63,1361275047043,1361275047043,1696428215,1696428215,0
1361275075,1696456172,1,63,63,1361275047107,1361275047107,1696428279,1696428279,0
1361275076,1696456212,1,63,63,1361275047937,1361275047937,1696428149,1696428149,0
1361275076,1696456216,1,63,63,1361275048572,1361275048572,1696428788,1696428788,0
1361275100,1696480544,1,46,46,1361275072436,1361275072436,1696452980,1696452980,0
1361275673,1697054092,13,6234,479.5384615,1361275648584,1361275648904,1697029676,1697029996,320
1361275677,1697058072,9,861,95.66666667,1361275649309,1361275649501,1697030381,1697030573,192
1361275677,1697058096,8,815,101.875,1361275649028,1361275649220,1697030124,1697030316,192
1361275906,1697286676,4,252,63,1361275897957,1361275905061,1697278633,1697285737,7104
1361275906,1697286688,4,252,63,1361275898137,1361275905177,1697278825,1697285865,7040
1361275922,1697302684,4,252,63,1361275914522,1361275921562,1697295206,1697302246,7040
1361275938,1697318640,1,63,63,1361275913094,1361275913094,1697293734,1697293734,0
1361275938,1697318680,1,63,63,1361275913247,1361275913247,1697293927,1697293927,0
1361275954,1697334608,1,63,63,1361275929702,1361275929702,1697310310,1697310310,0
1361275970,1697350752,2,92,46,1361275963096,1361275963096,1697343848,1697343848,0
1361275970,1697350752,2,92,46,1361275963095,1361275963095,1697343847,1697343847,0
1361275970,1697350764,2,92,46,1361275963085,1361275963085,1697343849,1697343849,0
1361275990,1697370672,8,815,101.875,1361275964837,1361275965029,1697345509,1697345701,192
1361275990,1697370672,9,861,95.66666667,1361275965096,1361275965288,1697345768,1697345960,192
1361275990,1697370672,9,861,95.66666667,1361275965351,1361275965543,1697346023,1697346215,192
1361275990,1697370704,9,861,95.66666667,1361275964550,1361275964742,1697345254,1697345446,192
1361276354,1697735068,3,189,63,1361276346966,1361276349974,1697728034,1697731042,3008
1361276370,1697751052,2,126,63,1361276354020,1361276362084,1697735072,1697743136,8064
1361276370,1697751056,3,189,63,1361276363361,1361276366433,1697744417,1697747489,3072
1361276370,1697751072,3,189,63,1361276363346,1361276366418,1697744418,1697747490,3072
1361276378,1697759096,4,252,63,1361276369595,1361276376635,1697750691,1697757731,7040
1361276386,1697767032,2,126,63,1361276370487,1361276378487,1697751519,1697759519,8000
1361276386,1697767032,2,126,63,1361276370487,1361276378487,1697751519,1697759519,8000
1361276411,1697791528,1,63,63,1361276385266,1361276385266,1697765794,1697765794,0
1361277306,1698686312,2,122,61,1361277281021,1361277283133,1698661333,1698663445,2112
1361277466,1698846656,8,815,101.875,1361277439648,1361277439840,1698820304,1698820496,192
1361277466,1698846696,14,6617,472.6428571,1361277438967,1361277439287,1698819663,1698819983,320
1361277466,1698846700,9,861,95.66666667,1361277439349,1361277439541,1698820049,1698820241,192
1361277466,1698846700,9,861,95.66666667,1361277439859,1361277440051,1698820559,1698820751,192
1361277707,1699087888,3,189,63,1361277700659,1361277703731,1699081547,1699084619,3072
1361277715,1699095912,3,189,63,1361277711259,1361277714267,1699092171,1699095179,3008
1361277715,1699095924,3,189,63,1361277711250,1361277714258,1699092174,1699095182,3008
1361277723,1699103908,2,126,63,1361277707746,1361277715746,1699088654,1699096654,8000
1361277731,1699111888,2,126,63,1361277718324,1361277726388,1699099212,1699107276,8064
1361277731,1699111900,2,126,63,1361277718311,1361277726375,1699099211,1699107275,8064
1361277843,1699223996,2,126,63,1361277839944,1361277840968,1699220940,1699221964,1024
1361277851,1699231996,2,126,63,1361277843013,1361277847045,1699224009,1699228041,4032
1361277883,1699263196,1,63,63,1361277855845,1361277855845,1699236041,1699236041,0
1361278191,1699571940,1,48,48,1361278166202,1361278166202,1699547142,1699547142,0
1361278700,1700080688,1,46,46,1361278673327,1361278673327,1700054015,1700054015,0
1361279149,1700530000,9,861,95.66666667,1361279123119,1361279123247,1700504119,1700504247,128
1361279149,1700530004,9,861,95.66666667,1361279123373,1361279123501,1700504377,1700504505,128
1361279149,1700530068,9,861,95.66666667,1361279123562,1361279123754,1700504630,1700504822,192
1361279381,1700761616,4,252,63,1361279373099,1361279380139,1700753715,1700760755,7040
1361279390,1700770568,14,6617,472.6428571,1361279364060,1361279364380,1700744628,1700744948,320
1361279390,1700770568,8,815,101.875,1361279364697,1361279364889,1700745265,1700745457,192
1361279390,1700770592,9,861,95.66666667,1361279364929,1361279365121,1700745521,1700745713,192
1361279390,1700770608,8,815,101.875,1361279364402,1361279364530,1700745010,1700745138,128
1361279414,1700794900,1,63,63,1361279387917,1361279387917,1700768817,1700768817,0
1361279421,1700801628,3,189,63,1361279417504,1361279420512,1700798132,1700801140,3008
1361279437,1700817652,2,126,63,1361279424520,1361279432584,1700805172,1700813236,8064
1361279461,1700841632,2,126,63,1361279458652,1361279459676,1700839284,1700840308,1024
1361279469,1700849636,2,126,63,1361279461716,1361279465748,1700842352,1700846384,4032
1361279498,1700879012,1,63,63,1361279473372,1361279473372,1700854384,1700854384,0
1361279645,1701025752,2,126,63,1361279643294,1361279644318,1701024046,1701025070,1024
1361279645,1701025756,2,126,63,1361279643549,1361279644573,1701024305,1701025329,1024
1361279645,1701025792,2,126,63,1361279643511,1361279644471,1701024303,1701025263,960
1361279645,1701025792,2,126,63,1361279643574,1361279644598,1701024366,1701025390,1024
1361279653,1701033748,2,126,63,1361279646562,1361279650594,1701027310,1701031342,4032
1361279653,1701033752,2,126,63,1361279646685,1361279650717,1701027437,1701031469,4032
1361279653,1701033764,2,126,63,1361279646548,1361279650580,1701027312,1701031344,4032
1361279653,1701033792,2,126,63,1361279646262,1361279650294,1701027054,1701031086,4032
1361279683,1701063424,1,63,63,1361279658725,1361279658725,1701039149,1701039149,0
1361279687,1701067340,1,63,63,1361279659067,1361279659067,1701039407,1701039407,0
1361279687,1701067340,1,63,63,1361279659130,1361279659130,1701039470,1701039470,0
1361279687,1701067384,1,63,63,1361279659021,1361279659021,1701039405,1701039405,0
1361280926,1702306516,16,6372,398.25,1361280914809,1361280924345,1702295325,1702304861,9536
1361280926,1702306520,11,953,86.63636364,1361280915765,1361280924341,1702296285,1702304861,8576
1361280926,1702306552,12,999,83.25,1361280915220,1361280924308,1702295772,1702304860,9088
1361280926,1702306552,12,999,83.25,1361280915475,1361280924307,1702296027,1702304859,8832
1361281449,1702829980,1,46,46,1361281422625,1361281422625,1702803605,1702803605,0
1361282098,1703479016,2,122,61,1361282073008,1361282075248,1703454024,1703456264,2240
1361282623,1704004040,14,6617,472.6428571,1361282598480,1361282598800,1703979520,1703979840,320
1361282623,1704004040,9,861,95.66666667,1361282598868,1361282599060,1703979908,1703980100,192
1361282627,1704008012,9,861,95.66666667,1361282599150,1361282599342,1703980162,1703980354,192
1361282863,1704243708,3,189,63,1361282857563,1361282860635,1704238271,1704241343,3072
1361282879,1704259696,2,126,63,1361282864677,1361282872677,1704245373,1704253373,8000
1361282879,1704259696,3,189,63,1361282873189,1361282876261,1704253885,1704256957,3072
1361282879,1704259696,2,126,63,1361282876964,1361282877988,1704257660,1704258684,1024
1361282887,1704267748,2,126,63,1361282879921,1361282883953,1704260669,1704264701,4032
1361282895,1704275748,2,126,63,1361282880241,1361282888241,1704260989,1704268989,8000
1361282911,1704291748,3,155,51.66666667,1361282892017,1361282909297,1704272765,1704290045,17280
1361282911,1704291756,2,92,46,1361282909354,1361282909354,1704290110,1704290110,0
1361282911,1704291796,2,92,46,1361282909313,1361282909313,1704290109,1704290109,0
1361282936,1704316548,8,815,101.875,1361282911224,1361282911416,1704291772,1704291964,192
1361282936,1704316552,8,815,101.875,1361282911540,1361282911732,1704292092,1704292284,192
1361282936,1704316592,9,861,95.66666667,1361282910924,1361282911116,1704291516,1704291708,192
1361282936,1704316632,9,861,95.66666667,1361282911717,1361282911909,1704292349,1704292541,192
1361283088,1704469076,1,46,46,1361283063847,1361283063847,1704444923,1704444923,0
1361283135,1704515900,3,189,63,1361283127959,1361283130967,1704508859,1704511867,3008
1361283143,1704523900,3,189,63,1361283137876,1361283140884,1704518776,1704521784,3008
1361283143,1704523944,3,189,63,1361283137066,1361283140138,1704518010,1704521082,3072
1361283143,1704523944,3,189,63,1361283137066,1361283140138,1704518010,1704521082,3072
1361283151,1704531880,2,126,63,1361283135018,1361283143082,1704515898,1704523962,8064
1361283159,1704539884,2,126,63,1361283144227,1361283152291,1704525111,1704533175,8064
1361283159,1704539936,2,126,63,1361283144177,1361283152241,1704525113,1704533177,8064
1361283159,1704539944,2,126,63,1361283144874,1361283152938,1704525818,1704533882,8064
1361284208,1705588752,17,6755,397.3529412,1361284193626,1361284204186,1705574378,1705584938,10560
1361284208,1705588776,12,999,83.25,1361284193986,1361284204162,1705574762,1705584938,10176
1361284208,1705588828,12,999,83.25,1361284194187,1361284204107,1705575015,1705584935,9920
1361284208,1705588828,12,999,83.25,1361284194446,1361284204110,1705575274,1705584938,9664
1361286027,1707407412,9,861,95.66666667,1361286000082,1361286000274,1707380494,1707380686,192
1361286027,1707407412,9,861,95.66666667,1361286000401,1361286000529,1707380813,1707380941,128
1361286027,1707407412,9,861,95.66666667,1361286000656,1361286000848,1707381068,1707381260,192
1361286282,1707662872,3,189,63,1361286276289,1361286279361,1707657161,1707660233,3072
1361286290,1707670764,3,189,63,1361286283693,1361286286701,1707664457,1707667465,3008
1361286290,1707670816,2,126,63,1361286286905,1361286287929,1707667721,1707668745,1024
1361286298,1707678768,2,126,63,1361286289960,1361286293992,1707670728,1707674760,4032
1361286298,1707678768,2,126,63,1361286283496,1361286291496,1707664264,1707672264,8000
1361286306,1707686848,2,126,63,1361286290649,1361286298713,1707671497,1707679561,8064
1361286320,1707700348,9,861,95.66666667,1361286294349,1361286294541,1707674697,1707674889,192
1361286320,1707700396,14,6617,472.6428571,1361286293404,1361286293724,1707673800,1707674120,320
1361286320,1707700404,8,815,101.875,1361286294035,1361286294227,1707674439,1707674631,192
1361286320,1707700404,9,861,95.66666667,1361286293782,1361286293974,1707674186,1707674378,192
1361286538,1707918952,3,189,63,1361286531119,1361286534191,1707912071,1707915143,3072
1361286554,1707934940,2,126,63,1361286538232,1361286546232,1707919172,1707927172,8000
1361286602,1707983064,3,189,63,1361286596732,1361286599740,1707977796,1707980804,3008
1361286618,1707999012,3,189,63,1361286613809,1361286616817,1707994821,1707997829,3008
1361286618,1707999024,2,126,63,1361286603811,1361286611875,1707984835,1707992899,8064
1361286618,1707999056,3,189,63,1361286613765,1361286616837,1707994821,1707997893,3072
1361286634,1708014988,2,126,63,1361286620873,1361286628937,1708001861,1708009925,8064
1361286634,1708015068,2,126,63,1361286620857,1361286628857,1708001925,1708009925,8000
1361286891,1708271164,12,999,83.25,1361286873980,1361286883452,1708254144,1708263616,9472
1361286891,1708271184,12,999,83.25,1361286874281,1361286883433,1708254465,1708263617,9152
1361286891,1708271228,17,6755,397.3529412,1361286873532,1361286883388,1708253760,1708263616,9856
1361287113,1708493828,8,815,101.875,1361287085921,1361287086113,1708466749,1708466941,192
1361287113,1708493904,8,815,101.875,1361287085588,1361287085780,1708466492,1708466684,192
1361287113,1708493912,9,861,95.66666667,1361287086158,1361287086350,1708467070,1708467262,192
1361287113,1708493912,9,861,95.66666667,1361287086413,1361287086605,1708467325,1708467517,192
1361287298,1708678400,14,6280,448.5714286,1361287273034,1361287273418,1708653434,1708653818,384
1361287298,1708678404,9,861,95.66666667,1361287273735,1361287273927,1708654139,1708654331,192
1361287298,1708678480,9,861,95.66666667,1361287273404,1361287273596,1708653884,1708654076,192
1361287302,1708682396,9,861,95.66666667,1361287273998,1361287274190,1708654394,1708654586,192
1361287318,1708698272,2,126,63,1361287313612,1361287314636,1708693884,1708694908,1024
1361287323,1708703436,2,126,63,1361287316517,1361287320549,1708696953,1708700985,4032
1361287339,1708719460,3,189,63,1361287333646,1361287336654,1708714106,1708717114,3008
1361287347,1708727472,3,189,63,1361287340288,1361287343296,1708720760,1708723768,3008
1361287354,1708734468,1,63,63,1361287328519,1361287328519,1708708987,1708708987,0
1361287355,1708735468,2,126,63,1361287340676,1361287348740,1708721144,1708729208,8064
1361287363,1708743500,2,126,63,1361287347300,1361287355300,1708727800,1708735800,8000
1361287427,1708807512,4,252,63,1361287419224,1361287426264,1708799736,1708806776,7040
1361287458,1708838996,1,63,63,1361287433844,1361287433844,1708814840,1708814840,0
1361287467,1708847472,3,189,63,1361287463233,1361287466305,1708843705,1708846777,3072
1361287483,1708863480,3,189,63,1361287477174,1361287480182,1708857654,1708860662,3008
1361287483,1708863508,2,126,63,1361287470298,1361287478298,1708850806,1708858806,8000
1361287499,1708879564,2,126,63,1361287484130,1361287492194,1708864694,1708872758,8064
1361287507,1708887532,4,252,63,1361287498881,1361287505985,1708879413,1708886517,7104
1361287539,1708919276,1,63,63,1361287514243,1361287514243,1708894519,1708894519,0
1361287659,1709039664,4,252,63,1361287651327,1361287658367,1709031991,1709039031,7040
1361287692,1709072408,1,63,63,1361287666684,1361287666684,1709047092,1709047092,0
1361287911,1709291940,9,861,95.66666667,1361287883941,1361287884069,1709264881,1709265009,128
1361287911,1709291944,9,861,95.66666667,1361287884193,1361287884961,1709265137,1709265905,768
1361288132,1709512492,3,189,63,1361288127264,1361288130336,1709507756,1709510828,3072
1361288148,1709528480,2,126,63,1361288134319,1361288142383,1709514799,1709522863,8064
1361288180,1709560488,3,138,46,1361288172516,1361288172580,1709553004,1709553068,64
1361288180,1709560532,2,92,46,1361288172472,1361288172472,1709553004,1709553004,0
1361288200,1709580476,9,977,108.5555556,1361288175858,1361288176114,1709556334,1709556590,256
1361288204,1709584552,8,815,101.875,1361288176422,1361288176614,1709556974,1709557166,192
1361288204,1709584552,8,815,101.875,1361288176740,1361288176932,1709557292,1709557484,192
1361288204,1709584624,9,861,95.66666667,1361288176030,1361288176222,1709556654,1709556846,192
1361288404,1709784992,2,126,63,1361288401448,1361288402472,1709782440,1709783464,1024
1361288404,1709784996,2,126,63,1361288401956,1361288402980,1709782952,1709783976,1024
1361288412,1709792992,2,126,63,1361288404969,1361288409001,1709785961,1709789993,4032
1361288412,1709793040,2,126,63,1361288404475,1361288408507,1709785515,1709789547,4032
1361288445,1709825200,1,63,63,1361288417343,1361288417343,1709797543,1709797543,0
1361288445,1709825280,1,63,63,1361288417776,1361288417776,1709798056,1709798056,0
1361288508,1709889060,3,189,63,1361288504354,1361288507362,1709885414,1709888422,3008
1361288508,1709889116,3,189,63,1361288504301,1361288507373,1709885417,1709888489,3072
1361288524,1709905184,2,126,63,1361288511270,1361288519334,1709892454,1709900518,8064
1361288525,1709905256,2,126,63,1361288512265,1361288520265,1709892521,1709900521,8000
1361288612,1709993152,2,106,53,1361288584262,1361288584326,1709965414,1709965478,64
1361288613,1709993200,2,92,46,1361288611839,1361288611839,1709992039,1709992039,0
1361288613,1709993252,2,92,46,1361288611787,1361288611787,1709992039,1709992039,0
1361288613,1709993252,2,92,46,1361288611787,1361288611787,1709992039,1709992039,0
1361288613,1709993252,2,92,46,1361288611786,1361288611786,1709992038,1709992038,0
1361288637,1710017544,9,861,95.66666667,1361288612580,1361288612772,1709993124,1709993316,192
1361288637,1710017580,9,861,95.66666667,1361288612802,1361288612994,1709993382,1709993574,192
1361288637,1710017624,11,4651,422.8181818,1361288612053,1361288612373,1709992677,1709992997,320
1361288641,1710021532,4,4335,1083.75,1361288614321,1361288633905,1709994853,1710014437,19584
1361288641,1710021600,9,861,95.66666667,1361288613102,1361288613294,1709993702,1709993894,192
1361288701,1710081820,1,60,60,1361288676880,1361288676880,1710057700,1710057700,0
1361288869,1710249396,4,252,63,1361288861048,1361288868088,1710241444,1710248484,7040
1361288893,1710273404,4,252,63,1361288884975,1361288892015,1710265379,1710272419,7040
1361288902,1710282412,1,63,63,1361288876134,1361288876134,1710256546,1710256546,0
1361288926,1710306372,1,63,63,1361288900111,1361288900111,1710280483,1710280483,0
1361288957,1710337396,3,189,63,1361288951092,1361288954100,1710331488,1710334496,3008
1361288973,1710353404,2,126,63,1361288958124,1361288966124,1710338528,1710346528,8000
1361289021,1710401468,3,189,63,1361289014509,1361289017517,1710394977,1710397985,3008
1361289037,1710417480,2,126,63,1361289021534,1361289029598,1710402014,1710410078,8064
1361289677,1711057868,2,92,46,1361289672721,1361289672721,1711053589,1711053589,0
1361289677,1711057940,2,92,46,1361289672648,1361289672648,1711053588,1711053588,0
1361289677,1711057944,2,92,46,1361289672647,1361289672647,1711053591,1711053591,0
1361289677,1711057944,2,92,46,1361289672647,1361289672647,1711053591,1711053591,0
1361289703,1711084072,8,815,101.875,1361289676871,1361289677063,1711057943,1711058135,192
1361289703,1711084076,8,815,101.875,1361289677186,1361289677378,1711058262,1711058454,192
1361289703,1711084108,11,4651,422.8181818,1361289676001,1361289676321,1711057109,1711057429,320
1361289703,1711084116,11,4651,422.8181818,1361289676443,1361289676763,1711057559,1711057879,320
1361289901,1711282068,3,189,63,1361289897798,1361289900806,1711278866,1711281874,3008
1361289901,1711282068,2,126,63,1361289897925,1361289898949,1711278993,1711280017,1024
1361289901,1711282072,2,126,63,1361289898242,1361289899202,1711279314,1711280274,960
1361289909,1711290100,2,126,63,1361289900904,1361289904936,1711282004,1711286036,4032
1361289909,1711290120,2,126,63,1361289901201,1361289905233,1711282321,1711286353,4032
1361289917,1711298072,2,126,63,1361289904835,1361289912899,1711285907,1711293971,8064
1361289940,1711320700,1,63,63,1361289913717,1361289913717,1711294417,1711294417,0
1361289940,1711320780,1,63,63,1361289913318,1361289913318,1711294098,1711294098,0
1361289950,1711330168,2,126,63,1361289947977,1361289949001,1711328145,1711329169,1024
1361289958,1711338152,2,126,63,1361289951001,1361289955033,1711331153,1711335185,4032
1361289988,1711369052,1,63,63,1361289962197,1361289962197,1711343249,1711343249,0
1361291384,1712765068,11,4651,422.8181818,1361291356272,1361291356592,1712737340,1712737660,320
1361291384,1712765112,9,861,95.66666667,1361291357378,1361291357570,1712738490,1712738682,192
1361291385,1712765152,11,4651,422.8181818,1361291357635,1361291357955,1712737787,1712738107,320
1361291385,1712765180,9,861,95.66666667,1361291357992,1361291358184,1712738172,1712738364,192
1361291590,1712971108,2,126,63,1361291587718,1361291588742,1712968826,1712969850,1024
1361291591,1712971144,4,252,63,1361291582087,1361291589127,1712962231,1712969271,7040
1361291598,1712979140,4,252,63,1361291590499,1361291597539,1712971639,1712978679,7040
1361291599,1712979144,2,126,63,1361291591752,1361291595784,1712971896,1712975928,4032
1361291621,1713001744,1,63,63,1361291596593,1361291596593,1712977337,1712977337,0
1361291629,1713009724,1,63,63,1361291603202,1361291603202,1712983926,1712983926,0
1361291633,1713013796,1,63,63,1361291605949,1361291605949,1712986745,1712986745,0
1361291671,1713051156,3,189,63,1361291665338,1361291668346,1713045494,1713048502,3008
1361291687,1713067220,2,126,63,1361291672316,1361291680316,1713052536,1713060536,8000
1361291830,351523652,1,48,48,1361291800807,1361291800807,351494459,351494459,0
1361292032,1713412256,1,48,48,1361292004115,1361292004115,1713384371,1713384371,0
1361292240,1713620160,2,92,46,1361292238829,1361292238829,1713618989,1713618989,0
1361292240,1713620164,2,92,46,1361292238825,1361292238825,1713618989,1713618989,0
1361292255,1713636112,14,4789,342.0714286,1361292246454,1361292253494,1713627566,1713634606,7040
1361292255,1713636128,2,92,46,1361292248744,1361292248808,1713629872,1713629936,64
1361292256,1713636160,13,1045,80.38461538,1361292247854,1361292254830,1713628014,1713634990,6976
1361292264,1713644168,14,1428,102,1361292248168,1361292262312,1713628336,1713642480,14144
1361292272,1713652152,2,92,46,1361292264373,1361292268405,1713644525,1713648557,4032
1361292275,1713655484,8,815,101.875,1361292249387,1361292249643,1713629871,1713630127,256
1361292303,1713683492,1,46,46,1361292276067,1361292276067,1713656559,1713656559,0
1361292351,1713731532,9,861,95.66666667,1361292326329,1361292326457,1713706861,1713706989,128
1361292351,1713731612,11,4651,422.8181818,1361292325800,1361292326120,1713706412,1713706732,320
1361292351,1713731616,9,861,95.66666667,1361292326499,1361292326691,1713707115,1713707307,192
1361292355,1713735460,8,815,101.875,1361292326912,1361292327104,1713707372,1713707564,192
1361292528,1713908312,3,189,63,1361292524240,1361292527248,1713904552,1713907560,3008
1361292544,1713924336,2,126,63,1361292531258,1361292539322,1713911594,1713919658,8064
1361292552,1713932388,3,189,63,1361292547016,1361292550088,1713927404,1713930476,3072
1361292552,1713932388,3,189,63,1361292547013,1361292550021,1713927401,1713930409,3008
1361292560,1713940372,3,189,63,1361292556056,1361292559064,1713936428,1713939436,3008
1361292568,1713948372,2,126,63,1361292554133,1361292562133,1713934505,1713942505,8000
1361292568,1713948372,2,126,63,1361292554069,1361292562133,1713934441,1713942505,8064
1361292576,1713956452,2,126,63,1361292563013,1361292571077,1713943465,1713951529,8064
1361292584,1713964392,4,252,63,1361292575872,1361292582912,1713956264,1713963304,7040
1361292615,1713995804,1,63,63,1361292590566,1361292590566,1713971370,1713971370,0
1361293009,1714389200,12,999,83.25,1361292994682,1361293004922,1714374882,1714385122,10240
1361293009,1714389204,11,953,86.63636364,1361292995000,1361293004920,1714375204,1714385124,9920
1361293009,1714389272,12,999,83.25,1361292995188,1361293004852,1714375460,1714385124,9664
1361294007,1715387328,1,448,448,1361293981803,1361293981803,1715362131,1715362131,0
1361294802,1716182484,44,56779,1290.431818,1361294800963,1361294801283,1716181447,1716181767,320
1361294818,1716198528,16,6372,398.25,1361294801943,1361294810455,1716182471,1716190983,8512
1361294818,1716198536,12,999,83.25,1361294802321,1361294810449,1716182857,1716190985,8128
1361294818,1716198544,11,953,86.63636364,1361294802888,1361294810440,1716183432,1716190984,7552
1361294818,1716198612,12,999,83.25,1361294802565,1361294810373,1716183177,1716190985,7808
1361294828,1716208980,1,60,60,1361294800469,1361294800469,1716181449,1716181449,0
1361295074,1716454672,12,999,83.25,1361295060547,1361295071747,1716441219,1716452419,11200
1361295074,1716454716,12,999,83.25,1361295059990,1361295071702,1716440706,1716452418,11712
1361295074,1716454768,16,6372,398.25,1361295059556,1361295071652,1716440324,1716452420,12096
1361295074,1716454792,11,953,86.63636364,1361295060173,1361295071629,1716440965,1716452421,11456
1361295546,1716926368,1,60,60,1361295520174,1361295520174,1716900542,1716900542,0
1361295943,1717323468,1,71,71,1361295915842,1361295915842,1717296310,1717296310,0
1361295967,1717347612,14,6617,472.6428571,1361295942388,1361295942708,1717323000,1717323320,320
1361295971,1717351436,9,861,95.66666667,1361295942946,1361295943138,1717323382,1717323574,192
1361295971,1717351568,8,815,101.875,1361295943134,1361295943262,1717323702,1717323830,128
1361295971,1717351572,9,861,95.66666667,1361295943387,1361295943579,1717323959,1717324151,192
1361295979,1717359424,2,120,60,1361295950956,1361295953964,1717331380,1717334388,3008
1361296228,1717608588,3,189,63,1361296221127,1361296224135,1717601715,1717604723,3008
1361296228,1717608588,3,189,63,1361296221190,1361296224198,1717601778,1717604786,3008
1361296244,1717624552,2,126,63,1361296228202,1361296236266,1717608754,1717616818,8064
1361296244,1717624608,2,126,63,1361296228209,1361296236209,1717608817,1717616817,8000
1361296252,1717632788,2,126,63,1361296249660,1361296250684,1717630448,1717631472,1024
1361296260,1717640656,2,126,63,1361296252865,1361296256833,1717633521,1717637489,3968
1361296292,1717672588,1,63,63,1361296264966,1361296264966,1717645554,1717645554,0
1361296316,1717696684,3,189,63,1361296308774,1361296311846,1717689458,1717692530,3072
1361296332,1717712596,2,126,63,1361296315965,1361296323965,1717696561,1717704561,8000
1361296853,1718234088,9,861,95.66666667,1361296828808,1361296829000,1718209896,1718210088,192
1361296858,1718238132,9,861,95.66666667,1361296830019,1361296830211,1718210151,1718210343,192
1361296858,1718238136,8,815,101.875,1361296830272,1361296830464,1718210408,1718210600,192
1361297020,1718400996,3,189,63,1361297015330,1361297018338,1718396326,1718399334,3008
1361297036,1718416988,4,218,54.5,1361297022378,1361297030762,1718403366,1718411750,8384
1361297036,1718416992,3,138,46,1361297030760,1361297030888,1718411752,1718411880,128
1361297036,1718416992,3,138,46,1361297030759,1361297030823,1718411751,1718411815,64
1361297058,1718438676,14,6617,472.6428571,1361297031904,1361297032160,1718412580,1718412836,256
1361297058,1718438764,9,861,95.66666667,1361297032459,1361297032587,1718413223,1718413351,128
1361297058,1718438764,9,861,95.66666667,1361297032202,1361297032330,1718412966,1718413094,128
1361297058,1718438772,8,815,101.875,1361297032704,1361297032896,1718413476,1718413668,192
1361297108,1718489024,3,138,46,1361297106373,1361297106437,1718487397,1718487461,64
1361297108,1718489096,3,138,46,1361297106299,1361297106363,1718487395,1718487459,64
1361297108,1718489096,3,138,46,1361297106299,1361297106363,1718487395,1718487459,64
1361297108,1718489096,3,138,46,1361297106300,1361297106364,1718487396,1718487460,64
1361297124,1718505028,11,953,86.63636364,1361297108290,1361297119554,1718489318,1718500582,11264
1361297124,1718505032,11,953,86.63636364,1361297108605,1361297119485,1718489637,1718500517,10880
1361297124,1718505068,11,953,86.63636364,1361297107735,1361297119511,1718488803,1718500579,11776
1361297124,1718505080,11,953,86.63636364,1361297107981,1361297119501,1718489061,1718500581,11520
1361297279,1718659484,1,46,46,1361297252254,1361297252254,1718632738,1718632738,0
1361297425,1718805948,1,46,46,1361297397005,1361297397005,1718777953,1718777953,0
1361297576,1718956124,2,122,61,1361297549763,1361297552003,1718929887,1718932127,2240
1361298245,1719625692,12,999,83.25,1361298226942,1361298237886,1719607634,1719618578,10944
1361298245,1719625696,12,999,83.25,1361298227452,1361298237820,1719608148,1719618516,10368
1361298245,1719625744,15,6289,419.2666667,1361298226443,1361298237835,1719607187,1719618579,11392
1361298245,1719625772,11,953,86.63636364,1361298227120,1361298237744,1719607892,1719618516,10624
1361298779,1720159900,1,48,48,1361298751208,1361298751208,1720132108,1720132108,0
1361299096,1720476836,1,46,46,1361299067172,1361299067172,1720448008,1720448008,0
1361299142,1720523008,16,6372,398.25,1361299129333,1361299141429,1720510341,1720522437,12096
1361299142,1720523012,12,999,83.25,1361299129970,1361299141426,1720510982,1720522438,11456
1361299142,1720523092,12,999,83.25,1361299129634,1361299141346,1720510726,1720522438,11712
1361299142,1720523096,11,953,86.63636364,1361299130207,1361299141343,1720511303,1720522439,11136
1361299159,1720539444,11,3267,297,1361299130986,1361299131690,1720511430,1720512134,704
1361299439,1720819376,2,141,70.5,1361299434986,1361299434986,1720815362,1720815362,0
1361299455,1720835288,12,999,83.25,1361299438208,1361299449600,1720818496,1720829888,11392
1361299455,1720835292,12,999,83.25,1361299438462,1361299449598,1720818754,1720829890,11136
1361299455,1720835360,17,6755,397.3529412,1361299437433,1361299449529,1720817793,1720829889,12096
1361299455,1720835364,12,999,83.25,1361299437875,1361299449523,1720818239,1720829887,11648
1361299460,1720840500,11,3267,297,1361299434348,1361299434988,1720814848,1720815488,640
1361299695,1721075564,3,193,64.33333333,1361299694056,1361299694056,1721074620,1721074620,0
1361300150,1721530304,2,122,61,1361300123236,1361300125540,1721503540,1721505844,2304
1361300170,1721550428,1,60,60,1361300143019,1361300143019,1721523447,1721523447,0
1361301268,1722648980,12,6151,512.5833333,1361301242226,1361301242546,1722623206,1722623526,320
1361301268,1722648984,9,861,95.66666667,1361301242604,1361301242796,1722623588,1722623780,192
1361301268,1722649056,14,6749,482.0714286,1361301241701,1361301242021,1722622757,1722623077,320
1361301268,1722649096,9,861,95.66666667,1361301242747,1361301242939,1722623843,1722624035,192
1361301268,1722649100,9,861,95.66666667,1361301243000,1361301243192,1722624100,1722624292,192
1361301472,1722852808,4,252,63,1361301464409,1361301471449,1722845217,1722852257,7040
1361301505,1722885764,1,63,63,1361301479556,1361301479556,1722860320,1722860320,0
1361301560,1722940980,2,126,63,1361301557998,1361301558958,1722938978,1722939938,960
1361301568,1722948892,2,126,63,1361301561093,1361301565125,1722941985,1722946017,4032
1361301576,1722956976,2,126,63,1361301573296,1361301574320,1722954272,1722955296,1024
1361301584,1722964904,2,126,63,1361301576378,1361301580410,1722957282,1722961314,4032
1361301584,1722964940,3,189,63,1361301579413,1361301582421,1722960353,1722963361,3008
1361301600,1722980920,2,126,63,1361301586473,1361301594537,1722967393,1722975457,8064
1361301601,1722981772,1,63,63,1361301573306,1361301573306,1722954078,1722954078,0
1361301613,1722993780,1,63,63,1361301588595,1361301588595,1722969375,1722969375,0
1361301656,1723036952,2,126,63,1361301653575,1361301654599,1723034527,1723035551,1024
1361301664,1723045028,2,126,63,1361301656571,1361301660603,1723037599,1723041631,4032
1361301697,1723077764,1,63,63,1361301668867,1361301668867,1723049631,1723049631,0
1361302369,1723749388,12,999,83.25,1361302352561,1361302362545,1723732949,1723742933,9984
1361302369,1723749424,11,953,86.63636364,1361302352973,1361302362509,1723733397,1723742933,9536
1361302369,1723749440,12,999,83.25,1361302352190,1361302362494,1723732630,1723742934,10304
1361302385,1723765348,40,52090,1302.25,1361302383320,1361302384472,1723763668,1723764820,1152
1361302393,1723773352,16,12573,785.8125,1361302375317,1361302387285,1723755669,1723767637,11968
1361302393,1723773400,5,2831,566.2,1361302390757,1361302391269,1723771157,1723771669,512
1361302393,1723773432,7,2448,349.7142857,1361302385349,1361302385477,1723765781,1723765909,128
1361302393,1723773440,9,3113,345.8888889,1361302378491,1361302387195,1723758931,1723767635,8704
1361302395,1723775452,5,2831,566.2,1361302390961,1361302391217,1723771413,1723771669,256
1361302401,1723781364,9,10331,1147.888889,1361302388999,1361302395463,1723769363,1723775827,6464
1361302401,1723781388,4,356,89,1361302386415,1361302395375,1723766803,1723775763,8960
1361302401,1723781424,42,52475,1249.404762,1361302385162,1361302395338,1723765586,1723775762,10176
1361302401,1723781424,111,158185,1425.09009,1361302385226,1361302395274,1723765650,1723775698,10048
1361302401,1723781440,8,6468,808.5,1361302388924,1361302395388,1723769364,1723775828,6464
1361302409,1723789352,9,3013,334.7777778,1361302391314,1361302403986,1723771666,1723784338,12672
1361302409,1723789368,8,5515,689.375,1361302388867,1361302401539,1723769235,1723781907,12672
1361302409,1723789368,31,38458,1240.580645,1361302388866,1361302401602,1723769234,1723781970,12736
1361302409,1723789372,40,51744,1293.6,1361302388862,1361302401534,1723769234,1723781906,12672
1361302409,1723789388,9,7895,877.2222222,1361302389230,1361302401582,1723769618,1723781970,12352
1361302409,1723789392,186,271303,1458.61828,1361302389037,1361302401581,1723769429,1723781973,12544
1361302409,1723789392,7,5426,775.1428571,1361302389483,1361302401515,1723769875,1723781907,12032
1361302409,1723789392,11,11231,1021,1361302389290,1361302401450,1723769682,1723781842,12160
1361302409,1723789392,49,67846,1384.612245,1361302389354,1361302401450,1723769746,1723781842,12096
1361302409,1723789400,4,549,137.25,1361302390564,1361302401444,1723770964,1723781844,10880
1361302409,1723789404,9,3013,334.7777778,1361302391263,1361302403935,1723771667,1723784339,12672
1361302409,1723789436,52,65583,1261.211538,1361302388543,1361302401599,1723768979,1723782035,13056
1361302409,1723789440,30,38111,1270.366667,1361302388796,1361302401532,1723769236,1723781972,12736
1361302409,1723789440,33,43180,1308.484848,1361302388859,1361302401531,1723769299,1723781971,12672
1361302409,1723789440,5,707,141.4,1361302402107,1361302403259,1723782547,1723783699,1152
1361302409,1723789444,7,5672,810.2857143,1361302389241,1361302401465,1723769685,1723781909,12224
1361302409,1723789444,7,4194,599.1428571,1361302389241,1361302401465,1723769685,1723781909,12224
1361302409,1723789444,15,15837,1055.8,1361302389240,1361302401272,1723769684,1723781716,12032
1361302409,1723789444,22,26117,1187.136364,1361302389240,1361302401464,1723769684,1723781908,12224
1361302409,1723789556,6,4204,700.6666667,1361302390409,1361302401353,1723770965,1723781909,10944
1361302415,1723795644,1,60,60,1361302389297,1361302389297,1723769941,1723769941,0
1361302417,1723797368,4,379,94.75,1361302415234,1361302415298,1723795602,1723795666,64
1361302417,1723797372,10,5882,588.2,1361302403393,1361302413313,1723783765,1723793685,9920
1361302417,1723797372,11,5935,539.5454545,1361302403392,1361302413312,1723783764,1723793684,9920
1361302417,1723797408,5,789,157.8,1361302402077,1361302413213,1723782485,1723793621,11136
1361302417,1723797408,4,869,217.25,1361302402075,1361302413211,1723782483,1723793619,11136
1361302417,1723797408,11,11028,1002.545455,1361302402139,1361302413211,1723782547,1723793619,11072
1361302417,1723797412,8,7057,882.125,1361302402264,1361302413208,1723782676,1723793620,10944
1361302417,1723797412,4,513,128.25,1361302402328,1361302413208,1723782740,1723793620,10880
1361302417,1723797444,16,12593,787.0625,1361302403256,1361302413240,1723783700,1723793684,9984
1361302417,1723797444,21,8144,387.8095238,1361302403384,1361302413304,1723783828,1723793748,9920
1361302417,1723797456,4,377,94.25,1361302412141,1361302412205,1723792597,1723792661,64
1361302417,1723797460,5,2395,479,1361302402023,1361302413159,1723782483,1723793619,11136
1361302417,1723797488,36,44688,1241.333333,1361302402253,1361302414349,1723782741,1723794837,12096
1361302421,362114960,10,10354,1035.4,1361302403192,1361302413176,362097152,362107136,9984
1361302421,362114964,30,39675,1322.5,1361302404277,1361302413173,362098241,362107137,8896
1361302425,1723805392,20,14579,728.95,1361302404331,1361302419307,1723784723,1723799699,14976
1361302425,1723805420,39,51658,1324.564103,1361302402319,1361302419279,1723782739,1723799699,16960
1361302425,1723805436,15,3459,230.6,1361302403327,1361302419327,1723783763,1723799763,16000
1361302425,1723805460,30,32101,1070.033333,1361302404262,1361302419238,1723784722,1723799698,14976
1361302425,1723805464,5,707,141.4,1361302418018,1361302418274,1723798482,1723798738,256
1361302427,1723807552,1,52,52,1361302402058,1361302402058,1723782610,1723782610,0
1361302427,1723807556,1,60,60,1361302402246,1361302402246,1723782802,1723782802,0
1361302429,362122960,99,133244,1345.89899,1361302411769,1361302425209,362105729,362119169,13440
1361302429,362122960,14,5394,385.2857143,1361302411833,1361302425209,362105793,362119169,13376
1361302429,362122960,34,37793,1111.558824,1361302411768,1361302425208,362105728,362119168,13440
1361302429,362122960,9,3369,374.3333333,1361302411832,1361302425208,362105792,362119168,13376
1361302429,362122964,10,10354,1035.4,1361302413429,1361302425269,362107393,362119233,11840
1361302429,362122984,28,27924,997.2857143,1361302411747,1361302425187,362105731,362119171,13440
1361302429,362122984,8,2325,290.625,1361302411874,1361302425122,362105858,362119106,13248
1361302431,1723811808,18,15077,837.6111111,1361302402827,1361302424843,1723783635,1723805651,22016
1361302433,1723813380,6,3211,535.1666667,1361302415224,1361302425272,1723795604,1723805652,10048
1361302433,1723813384,10,4253,425.3,1361302415539,1361302425331,1723795923,1723805715,9792
1361302433,1723813384,14,5209,372.0714286,1361302415602,1361302425330,1723795986,1723805714,9728
1361302433,1723813392,4,399,99.75,1361302417900,1361302425388,1723798292,1723805780,7488
1361302433,1723813416,11,5936,539.6363636,1361302421395,1361302431315,1723801811,1723811731,9920
1361302433,1723813416,21,8143,387.7619048,1361302421394,1361302431250,1723801810,1723811666,9856
1361302433,1723813420,10,4730,473,1361302413584,1361302425296,1723794004,1723805716,11712
1361302433,1723813420,4,621,155.25,1361302413518,1361302425230,1723793938,1723805650,11712
1361302433,1723813452,18,16567,920.3888889,1361302415469,1361302425261,1723795921,1723805713,9792
1361302433,1723813452,9,4217,468.5555556,1361302415469,1361302425261,1723795921,1723805713,9792
1361302433,1723813456,4,682,170.5,1361302417389,1361302425261,1723797845,1723805717,7872
1361302433,1723813456,11,4833,439.3636364,1361302415533,1361302425261,1723795989,1723805717,9728
1361302433,1723813456,5,707,141.4,1361302425323,1361302425707,1723805779,1723806163,384
1361302433,1723813456,11,4206,382.3636364,1361302415658,1361302425194,1723796114,1723805650,9536
1361302433,1723813500,11,5936,539.6363636,1361302421311,1361302431231,1723801811,1723811731,9920
1361302433,1723813504,4,669,167.25,1361302413436,1361302425212,1723793940,1723805716,11776
1361302439,1723819876,1,60,60,1361302413190,1361302413190,1723794066,1723794066,0
1361302449,1723829536,5,707,141.4,1361302447132,1361302447324,1723827668,1723827860,192
1361302457,1723837384,5,707,141.4,1361302455413,1361302455669,1723835797,1723836053,256
1361302465,1723845412,12,1662,138.5,1361302452951,1361302464855,1723833363,1723845267,11904
1361302465,1723845452,4,681,170.25,1361302446832,1361302458800,1723827284,1723839252,11968
1361302491,1723871968,1,52,52,1361302464362,1361302464362,1723845330,1723845330,0
1361302720,1724100340,1,46,46,1361302692953,1361302692953,1724073293,1724073293,0
1361304132,1725512816,1,46,46,1361304104362,1361304104362,1725485178,1725485178,0
1361304167,1725547580,2,104,52,1361304142614,1361304145750,1725523194,1725526330,3136
1361304183,1725563644,13,2393,184.0769231,1361304158164,1361304173524,1725538808,1725554168,15360
1361304183,1725563720,13,6197,476.6923077,1361304156936,1361304157704,1725537656,1725538424,768
1361304183,1725563748,9,861,95.66666667,1361304157739,1361304157931,1725538487,1725538679,192
1361304215,1725595660,1,383,383,1361304189573,1361304189573,1725570233,1725570233,0
1361304247,1725627768,1,383,383,1361304221656,1361304221656,1725602424,1725602424,0
1361304311,1725691840,1,383,383,1361304285839,1361304285839,1725666679,1725666679,0
1361304475,1725855336,3,189,63,1361304468675,1361304471747,1725849011,1725852083,3072
1361304475,1725855376,2,126,63,1361304473307,1361304474331,1725853683,1725854707,1024
1361304483,1725863416,2,126,63,1361304476275,1361304480307,1725856691,1725860723,4032
1361304491,1725871428,2,126,63,1361304475688,1361304483688,1725856116,1725864116,8000
1361304507,1725887384,17,6755,397.3529412,1361304489493,1361304501589,1725869877,1725881973,12096
1361304507,1725887384,12,999,83.25,1361304489877,1361304501589,1725870261,1725881973,11712
1361304507,1725887384,11,953,86.63636364,1361304490451,1361304501587,1725870835,1725881971,11136
1361304507,1725887384,12,999,83.25,1361304490195,1361304501587,1725870579,1725881971,11392
1361304516,1725896496,1,63,63,1361304488290,1361304488290,1725868786,1725868786,0
1361304548,1725928616,9,861,95.66666667,1361304522731,1361304522859,1725903347,1725903475,128
1361304548,1725928620,9,861,95.66666667,1361304522983,1361304523175,1725903603,1725903795,192
1361304548,1725928624,8,815,101.875,1361304523236,1361304523364,1725903860,1725903988,128
1361304548,1725928700,9,861,95.66666667,1361304522328,1361304522520,1725903028,1725903220,192
1361304747,1726127632,4,252,63,1361304739222,1361304746326,1726119854,1726126958,7104
1361304781,1726161232,1,63,63,1361304754727,1361304754727,1726134959,1726134959,0
1361304787,1726167696,3,189,63,1361304783385,1361304786393,1726164081,1726167089,3008
1361304803,1726183692,2,126,63,1361304790429,1361304798429,1726171121,1726179121,8000
1361304835,1726215628,2,126,63,1361304833308,1361304834332,1726213936,1726214960,1024
1361304835,1726215628,4,252,63,1361304827484,1361304834524,1726208112,1726215152,7040
1361304843,1726223748,2,126,63,1361304836194,1361304840226,1726216942,1726220974,4032
1361304869,1726249576,1,63,63,1361304842639,1361304842639,1726223215,1726223215,0
1361304873,1726253568,1,63,63,1361304848468,1361304848468,1726229036,1726229036,0
1361306340,1727721080,8,815,101.875,1361306314174,1361306314366,1727695254,1727695446,192
1361306341,1727721272,8,815,101.875,1361306314729,1361306314921,1727695001,1727695193,192
1361306341,1727721276,9,861,95.66666667,1361306315298,1361306315426,1727695574,1727695702,128
1361306573,1727953528,3,189,63,1361306566370,1361306569378,1727946898,1727949906,3008
1361306573,1727953628,3,189,63,1361306566271,1361306569279,1727946899,1727949907,3008
1361306589,1727969508,2,126,63,1361306573433,1361306581497,1727953941,1727962005,8064
1361306589,1727969636,3,189,63,1361306583799,1361306586807,1727964435,1727967443,3008
1361306601,1727981932,9,861,95.66666667,1361306573966,1361306574158,1727954898,1727955090,192
1361306601,1727981960,9,861,95.66666667,1361306574706,1361306574898,1727955666,1727955858,192
1361306601,1727982000,1,63,63,1361306572938,1361306572938,1727953938,1727953938,0
1361306601,1727982036,9,861,95.66666667,1361306574121,1361306574313,1727955157,1727955349,192
1361306601,1727982036,8,815,101.875,1361306574376,1361306574568,1727955412,1727955604,192
1361306605,1727985632,2,126,63,1361306590842,1361306598906,1727971474,1727979538,8064
1361306797,1728177924,2,126,63,1361306795348,1361306796372,1728176272,1728177296,1024
1361306805,1728185784,4,252,63,1361306797792,1361306804832,1728178576,1728185616,7040
1361306805,1728185792,2,126,63,1361306798489,1361306802521,1728179281,1728183313,4032
1361306829,1728209928,3,189,63,1361306824080,1361306827088,1728205008,1728208016,3008
1361306838,1728218548,1,63,63,1361306810827,1361306810827,1728191375,1728191375,0
1361306838,1728218784,1,63,63,1361306812896,1361306812896,1728193680,1728193680,0
1361306845,1728225956,2,126,63,1361306831091,1361306839155,1728212047,1728220111,8064
1361306853,1728233916,4,252,63,1361306845021,1361306852061,1728225937,1728232977,7040
1361306886,1728266484,1,63,63,1361306860554,1361306860554,1728241038,1728241038,0
1361307826,1729206864,1,48,48,1361307797888,1361307797888,1729178752,1729178752,0
1361307902,1729282784,12,999,83.25,1361307886031,1361307895247,1729266815,1729276031,9216
1361307902,1729282920,12,999,83.25,1361307885386,1361307895114,1729266306,1729276034,9728
1361307902,1729282920,11,953,86.63636364,1361307885639,1361307895111,1729266559,1729276031,9472
1361307932,1729312392,1,46,46,1361307905943,1361307905943,1729286335,1729286335,0
1361308374,1729755024,17,6755,397.3529412,1361308360408,1361308371096,1729741432,1729752120,10688
1361308374,1729755028,12,999,83.25,1361308360788,1361308371092,1729741816,1729752120,10304
1361308375,1729755112,11,953,86.63636364,1361308362023,1361308372007,1729742135,1729752119,9984
1361308414,1729795024,11,953,86.63636364,1361308396698,1361308408794,1729777722,1729789818,12096
1361308414,1729795028,11,953,86.63636364,1361308397012,1361308408788,1729778040,1729789816,11776
1361308415,1729795108,11,953,86.63636364,1361308398187,1361308409707,1729778295,1729789815,11520
1361308415,1729795112,12,999,83.25,1361308398441,1361308409705,1729778553,1729789817,11264
1361309569,1730949144,1,60,60,1361309541750,1361309541750,1730921894,1730921894,0
1361309786,1731166316,12,999,83.25,1361309770438,1361309779910,1731150754,1731160226,9472
1361309786,1731166320,11,953,86.63636364,1361309770692,1361309779908,1731151012,1731160228,9216
1361309786,1731166396,16,6372,398.25,1361309769718,1361309779830,1731150114,1731160226,10112
1361309786,1731166400,12,999,83.25,1361309770099,1361309779827,1731150499,1731160227,9728
1361309805,1731185936,2,152,76,1361309777948,1361309792988,1731158884,1731173924,15040
1361309833,1731213900,1,60,60,1361309805565,1361309805565,1731186465,1731186465,0
1361309833,1731213988,2,152,76,1361309807975,1361309823079,1731188963,1731204067,15104
1361309865,1731246076,1,76,76,1361309838029,1361309838029,1731219105,1731219105,0
1361310234,1731615012,17,6418,377.5294118,1361310215497,1361310226633,1731596509,1731607645,11136
1361310234,1731615016,12,999,83.25,1361310215876,1361310226628,1731596892,1731607644,10752
1361310234,1731615020,11,953,86.63636364,1361310216193,1361310226561,1731597213,1731607581,10368
1361310234,1731615020,12,999,83.25,1361310216448,1361310226560,1731597468,1731607580,10112
1361310242,1731622404,2,152,76,1361310217575,1361310232615,1731597979,1731613019,15040
1361310274,1731654480,2,152,76,1361310247580,1361310262620,1731628060,1731643100,15040
1361310302,1731682816,1,76,76,1361310277325,1361310277325,1731658141,1731658141,0
1361310547,1731927652,16,6372,398.25,1361310529517,1361310541549,1731910169,1731922201,12032
1361310547,1731927652,12,999,83.25,1361310529900,1361310541548,1731910552,1731922200,11648
1361310547,1731927676,12,999,83.25,1361310530388,1361310541524,1731911064,1731922200,11136
1361310547,1731927756,12,999,83.25,1361310530050,1361310541442,1731910806,1731922198,11392
1361310559,1731939604,2,152,76,1361310533403,1361310548443,1731914007,1731929047,15040
1361310591,1731971484,2,152,76,1361310563603,1361310578643,1731944087,1731959127,15040
1361310619,1731999568,1,76,76,1361310593599,1361310593599,1731974167,1731974167,0
1361310972,1732352808,17,6418,377.5294118,1361310957255,1361310968711,1732338063,1732349519,11456
1361310972,1732352808,12,999,83.25,1361310957640,1361310968712,1732338448,1732349520,11072
1361310972,1732352836,12,999,83.25,1361310958124,1361310968684,1732338960,1732349520,10560
1361310972,1732352908,12,999,83.25,1361310957797,1361310968613,1732338705,1732349521,10816
1361310984,1732364760,2,152,76,1361310959480,1361310974520,1732340240,1732355280,15040
1361311016,1732396576,2,152,76,1361310989745,1361311004785,1732370321,1732385361,15040
1361311044,1732424788,1,76,76,1361311019548,1361311019548,1732400336,1732400336,0
1361311429,1732809572,12,999,83.25,1361311412975,1361311424687,1732793547,1732805259,11712
1361311429,1732809576,11,953,86.63636364,1361311413292,1361311424684,1732793868,1732805260,11392
1361311429,1732809648,16,6372,398.25,1361311412514,1361311424610,1732793162,1732805258,12096
1361311429,1732809656,12,999,83.25,1361311413465,1361311424601,1732794121,1732805257,11136
1361311589,1732969804,1,48,48,1361311562628,1361311562628,1732943432,1732943432,0
1361312263,1733643180,3,144,48,1361312236329,1361312245417,1733616509,1733625597,9088
1361312326,1733707060,9,861,95.66666667,1361312299193,1361312299385,1733680253,1733680445,192
1361312327,1733707136,13,6234,479.5384615,1361312299412,1361312299732,1733679548,1733679868,320
1361312327,1733707164,9,861,95.66666667,1361312299767,1361312299959,1733679931,1733680123,192
1361312327,1733707172,8,815,101.875,1361312300337,1361312300529,1733680509,1733680701,192
1361312511,1733891960,2,126,63,1361312509400,1361312510424,1733890360,1733891384,1024
1361312519,1733900064,2,126,63,1361312512304,1361312516336,1733893368,1733897400,4032
1361312551,1733931972,1,63,63,1361312524493,1361312524493,1733905465,1733905465,0
1361312608,1733988204,4,252,63,1361312600139,1361312607243,1733980343,1733987447,7104
1361312608,1733988240,3,189,63,1361312601832,1361312604840,1733982072,1733985080,3008
1361312608,1733988288,4,252,63,1361312600119,1361312607159,1733980407,1733987447,7040
1361312624,1734004252,2,126,63,1361312608923,1361312616923,1733989175,1733997175,8000
1361312639,1734019992,1,63,63,1361312614521,1361312614521,1733995513,1733995513,0
1361312640,1734020152,1,63,63,1361312615360,1361312615360,1733995512,1733995512,0
1361314105,1735485220,12,999,83.25,1361314088996,1361314100452,1735469216,1735480672,11456
1361314105,1735485228,11,953,86.63636364,1361314089310,1361314100446,1735469538,1735480674,11136
1361314105,1735485260,17,6755,397.3529412,1361314088317,1361314100413,1735468577,1735480673,12096
1361314105,1735485264,12,999,83.25,1361314088697,1361314100409,1735468961,1735480673,11712
1361314201,1735581248,11,953,86.63636364,1361314183689,1361314194953,1735563937,1735575201,11264
1361314201,1735581296,12,999,83.25,1361314182870,1361314194966,1735563166,1735575262,12096
1361314201,1735581376,11,953,86.63636364,1361314183047,1361314194823,1735563423,1735575199,11776
1361314201,1735581376,11,953,86.63636364,1361314183302,1361314194822,1735563678,1735575198,11520
1361314224,1735604152,2,152,76,1361314198759,1361314213799,1735578911,1735593951,15040
1361314256,1735636072,2,152,76,1361314228920,1361314243960,1735608992,1735624032,15040
1361314283,1735663984,1,76,76,1361314258088,1361314258088,1735639072,1735639072,0
1361315081,1736461816,12,999,83.25,1361315069059,1361315079619,1736449875,1736460435,10560
1361315081,1736461816,12,999,83.25,1361315069378,1361315079618,1736450194,1736460434,10240
1361315081,1736461860,11,953,86.63636364,1361315068757,1361315079573,1736449617,1736460433,10816
1361315097,1736477108,2,152,76,1361315070791,1361315085831,1736450899,1736465939,15040
1361315125,1736505176,2,152,76,1361315100803,1361315115843,1736480979,1736496019,15040
1361315157,1736537372,1,76,76,1361315130687,1361315130687,1736511059,1736511059,0
1361315297,1736677904,1,48,48,1361315271848,1361315271848,1736652752,1736652752,0
1361315414,1736794096,1,46,46,1361315387532,1361315387532,1736767628,1736767628,0
1361315947,1737327864,1,46,46,1361315921156,1361315921156,1737302020,1737302020,0
1361316892,1738272112,17,6896,405.6470588,1361316876902,1361316885478,1738257014,1738265590,8576
1361316892,1738272148,16,6372,398.25,1361316877249,1361316885505,1738257397,1738265653,8256
1361316892,1738272148,11,953,86.63636364,1361316877633,1361316885505,1738257781,1738265653,7872
1361316892,1738272152,12,999,83.25,1361316877887,1361316885503,1738258039,1738265655,7616
1361316892,1738272156,12,999,83.25,1361316878205,1361316885501,1738258361,1738265657,7296
1361316901,1738281816,2,152,76,1361316875367,1361316890407,1738256183,1738271223,15040
1361316933,1738313920,2,152,76,1361316905342,1361316920382,1738286262,1738301302,15040
1361316961,1738341900,1,76,76,1361316935442,1361316935442,1738316342,1738316342,0
1361317529,1738909784,1,48,48,1361317501309,1361317501309,1738882093,1738882093,0
1361317804,1739184776,12,999,83.25,1361317789312,1361317799616,1739170088,1739180392,10304
1361317804,1739184848,17,6755,397.3529412,1361317788855,1361317799543,1739169703,1739180391,10688
1361317804,1739184856,12,999,83.25,1361317789490,1361317799538,1739170346,1739180394,10048
1361317815,1739195520,2,152,76,1361317790656,1361317805696,1739171176,1739186216,15040
1361317847,1739227592,2,152,76,1361317820665,1361317835705,1739201257,1739216297,15040
1361317875,1739255660,1,76,76,1361317850677,1361317850677,1739231337,1739231337,0
1361319575,1740955288,1,48,48,1361319547534,1361319547534,1740927822,1740927822,0
1361319582,1740962572,12,999,83.25,1361319569393,1361319577777,1740949965,1740958349,8384
1361319582,1740962684,15,6289,419.2666667,1361319567235,1361319577667,1740947919,1740958351,10432
1361319582,1740962684,21,15639,744.7142857,1361319567617,1361319580545,1740948301,1740961229,12928
1361319582,1740962716,16,6372,398.25,1361319568739,1361319577635,1740949455,1740958351,8896
1361319582,1740962720,11,953,86.63636364,1361319569501,1361319577565,1740950221,1740958285,8064
1361319594,1740974868,11,3267,297,1361319568456,1361319569224,1740949324,1740950092,768
1361319594,1740974872,2,152,76,1361319568196,1361319583236,1740949068,1740964108,15040
1361319626,1741006836,2,152,76,1361319598312,1361319613288,1740979148,1740994124,14976
1361319654,1741034884,2,152,76,1361319628279,1361319643383,1741009163,1741024267,15104
1361319687,1741067084,2,152,76,1361319659159,1361319674199,1741039243,1741054283,15040
1361319715,1741095184,2,152,76,1361319689204,1361319704244,1741069388,1741084428,15040
1361319747,1741127200,2,152,76,1361319719269,1361319734309,1741099469,1741114509,15040
1361319775,1741155272,2,152,76,1361319749273,1361319764313,1741129545,1741144585,15040
1361319807,1741187152,1,76,76,1361319779474,1361319779474,1741159626,1741159626,0
1361319942,1741322808,2,141,70.5,1361319941825,1361319941825,1741322633,1741322633,0
1361319967,1741347712,12,3356,279.6666667,1361319941409,1361319942305,1741322121,1741323017,896
1361320027,379720728,13,14250,1096.153846,1361320011605,1361320023637,379705333,379717365,12032
1361320027,379720736,7,4810,687.1428571,1361320011597,1361320023629,379705333,379717365,12032
1361320030,1741410932,18,8092,449.5555556,1361320011973,1361320022981,1741392905,1741403913,11008
1361320184,1741564428,3,152,50.66666667,1361320159607,1361320168695,1741540035,1741549123,9088
1361320223,1741603104,2,141,70.5,1361320219579,1361320219579,1741599683,1741599683,0
1361320248,1741628436,11,3267,297,1361320219886,1361320220398,1741600322,1741600834,512
1361320432,1741812708,1,46,46,1361320407003,1361320407003,1741787711,1741787711,0
1361320527,1741907492,2,141,70.5,1361320526133,1361320526133,1741906625,1741906625,0
1361320552,1741932992,11,3267,297,1361320525056,1361320525760,1741906048,1741906752,704
1361320847,1742227536,2,141,70.5,1361320845956,1361320845956,1742226492,1742226492,0
1361320873,1742253332,11,3267,297,1361320845644,1361320846220,1742225976,1742226552,576
1361321207,1742587708,2,141,70.5,1361321201936,1361321201936,1742582644,1742582644,0
1361321229,1742609904,11,3267,297,1361321201166,1361321201934,1742582070,1742582838,768
1361321391,1742771692,11,953,86.63636364,1361321375328,1361321385824,1742756020,1742766516,10496
1361321391,1742771700,11,953,86.63636364,1361321374550,1361321385814,1742755250,1742766514,11264
1361321391,1742771748,16,6372,398.25,1361321373734,1361321385766,1742754482,1742766514,12032
1361321391,1742771776,12,999,83.25,1361321374154,1361321385738,1742754930,1742766514,11584
1361321479,1742859764,12,999,83.25,1361321462549,1361321474261,1742843313,1742855025,11712
1361321479,1742859808,16,6372,398.25,1361321462889,1361321474217,1742843697,1742855025,11328
1361321479,1742859812,11,953,86.63636364,1361321462118,1361321474214,1742842930,1742855026,12096
1361321479,1742859828,12,999,83.25,1361321463317,1361321474197,1742844145,1742855025,10880
1361321511,1742891804,2,141,70.5,1361321505579,1361321505579,1742886383,1742886383,0
1361321530,1742910784,11,3267,297,1361321504895,1361321505791,1742885679,1742886575,896
1361321775,1743155904,2,141,70.5,1361321771972,1361321771972,1743152876,1743152876,0
1361321799,1743179576,11,3267,297,1361321771723,1361321772491,1743152299,1743153067,768
1361321935,1743316024,3,144,48,1361321908235,1361321917323,1743289259,1743298347,9088
1361322088,1743468556,2,141,70.5,1361322083804,1361322083804,1743464360,1743464360,0
1361322108,1743488828,11,3267,297,1361322082957,1361322083597,1743463785,1743464425,640
1361322376,1743756728,2,141,70.5,1361322368618,1361322368618,1743749346,1743749346,0
1361323281,1744661416,15,6289,419.2666667,1361323267476,1361323279572,1744647892,1744659988,12096
1361323281,1744661452,12,999,83.25,1361323268465,1361323279473,1744648917,1744659925,11008
1361323281,1744661524,11,953,86.63636364,1361323267818,1361323279466,1744648342,1744659990,11648
1361323281,1744661528,12,999,83.25,1361323268070,1361323279462,1744648598,1744659990,11392
1361323334,1744714748,2,152,76,1361323306313,1361323321353,1744687061,1744702101,15040
1361323362,1744742872,2,152,76,1361323336267,1361323351307,1744717139,1744732179,15040
1361323394,1744774712,1,76,76,1361323366510,1361323366510,1744747222,1744747222,0
1361324296,1745676876,1,56,56,1361324268860,1361324268860,1745649736,1745649736,0
1361324352,1745732920,1,46,46,1361324325579,1361324325579,1745706499,1745706499,0
1361324418,1745798704,15,6289,419.2666667,1361324398883,1361324410019,1745779587,1745790723,11136
1361324418,1745798736,11,953,86.63636364,1361324399557,1361324409989,1745780293,1745790725,10432
1361324418,1745798736,12,999,83.25,1361324399812,1361324409924,1745780548,1745790660,10112
1361324418,1745798812,12,999,83.25,1361324399161,1361324409913,1745779973,1745790725,10752
1361324429,1745809208,2,152,76,1361324401106,1361324416146,1745781314,1745796354,15040
1361324457,1745837264,2,152,76,1361324431130,1361324446170,1745811394,1745826434,15040
1361324489,1745869280,2,152,76,1361324461196,1361324476236,1745841476,1745856516,15040
1361324517,1745897420,2,152,76,1361324491136,1361324506176,1745871556,1745886596,15040
1361324540,384234000,5,574,114.8,1361324536096,1361324536160,384230096,384230160,64
1361324540,384234004,5,573,114.6,1361324536926,1361324536990,384230930,384230994,64
1361324540,384234012,102,147438,1445.470588,1361324536214,1361324536406,384230226,384230418,192
1361324540,384234012,15,17948,1196.533333,1361324537048,1361324537112,384231060,384231124,64
1361324540,384234024,5,573,114.6,1361324537227,1361324537291,384231251,384231315,64
1361324549,1745929340,2,152,76,1361324521294,1361324536334,1745901634,1745916674,15040
1361324556,384249996,399,591066,1481.368421,1361324538150,1361324550118,384232146,384244114,11968
1361324577,1745957476,2,152,76,1361324551239,1361324566279,1745931715,1745946755,15040
1361324609,1745989420,2,152,76,1361324581372,1361324596476,1745961792,1745976896,15104
1361324637,1746017476,1,76,76,1361324611395,1361324611395,1745991871,1745991871,0
1361326231,1747611884,9,861,95.66666667,1361326206740,1361326206932,1747587624,1747587816,192
1361326231,1747611968,12,6151,512.5833333,1361326206209,1361326206593,1747587177,1747587561,384
1361326235,1747615976,9,861,95.66666667,1361326206906,1361326207098,1747587882,1747588074,192
1361326235,1747616000,9,861,95.66666667,1361326207136,1361326207392,1747588136,1747588392,256
1361326468,1747848868,3,138,46,1361326463264,1361326463328,1747844132,1747844196,64
1361326468,1747848872,3,138,46,1361326463262,1361326463326,1747844134,1747844198,64
1361326484,1747864732,12,999,83.25,1361326466216,1361326477352,1747846948,1747858084,11136
1361326484,1747864776,16,6372,398.25,1361326465214,1361326477310,1747845990,1747858086,12096
1361326484,1747864808,12,999,83.25,1361326465821,1361326477277,1747846629,1747858085,11456
1361326484,1747864808,12,999,83.25,1361326465565,1361326477277,1747846373,1747858085,11712
1361326488,1747868592,2,109,54.5,1361326463604,1361326463604,1747844196,1747844196,0
1361326488,1747868592,2,109,54.5,1361326463604,1361326463604,1747844196,1747844196,0
1361327647,1749027216,8,815,101.875,1361327621212,1361327621404,1749001428,1749001620,192
1361327647,1749027216,9,861,95.66666667,1361327621467,1361327621659,1749001683,1749001875,192
1361327831,1749211984,3,189,63,1361327826584,1361327829656,1749207568,1749210640,3072
1361327848,1749228092,2,126,63,1361327834515,1361327842579,1749214607,1749222671,8064
1361327872,1749252088,4,252,63,1361327863062,1361327870102,1749243150,1749250190,7040
1361327899,1749279772,8,815,101.875,1361327871209,1361327871337,1749251981,1749252109,128
1361327899,1749279776,8,815,101.875,1361327871718,1361327871910,1749252494,1749252686,192
1361327899,1749279944,9,861,95.66666667,1361327870784,1361327870912,1749251728,1749251856,128
1361327899,1749279968,9,861,95.66666667,1361327871272,1361327871400,1749252240,1749252368,128
1361328104,1749484356,2,126,63,1361328101128,1361328102088,1749481484,1749482444,960
1361328112,1749492276,2,126,63,1361328104217,1361328108249,1749484493,1749488525,4032
1361328128,1749508320,3,138,46,1361328126893,1361328127021,1749507213,1749507341,128
1361328128,1749508348,5,264,52.8,1361328116176,1361328126992,1749496524,1749507340,10816
1361328144,1749524332,11,953,86.63636364,1361328126941,1361328139037,1749507273,1749519369,12096
1361328144,1749524332,11,953,86.63636364,1361328127199,1361328139039,1749507531,1749519371,11840
1361328144,1749524340,17,6755,397.3529412,1361328127767,1361328139031,1749508107,1749519371,11264
1361328144,1749524408,11,953,86.63636364,1361328127379,1361328138963,1749507787,1749519371,11584
1361328152,1749532072,2,109,54.5,1361328127203,1361328127203,1749507275,1749507275,0
1361328152,1749532072,2,109,54.5,1361328127201,1361328127201,1749507273,1749507273,0
1361328172,1749552068,2,152,76,1361328143909,1361328159013,1749523977,1749539081,15104
1361328200,1749580180,2,152,76,1361328173876,1361328188980,1749554056,1749569160,15104
1361328231,1749612012,1,76,76,1361328203190,1361328203190,1749584202,1749584202,0
1361329353,1750733996,12,999,83.25,1361329336627,1361329347699,1750717623,1750728695,11072
1361329354,1750734128,15,6289,419.2666667,1361329336471,1361329348567,1750716599,1750728695,12096
1361329354,1750734132,12,999,83.25,1361329336982,1361329348566,1750717114,1750728698,11584
1361329356,1750736776,11,953,86.63636364,1361329336594,1361329347922,1750717370,1750728698,11328
1361329365,1750745580,2,152,76,1361329337622,1361329352662,1750718202,1750733242,15040
1361329393,1750773680,2,152,76,1361329367599,1361329382639,1750748279,1750763319,15040
1361329410,1750790092,4,1064,266,1361329408956,1361329409084,1750789048,1750789176,128
1361329413,389107344,53,74043,1397.037736,1361329408364,1361329408620,389102708,389102964,256
1361329437,1750817788,2,152,76,1361329412612,1361329427652,1750793400,1750808440,15040
1361329469,1750849876,2,152,76,1361329442605,1361329457581,1750823481,1750838457,14976
1361329497,1750877904,2,152,76,1361329472656,1361329487696,1750853560,1750868600,15040
1361329529,1750909800,2,152,76,1361329502838,1361329517878,1750883638,1750898678,15040
1361329573,1750953892,1,76,76,1361329547866,1361329547866,1750928758,1750928758,0
1361331158,1752538088,12,999,83.25,1361331141860,1361331153444,1752521948,1752533532,11584
1361331158,1752538092,12,999,83.25,1361331142113,1361331153377,1752522205,1752533469,11264
1361331158,1752538176,12,999,83.25,1361331142286,1361331153294,1752522462,1752533470,11008
1361331158,1752538220,15,6289,419.2666667,1361331141219,1361331153315,1752521439,1752533535,12096
1361331326,1752706152,1,46,46,1361331298145,1361331298145,1752678297,1752678297,0
1361331579,1752959528,1,48,48,1361331552423,1361331552423,1752932951,1752932951,0
1361331932,1753312152,2,96,48,1361331906969,1361331909785,1753287121,1753289937,2816
1361332746,1754126312,2,96,48,1361332720303,1361332723311,1754100615,1754103623,3008
1361335227,1756607704,2,122,61,1361335201087,1361335203391,1756581791,1756584095,2304
1361337364,1758744568,1,60,60,1361337337573,1361337337573,1758718141,1758718141,0
1361337416,1758796660,5,250,50,1361337390345,1361337411465,1758771005,1758792125,21120
1361339637,1761017592,1,58,58,1361339612011,1361339612011,1760992603,1760992603,0
1361343056,1764436940,1,46,46,1361343029851,1361343029851,1764410791,1764410791,0
1361344057,1765437804,1,46,46,1361344032467,1361344032467,1765413271,1765413271,0
1361344058,1765438228,1,46,46,1361344032981,1361344032981,1765413209,1765413209,0
1361344294,1765674128,2,122,61,1361344268211,1361344270515,1765648339,1765650643,2304
1361347090,406784412,3,919,306.3333333,1361347090648,1361347090648,406785060,406785060,0
1361347094,1768474776,4,2481,620.25,1361347091524,1361347091716,1768472300,1768472492,192
1361347095,1768475604,8,1424,178,1361347094190,1361347094638,1768474794,1768475242,448
1361347095,1768475632,4,824,206,1361347091986,1361347092114,1768472618,1768472746,128
1361347098,406792272,4,971,242.75,1361347095334,1361347095782,406789606,406790054,448
1361347098,406792272,4,478,119.5,1361347091813,1361347091877,406786085,406786149,64
1361347103,1768483580,7,2326,332.2857143,1361347098119,1361347098247,1768478699,1768478827,128
1361347103,1768483580,9,1942,215.7777778,1361347098247,1361347098375,1768478827,1768478955,128
1361347103,1768483580,10,1994,199.4,1361347098374,1361347098502,1768478954,1768479082,128
1361347103,1768483580,7,2342,334.5714286,1361347098629,1361347098757,1768479209,1768479337,128
1361347103,1768483584,8,2922,365.25,1361347098753,1361347098817,1768479337,1768479401,64
1361347103,1768483584,8,1890,236.25,1361347098945,1361347099009,1768479529,1768479593,64
1361347103,1768483584,7,1838,262.5714286,1361347099011,1361347099139,1768479595,1768479723,128
1361347103,1768483584,8,2930,366.25,1361347096002,1361347096066,1768476586,1768476650,64
1361347103,1768483584,9,1942,215.7777778,1361347099458,1361347099586,1768480042,1768480170,128
1361347103,1768483584,8,2378,297.25,1361347096066,1361347096194,1768476650,1768476778,128
1361347103,1768483584,10,2738,273.8,1361347096193,1361347096321,1768476777,1768476905,128
1361347103,1768483588,10,2482,248.2,1361347096767,1361347096959,1768477355,1768477547,192
1361347103,1768483588,8,1890,236.25,1361347096959,1361347097023,1768477547,1768477611,64
1361347103,1768483588,10,1994,199.4,1361347097023,1361347097151,1768477611,1768477739,128
1361347103,1768483588,8,1890,236.25,1361347097150,1361347097278,1768477738,1768477866,128
1361347103,1768483588,7,1838,262.5714286,1361347097278,1361347097342,1768477866,1768477930,64
1361347103,1768483588,10,1994,199.4,1361347097341,1361347097533,1768477929,1768478121,192
1361347103,1768483588,10,2610,261,1361347097725,1361347097853,1768478313,1768478441,128
1361347103,1768483588,8,2386,298.25,1361347097597,1361347097725,1768478185,1768478313,128
1361347103,1768483592,8,2746,343.25,1361347098044,1361347098108,1768478636,1768478700,64
1361347103,1768483592,8,2021,252.625,1361347100476,1361347100540,1768481068,1768481132,64
1361347103,1768483592,10,1994,199.4,1361347097852,1361347098044,1768478444,1768478636,192
1361347103,1768483592,7,1401,200.1428571,1361347101626,1361347102330,1768482218,1768482922,704
1361347103,1768483596,10,4818,481.8,1361347098487,1361347098615,1768479083,1768479211,128
1361347103,1768483596,9,3246,360.6666667,1361347098806,1361347098934,1768479402,1768479530,128
1361347103,1768483596,10,3546,354.6,1361347099125,1361347099253,1768479721,1768479849,128
1361347103,1768483600,10,1994,199.4,1361347099252,1361347099444,1768479852,1768480044,192
1361347103,1768483612,10,1994,199.4,1361347096295,1361347096487,1768476907,1768477099,192
1361347103,1768483612,8,2698,337.25,1361347096485,1361347096549,1768477097,1768477161,64
1361347103,1768483616,8,2714,339.25,1361347096545,1361347096673,1768477161,1768477289,128
1361347103,1768483616,8,2386,298.25,1361347096672,1361347096736,1768477288,1768477352,64
1361347103,1768483616,7,1838,262.5714286,1361347097506,1361347097570,1768478122,1768478186,64
1361347103,1768483620,11,3405,309.5454545,1361347092829,1361347099805,1768473449,1768480425,6976
1361347106,406800264,4,478,119.5,1361347104620,1361347104620,406798884,406798884,0
1361347111,1768491584,6,1826,304.3333333,1361347099907,1361347103235,1768480491,1768483819,3328
1361347111,1768491588,8,1977,247.125,1361347102013,1361347103293,1768482601,1768483881,1280
1361347111,1768491620,12,3622,301.8333333,1361347100063,1361347103263,1768480683,1768483883,3200
1361347126,1768506824,1,108,108,1361347099796,1361347099796,1768480620,1768480620,0
1361347126,1768506824,1,108,108,1361347099923,1361347099923,1768480747,1768480747,0
1361347126,1768506892,1,108,108,1361347099790,1361347099790,1768480682,1768480682,0
1361347130,406824380,1,52,52,1361347102969,1361347102969,406797349,406797349,0
1361347215,1768595096,1,46,46,1361347190567,1361347190567,1768570663,1768570663,0
1361347655,1769035704,1,46,46,1361347628227,1361347628227,1769008931,1769008931,0
1361348116,1769496208,1,46,46,1361348089706,1361348089706,1769469914,1769469914,0
1361348157,1769537520,1,46,46,1361348128307,1361348128307,1769508827,1769508827,0
1361348158,1769538768,1,46,46,1361348128059,1361348128059,1769508827,1769508827,0
1361348204,1769584476,1,46,46,1361348177310,1361348177310,1769557786,1769557786,0
1361349222,1770602216,1,46,46,1361349194193,1361349194193,1770574409,1770574409,0
1361349294,1770674200,3,144,48,1361349269602,1361349278562,1770649802,1770658762,8960
1361349438,1770818340,1,46,46,1361349411795,1361349411795,1770792135,1770792135,0
1361349706,1771086800,2,122,61,1361349677953,1361349678273,1771058753,1771059073,320
1361349763,1771142948,2,122,61,1361349737622,1361349738006,1771117570,1771117954,384
1361350091,1771471564,1,46,46,1361350065831,1361350065831,1771446395,1771446395,0
1361350625,1772005192,1,46,46,1361350599444,1361350599444,1771979636,1771979636,0
1361350827,1772207064,44,56507,1284.25,1361350826514,1361350826770,1772206578,1772206834,256
1361350857,1772237400,2,152,76,1361350831040,1361350846016,1772211440,1772226416,14976
1361350881,1772261352,1,56,56,1361350855986,1361350855986,1772236338,1772236338,0
1361350889,1772269348,2,152,76,1361350861110,1361350876150,1772241458,1772256498,15040
1361350897,1772277356,1,404,404,1361350872299,1361350872299,1772252655,1772252655,0
1361350917,1772297464,2,152,76,1361350891072,1361350906176,1772271536,1772286640,15104
1361350949,1772329496,2,152,76,1361350921183,1361350936223,1772301679,1772316719,15040
1361350977,1772357520,2,152,76,1361350951175,1361350966215,1772331695,1772346735,15040
1361351009,1772389548,2,152,76,1361350981226,1361350996266,1772361774,1772376814,15040
1361351019,1772399204,11,953,86.63636364,1361351007043,1361351018435,1772387247,1772398639,11392
1361351019,1772399212,15,6289,419.2666667,1361351006393,1361351018425,1772386605,1772398637,12032
1361351019,1772399216,12,999,83.25,1361351006776,1361351018424,1772386992,1772398640,11648
1361351019,1772399232,11,953,86.63636364,1361351007269,1361351018405,1772387501,1772398637,11136
1361351033,1772413576,1,46,46,1361351006096,1361351006096,1772386672,1772386672,0
1361351037,1772417600,2,152,76,1361351011254,1361351026294,1772391854,1772406894,15040
1361351069,1772449624,1,76,76,1361351041308,1361351041308,1772421932,1772421932,0
1361351081,1772461704,2,152,76,1361351056271,1361351071247,1772436975,1772451951,14976
1361351113,1772493768,2,152,76,1361351086222,1361351101262,1772466990,1772482030,15040
1361351141,1772521872,1,76,76,1361351116197,1361351116197,1772497069,1772497069,0
1361352059,1773439884,7,1969,281.2857143,1361352053065,1361352053385,1773433949,1773434269,320
1361352067,1773447880,14,9975,712.5,1361352063630,1361352064590,1773444510,1773445470,960
1361352067,1773447892,8,3305,413.125,1361352060867,1361352061443,1773441759,1773442335,576
1361352075,1773455888,13,3884,298.7692308,1361352065096,1361352068936,1773445984,1773449824,3840
1361352075,1773455888,31,42071,1357.129032,1361352070151,1361352070663,1773451039,1773451551,512
1361352075,1773455892,51,70793,1388.098039,1361352070788,1361352071236,1773451680,1773452128,448
1361352075,1773455892,11,10745,976.8181818,1361352071235,1361352071491,1773452127,1773452383,256
1361352075,1773455892,82,118632,1446.731707,1361352071554,1361352072770,1773452446,1773453662,1216
1361352075,1773455896,41,56415,1375.97561,1361352069055,1361352069567,1773449951,1773450463,512
1361352075,1773455916,7,1513,216.1428571,1361352070187,1361352070635,1773451103,1773451551,448
1361352076,411769628,4,971,242.75,1361352060363,1361352075467,411753991,411769095,15104
1361352079,1773459668,1,108,108,1361352052834,1361352052834,1773433502,1773433502,0
1361352079,1773459708,1,108,108,1361352052731,1361352052731,1773433439,1773433439,0
1361352079,1773459708,1,108,108,1361352052858,1361352052858,1773433566,1773433566,0
1361352083,1773463864,10,3261,326.1,1361352063326,1361352078686,1773444190,1773459550,15360
1361352091,1773471740,16,5419,338.6875,1361352065499,1361352067483,1773446239,1773448223,1984
1361352091,1773471864,7,1925,275,1361352069661,1361352085085,1773450525,1773465949,15424
1361352091,1773471876,4,724,181,1361352070036,1361352085076,1773450912,1773465952,15040
1361352096,1773476000,26,5812,223.5384615,1361352070078,1361352093310,1773450078,1773473310,23232
1361352096,1773476044,17,3576,210.3529412,1361352070484,1361352092500,1773450528,1773472544,22016
1361352107,1773487916,4,479,119.75,1361352104489,1361352104681,1773485405,1773485597,192
1361352107,1773487928,14,10396,742.5714286,1361352101469,1361352101917,1773482397,1773482845,448
1361352108,1773487952,4,479,119.75,1361352107055,1361352107247,1773487007,1773487199,192
1361352116,1773495944,8,2378,297.25,1361352114229,1361352114677,1773494173,1773494621,448
1361352116,1773495948,24,15364,640.1666667,1361352102960,1361352108464,1773482908,1773488412,5504
1361352116,1773495948,40,46104,1152.6,1361352104049,1361352108849,1773483997,1773488797,4800
1361352116,411809608,160,231266,1445.4125,1361352107293,1361352108701,411800901,411802309,1408
1361352116,411809612,155,225130,1452.451613,1361352107289,1361352108697,411800901,411802309,1408
1361352119,1773499732,1,46,46,1361352094180,1361352094180,1773474912,1773474912,0
1361352123,1773503940,7,2326,332.2857143,1361352117649,1361352118033,1773498589,1773498973,384
1361352135,1773515740,3,158,52.66666667,1361352107548,1361352113308,1773488288,1773494048,5760
1361352139,1773519924,840,1150172,1369.252381,1361352120545,1361352133729,1773501469,1773514653,13184
1361352155,1773535924,8,3286,410.75,1361352148191,1361352148703,1773529115,1773529627,512
1361352172,1773551968,4,479,119.75,1361352151775,1361352166943,1773531743,1773546911,15168
1361352172,1773551980,7,3990,570,1361352153233,1361352171473,1773533213,1773551453,18240
1361352172,411865608,295,437507,1483.074576,1361352154784,1361352171744,411848392,411865352,16960
1361352172,411865612,120,171217,1426.808333,1361352154844,1361352171356,411848456,411864968,16512
1361352172,411865612,121,175481,1450.256198,1361352154844,1361352171356,411848456,411864968,16512
1361352172,411865612,244,352193,1443.413934,1361352154779,1361352171867,411848391,411865479,17088
1361352172,411865612,217,313031,1442.539171,1361352154779,1361352171419,411848391,411865031,16640
1361352175,1773555788,2,112,56,1361352148329,1361352153257,1773529117,1773534045,4928
1361352179,1773559784,37,25920,700.5405405,1361352151406,1361352165294,1773532190,1773546078,13888
1361352179,1773559784,40,39006,975.15,1361352151406,1361352161326,1773532190,1773542110,9920
1361352179,1773559784,19,16825,885.5263158,1361352151661,1361352160813,1773532445,1773541597,9152
1361352179,1773559784,12,9721,810.0833333,1361352151661,1361352160493,1773532445,1773541277,8832
1361352179,1773559784,24,22199,924.9583333,1361352151661,1361352160813,1773532445,1773541597,9152
1361352179,1773559832,16,13736,858.5,1361352151613,1361352160829,1773532445,1773541661,9216
1361352180,411873608,260,379107,1458.103846,1361352154783,1361352173535,411848391,411867143,18752
1361352187,1773567796,14,14672,1048,1361352160608,1361352165344,1773541404,1773546140,4736
1361352187,1773567796,14,12338,881.2857143,1361352160607,1361352165343,1773541403,1773546139,4736
1361352187,1773567832,8,5770,721.25,1361352159805,1361352160509,1773540637,1773541341,704
1361352187,1773567836,17,18117,1065.705882,1361352161080,1361352165368,1773541916,1773546204,4288
1361352187,1773567836,11,8038,730.7272727,1361352161080,1361352165304,1773541916,1773546140,4224
1361352188,1773568000,9,3415,379.4444444,1361352185404,1361352186172,1773565404,1773566172,768
1361352188,411881616,5,544,108.8,1361352186776,1361352187096,411880392,411880712,320
1361352188,411881616,82,115636,1410.195122,1361352187160,1361352187416,411880776,411881032,256
1361352188,411881616,90,129336,1437.066667,1361352183639,1361352184215,411877255,411877831,576
1361352188,411881616,5,538,107.6,1361352187926,1361352187926,411881542,411881542,0
1361352191,1773571780,18,23175,1287.5,1361352165490,1361352166066,1773546270,1773546846,576
1361352191,1773571816,8,6890,861.25,1361352164814,1361352165326,1773545630,1773546142,512
1361352191,1773571816,5,3948,789.6,1361352164813,1361352164877,1773545629,1773545693,64
1361352193,411887464,74,106532,1439.621622,1361352187209,1361352189001,411881673,411883465,1792
1361352196,411889616,4,481,120.25,1361352190168,1361352190168,411883784,411883784,0
1361352196,411889616,83,118668,1429.73494,1361352195478,1361352195734,411889094,411889350,256
1361352196,411889620,4,481,120.25,1361352188116,1361352188116,411881736,411881736,0
1361352197,411891444,1,52,52,1361352171164,1361352171164,411865608,411865608,0
1361352197,411891444,1,52,52,1361352171162,1361352171162,411865606,411865606,0
1361352197,411891460,1,52,52,1361352171149,1361352171149,411865609,411865609,0
1361352204,1773583988,9,3415,379.4444444,1361352195975,1361352196743,1773575963,1773576731,768
1361352204,411897652,5,538,107.6,1361352198259,1361352198259,411891911,411891911,0
1361352204,411897652,4,481,120.25,1361352198387,1361352198387,411892039,411892039,0
1361352204,411897656,5,544,108.8,1361352197104,1361352197360,411890760,411891016,256
1361352204,411897656,77,106688,1385.558442,1361352197424,1361352197680,411891080,411891336,256
1361352204,411897656,4,481,120.25,1361352200432,1361352200432,411894088,411894088,0
1361352204,411897656,77,111032,1441.974026,1361352198382,1361352200174,411892038,411893830,1792
1361352207,1773587884,1,52,52,1361352182472,1361352182472,1773563356,1773563356,0
1361352207,1773587884,8,1806,225.75,1361352182535,1361352202631,1773563419,1773583515,20096
1361352212,1773592000,4,233,58.25,1361352209918,1361352210686,1773589918,1773590686,768
1361352212,411905672,91,133305,1464.89011,1361352208545,1361352208737,411902217,411902409,192
1361352215,1773595836,2,112,56,1361352188984,1361352193272,1773569820,1773574108,4288
1361352217,411911440,145,208734,1439.544828,1361352213024,1361352214240,411907464,411908680,1216
1361352220,411913660,84,118189,1407.011905,1361352209643,1361352212715,411903303,411906375,3072
1361352220,411913660,274,405572,1480.189781,1361352209643,1361352212715,411903303,411906375,3072
1361352220,411913660,306,451328,1474.928105,1361352213803,1361352215211,411907463,411908871,1408
1361352220,411913664,290,426809,1471.755172,1361352208551,1361352212711,411902215,411906375,4160
1361352220,411913664,488,723691,1482.973361,1361352209639,1361352212711,411903303,411906375,3072
1361352220,411913664,300,439787,1465.956667,1361352209638,1361352212710,411903302,411906374,3072
1361352231,1773611836,2,104,52,1361352205110,1361352208886,1773585946,1773589722,3776
1361352231,1773611836,2,104,52,1361352205110,1361352208886,1773585946,1773589722,3776
1361352233,411927444,73,106604,1460.328767,1361352207772,1361352208028,411902216,411902472,256
1361352233,411927444,23,30164,1311.478261,1361352207772,1361352208092,411902216,411902536,320
1361352233,411927468,23,30164,1311.478261,1361352207748,1361352208068,411902216,411902536,320
1361352235,1773615820,13,6370,490,1361352208903,1361352212423,1773589723,1773593243,3520
1361352235,1773615820,10,3226,322.6,1361352208902,1361352212294,1773589722,1773593114,3392
1361352235,1773615828,6,7015,1169.166667,1361352210880,1361352212032,1773591708,1773592860,1152
1361352235,1773615852,24,26844,1118.5,1361352207209,1361352233705,1773588061,1773614557,26496
1361352235,1773615852,11,12794,1163.090909,1361352207208,1361352212328,1773588060,1773593180,5120
1361352235,1773615856,44,11573,263.0227273,1361352207781,1361352224869,1773588637,1773605725,17088
1361352235,1773615860,11,3872,352,1361352208864,1361352212192,1773589724,1773593052,3328
1361352235,1773615868,6,7031,1171.833333,1361352210840,1361352211992,1773591708,1773592860,1152
1361352236,411929672,683,1009815,1478.499268,1361352209633,1361352231905,411903305,411925577,22272
1361352239,1773619852,4,5002,1250.5,1361352210921,1361352212073,1773591773,1773592925,1152
1361352239,1773619852,3,2184,728,1361352211048,1361352212328,1773591900,1773593180,1280
1361352241,411935448,52,70407,1353.980769,1361352213013,1361352214165,411907461,411908613,1152
1361352243,1773623852,67,93258,1391.910448,1361352216038,1361352225382,1773596890,1773606234,9344
1361352243,1773623896,7,9574,1367.714286,1361352215932,1361352215932,1773596828,1773596828,0
1361352243,1773623900,14,18055,1289.642857,1361352215994,1361352216250,1773596894,1773597150,256
1361352244,1773624052,9,3415,379.4444444,1361352237576,1361352238280,1773617628,1773618332,704
1361352244,1773624056,6,653,108.8333333,1361352239172,1361352239236,1773619228,1773619292,64
1361352244,411937668,84,121378,1444.97619,1361352237218,1361352237346,411930886,411931014,128
1361352251,1773631932,58,79702,1374.172414,1361352223894,1361352246486,1773604826,1773627418,22592
1361352255,1773635892,2,112,56,1361352229568,1361352233216,1773610460,1773614108,3648
1361352260,1773640052,438,562191,1283.541096,1361352121738,1361352253706,1773501790,1773633758,131968
1361352260,1773640052,551,747980,1357.495463,1361352121865,1361352253577,1773501917,1773633629,131712
1361352260,1773640064,600,804929,1341.548333,1361352121722,1361352253690,1773501786,1773633754,131968
1361352263,1773643880,11,10037,912.4545455,1361352234957,1361352245901,1773615837,1773626781,10944
1361352263,1773643924,99,144159,1456.151515,1361352238431,1361352238623,1773619355,1773619547,192
1361352267,1773647908,16,4622,288.875,1361352241903,1361352263343,1773622811,1773644251,21440
1361352271,1773651912,9,13023,1447,1361352245674,1361352245674,1773626586,1773626586,0
1361352276,1773656028,2,141,70.5,1361352275937,1361352275937,1773655965,1773655965,0
1361352276,1773656032,2,141,70.5,1361352272922,1361352272922,1773652954,1773652954,0
1361352276,1773656032,149,210412,1412.161074,1361352165979,1361352271899,1773546011,1773651931,105920
1361352276,1773656040,2,141,70.5,1361352272914,1361352272914,1773652954,1773652954,0
1361352276,1773656044,2,141,70.5,1361352273937,1361352273937,1773653981,1773653981,0
1361352288,1773667992,1,52,52,1361352260930,1361352260930,1773640922,1773640922,0
1361352288,1773668000,1,52,52,1361352261948,1361352261948,1773641948,1773641948,0
1361352288,1773668036,1,52,52,1361352260887,1361352260887,1773640923,1773640923,0
1361352288,1773668044,1,52,52,1361352261905,1361352261905,1773641949,1773641949,0
1361352292,1773671972,1,52,52,1361352264984,1361352264984,1773644956,1773644956,0
1361352292,1773672072,2,141,70.5,1361352285877,1361352285877,1773665949,1773665949,0
1361352296,1773675980,2,112,56,1361352271182,1361352274126,1773651162,1773654106,2944
1361352300,1773679980,1,52,52,1361352271952,1361352271952,1773651932,1773651932,0
1361352316,1773696140,2,141,70.5,1361352312816,1361352312816,1773692956,1773692956,0
1361352336,1773716140,2,112,56,1361352311726,1361352313966,1773691866,1773694106,2240
1361352344,1773724068,1,52,52,1361352316855,1361352316855,1773696923,1773696923,0
1361352349,1773729232,1,46,46,1361352321874,1361352321874,1773702106,1773702106,0
1361352350,1773730244,1,46,46,1361352321863,1361352321863,1773702107,1773702107,0
1361352350,1773730796,118,171511,1453.483051,1361352224223,1361352344927,1773605019,1773725723,120704
1361352350,1773730796,232,342661,1476.987069,1361352224415,1361352344607,1773605211,1773725403,120192
1361352350,1773730804,154,225684,1465.480519,1361352224213,1361352344341,1773605017,1773725145,120128
1361352356,1773736892,7,2326,332.2857143,1361352348285,1361352348605,1773729177,1773729497,320
1361352356,1773736908,1477,2064305,1397.633717,1361352149038,1361352354414,1773529946,1773735322,205376
1361352360,1773740124,1,60,60,1361352335167,1361352335167,1773715291,1773715291,0
1361352360,1773740124,1,60,60,1361352335166,1361352335166,1773715290,1773715290,0
1361352372,1773752900,2,92,46,1361352366196,1361352366260,1773747096,1773747160,64
1361352376,1773756168,2,104,52,1361352351763,1361352353043,1773731931,1773733211,1280
1361352378,412071704,1,46,46,1361352353026,1361352353026,412046730,412046730,0
1361352380,1773760100,3,158,52.66666667,1361352352471,1361352357079,1773732571,1773737179,4608
1361352380,1773760100,1,46,46,1361352353046,1361352353046,1773733146,1773733146,0
1361352380,1773760100,1,52,52,1361352353109,1361352353109,1773733209,1773733209,0
1361352380,1773760100,1,52,52,1361352353109,1361352353109,1773733209,1773733209,0
1361352380,1773760100,1,52,52,1361352353109,1361352353109,1773733209,1773733209,0
1361352380,1773760104,1,46,46,1361352353044,1361352353044,1773733148,1773733148,0
1361352380,1773760104,1,52,52,1361352353107,1361352353107,1773733211,1773733211,0
1361352380,1773760104,1,52,52,1361352353107,1361352353107,1773733211,1773733211,0
1361352380,1773760104,1,52,52,1361352353107,1361352353107,1773733211,1773733211,0
1361352380,1773760104,1,52,52,1361352353107,1361352353107,1773733211,1773733211,0
1361352380,1773760104,1,52,52,1361352353107,1361352353107,1773733211,1773733211,0
1361352380,1773760136,1,46,46,1361352353008,1361352353008,1773733144,1773733144,0
1361352380,1773760136,1,46,46,1361352353008,1361352353008,1773733144,1773733144,0
1361352380,1773760140,1,46,46,1361352353008,1361352353008,1773733148,1773733148,0
1361352380,1773760140,1,52,52,1361352353072,1361352353072,1773733212,1773733212,0
1361352380,1773760140,1,52,52,1361352353072,1361352353072,1773733212,1773733212,0
1361352380,1773760140,1,46,46,1361352353007,1361352353007,1773733147,1773733147,0
1361352380,1773760140,1,52,52,1361352353070,1361352353070,1773733210,1773733210,0
1361352380,1773760140,1,52,52,1361352353070,1361352353070,1773733210,1773733210,0
1361352380,1773760140,1,52,52,1361352353070,1361352353070,1773733210,1773733210,0
1361352380,1773760140,1,52,52,1361352353070,1361352353070,1773733210,1773733210,0
1361352388,1773768904,8,1505,188.125,1361352366323,1361352382771,1773747227,1773763675,16448
1361352392,1773772124,1,46,46,1361352367039,1361352367039,1773747163,1773747163,0
1361352392,1773772160,1,46,46,1361352367000,1361352367000,1773747160,1773747160,0
1361352392,1773772164,1,46,46,1361352366999,1361352366999,1773747163,1773747163,0
1361352420,1773800192,2,112,56,1361352393016,1361352396984,1773773208,1773777176,3968
1361352460,1773840288,2,112,56,1361352433626,1361352436890,1773813914,1773817178,3264
1361352500,1773880360,2,112,56,1361352474258,1361352476818,1773854618,1773857178,2560
1361352516,412209688,145,209069,1441.855172,1361352213776,1361352214992,411907464,411908680,1216
1361352516,412209688,179,260777,1456.854749,1361352213776,1361352214992,411907464,411908680,1216
1361352540,1773920376,2,112,56,1361352514880,1361352516800,1773895256,1773897176,1920
1361352580,1773960404,2,112,56,1361352555556,1361352556772,1773935960,1773937176,1216
1361352624,1774004480,2,112,56,1361352596181,1361352596693,1773976661,1773977173,512
1361352664,1774044500,2,112,56,1361352636673,1361352636801,1774017173,1774017301,128
1361352704,1774084500,2,112,56,1361352676672,1361352677504,1774057172,1774058004,832
1361352744,1774124572,2,112,56,1361352716601,1361352718073,1774097173,1774098645,1472
1361352784,1774164592,2,112,56,1361352756578,1361352758754,1774137170,1774139346,2176
1361352824,1774204688,2,112,56,1361352796483,1361352799299,1774177171,1774179987,2816
1361352829,1774209212,12,999,83.25,1361352811424,1361352823072,1774191636,1774203284,11648
1361352829,1774209212,13,1045,80.38461538,1361352811936,1361352823456,1774192148,1774203668,11520
1361352829,1774209220,15,6289,419.2666667,1361352810968,1361352823064,1774191188,1774203284,12096
1361352829,1774209236,12,999,83.25,1361352811654,1361352823046,1774191890,1774203282,11392
1361352864,1774244756,2,112,56,1361352836414,1361352839934,1774217170,1774220690,3520
1361352904,1774284840,2,112,56,1361352876331,1361352880491,1774257171,1774261331,4160
1361352945,1774325092,2,112,56,1361352917078,1361352921942,1774297170,1774302034,4864
1361352985,1774365132,2,112,56,1361352957038,1361352962542,1774337170,1774342674,5504
1361353025,1774405224,2,112,56,1361352996946,1361353003154,1774377170,1774383378,6208
1361353065,1774445224,2,112,56,1361353036943,1361353043791,1774417167,1774424015,6848
1361353105,1774485204,2,112,56,1361353076962,1361353084514,1774457166,1774464718,7552
1361353145,1774525260,2,112,56,1361353116907,1361353125099,1774497167,1774505359,8192
1361353181,1774561444,2,112,56,1361353156723,1361353165555,1774537167,1774545999,8832
1361353221,1774601352,2,112,56,1361353196815,1361353206287,1774577167,1774586639,9472
1361353261,1774641392,2,112,56,1361353236772,1361353246884,1774617164,1774627276,10112
1361353301,1774681508,2,112,56,1361353276657,1361353287409,1774657165,1774667917,10752
1361353341,1774721528,2,112,56,1361353316636,1361353328028,1774697164,1774708556,11392
1361353381,1774761484,2,112,56,1361353356743,1361353368647,1774737227,1774749131,11904
1361353421,1774801536,2,112,56,1361353396691,1361353409235,1774777227,1774789771,12544
1361353461,1774841788,2,112,56,1361353436438,1361353449622,1774817226,1774830410,13184
1361353501,1774881820,2,112,56,1361353476406,1361353490230,1774857226,1774871050,13824
1361353542,1774921964,2,112,56,1361353517262,1361353531662,1774897226,1774911626,14400
1361353582,1774961984,2,112,56,1361353557238,1361353572214,1774937222,1774952198,14976
1361353622,1775002252,2,112,56,1361353596972,1361353612588,1774977224,1774992840,15616
1361353662,1775042316,2,112,56,1361353636906,1361353653226,1775017222,1775033542,16320
1361353702,1775082372,2,112,56,1361353676852,1361353693812,1775057224,1775074184,16960
1361353706,1775086312,1,46,46,1361353679726,1361353679726,1775060038,1775060038,0
1361353742,1775122492,2,112,56,1361353716730,1361353734330,1775097222,1775114822,17600
1361353782,1775162668,2,112,56,1361353756552,1361353774728,1775137220,1775155396,18176
1361353822,1775202696,2,112,56,1361353796526,1361353815342,1775177222,1775196038,18816
1361353862,1775242752,2,112,56,1361353836467,1361353855923,1775217219,1775236675,19456
1361353902,1775282816,2,112,56,1361353876402,1361353896498,1775257218,1775277314,20096
1361353943,1775323148,2,112,56,1361353917069,1361353937741,1775297217,1775317889,20672
1361353983,1775363144,2,112,56,1361353957073,1361353978385,1775337217,1775358529,21312
1361354023,1775403132,2,112,56,1361353997087,1361354018975,1775377219,1775399107,21888
1361354063,1775443252,2,112,56,1361354036964,1361354059492,1775417216,1775439744,22528
1361354103,1775483296,2,112,56,1361354076920,1361354100024,1775457216,1775480320,23104
1361354143,1775523448,2,112,56,1361354116768,1361354140448,1775497216,1775520896,23680
1361354183,1775563348,2,112,56,1361354156865,1361354181121,1775537213,1775561469,24256
1361354223,1775603456,2,112,56,1361354196756,1361354221524,1775577212,1775601980,24768
1361354263,1775643508,2,112,56,1361354236705,1361354262049,1775617213,1775642557,25344
1361354303,1775683564,2,112,56,1361354276649,1361354302569,1775657213,1775683133,25920
1361354343,1775723676,1,46,46,1361354316535,1361354316535,1775697211,1775697211,0
1361354371,1775751652,2,112,56,1361354343058,1361354356562,1775723710,1775737214,13504
1361354411,1775791776,2,112,56,1361354383506,1361354396434,1775764282,1775777210,12928
1361354451,1775831872,2,112,56,1361354424051,1361354436339,1775804923,1775817211,12288
1361354491,1775871892,2,112,56,1361354464668,1361354476316,1775845560,1775857208,11648
1361354531,1775911912,3,158,52.66666667,1361354505226,1361354527114,1775886138,1775908026,21888
1361354534,1775914884,8,1890,236.25,1361354527141,1361354527269,1775908025,1775908153,128
1361354556,414250172,6,3753,625.5,1361354540665,1361354555769,414234837,414249941,15104
1361354559,1775938976,8,1930,241.25,1361354542129,1361354557873,1775922105,1775937849,15744
1361354559,1775938988,4,724,181,1361354541925,1361354556965,1775921913,1775936953,15040
1361354568,1775948272,1,46,46,1361354541575,1361354541575,1775921847,1775921847,0
1361354572,1775951948,2,112,56,1361354546765,1361354568077,1775926713,1775948025,21312
1361354583,1775962988,11,6256,568.7272727,1361354568294,1361354575910,1775948282,1775955898,7616
1361354583,1775962996,4,725,181.25,1361354568028,1361354575836,1775948024,1775955832,7808
1361354585,414279004,1,52,52,1361354557345,1361354557345,414251349,414251349,0
1361354592,1775971960,1,52,52,1361354567808,1361354567808,1775947768,1775947768,0
1361354612,1775992004,2,112,56,1361354587283,1361354608083,1775967287,1775988087,20800
1361354631,1776011036,15,6289,419.2666667,1361354615794,1361354627890,1775995830,1776007926,12096
1361354631,1776011040,11,953,86.63636364,1361354616242,1361354627826,1775996282,1776007866,11584
1361354631,1776011040,12,999,83.25,1361354616497,1361354627825,1775996537,1776007865,11328
1361354631,1776011040,12,999,83.25,1361354616753,1361354627825,1775996793,1776007865,11072
1361354631,1776011044,4,724,181,1361354613677,1361354628653,1775993721,1776008697,14976
1361354631,1776011044,6,1349,224.8333333,1361354613868,1361354629356,1775993912,1776009400,15488
1361354652,1776032112,2,112,56,1361354627752,1361354648104,1776007864,1776028216,20352
1361354652,414346252,4,477,119.25,1361354649644,1361354649772,414343896,414344024,128
1361354652,414346252,14,13424,958.8571429,1361354649708,1361354649900,414343960,414344152,192
1361354652,414346252,8,4119,514.875,1361354636332,1361354646508,414330584,414340760,10176
1361354652,414346252,12,9671,805.9166667,1361354646508,1361354647148,414340760,414341400,640
1361354652,414346252,24,25185,1049.375,1361354647402,1361354647914,414341654,414342166,512
1361354652,414346252,11,10739,976.2727273,1361354648169,1361354648297,414342421,414342549,128
1361354652,414346252,18,17144,952.4444444,1361354648297,1361354648553,414342549,414342805,256
1361354652,414346252,91,122850,1350,1361354648297,1361354649577,414342549,414343829,1280
1361354652,414346252,12,11351,945.9166667,1361354651629,1361354651757,414345881,414346009,128
1361354652,414346256,7,3811,544.4285714,1361354649192,1361354649384,414343448,414343640,192
1361354652,414346256,8,4695,586.875,1361354649576,1361354649704,414343832,414343960,128
1361354652,414346256,64,86383,1349.734375,1361354649768,1361354650408,414344024,414344664,640
1361354652,414346256,36,40154,1115.388889,1361354649895,1361354650855,414344151,414345111,960
1361354652,414346256,4,477,119.25,1361354647079,1361354647207,414341335,414341463,128
1361354652,414346256,12,9687,807.25,1361354647143,1361354647399,414341399,414341655,256
1361354652,414346256,58,78554,1354.37931,1361354647206,1361354647718,414341462,414341974,512
1361354652,414346256,83,112233,1352.204819,1361354650854,1361354651622,414345110,414345878,768
1361354652,414346256,11,8387,762.4545455,1361354647910,1361354648166,414342166,414342422,256
1361354652,414346256,4,477,119.25,1361354648165,1361354648293,414342421,414342549,128
1361354652,414346256,4,478,119.5,1361354651749,1361354651813,414346005,414346069,64
1361354652,414346256,13,11435,879.6153846,1361354648553,1361354649193,414342809,414343449,640
1361354655,1776035072,7,2161,308.7142857,1361354637966,1361354653454,1776018038,1776033526,15488
1361354660,1776040112,1,46,46,1361354635560,1361354635560,1776015672,1776015672,0
1361354660,414354252,58,78692,1356.758621,1361354653293,1361354653613,414347545,414347865,320
1361354660,414354252,8,4407,550.875,1361354653613,1361354653933,414347865,414348185,320
1361354660,414354252,4,477,119.25,1361354653932,1361354653996,414348184,414348248,64
1361354660,414354252,54,70458,1304.777778,1361354653996,1361354654700,414348248,414348952,704
1361354660,414354252,4,477,119.25,1361354652587,1361354652715,414346839,414346967,128
1361354660,414354252,48,62076,1293.25,1361354655147,1361354655659,414349399,414349911,512
1361354660,414354252,7,4691,670.1428571,1361354652459,1361354652587,414346711,414346839,128
1361354660,414354252,4,477,119.25,1361354656106,1361354656298,414350358,414350550,192
1361354660,414354252,4,478,119.5,1361354655786,1361354655850,414350038,414350102,64
1361354660,414354252,16,14784,924,1361354656490,1361354656874,414350742,414351126,384
1361354660,414354252,59,80378,1362.338983,1361354651753,1361354652073,414346005,414346325,320
1361354660,414354256,8,3799,474.875,1361354653928,1361354654184,414348184,414348440,256
1361354660,414354256,15,12492,832.8,1361354654184,1361354654696,414348440,414348952,512
1361354660,414354256,41,55009,1341.682927,1361354654696,1361354655016,414348952,414349272,320
1361354660,414354256,16,11913,744.5625,1361354654696,1361354655144,414348952,414349400,448
1361354660,414354256,9,7307,811.8888889,1361354652328,1361354652456,414346584,414346712,128
1361354660,414354256,4,477,119.25,1361354655143,1361354655271,414349399,414349527,128
1361354660,414354256,71,97833,1377.929577,1361354652583,1361354653287,414346839,414347543,704
1361354660,414354256,11,8739,794.4545455,1361354652711,1361354652903,414346967,414347159,192
1361354660,414354256,70,88085,1258.357143,1361354655655,1361354656487,414349911,414350743,832
1361354660,414354256,18,17481,971.1666667,1361354651814,1361354652326,414346070,414346582,512
1361354668,414362252,71,85962,1210.732394,1361354656362,1361354661290,414350614,414355542,4928
1361354672,1776052144,2,152,76,1361354643977,1361354659017,1776024121,1776039161,15040
1361354672,1776052172,22,11515,523.4090909,1361354646121,1361354662569,1776026293,1776042741,16448
1361354684,414378256,56,78449,1400.875,1361354682216,1361354682984,414376472,414377240,768
1361354684,414378256,25,31115,1244.6,1361354683431,1361354683751,414377687,414378007,320
1361354684,414378260,137,190766,1392.452555,1361354661284,1361354682148,414355544,414376408,20864
1361354684,414378260,56,78449,1400.875,1361354682978,1361354683426,414377238,414377686,448
1361354687,1776067120,2,98,49,1361354677665,1361354682977,1776057785,1776063097,5312
1361354688,1776068144,1,46,46,1361354663750,1361354663750,1776043894,1776043894,0
1361354692,414386320,65,91277,1404.261538,1361354684137,1361354684777,414378457,414379097,640
1361354692,414386320,41,54787,1336.268293,1361354686312,1361354686632,414380632,414380952,320
1361354692,414386320,41,55008,1341.658537,1361354686631,1361354687079,414380951,414381399,448
1361354692,414386320,58,80325,1384.913793,1361354684775,1361354685351,414379095,414379671,576
1361354692,414386320,55,76897,1398.127273,1361354683687,1361354684135,414378007,414378455,448
1361354692,414386320,57,78639,1379.631579,1361354685350,1361354685798,414379670,414380118,448
1361354692,414386324,57,78639,1379.631579,1361354685797,1361354686309,414380121,414380633,512
1361354692,414386324,37,49718,1343.72973,1361354687076,1361354687396,414381400,414381720,320
1361354692,414386324,38,51270,1349.210526,1361354687396,1361354687716,414381720,414382040,320
1361354696,1776076164,2,112,56,1361354668211,1361354688115,1776048375,1776068279,19904
1361354700,1776080136,2,152,76,1361354674064,1361354689104,1776054200,1776069240,15040
1361354700,414394308,32,43626,1363.3125,1361354687733,1361354695861,414382041,414390169,8128
1361354732,1776112204,2,152,76,1361354704072,1361354719112,1776084276,1776099316,15040
1361354736,1776116184,2,112,56,1361354708829,1361354728093,1776089013,1776108277,19264
1361354760,1776140232,2,152,76,1361354734125,1361354749165,1776114357,1776129397,15040
1361354776,1776156212,2,112,56,1361354749314,1361354768066,1776129526,1776148278,18752
1361354792,1776172216,2,152,76,1361354764221,1361354779261,1776144437,1776159477,15040
1361354816,1776196296,2,112,56,1361354789803,1361354807979,1776170099,1776188275,18176
1361354820,1776200260,2,152,76,1361354794257,1361354809297,1776174517,1776189557,15040
1361354831,1776211180,8,1898,237.25,1361354829025,1361354829409,1776209205,1776209589,384
1361354852,1776232336,2,152,76,1361354824262,1361354839302,1776204598,1776219638,15040
1361354856,1776236328,2,112,56,1361354830350,1361354847950,1776210678,1776228278,17600
1361354880,1776260364,1,76,76,1361354854313,1361354854313,1776234677,1776234677,0
1361354896,1776276376,2,112,56,1361354870812,1361354887900,1776251188,1776268276,17088
1361354896,1776276388,2,152,76,1361354869330,1361354884370,1776249718,1776264758,15040
1361354924,1776304660,2,152,76,1361354899133,1361354914173,1776279793,1776294833,15040
1361354936,1776316640,2,112,56,1361354911060,1361354927636,1776291700,1776308276,16576
1361354956,1776336712,1,76,76,1361354929163,1361354929163,1776309875,1776309875,0
1361354976,1776356720,2,112,56,1361354951552,1361354967552,1776332272,1776348272,16000
1361355020,1776400800,2,112,56,1361354992113,1361355007473,1776372913,1776388273,15360
1361355060,1776440740,2,112,56,1361355032812,1361355047532,1776413552,1776428272,14720
1361355101,1776481160,2,112,56,1361355073971,1361355088115,1776454131,1776468275,14144
1361355141,1776521216,2,112,56,1361355114552,1361355128056,1776494768,1776508272,13504
1361355143,1776523344,8,1890,236.25,1361355138743,1361355138935,1776519087,1776519279,192
1361355181,1776561168,2,112,56,1361355155175,1361355168103,1776535343,1776548271,12928
1361355221,1776601240,2,112,56,1361355195743,1361355208031,1776575983,1776588271,12288
1361355261,1776641332,2,112,56,1361355236289,1361355247937,1776616621,1776628269,11648
1361355301,1776681416,2,112,56,1361355276782,1361355287854,1776657198,1776668270,11072
1361355345,1776725448,2,112,56,1361355317388,1361355327820,1776697836,1776708268,10432
1361355385,1776765592,2,112,56,1361355357821,1361355367677,1776738413,1776748269,9856
1361355425,1776805640,2,112,56,1361355398413,1361355407629,1776779053,1776788269,9216
1361355455,1776835700,10,1994,199.4,1361355448401,1361355448849,1776829101,1776829549,448
1361355465,1776845636,2,112,56,1361355438992,1361355447696,1776819628,1776828332,8704
1361355505,1776885684,2,112,56,1361355479648,1361355487584,1776860332,1776868268,7936
1361355545,1776925700,2,112,56,1361355520271,1361355527567,1776900971,1776908267,7296
1361355550,1776930436,1,46,46,1361355525015,1361355525015,1776905451,1776905451,0
1361355550,1776930900,1,46,46,1361355524552,1361355524552,1776905452,1776905452,0
1361355585,1776965872,2,112,56,1361355560739,1361355567395,1776941611,1776948267,6656
1361355629,1777009848,2,112,56,1361355601336,1361355607480,1776982184,1776988328,6144
1361355669,1777049904,2,112,56,1361355641918,1361355647422,1777022822,1777028326,5504
1361355710,1777089940,2,112,56,1361355683459,1361355688387,1777063399,1777068327,4928
1361355750,1777129964,2,112,56,1361355724076,1361355728364,1777104040,1777108328,4288
1361355760,1777139976,8,1890,236.25,1361355759133,1361355759261,1777139109,1777139237,128
1361355790,1777169972,2,112,56,1361355764640,1361355768352,1777144612,1777148324,3712
1361355830,1777210052,2,112,56,1361355805073,1361355808273,1777185125,1777188325,3200
1361355870,1777250104,2,112,56,1361355845662,1361355848222,1777225766,1777228326,2560
1361355914,1777294204,2,112,56,1361355886073,1361355888121,1777266277,1777268325,2048
1361355954,1777334188,2,112,56,1361355926727,1361355928135,1777306915,1777308323,1408
1361355994,1777374260,2,112,56,1361355967229,1361355968061,1777347489,1777348321,832
1361356024,1777404260,4,204,51,1361356007741,1361356023485,1777388001,1777403745,15744
1361356050,1777430388,1,46,46,1361356023292,1361356023292,1777403680,1777403680,0
1361356051,415745200,1,46,46,1361356023080,1361356023080,415717280,415717280,0
1361356448,1777828512,12,999,83.25,1361356433530,1361356445178,1777814042,1777825690,11648
1361356448,1777828512,12,999,83.25,1361356433790,1361356445182,1777814302,1777825694,11392
1361356448,1777828520,16,6372,398.25,1361356433141,1361356445173,1777813661,1777825693,12032
1361356448,1777828520,12,999,83.25,1361356434036,1361356445172,1777814556,1777825692,11136
1361356911,1778291612,1,46,46,1361356886415,1361356886415,1778267027,1778267027,0
1361356960,1778340704,1,46,46,1361356933812,1361356933812,1778314516,1778314516,0
1361356960,1778340708,1,46,46,1361356933809,1361356933809,1778314517,1778314517,0
1361356961,1778341452,1,46,46,1361356934127,1361356934127,1778314579,1778314579,0
1361357745,1779125164,2,96,48,1361357719430,1361357722438,1779099594,1779102602,3008
1361357837,1779217284,1,46,46,1361357811849,1361357811849,1779192133,1779192133,0
1361357925,1779305592,1,46,46,1361357898263,1361357898263,1779278855,1779278855,0
1361358058,1779438160,1,48,48,1361358033795,1361358033795,1779413955,1779413955,0
1361358062,1779442092,1,48,48,1361358034055,1361358034055,1779414147,1779414147,0
1361358062,1779442104,1,48,48,1361358034812,1361358034812,1779414916,1779414916,0
1361358062,1779442128,1,48,48,1361358035749,1361358035749,1779415877,1779415877,0
1361358062,1779442208,1,48,48,1361358034709,1361358034709,1779414917,1779414917,0
1361358062,1779442212,1,48,48,1361358034961,1361358034961,1779415173,1779415173,0
1361358190,1779570340,1,46,46,1361358162253,1361358162253,1779542593,1779542593,0
1361358210,1779590508,1,46,46,1361358182311,1361358182311,1779562819,1779562819,0
1361358254,1779634564,1,46,46,1361358228653,1361358228653,1779609217,1779609217,0
1361358257,1779637720,12,999,83.25,1361358239569,1361358250705,1779620289,1779631425,11136
1361358257,1779637728,14,4789,342.0714286,1361358238665,1361358250697,1779619393,1779631425,12032
1361358257,1779637728,12,999,83.25,1361358239112,1361358250696,1779619840,1779631424,11584
1361358257,1779637728,11,953,86.63636364,1361358239367,1361358250695,1779620095,1779631423,11328
1361358380,1779760312,1,48,48,1361358352550,1361358352550,1779732862,1779732862,0
1361358381,1779761436,1,48,48,1361358352427,1361358352427,1779732863,1779732863,0
1361358381,1779761440,1,48,48,1361358352425,1361358352425,1779732865,1779732865,0
1361358523,1779903376,1,46,46,1361358497763,1361358497763,1779878139,1779878139,0
1361358639,1780019552,2,96,48,1361358614579,1361358617459,1779995131,1779998011,2880
1361358764,1780144172,1,46,46,1361358738285,1361358738285,1780118457,1780118457,0
1361359104,1780484852,1,78,78,1361359079231,1361359079231,1780460083,1780460083,0
1361359169,1780549268,1,46,46,1361359143941,1361359143941,1780524209,1780524209,0
1361359439,1780819204,1,48,48,1361359412481,1361359412481,1780792685,1780792685,0
1361359439,1780819208,1,48,48,1361359412479,1361359412479,1780792687,1780792687,0
1361359440,1780820440,1,48,48,1361359412247,1361359412247,1780792687,1780792687,0
1361360211,1781591348,1,108,108,1361360208166,1361360208166,1781588514,1781588514,0
1361360211,1781591348,5,2106,421.2,1361360207910,1361360208422,1781588258,1781588770,512
1361360211,1781591348,1,108,108,1361360208102,1361360208102,1781588450,1781588450,0
1361360211,1781591348,2,216,108,1361360207974,1361360208102,1781588322,1781588450,128
1361360211,1781591348,3,2365,788.3333333,1361360208166,1361360208230,1781588514,1781588578,64
1361360211,1781591352,8,2004,250.5,1361360209251,1361360209443,1781589603,1781589795,192
1361360211,1781591364,5,772,154.4,1361360209240,1361360209624,1781589604,1781589988,384
1361360214,419907656,5,451,90.2,1361360210723,1361360211299,419904379,419904955,576
1361360214,419907656,4,1448,362,1361360211362,1361360211426,419905018,419905082,64
1361360219,1781599308,5,609,121.8,1361360215695,1361360216015,1781596003,1781596323,320
1361360219,1781599308,8,2018,252.25,1361360211663,1361360211855,1781591971,1781592163,192
1361360219,1781599308,4,724,181,1361360215758,1361360215822,1781596066,1781596130,64
1361360219,1781599312,10,3248,324.8,1361360213450,1361360214218,1781593762,1781594530,768
1361360219,1781599316,6,983,163.8333333,1361360214215,1361360214407,1781594531,1781594723,192
1361360219,1781599316,10,9936,993.6,1361360214663,1361360214727,1781594979,1781595043,64
1361360219,1781599316,7,1460,208.5714286,1361360214343,1361360214983,1781594659,1781595299,640
1361360219,1781599316,9,1913,212.5555556,1361360218566,1361360218694,1781598882,1781599010,128
1361360219,1781599316,9,1913,212.5555556,1361360215174,1361360215366,1781595490,1781595682,192
1361360219,1781599320,9,3544,393.7777778,1361360211649,1361360213185,1781591969,1781593505,1536
1361360219,1781599320,5,1257,251.4,1361360211268,1361360211332,1781591588,1781591652,64
1361360219,1781599324,10,1965,196.5,1361360217533,1361360217789,1781597857,1781598113,256
1361360219,1781599324,9,1913,212.5555556,1361360217536,1361360217792,1781597860,1781598116,256
1361360219,1781599324,9,3035,337.2222222,1361360214336,1361360214976,1781594660,1781595300,640
1361360219,1781599324,6,798,133,1361360214400,1361360214720,1781594724,1781595044,320
1361360219,1781599324,5,609,121.8,1361360218175,1361360218623,1781598499,1781598947,448
1361360222,419915656,5,451,90.2,1361360215204,1361360215332,419908860,419908988,128
1361360222,419915656,5,2109,421.8,1361360215268,1361360215332,419908924,419908988,64
1361360222,419915656,5,451,90.2,1361360218916,1361360219108,419912572,419912764,192
1361360222,419915656,5,451,90.2,1361360216290,1361360217698,419909946,419911354,1408
1361360222,419915656,5,451,90.2,1361360220386,1361360220578,419914042,419914234,192
1361360227,1781607332,9,1913,212.5555556,1361360218934,1361360219254,1781599266,1781599586,320
1361360227,1781607332,5,609,121.8,1361360219638,1361360220022,1781599970,1781600354,384
1361360227,1781607336,12,4735,394.5833333,1361360223988,1361360224628,1781604324,1781604964,640
1361360227,1781607336,13,8273,636.3846154,1361360220148,1361360220340,1781600484,1781600676,192
1361360227,1781607340,5,609,121.8,1361360221233,1361360221553,1781601573,1781601893,320
1361360227,1781607340,9,1913,212.5555556,1361360221935,1361360222127,1781602275,1781602467,192
1361360227,1781607340,9,1913,212.5555556,1361360221807,1361360222063,1781602147,1781602403,256
1361360227,1781607340,8,1785,223.125,1361360225583,1361360226671,1781605923,1781607011,1088
1361360227,1781607344,9,1913,212.5555556,1361360219178,1361360219626,1781599522,1781599970,448
1361360227,1781607348,10,3421,342.1,1361360220329,1361360220777,1781600677,1781601125,448
1361360227,1781607348,12,4967,413.9166667,1361360221158,1361360221286,1781601506,1781601634,128
1361360227,1781607352,5,609,121.8,1361360222500,1361360222948,1781602852,1781603300,448
1361360227,1781607352,12,4927,410.5833333,1361360223011,1361360223203,1781603363,1781603555,192
1361360230,419923656,5,451,90.2,1361360221986,1361360222114,419915642,419915770,128
1361360230,419923660,243,357769,1472.300412,1361360223328,1361360224352,419916988,419918012,1024
1361360235,1781615316,9,1913,212.5555556,1361360231173,1361360231877,1781611489,1781612193,704
1361360235,1781615320,2,92,46,1361360227075,1361360227075,1781607395,1781607395,0
1361360235,1781615320,9,2849,316.5555556,1361360232449,1361360232897,1781612769,1781613217,448
1361360235,1781615324,9,1913,212.5555556,1361360229311,1361360229823,1781609635,1781610147,512
1361360235,1781615324,9,3310,367.7777778,1361360233662,1361360234878,1781613986,1781615202,1216
1361360238,419931656,4,1448,362,1361360234405,1361360234469,419928061,419928125,64
1361360238,419931660,97,138765,1430.56701,1361360230304,1361360230880,419923964,419924540,576
1361360238,419931660,4,445,111.25,1361360234784,1361360234976,419928444,419928636,192
1361360243,1781623320,4,715,178.75,1361360237313,1361360237313,1781617633,1781617633,0
1361360243,1781623324,10,3050,305,1361360237503,1361360238271,1781617827,1781618595,768
1361360243,1781623336,14,7501,535.7857143,1361360238257,1361360239089,1781618593,1781619425,832
1361360243,1781623356,10,3397,339.7,1361360234846,1361360236062,1781615202,1781616418,1216
1361360244,1781624288,7,1877,268.1428571,1361360215971,1361360216675,1781596259,1781596963,704
1361360418,1781798144,1,46,46,1361360389870,1361360389870,1781770014,1781770014,0
1361360419,1781799320,1,46,46,1361360389697,1361360389697,1781770017,1781770017,0
1361360419,1781799320,1,46,46,1361360389631,1361360389631,1781769951,1781769951,0
1361360484,1781864828,2,152,76,1361360457474,1361360472514,1781838302,1781853342,15040
1361360512,1781892856,2,152,76,1361360487525,1361360502565,1781868381,1781883421,15040
1361360545,1781924948,1,76,76,1361360518515,1361360518515,1781898463,1781898463,0
1361361636,1783016000,1,48,48,1361361609261,1361361609261,1782989261,1782989261,0
1361361636,1783016004,1,48,48,1361361609258,1361361609258,1782989262,1782989262,0
1361361636,1783016008,1,48,48,1361361609255,1361361609255,1782989263,1782989263,0
1361361867,1783247704,2,152,76,1361361840874,1361361855914,1783221578,1783236618,15040
1361361876,1783256544,12,999,83.25,1361361858186,1361361869834,1783238730,1783250378,11648
1361361876,1783256544,12,999,83.25,1361361858442,1361361869834,1783238986,1783250378,11392
1361361876,1783256544,12,999,83.25,1361361858698,1361361870218,1783239242,1783250762,11520
1361361876,1783256552,15,6289,419.2666667,1361361857728,1361361869824,1783238280,1783250376,12096
1361361899,1783279736,2,152,76,1361361870920,1361361885960,1783251656,1783266696,15040
1361361927,1783307788,1,76,76,1361361900949,1361361900949,1783281737,1783281737,0
1361362040,1783420140,1,46,46,1361362013786,1361362013786,1783393926,1783393926,0
1361363112,1784491932,1,46,46,1361363086556,1361363086556,1784466488,1784466488,0
1361363112,1784492472,1,46,46,1361363086014,1361363086014,1784466486,1784466486,0
1361363112,1784492496,1,46,46,1361363085991,1361363085991,1784466487,1784466487,0
1361363543,1784923452,3,138,46,1361363517195,1361363526219,1784897647,1784906671,9024
1361363661,1785041800,17,6755,397.3529412,1361363645997,1361363655213,1785026797,1785036013,9216
1361363661,1785041804,12,999,83.25,1361363646380,1361363655212,1785027184,1785036016,8832
1361363675,1785055764,2,152,76,1361363646993,1361363662033,1785027757,1785042797,15040
1361363703,1785083744,2,152,76,1361363677092,1361363692132,1785057836,1785072876,15040
1361363735,1785115768,1,76,76,1361363707215,1361363707215,1785087983,1785087983,0
1361363767,1785147836,5,250,50,1361363739594,1361363761034,1785120430,1785141870,21440
1361363812,1785192140,1,48,48,1361363785793,1361363785793,1785165933,1785165933,0
1361363840,1785220200,1,48,48,1361363814725,1361363814725,1785194925,1785194925,0
1361363844,1785224276,2,120,60,1361363819513,1361363820473,1785199789,1785200749,960
1361363848,1785228188,2,120,60,1361363821585,1361363822545,1785201773,1785202733,960
1361364004,1785384516,1,46,46,1361363976133,1361363976133,1785356649,1785356649,0
1361364004,1785384564,1,46,46,1361363976147,1361363976147,1785356711,1785356711,0
1361364062,1785442128,17,6418,377.5294118,1361364048584,1361364060680,1785428712,1785440808,12096
1361364062,1785442128,12,999,83.25,1361364048967,1361364060679,1785429095,1785440807,11712
1361364062,1785442132,12,999,83.25,1361364049222,1361364060678,1785429354,1785440810,11456
1361364062,1785442140,12,999,83.25,1361364049467,1361364060603,1785429607,1785440743,11136
1361364080,1785460632,2,152,76,1361364052112,1361364067152,1785432744,1785447784,15040
1361364108,1785488656,2,152,76,1361364082167,1361364097207,1785462823,1785477863,15040
1361364141,1785521000,1,76,76,1361364112903,1361364112903,1785492903,1785492903,0
1361364662,1786042408,2,96,48,1361364636265,1361364639145,1786016673,1786019553,2880
1361364686,1786066340,1,60,60,1361364658922,1361364658922,1786039262,1786039262,0
1361364686,1786066352,1,60,60,1361364660449,1361364660449,1786040801,1786040801,0
1361364690,1786070388,1,60,60,1361364662139,1361364662139,1786042527,1786042527,0
1361365159,1786539020,12,999,83.25,1361365141348,1361365151908,1786521368,1786531928,10560
1361365159,1786539040,11,953,86.63636364,1361365141967,1361365151887,1786522007,1786531927,9920
1361365159,1786539040,11,953,86.63636364,1361365141711,1361365151887,1786521751,1786531927,10176
1361365170,1786550872,1,76,76,1361365142097,1361365142097,1786522969,1786522969,0
1361365215,1786594920,2,152,76,1361365188166,1361365203206,1786568086,1786583126,15040
1361365243,1786623040,2,152,76,1361365218128,1361365233168,1786598168,1786613208,15040
1361365275,1786655056,2,152,76,1361365248188,1361365263228,1786628244,1786643284,15040
1361365303,1786683080,1,76,76,1361365278309,1361365278309,1786658389,1786658389,0
1361366361,1787741864,1,46,46,1361366336389,1361366336389,1787717253,1787717253,0
1361366417,1787797848,1,46,46,1361366392019,1361366392019,1787772867,1787772867,0
1361366814,1788194404,1,60,60,1361366786570,1361366786570,1788166974,1788166974,0
1361366958,1788338892,2,152,76,1361366930721,1361366945761,1788311613,1788326653,15040
1361366960,1788340224,11,953,86.63636364,1361366948606,1361366959870,1788328830,1788340094,11264
1361366960,1788340224,11,953,86.63636364,1361366948861,1361366959869,1788329085,1788340093,11008
1361366960,1788340232,14,6243,445.9285714,1361366947892,1361366959860,1788328124,1788340092,11968
1361366960,1788340560,11,953,86.63636364,1361366948012,1361366959532,1788328572,1788340092,11520
1361366966,1788346844,1,46,46,1361366938257,1361366938257,1788319101,1788319101,0
1361366986,1788366872,1,46,46,1361366959283,1361366959283,1788340155,1788340155,0
1361366986,1788366872,1,46,46,1361366959283,1361366959283,1788340155,1788340155,0
1361366987,1788366916,1,46,46,1361366960241,1361366960241,1788340157,1788340157,0
1361366987,1788366916,1,46,46,1361366960241,1361366960241,1788340157,1788340157,0
1361366987,1788366932,2,152,76,1361366961761,1361366976865,1788341693,1788356797,15104
1361367019,1788399048,1,76,76,1361366991724,1361366991724,1788371772,1788371772,0
1361367379,1788759572,1,46,46,1361367352091,1361367352091,1788732663,1788732663,0
1361367379,1788759580,1,46,46,1361367352722,1361367352722,1788733302,1788733302,0
1361367392,1788772416,17,6755,397.3529412,1361367373878,1361367385078,1788754294,1788765494,11200
1361367392,1788772452,12,999,83.25,1361367374227,1361367385043,1788754679,1788765495,10816
1361367392,1788772456,12,999,83.25,1361367374478,1361367385038,1788754934,1788765494,10560
1361367392,1788772456,12,999,83.25,1361367374734,1361367384974,1788755190,1788765430,10240
1361367399,1788779668,1,46,46,1361367373626,1361367373626,1788754294,1788754294,0
1361367439,1788819684,1,46,46,1361367412904,1361367412904,1788793588,1788793588,0
1361367439,1788819764,1,46,46,1361367412825,1361367412825,1788793589,1788793589,0
1361367913,1789293116,12,999,83.25,1361367896219,1361367905947,1789276335,1789286063,9728
1361367913,1789293116,12,999,83.25,1361367896474,1361367905946,1789276590,1789286062,9472
1361367913,1789293156,12,999,83.25,1361367896690,1361367905842,1789276846,1789285998,9152
1361367913,1789293172,16,6372,398.25,1361367895777,1361367905889,1789275949,1789286061,10112
1361368001,1789381384,11,953,86.63636364,1361367978958,1361367996558,1789359342,1789376942,17600
1361368001,1789381420,12,999,83.25,1361367978090,1361367996586,1789358510,1789377006,18496
1361368001,1789381420,11,953,86.63636364,1361367978346,1361367996586,1789358766,1789377006,18240
1361368001,1789381420,11,953,86.63636364,1361367978600,1361367996584,1789359020,1789377004,17984
1361368020,1789400612,11,3267,297,1361367994342,1361367995110,1789374954,1789375722,768
1361368024,1789404680,13,6234,479.5384615,1361367996579,1361367996899,1789377259,1789377579,320
1361368024,1789404684,8,815,101.875,1361367996960,1361367997152,1789377644,1789377836,192
1361368024,1789404688,9,861,95.66666667,1361367997532,1361367997724,1789378220,1789378412,192
1361368024,1789404732,9,861,95.66666667,1361367997167,1361367997359,1789377899,1789378091,192
1361368129,1789509468,3,138,46,1361368121720,1361368121784,1789502188,1789502252,64
1361368129,1789509468,3,138,46,1361368121719,1361368121783,1789502187,1789502251,64
1361368129,1789509480,3,138,46,1361368121707,1361368121771,1789502187,1789502251,64
1361368129,1789509480,3,138,46,1361368121707,1361368121771,1789502187,1789502251,64
1361368129,1789509480,3,193,64.33333333,1361368125418,1361368125482,1789505898,1789505962,64
1361368156,1789536884,9,861,95.66666667,1361368128727,1361368128919,1789509611,1789509803,192
1361368156,1789536884,9,861,95.66666667,1361368128213,1361368128405,1789509097,1789509289,192
1361368157,1789536888,9,861,95.66666667,1361368130043,1361368130171,1789509931,1789510059,128
1361368157,1789536928,9,861,95.66666667,1361368129426,1361368129618,1789509354,1789509546,192
1361368249,1789629704,3,138,46,1361368246858,1361368246922,1789627562,1789627626,64
1361368249,1789629704,4,184,46,1361368246858,1361368247306,1789627562,1789628010,448
1361368249,1789629704,3,138,46,1361368246858,1361368246922,1789627562,1789627626,64
1361368249,1789629704,3,138,46,1361368246858,1361368246922,1789627562,1789627626,64
1361368298,1789678720,1,46,46,1361368269818,1361368269818,1789650538,1789650538,0
1361368300,1789679896,1,46,46,1361368270639,1361368270639,1789650535,1789650535,0
1361368300,1789679944,1,46,46,1361368270720,1361368270720,1789650664,1789650664,0
1361368526,1789906108,1,64,64,1361368499481,1361368499481,1789879589,1789879589,0
1361368526,1789906188,1,64,64,1361368501002,1361368501002,1789881190,1789881190,0
1361368534,1789914156,1,64,64,1361368508522,1361368508522,1789888678,1789888678,0
1361368714,1790094696,1,46,46,1361368686856,1361368686856,1790067552,1790067552,0
1361368883,1790262996,17,6755,397.3529412,1361368870914,1361368880450,1790250910,1790260446,9536
1361368883,1790263024,11,953,86.63636364,1361368871271,1361368880423,1790251295,1790260447,9152
1361368887,1790267208,1,60,60,1361368859695,1361368859695,1790239903,1790239903,0
1361368887,1790267296,1,60,60,1361368860822,1361368860822,1790241118,1790241118,0
1361368907,1790287232,2,152,76,1361368880599,1361368895639,1790260831,1790275871,15040
1361368935,1790315376,2,152,76,1361368910534,1361368925574,1790290910,1790305950,15040
1361368967,1790347536,1,76,76,1361368940455,1361368940455,1790320991,1790320991,0
1361369252,1790632156,3,180,60,1361369225885,1361369234909,1790606041,1790615065,9024
1361369272,1790652224,3,180,60,1361369246808,1361369255832,1790627032,1790636056,9024
1361369292,1790672432,3,180,60,1361369267594,1361369276618,1790648026,1790657050,9024
1361369316,1790696540,3,180,60,1361369288475,1361369297499,1790669015,1790678039,9024
1361369713,1791093412,1,46,46,1361369687638,1361369687638,1791068050,1791068050,0
1361369713,1791093460,1,46,46,1361369687269,1361369687269,1791067729,1791067729,0
1361369843,1791223460,15,6289,419.2666667,1361369828323,1361369840419,1791208783,1791220879,12096
1361369843,1791223488,12,999,83.25,1361369829385,1361369840393,1791209873,1791220881,11008
1361369843,1791223504,12,999,83.25,1361369828728,1361369840376,1791209232,1791220880,11648
1361369843,1791223504,12,999,83.25,1361369829047,1361369840375,1791209551,1791220879,11328
1361369857,1791237820,2,152,76,1361369830780,1361369845820,1791211600,1791226640,15040
1361369889,1791269820,2,152,76,1361369860924,1361369875964,1791241744,1791256784,15040
1361369899,1791279452,6,3996,666,1361369898347,1361369898667,1791278799,1791279119,320
1361369902,1791282052,6,3996,666,1361369897597,1361369898749,1791277649,1791278801,1152
1361369907,1791287500,8,2684,335.5,1361369900092,1361369900604,1791280592,1791281104,512
1361369912,429605904,19,21945,1155,1361369899179,1361369911147,429593083,429605051,11968
1361369915,1791295448,24,16267,677.7916667,1361369899697,1361369911153,1791280145,1791291601,11456
1361369915,1791295448,14,5990,427.8571429,1361369898416,1361369909232,1791278864,1791289680,10816
1361369915,1791295452,11,5422,492.9090909,1361369898669,1361369909165,1791279121,1791289617,10496
1361369915,1791295492,10,5050,505,1361369898307,1361369909187,1791278799,1791289679,10880
1361369918,1791298228,2,152,76,1361369891595,1361369906699,1791271823,1791286927,15104
1361369923,1791303484,118,165219,1400.161017,1361369904587,1361369915531,1791285071,1791296015,10944
1361369946,1791326212,2,152,76,1361369921754,1361369936794,1791301966,1791317006,15040
1361369978,1791358196,2,152,76,1361369951852,1361369966892,1791332048,1791347088,15040
1361369979,1791359576,4,377,94.25,1361369975725,1361369975917,1791356301,1791356493,192
1361369979,1791359584,6,3996,666,1361369976997,1361369978533,1791357581,1791359117,1536
1361369979,1791359620,4,377,94.25,1361369975682,1361369975874,1791356302,1791356494,192
1361369987,1791367644,5,2515,503,1361369971308,1361369983340,1791351952,1791363984,12032
1361369992,429685996,18,21893,1216.277778,1361369978064,1361369990032,429672060,429684028,11968
1361369995,1791375596,15,6289,419.2666667,1361369981976,1361369994072,1791362572,1791374668,12096
1361369995,1791375600,12,999,83.25,1361369982357,1361369994069,1791362957,1791374669,11712
1361369995,1791375604,11,953,86.63636364,1361369982611,1361369994003,1791363215,1791374607,11392
1361369995,1791375608,12,999,83.25,1361369982864,1361369994000,1791363472,1791374608,11136
1361369996,1791375952,24,16266,677.75,1361369978974,1361369990622,1791358926,1791370574,11648
1361369996,1791375956,6,3216,536,1361369976281,1361369988249,1791356237,1791368205,11968
1361370002,1791382276,9,4998,555.3333333,1361369976219,1361369978843,1791356495,1791359119,2624
1361370002,1791382276,9,5318,590.8888889,1361369976282,1361369979098,1791356558,1791359374,2816
1361370006,1791386220,2,152,76,1361369981908,1361369996948,1791362128,1791377168,15040
1361370006,1791386232,10,4714,471.4,1361369979014,1361369979654,1791359246,1791359886,640
1361370038,1791418368,2,152,76,1361370011838,1361370026878,1791392206,1791407246,15040
1361370062,1791442648,1,52,52,1361370037094,1361370037094,1791417742,1791417742,0
1361370062,1791442652,1,52,52,1361370037088,1361370037088,1791417740,1791417740,0
1361370062,1791442696,1,52,52,1361370037046,1361370037046,1791417742,1791417742,0
1361370066,1791446668,1,76,76,1361370041553,1361370041553,1791422221,1791422221,0
1361370283,1791663700,12,999,83.25,1361370270639,1361370281839,1791651339,1791662539,11200
1361370283,1791663748,12,999,83.25,1361370270847,1361370281791,1791651595,1791662539,10944
1361370283,1791663748,11,953,86.63636364,1361370271165,1361370281789,1791651913,1791662537,10624
1361370283,1791663780,16,6335,395.9375,1361370270108,1361370281756,1791650888,1791662536,11648
1361370428,1791808012,11,953,86.63636364,1361370409310,1361370421406,1791789322,1791801418,12096
1361370428,1791808012,11,953,86.63636364,1361370409818,1361370421338,1791789830,1791801350,11520
1361370428,1791808056,12,999,83.25,1361370409519,1361370421359,1791789575,1791801415,11840
1361370428,1791808080,12,999,83.25,1361370410008,1361370421272,1791790088,1791801352,11264
1361370700,1792080600,12,999,83.25,1361370688014,1361370698254,1792068614,1792078854,10240
1361370700,1792080632,16,6372,398.25,1361370687018,1361370698282,1792067650,1792078914,11264
1361370700,1792080632,12,999,83.25,1361370687466,1361370698282,1792068098,1792078914,10816
1361370700,1792080636,12,999,83.25,1361370687720,1361370698280,1792068356,1792078916,10560
1361370977,1792357184,2,104,52,1361370951399,1361370954279,1792331583,1792334463,2880
1361370988,1792368604,12,999,83.25,1361370975618,1361370987330,1792356222,1792367934,11712
1361370988,1792368628,12,999,83.25,1361370975916,1361370987308,1792356544,1792367936,11392
1361370988,1792368640,17,6418,377.5294118,1361370975197,1361370987293,1792355837,1792367933,12096
1361370988,1792368668,11,953,86.63636364,1361370976132,1361370987204,1792356800,1792367872,11072
1361371024,430718472,9,7807,867.4444444,1361371007804,1361371019772,430702276,430714244,11968
1361371025,430718480,8,7207,900.875,1361371008794,1361371020762,430702274,430714242,11968
1361371025,1792405548,6,4799,799.8333333,1361371000377,1361371001209,1792380925,1792381757,832
1361371028,1792408768,16,7075,442.1875,1361371007965,1361371019997,1792388733,1792400765,12032
1361371069,1792449484,1,52,52,1361371043259,1361371043259,1792423743,1792423743,0
1361371189,1792569588,1,46,46,1361371164368,1361371164368,1792544956,1792544956,0
1361372039,1793419588,2,120,60,1361372014018,1361372016962,1793394606,1793397550,2944
1361372043,1793423548,1,60,60,1361372015658,1361372015658,1793396206,1793396206,0
1361372572,1793952684,2,120,60,1361372547417,1361372550425,1793928101,1793931109,3008
1361372572,1793952732,2,120,60,1361372546218,1361372549226,1793926950,1793929958,3008
1361372576,1793956652,2,120,60,1361372548540,1361372551548,1793929192,1793932200,3008
1361372576,1793956724,2,120,60,1361372548467,1361372551475,1793929191,1793932199,3008
1361372805,1794185140,12,6151,512.5833333,1361372780470,1361372780854,1794160610,1794160994,384
1361372809,1794189076,9,861,95.66666667,1361372780983,1361372781175,1794161059,1794161251,192
1361372809,1794189152,9,861,95.66666667,1361372781228,1361372781356,1794161380,1794161508,128
1361372809,1794189160,9,861,95.66666667,1361372781476,1361372781604,1794161636,1794161764,128
1361373014,1794393980,2,126,63,1361373012310,1361373013334,1794392290,1794393314,1024
1361373022,1794402024,2,126,63,1361373015273,1361373019305,1794395297,1794399329,4032
1361373053,1794433264,1,63,63,1361373027126,1361373027126,1794407390,1794407390,0
1361373070,1794449960,4,252,63,1361373061287,1361373068391,1794441247,1794448351,7104
1361373101,1794481428,1,63,63,1361373075924,1361373075924,1794456352,1794456352,0
1361373102,1794482060,3,189,63,1361373098306,1361373101378,1794478366,1794481438,3072
1361373110,1794490024,3,189,63,1361373103910,1361373106918,1794483934,1794486942,3008
1361373118,1794498028,2,126,63,1361373105443,1361373113443,1794485471,1794493471,8000
1361373126,1794506080,2,126,63,1361373110896,1361373118960,1794490976,1794499040,8064
1361373582,1794962420,17,6755,397.3529412,1361373569555,1361373576275,1794949975,1794956695,6720
1361373590,1794970420,12,999,83.25,1361373570261,1361373582293,1794950681,1794962713,12032
1361373590,1794970456,12,999,83.25,1361373569967,1361373582255,1794950423,1794962711,12288
1361373599,1794978868,2,152,76,1361373573116,1361373588156,1794952984,1794968024,15040
1361373630,1795010800,2,152,76,1361373602264,1361373617304,1794983064,1794998104,15040
1361373658,1795038860,1,76,76,1361373632219,1361373632219,1795013079,1795013079,0
1361375111,1796491564,12,999,83.25,1361375095149,1361375105261,1796475713,1796485825,10112
1361375111,1796491588,17,6755,397.3529412,1361375094739,1361375105235,1796475327,1796485823,10496
1361375111,1796491592,12,999,83.25,1361375095442,1361375105234,1796476034,1796485826,9792
1361375123,1796503028,2,152,76,1361375096642,1361375111682,1796476670,1796491710,15040
1361375151,1796531180,2,152,76,1361375126573,1361375141613,1796506753,1796521793,15040
1361375183,1796563396,1,76,76,1361375156436,1361375156436,1796536832,1796536832,0
1361375520,1796900564,16,6372,398.25,1361375504743,1361375515879,1796885307,1796896443,11136
1361375520,1796900588,12,999,83.25,1361375505102,1361375515790,1796885690,1796896378,10688
1361375520,1796900592,12,999,83.25,1361375505608,1361375515784,1796886200,1796896376,10176
1361375520,1796900592,12,999,83.25,1361375505356,1361375515788,1796885948,1796896380,10432
1361375532,1796912388,2,152,76,1361375505880,1361375520920,1796886268,1796901308,15040
1361375564,1796944484,2,152,76,1361375535861,1361375550901,1796916345,1796931385,15040
1361375592,1796972536,1,76,76,1361375565889,1361375565889,1796946425,1796946425,0
1361376282,1797662120,1,46,46,1361376255061,1361376255061,1797635181,1797635181,0
1361376898,1798278124,11,953,86.63636364,1361376886283,1361376897547,1798266407,1798277671,11264
1361376898,1798278196,15,6289,419.2666667,1361376885507,1361376897539,1798265703,1798277735,12032
1361376898,1798278196,11,953,86.63636364,1361376885889,1361376897473,1798266085,1798277669,11584
1361376898,1798278200,12,999,83.25,1361376886462,1361376897470,1798266662,1798277670,11008
1361376912,1798291996,1,46,46,1361376885643,1361376885643,1798265639,1798265639,0
1361376916,1798295960,2,152,76,1361376888109,1361376903149,1798268069,1798283109,15040
1361376944,1798323980,2,152,76,1361376918233,1361376933209,1798298213,1798313189,14976
1361376976,1798356072,1,76,76,1361376948219,1361376948219,1798328291,1798328291,0
1361377060,1798440224,5,250,50,1361377035172,1361377057316,1798415396,1798437540,22144
1361377485,1798865472,1,46,46,1361377457187,1361377457187,1798837659,1798837659,0
1361378403,1799783816,16,6372,398.25,1361378387517,1361378396029,1799768333,1799776845,8512
1361378403,1799783824,12,999,83.25,1361378387895,1361378395959,1799768719,1799776783,8064
1361378741,1800121088,1,48,48,1361378714897,1361378714897,1800094985,1800094985,0
1361378877,1800257604,1,46,46,1361378849868,1361378849868,1800230472,1800230472,0
1361379173,1800553156,12,999,83.25,1361379160903,1361379170759,1800541059,1800550915,9856
1361379173,1800553160,12,999,83.25,1361379161153,1361379170753,1800541313,1800550913,9600
1361379173,1800553160,11,953,86.63636364,1361379161411,1361379170755,1800541571,1800550915,9344
1361379173,1800553228,16,6372,398.25,1361379160446,1361379170686,1800540674,1800550914,10240
1361379196,1800576368,2,152,76,1361379171699,1361379186803,1800552067,1800567171,15104
1361379228,1800608488,2,152,76,1361379201723,1361379216763,1800582211,1800597251,15040
1361379256,1800636528,1,76,76,1361379231761,1361379231761,1800612289,1800612289,0
1361379549,1800929376,6,384,64,1361379522470,1361379527974,1800902846,1800908350,5504
1361379549,1800929388,5,320,64,1361379523610,1361379527962,1800903998,1800908350,4352
1361379549,1800929576,4,256,64,1361379524508,1361379527772,1800905084,1800908348,3264
1361379549,1800929576,4,256,64,1361379524508,1361379527772,1800905084,1800908348,3264
1361379966,1801346588,3,152,50.66666667,1361379938057,1361379947145,1801318645,1801327733,9088
1361380119,1801499104,12,999,83.25,1361380105710,1361380116206,1801485814,1801496310,10496
1361380119,1801499156,16,6372,398.25,1361380105208,1361380116152,1801485364,1801496308,10944
1361380119,1801499184,11,953,86.63636364,1361380105885,1361380115933,1801486069,1801496117,10048
1361380127,1801507172,12,3356,279.6666667,1361380116071,1361380121127,1801496243,1801501299,5056
1361380131,1801510888,2,152,76,1361380106051,1361380121091,1801485939,1801500979,15040
1361380152,1801532612,1,48,48,1361380126382,1361380126382,1801506994,1801506994,0
1361380163,1801543340,2,152,76,1361380135679,1361380150719,1801516019,1801531059,15040
1361380191,1801571268,1,76,76,1361380165832,1361380165832,1801546100,1801546100,0
1361380432,1801812352,11,953,86.63636364,1361380415471,1361380426991,1801795823,1801807343,11520
1361380432,1801812356,12,999,83.25,1361380415788,1361380426988,1801796144,1801807344,11200
1361380432,1801812492,12,999,83.25,1361380414757,1361380426853,1801795249,1801807345,12096
1361380432,1801812492,12,999,83.25,1361380415077,1361380426853,1801795569,1801807345,11776
1361380444,1801823976,2,152,76,1361380419303,1361380434343,1801799279,1801814319,15040
1361380476,1801856140,2,152,76,1361380449218,1361380464258,1801829358,1801844398,15040
1361380504,1801884308,1,76,76,1361380479131,1361380479131,1801859439,1801859439,0
1361381010,1802389860,11,953,86.63636364,1361380995154,1361381005842,1802375014,1802385702,10688
1361381010,1802389864,11,953,86.63636364,1361380995409,1361381005841,1802375273,1802385705,10432
1361381010,1802389936,12,999,83.25,1361380994822,1361381005766,1802374758,1802385702,10944
1361381021,1802401772,2,152,76,1361380995908,1361381010948,1802376680,1802391720,15040
1361381053,1802433756,2,152,76,1361381026002,1361381041042,1802406758,1802421798,15040
1361381082,1802461972,1,76,76,1361381056866,1361381056866,1802436838,1802436838,0
1361381980,1803360256,17,6755,397.3529412,1361381960888,1361381974584,1803341144,1803354840,13696
1361381980,1803360292,12,999,83.25,1361381961878,1361381974550,1803342170,1803354842,12672
1361381980,1803360368,11,953,86.63636364,1361381961481,1361381974473,1803341849,1803354841,12992
1361381980,1803360368,12,999,83.25,1361381961161,1361381974473,1803341529,1803354841,13312
1361381988,1803368276,12,999,83.25,1361381975587,1361381986915,1803355863,1803367191,11328
1361381988,1803368356,12,999,83.25,1361381974996,1361381986836,1803355352,1803367192,11840
1361381988,1803368356,11,953,86.63636364,1361381974739,1361381986835,1803355095,1803367191,12096
1361381988,1803368360,11,953,86.63636364,1361381975246,1361381986830,1803355606,1803367190,11584
1361382879,1804259180,1,46,46,1361382851319,1361382851319,1804231499,1804231499,0
1361383087,1804467620,9,861,95.66666667,1361383060090,1361383060282,1804440710,1804440902,192
1361383087,1804467712,9,861,95.66666667,1361383059488,1361383059680,1804440200,1804440392,192
1361383087,1804467716,8,815,101.875,1361383059739,1361383059931,1804440455,1804440647,192
1361383216,1804595940,1,78,78,1361383188450,1361383188450,1804568390,1804568390,0
1361383309,1804689512,3,189,63,1361383303522,1361383306530,1804684034,1804687042,3008
1361383325,1804705632,2,126,63,1361383310445,1361383318509,1804691077,1804699141,8064
1361383344,1804724436,1,46,46,1361383318574,1361383318574,1804699010,1804699010,0
1361383357,1804737600,2,126,63,1361383354315,1361383355403,1804734915,1804736003,1088
1361383365,1804745532,2,126,63,1361383357455,1361383361487,1804737987,1804742019,4032
1361383381,1804761692,3,189,63,1361383376496,1361383379504,1804757188,1804760196,3008
1361383388,1804768320,8,815,101.875,1361383362722,1361383362914,1804743042,1804743234,192
1361383388,1804768328,8,815,101.875,1361383362971,1361383363163,1804743299,1804743491,192
1361383388,1804768328,8,815,101.875,1361383363226,1361383363418,1804743554,1804743746,192
1361383388,1804768396,8,815,101.875,1361383363416,1361383363608,1804743812,1804744004,192
1361383397,1804777644,2,126,63,1361383383582,1361383391646,1804764226,1804772290,8064
1361383549,1804929648,2,126,63,1361383546138,1361383547162,1804926786,1804927810,1024
1361383549,1804929680,2,126,63,1361383547002,1361383548026,1804927682,1804928706,1024
1361383557,1804937616,2,126,63,1361383549240,1361383553272,1804929856,1804933888,4032
1361383557,1804937628,2,126,63,1361383550125,1361383554157,1804930753,1804934785,4032
1361383588,1804968388,1,63,63,1361383561562,1361383561562,1804941950,1804941950,0
1361383588,1804968404,1,63,63,1361383562446,1361383562446,1804942850,1804942850,0
1361383589,1804969696,2,126,63,1361383587623,1361383588647,1804968319,1804969343,1024
1361383597,1804977720,2,126,63,1361383590608,1361383594640,1804971328,1804975360,4032
1361383621,1805001696,3,189,63,1361383615206,1361383618214,1804995902,1804998910,3008
1361383628,1805008768,1,63,63,1361383602655,1361383602655,1804983423,1804983423,0
1361383637,1805017696,2,126,63,1361383622245,1361383630309,1805002941,1805011005,8064
1361384086,1805466432,16,6372,398.25,1361384070374,1361384080422,1805450806,1805460854,10048
1361384086,1805466456,11,953,86.63636364,1361384070734,1361384080398,1805451190,1805460854,9664
1361384086,1805466456,11,953,86.63636364,1361384070991,1361384080399,1805451447,1805460855,9408
1361384086,1805466460,12,999,83.25,1361384071245,1361384080333,1805451705,1805460793,9088
1361384110,1805490188,2,152,76,1361384084189,1361384099229,1805464377,1805479417,15040
1361384142,1805522000,2,152,76,1361384114454,1361384129494,1805494454,1805509494,15040
1361384170,1805550220,1,76,76,1361384144313,1361384144313,1805524533,1805524533,0
1361385284,1806664564,3,450,150,1361385258513,1361385264529,1806639077,1806645093,6016
1361385448,1806827912,12,999,83.25,1361385436060,1361385446172,1806815972,1806826084,10112
1361385448,1806828008,12,999,83.25,1361385436538,1361385446010,1806816546,1806826018,9472
1361385448,1806828008,12,999,83.25,1361385436218,1361385446074,1806816226,1806826082,9856
1361385464,1806844732,2,152,76,1361385435878,1361385450918,1806816610,1806831650,15040
1361385492,1806872776,2,152,76,1361385465915,1361385480955,1806846691,1806861731,15040
1361385524,1806904808,1,76,76,1361385495963,1361385495963,1806876771,1806876771,0
1361385855,1807234864,1,48,48,1361385827140,1361385827140,1807207004,1807207004,0
1361386663,1808043188,1,52,52,1361386636148,1361386636148,1808016336,1808016336,0
1361386872,1808252752,11,953,86.63636364,1361386855934,1361386865086,1808236686,1808245838,9152
1361386872,1808252764,11,953,86.63636364,1361386855346,1361386865074,1808236110,1808245838,9728
1361386872,1808252768,12,999,83.25,1361386855662,1361386865070,1808236430,1808245838,9408
1361386873,1808252832,17,6755,397.3529412,1361386855831,1361386866007,1808235663,1808245839,10176
1361386883,1808263736,2,152,76,1361386856012,1361386871052,1808236748,1808251788,15040
1361386912,1808291888,2,152,76,1361386886940,1361386901980,1808266828,1808281868,15040
1361386944,1808323880,1,76,76,1361386917029,1361386917029,1808296909,1808296909,0
1361387634,447327648,1,46,46,1361387605790,1361387605790,447299438,447299438,0
1361387689,1809069624,16,6372,398.25,1361387673713,1361387685809,1809054337,1809066433,12096
1361387689,1809069656,12,999,83.25,1361387674065,1361387685777,1809054721,1809066433,11712
1361387689,1809069660,11,953,86.63636364,1361387674636,1361387685708,1809055296,1809066368,11072
1361387689,1809069740,11,953,86.63636364,1361387674236,1361387685628,1809054976,1809066368,11392
1361387701,1809081252,2,152,76,1361387676517,1361387691557,1809056769,1809071809,15040
1361387733,1809113252,2,152,76,1361387706598,1361387721638,1809086850,1809101890,15040
1361387761,1809141252,1,76,76,1361387736611,1361387736611,1809116863,1809116863,0
1361389414,1810794600,1,46,46,1361389387887,1361389387887,1810768487,1810768487,0
1361389494,1810874652,11,953,86.63636364,1361389479995,1361389490043,1810860647,1810870695,10048
1361389494,1810874652,12,999,83.25,1361389480314,1361389490042,1810860966,1810870694,9728
1361389506,1810886500,2,152,76,1361389481042,1361389496146,1810861542,1810876646,15104
1361389538,1810918360,2,152,76,1361389511324,1361389526364,1810891684,1810906724,15040
1361389567,1810946960,1,76,76,1361389541743,1361389541743,1810921703,1810921703,0
1361389720,1811100656,1,46,46,1361389693108,1361389693108,1811073764,1811073764,0
1361390112,1811492204,1,60,60,1361390084977,1361390084977,1811465181,1811465181,0
1361390380,1811760528,1,46,46,1361390353769,1361390353769,1811734297,1811734297,0
1361390396,1811776524,13,6234,479.5384615,1361390369515,1361390369835,1811750039,1811750359,320
1361390396,1811776640,9,861,95.66666667,1361390369785,1361390369977,1811750425,1811750617,192
1361390396,1811776648,8,815,101.875,1361390370034,1361390370226,1811750682,1811750874,192
1361390594,1811973980,3,189,63,1361390588107,1361390591115,1811968087,1811971095,3008
1361390610,1811989860,2,126,63,1361390595263,1361390603327,1811975123,1811983187,8064
1361390642,1812021940,2,126,63,1361390639919,1361390640943,1812019859,1812020883,1024
1361390642,1812022036,2,126,63,1361390639697,1361390640721,1812019733,1812020757,1024
1361390650,1812030160,2,126,63,1361390642645,1361390646677,1812022805,1812026837,4032
1361390650,1812030160,2,126,63,1361390642771,1361390646803,1812022931,1812026963,4032
1361390681,1812061456,1,63,63,1361390654379,1361390654379,1812034835,1812034835,0
1361390681,1812061572,1,63,63,1361390654456,1361390654456,1812035028,1812035028,0
1361390729,1812109496,1,46,46,1361390703044,1361390703044,1812083540,1812083540,0
1361390729,1812109496,10,907,90.7,1361390703107,1361390703747,1812083603,1812084243,640
1361390729,1812109616,8,815,101.875,1361390703693,1361390703949,1812084309,1812084565,256
1361390963,1812343024,3,189,63,1361390957526,1361390960598,1812337550,1812340622,3072
1361390978,1812358788,2,126,63,1361390963866,1361390971866,1812344654,1812352654,8000
1361390986,1812366804,3,189,63,1361390981258,1361390984266,1812362062,1812365070,3008
1361391002,1812382776,2,126,63,1361390988326,1361390996390,1812369102,1812377166,8064
1361391088,450781704,7,4807,686.7142857,1361391075133,1361391087101,450768837,450780805,11968
1361391088,450781728,8,7207,900.875,1361391075110,1361391087014,450768838,450780742,11904
1361391091,1812470976,15,6104,406.9333333,1361391075204,1361391087236,1812455180,1812467212,12032
1361391091,1812471044,15,6289,419.2666667,1361391072964,1361391085060,1812453008,1812465104,12096
1361391091,1812471048,11,953,86.63636364,1361391074047,1361391085055,1812454095,1812465103,11008
1361391091,1812471136,12,999,83.25,1361391073383,1361391084967,1812453519,1812465103,11584
1361391091,1812471136,11,953,86.63636364,1361391073637,1361391084965,1812453773,1812465101,11328
1361391138,1812518752,1,93,93,1361391111294,1361391111294,1812492046,1812492046,0
1361391139,1812519056,10,907,90.7,1361391121525,1361391133813,1812501581,1812513869,12288
1361391139,1812519056,12,999,83.25,1361391121843,1361391134323,1812501899,1812514379,12480
1361391139,1812519144,12,999,83.25,1361391121180,1361391134236,1812501324,1812514380,13056
1361391139,1812519148,12,999,83.25,1361391122008,1361391133272,1812502156,1812513420,11264
1361391146,1812526748,11,3267,297,1361391119617,1361391120129,1812500365,1812500877,512
1361391163,1812543200,3,193,64.33333333,1361391160487,1361391160487,1812540687,1812540687,0
1361391459,1812839508,9,861,95.66666667,1361391433963,1361391434155,1812814471,1812814663,192
1361391459,1812839516,9,861,95.66666667,1361391434532,1361391434724,1812815048,1812815240,192
1361391459,1812839600,13,6234,479.5384615,1361391433486,1361391433806,1812814086,1812814406,320
1361391459,1812839712,8,815,101.875,1361391434081,1361391434209,1812814793,1812814921,128
1361391668,1813047964,3,189,63,1361391660939,1361391663947,1813040903,1813043911,3008
1361391684,1813063896,2,126,63,1361391681483,1361391682507,1813061379,1813062403,1024
1361391684,1813063972,2,126,63,1361391667970,1361391676034,1813047942,1813056006,8064
1361391684,1813063992,2,126,63,1361391681390,1361391682414,1813061382,1813062406,1024
1361391684,1813064012,2,126,63,1361391681560,1361391682584,1813061572,1813062596,1024
1361391692,1813072004,2,126,63,1361391684384,1361391688416,1813064388,1813068420,4032
1361391692,1813072004,2,126,63,1361391684384,1361391688416,1813064388,1813068420,4032
1361391692,1813072028,2,126,63,1361391684553,1361391688585,1813064581,1813068613,4032
1361391724,1813104392,1,63,63,1361391696093,1361391696093,1813076485,1813076485,0
1361391724,1813104396,1,63,63,1361391696281,1361391696281,1813076677,1813076677,0
1361391724,1813104516,1,63,63,1361391695969,1361391695969,1813076485,1813076485,0
1361392033,1813413348,8,815,101.875,1361392008260,1361392008452,1813388608,1813388800,192
1361392033,1813413456,8,815,101.875,1361392007894,1361392008086,1813388350,1813388542,192
1361392033,1813413460,9,861,95.66666667,1361392007637,1361392007765,1813388097,1813388225,128
1361392292,1813672352,3,189,63,1361392286332,1361392289340,1813666684,1813669692,3008
1361392292,1813672352,3,189,63,1361392286331,1361392289403,1813666683,1813669755,3072
1361392292,1813672352,3,189,63,1361392286395,1361392289403,1813666747,1813669755,3008
1361392301,1813681584,9,861,95.66666667,1361392275924,1361392276116,1813656508,1813656700,192
1361392301,1813681592,9,861,95.66666667,1361392276170,1361392276362,1813656762,1813656954,192
1361392301,1813681672,9,861,95.66666667,1361392275580,1361392275708,1813656252,1813656380,128
1361392301,1813681780,14,6617,472.6428571,1361392275089,1361392275345,1813655869,1813656125,256
1361392308,1813688272,2,126,63,1361392293453,1361392301517,1813673725,1813681789,8064
1361392308,1813688272,2,126,63,1361392293517,1361392301581,1813673789,1813681853,8064
1361392308,1813688664,2,126,63,1361392293122,1361392301122,1813673786,1813681786,8000
1361392516,1813896508,3,189,63,1361392511262,1361392514270,1813891770,1813894778,3008
1361392532,1813912440,2,126,63,1361392518367,1361392526431,1813898807,1813906871,8064
1361392604,1813984600,3,189,63,1361392600319,1361392603327,1813980919,1813983927,3008
1361392620,1814000480,2,126,63,1361392607477,1361392615541,1813987957,1813996021,8064
1361392644,1814024604,3,189,63,1361392640633,1361392643705,1814021237,1814024309,3072
1361392653,1814032884,3,189,63,1361392648076,1361392651148,1814027960,1814031032,3072
1361392660,1814040632,2,126,63,1361392647710,1361392655710,1814028342,1814036342,8000
1361392668,1814048660,2,126,63,1361392654401,1361392662401,1814035061,1814043061,8000
1361392879,1814258964,1,445,445,1361392852726,1361392852726,1814232690,1814232690,0
1361393828,1815208608,8,815,101.875,1361393803107,1361393803235,1815183715,1815183843,128
1361393828,1815208704,14,6617,472.6428571,1361393802372,1361393802628,1815183076,1815183332,256
1361393828,1815208708,9,861,95.66666667,1361393802754,1361393802882,1815183462,1815183590,128
1361393828,1815208740,8,815,101.875,1361393803233,1361393803425,1815183973,1815184165,192
1361394013,1815393048,2,96,48,1361393985683,1361393988883,1815365731,1815368931,3200
1361394094,1815474800,44,56507,1284.25,1361394088544,1361394088864,1815469344,1815469664,320
1361394103,1815482868,3,189,63,1361394099334,1361394102342,1815479202,1815482210,3008
1361394103,1815482984,3,189,63,1361394099152,1361394102160,1815479136,1815482144,3008
1361394103,1815482984,3,189,63,1361394099279,1361394102287,1815479263,1815482271,3008
1361394103,1815482992,3,189,63,1361394099528,1361394102600,1815479520,1815482592,3072
1361394113,1815493704,14,6617,472.6428571,1361394088193,1361394088513,1815468897,1815469217,320
1361394114,1815494060,9,861,95.66666667,1361394089222,1361394089414,1815469282,1815469474,192
1361394117,1815497396,9,861,95.66666667,1361394089138,1361394089330,1815469534,1815469726,192
1361394117,1815497524,8,815,101.875,1361394089397,1361394089525,1815469921,1815470049,128
1361394119,1815498824,2,126,63,1361394106353,1361394114417,1815486177,1815494241,8064
1361394119,1815498824,2,126,63,1361394106416,1361394114480,1815486240,1815494304,8064
1361394119,1815498936,2,126,63,1361394106367,1361394114431,1815486303,1815494367,8064
1361394119,1815498940,2,126,63,1361394106683,1361394114683,1815486623,1815494623,8000
1361394327,1815707100,3,189,63,1361394321690,1361394324762,1815701790,1815704862,3072
1361394327,1815707176,2,126,63,1361394324365,1361394325389,1815704541,1815705565,1024
1361394335,1815715324,2,126,63,1361394327291,1361394331259,1815707615,1815711583,3968
1361394343,1815723136,2,126,63,1361394328758,1361394336758,1815708894,1815716894,8000
1361394343,1815723176,3,189,63,1361394337613,1361394340685,1815717789,1815720861,3072
1361394359,1815739184,2,126,63,1361394344706,1361394352706,1815724890,1815732890,8000
1361394365,1815745644,1,63,63,1361394339001,1361394339001,1815719645,1815719645,0
1361394415,1815795184,3,189,63,1361394408002,1361394411010,1815788186,1815791194,3008
1361394431,1815811292,2,126,63,1361394414937,1361394423001,1815795229,1815803293,8064
1361395376,1816755884,3,156,52,1361395349218,1361395358178,1816729102,1816738062,8960
1361395608,1816988716,17,6755,397.3529412,1361395592028,1361395602972,1816972744,1816983688,10944
1361395608,1816988720,12,999,83.25,1361395592472,1361395602968,1816973192,1816983688,10496
1361395609,1816988812,12,999,83.25,1361395593637,1361395603877,1816973449,1816983689,10240
1361395644,1817024512,9,861,95.66666667,1361395618536,1361395618728,1816999048,1816999240,192
1361395644,1817024512,8,815,101.875,1361395618791,1361395618983,1816999303,1816999495,192
1361395644,1817024608,8,815,101.875,1361395617866,1361395618058,1816998474,1816998666,192
1361395644,1817024612,9,861,95.66666667,1361395618118,1361395618310,1816998730,1816998922,192
1361395717,1817096976,3,444,148,1361395691969,1361395697985,1817071945,1817077961,6016
1361395857,1817237584,4,252,63,1361395848670,1361395855710,1817229254,1817236294,7040
1361395881,1817261596,3,189,63,1361395877075,1361395880083,1817257671,1817260679,3008
1361395889,1817269556,1,63,63,1361395863803,1361395863803,1817244359,1817244359,0
1361395898,1817277800,2,126,63,1361395884908,1361395892908,1817264708,1817272708,8000
1361395905,1817285708,3,189,63,1361395898531,1361395901603,1817279239,1817282311,3072
1361395921,1817301704,2,126,63,1361395905635,1361395913635,1817286339,1817294339,8000
1361395937,1817317724,2,126,63,1361395935314,1361395936338,1817316038,1817317062,1024
1361395945,1817325628,2,126,63,1361395938417,1361395942449,1817319045,1817323077,4032
1361395977,1817357500,1,63,63,1361395950638,1361395950638,1817331138,1817331138,0
1361396330,1817710784,3,444,148,1361396305229,1361396311245,1817686013,1817692029,6016
1361396948,1818327904,3,444,148,1361396920502,1361396926582,1818300406,1818306486,6080
1361397237,456930916,3,180,60,1361397211730,1361397220754,456905646,456914670,9024
1361397237,456930924,3,152,50.66666667,1361397212811,1361397221835,456906735,456915759,9024
1361397237,456931040,3,152,50.66666667,1361397212694,1361397221718,456906734,456915758,9024
1361397237,456931040,1,60,60,1361397212758,1361397212758,456906798,456906798,0
1361397241,456934904,3,180,60,1361397213150,1361397222110,456907054,456916014,8960
1361397433,1818812972,8,815,101.875,1361397407786,1361397407978,1818787758,1818787950,192
1361397433,1818812976,9,861,95.66666667,1361397408038,1361397408294,1818788014,1818788270,256
1361397433,1818813052,13,6234,479.5384615,1361397407003,1361397407323,1818787055,1818787375,320
1361397433,1818813056,9,861,95.66666667,1361397407446,1361397407574,1818787502,1818787630,128
1361397557,1818937392,3,444,148,1361397531973,1361397537989,1818912365,1818918381,6016
1361397598,1818977968,4,252,63,1361397590315,1361397597355,1818970283,1818977323,7040
1361397598,1818978088,3,189,63,1361397591221,1361397594229,1818971309,1818974317,3008
1361397614,1818994012,2,126,63,1361397598336,1361397606400,1818978348,1818986412,8064
1361397630,1819009844,1,63,63,1361397605543,1361397605543,1818985387,1818985387,0
1361397662,1819042208,3,189,63,1361397655160,1361397658168,1819035368,1819038376,3008
1361397678,1819058276,2,126,63,1361397662136,1361397670200,1819042412,1819050476,8064
1361397710,1819090296,3,189,63,1361397703202,1361397706210,1819083498,1819086506,3008
1361397726,1819106284,2,126,63,1361397710252,1361397718316,1819090536,1819098600,8064
1361397886,1819266588,12,999,83.25,1361397871100,1361397881852,1819251688,1819262440,10752
1361397886,1819266668,13,1045,80.38461538,1361397869739,1361397881835,1819250407,1819262503,12096
1361397886,1819266676,12,999,83.25,1361397870433,1361397881825,1819251109,1819262501,11392
1361397886,1819266696,12,999,83.25,1361397870672,1361397881744,1819251368,1819262440,11072
1361398171,1819551604,3,447,149,1361398144101,1361398150181,1819524705,1819530785,6080
1361398511,1819891292,12,999,83.25,1361398492377,1361398504025,1819872669,1819884317,11648
1361398511,1819891328,12,999,83.25,1361398492855,1361398503927,1819873183,1819884255,11072
1361398511,1819891372,16,6372,398.25,1361398491851,1361398503947,1819872223,1819884319,12096
1361398511,1819891412,12,999,83.25,1361398492514,1361398503906,1819872926,1819884318,11392
1361398781,1820161360,3,447,149,1361398755731,1361398761747,1820136091,1820142107,6016
1361398849,1820229532,2,122,61,1361398822627,1361398824739,1820203159,1820205271,2112
1361399394,1820774648,3,447,149,1361399369639,1361399375655,1820750287,1820756303,6016
1361400012,1821392024,3,447,149,1361399984207,1361399990287,1821364231,1821370311,6080
1361400124,1821504252,13,6234,479.5384615,1361400096938,1361400097258,1821477190,1821477510,320
1361400124,1821504280,9,861,95.66666667,1361400097550,1361400097742,1821477830,1821478022,192
1361400124,1821504388,9,861,95.66666667,1361400097184,1361400097376,1821477572,1821477764,192
1361400124,1821504396,9,861,95.66666667,1361400097752,1361400097944,1821478148,1821478340,192
1361400193,1821573012,3,138,46,1361400191382,1361400191446,1821571394,1821571458,64
1361400193,1821573028,3,138,46,1361400191369,1361400191433,1821571397,1821571461,64
1361400193,1821573028,3,138,46,1361400191369,1361400191433,1821571397,1821571461,64
1361400193,1821573116,3,138,46,1361400191279,1361400191343,1821571395,1821571459,64
1361400209,1821589044,11,953,86.63636364,1361400194040,1361400206136,1821574084,1821586180,12096
1361400209,1821589048,12,999,83.25,1361400194803,1361400206131,1821574851,1821586179,11328
1361400209,1821589068,11,953,86.63636364,1361400194527,1361400206111,1821574595,1821586179,11584
1361400209,1821589152,11,953,86.63636364,1361400194186,1361400206026,1821574338,1821586178,11840
1361400257,1821637128,11,953,86.63636364,1361400243426,1361400254690,1821623554,1821634818,11264
1361400257,1821637208,11,953,86.63636364,1361400242516,1361400254612,1821622724,1821634820,12096
1361400257,1821637208,11,953,86.63636364,1361400242771,1361400254611,1821622979,1821634819,11840
1361400257,1821637212,11,953,86.63636364,1361400243087,1361400254607,1821623299,1821634819,11520
1361400281,1821660820,11,3267,297,1361400253719,1361400254231,1821633539,1821634051,512
1361400369,1821749524,3,193,64.33333333,1361400368343,1361400368343,1821748867,1821748867,0
1361400385,1821765424,15,6289,419.2666667,1361400372729,1361400384825,1821753153,1821765249,12096
1361400385,1821765512,12,999,83.25,1361400373025,1361400384737,1821753537,1821765249,11712
1361400385,1821765516,12,999,83.25,1361400373275,1361400384731,1821753791,1821765247,11456
1361400385,1821765520,12,999,83.25,1361400373595,1361400384667,1821754115,1821765187,11072
1361400582,1821961896,8,815,101.875,1361400555847,1361400556039,1821935743,1821935935,192
1361400582,1821961900,8,815,101.875,1361400556417,1361400556545,1821936317,1821936445,128
1361400582,1821961928,8,815,101.875,1361400556647,1361400556775,1821936575,1821936703,128
1361400582,1821962008,9,861,95.66666667,1361400555988,1361400556180,1821935996,1821936188,192
1361400622,1822002200,3,447,149,1361400596244,1361400602260,1821976444,1821982460,6016
1361400867,1822246920,3,189,63,1361400861226,1361400864234,1822241146,1822244154,3008
1361400867,1822246920,3,189,63,1361400861160,1361400864168,1822241080,1822244088,3008
1361400883,1822263012,2,126,63,1361400868109,1361400876173,1822248121,1822256185,8064
1361400883,1822263012,2,126,63,1361400868172,1361400876236,1822248184,1822256248,8064
1361400899,1822278868,12,999,83.25,1361400882525,1361400893405,1822262393,1822273273,10880
1361400899,1822278872,11,953,86.63636364,1361400883034,1361400893338,1822262906,1822273210,10304
1361400899,1822278952,12,999,83.25,1361400882695,1361400893255,1822262647,1822273207,10560
1361400899,1822279036,11,953,86.63636364,1361400882103,1361400893239,1822262139,1822273275,11136
1361400915,1822294924,1,63,63,1361400888679,1361400888679,1822268603,1822268603,0
1361400915,1822295036,1,63,63,1361400888566,1361400888566,1822268602,1822268602,0
1361401237,1822617208,1,46,46,1361401208709,1361401208709,1822588917,1822588917,0
1361401237,1822617336,3,447,149,1361401208836,1361401214852,1822589172,1822595188,6016
1361402045,1823425484,16,6372,398.25,1361402031203,1361402043171,1823411687,1823423655,11968
1361402045,1823425508,12,999,83.25,1361402031565,1361402043149,1823412073,1823423657,11584
1361402045,1823425512,11,953,86.63636364,1361402031817,1361402043145,1823412329,1823423657,11328
1361402045,1823425512,12,999,83.25,1361402032135,1361402043143,1823412647,1823423655,11008
1361403858,1825237916,11,953,86.63636364,1361403847296,1361403855040,1825227212,1825234956,7744
1361403858,1825237920,11,953,86.63636364,1361403847614,1361403855038,1825227534,1825234958,7424
1361403858,1825237936,11,953,86.63636364,1361403847851,1361403855019,1825227787,1825234955,7168
1361403889,1825269648,13,6234,479.5384615,1361403864101,1361403864421,1825244749,1825245069,320
1361403889,1825269668,9,861,95.66666667,1361403864464,1361403864656,1825245132,1825245324,192
1361403893,1825273412,9,861,95.66666667,1361403865298,1361403865426,1825245710,1825245838,128
1361403893,1825273576,8,815,101.875,1361403864810,1361403865002,1825245386,1825245578,192
1361404097,1825477740,3,189,63,1361404093507,1361404096579,1825474247,1825477319,3072
1361404114,1825493796,2,126,63,1361404101556,1361404109556,1825481352,1825489352,8000
1361404121,1825501772,3,189,63,1361404115685,1361404118693,1825496457,1825499465,3008
1361404122,1825501832,3,189,63,1361404116690,1361404119762,1825496522,1825499594,3072
1361404137,1825517764,2,126,63,1361404122796,1361404130796,1825503560,1825511560,8000
1361404137,1825517768,2,126,63,1361404122857,1361404130921,1825503625,1825511689,8064
1361404250,1825629952,3,189,63,1361404245272,1361404248344,1825625224,1825628296,3072
1361404266,1825646060,2,126,63,1361404252204,1361404260268,1825632264,1825640328,8064
1361405461,465154508,1,46,46,1361405434334,1361405434334,465127842,465127842,0
1361405651,1827031092,2,92,46,1361405650486,1361405650486,1827030578,1827030578,0
1361405651,1827031144,2,92,46,1361405650433,1361405650433,1827030577,1827030577,0
1361405651,1827031172,2,92,46,1361405650407,1361405650407,1827030579,1827030579,0
1361405651,1827031172,2,92,46,1361405650407,1361405650407,1827030579,1827030579,0
1361405677,1827057188,9,861,95.66666667,1361405651860,1361405652052,1827032048,1827032240,192
1361405677,1827057224,9,861,95.66666667,1361405652339,1361405652531,1827032563,1827032755,192
1361405677,1827057272,14,6617,472.6428571,1361405651392,1361405651712,1827031664,1827031984,320
1361405677,1827057308,9,861,95.66666667,1361405651997,1361405652189,1827032305,1827032497,192
1361405891,1827271308,3,189,63,1361405886617,1361405889689,1827266925,1827269997,3072
1361405907,1827287212,2,126,63,1361405893819,1361405901819,1827274031,1827282031,8000
1361405907,1827287332,2,126,63,1361405903872,1361405904896,1827284204,1827285228,1024
1361405915,1827295276,3,189,63,1361405908858,1361405911930,1827289134,1827292206,3072
1361405915,1827295284,2,126,63,1361405906930,1361405910962,1827287214,1827291246,4032
1361405931,1827311232,2,126,63,1361405916005,1361405924005,1827296237,1827304237,8000
1361405945,1827325544,1,63,63,1361405918766,1361405918766,1827299310,1827299310,0
1361405995,1827375400,3,189,63,1361405989820,1361405992892,1827370220,1827373292,3072
1361406011,1827391396,2,126,63,1361405996928,1361406004928,1827377324,1827385324,8000
1361406427,1827807528,15,6289,419.2666667,1361406412853,1361406423029,1827793381,1827803557,10176
1361406427,1827807552,12,999,83.25,1361406413468,1361406423004,1827794020,1827803556,9536
1361406427,1827807608,12,999,83.25,1361406413157,1361406422949,1827793765,1827803557,9792
1361406439,1827819172,1,46,46,1361406412187,1361406412187,1827792359,1827792359,0
1361406660,1828039984,15,6289,419.2666667,1361406644820,1361406656916,1828024804,1828036900,12096
1361406660,1828039988,12,999,83.25,1361406645519,1361406656911,1828025507,1828036899,11392
1361406660,1828040064,12,999,83.25,1361406645122,1361406656834,1828025186,1828036898,11712
1361406660,1828040068,11,953,86.63636364,1361406645693,1361406656829,1828025761,1828036897,11136
1361406992,1828372544,1,56,56,1361406964382,1361406964382,1828344926,1828344926,0
1361406996,1828376520,6,384,64,1361406969651,1361406975411,1828350171,1828355931,5760
1361406996,1828376536,6,384,64,1361406970791,1361406976231,1828351327,1828356767,5440
1361406996,1828376556,2,120,60,1361406971151,1361406974095,1828351707,1828354651,2944
1361406996,1828376708,6,384,64,1361406970619,1361406976059,1828351327,1828356767,5440
1361407217,1828597012,2,96,48,1361407192367,1361407195375,1828572379,1828575387,3008
1361407249,1828628912,2,230,115,1361407222290,1361407222354,1828602202,1828602266,64
1361407557,1828937752,2,104,52,1361407531269,1361407534213,1828912021,1828914965,2944
1361407565,1828945672,2,100,50,1361407537365,1361407540437,1828918037,1828921109,3072
1361407569,1828949728,2,96,48,1361407543386,1361407546458,1828924114,1828927186,3072
1361407577,1828957756,1,48,48,1361407552448,1361407552448,1828933204,1828933204,0
1361407589,1828969732,1,48,48,1361407563481,1361407563481,1828944213,1828944213,0
1361407601,1828981772,1,48,48,1361407574449,1361407574449,1828955221,1828955221,0
1361407614,1828993912,1,48,48,1361407586317,1361407586317,1828966229,1828966229,0
1361407622,1829001788,1,48,48,1361407597447,1361407597447,1828977235,1828977235,0
1361407719,1829099760,1,48,48,1361407693243,1361407693243,1829074003,1829074003,0
1361407720,1829099764,1,48,48,1361407694237,1361407694237,1829074001,1829074001,0
1361407720,1829100604,1,48,48,1361407693396,1361407693396,1829074000,1829074000,0
1361407991,1829371396,2,116,58,1361407986784,1361407987808,1829367180,1829368204,1024
1361407991,1829371448,7,436,62.28571429,1361407981488,1361407987760,1829361936,1829368208,6272
1361408011,1829390832,4,256,64,1361407984215,1361407987351,1829364047,1829367183,3136
1361408011,1829390832,4,256,64,1361407984215,1361407987351,1829364047,1829367183,3136
1361408011,1829390940,4,256,64,1361407983017,1361407986089,1829362957,1829366029,3072
1361408472,1829852492,12,999,83.25,1361408461946,1361408469498,1829842438,1829849990,7552
1361408472,1829852492,12,999,83.25,1361408462201,1361408469497,1829842693,1829849989,7296
1361408472,1829852524,12,999,83.25,1361408462427,1361408469467,1829842951,1829849991,7040
1361408504,1829884384,9,861,95.66666667,1361408476773,1361408476965,1829857157,1829857349,192
1361408504,1829884388,8,815,101.875,1361408477026,1361408477218,1829857414,1829857606,192
1361408504,1829884420,8,815,101.875,1361408477571,1361408477763,1829857991,1829858183,192
1361408504,1829884552,9,861,95.66666667,1361408477117,1361408477309,1829857669,1829857861,192
1361408548,1829928648,3,414,138,1361408520540,1361408526556,1829901188,1829907204,6016
1361408669,1830048884,5,320,64,1361408643865,1361408647897,1830023749,1830027781,4032
1361408669,1830048884,5,320,64,1361408643864,1361408647896,1830023748,1830027780,4032
1361408669,1830048924,6,384,64,1361408641649,1361408646641,1830021573,1830026565,4992
1361408669,1830048956,6,384,64,1361408642705,1361408647697,1830022661,1830027653,4992
1361408721,1830101276,3,189,63,1361408714064,1361408717072,1830094340,1830097348,3008
1361408737,1830117224,2,126,63,1361408721154,1361408729218,1830101378,1830109442,8064
1361408761,1830141276,2,126,63,1361408758029,1361408759053,1830138305,1830139329,1024
1361408769,1830149064,3,450,150,1361408744226,1361408750242,1830124290,1830130306,6016
1361408769,1830149284,2,126,63,1361408761030,1361408765062,1830141314,1830145346,4032
1361408801,1830181480,1,63,63,1361408772930,1361408772930,1830153410,1830153410,0
1361408809,1830189616,3,189,63,1361408802427,1361408805435,1830183043,1830186051,3008
1361408817,1830197640,4,252,63,1361408807906,1361408814946,1830188546,1830195586,7040
1361408825,1830205612,2,126,63,1361408809470,1361408817534,1830190082,1830198146,8064
1361408849,1830229548,1,63,63,1361408823099,1361408823099,1830203647,1830203647,0
1361409070,1830450108,2,120,60,1361409043507,1361409046451,1830423615,1830426559,2944
1361409074,1830453920,2,120,60,1361409046127,1361409048623,1830426047,1830428543,2496
1361409074,1830454032,2,120,60,1361409046013,1361409048509,1830426045,1830428541,2496
1361409074,1830454080,1,60,60,1361409047439,1361409047439,1830427519,1830427519,0
1361409114,1830494164,2,104,52,1361409089723,1361409092731,1830469887,1830472895,3008
1361409114,1830494480,2,104,52,1361409087167,1361409090175,1830467647,1830470655,3008
1361409114,1830494512,2,104,52,1361409088219,1361409091227,1830468731,1830471739,3008
1361409114,1830494524,2,104,52,1361409089361,1361409092305,1830469885,1830472829,2944
1361409162,1830542412,3,432,144,1361409136576,1361409142592,1830516988,1830523004,6016
1361409210,1830590388,2,104,52,1361409182359,1361409185303,1830562747,1830565691,2944
1361409414,1830794580,2,128,64,1361409389270,1361409392150,1830769850,1830772730,2880
1361409434,1830814664,1,48,48,1361409408510,1361409408510,1830789174,1830789174,0
1361409531,1830911044,3,150,50,1361409520169,1361409529833,1830900213,1830909877,9664
1361409543,1830922856,2,104,52,1361409517798,1361409520870,1830897654,1830900726,3072
1361409546,1830926664,2,104,52,1361409518144,1361409521152,1830898808,1830901816,3008
1361409546,1830926700,2,104,52,1361409519195,1361409522203,1830899895,1830902903,3008
1361410088,1831467932,3,447,149,1361410063504,1361410069520,1831443436,1831449452,6016
1361410293,1831672800,7,1966,280.8571429,1361410289620,1361410289876,1831669420,1831669676,256
1361410293,1831672824,8,2018,252.25,1361410290171,1361410290427,1831669995,1831670251,256
1361410293,1831672884,8,2018,252.25,1361410289855,1361410290111,1831669739,1831669995,256
1361410296,1831676468,9,861,95.66666667,1361410268281,1361410268409,1831648749,1831648877,128
1361410296,1831676468,9,861,95.66666667,1361410267958,1361410268150,1831648426,1831648618,192
1361410296,1831676592,9,861,95.66666667,1361410268410,1361410268602,1831649002,1831649194,192
1361410312,1831692508,1,108,108,1361410285390,1361410285390,1831665898,1831665898,0
1361410312,1831692512,1,108,108,1361410285452,1361410285452,1831665964,1831665964,0
1361410312,1831692596,2,216,108,1361410285173,1361410285301,1831665769,1831665897,128
1361410349,1831728944,8,3305,413.125,1361410343619,1361410344067,1831723563,1831724011,448
1361410349,1831728944,18,14522,806.7777778,1361410347202,1361410348226,1831727146,1831728170,1024
1361410356,1831736636,5,250,50,1361410327887,1361410350223,1831708523,1831730859,22336
1361410357,1831736844,4,479,119.75,1361410352807,1361410352871,1831732651,1831732715,64
1361410357,1831736844,9,2664,296,1361410349094,1361410349542,1831728938,1831729386,448
1361410357,1831736852,13,4076,313.5384615,1361410349982,1361410353374,1831729834,1831733226,3392
1361410357,1831736924,8,2021,252.625,1361410349080,1361410349144,1831729004,1831729068,64
1361410358,470051864,5,1778,355.6,1361410342494,1361410357534,470036358,470051398,15040
1361410365,1831744880,10,3261,326.1,1361410345794,1361410361154,1831725674,1831741034,15360
1361410372,1831752568,1,108,108,1361410346129,1361410346129,1831726697,1831726697,0
1361410372,1831752612,12,3002,250.1666667,1361410347430,1361410364390,1831728042,1831745002,16960
1361410372,1831752692,1,108,108,1361410345943,1361410345943,1831726635,1831726635,0
1361410372,1831752692,1,108,108,1361410346070,1361410346070,1831726762,1831726762,0
1361410373,1831752856,2,92,46,1361410365018,1361410365018,1831744874,1831744874,0
1361410373,1831752892,41,56415,1375.97561,1361410366773,1361410367029,1831746665,1831746921,256
1361410373,1831752900,28,37571,1341.821429,1361410370607,1361410370927,1831750507,1831750827,320
1361410373,1831752984,82,118632,1446.731707,1361410370844,1361410371356,1831750828,1831751340,512
1361410373,1831752988,51,70793,1388.098039,1361410371607,1361410371799,1831751595,1831751787,192
1361410373,1831752988,11,10745,976.8181818,1361410371479,1361410371607,1831751467,1831751595,128
1361410381,1831760856,4,700,175,1361410365209,1361410380249,1831745065,1831760105,15040
1361410388,1831768732,3,432,144,1361410362157,1361410368173,1831742889,1831748905,6016
1361410389,1831768948,8,1971,246.375,1361410368895,1361410387199,1831748843,1831767147,18304
1361410389,1831768952,21,4456,212.1904762,1361410369339,1361410387195,1831749291,1831767147,17856
1361410392,1831772692,16,5156,322.25,1361410364630,1361410366550,1831745322,1831747242,1920
1361410401,1831780780,1,48,48,1361410375591,1361410375591,1831755371,1831755371,0
1361410412,1831792644,1,52,52,1361410386310,1361410386310,1831766954,1831766954,0
1361410413,1831792768,20,4317,215.85,1361410387377,1361410407089,1831767145,1831786857,19712
1361410432,1831812612,1,48,48,1361410404006,1361410404006,1831784618,1831784618,0
1361410432,1831812688,1,66,66,1361410406551,1361410406551,1831787239,1831787239,0
1361410473,1831852844,2,112,56,1361410447971,1361410449443,1831827815,1831829287,1472
1361410501,1831881212,5,802,160.4,1361410483892,1361410498996,1831864104,1831879208,15104
1361410509,1831888864,1,46,46,1361410484111,1361410484111,1831863975,1831863975,0
1361410513,1831892856,2,112,56,1361410487383,1361410488471,1831867239,1831868327,1088
1361410525,1831905192,4,252,63,1361410517512,1361410524552,1831897704,1831904744,7040
1361410525,1831905240,4,252,63,1361410516057,1361410523097,1831896297,1831903337,7040
1361410533,1831913188,2,92,46,1361410525131,1361410525195,1831905319,1831905383,64
1361410549,1831929184,4,252,63,1361410541777,1361410548817,1831921961,1831929001,7040
1361410552,470245600,1,46,46,1361410525350,1361410525350,470218950,470218950,0
1361410553,1831932836,1,46,46,1361410525549,1361410525549,1831905385,1831905385,0
1361410557,1831936868,1,63,63,1361410531531,1361410531531,1831911399,1831911399,0
1361410561,1831940924,1,63,63,1361410532885,1361410532885,1831912809,1831912809,0
1361410585,1831964840,1,63,63,1361410557222,1361410557222,1831937062,1831937062,0
1361410665,1832044924,1,108,108,1361410636882,1361410636882,1832016806,1832016806,0
1361410665,1832044928,2,216,108,1361410637007,1361410637071,1832016935,1832016999,64
1361410665,1832045044,2,216,108,1361410636954,1361410637082,1832016998,1832017126,128
1361410737,1832117252,8,815,101.875,1361410711178,1361410711370,1832091430,1832091622,192
1361410737,1832117276,8,815,101.875,1361410711409,1361410711601,1832091685,1832091877,192
1361410926,1832305892,3,138,46,1361410922796,1361410922860,1832302688,1832302752,64
1361410926,1832305896,3,138,46,1361410922859,1361410922923,1832302755,1832302819,64
1361410942,1832322044,11,953,86.63636364,1361410925972,1361410937748,1832306016,1832317792,11776
1361410942,1832322048,12,999,83.25,1361410926226,1361410937746,1832306274,1832317794,11520
1361410942,1832322048,12,999,83.25,1361410926481,1361410937745,1832306529,1832317793,11264
1361410942,1832322104,12,999,83.25,1361410925656,1361410937752,1832305760,1832317856,12096
1361410950,470644148,5,574,114.8,1361410942786,1361410942850,470636934,470636998,64
1361411206,1832586324,3,450,150,1361411180409,1361411186489,1832560733,1832566813,6080
1361411226,1832606520,2,230,115,1361411201078,1361411201142,1832581598,1832581662,64
1361411366,1832746620,2,122,61,1361411339727,1361411341839,1832720347,1832722459,2112
1361411542,1832922736,2,96,48,1361411515545,1361411518553,1832896281,1832899289,3008
1361411543,1832922768,2,96,48,1361411517598,1361411520606,1832897366,1832900374,3008
1361411543,1832922808,2,96,48,1361411515382,1361411518326,1832895190,1832898134,2944
1361411543,1832922884,2,96,48,1361411517483,1361411520491,1832897367,1832900375,3008
1361411603,1832983216,3,435,145,1361411576608,1361411582624,1832956824,1832962840,6016
1361411691,1833071320,1,46,46,1361411664437,1361411664437,1833044757,1833044757,0
1361411775,1833155296,1,46,46,1361411748494,1361411748494,1833128790,1833128790,0
1361411847,1833227352,3,144,48,1361411821011,1361411829907,1833201363,1833210259,8896
1361411847,1833227384,3,144,48,1361411821810,1361411830834,1833202194,1833211218,9024
1361411851,1833231608,3,144,48,1361411826258,1361411835154,1833206866,1833215762,8896
1361411851,1833231612,3,144,48,1361411826254,1361411835150,1833206866,1833215762,8896
1361412124,1833503944,2,122,61,1361412096743,1361412098983,1833476687,1833478927,2240
1361412192,1833572092,2,120,60,1361412167380,1361412170580,1833547472,1833550672,3200
1361412192,1833572140,2,120,60,1361412165091,1361412168099,1833545231,1833548239,3008
1361412192,1833572260,2,120,60,1361412166188,1361412169068,1833546448,1833549328,2880
1361412192,1833572292,2,120,60,1361412167178,1361412170378,1833547470,1833550670,3200
1361412380,1833760400,1,52,52,1361412352666,1361412352666,1833733066,1833733066,0
1361412525,1833905036,2,96,48,1361412497284,1361412500164,1833877320,1833880200,2880
1361412636,1834016276,1,48,48,1361412609170,1361412609170,1833989446,1833989446,0
1361412636,1834016280,1,48,48,1361412609105,1361412609105,1833989385,1833989385,0
1361412683,1834063308,1,48,48,1361412655858,1361412655858,1834036166,1834036166,0
1361412685,1834065216,1,48,48,1361412655888,1361412655888,1834036104,1834036104,0
1361412697,1834077628,3,447,149,1361412672308,1361412678324,1834052936,1834058952,6016
1361412755,1834135072,11,953,86.63636364,1361412742813,1361412749853,1834122885,1834129925,7040
1361412755,1834135152,17,6755,397.3529412,1361412742350,1361412749838,1834122502,1834129990,7488
1361412755,1834135188,11,953,86.63636364,1361412742955,1361412749739,1834123143,1834129927,6784
1361412786,1834165752,8,815,101.875,1361412759132,1361412759324,1834138884,1834139076,192
1361412786,1834165836,9,861,95.66666667,1361412758538,1361412758666,1834138374,1834138502,128
1361412786,1834165840,8,815,101.875,1361412758788,1361412758980,1834138628,1834138820,192
1361412786,1834165872,9,861,95.66666667,1361412759332,1361412759460,1834139204,1834139332,128
1361413003,1834383332,3,189,63,1361412999509,1361413002517,1834379841,1834382849,3008
1361413019,1834399232,2,126,63,1361413006649,1361413014713,1834386881,1834394945,8064
1361413059,1834439264,3,189,63,1361413054681,1361413057689,1834434945,1834437953,3008
1361413075,1834455304,2,126,63,1361413061679,1361413069743,1834441983,1834450047,8064
1361413163,1834543288,3,189,63,1361413159361,1361413162369,1834539649,1834542657,3008
1361413179,1834559340,2,126,63,1361413166346,1361413174410,1834546686,1834554750,8064
1361413187,1834567348,4,252,63,1361413178244,1361413185284,1834558592,1834565632,7040
1361413219,1834598980,1,63,63,1361413193713,1361413193713,1834573693,1834573693,0
1361413315,1834695008,3,450,150,1361413287319,1361413293399,1834667327,1834673407,6080
1361413347,1834727216,2,104,52,1361413322692,1361413325636,1834702908,1834705852,2944
1361413499,1834879516,2,96,48,1361413474840,1361413477784,1834855356,1834858300,2944
1361413805,1835184924,12,999,83.25,1361413794211,1361413804003,1835174135,1835183927,9792
1361413805,1835184928,11,953,86.63636364,1361413794718,1361413803998,1835174646,1835183926,9280
1361413805,1835184928,11,953,86.63636364,1361413794461,1361413803997,1835174389,1835183925,9536
1361413805,1835185064,14,4789,342.0714286,1361413793684,1361413803860,1835173748,1835183924,10176
1361413925,1835304960,3,450,150,1361413898940,1361413905020,1835278900,1835284980,6080
1361414078,1835457792,12,999,83.25,1361414060064,1361414071776,1835439856,1835451568,11712
1361414078,1835457844,17,6418,377.5294118,1361414059568,1361414071728,1835439412,1835451572,12160
1361414078,1835457868,12,999,83.25,1361414060247,1361414071639,1835440115,1835451507,11392
1361414078,1835457868,11,953,86.63636364,1361414060502,1361414071638,1835440370,1835451506,11136
1361414286,1835666448,1,46,46,1361414257421,1361414257421,1835637869,1835637869,0
1361414287,1835667300,1,46,46,1361414257633,1361414257633,1835637933,1835637933,0
1361414539,1835918780,3,450,150,1361414512552,1361414518568,1835892332,1835898348,6016
1361414647,1836027164,3,447,149,1361414618918,1361414624934,1835999082,1836005098,6016
1361414695,1836075536,11,953,86.63636364,1361414681584,1361414692720,1836062120,1836073256,11136
1361414695,1836075584,16,6372,398.25,1361414680577,1361414692673,1836061161,1836073257,12096
1361414695,1836075588,12,999,83.25,1361414681021,1361414692669,1836061609,1836073257,11648
1361414695,1836075592,12,999,83.25,1361414681271,1361414692663,1836061863,1836073255,11392
1361414759,1836139556,12,1030,85.83333333,1361414746586,1361414757786,1836127142,1836138342,11200
1361414759,1836139600,11,953,86.63636364,1361414745711,1361414757807,1836126311,1836138407,12096
1361414759,1836139604,12,999,83.25,1361414745963,1361414757739,1836126567,1836138343,11776
1361414759,1836139604,12,999,83.25,1361414746282,1361414757738,1836126886,1836138342,11456
1361414767,1836147676,7,4893,699,1361414743522,1361414766050,1836124198,1836146726,22528
1361415112,1836492604,1,46,46,1361415087207,1361415087207,1836467811,1836467811,0
1361415207,1836587664,12,999,83.25,1361415192041,1361415201001,1836572705,1836581665,8960
1361415207,1836587672,12,999,83.25,1361415191327,1361415200991,1836571999,1836581663,9664
1361415207,1836587676,18,6801,377.8333333,1361415191647,1361415200991,1836572323,1836581667,9344
1361415217,1836596988,11,3267,297,1361415191116,1361415191820,1836571104,1836571808,704
1361415240,1836619812,3,193,64.33333333,1361415239484,1361415239484,1836619296,1836619296,0
1361415257,1836637044,3,444,148,1361415232724,1361415238740,1836612768,1836618784,6016
1361415269,1836649096,9,861,95.66666667,1361415242529,1361415242721,1836622625,1836622817,192
1361415269,1836649100,8,815,101.875,1361415243098,1361415243290,1836623198,1836623390,192
1361415269,1836649188,9,861,95.66666667,1361415242180,1361415242372,1836622368,1836622560,192
1361415269,1836649196,9,861,95.66666667,1361415242746,1361415242874,1836622942,1836623070,128
1361415496,1836875948,3,189,63,1361415491890,1361415494898,1836871838,1836874846,3008
1361415496,1836875948,3,189,63,1361415491890,1361415494898,1836871838,1836874846,3008
1361415512,1836891904,2,126,63,1361415498972,1361415507036,1836878876,1836886940,8064
1361415512,1836891980,2,126,63,1361415498896,1361415506960,1836878876,1836886940,8064
1361415520,1836899980,4,252,63,1361415512463,1361415519503,1836892443,1836899483,7040
1361415529,1836909704,9,861,95.66666667,1361415503228,1361415503420,1836883932,1836884124,192
1361415530,1836909784,14,6617,472.6428571,1361415503508,1361415503828,1836883292,1836883612,320
1361415530,1836909824,8,815,101.875,1361415504363,1361415504555,1836884187,1836884379,192
1361415530,1836909880,9,861,95.66666667,1361415503795,1361415503987,1836883675,1836883867,192
1361415554,1836933872,1,63,63,1361415527676,1361415527676,1836907548,1836907548,0
1361415576,1836955972,3,189,63,1361415571096,1361415574104,1836951068,1836954076,3008
1361415592,1836971940,2,126,63,1361415578167,1361415586231,1836958107,1836966171,8064
1361415760,1837140232,4,252,63,1361415751375,1361415758415,1837131607,1837138647,7040
1361415784,1837164188,3,189,63,1361415779196,1361415782268,1837159384,1837162456,3072
1361415784,1837164188,3,189,63,1361415779196,1361415782268,1837159384,1837162456,3072
1361415794,1837174236,1,63,63,1361415766476,1361415766476,1837146712,1837146712,0
1361415800,1837180220,2,126,63,1361415786269,1361415794269,1837166489,1837174489,8000
1361415800,1837180220,2,126,63,1361415786269,1361415794269,1837166489,1837174489,8000
1361415848,1837228180,4,252,63,1361415840068,1361415847108,1837220248,1837227288,7040
1361415874,1837254364,3,444,148,1361415846665,1361415852745,1837227029,1837233109,6080
1361415882,1837262384,1,63,63,1361415854967,1361415854967,1837235351,1837235351,0
1361416096,1837476428,12,999,83.25,1361416077639,1361416088391,1837458067,1837468819,10752
1361416096,1837476428,12,999,83.25,1361416077895,1361416088391,1837458323,1837468819,10496
1361416096,1837476504,17,6418,377.5294118,1361416076859,1361416088379,1837457363,1837468883,11520
1361416096,1837476508,12,999,83.25,1361416077239,1361416088311,1837457747,1837468819,11072
1361416299,1837679356,1,46,46,1361416272781,1361416272781,1837653137,1837653137,0
1361416488,1837867868,3,444,148,1361416461105,1361416467121,1837840973,1837846989,6016
1361416881,1838261340,1,46,46,1361416853780,1361416853780,1838234120,1838234120,0
1361417102,1838481776,3,447,149,1361417075396,1361417081476,1838455172,1838461252,6080
1361417711,1839091124,3,447,149,1361417685854,1361417691934,1839065978,1839072058,6080
1361417892,1839271772,11,953,86.63636364,1361417879739,1361417889019,1839259511,1839268791,9280
1361417892,1839271828,12,999,83.25,1361417879426,1361417888962,1839259254,1839268790,9536
1361418328,1839708032,3,447,149,1361418300019,1361418306099,1839680051,1839686131,6080
1361418776,1840156696,1,46,46,1361418749202,1361418749202,1840129898,1840129898,0
1361418941,1840320996,3,447,149,1361418913930,1361418920010,1840293926,1840300006,6080
1361419283,1840662960,1,46,46,1361419255531,1361419255531,1840635491,1840635491,0
1361419283,1840662992,1,46,46,1361419255562,1361419255562,1840635554,1840635554,0
1361419390,1840770056,11,953,86.63636364,1361419378184,1361419387208,1840758240,1840767264,9024
1361419390,1840770060,11,953,86.63636364,1361419378436,1361419387140,1840758496,1840767200,8704
1361419410,1840789784,11,3267,297,1361419385816,1361419386584,1840765600,1840766368,768
1361419554,1840934120,3,447,149,1361419526277,1361419532293,1840906397,1840912413,6016
1361419694,1841074712,2,141,70.5,1361419688117,1361419688117,1841068829,1841068829,0
1361419762,1841142664,1,46,46,1361419734692,1361419734692,1841115356,1841115356,0
1361419763,1841143056,1,46,46,1361419735044,1361419735044,1841115100,1841115100,0
1361419827,1841206864,1,46,46,1361419800961,1361419800961,1841180825,1841180825,0
1361419827,1841207232,1,46,46,1361419800788,1361419800788,1841181020,1841181020,0
1361420027,1841407008,11,3267,297,1361420001008,1361420001648,1841381016,1841381656,640
1361420167,1841547104,3,447,149,1361420140175,1361420146191,1841520279,1841526295,6016
1361420383,1841763700,2,141,70.5,1361420380404,1361420380404,1841761104,1841761104,0
1361420407,1841787364,11,3267,297,1361420380231,1361420380743,1841760595,1841761107,512
1361420624,1842003912,2,141,70.5,1361420619143,1361420619143,1841999055,1841999055,0
1361420643,1842023420,11,3267,297,1361420618060,1361420618700,1841998480,1841999120,640
1361420936,1842316608,2,141,70.5,1361420934796,1361420934796,1842315404,1842315404,0
1361421109,1842488952,11,3267,297,1361421083542,1361421084054,1842463494,1842464006,512
1361421201,1842581448,12,999,83.25,1361421182693,1361421194021,1842563141,1842574469,11328
1361421201,1842581504,15,6289,419.2666667,1361421181872,1361421193968,1842562376,1842574472,12096
1361421201,1842581508,12,999,83.25,1361421182379,1361421193963,1842562887,1842574471,11584
1361421201,1842581524,17,6755,397.3529412,1361421182874,1361421193882,1842563398,1842574406,11008
1361421662,1843041860,1,46,46,1361421635434,1361421635434,1843015294,1843015294,0
1361421706,1843086104,3,230,76.66666667,1361421688885,1361421701749,1843068989,1843081853,12864
1361421726,1843105880,11,3267,297,1361421701396,1361421702036,1843081276,1843081916,640
1361421838,1843218372,1,46,46,1361421811178,1361421811178,1843191550,1843191550,0
1361422019,1843398804,2,141,70.5,1361422013597,1361422013597,1843393401,1843393401,0
1361422039,1843419240,11,3267,297,1361422012648,1361422013288,1843392888,1843393528,640
1361422520,1843900384,1,60,60,1361422494993,1361422494993,1843875377,1843875377,0
1361422524,1843904160,1,439,439,1361422496436,1361422496436,1843876596,1843876596,0
1361422524,1843904160,1,440,440,1361422496436,1361422496436,1843876596,1843876596,0
1361422524,1843904160,1,441,441,1361422496435,1361422496435,1843876595,1843876595,0
1361422524,1843904160,1,439,439,1361422496499,1361422496499,1843876659,1843876659,0
1361422524,1843904160,1,439,439,1361422496499,1361422496499,1843876659,1843876659,0
1361422524,1843904160,1,439,439,1361422496434,1361422496434,1843876594,1843876594,0
1361422524,1843904160,1,440,440,1361422496498,1361422496498,1843876658,1843876658,0
1361422524,1843904160,1,441,441,1361422496562,1361422496562,1843876722,1843876722,0
1361422524,1843904160,1,441,441,1361422496561,1361422496561,1843876721,1843876721,0
1361422524,1843904160,1,441,441,1361422496561,1361422496561,1843876721,1843876721,0
1361422524,1843904160,1,441,441,1361422496496,1361422496496,1843876656,1843876656,0
1361422524,1843904160,1,440,440,1361422496496,1361422496496,1843876656,1843876656,0
1361422524,1843904164,1,439,439,1361422496496,1361422496496,1843876660,1843876660,0
1361422524,1843904164,1,439,439,1361422496496,1361422496496,1843876660,1843876660,0
1361422524,1843904184,1,441,441,1361422496474,1361422496474,1843876658,1843876658,0
1361422524,1843904184,1,442,442,1361422496536,1361422496536,1843876720,1843876720,0
1361422524,1843904184,1,439,439,1361422496536,1361422496536,1843876720,1843876720,0
1361422524,1843904308,1,442,442,1361422496288,1361422496288,1843876596,1843876596,0
1361422524,1843904308,1,441,441,1361422496288,1361422496288,1843876596,1843876596,0
1361422524,1843904308,1,440,440,1361422496288,1361422496288,1843876596,1843876596,0
1361422524,1843904308,1,441,441,1361422496287,1361422496287,1843876595,1843876595,0
1361422524,1843904308,1,441,441,1361422496287,1361422496287,1843876595,1843876595,0
1361422524,1843904308,1,442,442,1361422496287,1361422496287,1843876595,1843876595,0
1361422524,1843904308,1,440,440,1361422496351,1361422496351,1843876659,1843876659,0
1361422524,1843904308,1,439,439,1361422496350,1361422496350,1843876658,1843876658,0
1361422524,1843904308,1,441,441,1361422496350,1361422496350,1843876658,1843876658,0
1361422524,1843904308,1,442,442,1361422496350,1361422496350,1843876658,1843876658,0
1361422524,1843904308,1,441,441,1361422496414,1361422496414,1843876722,1843876722,0
1361422524,1843904308,1,441,441,1361422496413,1361422496413,1843876721,1843876721,0
1361422524,1843904308,1,441,441,1361422496413,1361422496413,1843876721,1843876721,0
1361422540,1843920156,1,60,60,1361422515380,1361422515380,1843895536,1843895536,0
1361422636,1844016576,1,441,441,1361422609105,1361422609105,1843989681,1843989681,0
1361422636,1844016576,1,441,441,1361422609169,1361422609169,1843989745,1843989745,0
1361422636,1844016576,1,439,439,1361422609169,1361422609169,1843989745,1843989745,0
1361422636,1844016576,1,441,441,1361422609169,1361422609169,1843989745,1843989745,0
1361422636,1844016576,1,440,440,1361422609168,1361422609168,1843989744,1843989744,0
1361422636,1844016576,1,441,441,1361422609232,1361422609232,1843989808,1843989808,0
1361422636,1844016576,1,441,441,1361422609232,1361422609232,1843989808,1843989808,0
1361422636,1844016576,1,440,440,1361422609231,1361422609231,1843989807,1843989807,0
1361422636,1844016580,1,441,441,1361422609227,1361422609227,1843989807,1843989807,0
1361422636,1844016580,1,441,441,1361422609099,1361422609099,1843989679,1843989679,0
1361422636,1844016580,1,441,441,1361422609162,1361422609162,1843989742,1843989742,0
1361422636,1844016580,1,442,442,1361422609165,1361422609165,1843989745,1843989745,0
1361422636,1844016580,1,442,442,1361422609165,1361422609165,1843989745,1843989745,0
1361422636,1844016580,1,442,442,1361422609165,1361422609165,1843989745,1843989745,0
1361422636,1844016580,1,440,440,1361422609229,1361422609229,1843989809,1843989809,0
1361422636,1844016580,1,441,441,1361422609291,1361422609291,1843989871,1843989871,0
1361422636,1844016696,1,439,439,1361422608986,1361422608986,1843989682,1843989682,0
1361422636,1844016696,1,441,441,1361422609049,1361422609049,1843989745,1843989745,0
1361422636,1844016696,1,441,441,1361422609049,1361422609049,1843989745,1843989745,0
1361422636,1844016696,1,439,439,1361422609049,1361422609049,1843989745,1843989745,0
1361422636,1844016696,1,441,441,1361422609048,1361422609048,1843989744,1843989744,0
1361422636,1844016696,1,442,442,1361422609048,1361422609048,1843989744,1843989744,0
1361422636,1844016696,1,441,441,1361422609112,1361422609112,1843989808,1843989808,0
1361422636,1844016696,1,442,442,1361422609111,1361422609111,1843989807,1843989807,0
1361422636,1844016696,1,441,441,1361422609111,1361422609111,1843989807,1843989807,0
1361422636,1844016696,1,442,442,1361422609111,1361422609111,1843989807,1843989807,0
1361422636,1844016696,1,440,440,1361422609111,1361422609111,1843989807,1843989807,0
1361422636,1844016696,1,441,441,1361422609111,1361422609111,1843989807,1843989807,0
1361422636,1844016696,1,439,439,1361422609175,1361422609175,1843989871,1843989871,0
1361422636,1844016700,1,439,439,1361422609106,1361422609106,1843989806,1843989806,0
1361422907,1844287704,2,141,70.5,1361422903628,1361422903628,1844284332,1844284332,0
1361423013,1844392944,9,861,95.66666667,1361422987844,1361422988036,1844367788,1844367980,192
1361423013,1844392972,9,861,95.66666667,1361422988133,1361422988261,1844368105,1844368233,128
1361423013,1844393024,12,6151,512.5833333,1361422987379,1361422987699,1844367403,1844367723,320
1361423013,1844393104,8,815,101.875,1361422988257,1361422988449,1844368361,1844368553,192
1361423013,1844393144,14,6751,482.2142857,1361422986873,1361422987193,1844367017,1844367337,320
1361423220,1844599828,3,189,63,1361423215347,1361423218419,1844595175,1844598247,3072
1361423236,1844615824,2,126,63,1361423233592,1361423234616,1844613416,1844614440,1024
1361423236,1844615832,2,126,63,1361423222446,1361423230446,1844602278,1844610278,8000
1361423244,1844623912,2,126,63,1361423236574,1361423240542,1844616486,1844620454,3968
1361423273,1844653428,1,63,63,1361423248090,1361423248090,1844628518,1844628518,0
1361423300,1844679836,3,189,63,1361423295017,1361423298089,1844674853,1844677925,3072
1361423316,1844695904,2,126,63,1361423302054,1361423310118,1844681958,1844690022,8064
1361423324,1844703888,3,189,63,1361423320311,1361423323319,1844700199,1844703207,3008
1361423324,1844703968,3,189,63,1361423320229,1361423323237,1844700197,1844703205,3008
1361423340,1844719960,2,126,63,1361423327279,1361423335343,1844707239,1844715303,8064
1361423340,1844719960,2,126,63,1361423327279,1361423335343,1844707239,1844715303,8064
1361423812,1845192168,17,6755,397.3529412,1361423792982,1361423804310,1845173150,1845184478,11328
1361423812,1845192172,11,953,86.63636364,1361423793364,1361423804308,1845173536,1845184480,10944
1361423812,1845192172,12,999,83.25,1361423793939,1361423804307,1845174111,1845184479,10368
1361423812,1845192264,12,999,83.25,1361423793592,1361423804216,1845173856,1845184480,10624
1361423819,1845198760,1,46,46,1361423793326,1361423793326,1845173086,1845173086,0
1361424055,1845435192,5,250,50,1361424028858,1361424050362,1845409050,1845430554,21504
1361424099,1845479288,1,48,48,1361424074716,1361424074716,1845455004,1845455004,0
1361424131,1845511276,1,48,48,1361424103973,1361424103973,1845484249,1845484249,0
1361424249,1845628752,1,46,46,1361424222066,1361424222066,1845601818,1845601818,0
1361424250,1845629932,1,46,46,1361424221885,1361424221885,1845601817,1845601817,0
1361425606,1846986240,12,999,83.25,1361425593846,1361425604534,1846974086,1846984774,10688
1361425606,1846986240,12,999,83.25,1361425594100,1361425604532,1846974340,1846984772,10432
1361425606,1846986300,12,999,83.25,1361425594358,1361425604470,1846974658,1846984770,10112
1361425606,1846986344,16,6372,398.25,1361425593292,1361425604428,1846973636,1846984772,11136
1361426720,1848100328,1,46,46,1361426695309,1361426695309,1848075637,1848075637,0
1361426912,1848292532,1,92,92,1361426884028,1361426884028,1848264560,1848264560,0
1361427028,1848408512,1,92,92,1361427002380,1361427002380,1848382892,1848382892,0
1361427421,1848801360,10,1244,124.4,1361427393695,1361427394911,1848774055,1848775271,1216
1361427421,1848801452,13,6197,476.6923077,1361427393093,1361427393541,1848773545,1848773993,448
1361427421,1848801484,9,861,95.66666667,1361427393893,1361427394085,1848774377,1848774569,192
1361427642,1849022000,9,861,95.66666667,1361427617605,1361427617797,1848997605,1848997797,192
1361427646,1849025824,9,861,95.66666667,1361427618035,1361427618227,1848997859,1848998051,192
1361427646,1849025828,9,861,95.66666667,1361427618289,1361427618481,1848998117,1848998309,192
1361427646,1849025920,8,815,101.875,1361427618518,1361427618646,1848998438,1848998566,128
1361427658,1849038108,2,126,63,1361427655257,1361427656217,1849035365,1849036325,960
1361427666,1849046148,2,126,63,1361427664177,1361427665201,1849044325,1849045349,1024
1361427666,1849046156,2,126,63,1361427658215,1361427662247,1849038371,1849042403,4032
1361427666,1849046156,3,189,63,1361427662119,1361427665127,1849042275,1849045283,3008
1361427674,1849054432,3,138,46,1361427666966,1361427667094,1849047398,1849047526,128
1361427674,1849054504,3,138,46,1361427666957,1361427667021,1849047461,1849047525,64
1361427674,1849054504,3,138,46,1361427666893,1361427667021,1849047397,1849047525,128
1361427674,1849054504,3,138,46,1361427666957,1361427667021,1849047461,1849047525,64
1361427698,1849078320,1,63,63,1361427670149,1361427670149,1849050469,1849050469,0
1361428264,1849643932,1,46,46,1361428236543,1361428236543,1849616475,1849616475,0
1361428985,1850365644,1,48,48,1361428957165,1361428957165,1850337809,1850337809,0
1361429492,1850872244,12,999,83.25,1361429473206,1361429484150,1850853450,1850864394,10944
1361429492,1850872244,11,953,86.63636364,1361429473717,1361429484149,1850853961,1850864393,10432
1361429492,1850872316,12,999,83.25,1361429473389,1361429484077,1850853705,1850864393,10688
1361430068,1851448680,12,999,83.25,1361430052089,1361430063481,1851432769,1851444161,11392
1361430068,1851448684,16,6372,398.25,1361430051381,1361430063541,1851432065,1851444225,12160
1361430069,1851448720,12,999,83.25,1361430053304,1361430064440,1851433024,1851444160,11136
1361430069,1851448724,12,999,83.25,1361430052789,1361430064437,1851432513,1851444161,11648
1361430216,1851595688,1,60,60,1361430187925,1361430187925,1851567613,1851567613,0
1361430216,1851595776,1,60,60,1361430187901,1361430187901,1851567677,1851567677,0
1361430404,1851784092,3,453,151,1361430378240,1361430384192,1851758332,1851764284,5952
1361431058,1852437936,2,104,52,1361431030481,1361431033489,1852410417,1852413425,3008
1361431058,1852437984,2,104,52,1361431032675,1361431035683,1852412659,1852415667,3008
1361431058,1852438048,2,104,52,1361431031455,1361431034463,1852411503,1852414511,3008
1361431058,1852438060,2,104,52,1361431032597,1361431035605,1852412657,1852415665,3008
1361431146,1852526184,2,96,48,1361431120729,1361431123737,1852500913,1852503921,3008
1361431234,1852614480,3,152,50.66666667,1361431209136,1361431218160,1852589616,1852598640,9024
1361431322,1852702524,1,46,46,1361431296834,1361431296834,1852677358,1852677358,0
1361431414,1852794544,9,861,95.66666667,1361431388843,1361431388971,1852769387,1852769515,128
1361431414,1852794572,8,815,101.875,1361431389072,1361431389264,1852769644,1852769836,192
1361431710,1853090112,3,189,63,1361431702870,1361431705878,1853082982,1853085990,3008
1361431726,1853106060,2,126,63,1361431709963,1361431717963,1853090023,1853098023,8000
1361431747,1853127148,1,63,63,1361431720629,1361431720629,1853100777,1853100777,0
1361431747,1853127148,8,815,101.875,1361431720945,1361431721137,1853101093,1853101285,192
1361431747,1853127168,9,861,95.66666667,1361431721183,1361431721375,1853101351,1853101543,192
1361431747,1853127172,9,861,95.66666667,1361431721436,1361431721628,1853101608,1853101800,192
1361431966,1853346488,4,252,63,1361431957786,1361431964826,1853338274,1853345314,7040
1361431971,1853351644,9,861,95.66666667,1361431946433,1361431946689,1853327077,1853327333,256
1361431971,1853351644,9,861,95.66666667,1361431946814,1361431947006,1853327458,1853327650,192
1361431972,1853351716,8,815,101.875,1361431947102,1361431947230,1853326818,1853326946,128
1361431975,1853355668,8,815,101.875,1361431947046,1361431947238,1853327714,1853327906,192
1361432000,1853379692,1,63,63,1361431973687,1361431973687,1853353379,1853353379,0
1361432006,1853386468,4,252,63,1361431998000,1361432005040,1853378468,1853385508,7040
1361432040,1853419696,1,63,63,1361432013876,1361432013876,1853393572,1853393572,0
1361432086,1853466672,2,126,63,1361432084129,1361432085089,1853464801,1853465761,960
1361432094,1853474684,2,126,63,1361432087127,1361432091159,1853467811,1853471843,4032
1361432128,1853507704,1,63,63,1361432100200,1361432100200,1853479904,1853479904,0
1361432206,1853586672,4,252,63,1361432198430,1361432205470,1853579102,1853586142,7040
1361432207,1853586680,4,252,63,1361432198401,1361432205441,1853578081,1853585121,7040
1361432240,1853619980,1,63,63,1361432213204,1361432213204,1853593184,1853593184,0
1361432240,1853619988,1,63,63,1361432214218,1361432214218,1853594206,1853594206,0
1361432247,1853626684,3,189,63,1361432240699,1361432243771,1853620383,1853623455,3072
1361432263,1853642764,2,126,63,1361432247724,1361432255724,1853627488,1853635488,8000
1361432287,1853666760,4,252,63,1361432277999,1361432285039,1853657759,1853664799,7040
1361432320,1853700124,1,63,63,1361432292737,1361432292737,1853672861,1853672861,0
1361432517,1853897032,1,46,46,1361432488668,1361432488668,1853868700,1853868700,0
1361432517,1853897036,1,46,46,1361432488792,1361432488792,1853868828,1853868828,0
1361432517,1853897084,1,46,46,1361432488807,1361432488807,1853868891,1853868891,0
1361432637,1854016912,1,48,48,1361432612177,1361432612177,1853992089,1853992089,0
1361432637,1854016964,1,48,48,1361432611740,1361432611740,1853991704,1853991704,0
1361432689,1854069036,1,46,46,1361432661589,1361432661589,1854041625,1854041625,0
1361432797,1854177020,3,162,54,1361432771745,1361432777761,1854151765,1854157781,6016
1361433150,1854529692,1,131,131,1361433122341,1361433122341,1854502033,1854502033,0
1361433258,1854638008,5,250,50,1361433230119,1361433251175,1854610127,1854631183,21056
1361433454,1854834148,8,496,62,1361433429210,1361433440218,1854809358,1854820366,11008
1361433454,1854834184,1,46,46,1361433427125,1361433427125,1854807309,1854807309,0
1361433534,1854914196,13,6234,479.5384615,1361433507046,1361433507302,1854887242,1854887498,256
1361433534,1854914204,8,815,101.875,1361433507679,1361433507871,1854887883,1854888075,192
1361433534,1854914208,8,815,101.875,1361433507934,1361433508126,1854888142,1854888334,192
1361433534,1854914276,9,861,95.66666667,1361433507351,1361433507543,1854887627,1854887819,192
1361433582,1854962324,6,298,49.66666667,1361433557032,1361433578792,1854937356,1854959116,21760
1361433596,493290224,3,919,306.3333333,1361433595084,1361433595148,493289308,493289372,64
1361433597,493291236,4,478,119.5,1361433596162,1361433596162,493290398,493290398,0
1361433598,1854978292,8,3305,413.125,1361433596040,1361433596488,1854976332,1854976780,448
1361433605,493299248,4,971,242.75,1361433600821,1361433601333,493295069,493295581,512
1361433607,1854987648,8,1424,178,1361433599457,1361433599841,1854980105,1854980489,384
1361433607,1854987648,11,3086,280.5454545,1361433602593,1361433603425,1854983241,1854984073,832
1361433607,1854987656,11,2790,253.6363636,1361433603292,1361433604700,1854983948,1854985356,1408
1361433607,1854987664,11,2046,186,1361433604500,1361433605908,1854985164,1854986572,1408
1361433607,1854987684,11,2534,230.3636364,1361433601790,1361433602686,1854982474,1854983370,896
1361433608,1854987700,11,3307,300.6363636,1361433597656,1361433607896,1854977356,1854987596,10240
1361433608,1854987700,10,1994,199.4,1361433602326,1361433602902,1854982026,1854982602,576
1361433608,1854987704,7,1969,281.2857143,1361433606228,1361433606612,1854985932,1854986316,384
1361433610,1854990388,3,144,48,1361433584741,1361433586213,1854965129,1854966601,1472
1361433615,1854995676,10,2913,291.3,1361433597704,1361433606984,1854978380,1854987660,9280
1361433615,1854995684,11,2870,260.9090909,1361433606784,1361433608128,1854987468,1854988812,1344
1361433616,1854995692,11,2046,186,1361433612829,1361433615005,1854992521,1854994697,2176
1361433616,1854995716,11,2854,259.4545455,1361433606789,1361433607941,1854986505,1854987657,1152
1361433616,1854995720,10,1994,199.4,1361433611457,1361433612801,1854991177,1854992521,1344
1361433616,1854995724,5,752,150.4,1361433599615,1361433607999,1854979339,1854987723,8384
1361433616,1854995728,11,2542,231.0909091,1361433609084,1361433610108,1854988812,1854989836,1024
1361433616,1854995732,11,2534,230.3636364,1361433610039,1361433611703,1854989771,1854991435,1664
1361433624,1855003700,10,1994,199.4,1361433614933,1361433617301,1854994633,1854997001,2368
1361433624,1855003712,11,2046,186,1361433617225,1361433621193,1854996937,1855000905,3968
1361433624,1855003740,7,1925,275,1361433607917,1361433623341,1854987657,1855003081,15424
1361433630,1855010392,1,108,108,1361433605026,1361433605026,1854985418,1854985418,0
1361433630,1855010392,1,108,108,1361433605089,1361433605089,1854985481,1854985481,0
1361433630,1855010428,1,48,48,1361433603133,1361433603133,1854983561,1854983561,0
1361433630,1855010472,1,108,108,1361433604883,1361433604883,1854985355,1854985355,0
1361433632,1855011692,11,2046,186,1361433625695,1361433630943,1855005387,1855010635,5248
1361433632,1855011732,9,1942,215.7777778,1361433620981,1361433625589,1855000713,1855005321,4608
1361433636,493330200,1,52,52,1361433610149,1361433610149,493304349,493304349,0
1361433639,1855019680,11,2902,263.8181818,1361433635393,1361433636033,1855016073,1855016713,640
1361433639,1855019684,11,2046,186,1361433633086,1361433635582,1855013770,1855016266,2496
1361433639,1855019684,10,2482,248.2,1361433635965,1361433636605,1855016649,1855017289,640
1361433640,1855019688,10,1994,199.4,1361433637540,1361433638564,1855017228,1855018252,1024
1361433640,1855019716,11,2542,231.0909091,1361433630406,1361433632646,1855010122,1855012362,2240
1361433640,1855019724,11,2662,242,1361433632511,1361433634239,1855012235,1855013963,1728
1361433647,1855027676,10,1994,199.4,1361433641607,1361433642247,1855022283,1855022923,640
1361433647,1855027680,8,1890,236.25,1361433642244,1361433642692,1855022924,1855023372,448
1361433647,1855027684,9,1942,215.7777778,1361433643325,1361433643709,1855024009,1855024393,384
1361433648,1855027688,11,2550,231.8181818,1361433640868,1361433641444,1855020556,1855021132,576
1361433648,1855027688,11,3078,279.8181818,1361433641379,1361433642147,1855021067,1855021835,768
1361433648,1855027720,13,4974,382.6153846,1361433640194,1361433640898,1855019914,1855020618,704
1361433648,1855027724,11,3598,327.0909091,1361433643584,1361433644288,1855023308,1855024012,704
1361433648,1855027728,9,1942,215.7777778,1361433644666,1361433645306,1855024394,1855025034,640
1361433648,1855027732,12,3402,283.5,1361433641973,1361433642677,1855021705,1855022409,704
1361433648,1855027752,11,2046,186,1361433638434,1361433640226,1855018186,1855019978,1792
1361433658,1855038392,1,48,48,1361433632164,1361433632164,1855012556,1855012556,0
1361433658,1855038460,1,46,46,1361433630301,1361433630301,1855010761,1855010761,0
1361433664,1855043744,99,8297,83.80808081,1361433646377,1361433663145,1855026121,1855042889,16768
1361433669,493363248,4,478,119.5,1361433665974,1361433666038,493360222,493360286,64
1361433670,1855050500,7,1379,197,1361433645237,1361433664821,1855025737,1855045321,19584
1361433672,1855051716,6,1349,224.8333333,1361433661700,1361433664580,1855041416,1855044296,2880
1361433672,1855051728,2,92,46,1361433665465,1361433665465,1855045193,1855045193,0
1361433686,1855066672,3,264,88,1361433660874,1361433664394,1855041546,1855045066,3520
1361433692,493386204,1,52,52,1361433664608,1361433664608,493358812,493358812,0
1361433800,1855179748,3,189,63,1361433795749,1361433798821,1855175497,1855178569,3072
1361433816,1855195932,2,126,63,1361433802667,1361433810667,1855182599,1855190599,8000
1361433824,1855203900,3,189,63,1361433820622,1361433823630,1855200522,1855203530,3008
1361433824,1855203936,3,189,63,1361433820582,1361433823590,1855200518,1855203526,3008
1361433824,1855203936,3,189,63,1361433820582,1361433823654,1855200518,1855203590,3072
1361433840,1855219916,2,126,63,1361433827645,1361433835709,1855207561,1855215625,8064
1361433840,1855219916,2,126,63,1361433827644,1361433835708,1855207560,1855215624,8064
1361433840,1855219948,2,126,63,1361433827612,1361433835676,1855207560,1855215624,8064
1361433919,1855298976,1,52,52,1361433891068,1361433891068,1855271044,1855271044,0
1361434275,1855655644,1,52,52,1361434248156,1361434248156,1855628800,1855628800,0
1361434420,1855799956,14,6617,472.6428571,1361434393865,1361434394185,1855773821,1855774141,320
1361434420,1855799980,9,861,95.66666667,1361434394225,1361434394417,1855774205,1855774397,192
1361434420,1855799984,9,861,95.66666667,1361434394480,1361434394672,1855774464,1855774656,192
1361434593,1855972776,3,189,63,1361434586493,1361434589565,1855966269,1855969341,3072
1361434609,1855988848,3,189,63,1361434603891,1361434606899,1855983739,1855986747,3008
1361434609,1855988880,2,126,63,1361434593490,1361434601490,1855973370,1855981370,8000
1361434617,1855996816,4,252,63,1361434608405,1361434615509,1855988221,1855995325,7104
1361434625,1856004896,2,126,63,1361434610884,1361434618948,1855990780,1855998844,8064
1361434649,1856028804,1,63,63,1361434623520,1361434623520,1856003324,1856003324,0
1361434673,1856053040,2,92,46,1361434671859,1361434671859,1856051899,1856051899,0
1361434673,1856053040,2,92,46,1361434671859,1361434671859,1856051899,1856051899,0
1361434673,1856053040,2,92,46,1361434671923,1361434671923,1856051963,1856051963,0
1361434701,1856080844,9,861,95.66666667,1361434673333,1361434673461,1856053177,1856053305,128
1361434701,1856080848,8,815,101.875,1361434673841,1361434674033,1856053689,1856053881,192
1361434701,1856080920,9,861,95.66666667,1361434673515,1361434673707,1856053435,1856053627,192
1361434701,1856080924,8,815,101.875,1361434674022,1361434674214,1856053946,1856054138,192
1361434889,1856269640,3,189,63,1361434882326,1361434885334,1856262966,1856265974,3008
1361434905,1856285624,2,126,63,1361434889385,1361434897449,1856270009,1856278073,8064
1361434978,1856357692,3,189,63,1361434974793,1361434977865,1856354485,1856357557,3072
1361434978,1856357700,2,126,63,1361434975424,1361434976448,1856355124,1856356148,1024
1361434985,1856365640,2,126,63,1361434977557,1361434981525,1856358197,1856362165,3968
1361434993,1856373648,2,126,63,1361434980942,1361434988942,1856361590,1856369590,8000
1361435017,1856397416,1,63,63,1361434989813,1361434989813,1856370229,1856370229,0
1361435058,1856437764,3,189,63,1361435051714,1361435054722,1856431478,1856434486,3008
1361435065,1856445492,1,131,131,1361435036970,1361435036970,1856417462,1856417462,0
1361435074,1856453752,2,126,63,1361435058764,1361435066828,1856438516,1856446580,8064
1361435399,1856779528,1,48,48,1361435371519,1361435371519,1856752047,1856752047,0
1361435401,1856780824,1,48,48,1361435372225,1361435372225,1856752049,1856752049,0
1361435401,1856780940,1,48,48,1361435372172,1361435372172,1856752112,1856752112,0
1361435652,1857032008,1,46,46,1361435624770,1361435624770,1857004778,1857004778,0
1361435652,1857032012,1,46,46,1361435624898,1361435624898,1857004910,1857004910,0
1361435653,1857032844,1,46,46,1361435625000,1361435625000,1857004844,1857004844,0
1361436208,1857588088,9,861,95.66666667,1361436183659,1361436183851,1857563747,1857563939,192
1361436208,1857588088,9,861,95.66666667,1361436183402,1361436183594,1857563490,1857563682,192
1361436208,1857588136,9,861,95.66666667,1361436183100,1361436183292,1857563236,1857563428,192
1361436427,1857807128,3,189,63,1361436422783,1361436425791,1857802911,1857805919,3008
1361436443,1857823128,2,126,63,1361436429823,1361436437887,1857809951,1857818015,8064
1361436507,1857887180,3,189,63,1361436502093,1361436505101,1857882273,1857885281,3008
1361436532,1857912360,9,861,95.66666667,1361436507541,1361436507669,1857887901,1857888029,128
1361436532,1857912428,8,815,101.875,1361436507730,1361436507858,1857888158,1857888286,128
1361436536,1857916320,9,861,95.66666667,1361436508095,1361436508287,1857888415,1857888607,192
1361436536,1857916328,1,63,63,1361436508983,1361436508983,1857889311,1857889311,0
1361436572,1857952464,3,138,46,1361436544620,1361436557420,1857925084,1857937884,12800
1361436587,1857967244,2,126,63,1361436585608,1361436586632,1857965852,1857966876,1024
1361436595,1857975268,2,126,63,1361436588656,1361436592688,1857968924,1857972956,4032
1361436628,1858008456,1,63,63,1361436600501,1361436600501,1857980957,1857980957,0
1361436739,1858119336,2,126,63,1361436737708,1361436738732,1858118044,1858119068,1024
1361436747,1858127312,2,126,63,1361436740739,1361436744771,1858121051,1858125083,4032
1361436772,1858152620,8,815,101.875,1361436746447,1361436746575,1858127067,1858127195,128
1361436772,1858152620,8,815,101.875,1361436746702,1361436746894,1858127322,1858127514,192
1361436772,1858152624,8,815,101.875,1361436746956,1361436747148,1858127580,1858127772,192
1361436772,1858152660,9,861,95.66666667,1361436746153,1361436746281,1858126813,1858126941,128
1361436781,1858160872,1,63,63,1361436753274,1361436753274,1858133146,1858133146,0
1361436819,1858199336,3,189,63,1361436814633,1361436817641,1858194969,1858197977,3008
1361436835,1858215336,2,126,63,1361436821676,1361436829740,1858202012,1858210076,8064
1361436851,1858231376,4,252,63,1361436843075,1361436850115,1858223451,1858230491,7040
1361436885,1858264916,1,63,63,1361436858636,1361436858636,1858238552,1858238552,0
1361436987,1858367496,3,189,63,1361436980550,1361436983558,1858361046,1858364054,3008
1361437003,1858383456,2,126,63,1361436987632,1361436995696,1858368088,1858376152,8064
1361437059,1858439520,2,126,63,1361437056048,1361437057072,1858436568,1858437592,1024
1361437067,1858447472,2,126,63,1361437059168,1361437063200,1858439640,1858443672,4032
1361437077,1858457448,8,496,62,1361437050679,1361437061751,1858431127,1858442199,11072
1361437091,1858471504,4,252,63,1361437082624,1361437089664,1858463128,1858470168,7040
1361437091,1858471540,4,252,63,1361437082521,1361437089561,1858463061,1858470101,7040
1361437097,1858477428,1,63,63,1361437071241,1361437071241,1858451669,1858451669,0
1361437125,1858505424,1,63,63,1361437097741,1361437097741,1858478165,1858478165,0
1361437125,1858505424,1,63,63,1361437097805,1361437097805,1858478229,1858478229,0
1361437380,1858759772,44,56779,1290.431818,1361437374039,1361437374295,1858753811,1858754067,256
1361437388,1858767764,12,999,83.25,1361437374493,1361437384413,1858754257,1858764177,9920
1361437388,1858767764,12,999,83.25,1361437374749,1361437384349,1858754513,1858764113,9600
1361437388,1858767764,11,953,86.63636364,1361437375069,1361437384349,1858754833,1858764113,9280
1361437388,1858767776,15,6289,419.2666667,1361437374097,1361437384401,1858753873,1858764177,10304
1361437402,1858782168,1,46,46,1361437377161,1361437377161,1858757329,1858757329,0
1361437402,1858782484,1,46,46,1361437376652,1361437376652,1858757136,1858757136,0
1361437402,1858782492,1,46,46,1361437376839,1361437376839,1858757331,1858757331,0
1361437498,1858878044,2,96,48,1361437469957,1361437472901,1858850001,1858852945,2944
1361437510,1858890080,2,96,48,1361437483360,1361437486176,1858863440,1858866256,2816
1361437510,1858890132,2,96,48,1361437482986,1361437485802,1858863118,1858865934,2816
1361437598,1858978460,1,446,446,1361437570081,1361437570081,1858950541,1858950541,0
1361437598,1858978584,1,443,443,1361437573477,1361437573477,1858954061,1858954061,0
1361437602,1858982544,1,446,446,1361437574480,1361437574480,1858955024,1858955024,0
1361437719,1859098672,1,60,60,1361437694643,1361437694643,1859074315,1859074315,0
1361438805,1860184752,1,52,52,1361438777814,1361438777814,1860157566,1860157566,0
1361438901,1860280776,14,6617,472.6428571,1361438873913,1361438874169,1860253689,1860253945,256
1361438901,1860280776,9,861,95.66666667,1361438874553,1361438874745,1860254329,1860254521,192
1361438901,1860280780,9,861,95.66666667,1361438874806,1361438874998,1860254586,1860254778,192
1361438901,1860280824,9,861,95.66666667,1361438874251,1361438874443,1860254075,1860254267,192
1361438973,1860352880,2,96,48,1361438947474,1361438950418,1860327354,1860330298,2944
1361439129,1860509296,3,152,50.66666667,1361439101808,1361439110832,1860482104,1860491128,9024
1361439149,1860529436,2,126,63,1361439147749,1361439148773,1860528185,1860529209,1024
1361439157,1860537412,2,126,63,1361439150841,1361439154873,1860531253,1860535285,4032
1361439189,1860569312,1,63,63,1361439162973,1361439162973,1860543285,1860543285,0
1361439205,1860585464,4,252,63,1361439197063,1361439204167,1860577527,1860584631,7104
1361439205,1860585504,2,126,63,1361439202717,1361439203741,1860583221,1860584245,1024
1361439205,1860585512,4,252,63,1361439196312,1361439203416,1860576824,1860583928,7104
1361439213,1860593472,2,126,63,1361439205824,1361439209792,1860586296,1860590264,3968
1361439237,1860617492,1,63,63,1361439211433,1361439211433,1860591925,1860591925,0
1361439237,1860617500,1,63,63,1361439212131,1361439212131,1860592631,1860592631,0
1361439241,1860621412,8,815,101.875,1361439215228,1361439215356,1860595640,1860595768,128
1361439245,1860625424,1,63,63,1361439217903,1361439217903,1860598327,1860598327,0
1361439498,1860877720,9,861,95.66666667,1361439473707,1361439473899,1860853427,1860853619,192
1361439502,1860881676,9,861,95.66666667,1361439474263,1361439474455,1860853939,1860854131,192
1361439502,1860881720,8,815,101.875,1361439473962,1361439474154,1860853682,1860853874,192
1361439502,1860881724,8,815,101.875,1361439474470,1361439474662,1860854194,1860854386,192
1361439574,1860954084,3,189,63,1361439567611,1361439570619,1860947695,1860950703,3008
1361439590,1860970064,2,126,63,1361439574672,1361439582736,1860954736,1860962800,8064
1361439690,1861070176,8,496,62,1361439664799,1361439675807,1861044975,1861055983,11008
1361439734,1861114300,2,126,63,1361439732514,1361439733538,1861112814,1861113838,1024
1361439734,1861114400,2,126,63,1361439732414,1361439733438,1861112814,1861113838,1024
1361439742,1861122304,2,126,63,1361439735520,1361439739552,1861115824,1861119856,4032
1361439742,1861122304,2,126,63,1361439735520,1361439739552,1861115824,1861119856,4032
1361439774,1861154452,1,63,63,1361439747466,1361439747466,1861127918,1861127918,0
1361439774,1861154500,1,63,63,1361439747419,1361439747419,1861127919,1861127919,0
1361439782,1861162292,2,126,63,1361439780715,1361439781739,1861161007,1861162031,1024
1361439782,1861162292,2,126,63,1361439780715,1361439781739,1861161007,1861162031,1024
1361439790,1861170352,2,126,63,1361439783725,1361439787757,1861164077,1861168109,4032
1361439790,1861170352,2,126,63,1361439783661,1361439787693,1861164013,1861168045,4032
1361439818,1861198480,1,60,60,1361439792429,1361439792429,1861172909,1861172909,0
1361439822,1861202456,1,63,63,1361439795655,1361439795655,1861176111,1861176111,0
1361439822,1861202500,1,63,63,1361439795609,1361439795609,1861176109,1861176109,0
1361439995,1861374860,1,46,46,1361439968469,1361439968469,1861348329,1861348329,0
1361440155,1861535028,8,496,62,1361440127598,1361440138606,1861507626,1861518634,11008
1361440191,1861570980,8,496,62,1361440163101,1361440174109,1861543081,1861554089,11008
1361440632,1862011888,1,90,90,1361440604529,1361440604529,1861984417,1861984417,0
1361440736,1862115944,1,131,131,1361440710969,1361440710969,1862090913,1862090913,0
1361440976,1862356440,8,496,62,1361440948418,1361440959362,1862328858,1862339802,10944
1361441032,1862412464,9,861,95.66666667,1361441007403,1361441007595,1862387867,1862388059,192
1361441032,1862412472,9,861,95.66666667,1361441007717,1361441007845,1862388189,1862388317,128
1361441032,1862412500,14,6617,472.6428571,1361441006981,1361441007301,1862387481,1862387801,320
1361441037,1862416768,8,815,101.875,1361441008677,1361441008869,1862388445,1862388637,192
1361441223,1862603376,3,189,63,1361441219839,1361441222847,1862600215,1862603223,3008
1361441239,1862619420,2,126,63,1361441226837,1361441234901,1862607257,1862615321,8064
1361441311,1862691432,3,189,63,1361441307398,1361441310406,1862687830,1862690838,3008
1361441311,1862691432,3,189,63,1361441307398,1361441310470,1862687830,1862690902,3072
1361441327,1862707472,2,126,63,1361441314399,1361441322463,1862694871,1862702935,8064
1361441327,1862707472,2,126,63,1361441314463,1361441322463,1862694935,1862702935,8000
1361441335,1862715448,2,126,63,1361441332664,1361441333688,1862713112,1862714136,1024
1361441343,1862723500,2,126,63,1361441335681,1361441339713,1862716181,1862720213,4032
1361441373,1862753644,1,63,63,1361441347633,1361441347633,1862728277,1862728277,0
1361441814,1863194180,1,90,90,1361441789754,1361441789754,1863169934,1863169934,0
1361442387,1863766948,1,46,46,1361442360156,1361442360156,1863740104,1863740104,0
1361442543,1863923100,1,131,131,1361442518785,1361442518785,1863898885,1863898885,0
1361442823,1864203604,13,6234,479.5384615,1361442797699,1361442798083,1864178303,1864178687,384
1361442823,1864203608,8,815,101.875,1361442798142,1361442798334,1864178750,1864178942,192
1361442824,1864203656,9,861,95.66666667,1361442799353,1361442799545,1864179009,1864179201,192
1361442960,1864339972,1,48,48,1361442932537,1361442932537,1864312509,1864312509,0
1361443020,1864400036,1,90,90,1361442993787,1361442993787,1864373823,1864373823,0
1361443121,1864500664,3,189,63,1361443117355,1361443120363,1864497019,1864500027,3008
1361443121,1864500676,3,189,63,1361443117342,1361443120350,1864497018,1864500026,3008
1361443128,1864508088,9,861,95.66666667,1361443101954,1361443102146,1864482042,1864482234,192
1361443128,1864508088,8,815,101.875,1361443102212,1361443102404,1864482300,1864482492,192
1361443128,1864508132,9,861,95.66666667,1361443102425,1361443102617,1864482557,1864482749,192
1361443128,1864508132,8,815,101.875,1361443102744,1361443102872,1864482876,1864483004,128
1361443137,1864516688,2,126,63,1361443124372,1361443132436,1864504060,1864512124,8064
1361443137,1864516688,2,126,63,1361443124436,1361443132436,1864504124,1864512124,8000
1361443169,1864548760,3,189,63,1361443163339,1361443166411,1864543099,1864546171,3072
1361443185,1864564756,2,126,63,1361443170383,1361443178447,1864550139,1864558203,8064
1361443361,1864740820,3,189,63,1361443357710,1361443360718,1864737530,1864740538,3008
1361443361,1864740820,3,189,63,1361443357709,1361443360717,1864737529,1864740537,3008
1361443361,1864740832,3,189,63,1361443353920,1361443356992,1864733752,1864736824,3072
1361443377,1864756836,2,126,63,1361443364733,1361443372797,1864744569,1864752633,8064
1361443377,1864756836,2,126,63,1361443361020,1361443369084,1864740856,1864748920,8064
1361443377,1864756848,2,126,63,1361443364720,1361443372784,1864744568,1864752632,8064
1361443513,1864893184,3,189,63,1361443506140,1361443509148,1864886324,1864889332,3008
1361443529,1864909192,2,126,63,1361443513173,1361443521237,1864893365,1864901429,8064
1361443910,1865290084,9,861,95.66666667,1361443883709,1361443883901,1865263793,1865263985,192
1361443910,1865290084,9,861,95.66666667,1361443883453,1361443883645,1865263537,1865263729,192
1361443910,1865290128,14,6617,472.6428571,1361443882703,1361443883087,1865262831,1865263215,384
1361443910,1865290132,8,815,101.875,1361443883149,1361443883277,1865263281,1865263409,128
1361444146,1865526132,3,189,63,1361444139079,1361444142151,1865519211,1865522283,3072
1361444146,1865526148,3,189,63,1361444139066,1361444142138,1865519214,1865522286,3072
1361444162,1865542140,2,126,63,1361444146112,1361444154176,1865526252,1865534316,8064
1361444162,1865542156,2,126,63,1361444146097,1361444154161,1865526253,1865534317,8064
1361444186,1865566224,3,189,63,1361444179497,1361444182505,1865559721,1865562729,3008
1361444202,1865582172,2,126,63,1361444186593,1361444194657,1865566765,1865574829,8064
1361444218,1865598192,2,126,63,1361444216523,1361444217547,1865596715,1865597739,1024
1361444226,1865606176,2,126,63,1361444219545,1361444223577,1865599721,1865603753,4032
1361444259,1865638892,1,63,63,1361444231925,1361444231925,1865611817,1865611817,0
1361444263,1865642984,1,90,90,1361444237531,1361444237531,1865617515,1865617515,0
1361444505,1865884720,1,60,60,1361444476318,1361444476318,1865856038,1865856038,0
1361444505,1865884728,1,60,60,1361444476309,1361444476309,1865856037,1865856037,0
1361444506,1865885672,1,60,60,1361444476239,1361444476239,1865855911,1865855911,0
1361444599,1865979644,1,46,46,1361444573442,1361444573442,1865954086,1865954086,0
1361444628,1866007676,1,46,46,1361444603144,1361444603144,1865982820,1865982820,0
1361444864,1866244104,1,71,71,1361444837723,1361444837723,1866217827,1866217827,0
1361444932,1866312276,1,46,46,1361444906346,1361444906346,1866286622,1866286622,0
1361445438,1866817816,1,90,90,1361445410672,1361445410672,1866790488,1866790488,0
1361445634,1867014288,13,6234,479.5384615,1361445607191,1361445607511,1866987479,1866987799,320
1361445634,1867014288,9,861,95.66666667,1361445607636,1361445607764,1866987924,1866988052,128
1361445634,1867014292,9,861,95.66666667,1361445608146,1361445608338,1866988438,1866988630,192
1361445634,1867014332,8,815,101.875,1361445607848,1361445607976,1866988180,1866988308,128
1361445899,1867279080,3,189,63,1361445894563,1361445897635,1867274643,1867277715,3072
1361445899,1867279080,3,189,63,1361445894561,1361445897633,1867274641,1867277713,3072
1361445915,1867295092,2,126,63,1361445901654,1361445909718,1867281746,1867289810,8064
1361445915,1867295128,2,126,63,1361445901617,1361445909681,1867281745,1867289809,8064
1361445947,1867327112,4,252,63,1361445939775,1361445946815,1867319887,1867326927,7040
1361445979,1867359280,1,63,63,1361445954712,1361445954712,1867334992,1867334992,0
1361445995,1867375164,3,189,63,1361445991117,1361445994189,1867371281,1867374353,3072
1361446011,1867391212,2,126,63,1361445998171,1361446006235,1867378383,1867386447,8064
1361446075,1867455612,1,46,46,1361446047371,1361446047371,1867427983,1867427983,0
1361446599,506292660,5,451,90.2,1361446599060,1361446599252,506292720,506292912,192
1361446601,506294580,4,1448,362,1361446599655,1361446599719,506293235,506293299,64
1361446603,1867983572,8,3137,392.125,1361446597161,1361446597993,1867977733,1867978565,832
1361446603,1867983572,5,2106,421.2,1361446597101,1361446597357,1867977673,1867977929,256
1361446603,1867983572,6,983,163.8333333,1361446601259,1361446601451,1867981831,1867982023,192
1361446603,1867983572,7,1460,208.5714286,1361446601386,1361446602026,1867981958,1867982598,640
1361446603,1867983576,32,41637,1301.15625,1361446598313,1361446598889,1867978889,1867979465,576
1361446603,1867983576,5,1257,251.4,1361446598951,1361446599015,1867979527,1867979591,64
1361446603,1867983580,4,724,181,1361446602853,1361446602917,1867983433,1867983497,64
1361446603,1867983584,11,3294,299.4545455,1361446600544,1361446601248,1867981128,1867981832,704
1361446603,1867983612,6,798,133,1361446601409,1361446601729,1867982021,1867982341,320
1361446603,1867983612,11,3139,285.3636364,1361446601412,1361446602116,1867982024,1867982728,704
1361446603,1867983616,9,1913,212.5555556,1361446602237,1361446602365,1867982853,1867982981,128
1361446603,1867983616,8,3492,436.5,1361446599361,1361446600065,1867979977,1867980681,704
1361446609,506302588,5,451,90.2,1361446603870,1361446604766,506297458,506298354,896
1361446609,506302592,5,451,90.2,1361446606427,1361446607579,506300019,506301171,1152
1361446609,506302596,5,451,90.2,1361446602710,1361446602838,506296306,506296434,128
1361446609,506302596,5,2109,421.8,1361446602902,1361446602902,506296498,506296498,0
1361446611,1867991576,12,4967,413.9166667,1361446608040,1361446608232,1867988616,1867988808,192
1361446611,1867991580,5,609,121.8,1361446605156,1361446605540,1867985736,1867986120,384
1361446611,1867991584,11,5273,479.3636364,1361446607070,1361446607262,1867987654,1867987846,192
1361446611,1867991588,10,1965,196.5,1361446607004,1361446607324,1867987592,1867987912,320
1361446611,1867991588,8,1929,241.125,1361446603098,1361446603802,1867983686,1867984390,704
1361446611,1867991592,10,1965,196.5,1361446604376,1361446604760,1867984968,1867985352,384
1361446611,1867991592,9,1913,212.5555556,1361446608664,1361446608856,1867989256,1867989448,192
1361446611,1867991612,9,1913,212.5555556,1361446605187,1361446605315,1867985799,1867985927,128
1361446611,1867991612,12,4967,413.9166667,1361446609347,1361446609603,1867989959,1867990215,256
1361446611,1867991612,12,4927,410.5833333,1361446609537,1361446610049,1867990149,1867990661,512
1361446611,1867991616,9,1913,212.5555556,1361446605757,1361446605949,1867986373,1867986565,192
1361446611,1867991616,5,609,121.8,1361446609984,1361446610432,1867990600,1867991048,448
1361446611,1867991616,9,1913,212.5555556,1361446606398,1361446606526,1867987014,1867987142,128
1361446611,1867991616,12,4735,394.5833333,1361446610493,1361446610685,1867991109,1867991301,192
1361446611,1867991620,5,609,121.8,1361446602748,1361446603132,1867983368,1867983752,384
1361446611,1867991620,5,609,121.8,1361446607739,1361446608123,1867988359,1867988743,384
1361446617,506310588,5,451,90.2,1361446611231,1361446611743,506304819,506305331,512
1361446617,506310588,97,138629,1429.164948,1361446612958,1361446613918,506306546,506307506,960
1361446617,506310588,4,445,111.25,1361446612766,1361446612958,506306354,506306546,192
1361446617,506310592,5,451,90.2,1361446608857,1361446609881,506302449,506303473,1024
1361446619,1867999572,10,1877,187.7,1361446611243,1361446612779,1867991815,1867993351,1536
1361446619,1867999576,9,2849,316.5555556,1361446616871,1361446617255,1867997447,1867997831,384
1361446619,1867999576,9,1913,212.5555556,1361446613671,1361446614439,1867994247,1867995015,768
1361446619,1867999584,9,1913,212.5555556,1361446611166,1361446611358,1867991750,1867991942,192
1361446619,1867999588,5,609,121.8,1361446611675,1361446612059,1867992263,1867992647,384
1361446619,1867999616,9,1913,212.5555556,1361446614976,1361446615360,1867995592,1867995976,384
1361446625,506318588,4,445,111.25,1361446617884,1361446618012,506311472,506311600,128
1361446625,506318592,4,1448,362,1361446618456,1361446618520,506312048,506312112,64
1361446627,1868007592,9,3310,367.7777778,1361446618005,1361446619989,1867998597,1868000581,1984
1361446627,1868007592,14,7501,535.7857143,1361446623509,1361446624277,1868004101,1868004869,768
1361446627,1868007596,10,3397,339.7,1361446619986,1361446621202,1868000582,1868001798,1216
1361446627,1868007628,4,715,178.75,1361446622451,1361446622451,1868003079,1868003079,0
1361446627,1868007632,11,3096,281.4545455,1361446622701,1361446623405,1868003333,1868004037,704
1361446636,1868016492,1,90,90,1361446611452,1361446611452,1867991944,1867991944,0
1361446709,1868088708,6,384,64,1361446682441,1361446687881,1868062149,1868067589,5440
1361446709,1868088736,1,64,64,1361446683564,1361446683564,1868063300,1868063300,0
1361446709,1868088744,6,384,64,1361446681319,1361446686759,1868061063,1868066503,5440
1361446709,1868088752,5,320,64,1361446683549,1361446687837,1868063301,1868067589,4288
1361447362,1868741892,2,96,48,1361447337544,1361447340232,1868717436,1868720124,2688
1361447422,1868801956,14,6617,472.6428571,1361447397897,1361447398153,1868777853,1868778109,256
1361447426,1868805952,9,861,95.66666667,1361447398538,1361447398730,1868778490,1868778682,192
1361447426,1868805992,9,861,95.66666667,1361447398244,1361447398372,1868778236,1868778364,128
1361447426,1868805992,9,861,95.66666667,1361447398753,1361447398945,1868778745,1868778937,192
1361447620,1869000596,3,189,63,1361447614981,1361447618053,1868995577,1868998649,3072
1361447636,1869016588,2,126,63,1361447622093,1361447630093,1869002681,1869010681,8000
1361447636,1869016632,3,189,63,1361447632352,1361447635360,1869012984,1869015992,3008
1361447653,1869032696,2,126,63,1361447640325,1361447648389,1869020021,1869028085,8064
1361447725,1869104640,4,252,63,1361447716797,1361447723837,1869096437,1869103477,7040
1361447759,1869138820,1,63,63,1361447731720,1361447731720,1869111540,1869111540,0
1361447805,1869184692,2,126,63,1361447803463,1361447804423,1869183155,1869184115,960
1361447813,1869192684,2,126,63,1361447806482,1361447810514,1869186166,1869190198,4032
1361447843,1869223140,1,63,63,1361447818119,1361447818119,1869198259,1869198259,0
1361448649,1870029308,1,46,46,1361448621140,1361448621140,1870001448,1870001448,0
1361448650,1870029840,1,46,46,1361448621608,1361448621608,1870001448,1870001448,0
1361448821,1870200944,1,46,46,1361448796476,1361448796476,1870176420,1870176420,0
1361449169,1870549508,1,95,95,1361449144708,1361449144708,1870525216,1870525216,0
1361449189,1870569500,2,160,80,1361449164683,1361449175371,1870545183,1870555871,10688
1361449189,1870569520,6,504,84,1361449164663,1361449177335,1870545183,1870557855,12672
1361449213,1870593532,14,6617,472.6428571,1361449187566,1361449187886,1870568098,1870568418,320
1361449213,1870593596,9,861,95.66666667,1361449187884,1361449188076,1870568480,1870568672,192
1361449213,1870593620,9,861,95.66666667,1361449188115,1361449188307,1870568735,1870568927,192
1361449217,1870597500,3,152,50.66666667,1361449189708,1361449198732,1870570208,1870579232,9024
1361449217,1870597540,2,116,58,1361449189668,1361449192676,1870570208,1870573216,3008
1361449269,1870649544,6,504,84,1361449241696,1361449267296,1870622240,1870647840,25600
1361449269,1870649544,2,160,80,1361449241695,1361449263647,1870622239,1870644191,21952
1361449298,1870677872,3,152,50.66666667,1361449273341,1361449282301,1870653213,1870662173,8960
1361449298,1870677872,2,116,58,1361449273341,1361449276285,1870653213,1870656157,2944
1361449298,1870677912,3,252,84,1361449273303,1361449276951,1870653215,1870656863,3648
1361449302,1870681848,1,80,80,1361449275030,1361449275030,1870654878,1870654878,0
1361449430,1870809848,3,138,46,1361449422422,1361449422486,1870802270,1870802334,64
1361449450,1870829988,2,109,54.5,1361449422279,1361449422279,1870802267,1870802267,0
1361449450,1870830000,8,815,101.875,1361449424125,1361449424317,1870804125,1870804317,192
1361449450,1870830000,8,815,101.875,1361449424380,1361449424572,1870804380,1870804572,192
1361449450,1870830000,8,815,101.875,1361449424634,1361449424826,1870804634,1870804826,192
1361449450,1870830032,2,109,54.5,1361449422237,1361449422237,1870802269,1870802269,0
1361449450,1870830040,9,861,95.66666667,1361449423830,1361449423958,1870803870,1870803998,128
1361449546,1870926424,2,160,80,1361449521041,1361449545873,1870901465,1870926297,24832
1361449546,1870926424,4,336,84,1361449521041,1361449545873,1870901465,1870926297,24832
1361449574,1870954420,5,420,84,1361449547607,1361449558551,1870928027,1870938971,10944
1361449574,1870954460,2,116,58,1361449549868,1361449552812,1870930328,1870933272,2944
1361449578,1870958424,3,152,50.66666667,1361449549907,1361449558931,1870930331,1870939355,9024
1361449582,1870962432,1,80,80,1361449556681,1361449556681,1870937113,1870937113,0
1361449646,1871026040,4,252,63,1361449637138,1361449644178,1871017178,1871024218,7040
1361449646,1871026072,4,252,63,1361449636913,1361449643953,1871016985,1871024025,7040
1361449667,1871046868,1,46,46,1361449638011,1361449638011,1871017879,1871017879,0
1361449678,1871058084,3,189,63,1361449671526,1361449674534,1871051610,1871054618,3008
1361449679,1871058888,1,63,63,1361449652199,1361449652199,1871032087,1871032087,0
1361449679,1871058892,1,63,63,1361449652390,1361449652390,1871032282,1871032282,0
1361449687,1871066984,1,46,46,1361449659977,1361449659977,1871039961,1871039961,0
1361449694,1871074080,2,126,63,1361449678570,1361449686634,1871058650,1871066714,8064
1361449734,1871114232,3,189,63,1361449729936,1361449732944,1871110168,1871113176,3008
1361449750,1871130172,2,126,63,1361449737036,1361449745100,1871117208,1871125272,8064
1361449895,1871275304,1,48,48,1361449867206,1361449867206,1871247510,1871247510,0
1361450368,1871748036,1,46,46,1361450341515,1361450341515,1871721551,1871721551,0
1361450384,1871763996,6,298,49.66666667,1361450359793,1361450381489,1871739789,1871761485,21696
1361450432,1871812316,1,48,48,1361450405232,1361450405232,1871785548,1871785548,0
1361450460,1871840352,1,48,48,1361450434702,1361450434702,1871815054,1871815054,0
1361450464,1871844352,2,122,61,1361450437708,1361450437964,1871818060,1871818316,256
1361450492,1871872428,2,122,61,1361450465344,1361450467648,1871845772,1871848076,2304
1361450877,1872256964,2,122,61,1361450849036,1361450851148,1872229000,1872231112,2112
1361450983,1872363196,2,92,46,1361450975904,1361450975904,1872356100,1872356100,0
1361450983,1872363196,2,92,46,1361450975840,1361450975904,1872356036,1872356100,64
1361450983,1872363236,2,92,46,1361450975865,1361450975865,1872356101,1872356101,0
1361450983,1872363236,2,92,46,1361450975865,1361450975865,1872356101,1872356101,0
1361451005,1872385140,9,861,95.66666667,1361450978329,1361450978521,1872358469,1872358661,192
1361451005,1872385172,13,6234,479.5384615,1361450977272,1361450977592,1872357444,1872357764,320
1361451005,1872385176,9,861,95.66666667,1361450977717,1361450977845,1872357893,1872358021,128
1361451005,1872385176,8,815,101.875,1361450977972,1361450978100,1872358148,1872358276,128
1361451207,1872587420,3,189,63,1361451200381,1361451203389,1872580801,1872583809,3008
1361451223,1872603436,2,126,63,1361451207406,1361451215470,1872587842,1872595906,8064
1361451263,1872643480,2,126,63,1361451261378,1361451262402,1872641858,1872642882,1024
1361451263,1872643480,4,252,63,1361451255488,1361451262528,1872635968,1872643008,7040
1361451263,1872643492,2,126,63,1361451261428,1361451262452,1872641920,1872642944,1024
1361451271,1872651504,2,126,63,1361451264360,1361451268392,1872644864,1872648896,4032
1361451271,1872651540,2,126,63,1361451264454,1361451268486,1872644994,1872649026,4032
1361451297,1872677616,1,63,63,1361451270456,1361451270456,1872651072,1872651072,0
1361451301,1872681600,1,63,63,1361451276360,1361451276360,1872656960,1872656960,0
1361451301,1872681600,1,63,63,1361451276424,1361451276424,1872657024,1872657024,0
1361451459,1872838976,1,46,46,1361451432056,1361451432056,1872812032,1872812032,0
1361451460,1872839852,1,46,46,1361451432178,1361451432178,1872812030,1872812030,0
1361451460,1872839856,1,46,46,1361451432175,1361451432175,1872812031,1872812031,0
1361451694,1873074244,1,46,46,1361451668456,1361451668456,1873048700,1873048700,0
1361451887,1873266780,14,6617,472.6428571,1361451862644,1361451862964,1873242424,1873242744,320
1361451891,1873270776,9,861,95.66666667,1361451863031,1361451863223,1873242807,1873242999,192
1361451891,1873270780,9,861,95.66666667,1361451863538,1361451863730,1873243318,1873243510,192
1361451891,1873270816,8,815,101.875,1361451863247,1361451863439,1873243063,1873243255,192
1361451903,1873283128,1,46,46,1361451877847,1361451877847,1873257975,1873257975,0
1361451907,1873287128,1,46,46,1361451880021,1361451880021,1873260149,1873260149,0
1361451959,1873339160,3,144,48,1361451933045,1361451942005,1873313205,1873322165,8960
1361452067,1873447308,1,46,46,1361452040224,1361452040224,1873420532,1873420532,0
1361452144,1873524412,3,189,63,1361452140856,1361452143864,1873521268,1873524276,3008
1361452160,1873540376,2,126,63,1361452147933,1361452155997,1873528309,1873536373,8064
1361452177,1873556692,3,189,63,1361452170885,1361452173893,1873550577,1873553585,3008
1361452177,1873556692,2,126,63,1361452174216,1361452175176,1873553908,1873554868,960
1361452177,1873556728,2,126,63,1361452174241,1361452175201,1873553969,1873554929,960
1361452184,1873564376,2,126,63,1361452176540,1361452180572,1873556916,1873560948,4032
1361452184,1873564388,2,126,63,1361452176590,1361452180622,1873556978,1873561010,4032
1361452192,1873572396,2,126,63,1361452177224,1361452185288,1873557620,1873565684,8064
1361452215,1873595392,1,63,63,1361452188619,1361452188619,1873569011,1873569011,0
1361452215,1873595392,1,63,63,1361452188683,1361452188683,1873569075,1873569075,0
1361452243,1873623456,1,46,46,1361452218635,1361452218635,1873599091,1873599091,0
1361452306,1873686252,1,48,48,1361452278739,1361452278739,1873658991,1873658991,0
1361452306,1873686256,1,48,48,1361452278737,1361452278737,1873658993,1873658993,0
1361452306,1873686288,1,48,48,1361452278706,1361452278706,1873658994,1873658994,0
1361452420,1873799860,1,46,46,1361452395163,1361452395163,1873775023,1873775023,0
1361453681,1875061392,14,6617,472.6428571,1361453653494,1361453653814,1875033886,1875034206,320
1361453681,1875061440,9,861,95.66666667,1361453653828,1361453654020,1875034268,1875034460,192
1361453681,1875061440,9,861,95.66666667,1361453654147,1361453654275,1875034587,1875034715,128
1361453681,1875061444,9,861,95.66666667,1361453654400,1361453654592,1875034844,1875035036,192
1361453809,1875189548,2,104,52,1361453780888,1361453783896,1875161436,1875164444,3008
1361453817,1875197504,2,104,52,1361453789250,1361453792322,1875169754,1875172826,3072
1361453817,1875197580,2,104,52,1361453791096,1361453794232,1875171676,1875174812,3136
1361453869,1875249588,1,90,90,1361453844396,1361453844396,1875224984,1875224984,0
1361453890,1875269824,3,138,46,1361453884456,1361453884520,1875264280,1875264344,64
1361453910,1875289652,2,109,54.5,1361453884630,1361453884630,1875264282,1875264282,0
1361453910,1875289652,2,109,54.5,1361453884628,1361453884628,1875264280,1875264280,0
1361453910,1875289652,2,109,54.5,1361453884628,1361453884628,1875264280,1875264280,0
1361453913,1875293584,9,861,95.66666667,1361453885746,1361453885938,1875266330,1875266522,192
1361453913,1875293584,9,861,95.66666667,1361453886002,1361453886194,1875266586,1875266778,192
1361453913,1875293588,9,861,95.66666667,1361453886254,1361453886446,1875266842,1875267034,192
1361453914,1875293628,14,6617,472.6428571,1361453886318,1361453886638,1875265946,1875266266,320
1361454130,1875510168,4,252,63,1361454122831,1361454129871,1875502999,1875510039,7040
1361454150,1875529808,6,792,132,1361454122676,1361454141876,1875502484,1875521684,19200
1361454154,1875534180,4,252,63,1361454145921,1361454152961,1875526101,1875533141,7040
1361454166,1875545856,1,63,63,1361454138246,1361454138246,1875518102,1875518102,0
1361454186,1875565896,1,63,63,1361454161308,1361454161308,1875541204,1875541204,0
1361454190,1875569880,3,399,133,1361454163118,1361454169198,1875542998,1875549078,6080
1361454202,1875582280,3,189,63,1361454196315,1361454199323,1875576595,1875579603,3008
1361454218,1875598280,2,126,63,1361454203354,1361454211418,1875583634,1875591698,8064
1361454234,1875614248,3,189,63,1361454229179,1361454232187,1875609427,1875612435,3008
1361454250,1875630380,2,126,63,1361454236089,1361454244153,1875616469,1875624533,8064
1361454432,1875812048,1,48,48,1361454404098,1361454404098,1875784146,1875784146,0
1361454433,1875813256,1,48,48,1361454403890,1361454403890,1875784146,1875784146,0
1361454433,1875813288,1,48,48,1361454403857,1361454403857,1875784145,1875784145,0
1361454511,1875890812,5,522,104.4,1361454485741,1361454506861,1875865553,1875886673,21120
1361454571,1875951176,2,120,60,1361454546494,1361454546494,1875926670,1875926670,0
1361454651,1876031252,2,122,61,1361454625138,1361454627314,1876005390,1876007566,2176
1361454691,1876071252,1,46,46,1361454664241,1361454664241,1876044493,1876044493,0
1361454707,1876087328,1,433,433,1361454680038,1361454680038,1876060366,1876060366,0
1361454715,1876095572,1,434,434,1361454690482,1361454690482,1876071054,1876071054,0
1361454715,1876095576,1,434,434,1361454688236,1361454688236,1876068812,1876068812,0
1361455069,1876448616,1,90,90,1361455044327,1361455044327,1876423943,1876423943,0
1361455100,1876480552,2,122,61,1361455072125,1361455074557,1876452677,1876455109,2432
1361455125,1876504668,3,456,152,1361455097011,1361455103027,1876476679,1876482695,6016
1361455129,1876508672,3,147,49,1361455103918,1361455109934,1876483590,1876489606,6016
1361455277,1876656704,2,108,54,1361455252429,1361455256461,1876632133,1876636165,4032
1361455473,1876852924,14,6617,472.6428571,1361455448110,1361455448430,1876828034,1876828354,320
1361455473,1876852944,9,861,95.66666667,1361455448473,1361455448665,1876828417,1876828609,192
1361455473,1876852988,14,6617,472.6428571,1361455447597,1361455447981,1876827585,1876827969,384
1361455475,1876854640,9,861,95.66666667,1361455449098,1361455449226,1876828738,1876828866,128
1361455517,1876897008,6,300,50,1361455491159,1361455508887,1876871167,1876888895,17728
1361455667,1877047440,4,252,63,1361455658854,1361455665958,1877039294,1877046398,7104
1361455667,1877047488,2,126,63,1361455664693,1361455665717,1877045181,1877046205,1024
1361455675,1877055500,2,126,63,1361455667690,1361455671722,1877048190,1877052222,4032
1361455675,1877055508,3,189,63,1361455668580,1361455671652,1877049088,1877052160,3072
1361455689,1877069440,2,120,60,1361455664614,1361455668198,1877045054,1877048638,3584
1361455689,1877069480,2,120,60,1361455663422,1361455666430,1877043902,1877046910,3008
1361455691,1877071452,2,126,63,1361455675740,1361455683740,1877056192,1877064192,8000
1361455693,1877073392,2,120,60,1361455665752,1361455669336,1877046144,1877049728,3584
1361455699,1877079476,3,189,63,1361455695684,1361455698692,1877076160,1877079168,3008
1361455701,1877081432,1,63,63,1361455673968,1361455673968,1877054400,1877054400,0
1361455705,1877085428,1,63,63,1361455679856,1361455679856,1877060284,1877060284,0
1361455715,1877095452,2,126,63,1361455702745,1361455710809,1877083197,1877091261,8064
1361455721,1877101436,2,338,169,1361455693994,1361455695978,1877074430,1877076414,1984
1361455729,1877109484,2,180,90,1361455703865,1361455707897,1877084349,1877088381,4032
1361455910,1877289644,2,274,137,1361455882238,1361455886206,1877261882,1877265850,3968
1361456014,1877393708,2,182,91,1361455988287,1361455992319,1877367995,1877372027,4032
1361456066,1877446044,3,507,169,1361456040814,1361456046830,1877420858,1877426874,6016
1361456166,1877546024,2,338,169,1361456139968,1361456143936,1877519992,1877523960,3968
1361456270,1877650296,1,90,90,1361456245549,1361456245549,1877625845,1877625845,0
1361457012,1878392348,12,999,83.25,1361456994605,1361457004077,1878374953,1878384425,9472
1361457012,1878392384,17,6755,397.3529412,1361456993929,1361457004105,1878374313,1878384489,10176
1361457012,1878392388,12,999,83.25,1361456994311,1361457004103,1878374699,1878384491,9792
1361457012,1878392388,11,953,86.63636364,1361456994887,1361457004039,1878375275,1878384427,9152
1361457055,1878435560,1,46,46,1361457028954,1361457028954,1878409514,1878409514,0
1361457496,1878876240,1,90,90,1361457470036,1361457470036,1878850276,1878850276,0
1361458406,1879785832,14,6617,472.6428571,1361458379421,1361458379677,1879759253,1879759509,256
1361458406,1879785840,9,861,95.66666667,1361458380055,1361458380247,1879759895,1879760087,192
1361458406,1879785912,9,861,95.66666667,1361458379727,1361458379855,1879759639,1879759767,128
1361458623,1880002804,3,138,46,1361458615926,1361458615990,1879995730,1879995794,64
1361458623,1880002852,3,138,46,1361458615878,1361458615942,1879995730,1879995794,64
1361458642,1880022432,2,109,54.5,1361458615297,1361458615297,1879995729,1879995729,0
1361458642,1880022444,9,861,95.66666667,1361458616312,1361458616504,1879996756,1879996948,192
1361458642,1880022444,9,861,95.66666667,1361458616565,1361458616757,1879997009,1879997201,192
1361458642,1880022468,8,815,101.875,1361458616798,1361458616990,1879997266,1879997458,192
1361458642,1880022472,8,815,101.875,1361458617048,1361458617240,1879997520,1879997712,192
1361458683,1880062792,1,90,90,1361458657667,1361458657667,1880037459,1880037459,0
1361458839,1880219072,4,252,63,1361458831015,1361458838055,1880211087,1880218127,7040
1361458863,1880243108,3,189,63,1361458856258,1361458859266,1880236366,1880239374,3008
1361458863,1880243156,3,189,63,1361458856212,1361458859220,1880236368,1880239376,3008
1361458871,1880251488,1,63,63,1361458845703,1361458845703,1880226191,1880226191,0
1361458879,1880259076,2,126,63,1361458863331,1361458871395,1880243407,1880251471,8064
1361458879,1880259120,2,126,63,1361458863288,1361458871352,1880243408,1880251472,8064
1361458983,1880363580,2,126,63,1361458980394,1361458981418,1880360974,1880361998,1024
1361458992,1880371644,2,126,63,1361458984338,1361458988370,1880363982,1880368014,4032
1361459024,1880403884,1,63,63,1361458996194,1361458996194,1880376078,1880376078,0
1361459712,1881091960,12,999,83.25,1361459695050,1361459704458,1881075010,1881084418,9408
1361459712,1881091960,12,999,83.25,1361459694793,1361459704521,1881074753,1881084481,9728
1361459712,1881091984,12,999,83.25,1361459695281,1361459704433,1881075265,1881084417,9152
1361459712,1881092020,17,6755,397.3529412,1361459694348,1361459704460,1881074368,1881084480,10112
1361459886,1881265736,1,90,90,1361459861545,1361459861545,1881241281,1881241281,0
1361460608,1881988040,1,48,48,1361460581931,1361460581931,1881961971,1881961971,0
1361460971,1882351160,3,152,50.66666667,1361460946669,1361460955693,1882326829,1882335853,9024
1361460971,1882351220,3,152,50.66666667,1361460945524,1361460954548,1882325744,1882334768,9024
1361460975,1882355088,2,104,52,1361460947896,1361460950840,1882327984,1882330928,2944
1361460975,1882355164,3,152,50.66666667,1361460947819,1361460956779,1882327983,1882336943,8960
1361461127,1882507540,1,90,90,1361461100978,1361461100978,1882481518,1882481518,0
1361461436,1882816124,8,815,101.875,1361461409162,1361461409354,1882789286,1882789478,192
1361461436,1882816128,13,6234,479.5384615,1361461408263,1361461408519,1882788391,1882788647,256
1361461436,1882816204,9,861,95.66666667,1361461408571,1361461408699,1882788775,1882788903,128
1361461436,1882816208,8,815,101.875,1361461408824,1361461409016,1882789032,1882789224,192
1361461633,1883013360,3,189,63,1361461628636,1361461631644,1883008996,1883012004,3008
1361461649,1883029424,2,126,63,1361461635615,1361461643615,1883016039,1883024039,8000
1361461745,1883125416,4,252,63,1361461737381,1361461744485,1883117797,1883124901,7104
1361461745,1883125460,4,252,63,1361461737207,1361461744311,1883117667,1883124771,7104
1361461745,1883125460,4,252,63,1361461737271,1361461744311,1883117731,1883124771,7040
1361461781,1883160656,1,63,63,1361461753116,1361461753116,1883132772,1883132772,0
1361461781,1883160708,1,63,63,1361461753127,1361461753127,1883132835,1883132835,0
1361461781,1883160708,1,63,63,1361461753189,1361461753189,1883132897,1883132897,0
1361462286,1883666164,3,162,54,1361462258456,1361462264472,1883638620,1883644636,6016
1361462298,1883678484,1,90,90,1361462272215,1361462272215,1883652699,1883652699,0
1361462982,1884362348,1,48,48,1361462954261,1361462954261,1884334609,1884334609,0
1361463026,1884406540,11,953,86.63636364,1361463014165,1361463025557,1884394705,1884406097,11392
1361463027,1884406612,17,6755,397.3529412,1361463014453,1361463026485,1884394065,1884406097,12032
1361463027,1884406612,12,999,83.25,1361463014836,1361463026484,1884394448,1884406096,11648
1361463027,1884406616,12,999,83.25,1361463015408,1361463026480,1884395024,1884406096,11072
1361463501,1884881064,1,90,90,1361463476199,1361463476199,1884856263,1884856263,0
1361464603,1885983516,1,46,46,1361464575445,1361464575445,1885955961,1885955961,0
1361464768,1886147828,1,90,90,1361464742530,1361464742530,1886122358,1886122358,0
1361464780,1886159728,9,861,95.66666667,1361464754727,1361464754919,1886134455,1886134647,192
1361464780,1886159732,9,861,95.66666667,1361464755234,1361464755426,1886134966,1886135158,192
1361464780,1886159808,9,861,95.66666667,1361464754903,1361464755095,1886134711,1886134903,192
1361464924,1886303892,1,46,46,1361464896513,1361464896513,1886276405,1886276405,0
1361464992,1886372324,3,450,150,1361464965389,1361464971469,1886345713,1886351793,6080
1361465012,1886392532,4,252,63,1361465004541,1361465011581,1886385073,1886392113,7040
1361465012,1886392544,3,189,63,1361465006131,1361465009203,1886386675,1886389747,3072
1361465028,1886408544,2,126,63,1361465013234,1361465021234,1886393778,1886401778,8000
1361465048,1886428256,1,63,63,1361465019923,1361465019923,1886400179,1886400179,0
1361465085,1886464652,3,189,63,1361465079917,1361465082925,1886459569,1886462577,3008
1361465101,1886480660,2,126,63,1361465086949,1361465095013,1886466609,1886474673,8064
1361465109,1886488632,11,953,86.63636364,1361465097986,1361465104898,1886477618,1886484530,6912
1361465109,1886488676,12,999,83.25,1361465097173,1361465104853,1886476849,1886484529,7680
1361465109,1886488712,15,6289,419.2666667,1361465095281,1361465104881,1886474993,1886484593,9600
1361465109,1886488732,12,999,83.25,1361465096350,1361465104862,1886476082,1886484594,8512
1361465278,1886657808,1,48,48,1361465251214,1361465251214,1886631022,1886631022,0
1361465398,1886777760,11,953,86.63636364,1361465378876,1361465390524,1886758636,1886770284,11648
1361465398,1886777808,17,6418,377.5294118,1361465378380,1361465390476,1886758188,1886770284,12096
1361465398,1886777840,12,999,83.25,1361465379435,1361465390443,1886759275,1886770283,11008
1361465398,1886777844,12,999,83.25,1361465379114,1361465390442,1886758958,1886770286,11328
1361465429,1886808740,1,46,46,1361465404110,1361465404110,1886783850,1886783850,0
1361465454,1886833808,17,6755,397.3529412,1361465436042,1361465450442,1886815850,1886830250,14400
1361465454,1886833808,12,999,83.25,1361465436490,1361465450442,1886816298,1886830250,13952
1361465454,1886833812,12,999,83.25,1361465437064,1361465450440,1886816876,1886830252,13376
1361465454,1886833880,12,999,83.25,1361465436675,1361465450371,1886816555,1886830251,13696
1361465470,1886849872,12,999,83.25,1361465451916,1361465464012,1886831788,1886843884,12096
1361465470,1886849872,11,953,86.63636364,1361465452170,1361465464010,1886832042,1886843882,11840
1361465470,1886850288,11,953,86.63636364,1361465452077,1361465463533,1886832365,1886843821,11456
1361465470,1886850288,11,953,86.63636364,1361465452333,1361465463533,1886832621,1886843821,11200
1361465477,1886857004,2,112,56,1361465448901,1361465448965,1886828905,1886828969,64
1361465505,1886885068,1,52,52,1361465478853,1361465478853,1886858921,1886858921,0
1361465505,1886885072,11,3267,297,1361465478980,1361465479492,1886859052,1886859564,512
1361465541,1886921000,1,1500,1500,1361465515532,1361465515532,1886895532,1886895532,0
1361465693,1887073128,3,447,149,1361465665032,1361465671048,1887045160,1887051176,6016
1361465782,1887161940,12,999,83.25,1361465764035,1361465775299,1887143975,1887155239,11264
1361465782,1887161940,12,999,83.25,1361465763778,1361465775298,1887143718,1887155238,11520
1361465782,1887161940,16,6372,398.25,1361465764354,1361465775298,1887144294,1887155238,10944
1361465782,1887162016,16,6335,395.9375,1361465763128,1361465775224,1887143144,1887155240,12096
1361465793,1887173236,11,3267,297,1361465766618,1361465767194,1887146854,1887147430,576
1361465793,1887173260,2,141,70.5,1361465767041,1361465767041,1887147301,1887147301,0
1361465913,1887293412,1,90,90,1361465886887,1361465886887,1887267299,1887267299,0
1361465995,1887374920,1,52,52,1361465969682,1361465969682,1887349602,1887349602,0
1361466063,1887443140,1,52,52,1361466033781,1361466033781,1887413921,1887413921,0
1361466402,1887782264,3,447,149,1361466377589,1361466383605,1887757853,1887763869,6016
1361466526,1887906548,5,1565,313,1361466498390,1361466515158,1887878938,1887895706,16768
1361466559,1887938624,1,313,313,1361466533939,1361466533939,1887913563,1887913563,0
1361466571,1887950680,1,46,46,1361466544314,1361466544314,1887923994,1887923994,0
1361466595,1887974732,1,313,313,1361466569606,1361466569606,1887949338,1887949338,0
1361466667,1888047108,1,313,313,1361466640782,1361466640782,1888020890,1888020890,0
1361466787,1888167132,1,313,313,1361466760757,1361466760757,1888140889,1888140889,0
1361466823,1888203044,1,89,89,1361466798859,1361466798859,1888178903,1888178903,0
1361466859,1888239132,1,64,64,1361466833588,1361466833588,1888213720,1888213720,0
1361467019,1888399260,3,447,149,1361466992177,1361466998193,1888372437,1888378453,6016
1361467056,1888435660,12,999,83.25,1361467043527,1361467054919,1888423187,1888434579,11392
1361467056,1888435664,11,953,86.63636364,1361467043780,1361467054916,1888423444,1888434580,11136
1361467056,1888435752,16,6372,398.25,1361467042732,1361467054828,1888422484,1888434580,12096
1361467056,1888435752,12,999,83.25,1361467043116,1361467054828,1888422868,1888434580,11712
1361467116,1888495688,1,90,90,1361467091563,1361467091563,1888471251,1888471251,0
1361467906,1889285760,3,162,54,1361467878552,1361467884568,1889258312,1889264328,6016
1361467954,1889333968,8,815,101.875,1361467929030,1361467929222,1889308998,1889309190,192
1361467954,1889333980,9,861,95.66666667,1361467929275,1361467929467,1889309255,1889309447,192
1361467955,1889335304,9,861,95.66666667,1361467928437,1361467928629,1889308741,1889308933,192
1361468113,1889493104,2,126,63,1361468110333,1361468111357,1889490437,1889491461,1024
1361468121,1889501040,2,126,63,1361468113467,1361468117499,1889493507,1889497539,4032
1361468121,1889501040,3,189,63,1361468114683,1361468117691,1889494723,1889497731,3008
1361468121,1889501112,3,189,63,1361468113970,1361468116978,1889494082,1889497090,3008
1361468137,1889517236,2,126,63,1361468120887,1361468128951,1889501123,1889509187,8064
1361468137,1889517244,2,126,63,1361468121519,1361468129583,1889501763,1889509827,8064
1361468150,1889530184,1,63,63,1361468125356,1361468125356,1889505540,1889505540,0
1361468178,1889558296,2,300,150,1361468152123,1361468154171,1889532419,1889534467,2048
1361468186,1889566212,1,150,150,1361468158223,1361468158223,1889538435,1889538435,0
1361468218,1889598272,3,447,149,1361468191505,1361468197585,1889571777,1889577857,6080
1361468225,1889605128,2,92,46,1361468218786,1361468218786,1889598914,1889598914,0
1361468225,1889605208,2,92,46,1361468218707,1361468218707,1889598915,1889598915,0
1361468225,1889605208,2,92,46,1361468218771,1361468218771,1889598979,1889598979,0
1361468246,1889626380,14,6617,472.6428571,1361468220645,1361468220965,1889601025,1889601345,320
1361468246,1889626384,9,861,95.66666667,1361468221026,1361468221154,1889601410,1889601538,128
1361468246,1889626384,9,861,95.66666667,1361468221281,1361468221473,1889601665,1889601857,192
1361468246,1889626468,16,7743,483.9375,1361468220172,1361468220428,1889600640,1889600896,256
1361468246,1889626496,9,861,95.66666667,1361468221426,1361468221618,1889601922,1889602114,192
1361468403,1889782596,1,90,90,1361468378165,1361468378165,1889757761,1889757761,0
1361468465,1889845372,2,126,63,1361468463595,1361468464555,1889843967,1889844927,960
1361468473,1889853300,2,126,63,1361468466674,1361468470706,1889846974,1889851006,4032
1361468473,1889853332,2,126,63,1361468471504,1361468472528,1889851836,1889852860,1024
1361468481,1889861344,2,126,63,1361468474502,1361468478534,1889854846,1889858878,4032
1361468497,1889877356,2,126,63,1361468495419,1361468496443,1889875775,1889876799,1024
1361468505,1889885304,2,126,63,1361468498540,1361468502572,1889878844,1889882876,4032
1361468507,1889886852,1,63,63,1361468479219,1361468479219,1889859071,1889859071,0
1361468515,1889894864,1,63,63,1361468487076,1361468487076,1889866940,1889866940,0
1361468539,1889918912,1,63,63,1361468510965,1361468510965,1889890877,1889890877,0
1361468617,1889997456,2,126,63,1361468615190,1361468616214,1889995646,1889996670,1024
1361468625,1890005440,2,126,63,1361468618275,1361468622243,1889998715,1890002683,3968
1361468649,1890029448,3,189,63,1361468642266,1361468645274,1890022714,1890025722,3008
1361468655,1890035384,1,63,63,1361468630364,1361468630364,1890010748,1890010748,0
1361468665,1890045376,2,126,63,1361468649378,1361468657442,1890029754,1890037818,8064
1361468832,1890211912,3,447,149,1361468805168,1361468811184,1890185080,1890191096,6016
1361469450,1890829644,3,447,149,1361469422516,1361469428596,1890802160,1890808240,6080
1361469530,1890910040,1,90,90,1361469502055,1361469502055,1890882095,1890882095,0
1361469751,1891130724,9,861,95.66666667,1361469724641,1361469724833,1891104365,1891104557,192
1361469751,1891130776,14,6617,472.6428571,1361469724265,1361469724521,1891104041,1891104297,256
1361469751,1891130808,8,815,101.875,1361469724810,1361469725002,1891104618,1891104810,192
1361469751,1891130816,9,861,95.66666667,1361469725121,1361469725249,1891104937,1891105065,128
1361469939,1891319192,2,126,63,1361469935945,1361469936969,1891316137,1891317161,1024
1361469947,1891327156,2,126,63,1361469938987,1361469943019,1891319143,1891323175,4032
1361469963,1891343232,2,126,63,1361469961121,1361469962145,1891341353,1891342377,1024
1361469963,1891343280,2,126,63,1361469961327,1361469962351,1891341607,1891342631,1024
1361469971,1891351224,2,126,63,1361469964201,1361469968233,1891344425,1891348457,4032
1361469971,1891351224,2,126,63,1361469964455,1361469968487,1891344679,1891348711,4032
1361469979,1891359024,1,63,63,1361469951216,1361469951216,1891331240,1891331240,0
1361470003,1891383032,1,63,63,1361469976677,1361469976677,1891356709,1891356709,0
1361470003,1891383100,1,63,63,1361469976418,1361469976418,1891356518,1891356518,0
1361470051,1891431356,3,189,63,1361470047074,1361470050082,1891427430,1891430438,3008
1361470063,1891443168,3,447,149,1361470035040,1361470041056,1891415208,1891421224,6016
1361470067,1891447504,2,126,63,1361470053966,1361470062030,1891434470,1891442534,8064
1361470608,1891988028,1,127,127,1361470580708,1361470580708,1891960736,1891960736,0
1361470676,1892056120,3,450,150,1361470649091,1361470655171,1892029211,1892035291,6080
1361470732,1892112176,1,90,90,1361470706253,1361470706253,1892086429,1892086429,0
1361471286,1892665588,3,450,150,1361471261200,1361471267216,1892640788,1892646804,6016
1361471525,1892905540,12,999,83.25,1361471513748,1361471524884,1892894288,1892905424,11136
1361471526,1892905592,12,999,83.25,1361471514441,1361471525833,1892894033,1892905425,11392
1361471526,1892905664,17,6755,397.3529412,1361471513662,1361471525758,1892893326,1892905422,12096
1361471526,1892905668,12,999,83.25,1361471514046,1361471525758,1892893714,1892905426,11712
1361471899,1893279544,3,450,150,1361471874635,1361471880651,1893255179,1893261195,6016
1361472024,1893403680,1,90,90,1361471996075,1361471996075,1893375755,1893375755,0
1361472212,1893592208,1,90,90,1361472187095,1361472187095,1893567303,1893567303,0
1361472465,1893845060,1,56,56,1361472437348,1361472437348,1893817408,1893817408,0
1361472517,1893896988,3,450,150,1361472489775,1361472495791,1893869763,1893875779,6016
1361472621,1894001480,1,95,95,1361472594369,1361472594369,1893974849,1893974849,0
1361472714,1894093916,1,90,90,1361472686644,1361472686644,1894066560,1894066560,0
1361472834,1894214036,1,64,64,1361472809017,1361472809017,1894189053,1894189053,0
1361472834,1894214072,6,384,64,1361472806677,1361472812053,1894186749,1894192125,5376
1361472834,1894214104,6,384,64,1361472807796,1361472813108,1894187900,1894193212,5312
1361472834,1894214116,5,320,64,1361472808936,1361472813096,1894189052,1894193212,4160
1361473091,1894470748,1,95,95,1361473063444,1361473063444,1894443192,1894443192,0
1361473143,1894522960,1,90,90,1361473117121,1361473117121,1894497081,1894497081,0
1361473272,1894651576,14,4789,342.0714286,1361473253374,1361473265022,1894632950,1894644598,11648
1361473272,1894651576,12,999,83.25,1361473253820,1361473265020,1894633396,1894644596,11200
1361473272,1894651584,12,999,83.25,1361473254069,1361473265013,1894633653,1894644597,10944
1361473272,1894651656,12,999,83.25,1361473254253,1361473264941,1894633909,1894644597,10688
1361473392,1894771680,1,95,95,1361473365586,1361473365586,1894745266,1894745266,0
1361473420,1894799696,1,90,90,1361473392707,1361473392707,1894772403,1894772403,0
1361473432,1894811820,1,64,64,1361473406665,1361473406665,1894786485,1894786485,0
1361473460,1894839904,1,48,48,1361473433075,1361473433075,1894812979,1894812979,0
1361473488,1894868184,1,60,60,1361473463067,1361473463067,1894843251,1894843251,0
1361473492,1894872168,1,60,60,1361473464813,1361473464813,1894844981,1894844981,0
1361473520,1894900540,1,46,46,1361473493175,1361473493175,1894873715,1894873715,0
1361473521,1894900948,1,46,46,1361473493768,1361473493768,1894873716,1894873716,0
1361474294,1895674444,3,152,50.66666667,1361474267274,1361474276234,1895647718,1895656678,8960
1361474346,1895726508,1,90,90,1361474321290,1361474321290,1895701798,1895701798,0
1361474427,1895806860,1,46,46,1361474400143,1361474400143,1895780003,1895780003,0
1361474623,1896003416,1,90,90,1361474596834,1361474596834,1895977250,1895977250,0
1361474735,1896115464,1,48,48,1361474708401,1361474708401,1896088865,1896088865,0
1361475072,1896451748,9,861,95.66666667,1361475044793,1361475044985,1896424541,1896424733,192
1361475072,1896451824,9,861,95.66666667,1361475044459,1361475044651,1896424283,1896424475,192
1361475072,1896451860,9,861,95.66666667,1361475044935,1361475045127,1896424795,1896424987,192
1361475260,1896640500,8,815,101.875,1361475235654,1361475235846,1896616154,1896616346,192
1361475261,1896640588,8,815,101.875,1361475235797,1361475235989,1896615385,1896615577,192
1361475261,1896640612,8,815,101.875,1361475236028,1361475236220,1896615640,1896615832,192
1361475261,1896640612,8,815,101.875,1361475236283,1361475236475,1896615895,1896616087,192
1361475272,1896652448,1,46,46,1361475244153,1361475244153,1896624601,1896624601,0
1361475277,1896656792,2,126,63,1361475274694,1361475275718,1896654486,1896655510,1024
1361475285,1896664748,2,126,63,1361475277748,1361475281780,1896657496,1896661528,4032
1361475317,1896696576,1,63,63,1361475290015,1361475290015,1896669591,1896669591,0
1361475325,1896704920,3,189,63,1361475319046,1361475322054,1896698966,1896701974,3008
1361475341,1896720860,2,126,63,1361475326149,1361475334213,1896706009,1896714073,8064
1361475365,1896744904,3,189,63,1361475359766,1361475362774,1896739670,1896742678,3008
1361475381,1896760992,2,126,63,1361475366720,1361475374784,1896746712,1896754776,8064
1361475477,1896857148,3,189,63,1361475473184,1361475476256,1896853332,1896856404,3072
1361475477,1896857152,3,189,63,1361475473373,1361475476381,1896853525,1896856533,3008
1361475493,1896873200,2,126,63,1361475480367,1361475488431,1896860567,1896868631,8064
1361475493,1896873272,2,126,63,1361475480102,1361475488166,1896860374,1896868438,8064
1361475573,1896953292,3,189,63,1361475566543,1361475569551,1896946835,1896949843,3008
1361475573,1896953372,3,189,63,1361475566465,1361475569473,1896946837,1896949845,3008
1361475589,1896969292,2,126,63,1361475573583,1361475581647,1896953875,1896961939,8064
1361475589,1896969364,2,126,63,1361475573512,1361475581576,1896953876,1896961940,8064
1361475665,1897045068,1,90,90,1361475636973,1361475636973,1897017041,1897017041,0
1361475694,1897073852,8,2004,250.5,1361475686791,1361475686983,1897066643,1897066835,192
1361475694,1897073964,7,1966,280.8571429,1361475688854,1361475689110,1897068818,1897069074,256
1361475713,1897093080,2,216,108,1361475685729,1361475685793,1897065809,1897065873,64
1361475713,1897093096,2,216,108,1361475685458,1361475685586,1897065554,1897065682,128
1361475713,1897093208,2,216,108,1361475685472,1361475685600,1897065680,1897065808,128
1361475761,1897141292,3,156,52,1361475736654,1361475745742,1897116946,1897126034,9088
1361475829,1897209312,1,90,90,1361475802041,1361475802041,1897182353,1897182353,0
1361475889,535582572,4,445,111.25,1361475886383,1361475886639,535579955,535580211,256
1361475893,1897273376,2,216,108,1361475866681,1361475866745,1897247057,1897247121,64
1361475893,1897273460,1,108,108,1361475866339,1361475866339,1897246799,1897246799,0
1361475893,1897273460,2,216,108,1361475866466,1361475866594,1897246926,1897247054,128
1361475894,1897274156,9,3310,367.7777778,1361475891987,1361475893779,1897272143,1897273935,1792
1361475897,535590560,4,1448,362,1361475889786,1361475889978,535583346,535583538,192
1361475902,1897282068,4,479,119.75,1361475895594,1361475895658,1897275662,1897275726,64
1361475902,1897282120,12,4555,379.5833333,1361475894776,1361475895672,1897274896,1897275792,896
1361475902,1897282128,4,479,119.75,1361475895664,1361475895728,1897275792,1897275856,64
1361475917,1897297488,28,15004,535.8571429,1361475890567,1361475911239,1897271055,1897291727,20672
1361475921,1897301436,6,3346,557.6666667,1361475895612,1361475896252,1897276048,1897276688,640
1361475921,1897301456,21,21278,1013.238095,1361475896357,1361475916837,1897276813,1897297293,20480
1361475924,535618100,12,3252,271,1361475896734,1361475923550,535590834,535617650,26816
1361475924,535618124,75,101883,1358.44,1361475898950,1361475912710,535593074,535606834,13760
1361475924,535618156,78,104668,1341.897436,1361475898727,1361475912487,535592883,535606643,13760
1361475924,535618168,72,79912,1109.888889,1361475899227,1361475921883,535593395,535616051,22656
1361475926,1897306212,4,720,180,1361475917916,1361475917980,1897298128,1897298192,64
1361475937,1897317460,34,24152,710.3529412,1361475911268,1361475935652,1897291728,1897316112,24384
1361475945,1897325432,11,4506,409.6363636,1361475917822,1361475935998,1897298254,1897316430,18176
1361475949,1897329444,5,1432,286.4,1361475923504,1361475946992,1897303948,1897327436,23488
1361475950,1897330176,2,104,52,1361475947327,1361475947327,1897327503,1897327503,0
1361475952,535646272,3,942,314,1361475926195,1361475948403,535620467,535642675,22208
1361475953,535646296,67,82593,1232.731343,1361475925250,1361475952194,535618546,535645490,26944
1361475953,535646336,1,52,52,1361475928284,1361475928284,535621620,535621620,0
1361475953,535646336,1,52,52,1361475928475,1361475928475,535621811,535621811,0
1361475953,535646580,185,230538,1246.151351,1361475900004,1361475951780,535593584,535645360,51776
1361475958,1897338088,108,154105,1426.898148,1361475949268,1361475953428,1897329356,1897333516,4160
1361475958,1897338156,78,105869,1357.294872,1361475948820,1361475954388,1897328976,1897334544,5568
1361475966,1897346068,2,98,49,1361475951403,1361475959339,1897331471,1897339407,7936
1361475966,1897346196,4,225,56.25,1361475962280,1361475964392,1897342476,1897344588,2112
1361475966,1897346204,10,3589,358.9,1361475947297,1361475965153,1897327501,1897345357,17856
1361475974,1897353632,9,11857,1317.444444,1361475949022,1361475949150,1897328654,1897328782,128
1361475989,535682292,5,1570,314,1361475963590,1361475981510,535656882,535674802,17920
1361475989,535682344,1,52,52,1361475964691,1361475964691,535658035,535658035,0
1361475990,1897369564,15,4142,276.1333333,1361475965024,1361475988320,1897344588,1897367884,23296
1361475990,1897369568,31,20922,674.9032258,1361475965790,1361475989022,1897345358,1897368590,23232
1361475990,1897370076,4,720,180,1361475981984,1361475982048,1897362060,1897362124,64
1361475990,1897370084,10,3205,320.5,1361475966680,1361475981912,1897346764,1897361996,15232
1361475993,535686280,1,52,52,1361475967249,1361475967249,535660529,535660529,0
1361475998,1897378096,4,735,183.75,1361475982157,1361475997453,1897362253,1897377549,15296
1361475998,1897378096,376,544726,1448.739362,1361475990093,1361475995405,1897370189,1897375501,5312
1361475998,1897378144,472,666125,1411.28178,1361475988829,1361475994397,1897368973,1897374541,5568
1361475998,1897378184,10,4451,445.1,1361475991861,1361475992565,1897372045,1897372749,704
1361476001,535694568,167,212846,1274.526946,1361475964468,1361475997364,535658036,535690932,32896
1361476001,535694588,149,188203,1263.107383,1361475966944,1361475997408,535660532,535690996,30464
1361476006,1897386100,2,133,66.5,1361476002762,1361476002762,1897382862,1897382862,0
1361476006,1897386144,11,3139,285.3636364,1361476001567,1361476002463,1897381711,1897382607,896
1361476006,1897386204,8,1934,241.75,1361476003872,1361476004960,1897384076,1897385164,1088
1361476009,535702548,2,366,183,1361475989126,1361476004102,535682674,535697650,14976
1361476009,535702556,14,16080,1148.571429,1361476008127,1361476008191,535701683,535701747,64
1361476014,1897393556,1,46,46,1361475989417,1361475989417,1897368973,1897368973,0
1361476014,1897393636,12,16309,1359.083333,1361475989016,1361475989208,1897368652,1897368844,192
1361476014,1897394112,10,3594,359.4,1361476006782,1361476007934,1897386894,1897388046,1152
1361476014,1897394148,9,3530,392.2222222,1361476011866,1361476013850,1897392014,1897393998,1984
1361476014,1897394240,9,3248,360.8888889,1361476005052,1361476005820,1897385292,1897386060,768
1361476017,535710612,74,104387,1410.635135,1361476008967,1361476009223,535702579,535702835,256
1361476017,535710624,4,499,124.75,1361476008444,1361476009212,535702068,535702836,768
1361476018,1897397576,31,9675,312.0967742,1361475993236,1361476012756,1897372812,1897392332,19520
1361476018,1897397592,1,46,46,1361475990597,1361475990597,1897370189,1897370189,0
1361476022,1897402208,2,92,46,1361476015838,1361476015838,1897396046,1897396046,0
1361476029,535722348,7,1420,202.8571429,1361476001104,1361476028112,535694452,535721460,27008
1361476030,1897409612,1,46,46,1361476003376,1361476003376,1897382988,1897382988,0
1361476030,1897409620,2,104,52,1361476003687,1361476017319,1897383307,1897396939,13632
1361476041,535734336,13,16028,1232.923077,1361476013656,1361476013720,535706992,535707056,64
1361476042,1897421592,7,3405,486.4285714,1361476017350,1361476018118,1897396942,1897397710,768
1361476042,1897421676,7,2847,406.7142857,1361476016434,1361476017330,1897396110,1897397006,896
1361476054,1897433588,1,52,52,1361476027466,1361476027466,1897407054,1897407054,0
1361476118,1897497780,5,250,50,1361476091527,1361476113287,1897471307,1897493067,21760
1361476162,1897541756,1,48,48,1361476137693,1361476137693,1897517449,1897517449,0
1361476194,1897573728,1,48,48,1361476167097,1361476167097,1897546825,1897546825,0
1361476321,536014992,2242,3351304,1494.783229,1361476013709,1361476023245,535707701,535717237,9536
1361476326,1897706268,1,90,90,1361476301534,1361476301534,1897681802,1897681802,0
1361476346,1897726248,3,426,142,1361476319666,1361476325170,1897699914,1897705418,5504
1361476759,1898139516,1,90,90,1361476731677,1361476731677,1898112193,1898112193,0
1361476824,1898203756,1,56,56,1361476798740,1361476798740,1898178496,1898178496,0
1361476860,1898239704,9,861,95.66666667,1361476834056,1361476834248,1898213760,1898213952,192
1361476860,1898239732,8,815,101.875,1361476834348,1361476834476,1898214080,1898214208,128
1361476860,1898239748,2,122,61,1361476831900,1361476834140,1898211648,1898213888,2240
1361476860,1898239940,9,861,95.66666667,1361476833563,1361476833755,1898213503,1898213695,192
1361476965,1898345000,1,46,46,1361476936287,1361476936287,1898316287,1898316287,0
1361476965,1898345004,1,46,46,1361476936284,1361476936284,1898316288,1898316288,0
1361477032,1898411980,1,90,90,1361477007347,1361477007347,1898387327,1898387327,0
1361477072,1898452376,4,252,63,1361477063012,1361477070116,1898443388,1898450492,7104
1361477072,1898452380,4,252,63,1361477063199,1361477070303,1898443579,1898450683,7104
1361477072,1898452388,4,252,63,1361477064664,1361477071704,1898445052,1898452092,7040
1361477104,1898484040,1,63,63,1361477078645,1361477078645,1898458685,1898458685,0
1361477104,1898484140,1,63,63,1361477078352,1361477078352,1898458492,1898458492,0
1361477104,1898484180,3,447,149,1361477079209,1361477085225,1898459389,1898465405,6016
1361477108,1898488032,1,63,63,1361477080126,1361477080126,1898460158,1898460158,0
1361477108,1898488068,8,815,101.875,1361477081239,1361477081431,1898461307,1898461499,192
1361477108,1898488076,8,815,101.875,1361477081810,1361477082002,1898461886,1898462078,192
1361477108,1898488160,8,815,101.875,1361477080894,1361477081086,1898461054,1898461246,192
1361477108,1898488180,9,861,95.66666667,1361477081384,1361477081576,1898461564,1898461756,192
1361477272,1898652428,1,46,46,1361477244079,1361477244079,1898624507,1898624507,0
1361477272,1898652516,1,46,46,1361477243864,1361477243864,1898624380,1898624380,0
1361477272,1898652516,1,46,46,1361477243927,1361477243927,1898624443,1898624443,0
1361477273,1898652628,1,46,46,1361477245772,1361477245772,1898625400,1898625400,0
1361477273,1898652632,1,46,46,1361477245836,1361477245836,1898625468,1898625468,0
1361477273,1898652632,1,46,46,1361477245899,1361477245899,1898625531,1898625531,0
1361477313,1898692928,4,252,63,1361477304160,1361477311200,1898684088,1898691128,7040
1361477321,1898700852,4,252,63,1361477311855,1361477318895,1898691707,1898698747,7040
1361477321,1898700852,4,252,63,1361477311919,1361477318959,1898691771,1898698811,7040
1361477345,1898724640,1,63,63,1361477319552,1361477319552,1898699192,1898699192,0
1361477353,1898732772,1,63,63,1361477327038,1361477327038,1898706810,1898706810,0
1361477353,1898732772,1,63,63,1361477327038,1361477327038,1898706810,1898706810,0
1361477393,1898773216,2,126,63,1361477389887,1361477390911,1898770103,1898771127,1024
1361477401,1898781180,2,126,63,1361477392997,1361477397029,1898773177,1898777209,4032
1361477433,1898812900,1,63,63,1361477405309,1361477405309,1898785209,1898785209,0
1361477585,1898965364,1,90,90,1361477557481,1361477557481,1898937845,1898937845,0
1361477814,1899193948,3,447,149,1361477787654,1361477793670,1899167602,1899173618,6016
1361477870,1899250428,1,46,46,1361477845223,1361477845223,1899225651,1899225651,0
1361477918,1899298384,1,46,46,1361477892495,1361477892495,1899272879,1899272879,0
1361477918,1899298404,1,46,46,1361477892862,1361477892862,1899273266,1899273266,0
1361477963,1899342592,1,90,90,1361477937318,1361477937318,1899316910,1899316910,0
1361478239,1899619208,1,90,90,1361478212283,1361478212283,1899592491,1899592491,0
1361478247,1899627216,1,46,46,1361478220594,1361478220594,1899600810,1899600810,0
1361478480,1899860088,3,447,149,1361478455793,1361478461809,1899835881,1899841897,6016
1361478656,1900036532,9,861,95.66666667,1361478628466,1361478628658,1900008998,1900009190,192
1361478657,1900036536,9,861,95.66666667,1361478629718,1361478629910,1900009254,1900009446,192
1361478657,1900036560,9,861,95.66666667,1361478629951,1361478630143,1900009511,1900009703,192
1361478737,1900116708,1,90,90,1361478712233,1361478712233,1900091941,1900091941,0
1361478741,1900120596,1,46,46,1361478713943,1361478713943,1900093539,1900093539,0
1361478869,1900249328,4,252,63,1361478860857,1361478867897,1900241185,1900248225,7040
1361478885,1900265384,4,252,63,1361478876228,1361478883268,1900256612,1900263652,7040
1361478901,1900281108,1,63,63,1361478876180,1361478876180,1900256288,1900256288,0
1361478917,1900297396,1,63,63,1361478891317,1361478891317,1900271713,1900271713,0
1361478950,1900329920,2,126,63,1361478948496,1361478949520,1900328416,1900329440,1024
1361478958,1900337984,2,126,63,1361478951439,1361478955471,1900331423,1900335455,4032
1361478990,1900369568,1,63,63,1361478963953,1361478963953,1900343521,1900343521,0
1361478990,1900369800,5,250,50,1361478965513,1361478986953,1900345313,1900366753,21440
1361479002,1900381640,8,815,101.875,1361478976937,1361478977129,1900356577,1900356769,192
1361479002,1900381724,8,815,101.875,1361478976596,1361478976724,1900356320,1900356448,128
1361479002,1900381756,8,815,101.875,1361478977075,1361478977267,1900356831,1900357023,192
1361479038,1900417612,1,48,48,1361479011330,1361479011330,1900390942,1900390942,0
1361479066,1900445776,1,48,48,1361479040478,1361479040478,1900420254,1900420254,0
1361479078,1900457612,1,64,64,1361479050755,1361479050755,1900430367,1900430367,0
1361479078,1900457732,1,64,64,1361479050508,1361479050508,1900430240,1900430240,0
1361479222,1900602392,2,126,63,1361479220660,1361479221620,1900601052,1900602012,960
1361479230,1900610340,2,126,63,1361479223719,1361479227751,1900604059,1900608091,4032
1361479247,1900626720,3,138,46,1361479245524,1361479246548,1900625244,1900626268,1024
1361479247,1900626804,3,138,46,1361479245440,1361479246464,1900625244,1900626268,1024
1361479262,1900642372,2,109,54.5,1361479235786,1361479244874,1900616158,1900625246,9088
1361479270,1900650364,3,447,149,1361479243154,1361479249234,1900623518,1900629598,6080
1361479274,1900654488,14,6617,472.6428571,1361479247187,1361479247507,1900627675,1900627995,320
1361479274,1900654520,9,861,95.66666667,1361479247540,1361479247732,1900628060,1900628252,192
1361479274,1900654524,8,815,101.875,1361479247794,1361479247986,1900628318,1900628510,192
1361479274,1900654528,9,861,95.66666667,1361479248109,1361479248237,1900628637,1900628765,128
1361479290,1900670464,1,90,90,1361479265452,1361479265452,1900645916,1900645916,0
1361479443,1900822872,1,90,90,1361479417531,1361479417531,1900797403,1900797403,0
1361479503,1900883296,3,138,46,1361479501265,1361479501329,1900881561,1900881625,64
1361479503,1900883296,3,138,46,1361479501329,1361479501393,1900881625,1900881689,64
1361479503,1900883372,3,138,46,1361479501190,1361479501254,1900881562,1900881626,64
1361479503,1900883372,3,138,46,1361479501188,1361479501252,1900881560,1900881624,64
1361479519,1900899312,16,6372,398.25,1361479501378,1361479513474,1900881690,1900893786,12096
1361479519,1900899312,12,999,83.25,1361479502271,1361479513407,1900882583,1900893719,11136
1361479519,1900899388,11,953,86.63636364,1361479501941,1361479513333,1900882329,1900893721,11392
1361479519,1900899388,12,999,83.25,1361479501685,1361479513397,1900882073,1900893785,11712
1361479551,1900931380,3,150,50,1361479537790,1361479547774,1900918170,1900928154,9984
1361479635,1901015356,1,64,64,1361479608405,1361479608405,1900988761,1900988761,0
1361479635,1901015360,1,64,64,1361479608848,1361479608848,1900989208,1900989208,0
1361479635,1901015448,1,64,64,1361479608440,1361479608440,1900988888,1900988888,0
1361479635,1901015468,6,384,64,1361479608805,1361479613989,1900989273,1900994457,5184
1361479884,1901263840,3,447,149,1361479856596,1361479862612,1901236436,1901242452,6016
1361479944,1901323780,1,90,90,1361479917261,1361479917261,1901297041,1901297041,0
1361480156,1901536176,1,46,46,1361480129662,1361480129662,1901509838,1901509838,0
1361480373,1901752880,1,90,90,1361480347237,1361480347237,1901727117,1901727117,0
1361480497,1901876660,3,447,149,1361480468989,1361480475005,1901848649,1901854665,6016
1361480634,1902014160,1,46,46,1361480605766,1361480605766,1901985926,1901985926,0
1361480635,1902015268,1,46,46,1361480605662,1361480605662,1901985930,1901985930,0
1361480649,1902028872,1,90,90,1361480622631,1361480622631,1902002503,1902002503,0
1361480690,1902069896,3,150,50,1361480679377,1361480689425,1902059273,1902069321,10048
1361480722,1902101976,44,57035,1296.25,1361480719101,1361480719357,1902099077,1902099333,256
1361480743,1902123228,1,46,46,1361480713728,1361480713728,1902093956,1902093956,0
1361480745,1902124976,9,861,95.66666667,1361480718781,1361480718973,1902098757,1902098949,192
1361480745,1902125092,9,861,95.66666667,1361480718987,1361480719179,1902099079,1902099271,192
1361480745,1902125096,9,861,95.66666667,1361480719240,1361480719560,1902099336,1902099656,320
1361480906,1902286008,2,126,63,1361480903132,1361480904092,1902283140,1902284100,960
1361480914,1902293960,2,126,63,1361480906186,1361480910218,1902286146,1902290178,4032
1361480945,1902325200,1,63,63,1361480917978,1361480917978,1902298178,1902298178,0
1361480970,1902350080,3,189,63,1361480966547,1361480969555,1902346627,1902349635,3008
1361480986,1902366084,2,126,63,1361480973581,1361480981645,1902353665,1902361729,8064
1361481073,1902453420,8,815,101.875,1361481047037,1361481047165,1902427457,1902427585,128
1361481073,1902453424,8,815,101.875,1361481047291,1361481047483,1902427715,1902427907,192
1361481077,1902457476,1,63,63,1361481052293,1361481052293,1902432769,1902432769,0
1361481141,1902521384,3,450,150,1361481113377,1361481119457,1902493761,1902499841,6080
1361481210,1902589636,1,90,90,1361481184137,1361481184137,1902563773,1902563773,0
1361481290,1902670388,2,126,63,1361481288603,1361481289563,1902668991,1902669951,960
1361481298,1902677780,1,95,95,1361481272763,1361481272763,1902652543,1902652543,0
1361481298,1902678300,4,252,63,1361481289523,1361481296563,1902669823,1902676863,7040
1361481298,1902678336,2,126,63,1361481291662,1361481295694,1902671998,1902676030,4032
1361481322,1902701668,9,861,95.66666667,1361481297000,1361481297128,1902676668,1902676796,128
1361481322,1902701676,8,815,101.875,1361481297506,1361481297634,1902677182,1902677310,128
1361481322,1902701680,8,815,101.875,1361481297759,1361481297951,1902677439,1902677631,192
1361481322,1902701768,9,861,95.66666667,1361481297158,1361481297286,1902676926,1902677054,128
1361481346,1902725768,1,84,84,1361481319173,1361481319173,1902698941,1902698941,0
1361481434,1902814080,1,64,64,1361481408652,1361481408652,1902788732,1902788732,0
1361481434,1902814080,6,384,64,1361481408652,1361481413900,1902788732,1902793980,5248
1361481434,1902814188,1,64,64,1361481408224,1361481408224,1902788412,1902788412,0
1361481434,1902814188,1,64,64,1361481408351,1361481408351,1902788539,1902788539,0
1361481514,1902894500,3,189,63,1361481507303,1361481510311,1902887803,1902890811,3008
1361481530,1902910476,2,126,63,1361481528509,1361481529533,1902908985,1902910009,1024
1361481530,1902910508,2,126,63,1361481514336,1361481522400,1902894844,1902902908,8064
1361481538,1902918524,4,252,63,1361481529488,1361481536528,1902910012,1902917052,7040
1361481539,1902918560,2,126,63,1361481532497,1361481536465,1902912057,1902916025,3968
1361481570,1902950456,1,63,63,1361481543633,1361481543633,1902924089,1902924089,0
1361481571,1902950580,1,63,63,1361481545533,1361481545533,1902925113,1902925113,0
1361481579,1902958672,1,90,90,1361481552228,1361481552228,1902931900,1902931900,0
1361481603,1902982828,3,189,63,1361481599687,1361481602695,1902979515,1902982523,3008
1361481619,1902998820,2,126,63,1361481606733,1361481614797,1902986553,1902994617,8064
1361481751,1903131180,3,450,150,1361481726434,1361481732450,1903106614,1903112630,6016
1361481799,1903179056,1,48,48,1361481773216,1361481773216,1903153272,1903153272,0
1361481855,1903235096,1,90,90,1361481827317,1361481827317,1903207413,1903207413,0
1361482123,1903503512,3,162,54,1361482095314,1361482101330,1903475826,1903481842,6016
1361482352,1903731852,1,90,90,1361482327266,1361482327266,1903707118,1903707118,0
1361482368,1903747884,3,450,150,1361482340802,1361482346882,1903720686,1903726766,6080
1361482849,1904229028,1,90,90,1361482821804,1361482821804,1904201832,1904201832,0
1361482862,1904242468,1,48,48,1361482834610,1361482834610,1904215078,1904215078,0
1361482864,1904243724,1,48,48,1361482835356,1361482835356,1904215080,1904215080,0
1361482865,1904245124,9,861,95.66666667,1361482840012,1361482840204,1904220136,1904220328,192
1361482865,1904245204,14,6617,472.6428571,1361482839546,1361482839866,1904219750,1904220070,320
1361482865,1904245212,9,861,95.66666667,1361482840177,1361482840369,1904220389,1904220581,192
1361482865,1904245240,8,815,101.875,1361482840409,1361482840601,1904220649,1904220841,192
1361482965,1904345284,1,46,46,1361482937896,1361482937896,1904318180,1904318180,0
1361482981,1904361168,3,450,150,1361482953564,1361482959580,1904333732,1904339748,6016
1361483038,1904418372,4,252,63,1361483029650,1361483036690,1904410022,1904417062,7040
1361483046,1904426284,2,126,63,1361483043623,1361483044647,1904423907,1904424931,1024
1361483054,1904434324,2,126,63,1361483046656,1361483050688,1904426980,1904431012,4032
1361483057,1904437356,1,90,90,1361483032030,1361483032030,1904412386,1904412386,0
1361483069,1904449488,1,63,63,1361483044634,1361483044634,1904425122,1904425122,0
1361483085,1904465396,1,63,63,1361483058615,1361483058615,1904439011,1904439011,0
1361483098,1904477536,14,6617,472.6428571,1361483073426,1361483073746,1904452962,1904453282,320
1361483101,1904481420,9,861,95.66666667,1361483072927,1361483073119,1904453347,1904453539,192
1361483101,1904481428,9,861,95.66666667,1361483073173,1361483073365,1904453601,1904453793,192
1361483101,1904481428,8,815,101.875,1361483073431,1361483073623,1904453859,1904454051,192
1361483110,1904490332,3,189,63,1361483104056,1361483107128,1904484388,1904487460,3072
1361483127,1904506612,2,126,63,1361483111877,1361483119877,1904491489,1904499489,8000
1361483142,1904522464,2,126,63,1361483139379,1361483140403,1904519843,1904520867,1024
1361483150,1904530316,2,126,63,1361483142599,1361483146631,1904522915,1904526947,4032
1361483182,1904561580,1,63,63,1361483155368,1361483155368,1904534948,1904534948,0
1361483198,1904577688,1,46,46,1361483170553,1361483170553,1904550241,1904550241,0
1361483319,1904698540,3,189,63,1361483315788,1361483318796,1904695328,1904698336,3008
1361483334,1904714508,2,126,63,1361483321860,1361483329924,1904702368,1904710432,8064
1361483351,1904730600,2,126,63,1361483349134,1361483350094,1904728734,1904729694,960
1361483359,1904738640,2,126,63,1361483352104,1361483356136,1904731744,1904735776,4032
1361483375,1904754640,3,189,63,1361483369704,1361483372712,1904749344,1904752352,3008
1361483375,1904754720,3,189,63,1361483369496,1361483372568,1904749216,1904752288,3072
1361483390,1904770320,1,63,63,1361483363518,1361483363518,1904743838,1904743838,0
1361483391,1904770636,2,126,63,1361483376746,1361483384810,1904756382,1904764446,8064
1361483391,1904770736,2,126,63,1361483376584,1361483384584,1904756320,1904764320,8000
1361483559,1904938924,1,90,90,1361483532233,1361483532233,1904912157,1904912157,0
1361483595,1904974956,3,450,150,1361483567529,1361483573545,1904947485,1904953501,6016
1361483635,1905015092,1,60,60,1361483610591,1361483610591,1904990683,1904990683,0
1361483639,1905018928,1,60,60,1361483612420,1361483612420,1904992348,1904992348,0
1361483759,1905139268,1,48,48,1361483733039,1361483733039,1905113307,1905113307,0
1361484204,1905584240,3,450,150,1361484179522,1361484185538,1905559762,1905565778,6016
1361484264,1905644236,1,90,90,1361484237189,1361484237189,1905617425,1905617425,0
1361484573,1905953232,1,95,95,1361484548166,1361484548166,1905928398,1905928398,0
1361484657,1906037476,14,6617,472.6428571,1361484632273,1361484632593,1906012749,1906013069,320
1361484657,1906037484,9,861,95.66666667,1361484632649,1361484632841,1906013133,1906013325,192
1361484661,1906041448,9,861,95.66666667,1361484632941,1361484633133,1906013389,1906013581,192
1361484661,1906041476,8,815,101.875,1361484633166,1361484633358,1906013642,1906013834,192
1361484834,1906213924,1,90,90,1361484807990,1361484807990,1906187914,1906187914,0
1361484866,1906246308,3,189,63,1361484861555,1361484864627,1906241863,1906244935,3072
1361484866,1906246312,3,189,63,1361484861615,1361484864623,1906241927,1906244935,3008
1361484882,1906262288,2,126,63,1361484868679,1361484876743,1906248967,1906257031,8064
1361484882,1906262372,2,126,63,1361484868597,1361484876597,1906248969,1906256969,8000
1361484910,1906290120,1,95,95,1361484883374,1361484883374,1906263494,1906263494,0
1361484914,1906294344,3,189,63,1361484908239,1361484911311,1906288583,1906291655,3072
1361484922,1906302224,3,450,150,1361484896007,1361484902023,1906276231,1906282247,6016
1361484930,1906310324,2,126,63,1361484915364,1361484923364,1906295688,1906303688,8000
1361484955,1906334580,3,189,63,1361484951178,1361484954250,1906330758,1906333830,3072
1361484971,1906350628,2,126,63,1361484958237,1361484966237,1906337865,1906345865,8000
1361485468,1906847888,1,90,90,1361485442513,1361485442513,1906822401,1906822401,0
1361485536,1906915864,3,450,150,1361485511077,1361485517029,1906890941,1906896893,5952
1361485969,1907349412,1,90,90,1361485941758,1361485941758,1907322170,1907322170,0
1361486086,1907465832,1,48,48,1361486059902,1361486059902,1907439734,1907439734,0
1361486206,1907586236,3,450,150,1361486180905,1361486186921,1907561141,1907567157,6016
1361486270,1907650276,6,828,138,1361486245121,1361486251137,1907625397,1907631413,6016
1361486314,1907694224,6,837,139.5,1361486287283,1361486293363,1907667507,1907673587,6080
1361486439,1907818848,11,953,86.63636364,1361486425323,1361486434795,1907805171,1907814643,9472
1361486463,1907842900,16,6335,395.9375,1361486441396,1361486460404,1907821296,1907840304,19008
1361486463,1907842904,12,999,83.25,1361486441969,1361486460401,1907821873,1907840305,18432
1361486463,1907842916,12,999,83.25,1361486442534,1361486460326,1907822450,1907840242,17792
1361486463,1907842984,12,999,83.25,1361486442144,1361486460256,1907822128,1907840240,18112
1361486476,546169640,9,7809,867.6666667,1361486460270,1361486472238,546153910,546165878,11968
1361486476,546169640,8,7208,901,1361486460333,1361486472237,546153973,546165877,11904
1361486479,1907858924,12,999,83.25,1361486460379,1361486472411,1907840303,1907852335,12032
1361486479,1907858932,11,953,86.63636364,1361486461461,1361486472405,1907841393,1907852337,10944
1361486479,1907858976,18,7173,398.5,1361486460202,1361486472298,1907840178,1907852274,12096
1361486479,1907858980,11,953,86.63636364,1361486460773,1361486472357,1907840753,1907852337,11584
1361486479,1907859004,11,953,86.63636364,1361486461004,1361486472332,1907841008,1907852336,11328
1361486551,1907930892,11,3267,297,1361486522874,1361486523450,1907902766,1907903342,576
1361486639,1908019424,3,193,64.33333333,1361486633893,1361486633893,1908014317,1908014317,0
1361486675,1908055504,1,90,90,1361486646869,1361486646869,1908027373,1908027373,0
1361486820,1908200052,3,450,150,1361486794841,1361486800857,1908174893,1908180909,6016
1361487173,1908552840,1,90,90,1361487147432,1361487147432,1908527272,1908527272,0
1361487437,1908817288,3,450,150,1361487409825,1361487415841,1908790113,1908796129,6016
1361487878,1909258268,1,90,90,1361487852208,1361487852208,1909232476,1909232476,0
1361488051,1909430764,3,450,150,1361488025316,1361488031332,1909405080,1909411096,6016
1361488299,1909679328,9,861,95.66666667,1361488272111,1361488272303,1909652439,1909652631,192
1361488299,1909679332,9,861,95.66666667,1361488272361,1361488272553,1909652693,1909652885,192
1361488299,1909679336,9,861,95.66666667,1361488272677,1361488272805,1909653013,1909653141,128
1361488299,1909679496,12,6151,512.5833333,1361488271495,1361488271879,1909651991,1909652375,384
1361488303,1909683480,3,414,138,1361488277142,1361488283222,1909657622,1909663702,6080
1361488396,1909775780,3,138,46,1361488388302,1361488388366,1909768082,1909768146,64
1361488396,1909775780,3,138,46,1361488388302,1361488388366,1909768082,1909768146,64
1361488396,1909775780,3,138,46,1361488388366,1361488388430,1909768146,1909768210,64
1361488396,1909775784,3,138,46,1361488388302,1361488388366,1909768086,1909768150,64
1361488404,1909783700,11,953,86.63636364,1361488391521,1361488403617,1909771221,1909783317,12096
1361488404,1909783708,11,953,86.63636364,1361488392408,1361488403544,1909772116,1909783252,11136
1361488404,1909783756,11,953,86.63636364,1361488391783,1361488403559,1909771539,1909783315,11776
1361488404,1909783784,11,953,86.63636364,1361488392077,1361488403469,1909771861,1909783253,11392
1361488412,1909791764,13,3408,262.1538462,1361488391391,1361488404319,1909771155,1909784083,12928
1361488423,1909803408,1,90,90,1361488396570,1361488396570,1909776978,1909776978,0
1361488863,1910242780,1,46,46,1361488833353,1361488833353,1910213133,1910213133,0
1361488863,1910242784,1,46,46,1361488833411,1361488833411,1910213195,1910213195,0
1361488925,1910305224,11,953,86.63636364,1361488908621,1361488917837,1910288845,1910298061,9216
1361488925,1910305284,16,6372,398.25,1361488907601,1361488917777,1910287885,1910298061,10176
1361488925,1910305292,12,999,83.25,1361488907976,1361488917768,1910288268,1910298060,9792
1361488925,1910305296,12,999,83.25,1361488908229,1361488917765,1910288525,1910298061,9536
1361488949,1910328536,11,3267,297,1361488924475,1361488925243,1910304011,1910304779,768
1361488973,1910353340,3,193,64.33333333,1361488971862,1361488971862,1910352202,1910352202,0
1361488993,1910372632,1,95,95,1361488965852,1361488965852,1910345484,1910345484,0
1361489085,1910464584,1,90,90,1361489057736,1361489057736,1910437320,1910437320,0
1361489459,1910838856,1,48,48,1361489432757,1361489432757,1910812613,1910812613,0
1361489459,1910838876,1,48,48,1361489432736,1361489432736,1910812612,1910812612,0
1361489459,1910839036,1,64,64,1361489432769,1361489432769,1910812805,1910812805,0
1361489461,1910840940,1,64,64,1361489433312,1361489433312,1910813252,1910813252,0
1361489582,1910961636,1,90,90,1361489557711,1361489557711,1910937347,1910937347,0
1361489710,1911090176,15,6289,419.2666667,1361489692080,1361489703152,1911072256,1911083328,11072
1361489710,1911090180,11,953,86.63636364,1361489692971,1361489703147,1911073151,1911083327,10176
1361489710,1911090256,12,999,83.25,1361489692385,1361489703073,1911072641,1911083329,10688
1361489710,1911090256,12,999,83.25,1361489692638,1361489703070,1911072894,1911083326,10432
1361490003,1911382800,3,414,138,1361489977442,1361489983458,1911357242,1911363258,6016
1361490288,1911667572,1,90,90,1361490262916,1361490262916,1911642488,1911642488,0
1361490511,1911890632,12,999,83.25,1361490496197,1361490507525,1911875829,1911887157,11328
1361490511,1911890672,11,953,86.63636364,1361490496411,1361490507483,1911876083,1911887155,11072
1361490511,1911890696,16,6372,398.25,1361490495430,1361490507526,1911875126,1911887222,12096
1361490511,1911890696,11,953,86.63636364,1361490495875,1361490507459,1911875571,1911887155,11584
1361490736,1912116352,3,414,138,1361490711410,1361490717426,1912091762,1912097778,6016
1361490756,1912136448,3,152,50.66666667,1361490730257,1361490739281,1912110705,1912119729,9024
1361490789,1912168508,1,90,90,1361490762878,1361490762878,1912142386,1912142386,0
1361491057,1912437220,3,450,150,1361491029873,1361491035889,1912410093,1912416109,6016
1361491242,1912622176,1,95,95,1361491216665,1361491216665,1912596841,1912596841,0
1361491358,1912738104,3,414,138,1361491330590,1361491336670,1912710694,1912716774,6080
1361491494,1912874336,1,90,90,1361491467126,1361491467126,1912847462,1912847462,0
1361491767,1913146948,2,96,48,1361491742071,1361491745015,1913122019,1913124963,2944
1361492048,1913427780,1,90,90,1361492023641,1361492023641,1913403421,1913403421,0
1361492104,1913484388,17,6755,397.3529412,1361492089272,1361492098872,1913469660,1913479260,9600
1361492104,1913484392,12,999,83.25,1361492089654,1361492098806,1913470046,1913479198,9152
1361492104,1913484412,12,999,83.25,1361492089889,1361492098785,1913470301,1913479197,8896
1361492273,1913652700,17,6418,377.5294118,1361492255143,1361492267239,1913634843,1913646939,12096
1361492273,1913652704,11,953,86.63636364,1361492255779,1361492267235,1913635483,1913646939,11456
1361492273,1913652704,12,999,83.25,1361492255523,1361492267235,1913635227,1913646939,11712
1361492273,1913652784,12,999,83.25,1361492255954,1361492267090,1913635738,1913646874,11136
1361492280,1913660296,11,3267,297,1361492254867,1361492255443,1913635163,1913635739,576
1361492385,1913765144,3,193,64.33333333,1361492378857,1361492378857,1913759001,1913759001,0
1361492457,1913836764,3,447,149,1361492430753,1361492436769,1913810517,1913816533,6016
1361493074,1914453968,3,447,149,1361493046541,1361493052557,1914426509,1914432525,6016
1361493090,1914469996,2,128,64,1361493065009,1361493066097,1914445005,1914446093,1088
1361493779,1915159036,14,3460,247.1428571,1361493759998,1361493772222,1915140034,1915152258,12224
1361494036,1915416232,1,48,48,1361494011769,1361494011769,1915392001,1915392001,0
1361494285,1915664552,1,48,48,1361494257886,1361494257886,1915637438,1915637438,0
1361494489,1915868656,1,46,46,1361494461361,1361494461361,1915841017,1915841017,0
1361494489,1915868740,1,46,46,1361494460894,1361494460894,1915840634,1915840634,0
1361494660,1916039748,11,953,86.63636364,1361494649169,1361494656017,1916028917,1916035765,6848
1361494660,1916039804,11,953,86.63636364,1361494648858,1361494656026,1916028662,1916035830,7168
1361494660,1916039812,12,999,83.25,1361494649364,1361494655956,1916029176,1916035768,6592
1361494689,1916068940,8,815,101.875,1361494662611,1361494662739,1916042551,1916042679,128
1361494689,1916068944,8,815,101.875,1361494662862,1361494663054,1916042806,1916042998,192
1361494689,1916069052,9,861,95.66666667,1361494663011,1361494663203,1916043063,1916043255,192
1361494689,1916069056,8,815,101.875,1361494663260,1361494663452,1916043316,1916043508,192
1361494825,1916205388,1,60,60,1361494799183,1361494799183,1916179571,1916179571,0
1361494829,1916209296,1,60,60,1361494801259,1361494801259,1916181555,1916181555,0
1361494908,1916288044,3,189,63,1361494903655,1361494906727,1916283699,1916286771,3072
1361494916,1916295948,2,126,63,1361494914823,1361494915783,1916294771,1916295731,960
1361494924,1916303856,2,126,63,1361494917921,1361494921953,1916297777,1916301809,4032
1361494924,1916303872,2,126,63,1361494910928,1361494918992,1916290800,1916298864,8064
1361494948,1916327980,4,252,63,1361494938855,1361494945959,1916318835,1916325939,7104
1361494958,1916337600,1,63,63,1361494930274,1361494930274,1916309874,1916309874,0
1361494982,1916361676,1,63,63,1361494954260,1361494954260,1916333936,1916333936,0
1361495092,1916472144,3,189,63,1361495085440,1361495088448,1916465584,1916468592,3008
1361495108,1916488136,2,126,63,1361495092488,1361495100552,1916472624,1916480688,8064
1361495154,1916534000,1,52,52,1361495127056,1361495127056,1916507056,1916507056,0
1361495318,1916698516,3,450,150,1361495292551,1361495298631,1916673067,1916679147,6080
1361495720,1917099532,1,60,60,1361495694362,1361495694362,1917073894,1917073894,0
1361495796,1917175704,1,60,60,1361495769199,1361495769199,1917148903,1917148903,0
1361496100,1917480372,3,447,149,1361496073742,1361496079822,1917454114,1917460194,6080
1361496353,1917733232,1,60,60,1361496327574,1361496327574,1917707806,1917707806,0
1361496481,1917861304,14,6617,472.6428571,1361496454027,1361496454347,1917834331,1917834651,320
1361496481,1917861308,8,815,101.875,1361496454407,1361496454599,1917834715,1917834907,192
1361496714,1918094068,3,447,149,1361496687798,1361496693814,1918067866,1918073882,6016
1361496734,1918114456,3,189,63,1361496726833,1361496729841,1918107289,1918110297,3008
1361496734,1918114456,3,189,63,1361496726832,1361496729840,1918107288,1918110296,3008
1361496742,1918122356,5,264,52.8,1361496733971,1361496735763,1918114327,1918116119,1792
1361496742,1918122412,5,264,52.8,1361496733917,1361496735709,1918114329,1918116121,1792
1361496762,1918142148,9,861,95.66666667,1361496737573,1361496737701,1918117721,1918117849,128
1361496766,1918146056,8,815,101.875,1361496737920,1361496738048,1918117976,1918118104,128
1361496766,1918146060,8,815,101.875,1361496738171,1361496738363,1918118231,1918118423,192
1361496766,1918146184,9,861,95.66666667,1361496738303,1361496738495,1918118487,1918118679,192
1361496951,1918331008,3,189,63,1361496945004,1361496948012,1918325012,1918328020,3008
1361496967,1918346900,2,126,63,1361496952151,1361496960215,1918332051,1918340115,8064
1361497055,1918435304,3,189,63,1361497049924,1361497052932,1918430228,1918433236,3008
1361497055,1918435304,3,189,63,1361497049923,1361497052931,1918430227,1918433235,3008
1361497055,1918435304,3,189,63,1361497049923,1361497052931,1918430227,1918433235,3008
1361497071,1918451248,2,126,63,1361497057017,1361497065081,1918437265,1918445329,8064
1361497071,1918451320,2,126,63,1361497056948,1361497065012,1918437268,1918445332,8064
1361497071,1918451320,2,126,63,1361497056947,1361497065011,1918437267,1918445331,8064
1361497328,1918708020,3,447,149,1361497302874,1361497308890,1918682894,1918688910,6016
1361497344,1918724148,11,953,86.63636364,1361497329948,1361497339292,1918710096,1918719440,9344
1361497344,1918724148,12,999,83.25,1361497330203,1361497339291,1918710351,1918719439,9088
1361497344,1918724196,17,6755,397.3529412,1361497329513,1361497339241,1918709709,1918719437,9728
1361497344,1918724224,12,999,83.25,1361497330383,1361497339215,1918710607,1918719439,8832
1361497351,557044364,5,574,114.8,1361497344583,1361497344647,557037947,557038011,64
1361497954,1919333684,3,450,150,1361497926882,1361497932898,1919306566,1919312582,6016
1361498322,1919702136,17,6755,397.3529412,1361498309593,1361498319705,1919689729,1919699841,10112
1361498322,1919702144,12,999,83.25,1361498310606,1361498319694,1919690750,1919699838,9088
1361498322,1919702196,12,999,83.25,1361498310301,1361498319645,1919690497,1919699841,9344
1361498566,1919946172,3,450,150,1361498540017,1361498546033,1919920189,1919926205,6016
1361499180,1920559872,3,450,150,1361499154194,1361499160210,1920534066,1920540082,6016
1361499794,1921173604,3,450,150,1361499766677,1361499772693,1921146281,1921152297,6016
1361499894,1921274040,3,162,54,1361499866527,1361499872543,1921246567,1921252583,6016
1361500139,1921518592,1,46,46,1361500114395,1361500114395,1921493987,1921493987,0
1361500142,1921522436,9,861,95.66666667,1361500114063,1361500114255,1921494499,1921494691,192
1361500142,1921522444,8,815,101.875,1361500114314,1361500114506,1921494758,1921494950,192
1361500150,1921529756,3,138,46,1361500146617,1361500146681,1921526373,1921526437,64
1361500150,1921529804,3,138,46,1361500146568,1361500146632,1921526372,1921526436,64
1361500166,1921545764,11,953,86.63636364,1361500150705,1361500161713,1921530469,1921541477,11008
1361500166,1921545768,11,953,86.63636364,1361500150379,1361500161707,1921530147,1921541475,11328
1361500166,1921545816,17,6755,397.3529412,1361500149566,1361500161662,1921529382,1921541478,12096
1361500166,1921545816,12,999,83.25,1361500150011,1361500161659,1921529827,1921541475,11648
1361500407,1921786856,3,450,150,1361500380113,1361500386129,1921759969,1921765985,6016
1361500638,1922018052,12,999,83.25,1361500620298,1361500632010,1922000350,1922012062,11712
1361500638,1922018056,11,953,86.63636364,1361500620615,1361500632007,1922000671,1922012063,11392
1361500638,1922018108,16,6335,395.9375,1361500619856,1361500631952,1921999964,1922012060,12096
1361500638,1922018120,11,953,86.63636364,1361500620804,1361500631940,1922000924,1922012060,11136
1361501020,1922399808,3,450,150,1361500993654,1361500999670,1922373462,1922379478,6016
1361501630,1923009560,3,450,150,1361501605796,1361501611876,1922985356,1922991436,6080
1361502448,1923828196,13,6234,479.5384615,1361502422236,1361502422556,1923802432,1923802752,320
1361502448,1923828224,9,861,95.66666667,1361502422850,1361502423042,1923803074,1923803266,192
1361502448,1923828308,9,861,95.66666667,1361502422509,1361502422701,1923802817,1923803009,192
1361502448,1923828336,9,861,95.66666667,1361502423057,1361502423185,1923803393,1923803521,128
1361502673,1924053140,4,252,63,1361502664786,1361502671826,1924044926,1924051966,7040
1361502689,1924068992,2,126,63,1361502686629,1361502687653,1924066621,1924067645,1024
1361502697,1924076956,2,126,63,1361502689675,1361502693707,1924069631,1924073663,4032
1361502705,1924084904,1,63,63,1361502680128,1361502680128,1924060032,1924060032,0
1361502729,1924108820,1,63,63,1361502701906,1361502701906,1924081726,1924081726,0
1361502770,1924149472,4,252,63,1361502760622,1361502767662,1924140094,1924147134,7040
1361502777,1924157440,4,252,63,1361502769126,1361502776166,1924149566,1924156606,7040
1361502801,1924181156,1,63,63,1361502775042,1361502775042,1924155198,1924155198,0
1361502809,1924189384,1,63,63,1361502784286,1361502784286,1924164670,1924164670,0
1361503703,1925082996,3,447,149,1361503678802,1361503684882,1925058798,1925064878,6080
1361504141,1925520588,16,6372,398.25,1361504127589,1361504137317,1925507177,1925516905,9728
1361504141,1925520588,12,999,83.25,1361504128163,1361504137315,1925507751,1925516903,9152
1361504141,1925520644,11,953,86.63636364,1361504128426,1361504137130,1925508070,1925516774,8704
1361504156,1925536260,11,3267,297,1361504130820,1361504131716,1925511080,1925511976,896
1361504205,1925585000,3,205,68.33333333,1361504199110,1361504199622,1925579110,1925579622,512
1361504305,1925684620,3,180,60,1361504278850,1361504281858,1925658470,1925661478,3008
1361504438,1925818220,1,46,46,1361504437160,1361504437160,1925817380,1925817380,0
1361504465,1925845164,9,861,95.66666667,1361504437343,1361504437919,1925817507,1925818083,576
1361504465,1925845208,10,907,90.7,1361504437939,1361504439731,1925818147,1925819939,1792
1361504466,1925845492,8,815,101.875,1361504440511,1361504440767,1925820003,1925820259,256
1361504701,1926081032,3,189,63,1361504695202,1361504698210,1926075234,1926078242,3008
1361504717,1926097128,2,126,63,1361504702142,1361504710206,1926082270,1926090334,8064
1361504725,1926105124,3,189,63,1361504719875,1361504722947,1926099999,1926103071,3072
1361504725,1926105204,3,189,63,1361504720050,1361504723122,1926100254,1926103326,3072
1361504741,1926121168,2,126,63,1361504726870,1361504734934,1926107038,1926115102,8064
1361504741,1926121168,2,126,63,1361504727190,1361504735190,1926107358,1926115358,8000
1361504741,1926121252,2,126,63,1361504739394,1361504740418,1926119646,1926120670,1024
1361504749,1926129224,2,126,63,1361504742496,1361504746528,1926122720,1926126752,4032
1361504782,1926162148,1,63,63,1361504754601,1361504754601,1926134749,1926134749,0
1361505039,1926418656,14,6617,472.6428571,1361505014289,1361505014545,1926393945,1926394201,256
1361505039,1926418776,9,861,95.66666667,1361505014553,1361505014681,1926394329,1926394457,128
1361505043,1926422604,9,861,95.66666667,1361505014985,1361505015177,1926394589,1926394781,192
1361505043,1926422696,9,861,95.66666667,1361505015146,1361505015338,1926394842,1926395034,192
1361505055,1926434660,3,447,149,1361505030607,1361505036623,1926410267,1926416283,6016
1361505172,1926552036,1,46,46,1361505143891,1361505143891,1926523927,1926523927,0
1361505262,1926641552,4,252,63,1361505253367,1361505260407,1926632919,1926639959,7040
1361505295,1926675068,1,63,63,1361505267956,1361505267956,1926648024,1926648024,0
1361505310,1926689656,4,252,63,1361505301520,1361505308624,1926681176,1926688280,7104
1361505334,1926713620,4,252,63,1361505325426,1361505332466,1926705046,1926712086,7040
1361505343,1926723152,1,63,63,1361505316128,1361505316128,1926696280,1926696280,0
1361505350,1926729632,3,189,63,1361505345895,1361505348967,1926725527,1926728599,3072
1361505366,1926745608,2,126,63,1361505353024,1361505361024,1926732632,1926740632,8000
1361505367,1926747224,1,63,63,1361505339927,1361505339927,1926720151,1926720151,0
1361505743,1927123396,3,447,149,1361505714915,1361505720931,1927095311,1927101327,6016
1361506357,1927736860,3,450,150,1361506329779,1361506335795,1927709639,1927715655,6016
1361506830,1928210088,9,861,95.66666667,1361506803914,1361506804106,1928184002,1928184194,192
1361506830,1928210088,8,815,101.875,1361506804169,1361506804361,1928184257,1928184449,192
1361506830,1928210092,9,861,95.66666667,1361506804418,1361506804610,1928184510,1928184702,192
1361506967,1928346524,3,450,150,1361506941882,1361506947898,1928321406,1928327422,6016
1361507112,1928491572,7,390,55.71428571,1361507103559,1361507109575,1928483131,1928489147,6016
1361507135,1928514796,2,109,54.5,1361507109288,1361507109288,1928489084,1928489084,0
1361507135,1928514796,2,109,54.5,1361507109289,1361507109289,1928489085,1928489085,0
1361507139,1928518576,8,815,101.875,1361507111876,1361507112068,1928491452,1928491644,192
1361507139,1928518628,8,815,101.875,1361507112144,1361507112272,1928491772,1928491900,128
1361507139,1928518712,9,861,95.66666667,1361507111228,1361507111420,1928490940,1928491132,192
1361507139,1928518736,8,815,101.875,1361507111461,1361507111653,1928491197,1928491389,192
1361507344,1928723816,3,189,63,1361507339280,1361507342288,1928719096,1928722104,3008
1361507360,1928739928,2,126,63,1361507346207,1361507354271,1928726135,1928734199,8064
1361507384,1928763912,4,252,63,1361507375088,1361507382128,1928755000,1928762040,7040
1361507400,1928779876,3,189,63,1361507396117,1361507399125,1928775993,1928779001,3008
1361507415,1928795108,1,63,63,1361507389996,1361507389996,1928770104,1928770104,0
1361507416,1928795860,2,126,63,1361507403173,1361507411237,1928783033,1928791097,8064
1361507472,1928851952,3,189,63,1361507467718,1361507470726,1928847670,1928850678,3008
1361507488,1928868016,2,126,63,1361507474695,1361507482759,1928854711,1928862775,8064
1361507584,1928963488,3,450,150,1361507556372,1361507562452,1928935860,1928941940,6080
1361508196,1929576424,3,450,150,1361508170211,1361508176227,1929550635,1929556651,6016
1361508220,1929600340,1,46,46,1361508193209,1361508193209,1929573549,1929573549,0
1361508457,1929837152,11,953,86.63636364,1361508444142,1361508454318,1929824294,1929834470,10176
1361508457,1929837208,17,6755,397.3529412,1361508443704,1361508454328,1929823912,1929834536,10624
1361508457,1929837228,12,999,83.25,1361508444322,1361508454242,1929824550,1929834470,9920
1361508810,1930189836,3,450,150,1361508785383,1361508791399,1930165219,1930171235,6016
1361509427,1930806888,3,450,150,1361509399912,1361509405928,1930779800,1930785816,6016
1361510041,1931420800,3,450,150,1361510014073,1361510020089,1931393873,1931399889,6016
1361510046,1931426296,1,46,46,1361510019593,1361510019593,1931399889,1931399889,0
1361510268,1931648136,12,999,83.25,1361510258469,1361510265317,1931638605,1931645453,6848
1361510268,1931648204,12,999,83.25,1361510257889,1361510265313,1931638093,1931645517,7424
1361510268,1931648208,11,953,86.63636364,1361510258142,1361510265246,1931638350,1931645454,7104
1361510297,1931677328,9,861,95.66666667,1361510272482,1361510272674,1931652810,1931653002,192
1361510297,1931677332,8,815,101.875,1361510272734,1361510272926,1931653066,1931653258,192
1361510301,1931681240,9,861,95.66666667,1361510273083,1361510273275,1931653323,1931653515,192
1361510301,1931681248,9,861,95.66666667,1361510273396,1361510273588,1931653644,1931653836,192
1361510516,1931896260,2,126,63,1361510514791,1361510515815,1931895051,1931896075,1024
1361510524,1931904284,2,126,63,1361510517836,1361510521868,1931898120,1931902152,4032
1361510548,1931928300,3,189,63,1361510541309,1361510544317,1931921609,1931924617,3008
1361510558,1931937768,1,63,63,1361510530386,1361510530386,1931910154,1931910154,0
1361510564,1931944360,2,126,63,1361510548286,1361510556350,1931928646,1931936710,8064
1361510596,1931976392,3,189,63,1361510588958,1361510591966,1931969350,1931972358,3008
1361510605,1931984460,2,126,63,1361510603397,1361510604421,1931982857,1931983881,1024
1361510612,1931992372,2,126,63,1361510605492,1361510609524,1931985864,1931989896,4032
1361510612,1931992424,2,126,63,1361510595967,1361510604031,1931976391,1931984455,8064
1361510646,1932025968,1,63,63,1361510617990,1361510617990,1931997958,1931997958,0
1361510654,1932034044,3,450,150,1361510627642,1361510633658,1932007686,1932013702,6016
1361511267,1932647400,3,450,150,1361511240014,1361511246030,1932620414,1932626430,6016
1361511881,1933261204,3,450,150,1361511855111,1361511861127,1933235315,1933241331,6016
1361512089,1933469408,14,6617,472.6428571,1361512063096,1361512063416,1933443504,1933443824,320
1361512089,1933469420,8,815,101.875,1361512064046,1361512064238,1933444466,1933444658,192
1361512090,1933469504,8,815,101.875,1361512064451,1361512064579,1933443955,1933444083,128
1361512090,1933469504,9,861,95.66666667,1361512064704,1361512064896,1933444208,1933444400,192
1361512178,1933557712,3,162,54,1361512153202,1361512159218,1933532914,1933538930,6016
1361512302,1933682160,3,189,63,1361512298158,1361512301166,1933678318,1933681326,3008
1361512302,1933682204,3,189,63,1361512297729,1361512300737,1933677933,1933680941,3008
1361512302,1933682208,3,189,63,1361512297856,1361512300928,1933678064,1933681136,3072
1361512318,1933698176,2,126,63,1361512304796,1361512312860,1933684972,1933693036,8064
1361512318,1933698196,2,126,63,1361512304971,1361512312971,1933685167,1933693167,8000
1361512318,1933698244,2,126,63,1361512305179,1361512313179,1933685423,1933693423,8000
1361512382,1933762384,2,126,63,1361512380431,1361512381391,1933760815,1933761775,960
1361512390,1933770364,2,126,63,1361512383457,1361512387489,1933763821,1933767853,4032
1361512418,1933798240,14,6617,472.6428571,1361512392221,1361512392541,1933772461,1933772781,320
1361512418,1933798272,9,861,95.66666667,1361512392571,1361512392763,1933772843,1933773035,192
1361512422,1933802204,1,63,63,1361512395713,1361512395713,1933775917,1933775917,0
1361512495,1933874792,3,450,150,1361512468186,1361512474202,1933847978,1933853994,6016
1361512591,1933970460,4,252,63,1361512582374,1361512589414,1933961834,1933968874,7040
1361512622,1934002420,2,109,54.5,1361512596454,1361512620454,1933976874,1934000874,24000
1361512647,1934027016,2,109,54.5,1361512620474,1361512620474,1934000490,1934000490,0
1361512651,1934030984,9,861,95.66666667,1361512624858,1361512625050,1934004842,1934005034,192
1361512651,1934031044,9,861,95.66666667,1361512624027,1361512624155,1934004071,1934004199,128
1361512651,1934031060,8,815,101.875,1361512624268,1361512624460,1934004328,1934004520,192
1361512651,1934031064,9,861,95.66666667,1361512624522,1361512624714,1934004586,1934004778,192
1361512895,1934274548,2,126,63,1361512893578,1361512894602,1934273126,1934274150,1024
1361512895,1934274584,2,126,63,1361512893285,1361512894309,1934272869,1934273893,1024
1361512895,1934274612,2,126,63,1361512893513,1361512894537,1934273125,1934274149,1024
1361512903,1934282620,2,126,63,1361512896322,1361512900354,1934275942,1934279974,4032
1361512903,1934282620,2,126,63,1361512896513,1361512900545,1934276133,1934280165,4032
1361512903,1934282672,2,126,63,1361512896459,1361512900491,1934276131,1934280163,4032
1361512936,1934315756,1,63,63,1361512908473,1361512908473,1934288229,1934288229,0
1361512936,1934315840,1,63,63,1361512908135,1361512908135,1934287975,1934287975,0
1361512936,1934315888,1,63,63,1361512908342,1361512908342,1934288230,1934288230,0
1361512943,1934322712,4,252,63,1361512933989,1361512941029,1934313701,1934320741,7040
1361512976,1934355944,1,63,63,1361512948861,1361512948861,1934328805,1934328805,0
1361513108,1934488388,3,450,150,1361513083072,1361513089088,1934463460,1934469476,6016
1361513559,1934938464,1,46,46,1361513531730,1361513531730,1934911194,1934911194,0
1361513722,1935101852,3,450,150,1361513697357,1361513703373,1935077209,1935083225,6016
1361514208,1935587460,15,6289,419.2666667,1361514192463,1361514204559,1935571923,1935584019,12096
1361514208,1935587460,12,999,83.25,1361514192846,1361514204558,1935572306,1935584018,11712
1361514208,1935587464,11,953,86.63636364,1361514193420,1361514204492,1935572884,1935583956,11072
1361514208,1935587504,11,953,86.63636364,1361514193122,1361514204450,1935572626,1935583954,11328
1361514303,1935683024,1,78,78,1361514276951,1361514276951,1935656975,1935656975,0
1361514339,1935719176,3,450,150,1361514312255,1361514318271,1935692431,1935698447,6016
1361514952,1936332060,3,450,150,1361514925291,1361514931307,1936305351,1936311367,6016
1361515165,1936544536,3,450,150,1361515138548,1361515144564,1936518084,1936524100,6016
1361515229,1936609400,1,46,46,1361515203923,1361515203923,1936584323,1936584323,0
1361515942,1937321696,3,447,149,1361515917576,1361515923656,1937297272,1937303352,6080
1361516018,1937398144,11,953,86.63636364,1361516003975,1361516010375,1937384119,1937390519,6400
1361516018,1937398144,12,999,83.25,1361516004485,1361516017157,1937384629,1937397301,12672
1361516018,1937398180,12,999,83.25,1361516004196,1361516017508,1937384376,1937397688,13312
1361516042,1937421932,8,815,101.875,1361516017690,1361516017882,1937397622,1937397814,192
1361516046,1937425912,8,815,101.875,1361516018288,1361516018544,1937398200,1937398456,256
1361516046,1937425980,8,815,101.875,1361516017960,1361516018152,1937397940,1937398132,192
1361516046,1937425992,8,815,101.875,1361516018719,1361516018911,1937398711,1937398903,192
1361516315,1937694676,3,189,63,1361516309847,1361516312919,1937689523,1937692595,3072
1361516331,1937710924,2,126,63,1361516316702,1361516324702,1937696626,1937704626,8000
1361516355,1937734872,3,189,63,1361516351122,1361516354194,1937730994,1937734066,3072
1361516355,1937734912,3,189,63,1361516351147,1361516354155,1937731059,1937734067,3008
1361516355,1937734912,3,189,63,1361516351147,1361516354155,1937731059,1937734067,3008
1361516371,1937750884,2,126,63,1361516358213,1361516366277,1937738097,1937746161,8064
1361516371,1937750924,2,126,63,1361516358172,1361516366236,1937738096,1937746160,8064
1361516371,1937750924,2,126,63,1361516358172,1361516366172,1937738096,1937746096,8000
1361516467,1937846924,11,953,86.63636364,1361516454620,1361516464540,1937834544,1937844464,9920
1361516467,1937846924,12,999,83.25,1361516454939,1361516464539,1937834863,1937844463,9600
1361516467,1937846940,18,6801,377.8333333,1361516454156,1361516464524,1937834096,1937844464,10368
1361516467,1937846964,12,999,83.25,1361516455154,1361516464498,1937835118,1937844462,9344
1361516559,1937938608,3,447,149,1361516531864,1361516537880,1937911472,1937917488,6016
1361517172,1938551592,3,447,149,1361517145180,1361517151324,1938524772,1938530916,6144
1361517596,1938976216,1,60,60,1361517570086,1361517570086,1938950302,1938950302,0
1361517784,1939164380,3,450,150,1361517756737,1361517762753,1939137117,1939143133,6016
1361517792,1939172336,1,46,46,1361517766317,1361517766317,1939146653,1939146653,0
1361518278,1939657552,14,6617,472.6428571,1361518253559,1361518253879,1939633111,1939633431,320
1361518282,1939661424,9,861,95.66666667,1361518254325,1361518254517,1939633749,1939633941,192
1361518282,1939661472,9,861,95.66666667,1361518254020,1361518254212,1939633492,1939633684,192
1361518282,1939661492,9,861,95.66666667,1361518254512,1361518254704,1939634004,1939634196,192
1361518398,1939777544,3,450,150,1361518372667,1361518378683,1939752211,1939758227,6016
1361518526,1939906040,4,252,63,1361518517643,1361518524683,1939897683,1939904723,7040
1361518558,1939937916,1,63,63,1361518532871,1361518532871,1939912787,1939912787,0
1361518574,1939954044,4,252,63,1361518565893,1361518572933,1939945937,1939952977,7040
1361518574,1939954060,3,189,63,1361518569844,1361518572852,1939949904,1939952912,3008
1361518590,1939970128,2,126,63,1361518576818,1361518584882,1939956946,1939965010,8064
1361518606,1939986000,1,63,63,1361518581038,1361518581038,1939961038,1939961038,0
1361518606,1939986268,2,126,63,1361518602788,1361518603812,1939983056,1939984080,1024
1361518614,1939994160,2,126,63,1361518605970,1361518610002,1939986130,1939990162,4032
1361518646,1940025972,1,63,63,1361518618187,1361518618187,1939998159,1939998159,0
1361518666,1940046264,1,46,46,1361518650021,1361518650021,1940030285,1940030285,0
1361518667,1940046888,1,46,46,1361518650847,1361518650847,1940030735,1940030735,0
1361518931,1940311376,1,46,46,1361518902323,1361518902323,1940282699,1940282699,0
1361519143,1940522600,2,92,46,1361519136758,1361519136758,1940516358,1940516358,0
1361519143,1940522600,2,92,46,1361519136758,1361519136822,1940516358,1940516422,64
1361519143,1940522600,2,92,46,1361519136758,1361519136758,1940516358,1940516358,0
1361519143,1940522600,2,92,46,1361519136758,1361519136758,1940516358,1940516358,0
1361519151,1940530572,12,999,83.25,1361519139797,1361519150293,1940519369,1940529865,10496
1361519151,1940530572,11,953,86.63636364,1361519140051,1361519150291,1940519623,1940529863,10240
1361519151,1940530584,12,999,83.25,1361519139529,1361519150281,1940519113,1940529865,10752
1361519151,1940530624,17,6418,377.5294118,1361519138209,1361519150241,1940517833,1940529865,12032
1361519400,1940780140,1,46,46,1361519371736,1361519371736,1940751876,1940751876,0
1361519872,1941251972,1,46,46,1361519845177,1361519845177,1941225149,1941225149,0
1361520049,1941428500,9,861,95.66666667,1361520024653,1361520024845,1941404153,1941404345,192
1361520049,1941428512,13,6234,479.5384615,1361520023746,1361520024002,1941403258,1941403514,256
1361520049,1941428548,9,861,95.66666667,1361520024094,1361520024222,1941403642,1941403770,128
1361520049,1941428556,8,815,101.875,1361520024344,1361520024472,1941403900,1941404028,128
1361520197,1941576668,1,46,46,1361520172005,1361520172005,1941551673,1941551673,0
1361520263,1941643320,4,252,63,1361520255893,1361520262933,1941636213,1941643253,7040
1361520263,1941643320,4,252,63,1361520255705,1361520262745,1941636025,1941643065,7040
1361520279,1941659332,4,252,63,1361520270409,1361520277449,1941650741,1941657781,7040
1361520293,1941672808,1,46,46,1361520267733,1361520267733,1941647541,1941647541,0
1361520297,1941676736,1,63,63,1361520271584,1361520271584,1941651320,1941651320,0
1361520297,1941676788,1,63,63,1361520271340,1361520271340,1941651128,1941651128,0
1361520303,1941683320,4,252,63,1361520294615,1361520301655,1941674935,1941681975,7040
1361520313,1941692748,1,63,63,1361520286099,1361520286099,1941665847,1941665847,0
1361520337,1941716812,1,63,63,1361520310228,1361520310228,1941690040,1941690040,0
1361521214,1942594008,1,46,46,1361521184579,1361521184579,1942564587,1942564587,0
1361521841,1943221112,9,861,95.66666667,1361521815377,1361521815569,1943195489,1943195681,192
1361521841,1943221152,9,861,95.66666667,1361521815078,1361521815270,1943195230,1943195422,192
1361521841,1943221152,9,861,95.66666667,1361521814822,1361521815014,1943194974,1943195166,192
1361522066,1943445564,4,252,63,1361522058607,1361522065647,1943438171,1943445211,7040
1361522098,1943477808,1,63,63,1361522073466,1361522073466,1943453274,1943453274,0
1361522130,1943509656,4,252,63,1361522121301,1361522128341,1943500957,1943507997,7040
1361522162,1943541828,1,63,63,1361522136233,1361522136233,1943516061,1943516061,0
1361522178,1943557636,4,252,63,1361522169702,1361522176742,1943549338,1943556378,7040
1361522210,1943589864,1,63,63,1361522184578,1361522184578,1943564442,1943564442,0
1361522242,1943622148,1,60,60,1361522215783,1361522215783,1943595931,1943595931,0
1361522242,1943622212,1,60,60,1361522215718,1361522215718,1943595930,1943595930,0
1361522490,1943869872,11,953,86.63636364,1361522475958,1361522488054,1943855830,1943867926,12096
1361522490,1943869884,11,953,86.63636364,1361522476139,1361522487979,1943856023,1943867863,11840
1361522490,1943869884,11,953,86.63636364,1361522476395,1361522487979,1943856279,1943867863,11584
1361522490,1943869884,11,953,86.63636364,1361522476714,1361522487978,1943856598,1943867862,11264
1361523113,1944492408,1,48,48,1361523087547,1361523087547,1944466955,1944466955,0
1361523869,1945248428,1,60,60,1361523841951,1361523841951,1945221379,1945221379,0
1361524029,1945408652,1,60,60,1361524004348,1361524004348,1945384000,1945384000,0
1361524057,1945436672,1,60,60,1361524029030,1361524029030,1945408702,1945408702,0
1361524284,1945664288,44,57019,1295.886364,1361524278649,1361524278969,1945658937,1945659257,320
1361524305,1945685140,13,6234,479.5384615,1361524279886,1361524280206,1945660026,1945660346,320
1361524305,1945685188,1,46,46,1361524279905,1361524279905,1945660093,1945660093,0
1361524305,1945685188,9,861,95.66666667,1361524280223,1361524280415,1945660411,1945660603,192
1361524305,1945685192,8,815,101.875,1361524280475,1361524280667,1945660667,1945660859,192
1361524476,1945856372,3,189,63,1361524470179,1361524473251,1945850551,1945853623,3072
1361524477,1945856416,4,252,63,1361524468831,1361524475935,1945848247,1945855351,7104
1361524492,1945872356,2,126,63,1361524477298,1361524485362,1945857654,1945865718,8064
1361524510,1945889712,1,63,63,1361524483638,1361524483638,1945863350,1945863350,0
1361524581,1945960468,4,252,63,1361524571945,1361524579049,1945951413,1945958517,7104
1361524614,1945994032,1,63,63,1361524586550,1361524586550,1945966582,1945966582,0
1361524638,1946018152,8,815,101.875,1361524612797,1361524612989,1945992949,1945993141,192
1361524638,1946018180,8,815,101.875,1361524613089,1361524613217,1945993269,1945993397,128
1361524638,1946018184,8,815,101.875,1361524613344,1361524613472,1945993528,1945993656,128
1361524861,1946240580,3,189,63,1361524856566,1361524859574,1946236146,1946239154,3008
1361524875,1946254844,1,60,60,1361524849392,1361524849392,1946229236,1946229236,0
1361524877,1946256612,2,126,63,1361524863572,1361524871636,1946243184,1946251248,8064
1361524915,1946294880,13,6234,479.5384615,1361524889738,1361524890058,1946269618,1946269938,320
1361524915,1946294884,9,861,95.66666667,1361524890695,1361524890887,1946270579,1946270771,192
1361524915,1946294916,1,46,46,1361524887972,1361524887972,1946267888,1946267888,0
1361524915,1946294944,8,815,101.875,1361524890376,1361524890504,1946270320,1946270448,128
1361524915,1946294944,9,861,95.66666667,1361524890121,1361524890249,1946270065,1946270193,128
1361524941,1946320636,4,252,63,1361524933503,1361524940543,1946313139,1946320179,7040
1361524975,1946354996,1,63,63,1361524948243,1361524948243,1946328239,1946328239,0
1361525029,1946408648,2,126,63,1361525026479,1361525027503,1946406127,1946407151,1024
1361525037,1946416648,2,126,63,1361525029550,1361525033582,1946409198,1946413230,4032
1361525068,1946447436,1,63,63,1361525041859,1361525041859,1946421295,1946421295,0
1361525181,1946560728,4,252,63,1361525172318,1361525179358,1946552046,1946559086,7040
1361525212,1946591880,1,63,63,1361525187269,1361525187269,1946567149,1946567149,0
1361525221,1946600728,4,252,63,1361525213083,1361525220187,1946592811,1946599915,7104
1361525229,1946608740,3,189,63,1361525224271,1361525227279,1946604011,1946607019,3008
1361525229,1946608740,3,189,63,1361525224335,1361525227343,1946604075,1946607083,3008
1361525245,1946624760,2,126,63,1361525231295,1361525239359,1946611055,1946619119,8064
1361525245,1946624768,2,126,63,1361525231349,1361525239413,1946611117,1946619181,8064
1361525256,1946635896,1,63,63,1361525228084,1361525228084,1946607980,1946607980,0
1361525829,1947209332,14,6617,472.6428571,1361525803513,1361525803833,1947183845,1947184165,320
1361525829,1947209336,9,861,95.66666667,1361525804210,1361525804338,1947184546,1947184674,128
1361525829,1947209336,9,861,95.66666667,1361525804468,1361525804596,1947184804,1947184932,128
1361525829,1947209368,9,861,95.66666667,1361525803859,1361525804051,1947184227,1947184419,192
1361526037,1947417240,2,126,63,1361526034512,1361526035536,1947414752,1947415776,1024
1361526045,1947425228,2,126,63,1361526037597,1361526041629,1947417825,1947421857,4032
1361526045,1947425236,2,126,63,1361526043859,1361526044883,1947424095,1947425119,1024
1361526053,1947433256,2,126,63,1361526046914,1361526050946,1947427170,1947431202,4032
1361526078,1947457664,1,63,63,1361526050191,1361526050191,1947429855,1947429855,0
1361526085,1947465244,4,252,63,1361526077518,1361526084558,1947457762,1947464802,7040
1361526086,1947465648,1,63,63,1361526059554,1361526059554,1947439202,1947439202,0
1361526101,1947481280,3,189,63,1361526097830,1361526100838,1947478110,1947481118,3008
1361526117,1947497280,2,126,63,1361526104870,1361526112934,1947485150,1947493214,8064
1361526119,1947499360,1,63,63,1361526092504,1361526092504,1947472864,1947472864,0
1361527288,1948668036,1,60,60,1361527262028,1361527262028,1948642064,1948642064,0
1361527625,1949004608,8,815,101.875,1361527600307,1361527600499,1948979915,1948980107,192
1361527625,1949004640,13,6234,479.5384615,1361527599313,1361527599633,1948978953,1948979273,320
1361527625,1949004644,9,861,95.66666667,1361527599759,1361527599951,1948979403,1948979595,192
1361527625,1949004644,9,861,95.66666667,1361527600014,1361527600206,1948979658,1948979850,192
1361527871,1949250392,3,189,63,1361527865991,1361527869063,1949245383,1949248455,3072
1361527879,1949258404,2,126,63,1361527876346,1361527877370,1949255750,1949256774,1024
1361527879,1949258404,2,126,63,1361527876409,1361527877369,1949255813,1949256773,960
1361527887,1949266404,2,126,63,1361527879418,1361527883450,1949258822,1949262854,4032
1361527887,1949266412,2,126,63,1361527879344,1361527883376,1949258756,1949262788,4032
1361527887,1949266420,2,126,63,1361527873067,1361527881067,1949252487,1949260487,8000
1361527918,1949297492,3,155,51.66666667,1361527891425,1361527913889,1949270917,1949293381,22464
1361527918,1949297528,3,155,51.66666667,1361527891324,1361527913852,1949270852,1949293380,22528
1361527919,1949298460,4,184,46,1361527914050,1361527914370,1949293510,1949293830,320
1361527919,1949298468,2,92,46,1361527913913,1361527913913,1949293381,1949293381,0
1361527942,1949321696,9,861,95.66666667,1361527915349,1361527915541,1949295045,1949295237,192
1361527942,1949321732,14,6617,472.6428571,1361527914930,1361527915250,1949294662,1949294982,320
1361527942,1949321736,9,861,95.66666667,1361527915563,1361527915755,1949295299,1949295491,192
1361527942,1949321736,8,815,101.875,1361527915822,1361527916014,1949295558,1949295750,192
1361528103,1949482572,3,189,63,1361528096526,1361528099598,1949476098,1949479170,3072
1361528119,1949498600,2,126,63,1361528103602,1361528111602,1949483202,1949491202,8000
1361528151,1949530628,4,252,63,1361528142741,1361528149781,1949522369,1949529409,7040
1361528167,1949546636,2,126,63,1361528165582,1361528166606,1949545218,1949546242,1024
1361528175,1949554624,2,126,63,1361528168602,1361528172634,1949548226,1949552258,4032
1361528182,1949562172,1,63,63,1361528157301,1361528157301,1949537473,1949537473,0
1361528206,1949586176,1,63,63,1361528180144,1361528180144,1949560320,1949560320,0
1361528255,1949634652,2,126,63,1361528253373,1361528254397,1949633025,1949634049,1024
1361528263,1949642672,2,126,63,1361528256359,1361528260391,1949636031,1949640063,4032
1361528295,1949674504,1,63,63,1361528268624,1361528268624,1949648128,1949648128,0
1361529293,1950672712,1,48,48,1361529266481,1361529266481,1950646193,1950646193,0
1361529417,1950797116,14,6617,472.6428571,1361529389913,1361529390233,1950770029,1950770349,320
1361529417,1950797116,9,861,95.66666667,1361529390553,1361529390745,1950770669,1950770861,192
1361529417,1950797152,9,861,95.66666667,1361529390264,1361529390456,1950770416,1950770608,192
1361529648,1951027532,3,189,63,1361529641886,1361529644958,1951021418,1951024490,3072
1361529664,1951043524,3,189,63,1361529658150,1361529661158,1951037674,1951040682,3008
1361529664,1951043528,2,126,63,1361529648931,1361529656995,1951028459,1951036523,8064
1361529680,1951059532,2,126,63,1361529665182,1361529673246,1951044714,1951052778,8064
1361529744,1951123560,3,189,63,1361529740481,1361529743489,1951120041,1951123049,3008
1361529758,1951138064,9,861,95.66666667,1361529731338,1361529731530,1951111402,1951111594,192
1361529758,1951138068,8,815,101.875,1361529731591,1361529731783,1951111659,1951111851,192
1361529758,1951138068,8,942,117.75,1361529731974,1361529747206,1951112042,1951127274,15232
1361529760,1951139592,2,126,63,1361529747488,1361529755552,1951127080,1951135144,8064
1361529790,1951170120,1,162,162,1361529763217,1361529763217,1951143337,1951143337,0
1361529822,1951202372,1,162,162,1361529795094,1361529795094,1951175466,1951175466,0
1361529887,1951266420,1,162,162,1361529860298,1361529860298,1951239718,1951239718,0
1361529976,1951355680,2,126,63,1361529973191,1361529974215,1951352871,1951353895,1024
1361529984,1951363684,2,126,63,1361529976259,1361529980291,1951355943,1951359975,4032
1361529987,1951366828,8,815,101.875,1361529961907,1361529962099,1951341735,1951341927,192
1361529987,1951366828,8,815,101.875,1361529961651,1361529961843,1951341479,1951341671,192
1361529987,1951366828,8,815,101.875,1361529962225,1361529962353,1951342053,1951342181,128
1361529987,1951366864,9,861,95.66666667,1361529961360,1361529961552,1951341224,1951341416,192
1361530015,1951394868,1,63,63,1361529988106,1361529988106,1951367974,1951367974,0
1361530072,1951451720,4,252,63,1361530064158,1361530071198,1951443878,1951450918,7040
1361530107,1951486952,1,63,63,1361530079029,1361530079029,1951458981,1951458981,0
1361530107,1951486960,1,46,46,1361530081070,1361530081070,1951461030,1951461030,0
1361530147,1951526988,1,46,46,1361530121166,1361530121166,1951501154,1951501154,0
1361530200,1951579792,3,189,63,1361530194388,1361530197460,1951574180,1951577252,3072
1361530216,1951595788,2,126,63,1361530201494,1361530209494,1951581282,1951589282,8000
1361530272,1951651804,4,252,63,1361530263493,1361530270597,1951643297,1951650401,7104
1361530272,1951651816,2,126,63,1361530269435,1361530270459,1951649251,1951650275,1024
1361530280,1951659816,2,126,63,1361530272441,1361530276473,1951652257,1951656289,4032
1361530303,1951683196,1,63,63,1361530278206,1361530278206,1951658402,1951658402,0
1361530311,1951691240,1,63,63,1361530284113,1361530284113,1951664353,1951664353,0
1361530376,1951755868,3,189,63,1361530371525,1361530374597,1951751393,1951754465,3072
1361530392,1951771896,2,126,63,1361530378599,1361530386599,1951758495,1951766495,8000
1361530457,1951837184,1,48,48,1361530430856,1361530430856,1951811040,1951811040,0
1361530457,1951837184,1,48,48,1361530430855,1361530430855,1951811039,1951811039,0
1361531435,1952814584,1,46,46,1361531407890,1361531407890,1952787474,1952787474,0
1361531436,1952815764,1,46,46,1361531407708,1361531407708,1952787472,1952787472,0
1361531545,1952925324,14,6617,472.6428571,1361531517290,1361531517610,1952897614,1952897934,320
1361531545,1952925332,8,815,101.875,1361531518243,1361531518435,1952898575,1952898767,192
1361531545,1952925364,9,861,95.66666667,1361531517635,1361531517827,1952897999,1952898191,192
1361531545,1952925368,9,1198,133.1111111,1361531517949,1361531519165,1952898317,1952899533,1216
1361531857,1953236888,2,126,63,1361531854428,1361531855452,1953234316,1953235340,1024
1361531857,1953236896,2,126,63,1361531854419,1361531855443,1953234315,1953235339,1024
1361531865,1953244884,2,126,63,1361531857436,1361531861468,1953237320,1953241352,4032
1361531865,1953244896,2,126,63,1361531857491,1361531861523,1953237387,1953241419,4032
1361531889,1953268896,2,126,63,1361531886929,1361531887953,1953266825,1953267849,1024
1361531889,1953268904,2,126,63,1361531887049,1361531888009,1953266953,1953267913,960
1361531894,1953273764,1,63,63,1361531869655,1361531869655,1953249419,1953249419,0
1361531894,1953273764,1,63,63,1361531869718,1361531869718,1953249482,1953249482,0
1361531897,1953276892,2,126,63,1361531890006,1361531894038,1953269898,1953273930,4032
1361531897,1953276892,2,126,63,1361531890070,1361531894102,1953269962,1953273994,4032
1361531926,1953305800,1,46,46,1361531898547,1361531898547,1953278347,1953278347,0
1361531930,1953309832,1,63,63,1361531902162,1361531902162,1953281994,1953281994,0
1361531930,1953309832,1,63,63,1361531902226,1361531902226,1953282058,1953282058,0
1361531954,1953333888,1,52,52,1361531926680,1361531926680,1953306568,1953306568,0
1361532431,1953810856,9,861,95.66666667,1361532404465,1361532404657,1953784321,1953784513,192
1361532431,1953810860,8,815,101.875,1361532404974,1361532405166,1953784834,1953785026,192
1361532431,1953810896,9,861,95.66666667,1361532404682,1361532404874,1953784578,1953784770,192
1361532625,1954005352,2,126,63,1361532622143,1361532623167,1954002495,1954003519,1024
1361532633,1954013348,2,126,63,1361532625219,1361532629187,1954005567,1954009535,3968
1361532656,1954035704,9,861,95.66666667,1361532630215,1361532630407,1954009919,1954010111,192
1361532656,1954035704,9,861,95.66666667,1361532630725,1361532630917,1954010429,1954010621,192
1361532656,1954035740,8,815,101.875,1361532630434,1361532630626,1954010174,1954010366,192
1361532656,1954035744,8,815,101.875,1361532630943,1361532631135,1954010687,1954010879,192
1361532674,1954053424,2,126,63,1361532672863,1361532673887,1954052287,1954053311,1024
1361532682,1954061408,2,126,63,1361532675949,1361532679981,1954055357,1954059389,4032
1361532709,1954088616,1,46,46,1361532683868,1361532683868,1954063484,1954063484,0
1361532709,1954088652,1,46,46,1361532683899,1361532683899,1954063551,1954063551,0
1361532713,1954093300,1,63,63,1361532687088,1361532687088,1954067388,1954067388,0
1361532722,1954101476,4,252,63,1361532713512,1361532720552,1954092988,1954100028,7040
1361532728,1954107844,1,46,46,1361532702714,1361532702714,1954082558,1954082558,0
1361532756,1954135848,1,63,63,1361532728244,1361532728244,1954108092,1954108092,0
1361532906,1954285592,4,252,63,1361532898291,1361532905331,1954277883,1954284923,7040
1361532922,1954301704,3,189,63,1361532916418,1361532919426,1954296122,1954299130,3008
1361532938,1954317700,2,126,63,1361532923463,1361532931527,1954303163,1954311227,8064
1361532941,1954320484,1,63,63,1361532913501,1361532913501,1954292985,1954292985,0
1361532962,1954341728,3,189,63,1361532956265,1361532959273,1954335993,1954339001,3008
1361532962,1954341740,3,189,63,1361532956383,1361532959391,1954336123,1954339131,3008
1361532978,1954357740,2,126,63,1361532963292,1361532971356,1954343032,1954351096,8064
1361532978,1954357740,2,126,63,1361532963420,1361532971484,1954343160,1954351224,8064
1361533005,1954384604,3,2365,788.3333333,1361533003559,1361533003623,1954383163,1954383227,64
1361533005,1954384604,6,2158,359.6666667,1361533003559,1361533004135,1954383163,1954383739,576
1361533005,1954384604,1,108,108,1361533003623,1361533003623,1954383227,1954383227,0
1361533005,1954384604,2,216,108,1361533003687,1361533003815,1954383291,1954383419,128
1361533005,1954384604,2,216,108,1361533003815,1361533003943,1954383419,1954383547,128
1361533005,592698904,5,451,90.2,1361533005395,1361533005587,592699299,592699491,192
1361533008,592701332,5,1508,301.6,1361533006355,1361533006419,592699687,592699751,64
1361533010,1954389764,9,3544,393.7777778,1361533007683,1361533009155,1954387447,1954388919,1472
1361533010,1954389768,5,1257,251.4,1361533006018,1361533006018,1954385786,1954385786,0
1361533010,1954389772,5,772,154.4,1361533004670,1361533005118,1954384442,1954384890,448
1361533016,592709420,5,2109,421.8,1361533013947,1361533014011,592707367,592707431,64
1361533016,592709420,5,451,90.2,1361533014328,1361533015480,592707748,592708900,1152
1361533016,592709424,5,451,90.2,1361533012727,1361533013239,592706151,592706663,512
1361533018,1954397772,6,983,163.8333333,1361533010172,1361533010428,1954389944,1954390200,256
1361533018,1954397772,9,1913,212.5555556,1361533013179,1361533013307,1954392951,1954393079,128
1361533018,1954397776,9,1913,212.5555556,1361533017271,1361533017527,1954397047,1954397303,256
1361533018,1954397776,10,3248,324.8,1361533009403,1361533010171,1954389179,1954389947,768
1361533018,1954397776,5,609,121.8,1361533013818,1361533014138,1954393594,1954393914,320
1361533018,1954397776,6,798,133,1361533010490,1361533010746,1954390266,1954390522,256
1361533018,1954397776,6,798,133,1361533011895,1361533012087,1954391671,1954391863,192
1361533018,1954397780,9,1913,212.5555556,1361533016820,1361533016948,1954396600,1954396728,128
1361533018,1954397784,8,3492,436.5,1361533010226,1361533010930,1954390010,1954390714,704
1361533018,1954397784,8,2949,368.625,1361533017522,1361533017906,1954397306,1954397690,384
1361533018,1954397784,11,3294,299.4545455,1361533011120,1361533011888,1954390904,1954391672,768
1361533018,1954397788,7,1460,208.5714286,1361533011950,1361533012526,1954391738,1954392314,576
1361533018,1954397788,11,3139,285.3636364,1361533012014,1361533012654,1954391802,1954392442,640
1361533018,1954397788,4,724,181,1361533014702,1361533014766,1954394490,1954394554,64
1361533018,1954397788,9,1913,212.5555556,1361533015405,1361533015533,1954395193,1954395321,128
1361533018,1954397788,5,609,121.8,1361533015916,1361533016364,1954395704,1954396152,448
1361533024,592717408,5,451,90.2,1361533018630,1361533018758,592712038,592712166,128
1361533024,592717408,5,451,90.2,1361533016709,1361533017285,592710117,592710693,576
1361533024,592717420,4,445,111.25,1361533021690,1361533021946,592715110,592715366,256
1361533024,592717420,4,445,111.25,1361533022010,1361533022202,592715430,592715622,192
1361533024,592717420,4,445,111.25,1361533022266,1361533022394,592715686,592715814,128
1361533024,592717420,5,451,90.2,1361533020218,1361533020410,592713638,592713830,192
1361533026,1954405772,2,92,46,1361533017979,1361533017979,1954397751,1954397751,0
1361533026,1954405772,9,1913,212.5555556,1361533018429,1361533018621,1954398201,1954398393,192
1361533026,1954405772,5,609,121.8,1361533017915,1361533018363,1954397687,1954398135,448
1361533026,1954405776,8,1867,233.375,1361533020280,1361533022200,1954400056,1954401976,1920
1361533026,1954405780,9,1913,212.5555556,1361533024694,1361533024822,1954404474,1954404602,128
1361533026,1954405780,9,1913,212.5555556,1361533021109,1361533021237,1954400889,1954401017,128
1361533026,1954405780,5,609,121.8,1361533021109,1361533021493,1954400889,1954401273,384
1361533026,1954405780,9,2849,316.5555556,1361533025332,1361533025460,1954405112,1954405240,128
1361533026,1954405780,12,4927,410.5833333,1361533021939,1361533022131,1954401719,1954401911,192
1361533026,1954405780,11,4921,447.3636364,1361533018675,1361533019123,1954398455,1954398903,448
1361533026,1954405784,5,609,121.8,1361533019505,1361533019953,1954399289,1954399737,448
1361533026,1954405784,12,4735,394.5833333,1361533022577,1361533022769,1954402361,1954402553,192
1361533026,1954405784,10,1877,187.7,1361533023217,1361533023921,1954403001,1954403705,704
1361533026,1954405784,15,8365,557.6666667,1361533019441,1361533019569,1954399225,1954399353,128
1361533026,1954405784,12,4967,413.9166667,1361533020081,1361533020273,1954399865,1954400057,192
1361533026,1954405788,9,1913,212.5555556,1361533024046,1361533024238,1954403834,1954404026,192
1361533032,592725408,4,1448,362,1361533026055,1361533026119,592719463,592719527,64
1361533034,1954413768,9,3310,367.7777778,1361533026239,1361533027583,1954406007,1954407351,1344
1361533034,1954413776,10,3397,339.7,1361533027575,1361533028791,1954407351,1954408567,1216
1361533034,1954413780,4,715,178.75,1361533030070,1361533030070,1954409850,1954409850,0
1361533034,1954413780,11,3096,281.4545455,1361533030325,1361533031029,1954410105,1954410809,704
1361533034,1954413784,14,7501,535.7857143,1361533031665,1361533032497,1954411449,1954412281,832
1361533041,1954420680,7,1877,268.1428571,1361533015127,1361533015767,1954394807,1954395447,640
1361533160,1954539436,1,46,46,1361533131466,1361533131466,1954510902,1954510902,0
1361533160,1954539468,1,46,46,1361533131434,1361533131434,1954510902,1954510902,0
1361534139,1955519172,1,60,60,1361534114331,1361534114331,1955494503,1955494503,0
1361534147,1955527212,1,60,60,1361534119286,1361534119286,1955499498,1955499498,0
1361534220,1955599500,9,861,95.66666667,1361534195259,1361534195387,1955574759,1955574887,128
1361534220,1955599548,9,861,95.66666667,1361534195467,1361534195659,1955575015,1955575207,192
1361534220,1955599580,14,6617,472.6428571,1361534194795,1361534195051,1955574375,1955574631,256
1361534456,1955836028,8,815,101.875,1361534431655,1361534431783,1955811683,1955811811,128
1361534456,1955836028,9,861,95.66666667,1361534431399,1361534431527,1955811427,1955811555,128
1361534460,1955840048,3,248,82.66666667,1361534432018,1361534432082,1955812066,1955812130,64
1361534475,1955854844,4,252,63,1361534466079,1361534473119,1955845923,1955852963,7040
1361534491,1955870844,2,126,63,1361534488928,1361534489952,1955868772,1955869796,1024
1361534499,1955878844,2,126,63,1361534491999,1361534496031,1955871843,1955875875,4032
1361534508,1955888108,1,63,63,1361534480918,1361534480918,1955861026,1955861026,0
1361534528,1955908248,1,63,63,1361534503627,1361534503627,1955883875,1955883875,0
1361534531,1955910848,4,252,63,1361534523481,1361534530585,1955903329,1955910433,7104
1361534564,1955944348,1,63,63,1361534538084,1361534538084,1955918432,1955918432,0
1361534641,1956020452,9,861,95.66666667,1361534615524,1361534615716,1955994976,1955995168,192
1361534641,1956020456,8,815,101.875,1361534616097,1361534616289,1955995553,1955995745,192
1361534641,1956020496,8,815,101.875,1361534615802,1361534615994,1955995298,1955995490,192
1361534641,1956020496,9,861,95.66666667,1361534616313,1361534616505,1955995809,1955996001,192
1361534673,1956052492,1,46,46,1361534647803,1361534647803,1956027295,1956027295,0
1361534683,1956062956,3,189,63,1361534678252,1361534681260,1956058208,1956061216,3008
1361534699,1956078992,2,126,63,1361534685255,1361534693319,1956065247,1956073311,8064
1361534715,1956094968,3,189,63,1361534711006,1361534714078,1956090974,1956094046,3072
1361534731,1956110988,2,126,63,1361534718090,1361534726090,1956098078,1956106078,8000
1361534737,1956116552,2,96,48,1361534709824,1361534712832,1956089376,1956092384,3008
1361534761,1956140604,1,52,52,1361534736650,1361534736650,1956116254,1956116254,0
1361534843,1956223048,3,189,63,1361534837453,1361534840461,1956217501,1956220509,3008
1361534843,1956223048,3,189,63,1361534838540,1361534841548,1956218588,1956221596,3008
1361534859,1956239044,2,126,63,1361534844497,1361534852561,1956224541,1956232605,8064
1361534859,1956239048,2,126,63,1361534845579,1361534853643,1956225627,1956233691,8064
1361534883,1956263064,2,126,63,1361534881597,1361534882621,1956261661,1956262685,1024
1361534891,1956271088,2,126,63,1361534884582,1361534888614,1956264670,1956268702,4032
1361534925,1956304760,1,63,63,1361534897004,1361534897004,1956276764,1956276764,0
1361534963,1956343128,4,252,63,1361534954874,1361534961978,1956335002,1956342106,7104
1361534997,1956376828,1,63,63,1361534970278,1361534970278,1956350106,1956350106,0
1361535003,1956383148,12,999,83.25,1361534986598,1361534998246,1956366746,1956378394,11648
1361535003,1956383148,12,999,83.25,1361534986917,1361534998245,1956367065,1956378393,11328
1361535003,1956383152,12,999,83.25,1361534987170,1361534998242,1956367322,1956378394,11072
1361535003,1956383156,17,6755,397.3529412,1361534986144,1361534998240,1956366300,1956378396,12096
1361535419,1956799336,16,6335,395.9375,1361535403621,1361535414949,1956783957,1956795285,11328
1361535419,1956799336,12,999,83.25,1361535404131,1361535414947,1956784467,1956795283,10816
1361535419,1956799348,12,999,83.25,1361535404377,1361535414937,1956784725,1956795285,10560
1361535419,1956799348,12,999,83.25,1361535404633,1361535414873,1956784981,1956795221,10240
1361536716,1958095940,1,46,46,1361536690334,1361536690334,1958070274,1958070274,0
1361536904,1958284172,9,861,95.66666667,1361536878963,1361536879155,1958259135,1958259327,192
1361536904,1958284172,8,815,101.875,1361536879282,1361536879410,1958259454,1958259582,128
1361536904,1958284176,8,815,101.875,1361536879536,1361536879664,1958259712,1958259840,128
1361537125,1958504420,3,189,63,1361537120414,1361537123422,1958499834,1958502842,3008
1361537125,1958504432,3,189,63,1361537120340,1361537123348,1958499772,1958502780,3008
1361537141,1958520404,2,126,63,1361537127469,1361537135533,1958506873,1958514937,8064
1361537141,1958520408,2,126,63,1361537127402,1361537135466,1958506810,1958514874,8064
1361537293,1958672492,3,189,63,1361537287571,1361537290643,1958667063,1958670135,3072
1361537309,1958688460,2,126,63,1361537294707,1361537302707,1958674167,1958682167,8000
1361537329,1958709316,9,861,95.66666667,1361537304221,1361537304413,1958684537,1958684729,192
1361537329,1958709320,8,815,101.875,1361537303962,1361537304154,1958684282,1958684474,192
1361537330,1958709352,14,6617,472.6428571,1361537304545,1361537304865,1958683897,1958684217,320
1361537533,1958912600,3,138,46,1361537525222,1361537525286,1958904822,1958904886,64
1361537533,1958912600,3,138,46,1361537525222,1361537525286,1958904822,1958904886,64
1361537550,1958929532,3,812,270.6666667,1361537524075,1361537524139,1958903607,1958903671,64
1361537630,1959009572,2,152,76,1361537603263,1361537618303,1958982835,1958997875,15040
1361537658,1959037660,2,152,76,1361537633254,1361537648294,1959012914,1959027954,15040
1361537690,1959069624,1,76,76,1361537663372,1361537663372,1959042996,1959042996,0
1361538104,1959483632,1,46,46,1361538076796,1361538076796,1959456428,1959456428,0
1361538976,1960356184,3,180,60,1361538948041,1361538950985,1960328225,1960331169,2944
1361538980,1960360224,3,180,60,1361538952993,1361538956001,1960333217,1960336225,3008
1361539000,1960380212,1,46,46,1361538975403,1361538975403,1960355615,1960355615,0
1361539341,1960720496,2,152,76,1361539316146,1361539331186,1960695642,1960710682,15040
1361539350,1960730192,11,953,86.63636364,1361539332218,1361539343610,1960712410,1960723802,11392
1361539350,1960730196,11,953,86.63636364,1361539332472,1361539343544,1960712668,1960723740,11072
1361539350,1960730204,15,6289,419.2666667,1361539331503,1361539343599,1960711707,1960723803,12096
1361539350,1960730204,12,999,83.25,1361539331951,1361539343599,1960712155,1960723803,11648
1361539373,1960752488,2,152,76,1361539346234,1361539361274,1960725722,1960740762,15040
1361539401,1960780624,1,76,76,1361539376113,1361539376113,1960755737,1960755737,0
1361539671,1961050440,12,999,83.25,1361539659942,1361539668646,1961039382,1961048086,8704
1361539671,1961050440,8,2684,335.5,1361539664420,1361539664996,1961043860,1961044436,576
1361539671,1961050444,8,2576,322,1361539664930,1361539665506,1961044374,1961044950,576
1361539671,1961050468,15,6289,419.2666667,1361539658633,1361539668617,1961038101,1961048085,9984
1361539671,1961050476,10,2668,266.8,1361539664386,1361539664962,1961043862,1961044438,576
1361539671,1961050480,11,953,86.63636364,1361539660927,1361539668607,1961040407,1961048087,7680
1361539671,1961050480,8,2684,335.5,1361539664894,1361539665470,1961044374,1961044950,576
1361539679,1961058436,22,17148,779.4545455,1361539664104,1361539675112,1961043540,1961054548,11008
1361539679,599372456,19,21981,1156.894737,1361539662850,1361539674818,599356306,599368274,11968
1361539685,1961065088,2,152,76,1361539659038,1361539674078,1961039126,1961054166,15040
1361539717,1961097196,2,152,76,1361539689009,1361539704049,1961069205,1961084245,15040
1361539745,1961125172,2,152,76,1361539719047,1361539734151,1961099219,1961114323,15104
1361539774,1961153456,2,152,76,1361539749908,1361539764948,1961129364,1961144404,15040
1361539806,1961185472,2,152,76,1361539779971,1361539795011,1961159443,1961174483,15040
1361539807,1961186500,7,2447,349.5714286,1361539802854,1361539802982,1961182354,1961182482,128
1361539807,1961186504,21,15629,744.2380952,1361539795555,1361539806883,1961175059,1961186387,11328
1361539818,599511348,33,43694,1324.060606,1361539794798,1361539812718,599488146,599506066,17920
1361540094,1961473856,1,46,46,1361540067136,1361540067136,1961446992,1961446992,0
1361541068,1962447532,1,46,46,1361541040116,1361541040116,1962419648,1962419648,0
1361541085,1962464448,1,48,48,1361541056200,1361541056200,1962435648,1962435648,0
1361541085,1962465256,1,48,48,1361541055455,1361541055455,1962435711,1962435711,0
1361541225,1962604672,1,46,46,1361541199206,1361541199206,1962578878,1962578878,0
1361541225,1962605308,1,46,46,1361541198633,1361541198633,1962578941,1962578941,0
1361541481,1962860496,11,953,86.63636364,1361541465107,1361541476243,1962844603,1962855739,11136
1361541481,1962860508,11,953,86.63636364,1361541464902,1361541476230,1962844410,1962855738,11328
1361541481,1962860508,12,999,83.25,1361541464646,1361541476230,1962844154,1962855738,11584
1361541481,1962860544,15,6289,419.2666667,1361541464163,1361541476195,1962843707,1962855739,12032
1361541545,1962924804,1,48,48,1361541518687,1361541518687,1962898491,1962898491,0
1361541585,1962965116,1,46,46,1361541559587,1361541559587,1962939703,1962939703,0
1361541878,1963258016,1,46,46,1361541850629,1361541850629,1963230645,1963230645,0
1361542034,1963414120,1,46,46,1361542007962,1361542007962,1963388082,1963388082,0
1361542897,1964276472,1,46,46,1361542868691,1361542868691,1964248163,1964248163,0
1361542897,1964276472,1,46,46,1361542868691,1361542868691,1964248163,1964248163,0
1361543282,1964661408,17,6896,405.6470588,1361543269008,1361543281040,1964648416,1964660448,12032
1361543282,1964661460,15,6289,419.2666667,1361543269340,1361543281052,1964648800,1964660512,11712
1361543282,1964661460,11,953,86.63636364,1361543269724,1361543281052,1964649184,1964660512,11328
1361543282,1964661464,12,999,83.25,1361543270040,1361543280984,1964649504,1964660448,10944
1361543282,1964661464,12,999,83.25,1361543270231,1361543280983,1964649695,1964660447,10752
1361543348,1964728044,2,152,76,1361543321490,1361543336530,1964701534,1964716574,15040
1361543376,1964756192,2,152,76,1361543351423,1361543366463,1964731615,1964746655,15040
1361543408,1964788180,1,76,76,1361543381513,1361543381513,1964761693,1964761693,0
1361543410,1964789552,12,999,83.25,1361543393596,1361543405180,1964773148,1964784732,11584
1361543410,1964789600,12,999,83.25,1361543393103,1361543405135,1964772703,1964784735,12032
1361543410,1964789600,12,999,83.25,1361543393292,1361543405132,1964772892,1964784732,11840
1361543410,1964789620,11,953,86.63636364,1361543393848,1361543405112,1964773468,1964784732,11264
1361543424,1964804192,2,152,76,1361543396541,1361543411581,1964776733,1964791773,15040
1361543452,1964832224,2,152,76,1361543426588,1361543441628,1964806812,1964821852,15040
1361543484,1964864304,2,152,76,1361543456589,1361543471629,1964836893,1964851933,15040
1361543513,1964892372,2,152,76,1361543487601,1361543502641,1964866973,1964882013,15040
1361543545,1964924612,2,152,76,1361543517440,1361543532480,1964897052,1964912092,15040
1361543573,1964952616,2,152,76,1361543547513,1361543562553,1964927129,1964942169,15040
1361543605,1964984636,2,152,76,1361543577573,1361543592613,1964957209,1964972249,15040
1361543633,1965012660,1,76,76,1361543607630,1361543607630,1964987290,1964987290,0
1361543966,1965345328,1,46,46,1361543939732,1361543939732,1965319060,1965319060,0
1361544443,1965822456,5,2352,470.4,1361544425296,1361544436752,1965804752,1965816208,11456
1361544563,1965942896,1,60,60,1361544538195,1361544538195,1965918091,1965918091,0
1361544612,1965992056,1,46,46,1361544586161,1361544586161,1965966217,1965966217,0
1361547012,1968391648,11,4651,422.8181818,1361546985830,1361546986150,1968365478,1968365798,320
1361547012,1968391672,9,861,95.66666667,1361546986512,1361546986704,1968366184,1968366376,192
1361547012,1968391672,8,815,101.875,1361546986832,1361546987024,1968366504,1968366696,192
1361547012,1968391720,9,861,95.66666667,1361546986143,1361546986399,1968365863,1968366119,256
1361547277,1968656940,3,189,63,1361547270207,1361547273215,1968650147,1968653155,3008
1361547293,1968672900,2,126,63,1361547277287,1361547285351,1968657187,1968665251,8064
1361547317,1968696944,4,252,63,1361547309625,1361547316729,1968689569,1968696673,7104
1361547352,1968732040,1,63,63,1361547324634,1361547324634,1968704674,1968704674,0
1361547357,1968736984,3,189,63,1361547350802,1361547353874,1968730786,1968733858,3072
1361547357,1968737052,3,189,63,1361547350797,1361547353805,1968730849,1968733857,3008
1361547373,1968753048,2,126,63,1361547357777,1361547365841,1968737825,1968745889,8064
1361547373,1968753052,2,126,63,1361547357836,1361547365900,1968737888,1968745952,8064
1361547432,1968812048,9,861,95.66666667,1361547405011,1361547405203,1968785059,1968785251,192
1361547432,1968812056,9,861,95.66666667,1361547405576,1361547405768,1968785632,1968785824,192
1361547432,1968812100,8,815,101.875,1361547405214,1361547405406,1968785314,1968785506,192
1361547432,1968812208,12,4697,391.4166667,1361547404467,1361547404787,1968784675,1968784995,320
1361547621,1969001092,3,189,63,1361547614051,1361547617123,1968994143,1968997215,3072
1361547637,1969017136,2,126,63,1361547621110,1361547629174,1969001246,1969009310,8064
1361547669,1969049132,3,189,63,1361547663736,1361547666744,1969043868,1969046876,3008
1361547685,1969065208,2,126,63,1361547670703,1361547678767,1969050911,1969058975,8064
1361547725,1969105180,2,126,63,1361547722889,1361547723913,1969103069,1969104093,1024
1361547725,1969105224,2,126,63,1361547722907,1361547723867,1969103131,1969104091,960
1361547733,1969113168,2,126,63,1361547725910,1361547729942,1969106078,1969110110,4032
1361547733,1969113168,2,126,63,1361547725973,1361547730005,1969106141,1969110173,4032
1361547766,1969145440,1,63,63,1361547738797,1361547738797,1969118237,1969118237,0
1361547766,1969145512,1,63,63,1361547738660,1361547738660,1969118172,1969118172,0
1361547782,1969161420,1,48,48,1361547756863,1361547756863,1969136283,1969136283,0
1361548622,1970001836,3,450,150,1361548594963,1361548600979,1969974799,1969980815,6016
1361548646,1970025856,11,953,86.63636364,1361548630718,1361548641982,1970010574,1970021838,11264
1361548646,1970025896,12,999,83.25,1361548630101,1361548642005,1970009997,1970021901,11904
1361548646,1970025900,12,999,83.25,1361548630418,1361548641938,1970010318,1970021838,11520
1361548646,1970025936,12,999,83.25,1361548629808,1361548641968,1970009744,1970021904,12160
1361548659,1970039040,1,76,76,1361548632582,1361548632582,1970012622,1970012622,0
1361548678,1970057876,12,999,83.25,1361548659754,1361548675242,1970039630,1970055118,15488
1361548678,1970057880,11,953,86.63636364,1361548660007,1361548671911,1970039887,1970051791,11904
1361548678,1970057880,11,953,86.63636364,1361548660261,1361548671909,1970040141,1970051789,11648
1361548678,1970057948,12,999,83.25,1361548660449,1361548671777,1970040397,1970051725,11328
1361548687,1970067016,2,152,76,1361548662621,1361548677661,1970042637,1970057677,15040
1361548711,1970091068,11,3267,297,1361548685993,1361548686825,1970066061,1970066893,832
1361548720,1970099352,1,76,76,1361548693367,1361548693367,1970072719,1970072719,0
1361548756,1970135416,2,152,76,1361548730550,1361548745654,1970109966,1970125070,15104
1361548788,1970167428,2,152,76,1361548760618,1361548775658,1970140046,1970155086,15040
1361548816,1970195376,2,152,76,1361548790748,1361548805788,1970170124,1970185164,15040
1361548848,1970227468,2,152,76,1361548820737,1361548835713,1970200205,1970215181,14976
1361548876,1970255800,2,152,76,1361548850483,1361548865459,1970230283,1970245259,14976
1361549022,1970402036,2,141,70.5,1361549014468,1361549014468,1970394504,1970394504,0
1361549040,1970419924,11,3267,297,1361549014068,1361549014644,1970393992,1970394568,576
1361549048,1970427960,2,152,76,1361549021138,1361549036178,1970401098,1970416138,15040
1361549076,1970456020,2,152,76,1361549051158,1361549066198,1970431178,1970446218,15040
1361549108,1970487924,1,76,76,1361549081331,1361549081331,1970461255,1970461255,0
1361549525,1970904824,3,447,149,1361549498064,1361549504080,1970877888,1970883904,6016
1361549529,1970908868,11,3267,297,1361549503652,1361549504356,1970883520,1970884224,704
1361549529,1970908880,2,141,70.5,1361549504283,1361549504283,1970884163,1970884163,0
1361549647,1971026516,2,141,70.5,1361549639684,1361549639684,1971019200,1971019200,0
1361549666,1971045368,11,3267,297,1361549639319,1361549639895,1971018687,1971019263,576
1361550151,1971530944,2,141,70.5,1361550144207,1361550144207,1971524151,1971524151,0
1361550163,1971543008,3,447,149,1361550137871,1361550143887,1971517879,1971523895,6016
1361550171,1971550904,11,3267,297,1361550143801,1361550144377,1971523705,1971524281,576
1361550448,1971827788,2,141,70.5,1361550447335,1361550447335,1971827123,1971827123,0
1361550472,1971851884,11,3267,297,1361550446664,1361550447304,1971826548,1971827188,640
1361550492,1971871792,12,6151,512.5833333,1361550463970,1361550464354,1971843762,1971844146,384
1361550492,1971871800,9,861,95.66666667,1361550464411,1361550464603,1971844211,1971844403,192
1361550492,1971871804,9,861,95.66666667,1361550464982,1361550465110,1971844786,1971844914,128
1361550492,1971871880,9,861,95.66666667,1361550464586,1361550464778,1971844466,1971844658,192
1361550641,1972020452,3,138,46,1361550638005,1361550638069,1972017457,1972017521,64
1361550641,1972020452,3,138,46,1361550638003,1361550638067,1972017455,1972017519,64
1361550641,1972020456,3,138,46,1361550638063,1361550638127,1972017519,1972017583,64
1361550641,1972020520,2,141,70.5,1361550637423,1361550637423,1972016943,1972016943,0
1361550641,1972020524,3,138,46,1361550637997,1361550638061,1972017521,1972017585,64
1361550657,1972036488,14,1091,77.92857143,1361550640978,1361550653522,1972020466,1972033010,12544
1361550657,1972036536,13,1045,80.38461538,1361550640416,1361550653536,1972019952,1972033072,13120
1361550657,1972036540,14,1091,77.92857143,1361550640667,1361550653467,1972020207,1972033007,12800
1361550657,1972036604,18,6801,377.8333333,1361550639964,1361550653468,1972019568,1972033072,13504
1361550664,1972044248,11,3267,297,1361550636183,1361550636823,1972016431,1972017071,640
1361550777,1972156472,3,450,150,1361550752479,1361550758495,1972131951,1972137967,6016
1361550969,1972348904,15,4835,322.3333333,1361550951211,1361550963307,1972331115,1972343211,12096
1361550969,1972348916,11,953,86.63636364,1361550952994,1361550963298,1972332910,1972343214,10304
1361550969,1972348916,11,953,86.63636364,1361550952736,1361550963296,1972332652,1972343212,10560
1361550969,1972348916,12,999,83.25,1361550953310,1361550963230,1972333226,1972343146,9920
1361551105,1972484836,3,891,297,1361551078639,1361551079471,1972458475,1972459307,832
1361551109,1972488900,11,3267,297,1361551084591,1361551085103,1972464491,1972465003,512
1361551141,1972520964,4,991,247.75,1361551112940,1361551114860,1972492904,1972494824,1920
1361551290,1972669500,13,6234,479.5384615,1361551264506,1361551264826,1972644006,1972644326,320
1361551290,1972669508,9,861,95.66666667,1361551265139,1361551265331,1972644647,1972644839,192
1361551290,1972669532,8,815,101.875,1361551265436,1361551265628,1972644968,1972645160,192
1361551290,1972669584,9,861,95.66666667,1361551264807,1361551264999,1972644391,1972644583,192
1361551370,1972749956,3,138,46,1361551368371,1361551368499,1972748327,1972748455,128
1361551370,1972749956,4,184,46,1361551368499,1361551368563,1972748455,1972748519,64
1361551370,1972749956,4,184,46,1361551368370,1361551368498,1972748326,1972748454,128
1361551370,1972750012,3,138,46,1361551368441,1361551368505,1972748453,1972748517,64
1361551378,1972757816,2,141,70.5,1361551375165,1361551375165,1972754981,1972754981,0
1361551394,1972773616,3,450,150,1361551368132,1361551374148,1972747748,1972753764,6016
1361551402,1972781596,11,3267,297,1361551374040,1361551375512,1972753636,1972755108,1472
1361551578,1972957908,2,141,70.5,1361551574621,1361551574621,1972954529,1972954529,0
1361551599,1972978308,11,3267,297,1361551574773,1361551575349,1972954081,1972954657,576
1361551603,1972982320,8,815,101.875,1361551577707,1361551577835,1972957027,1972957155,128
1361551603,1972982320,8,815,101.875,1361551577962,1361551578090,1972957282,1972957410,128
1361551603,1972982324,9,861,95.66666667,1361551578469,1361551578597,1972957793,1972957921,128
1361551603,1972982412,9,861,95.66666667,1361551578128,1361551578320,1972957540,1972957732,192
1361551802,1973182104,3,138,46,1361551800150,1361551800214,1973180254,1973180318,64
1361551827,1973206592,3,155,51.66666667,1361551800022,1361551800726,1973179614,1973180318,704
1361551827,1973206596,3,155,51.66666667,1361551800020,1361551800660,1973179616,1973180256,640
1361551827,1973206624,2,109,54.5,1361551800632,1361551800632,1973180256,1973180256,0
1361551915,1973294636,11,3267,297,1361551888361,1361551888937,1973267997,1973268573,576
1361551915,1973294720,2,141,70.5,1361551888790,1361551888790,1973268510,1973268510,0
1361551919,1973298636,14,6617,472.6428571,1361551894377,1361551894697,1973274013,1973274333,320
1361551919,1973298728,9,861,95.66666667,1361551894667,1361551894859,1973274395,1973274587,192
1361551923,1973302588,9,861,95.66666667,1361551895064,1361551895320,1973274652,1973274908,256
1361551923,1973302672,8,815,101.875,1361551895301,1361551895493,1973274973,1973275165,192
1361551979,1973358724,2,120,60,1361551951761,1361551951761,1973331485,1973331485,0
1361551986,1973366212,3,138,46,1361551984296,1361551984360,1973364508,1973364572,64
1361551986,1973366212,3,138,46,1361551984296,1361551984360,1973364508,1973364572,64
1361551986,1973366212,3,138,46,1361551984295,1361551984359,1973364507,1973364571,64
1361551986,1973366260,3,138,46,1361551984247,1361551984311,1973364507,1973364571,64
1361552007,1973386732,3,450,150,1361551979590,1361551985606,1973359322,1973365338,6016
1361552203,1973582316,2,141,70.5,1361552200551,1361552200551,1973579867,1973579867,0
1361552219,1973598316,13,1045,80.38461538,1361552203684,1361552216484,1973583000,1973595800,12800
1361552219,1973598320,13,1045,80.38461538,1361552203937,1361552216417,1973583257,1973595737,12480
1361552219,1973598324,13,1045,80.38461538,1361552203421,1361552216477,1973582745,1973595801,13056
1361552219,1973598368,17,6418,377.5294118,1361552202994,1361552216434,1973582362,1973595802,13440
1361552227,1973607140,11,3267,297,1361552199212,1361552199852,1973579352,1973579992,640
1361552496,1973875460,2,152,76,1361552468367,1361552483407,1973847827,1973862867,15040
1361552524,1973903516,2,152,76,1361552498392,1361552513432,1973877908,1973892948,15040
1361552548,1973927444,3,447,149,1361552521503,1361552527583,1973900947,1973907027,6080
1361552556,1973935420,1,76,76,1361552528505,1361552528505,1973907925,1973907925,0
1361552568,1973947564,2,152,76,1361552543462,1361552558502,1973923026,1973938066,15040
1361552579,1973958684,2,141,70.5,1361552577774,1361552577774,1973957458,1973957458,0
1361552600,1973979820,2,152,76,1361552573286,1361552588326,1973953106,1973968146,15040
1361552604,1973983760,11,3267,297,1361552577187,1361552577763,1973956947,1973957523,576
1361552628,1974007868,1,76,76,1361552603317,1361552603317,1973983185,1973983185,0
1361552835,1974214724,6,497,82.83333333,1361552828484,1361552832324,1974208208,1974212048,3840
1361552861,1974240316,11,3267,297,1361552835930,1361552837018,1974215246,1974216334,1088
1361552861,1974240356,1,89,89,1361552836787,1361552836787,1974216143,1974216143,0
1361553478,1974857484,1,60,60,1361553449964,1361553449964,1974829448,1974829448,0
1361553539,1974919216,2,141,70.5,1361553534667,1361553534667,1974914883,1974914883,0
1361553874,1975253788,11,3267,297,1361553846196,1361553846836,1975225984,1975226624,640
1361554034,1975414220,12,6151,512.5833333,1361554006977,1361554007297,1975387197,1975387517,320
1361554034,1975414224,9,861,95.66666667,1361554007421,1361554007549,1975387645,1975387773,128
1361554034,1975414228,8,815,101.875,1361554007930,1361554008122,1975388158,1975388350,192
1361554034,1975414300,9,861,95.66666667,1361554007601,1361554007729,1975387901,1975388029,128
1361554164,1975543620,3,138,46,1361554157849,1361554157913,1975537469,1975537533,64
1361554164,1975543620,3,138,46,1361554157913,1361554157977,1975537533,1975537597,64
1361554164,1975543620,3,138,46,1361554157913,1361554157977,1975537533,1975537597,64
1361554164,1975543684,3,138,46,1361554157848,1361554157912,1975537532,1975537596,64
1361554172,1975551692,14,4789,342.0714286,1361554159311,1361554171407,1975539003,1975551099,12096
1361554172,1975551700,12,999,83.25,1361554159686,1361554171398,1975539386,1975551098,11712
1361554172,1975551700,12,999,83.25,1361554159943,1361554171399,1975539643,1975551099,11456
1361554172,1975551704,11,953,86.63636364,1361554160260,1361554171396,1975539964,1975551100,11136
1361554239,1975618932,1,52,52,1361554214558,1361554214558,1975594490,1975594490,0
1361554243,1975622828,1,52,52,1361554215686,1361554215686,1975595514,1975595514,0
1361554476,1975855936,2,141,70.5,1361554471896,1361554471896,1975851832,1975851832,0
1361554484,1975863884,12,999,83.25,1361554472139,1361554483403,1975852023,1975863287,11264
1361554484,1975863884,18,6801,377.8333333,1361554472458,1361554483338,1975852342,1975863222,10880
1361554484,1975863928,16,6335,395.9375,1361554471261,1361554483357,1975851189,1975863285,12096
1361554484,1975863948,12,999,83.25,1361554471820,1361554483340,1975851768,1975863288,11520
1361554499,1975879068,11,3267,297,1361554471123,1361554471827,1975851191,1975851895,704
1361554579,1975959084,3,162,54,1361554554563,1361554560515,1975934647,1975940599,5952
1361554788,1976168176,2,141,70.5,1361554780769,1361554780769,1976160945,1976160945,0
1361554808,1976187316,11,3267,297,1361554781117,1361554781629,1976160433,1976160945,512
1361554812,1976191324,8,815,101.875,1361554784373,1361554784565,1976163697,1976163889,192
1361554812,1976191408,14,6617,472.6428571,1361554783905,1361554784225,1976163313,1976163633,320
1361554812,1976191416,8,815,101.875,1361554784538,1361554784730,1976163954,1976164146,192
1361554812,1976191420,9,861,95.66666667,1361554784791,1361554784983,1976164211,1976164403,192
1361554828,1976208260,6,497,82.83333333,1361554822223,1361554826703,1976202483,1976206963,4480
1361554856,1976235348,11,3267,297,1361554827932,1361554828636,1976207280,1976207984,704
1361554856,1976235476,9,861,95.66666667,1361554831581,1361554831773,1976211057,1976211249,192
1361554860,1976239460,8,815,101.875,1361554831853,1361554832109,1976211313,1976211569,256
1361554860,1976239464,8,815,101.875,1361554832168,1361554832360,1976211632,1976211824,192
1361555045,1976424400,3,138,46,1361555038312,1361555038376,1976417712,1976417776,64
1361555045,1976424400,3,138,46,1361555038376,1361555038440,1976417776,1976417840,64
1361555045,1976424472,3,138,46,1361555038238,1361555038366,1976417710,1976417838,128
1361555060,1976439976,1,445,445,1361555034661,1361555034661,1976414637,1976414637,0
1361555068,1976447908,1,63,63,1361555043114,1361555043114,1976423022,1976423022,0
1361555093,1976472440,2,126,63,1361555088126,1361555089150,1976467566,1976468590,1024
1361555093,1976472488,2,126,63,1361555088014,1361555089038,1976467502,1976468526,1024
1361555093,1976472488,2,126,63,1361555088014,1361555089038,1976467502,1976468526,1024
1361555221,1976600920,12,999,83.25,1361555208476,1361555220572,1976588396,1976600492,12096
1361555221,1976600928,12,999,83.25,1361555208917,1361555220565,1976588845,1976600493,11648
1361555221,1976600928,11,953,86.63636364,1361555209171,1361555220563,1976589099,1976600491,11392
1361555221,1976600952,11,953,86.63636364,1361555209405,1361555220541,1976589357,1976600493,11136
1361555253,1976633148,2,141,70.5,1361555249143,1361555249143,1976629291,1976629291,0
1361555269,1976648984,1,46,46,1361555242330,1361555242330,1976622314,1976622314,0
1361555277,1976656848,11,3267,297,1361555248867,1361555249507,1976628715,1976629355,640
1361555492,1976871848,1,48,48,1361555462560,1361555462560,1976842408,1976842408,0
1361555526,1976905520,2,141,70.5,1361555519465,1361555519465,1976898985,1976898985,0
1361555542,1976921872,17,6755,397.3529412,1361555521608,1361555533896,1976901480,1976913768,12288
1361555542,1976921876,12,999,83.25,1361555522627,1361555533827,1976902503,1976913703,11200
1361555542,1976921920,17,6755,397.3529412,1361555522198,1361555533782,1976902118,1976913702,11584
1361555542,1976921924,12,999,83.25,1361555522836,1361555533780,1976902760,1976913704,10944
1361555546,1976925528,11,3267,297,1361555518945,1361555519521,1976898473,1976899049,576
1361555558,1976938104,1,46,46,1361555532765,1361555532765,1976912869,1976912869,0
1361555847,1977226504,12,999,83.25,1361555834163,1361555845875,1977213667,1977225379,11712
1361555847,1977226516,17,6755,397.3529412,1361555834855,1361555845799,1977214371,1977225315,10944
1361555847,1977226552,17,6418,377.5294118,1361555833731,1361555845827,1977213283,1977225379,12096
1361555847,1977226556,11,953,86.63636364,1361555834367,1361555845823,1977213923,1977225379,11456
1361556215,1977594756,2,141,70.5,1361556210097,1361556210097,1977589853,1977589853,0
1361556223,1977602788,12,999,83.25,1361556209745,1361556221265,1977589533,1977601053,11520
1361556223,1977602844,15,6289,419.2666667,1361556209114,1361556221210,1977588958,1977601054,12096
1361556223,1977602872,12,999,83.25,1361556209983,1361556221183,1977589855,1977601055,11200
1361556223,1977602872,17,6755,397.3529412,1361556210236,1361556221116,1977590108,1977600988,10880
1361556235,1977615144,11,3267,297,1361556209070,1361556209838,1977589214,1977589982,768
1361556535,1977914872,17,6755,397.3529412,1361556521400,1361556533496,1977901272,1977913368,12096
1361556535,1977914876,12,999,83.25,1361556521781,1361556533493,1977901657,1977913369,11712
1361556535,1977914876,18,6801,377.8333333,1361556522483,1361556533491,1977902359,1977913367,11008
1361556535,1977914948,11,953,86.63636364,1361556522155,1361556533419,1977902103,1977913367,11264
1361556839,1978219196,2,141,70.5,1361556834481,1361556834481,1978214677,1978214677,0
1361556861,1978240660,9,861,95.66666667,1361556835720,1361556835848,1978215380,1978215508,128
1361556861,1978240664,9,861,95.66666667,1361556835972,1361556836100,1978215636,1978215764,128
1361556861,1978240712,11,3267,297,1361556834324,1361556835028,1978214036,1978214740,704
1361556861,1978240744,13,6234,479.5384615,1361556835188,1361556835508,1978214932,1978215252,320
1361556861,1978240752,9,861,95.66666667,1361556836139,1361556836331,1978215891,1978216083,192
1361557096,1978475392,4,184,46,1361557091598,1361557091662,1978470990,1978471054,64
1361557096,1978475392,4,184,46,1361557091598,1361557091662,1978470990,1978471054,64
1361557096,1978475396,4,184,46,1361557091595,1361557091659,1978470991,1978471055,64
1361557096,1978475432,5,264,52.8,1361557090087,1361557091559,1978469519,1978470991,1472
1361557174,1978553504,8,815,101.875,1361557149342,1361557149534,1978528846,1978529038,192
1361557174,1978553580,9,861,95.66666667,1361557148755,1361557148947,1978528335,1978528527,192
1361557174,1978553584,9,861,95.66666667,1361557149005,1361557149197,1978528589,1978528781,192
1361557174,1978553612,8,815,101.875,1361557149554,1361557149682,1978529166,1978529294,128
1361557384,1978763708,3,138,46,1361557383057,1361557383185,1978762765,1978762893,128
1361557392,1978771708,2,141,70.5,1361557388241,1361557388241,1978767949,1978767949,0
1361557406,1978786176,3,155,51.66666667,1361557381565,1361557382589,1978761741,1978762765,1024
1361557410,1978790048,2,109,54.5,1361557382714,1361557382714,1978762762,1978762762,0
1361557410,1978790152,2,109,54.5,1361557382612,1361557382612,1978762764,1978762764,0
1361557414,1978794048,11,3267,297,1361557387324,1361557388028,1978767372,1978768076,704
1361557464,1978843876,2,141,70.5,1361557458150,1361557458150,1978838026,1978838026,0
1361557483,1978862428,11,3267,297,1361557458086,1361557458726,1978837514,1978838154,640
1361557487,1978866408,13,6234,479.5384615,1361557460984,1361557461304,1978840392,1978840712,320
1361557487,1978866420,9,861,95.66666667,1361557461679,1361557461807,1978841099,1978841227,128
1361557487,1978866504,9,861,95.66666667,1361557461274,1361557461466,1978840778,1978840970,192
1361557487,1978866508,9,861,95.66666667,1361557461847,1361557461975,1978841355,1978841483,128
1361557680,1979059980,2,126,63,1361557678651,1361557679675,1979058631,1979059655,1024
1361557688,1979067940,4,184,46,1361557680033,1361557680097,1979059973,1979060037,64
1361557688,1979067988,4,184,46,1361557679987,1361557680051,1979059975,1979060039,64
1361557707,1979086992,3,155,51.66666667,1361557679983,1361557679983,1979059975,1979059975,0
1361557707,1979086992,3,138,46,1361557679981,1361557679981,1979059973,1979059973,0
1361557792,1979172068,19,6988,367.7894737,1361557772448,1361557787744,1979152516,1979167812,15296
1361557792,1979172144,19,6510,342.6315789,1361557772755,1361557787667,1979152899,1979167811,14912
1361557792,1979172148,14,1091,77.92857143,1361557773394,1361557787666,1979153542,1979167814,14272
1361557792,1979172172,15,1137,75.8,1361557773114,1361557787642,1979153286,1979167814,14528
1361557792,1979172180,15,1137,75.8,1361557773683,1361557787635,1979153863,1979167815,13952
1361557985,1979364604,2,141,70.5,1361557980590,1361557980590,1979360194,1979360194,0
1361558000,1979380052,1,74,74,1361557973102,1361557973102,1979353154,1979353154,0
1361558004,1979384152,11,3267,297,1361557979531,1361557980043,1979359683,1979360195,512
1361558041,1979420360,2,120,60,1361558012833,1361558013857,1979392193,1979393217,1024
1361558105,1979484684,12,999,83.25,1361558085917,1361558097501,1979465601,1979477185,11584
1361558105,1979484684,12,999,83.25,1361558086235,1361558097499,1979465919,1979477183,11264
1361558105,1979484712,12,999,83.25,1361558086529,1361558097409,1979466241,1979477121,10880
1361558105,1979484756,17,6418,377.5294118,1361558085333,1361558097429,1979465089,1979477185,12096
1361558402,1979781280,2,141,70.5,1361558399470,1361558399470,1979778750,1979778750,0
1361558417,1979797140,15,6289,419.2666667,1361558397777,1361558409937,1979777917,1979790077,12160
1361558418,1979797300,12,999,83.25,1361558399193,1361558410777,1979778493,1979790077,11584
1361558418,1979797300,12,999,83.25,1361558399446,1361558410710,1979778746,1979790010,11264
1361558418,1979797304,17,6755,397.3529412,1361558399699,1361558410707,1979779003,1979790011,11008
1361558426,1979805444,11,3267,297,1361558398535,1361558399367,1979777979,1979778811,832
1361558714,1980093512,2,141,70.5,1361558709695,1361558709695,1980089207,1980089207,0
1361558730,1980109516,17,6755,397.3529412,1361558713211,1361558725307,1980092727,1980104823,12096
1361558730,1980109524,11,953,86.63636364,1361558714098,1361558725298,1980093622,1980104822,11200
1361558730,1980109592,12,999,83.25,1361558713457,1361558725233,1980093049,1980104825,11776
1361558730,1980109596,12,999,83.25,1361558713769,1361558725225,1980093365,1980104821,11456
1361558734,1980114160,11,3267,297,1361558708537,1361558709049,1980088697,1980089209,512
1361559026,1980406056,2,141,70.5,1361559021273,1361559021273,1980401329,1980401329,0
1361559042,1980421952,13,1045,80.38461538,1361559026433,1361559035969,1980406385,1980415921,9536
1361559042,1980421964,15,6289,419.2666667,1361559023864,1361559035960,1980403828,1980415924,12096
1361559042,1980422004,12,999,83.25,1361559025616,1361559035920,1980405620,1980415924,10304
1361559042,1980422068,16,6335,395.9375,1361559024464,1361559035856,1980404532,1980415924,11392
1361559047,1980426776,11,3267,297,1361559021041,1361559021681,1980400817,1980401457,640
1361559338,1980718136,2,141,70.5,1361559333700,1361559333700,1980713836,1980713836,0
1361559354,1980734100,12,999,83.25,1361559337323,1361559348139,1980717423,1980728239,10816
1361559354,1980734148,18,6801,377.8333333,1361559336059,1361559348155,1980716207,1980728303,12096
1361559354,1980734176,18,6801,377.8333333,1361559336606,1361559348126,1980716782,1980728302,11520
1361559354,1980734184,12,999,83.25,1361559336983,1361559348055,1980717167,1980728239,11072
1361559359,1980739256,11,3267,297,1361559333068,1361559333644,1980713324,1980713900,576
1361559651,1981030312,2,141,70.5,1361559646778,1361559646778,1981026090,1981026090,0
1361559666,1981046248,17,6755,397.3529412,1361559648401,1361559660497,1981028649,1981040745,12096
1361559666,1981046272,12,999,83.25,1361559648761,1361559660473,1981029033,1981040745,11712
1361559666,1981046280,11,953,86.63636364,1361559649649,1361559660465,1981029929,1981040745,10816
1361559667,1981046332,17,6755,397.3529412,1361559650213,1361559661413,1981029545,1981040745,11200
1361559672,1981052200,11,3267,297,1361559645441,1361559646017,1981025641,1981026217,576
1361559979,1981358444,12,999,83.25,1361559961520,1361559973232,1981340964,1981352676,11712
1361559979,1981358452,12,999,83.25,1361559962025,1361559973225,1981341477,1981352677,11200
1361559979,1981358456,11,953,86.63636364,1361559962277,1361559973221,1981341733,1981352677,10944
1361559979,1981358560,17,6418,377.5294118,1361559961019,1361559973115,1981340579,1981352675,12096
1361559989,1981369108,1,46,46,1361559961369,1361559961369,1981341477,1981341477,0
1361560275,1981654656,2,141,70.5,1361560274199,1361560274199,1981653855,1981653855,0
1361560291,1981670652,16,6372,398.25,1361560274717,1361560285597,1981654369,1981665249,10880
1361560291,1981670696,12,999,83.25,1361560274096,1361560285552,1981653792,1981665248,11456
1361560291,1981670700,11,953,86.63636364,1361560274348,1361560285548,1981654048,1981665248,11200
1361560291,1981670732,15,6289,419.2666667,1361560273418,1361560285514,1981653150,1981665246,12096
1361560298,1981678036,11,3267,297,1361560273434,1361560273882,1981653470,1981653918,448
1361560398,1981778244,1,95,95,1361560372104,1361560372104,1981752348,1981752348,0
1361560603,1981982892,16,6372,398.25,1361560585960,1361560598056,1981965852,1981977948,12096
1361560603,1981982892,12,999,83.25,1361560586407,1361560598055,1981966299,1981977947,11648
1361560603,1981982896,17,6755,397.3529412,1361560586850,1361560598050,1981966746,1981977946,11200
1361560603,1981982900,12,999,83.25,1361560587233,1361560597985,1981967133,1981977885,10752
1361560699,1982078976,2,141,70.5,1361560696528,1361560696528,1982076504,1982076504,0
1361560716,1982095288,1,95,95,1361560690560,1361560690560,1982069848,1982069848,0
1361560723,1982103184,11,3267,297,1361560695747,1361560696387,1982075931,1982076571,640
1361560881,1982261100,1,48,48,1361560853715,1361560853715,1982233815,1982233815,0
1361560915,1982295012,17,6755,397.3529412,1361560899180,1361560910060,1982279192,1982290072,10880
1361560915,1982295044,16,6372,398.25,1361560897994,1361560910090,1982278038,1982290134,12096
1361560915,1982295076,12,999,83.25,1361560898345,1361560910057,1982278421,1982290133,11712
1361560916,1982295532,12,999,83.25,1361560899147,1361560910603,1982278679,1982290135,11456
1361561229,1982608436,3,152,50.66666667,1361561203941,1361561212965,1982583377,1982592401,9024
1361561229,1982608516,4,244,61,1361561203863,1361561214359,1982583379,1982593875,10496
1361561308,1982687348,2,141,70.5,1361561306555,1361561306555,1982685903,1982685903,0
1361561323,1982703260,12,999,83.25,1361561305003,1361561316459,1982685263,1982696719,11456
1361561324,1982703300,16,6372,398.25,1361561305323,1361561317419,1982684623,1982696719,12096
1361561324,1982703336,11,953,86.63636364,1361561306183,1361561317383,1982685519,1982696719,11200
1361561324,1982703340,12,999,83.25,1361561306500,1361561317380,1982685840,1982696720,10880
1361561333,1982712828,11,3267,297,1361561305565,1361561306205,1982685393,1982686033,640
1361561337,1982716904,4,244,61,1361561309457,1361561320017,1982689361,1982699921,10560
1361561337,1982716904,3,152,50.66666667,1361561309457,1361561310929,1982689361,1982690833,1472
1361561710,1983090244,1,46,46,1361561684471,1361561684471,1983064715,1983064715,0
1361561716,1983095552,12,999,83.25,1361561698410,1361561710122,1983077962,1983089674,11712
1361561716,1983095556,17,6755,397.3529412,1361561698726,1361561710118,1983078282,1983089674,11392
1361561716,1983095608,16,6372,398.25,1361561697971,1361561710067,1983077579,1983089675,12096
1361561716,1983095636,12,999,83.25,1361561699031,1361561710039,1983078667,1983089675,11008
1361562028,1983408160,11,953,86.63636364,1361562010694,1361562021830,1983390854,1983401990,11136
1361562028,1983408208,11,953,86.63636364,1361562010134,1361562021782,1983390342,1983401990,11648
1361562028,1983408208,12,999,83.25,1361562010389,1361562021781,1983390597,1983401989,11392
1361562029,1983408272,17,6418,377.5294118,1361562010622,1361562022718,1983389894,1983401990,12096
1361562035,1983414724,11,3267,297,1361562010616,1361562011192,1983390340,1983390916,576
1361562039,1983418732,2,141,70.5,1361562011121,1361562011121,1983390853,1983390853,0
1361562325,1983704440,2,141,70.5,1361562320977,1361562320977,1983700417,1983700417,0
1361562341,1983720360,12,999,83.25,1361562324384,1361562335648,1983703744,1983715008,11264
1361562341,1983720364,12,999,83.25,1361562324638,1361562335646,1983704002,1983715010,11008
1361562341,1983720400,16,6372,398.25,1361562323512,1361562335608,1983702912,1983715008,12096
1361562341,1983720404,11,953,86.63636364,1361562323892,1361562335604,1983703296,1983715008,11712
1361562347,1983727020,11,3267,297,1361562319819,1361562320459,1983699839,1983700479,640
1361562637,1984016608,2,141,70.5,1361562633763,1361562633763,1984013371,1984013371,0
1361562653,1984032864,11,953,86.63636364,1361562636707,1361562647523,1984016571,1984027387,10816
1361562653,1984032912,16,6372,398.25,1361562635444,1361562647540,1984015356,1984027452,12096
1361562653,1984032920,18,6801,377.8333333,1361562635950,1361562647534,1984015870,1984027454,11584
1361562653,1984032924,12,999,83.25,1361562636328,1361562647528,1984016252,1984027452,11200
1361562660,1984039544,11,3267,297,1361562633316,1361562633892,1984012860,1984013436,576
1361562860,1984239952,4,244,61,1361562835403,1361562845963,1984215355,1984225915,10560
1361562860,1984239952,3,152,50.66666667,1361562835402,1361562837706,1984215354,1984217658,2304
1361562965,1984345124,12,999,83.25,1361562949146,1361562962202,1984329270,1984342326,13056
1361562965,1984345128,12,999,83.25,1361562949398,1361562960790,1984329526,1984340918,11392
1361562965,1984345180,12,999,83.25,1361562949604,1361562960676,1984329784,1984340856,11072
1361562965,1984345180,18,6464,359.1111111,1361562948643,1361562962147,1984328823,1984342327,13504
1361563270,1984649320,2,141,70.5,1361563262716,1361563262716,1984642036,1984642036,0
1361563278,1984657324,12,999,83.25,1361563263097,1361563273785,1984642421,1984653109,10688
1361563278,1984657364,15,6289,419.2666667,1361563261710,1361563273806,1984641074,1984653170,12096
1361563278,1984657368,17,6418,377.5294118,1361563262347,1361563273739,1984641715,1984653107,11392
1361563278,1984657388,12,999,83.25,1361563262777,1361563273721,1984642165,1984653109,10944
1361563289,1984669000,11,3267,297,1361563261521,1361563262097,1984641521,1984642097,576
1361563574,1984954220,2,141,70.5,1361563571123,1361563571123,1984951343,1984951343,0
1361563590,1984970220,12,999,83.25,1361563574513,1361563585777,1984954733,1984965997,11264
1361563590,1984970224,17,6755,397.3529412,1361563574831,1361563585775,1984955055,1984965999,10944
1361563591,1984970268,17,6418,377.5294118,1361563574699,1361563586795,1984953967,1984966063,12096
1361563591,1984970272,11,953,86.63636364,1361563575208,1361563586792,1984954480,1984966064,11584
1361563598,1984977940,11,3267,297,1361563570954,1361563571530,1984950894,1984951470,576
1361563887,1985266316,2,141,70.5,1361563884277,1361563884277,1985263593,1985263593,0
1361563903,1985282308,18,6801,377.8333333,1361563887357,1361563898941,1985266665,1985278249,11584
1361563903,1985282312,12,999,83.25,1361563887993,1361563898937,1985267305,1985278249,10944
1361563903,1985282356,17,6755,397.3529412,1361563886925,1361563898893,1985266281,1985278249,11968
1361563903,1985282384,11,953,86.63636364,1361563887667,1361563898867,1985267051,1985278251,11200
1361563911,1985290812,11,3267,297,1361563883332,1361563883844,1985263144,1985263656,512
1361564271,1985650684,2,141,70.5,1361564267394,1361564267394,1985647078,1985647078,0
1361564279,1985658720,11,953,86.63636364,1361564266780,1361564276700,1985646500,1985656420,9920
1361564279,1985658800,12,999,83.25,1361564266956,1361564276620,1985646756,1985656420,9664
1361564279,1985658800,12,999,83.25,1361564267211,1361564276619,1985647011,1985656419,9408
1361564328,1985707636,3,144,48,1361564303342,1361564311342,1985682978,1985690978,8000
1361564340,1985719612,2,104,52,1361564313861,1361564316869,1985693473,1985696481,3008
1361564591,1985971020,17,6755,397.3529412,1361564577834,1361564589930,1985957854,1985969950,12096
1361564591,1985971020,11,953,86.63636364,1361564578538,1361564589930,1985958558,1985969950,11392
1361564591,1985971072,12,999,83.25,1361564578233,1361564589881,1985958305,1985969953,11648
1361564591,1985971088,12,999,83.25,1361564578726,1361564589862,1985958814,1985969950,11136
1361564604,1985984160,11,3267,297,1361564577438,1361564578270,1985957598,1985958430,832
1361564913,1986292488,2,141,70.5,1361564888636,1361564888636,1986268124,1986268124,0
1361564913,1986292560,11,3267,297,1361564888052,1361564888564,1986267612,1986268124,512
1361564917,1986296516,9,861,95.66666667,1361564891549,1361564891741,1986271065,1986271257,192
1361564917,1986296624,14,6617,472.6428571,1361564891056,1361564891376,1986270680,1986271000,320
1361564917,1986296628,9,861,95.66666667,1361564891693,1361564891885,1986271321,1986271513,192
1361564917,1986296632,10,1244,124.4,1361564892010,1361564893162,1986271642,1986272794,1152
1361565120,1986499496,4,184,46,1361565117869,1361565117933,1986497365,1986497429,64
1361565120,1986499540,5,264,52.8,1361565116482,1361565117826,1986496022,1986497366,1344
1361565120,1986499572,4,184,46,1361565117797,1361565117861,1986497369,1986497433,64
1361565146,1986525448,3,155,51.66666667,1361565117919,1361565117919,1986497367,1986497367,0
1361565302,1986681848,9,861,95.66666667,1361565274317,1361565274509,1986654165,1986654357,192
1361565302,1986681852,9,861,95.66666667,1361565274570,1361565274762,1986654422,1986654614,192
1361565302,1986681852,9,861,95.66666667,1361565274823,1361565275015,1986654675,1986654867,192
1361565302,1986681856,9,861,95.66666667,1361565275077,1361565275269,1986654933,1986655125,192
1361565520,1986899740,3,138,46,1361565519798,1361565519862,1986899538,1986899602,64
1361565520,1986899764,3,138,46,1361565519708,1361565519772,1986899472,1986899536,64
1361565528,1986907760,2,141,70.5,1361565523873,1361565523873,1986903633,1986903633,0
1361565543,1986922292,3,155,51.66666667,1361565517750,1361565520246,1986897042,1986899538,2496
1361565547,1986926392,2,109,54.5,1361565520080,1361565520080,1986899472,1986899472,0
1361565550,1986930248,11,3267,297,1361565522873,1361565523513,1986903121,1986903761,640
1361565680,1987059812,12,999,83.25,1361565665066,1361565676202,1987044878,1987056014,11136
1361565680,1987059832,12,999,83.25,1361565665365,1361565676181,1987045197,1987056013,10816
1361565680,1987059848,16,6372,398.25,1361565664073,1361565676169,1987043921,1987056017,12096
1361565680,1987059880,17,6755,397.3529412,1361565664613,1361565676133,1987044493,1987056013,11520
1361565984,1987364172,2,141,70.5,1361565977342,1361565977342,1987357514,1987357514,0
1361565992,1987372132,17,6418,377.5294118,1361565976165,1361565988261,1987356297,1987368393,12096
1361565992,1987372140,12,999,83.25,1361565976543,1361565988255,1987356683,1987368395,11712
1361565992,1987372216,12,999,83.25,1361565976978,1361565988178,1987357194,1987368394,11200
1361565992,1987372220,18,6801,377.8333333,1361565977296,1361565988176,1987357516,1987368396,10880
1361566003,1987383004,11,3267,297,1361565976744,1361565977512,1987356748,1987357516,768
1361566003,1987383120,2,128,64,1361565976947,1361565980979,1987357067,1987361099,4032
1361566256,1987635280,2,106,53,1361566229493,1361566229557,1987608773,1987608837,64
1361566300,1987679392,1,48,48,1361566275271,1361566275271,1987654663,1987654663,0
1361566316,1987695396,13,6234,479.5384615,1361566290175,1361566290431,1987669571,1987669827,256
1361566316,1987695396,8,815,101.875,1361566290560,1361566290752,1987669956,1987670148,192
1361566316,1987695400,8,815,101.875,1361566290812,1361566291004,1987670212,1987670404,192
1361566316,1987695404,9,861,95.66666667,1361566291066,1361566291258,1987670470,1987670662,192
1361566545,1987924520,3,138,46,1361566538243,1361566538307,1987917763,1987917827,64
1361566545,1987924520,3,138,46,1361566538179,1361566538307,1987917699,1987917827,128
1361566545,1987924596,3,138,46,1361566538167,1361566538231,1987917763,1987917827,64
1361566545,1987924632,2,141,70.5,1361566543120,1361566543120,1987922752,1987922752,0
1361566564,1987943940,3,155,51.66666667,1361566536477,1361566537821,1987916417,1987917761,1344
1361566568,1987947864,11,3267,297,1361566542378,1361566542890,1987922242,1987922754,512
1361566601,1987980572,2,141,70.5,1361566599947,1361566599947,1987979519,1987979519,0
1361566624,1988004080,9,3163,351.4444444,1361566598609,1361566599441,1987978689,1987979521,832
1361566628,1988008076,9,861,95.66666667,1361566601363,1361566601555,1987981439,1987981631,192
1361566628,1988008080,8,815,101.875,1361566601681,1361566601809,1987981761,1987981889,128
1361566628,1988008156,9,861,95.66666667,1361566601027,1361566601219,1987981183,1987981375,192
1361566628,1988008168,8,815,101.875,1361566601848,1361566602040,1987982016,1987982208,192
1361566721,1988100584,4,184,46,1361566715325,1361566715389,1988094909,1988094973,64
1361566721,1988100584,4,184,46,1361566715329,1361566715393,1988094913,1988094977,64
1361566721,1988100584,4,184,46,1361566715329,1361566715393,1988094913,1988094977,64
1361566721,1988100644,4,184,46,1361566715268,1361566715332,1988094912,1988094976,64
1361566929,1988308744,16,6335,395.9375,1361566913882,1361566927322,1988293626,1988307066,13440
1361566929,1988308748,13,1045,80.38461538,1361566914713,1361566927257,1988294461,1988307005,12544
1361566929,1988308824,14,1091,77.92857143,1361566914893,1361566927181,1988294717,1988307005,12288
1361566929,1988308824,14,1091,77.92857143,1361566915147,1361566927179,1988294971,1988307003,12032
1361567033,1988412956,4,319,79.75,1361567031304,1361567032072,1988411260,1988412028,768
1361567041,1988420824,3,267,89,1361567033228,1361567039308,1988413052,1988419132,6080
1361567065,1988444952,2,178,89,1361567047305,1361567063561,1988427257,1988443513,16256
1361567121,1988500848,1,89,89,1361567096176,1361567096176,1988476024,1988476024,0
1361567382,1988761632,1,60,60,1361567356613,1361567356613,1988736245,1988736245,0
1361567615,1988994380,1,60,60,1361567586814,1361567586814,1988966194,1988966194,0
1361567627,1989006424,1,60,60,1361567600465,1361567600465,1988979889,1988979889,0
1361568065,1989444504,1,46,46,1361568038268,1361568038268,1989417772,1989417772,0
1361568347,1989726276,44,57035,1296.25,1361568340699,1361568340891,1989719975,1989720167,192
1361568363,1989742340,12,999,83.25,1361568344411,1361568355803,1989723751,1989735143,11392
1361568363,1989742344,11,953,86.63636364,1361568344149,1361568355797,1989723493,1989735141,11648
1361568363,1989742344,11,953,86.63636364,1361568344662,1361568355798,1989724006,1989735142,11136
1361568363,1989742384,16,6372,398.25,1361568343661,1361568355757,1989723045,1989735141,12096
1361568369,1989748540,1,46,46,1361568343569,1361568343569,1989723109,1989723109,0
1361568467,1989846352,11,953,86.63636364,1361568456782,1361568465678,1989836134,1989845030,8896
1361568467,1989846352,13,1045,80.38461538,1361568457038,1361568466062,1989836390,1989845414,9024
1361568467,1989846428,15,6289,419.2666667,1361568456257,1361568465601,1989835685,1989845029,9344
1361569868,1991248252,12,999,83.25,1361569852789,1361569862837,1991233041,1991243089,10048
1361569869,1991248300,17,6755,397.3529412,1361569853099,1361569863851,1991232399,1991243151,10752
1361569869,1991248304,12,999,83.25,1361569853481,1361569863849,1991232785,1991243153,10368
1361571609,1992988608,1,52,52,1361571583582,1361571583582,1992963190,1992963190,0
1361571681,1993060596,8,815,101.875,1361571653801,1361571653993,1993033397,1993033589,192
1361571681,1993060664,8,815,101.875,1361571653477,1361571653669,1993033141,1993033333,192
1361571681,1993060668,11,4651,422.8181818,1361571653087,1361571653343,1993032755,1993033011,256
1361571805,1993185004,3,144,48,1361571778701,1361571787661,1993158705,1993167665,8960
1361571846,1993225572,4,252,63,1361571838400,1361571845440,1993217972,1993225012,7040
1361571846,1993225580,3,189,63,1361571839863,1361571842871,1993219443,1993222451,3008
1361571846,1993225620,4,252,63,1361571837968,1361571845008,1993217588,1993224628,7040
1361571862,1993241616,2,126,63,1361571846865,1361571854929,1993226481,1993234545,8064
1361571878,1993257388,1,63,63,1361571853301,1361571853301,1993232689,1993232689,0
1361571878,1993257552,1,63,63,1361571853521,1361571853521,1993233073,1993233073,0
1361571966,1993345672,2,92,46,1361571961175,1361571961175,1993340847,1993340847,0
1361571966,1993345740,2,92,46,1361571961108,1361571961108,1993340848,1993340848,0
1361571966,1993345740,2,92,46,1361571961108,1361571961108,1993340848,1993340848,0
1361571990,1993369468,9,861,95.66666667,1361571962213,1361571962405,1993341681,1993341873,192
1361571990,1993369468,9,861,95.66666667,1361571962467,1361571962659,1993341935,1993342127,192
1361571990,1993369472,8,815,101.875,1361571962720,1361571962912,1993342192,1993342384,192
1361571990,1993369476,8,815,101.875,1361571963037,1361571963229,1993342513,1993342705,192
1361572214,1993593976,3,189,63,1361572210148,1361572213156,1993590124,1993593132,3008
1361572214,1993594020,3,189,63,1361572210104,1361572213112,1993590124,1993593132,3008
1361572230,1993610100,2,126,63,1361572217066,1361572225130,1993597166,1993605230,8064
1361572230,1993610144,2,126,63,1361572217020,1361572225084,1993597164,1993605228,8064
1361572238,1993618032,4,252,63,1361572230059,1361572237163,1993610091,1993617195,7104
1361572254,1993634088,3,189,63,1361572250037,1361572253109,1993630125,1993633197,3072
1361572270,1993650024,1,63,63,1361572245237,1361572245237,1993625261,1993625261,0
1361572270,1993650136,2,126,63,1361572257092,1361572265156,1993637228,1993645292,8064
1361572580,1993959760,1,48,48,1361572553975,1361572553975,1993933735,1993933735,0
1361572855,1994234908,1,46,46,1361572828639,1361572828639,1994208547,1994208547,0
1361573353,1994732364,1,46,46,1361573325945,1361573325945,1994705309,1994705309,0
1361573381,1994760368,1,60,60,1361573355121,1361573355121,1994734489,1994734489,0
1361573381,1994760484,1,60,60,1361573355007,1361573355007,1994734491,1994734491,0
1361573385,1994764412,1,60,60,1361573359432,1361573359432,1994738844,1994738844,0
1361573393,1994772552,1,60,60,1361573365948,1361573365948,1994745500,1994745500,0
1361573469,1994848696,14,6750,482.1428571,1361573443688,1361573444008,1994823384,1994823704,320
1361573469,1994848816,14,6280,448.5714286,1361573444018,1361573444402,1994823834,1994824218,384
1361573472,1994851692,9,861,95.66666667,1361573444654,1361573444846,1994824346,1994824538,192
1361573473,1994852652,8,815,101.875,1361573444948,1361573445140,1994824600,1994824792,192
1361573473,1994852772,14,6617,472.6428571,1361573445149,1361573445405,1994824921,1994825177,256
1361573513,1994892828,1,60,60,1361573487975,1361573487975,1994867803,1994867803,0
1361573585,1994964936,1,60,60,1361573560694,1361573560694,1994940630,1994940630,0
1361573656,1995036012,3,189,63,1361573650667,1361573653675,1995030679,1995033687,3008
1361573672,1995051956,2,126,63,1361573657763,1361573665827,1995037719,1995045783,8064
1361573704,1995084032,3,189,63,1361573696981,1361573699989,1995077013,1995080021,3008
1361573720,1995100000,2,126,63,1361573704054,1361573712118,1995084054,1995092118,8064
1361573768,1995148060,4,252,63,1361573760057,1361573767161,1995140117,1995147221,7104
1361573768,1995148060,4,252,63,1361573760120,1361573767160,1995140180,1995147220,7040
1361573802,1995181724,1,63,63,1361573775559,1361573775559,1995155283,1995155283,0
1361573802,1995181844,1,63,63,1361573775375,1361573775375,1995155219,1995155219,0
1361573816,1995196056,3,189,63,1361573810429,1361573813437,1995190485,1995193493,3008
1361573832,1995212148,2,126,63,1361573817377,1361573825441,1995197525,1995205589,8064
1361575265,1996644820,11,4651,422.8181818,1361575237268,1361575237588,1996617088,1996617408,320
1361575265,1996644904,9,861,95.66666667,1361575237567,1361575237759,1996617471,1996617663,192
1361575265,1996644908,9,861,95.66666667,1361575237820,1361575238012,1996617728,1996617920,192
1361575273,1996652872,1,95,95,1361575248159,1361575248159,1996628031,1996628031,0
1361575498,1996877620,3,189,63,1361575492887,1361575495959,1996872507,1996875579,3072
1361575506,1996885584,4,252,63,1361575498105,1361575505145,1996877689,1996884729,7040
1361575514,1996893596,2,126,63,1361575499952,1361575508016,1996879548,1996887612,8064
1361575538,1996917232,1,63,63,1361575513498,1361575513498,1996892730,1996892730,0
1361575578,1996957880,3,189,63,1361575573842,1361575576850,1996953722,1996956730,3008
1361575594,1996973952,2,126,63,1361575580809,1361575588809,1996960761,1996968761,8000
1361575602,1996981924,11,953,86.63636364,1361575592612,1361575600036,1996972536,1996979960,7424
1361575602,1996981972,12,999,83.25,1361575592246,1361575599990,1996972218,1996979962,7744
1361575602,1996981972,12,999,83.25,1361575592820,1361575599988,1996972792,1996979960,7168
1361575630,1997009612,9,861,95.66666667,1361575603036,1361575603228,1996982648,1996982840,192
1361575630,1997009620,8,815,101.875,1361575603606,1361575603798,1996983226,1996983418,192
1361575630,1997009696,8,815,101.875,1361575603209,1361575603401,1996982905,1996983097,192
1361575843,1997222280,4,252,63,1361575834663,1361575841703,1997213943,1997220983,7040
1361575843,1997222324,4,252,63,1361575834876,1361575841916,1997214200,1997221240,7040
1361575874,1997254140,1,63,63,1361575848905,1361575848905,1997229045,1997229045,0
1361575874,1997254144,1,63,63,1361575849159,1361575849159,1997229303,1997229303,0
1361575930,1997310144,13,6234,479.5384615,1361575902339,1361575902659,1997282483,1997282803,320
1361575930,1997310152,8,815,101.875,1361575902972,1361575903164,1997283124,1997283316,192
1361575931,1997310232,9,861,95.66666667,1361575903638,1361575903830,1997282870,1997283062,192
1361575931,1997310236,9,861,95.66666667,1361575904145,1361575904337,1997283381,1997283573,192
1361575939,1997318564,2,126,63,1361575936072,1361575937096,1997315636,1997316660,1024
1361575947,1997326580,2,126,63,1361575939130,1361575943098,1997318710,1997322678,3968
1361575978,1997358156,1,63,63,1361575950584,1361575950584,1997330740,1997330740,0
1361576167,1997546512,6,276,46,1361576139130,1361576148538,1997518642,1997528050,9408
1361576179,1997558724,3,189,63,1361576172772,1361576175844,1997552496,1997555568,3072
1361576195,1997574740,2,126,63,1361576179799,1361576187863,1997559539,1997567603,8064
1361576227,1997606984,4,252,63,1361576218016,1361576225120,1997598000,1997605104,7104
1361576243,1997622980,3,189,63,1361576238693,1361576241765,1997618673,1997621745,3072
1361576243,1997623016,3,189,63,1361576238722,1361576241730,1997618738,1997621746,3008
1361576259,1997638788,1,63,63,1361576233316,1361576233316,1997613104,1997613104,0
1361576259,1997639116,2,126,63,1361576245660,1361576253724,1997625776,1997633840,8064
1361576259,1997639180,2,126,63,1361576245595,1361576253659,1997625775,1997633839,8064
1361576536,1997915568,1,60,60,1361576511482,1361576511482,1997891050,1997891050,0
1361576540,1997919824,12,999,83.25,1361576527613,1361576538493,1997907437,1997918317,10880
1361576540,1997919840,17,6755,397.3529412,1361576526892,1361576538476,1997906732,1997918316,11584
1361576540,1997919864,12,999,83.25,1361576527829,1361576538453,1997907693,1997918317,10624
1361576540,1997919904,12,999,83.25,1361576527213,1361576538413,1997907117,1997918317,11200
1361576549,636242536,5,574,114.8,1361576543523,1361576543651,636237059,636237187,128
1361577243,1998622444,1,46,46,1361577217132,1361577217132,1998596576,1998596576,0
1361578216,1999595376,8,815,101.875,1361578190243,1361578190435,1999569619,1999569811,192
1361578216,1999595408,9,861,95.66666667,1361578190533,1361578190725,1999569941,1999570133,192
1361578216,1999595412,9,861,95.66666667,1361578190784,1361578190976,1999570196,1999570388,192
1361578216,1999595444,12,6151,512.5833333,1361578189727,1361578190111,1999569171,1999569555,384
1361578390,1999769220,4,252,63,1361578380987,1361578388027,1999760207,1999767247,7040
1361578420,1999799680,1,63,63,1361578395632,1361578395632,1999775312,1999775312,0
1361578454,1999833276,2,126,63,1361578451716,1361578452676,1999830992,1999831952,960
1361578462,1999841284,2,126,63,1361578454713,1361578458745,1999833997,1999838029,4032
1361578492,1999872092,1,63,63,1361578466002,1361578466002,1999846094,1999846094,0
1361578518,1999897328,3,189,63,1361578513293,1361578516365,1999892621,1999895693,3072
1361578534,1999913316,2,126,63,1361578520408,1361578528408,1999899724,1999907724,8000
1361578534,1999913340,2,126,63,1361578532355,1361578533379,1999911695,1999912719,1024
1361578542,1999921308,2,126,63,1361578535457,1361578539489,1999914765,1999918797,4032
1361578572,1999952160,1,63,63,1361578546700,1361578546700,1999926860,1999926860,0
1361578769,2000148660,3,447,149,1361578742720,1361578748800,2000122380,2000128460,6080
1361578785,2000164788,1,46,46,1361578760316,1361578760316,2000140104,2000140104,0
1361579106,2000485924,12,6151,512.5833333,1361579081521,1361579081905,2000461445,2000461829,384
1361579110,2000489984,8,815,101.875,1361579081911,1361579082103,2000461895,2000462087,192
1361579110,2000489988,9,861,95.66666667,1361579082223,1361579082479,2000462211,2000462467,256
1361579110,2000489988,8,815,101.875,1361579082544,1361579082736,2000462532,2000462724,192
1361579342,2000722016,4,252,63,1361579334099,1361579341139,2000714115,2000721155,7040
1361579342,2000722052,4,252,63,1361579334064,1361579341104,2000714116,2000721156,7040
1361579358,2000738064,2,126,63,1361579354850,1361579355874,2000734914,2000735938,1024
1361579358,2000738064,2,126,63,1361579354913,1361579355873,2000734977,2000735937,960
1361579366,2000746056,2,126,63,1361579357929,1361579361961,2000737985,2000742017,4032
1361579366,2000746056,2,126,63,1361579357929,1361579361961,2000737985,2000742017,4032
1361579375,2000754472,1,63,63,1361579349744,1361579349744,2000729216,2000729216,0
1361579375,2000754548,1,63,63,1361579349670,1361579349670,2000729218,2000729218,0
1361579395,2000774528,1,63,63,1361579370552,1361579370552,2000750080,2000750080,0
1361579395,2000774608,1,63,63,1361579370475,1361579370475,2000750083,2000750083,0
1361579467,2000846968,1,46,46,1361579442688,1361579442688,2000822656,2000822656,0
1361579684,2001063344,3,447,149,1361579656429,1361579662445,2001035773,2001041789,6016
1361580313,2001692956,3,447,149,1361580284992,1361580291072,2001664948,2001671028,6080
1361580907,2002286476,9,861,95.66666667,1361580879191,1361580879383,2002258667,2002258859,192
1361580907,2002286480,9,861,95.66666667,1361580879443,1361580879635,2002258923,2002259115,192
1361580927,2002306400,3,450,150,1361580899428,1361580905444,2002278828,2002284844,6016
1361581120,2002499592,4,252,63,1361581112608,1361581119712,2002492200,2002499304,7104
1361581152,2002531576,3,189,63,1361581146479,1361581149487,2002526055,2002529063,3008
1361581155,2002534948,1,63,63,1361581127354,1361581127354,2002507302,2002507302,0
1361581168,2002547560,2,126,63,1361581153534,1361581161598,2002533094,2002541158,8064
1361581200,2002579260,8,815,101.875,1361581174696,1361581174888,2002553956,2002554148,192
1361581200,2002579260,8,815,101.875,1361581174955,1361581175147,2002554215,2002554407,192
1361581200,2002579264,8,815,101.875,1361581175526,1361581175718,2002554790,2002554982,192
1361581200,2002579316,9,861,95.66666667,1361581175153,1361581175409,2002554469,2002554725,256
1361581408,2002787760,3,189,63,1361581403699,1361581406707,2002783459,2002786467,3008
1361581408,2002787800,3,189,63,1361581403593,1361581406665,2002783393,2002786465,3072
1361581424,2002803760,2,126,63,1361581410738,1361581418738,2002790498,2002798498,8000
1361581424,2002803760,2,126,63,1361581410738,1361581418802,2002790498,2002798562,8064
1361581496,2002875828,4,252,63,1361581488364,1361581495404,2002868192,2002875232,7040
1361581496,2002875828,4,252,63,1361581488364,1361581495404,2002868192,2002875232,7040
1361581529,2002908276,1,63,63,1361581504020,1361581504020,2002883296,2002883296,0
1361581529,2002908276,1,63,63,1361581504020,1361581504020,2002883296,2002883296,0
1361581541,2002920248,3,450,150,1361581513842,1361581519922,2002893090,2002899170,6080
1361582154,2003533464,3,450,150,1361582127824,1361582133840,2003507288,2003513304,6016
1361582571,642264784,1,46,46,1361582544656,1361582544656,642238440,642238440,0
1361582699,2004078360,12,6151,512.5833333,1361582672367,1361582672687,2004051727,2004052047,320
1361582699,2004078360,9,861,95.66666667,1361582672814,1361582673006,2004052174,2004052366,192
1361582699,2004078368,9,861,95.66666667,1361582673126,1361582673254,2004052494,2004052622,128
1361582699,2004078368,9,861,95.66666667,1361582673384,1361582673576,2004052752,2004052944,192
1361582699,2004078432,1,46,46,1361582672230,1361582672230,2004051662,2004051662,0
1361582770,2004150200,3,450,150,1361582742821,1361582748837,2004123021,2004129037,6016
1361582929,2004309004,2,126,63,1361582926182,1361582927206,2004306186,2004307210,1024
1361582937,2004317020,2,126,63,1361582929175,1361582933207,2004309195,2004313227,4032
1361582967,2004346368,1,63,63,1361582941923,1361582941923,2004321291,2004321291,0
1361582977,2004357084,3,189,63,1361582972760,1361582975832,2004352844,2004355916,3072
1361582985,2004365124,3,189,63,1361582980014,1361582983086,2004360138,2004363210,3072
1361582993,2004373140,2,126,63,1361582979809,1361582987809,2004359949,2004367949,8000
1361583001,2004381092,2,126,63,1361582987152,1361582995152,2004367244,2004375244,8000
1361583106,2004485208,4,252,63,1361583097409,1361583104513,2004476617,2004483721,7104
1361583139,2004518624,1,63,63,1361583112095,1361583112095,2004491719,2004491719,0
1361583384,2004763432,3,450,150,1361583355867,1361583361947,2004735299,2004741379,6080
1361583746,2005125704,16,6372,398.25,1361583728904,1361583738568,2005108608,2005118272,9664
1361583746,2005125708,11,953,86.63636364,1361583729539,1361583738499,2005109247,2005118207,8960
1361583746,2005125712,12,999,83.25,1361583729857,1361583738497,2005109569,2005118209,8640
1361583746,2005125744,12,999,83.25,1361583729249,1361583738465,2005108993,2005118209,9216
1361583998,2005377256,3,450,150,1361583971074,1361583977154,2005350330,2005356410,6080
1361584102,2005481400,1,46,46,1361584077620,1361584077620,2005457020,2005457020,0
1361584106,2005485344,1,46,46,1361584077994,1361584077994,2005457338,2005457338,0
1361584242,2005621412,1,46,46,1361584214627,1361584214627,2005594039,2005594039,0
1361585493,2006872360,1,446,446,1361585464899,1361585464899,2006844259,2006844259,0
1361585561,2006940512,13,6234,479.5384615,1361585533612,1361585533932,2006913124,2006913444,320
1361585561,2006940532,8,815,101.875,1361585534295,1361585534487,2006913827,2006914019,192
1361585561,2006940616,9,861,95.66666667,1361585533891,1361585534147,2006913507,2006913763,256
1361585749,2007128344,3,189,63,1361585745743,1361585748751,2007125087,2007128095,3008
1361585749,2007128380,3,189,63,1361585745389,1361585748461,2007124769,2007127841,3072
1361585765,2007144328,2,126,63,1361585752547,1361585760611,2007131875,2007139939,8064
1361585765,2007144368,2,126,63,1361585752762,1361585760826,2007132130,2007140194,8064
1361585837,2007216380,2,126,63,1361585835499,1361585836523,2007214879,2007215903,1024
1361585845,2007224384,2,126,63,1361585838503,1361585842535,2007217887,2007221919,4032
1361585871,645564596,6,634,105.6666667,1361585866784,1361585866848,645560380,645560444,64
1361585878,2007257556,1,63,63,1361585850428,1361585850428,2007229984,2007229984,0
1361585982,2007361576,1,46,46,1361585957221,1361585957221,2007336797,2007336797,0
1361586101,2007480584,1,48,48,1361586070619,1361586070619,2007450203,2007450203,0
1361586138,2007518064,9,861,95.66666667,1361586112444,1361586112636,2007492508,2007492700,192
1361586138,2007518068,9,861,95.66666667,1361586112697,1361586112889,2007492765,2007492957,192
1361586138,2007518088,8,815,101.875,1361586112996,1361586113124,2007493084,2007493212,128
1361586138,2007518140,13,6234,479.5384615,1361586111982,1361586112302,2007492122,2007492442,320
1361586333,2007712592,2,126,63,1361586330895,1361586331919,2007710487,2007711511,1024
1361586333,2007712636,2,126,63,1361586330789,1361586331749,2007710425,2007711385,960
1361586341,2007720636,2,126,63,1361586333796,1361586337828,2007713432,2007717464,4032
1361586341,2007720636,2,126,63,1361586333859,1361586337891,2007713495,2007717527,4032
1361586365,2007744636,4,252,63,1361586357477,1361586364517,2007737113,2007744153,7040
1361586371,2007750828,1,63,63,1361586345699,1361586345699,2007725527,2007725527,0
1361586371,2007750908,1,63,63,1361586345682,1361586345682,2007725590,2007725590,0
1361586399,2007778860,1,63,63,1361586372357,1361586372357,2007752217,2007752217,0
1361586429,2007808636,3,189,63,1361586422372,1361586425380,2007802008,2007805016,3008
1361586445,2007824688,2,126,63,1361586429421,1361586437421,2007809109,2007817109,8000
1361586471,2007850932,1,46,46,1361586445305,1361586445305,2007825237,2007825237,0
1361587686,2009066060,13,6234,479.5384615,1361587657704,1361587658024,2009037764,2009038084,320
1361587686,2009066064,9,861,95.66666667,1361587658084,1361587658276,2009038148,2009038340,192
1361587686,2009066072,8,815,101.875,1361587658653,1361587658781,2009038725,2009038853,128
1361587686,2009066152,9,861,95.66666667,1361587658250,1361587658442,2009038402,2009038594,192
1361587847,2009226256,3,189,63,1361587841931,1361587845003,2009221187,2009224259,3072
1361587863,2009242296,2,126,63,1361587848994,1361587856994,2009228290,2009236290,8000
1361587919,2009298296,2,126,63,1361587916383,1361587917407,2009295679,2009296703,1024
1361587927,2009306332,2,126,63,1361587919357,1361587923389,2009298689,2009302721,4032
1361587927,2009306348,3,189,63,1361587922798,1361587925806,2009302146,2009305154,3008
1361587927,2009306348,3,189,63,1361587922861,1361587925869,2009302209,2009305217,3008
1361587943,2009322332,2,126,63,1361587929851,1361587937915,2009309183,2009317247,8064
1361587943,2009322396,2,126,63,1361587929853,1361587937917,2009309249,2009317313,8064
1361587955,2009334984,1,63,63,1361587930801,1361587930801,2009310785,2009310785,0
1361589041,2010420908,1,64,64,1361589016491,1361589016491,2010396399,2010396399,0
1361589464,2010843480,12,999,83.25,1361589448657,1361589458961,2010828137,2010838441,10304
1361589464,2010843484,18,6979,387.7222222,1361589447885,1361589458893,2010827369,2010838377,11008
1361589464,2010843484,11,953,86.63636364,1361589448909,1361589458957,2010828393,2010838441,10048
1361589464,2010843520,17,6755,397.3529412,1361589448234,1361589458922,2010827754,2010838442,10688
1361589464,2010843556,11,953,86.63636364,1361589449093,1361589458885,2010828649,2010838441,9792
1361590087,2011466904,9,861,95.66666667,1361590062625,1361590062753,2011442529,2011442657,128
1361590087,2011466972,13,6234,479.5384615,1361590062172,1361590062492,2011442144,2011442464,320
1361590091,2011470828,9,861,95.66666667,1361590062956,1361590063148,2011442784,2011442976,192
1361590091,2011470832,8,815,101.875,1361590063207,1361590063399,2011443039,2011443231,192
1361590281,2011660240,3,189,63,1361590275059,1361590278067,2011654299,2011657307,3008
1361590297,2011676280,2,126,63,1361590282059,1361590290123,2011661339,2011669403,8064
1361590329,2011708332,3,189,63,1361590322649,1361590325721,2011701981,2011705053,3072
1361590340,2011719992,1,46,46,1361590313283,1361590313283,2011693275,2011693275,0
1361590345,2011724492,2,126,63,1361590329592,1361590337592,2011709084,2011717084,8000
1361590361,2011740328,2,126,63,1361590359706,1361590360730,2011739034,2011740058,1024
1361590361,2011740376,2,126,63,1361590359725,1361590360749,2011739101,2011740125,1024
1361590369,2011748284,2,126,63,1361590362760,1361590366856,2011742044,2011746140,4096
1361590369,2011748284,2,126,63,1361590362886,1361590366918,2011742170,2011746202,4032
1361590400,2011779300,1,63,63,1361590374837,1361590374837,2011754137,2011754137,0
1361590400,2011779372,1,63,63,1361590374830,1361590374830,2011754202,2011754202,0
1361591866,2013246032,12,999,83.25,1361591853187,1361591863235,2013233219,2013243267,10048
1361591866,2013246080,12,999,83.25,1361591852884,1361591863188,2013232964,2013243268,10304
1361591866,2013246084,11,953,86.63636364,1361591853459,1361591863187,2013233543,2013243271,9728
1361591879,2013258188,1,60,60,1361591852946,1361591852946,2013232134,2013232134,0
1361591883,2013262252,1,46,46,1361591856591,1361591856591,2013235843,2013235843,0
1361592276,2013655940,1,48,48,1361592247324,1361592247324,2013627264,2013627264,0
1361592276,2013655940,1,48,48,1361592247324,1361592247324,2013627264,2013627264,0
1361592276,2013655940,1,48,48,1361592247323,1361592247323,2013627263,2013627263,0
1361592447,2013826244,1,48,48,1361592417041,1361592417041,2013796285,2013796285,0
1361593502,2014881412,1,46,46,1361593474392,1361593474392,2014853804,2014853804,0
1361593678,2015057840,13,6234,479.5384615,1361593651498,1361593651818,2015031338,2015031658,320
1361593678,2015057852,9,861,95.66666667,1361593651868,1361593652060,2015031720,2015031912,192
1361593678,2015057880,9,861,95.66666667,1361593652097,1361593652289,2015031977,2015032169,192
1361593678,2015057884,9,861,95.66666667,1361593652413,1361593652541,2015032297,2015032425,128
1361593836,2015215364,2,126,63,1361593833604,1361593834628,2015212968,2015213992,1024
1361593844,2015223384,2,126,63,1361593836592,1361593840624,2015215976,2015220008,4032
1361593875,2015254388,1,63,63,1361593848684,1361593848684,2015228072,2015228072,0
1361593908,2015287344,3,189,63,1361593903127,1361593906135,2015282471,2015285479,3008
1361593924,2015303412,2,126,63,1361593910097,1361593918161,2015289509,2015297573,8064
1361593940,2015319440,3,189,63,1361593933112,1361593936120,2015312552,2015315560,3008
1361593956,2015335428,3,189,63,1361593949760,1361593952832,2015329188,2015332260,3072
1361593956,2015335456,2,126,63,1361593940136,1361593948200,2015319592,2015327656,8064
1361593972,2015351472,2,126,63,1361593956823,1361593964823,2015336295,2015344295,8000
1361594268,2015647412,1,46,46,1361594241678,1361594241678,2015621090,2015621090,0
1361595461,2016840572,17,6755,397.3529412,1361595442781,1361595453725,2016822353,2016833297,10944
1361595461,2016840576,12,999,83.25,1361595443160,1361595453720,2016822736,2016833296,10560
1361595461,2016840576,11,953,86.63636364,1361595443416,1361595453720,2016822992,2016833296,10304
1361595919,2017298232,1,48,48,1361595888680,1361595888680,2017267912,2017267912,0
1361596333,2017712744,1,60,60,1361596307044,1361596307044,2017686788,2017686788,0
1361596369,2017748972,1,60,60,1361596344253,1361596344253,2017724225,2017724225,0
1361597255,2018634420,12,999,83.25,1361597243802,1361597254106,2018623222,2018633526,10304
1361597255,2018634420,12,999,83.25,1361597244056,1361597254104,2018623476,2018633524,10048
1361597255,2018634432,14,4789,342.0714286,1361597242059,1361597254155,2018621491,2018633587,12096
1361597255,2018634460,12,999,83.25,1361597243504,1361597254064,2018622964,2018633524,10560
1361597530,2018909388,1,48,48,1361597503219,1361597503219,2018882607,2018882607,0
1361597965,2019344564,1,46,46,1361597938684,1361597938684,2019318248,2019318248,0
1361599067,2020446388,13,6234,479.5384615,1361599042139,1361599042459,2020421527,2020421847,320
1361599067,2020446460,8,815,101.875,1361599042453,1361599042645,2020421913,2020422105,192
1361599067,2020446464,9,861,95.66666667,1361599042769,1361599042897,2020422233,2020422361,128
1361599071,2020450364,8,815,101.875,1361599043125,1361599043317,2020422489,2020422681,192
1361599232,2020611908,2,126,63,1361599229458,1361599230482,2020609366,2020610390,1024
1361599232,2020611940,3,189,63,1361599227633,1361599230641,2020607573,2020610581,3008
1361599240,2020619916,2,126,63,1361599232459,1361599236491,2020612375,2020616407,4032
1361599248,2020627952,2,126,63,1361599234662,1361599242726,2020614614,2020622678,8064
1361599271,2020650552,1,63,63,1361599244919,1361599244919,2020624471,2020624471,0
1361599280,2020659932,3,189,63,1361599273338,1361599276346,2020653270,2020656278,3008
1361599280,2020659980,3,189,63,1361599273163,1361599276235,2020653143,2020656215,3072
1361599296,2020675920,2,126,63,1361599280327,1361599288327,2020660247,2020668247,8000
1361599296,2020675956,2,126,63,1361599280353,1361599288417,2020660309,2020668373,8064
1361600850,2022229900,12,999,83.25,1361600833666,1361600843778,2022213566,2022223678,10112
1361600850,2022229916,12,999,83.25,1361600833075,1361600843827,2022212991,2022223743,10752
1361600850,2022229940,12,999,83.25,1361600833308,1361600843804,2022213248,2022223744,10496
1361600850,2022229952,17,6755,397.3529412,1361600832655,1361600843791,2022212607,2022223743,11136
1361601566,2022945932,1,46,46,1361601540824,1361601540824,2022920756,2022920756,0
1361601694,2023074032,1,78,78,1361601669299,1361601669299,2023049331,2023049331,0
1361602657,2024036312,14,6617,472.6428571,1361602632753,1361602633073,2024012065,2024012385,320
1361602661,2024040260,9,861,95.66666667,1361602633192,1361602633320,2024012452,2024012580,128
1361602661,2024040284,9,861,95.66666667,1361602633423,1361602633615,2024012707,2024012899,192
1361602868,2024247756,11,953,86.63636364,1361602851253,1361602863349,2024231009,2024243105,12096
1361602868,2024247756,11,953,86.63636364,1361602851508,1361602863348,2024231264,2024243104,11840
1361602868,2024247780,11,953,86.63636364,1361602851997,1361602863261,2024231777,2024243041,11264
1361602868,2024247792,12,999,83.25,1361602851728,1361602863248,2024231520,2024243040,11520
1361602876,2024255812,2,126,63,1361602870013,1361602871037,2024249825,2024250849,1024
1361602897,2024276596,1,63,63,1361602870229,1361602870229,2024249825,2024249825,0
1361602924,2024303812,3,189,63,1361602918010,1361602921082,2024297822,2024300894,3072
1361602940,2024319808,2,126,63,1361602925053,1361602933117,2024304861,2024312925,8064
1361603166,2024545536,1,46,46,1361603140940,1361603140940,2024520476,2024520476,0
1361603491,2024870312,1,56,56,1361603463013,1361603463013,2024842325,2024842325,0
1361603979,2025358964,2,122,61,1361603953555,1361603955603,2025333519,2025335567,2048
1361604670,2026049168,11,953,86.63636364,1361604661479,1361604669031,2026040647,2026048199,7552
1361605615,2026994708,3,162,54,1361605589115,1361605595067,2026968823,2026974775,5952
1361606092,2027471652,1,46,46,1361606066986,1361606066986,2027446638,2027446638,0
1361606096,2027475672,1,46,46,1361606070103,1361606070103,2027449775,2027449775,0
1361606489,2027868284,9,861,95.66666667,1361606462549,1361606462741,2027841833,2027842025,192
1361606489,2027868432,13,6234,479.5384615,1361606461760,1361606462080,2027841192,2027841512,320
1361606489,2027868440,9,861,95.66666667,1361606462135,1361606462327,2027841575,2027841767,192
1361606489,2027868448,9,861,95.66666667,1361606462706,1361606462834,2027842154,2027842282,128
1361606687,2028066476,3,189,63,1361606683090,1361606686098,2028062566,2028065574,3008
1361606703,2028082516,2,126,63,1361606690091,1361606698155,2028069607,2028077671,8064
1361606735,2028114508,2,126,63,1361606733875,1361606734899,2028113383,2028114407,1024
1361606743,2028122524,2,126,63,1361606736930,1361606740962,2028116454,2028120486,4032
1361606775,2028154564,2,126,63,1361606772410,1361606773434,2028151974,2028152998,1024
1361606777,2028156448,1,63,63,1361606749038,1361606749038,2028128486,2028128486,0
1361606783,2028162536,2,126,63,1361606775509,1361606779541,2028155045,2028159077,4032
1361606783,2028162584,3,189,63,1361606779751,1361606782759,2028159335,2028162343,3008
1361606799,2028178572,2,126,63,1361606786802,1361606794866,2028166374,2028174438,8064
1361606813,2028192380,1,63,63,1361606787698,1361606787698,2028167078,2028167078,0
1361607217,2028597000,5,320,64,1361607191295,1361607195263,2028571295,2028575263,3968
1361607217,2028597004,7,448,64,1361607190201,1361607197177,2028570205,2028577181,6976
1361607217,2028597016,5,320,64,1361607192431,1361607196399,2028572447,2028576415,3968
1361607217,2028597016,5,320,64,1361607192431,1361607196399,2028572447,2028576415,3968
1361607359,2028738900,12,999,83.25,1361607347744,1361607358432,2028727644,2028738332,10688
1361607359,2028738932,16,6372,398.25,1361607347329,1361607358401,2028727261,2028738333,11072
1361607359,2028738932,11,953,86.63636364,1361607348031,1361607358399,2028727963,2028738331,10368
1361607422,2028801964,1,48,48,1361607395614,1361607395614,2028775578,2028775578,0
1361607847,2029226608,8,496,62,1361607821183,1361607833087,2029200791,2029212695,11904
1361608220,2029599644,1,48,48,1361608191890,1361608191890,2029571534,2029571534,0
1361608244,2029623636,1,46,46,1361608218076,1361608218076,2029597712,2029597712,0
1361609030,2030409264,8,496,62,1361609002371,1361609016003,2030381635,2030395267,13632
1361609122,2030501648,3,152,50.66666667,1361609097409,1361609106881,2030477057,2030486529,9472
1361609174,2030553596,12,6151,512.5833333,1361609146486,1361609146806,2030526082,2030526402,320
1361609174,2030553600,8,815,101.875,1361609146866,1361609147058,2030526466,2030526658,192
1361609174,2030553600,9,861,95.66666667,1361609147185,1361609147313,2030526785,2030526913,128
1361609174,2030553604,9,861,95.66666667,1361609147438,1361609147630,2030527042,2030527234,192
1361609242,2030621624,2,96,48,1361609216854,1361609220182,2030596478,2030599806,3328
1361609352,2030732104,4,2481,620.25,1361609350517,1361609350709,2030730621,2030730813,192
1361609353,2030732152,4,824,206,1361609351789,1361609351981,2030730941,2030731133,192
1361609349,669042892,2,112,56,1361609350034,1361609350034,669043926,669043926,0
1361609357,669050336,4,971,242.75,1361609354881,1361609355265,669048217,669048601,384
1361609357,669050340,4,478,119.5,1361609355964,1361609356028,669049304,669049368,64
1361609357,669050340,4,478,119.5,1361609351611,1361609351611,669044951,669044951,0
1361609360,2030740092,10,1994,199.4,1361609358273,1361609358465,2030738365,2030738557,192
1361609360,2030740096,11,3598,327.0909091,1361609358464,1361609358656,2030738560,2030738752,192
1361609360,2030740096,9,1942,215.7777778,1361609358654,1361609358846,2030738750,2030738942,192
1361609360,2030740100,10,1994,199.4,1361609355450,1361609355642,2030735550,2030735742,192
1361609360,2030740100,8,2386,298.25,1361609355832,1361609355960,2030735932,2030736060,128
1361609360,2030740104,10,2482,248.2,1361609355956,1361609356084,2030736060,2030736188,128
1361609360,2030740104,11,3307,300.6363636,1361609351540,1361609359284,2030731644,2030739388,7744
1361609360,2030740104,8,1890,236.25,1361609356343,1361609356407,2030736447,2030736511,64
1361609360,2030740104,8,1890,236.25,1361609356406,1361609356470,2030736510,2030736574,64
1361609360,2030740104,10,1994,199.4,1361609356790,1361609356982,2030736894,2030737086,192
1361609360,2030740104,8,2378,297.25,1361609357109,1361609357237,2030737213,2030737341,128
1361609360,2030740104,8,2506,313.25,1361609356725,1361609356789,2030736829,2030736893,64
1361609360,2030740108,10,4818,481.8,1361609357555,1361609357683,2030737663,2030737791,128
1361609360,2030740108,8,2394,299.25,1361609357683,1361609357811,2030737791,2030737919,128
1361609360,2030740108,10,3026,302.6,1361609357811,1361609358003,2030737919,2030738111,192
1361609361,2030740128,9,3246,360.6666667,1361609358981,1361609359109,2030738109,2030738237,128
1361609361,2030740128,10,1994,199.4,1361609359108,1361609359236,2030738236,2030738364,128
1361609361,2030740132,8,1890,236.25,1361609355584,1361609355712,2030734716,2030734844,128
1361609361,2030740136,8,2378,297.25,1361609355711,1361609355775,2030734847,2030734911,64
1361609361,2030740136,11,2054,186.7272727,1361609359806,1361609359998,2030738942,2030739134,192
1361609361,2030740136,8,1424,178,1361609353917,1361609354301,2030733053,2030733437,384
1361609361,2030740136,7,2878,411.1428571,1361609356285,1361609356349,2030735421,2030735485,64
1361609361,2030740136,8,2634,329.25,1361609356348,1361609356412,2030735484,2030735548,64
1361609361,2030740140,10,2818,281.8,1361609356667,1361609356795,2030735807,2030735935,128
1361609361,2030740140,8,2698,337.25,1361609356603,1361609356667,2030735743,2030735807,64
1361609361,2030740140,10,1994,199.4,1361609357177,1361609357305,2030736317,2030736445,128
1361609361,2030740140,8,1890,236.25,1361609357048,1361609357176,2030736188,2030736316,128
1361609361,2030740144,8,1890,236.25,1361609357431,1361609357559,2030736575,2030736703,128
1361609361,2030740144,8,1890,236.25,1361609357559,1361609357623,2030736703,2030736767,64
1361609361,2030740144,8,2386,298.25,1361609357622,1361609357686,2030736766,2030736830,64
1361609361,2030740144,8,2746,343.25,1361609357941,1361609358069,2030737085,2030737213,128
1361609361,2030740144,10,1994,199.4,1361609358196,1361609358324,2030737340,2030737468,128
1361609361,2030740144,10,1994,199.4,1361609358324,1361609358516,2030737468,2030737660,192
1361609365,669058340,5,527,105.4,1361609363770,1361609363834,669057110,669057174,64
1361609368,2030748112,3,189,63,1361609363502,1361609366574,2030743614,2030746686,3072
1361609369,2030748152,8,2021,252.625,1361609363246,1361609363438,2030742398,2030742590,192
1361609369,2030748160,7,1401,200.1428571,1361609362278,1361609362982,2030741438,2030742142,704
1361609373,669066340,2,859,429.5,1361609350654,1361609365630,669043994,669058970,14976
1361609377,2030756132,10,3068,306.8,1361609360515,1361609375811,2030739647,2030754943,15296
1361609384,2030764100,5,1275,255,1361609359353,1361609376057,2030739453,2030756157,16704
1361609385,2030764136,2,126,63,1361609371583,1361609379583,2030750719,2030758719,8000
1361609385,2030764136,7,1925,275,1361609363965,1361609379325,2030743101,2030758461,15360
1361609390,2030769860,1,108,108,1361609361960,1361609361960,2030741820,2030741820,0
1361609390,2030769860,1,108,108,1361609362024,1361609362024,2030741884,2030741884,0
1361609390,2030769916,1,108,108,1361609362034,1361609362034,2030741950,2030741950,0
1361609405,669098352,5,527,105.4,1361609402353,1361609402417,669095705,669095769,64
1361609409,2030788128,18595,27869125,1498.742942,1361609364295,1361609401735,2030743423,2030780863,37440
1361609413,669106360,4,478,119.5,1361609412648,1361609412712,669106008,669106072,64
1361609414,2030794016,1,46,46,1361609386124,1361609386124,2030766140,2030766140,0
1361609417,2030796984,2,92,46,1361609413804,1361609413804,2030793788,2030793788,0
1361609421,669114356,4,478,119.5,1361609415658,1361609415722,669109014,669109078,64
1361609433,2030812160,2,126,63,1361609430566,1361609431590,2030809726,2030810750,1024
1361609438,2030818064,1,52,52,1361609413662,1361609413662,2030793726,2030793726,0
1361609441,2030820176,2,126,63,1361609433557,1361609437589,2030812733,2030816765,4032
1361609441,669134908,1,52,52,1361609413763,1361609413763,669107671,669107671,0
1361609470,2030850072,1,63,63,1361609444758,1361609444758,2030824830,2030824830,0
1361609553,2030932188,3,189,63,1361609548614,1361609551622,2030927802,2030930810,3008
1361609553,2030932220,3,189,63,1361609548518,1361609551590,2030927738,2030930810,3072
1361609569,2030948252,2,126,63,1361609555592,1361609563592,2030934844,2030942844,8000
1361609569,2030948252,2,126,63,1361609555592,1361609563656,2030934844,2030942908,8064
1361609831,2031211028,3,570,190,1361609805753,1361609811769,2031185781,2031191797,6016
1361610060,2031439592,9,861,95.66666667,1361610033003,1361610033195,2031412595,2031412787,192
1361610060,2031439592,1,46,46,1361610031979,1361610031979,2031411571,2031411571,0
1361610060,2031439604,9,861,95.66666667,1361610032673,1361610032865,2031412277,2031412469,192
1361610060,2031439648,14,6617,472.6428571,1361610031986,1361610032242,2031411634,2031411890,256
1361610060,2031439652,9,861,95.66666667,1361610032367,1361610032559,2031412019,2031412211,192
1361610273,2031652760,2,126,63,1361610270848,1361610271872,2031650608,2031651632,1024
1361610281,2031660716,2,126,63,1361610273966,1361610277998,2031653682,2031657714,4032
1361610313,2031692280,1,63,63,1361610286433,1361610286433,2031665713,2031665713,0
1361610361,2031740764,3,189,63,1361610356537,1361610359545,2031736301,2031739309,3008
1361610361,2031740800,3,189,63,1361610355797,1361610358805,2031735597,2031738605,3008
1361610377,2031756740,2,126,63,1361610363602,1361610371666,2031743342,2031751406,8064
1361610377,2031756776,2,126,63,1361610362862,1361610370926,2031742638,2031750702,8064
1361610401,2031780772,4,252,63,1361610392819,1361610399923,2031772591,2031779695,7104
1361610433,2031812700,1,63,63,1361610407993,1361610407993,2031787693,2031787693,0
1361610762,2032141544,3,447,149,1361610734481,1361610740497,2032114025,2032120041,6016
1361611400,2032779480,3,447,149,1361611374793,1361611380809,2032754273,2032760289,6016
1361611674,2033053676,47,57193,1216.87234,1361611664959,1361611670527,2033044635,2033050203,5568
1361611692,2033071748,9,861,95.66666667,1361611666487,1361611666679,2033046235,2033046427,192
1361611692,2033071752,9,861,95.66666667,1361611666737,1361611666929,2033046489,2033046681,192
1361611692,2033071780,14,6617,472.6428571,1361611665814,1361611666134,2033045594,2033045914,320
1361611692,2033071788,9,861,95.66666667,1361611666191,1361611666383,2033045979,2033046171,192
1361611906,2033286088,3,189,63,1361611899038,1361611902046,2033279126,2033282134,3008
1361611922,2033302056,2,126,63,1361611906110,1361611914174,2033286166,2033294230,8064
1361611922,2033302084,3,189,63,1361611917602,1361611920674,2033297686,2033300758,3072
1361611930,2033310096,3,189,63,1361611923478,1361611926486,2033303574,2033306582,3008
1361611938,2033318048,2,126,63,1361611924744,1361611932744,2033304792,2033312792,8000
1361611946,2033326024,2,126,63,1361611930589,1361611938653,2033310613,2033318677,8064
1361611962,2033342056,3,189,63,1361611957440,1361611960448,2033337496,2033340504,3008
1361611965,2033344444,2,96,48,1361611940834,1361611943778,2033320278,2033323222,2944
1361611969,2033348440,2,96,48,1361611941927,1361611944871,2033321367,2033324311,2944
1361611969,2033348444,2,96,48,1361611943009,1361611945953,2033322453,2033325397,2944
1361611969,2033348508,2,96,48,1361611942945,1361611945889,2033322453,2033325397,2944
1361611978,2033358040,2,126,63,1361611964494,1361611972558,2033344534,2033352598,8064
1361612205,2033584596,1,46,46,1361612176968,1361612176968,2033556564,2033556564,0
1361612576,2033955888,1,46,46,1361612548317,1361612548317,2033928205,2033928205,0
1361612576,2033955892,1,46,46,1361612548313,1361612548313,2033928205,2033928205,0
1361613123,2034502376,14,6617,472.6428571,1361613098517,1361613098837,2034477893,2034478213,320
1361613127,2034506336,9,861,95.66666667,1361613098940,1361613099132,2034478276,2034478468,192
1361613127,2034506340,9,861,95.66666667,1361613099194,1361613099386,2034478534,2034478726,192
1361613340,2034719232,2,126,63,1361613338274,1361613339298,2034717506,2034718530,1024
1361613348,2034727220,2,126,63,1361613341357,1361613345389,2034720577,2034724609,4032
1361613379,2034758976,1,63,63,1361613352698,1361613352698,2034732674,2034732674,0
1361613420,2034799204,3,189,63,1361613416379,1361613419387,2034795583,2034798591,3008
1361613452,2034831268,9,861,95.66666667,1361613425084,1361613425276,2034804352,2034804544,192
1361613452,2034831268,8,815,101.875,1361613425402,1361613425530,2034804670,2034804798,128
1361613452,2034831272,8,815,101.875,1361613425657,1361613425849,2034804929,2034805121,192
1361613516,2034895524,4,252,63,1361613508602,1361613515706,2034888126,2034895230,7104
1361613552,2034931332,1,63,63,1361613523900,1361613523900,2034903232,2034903232,0
1361613636,2035015520,3,189,63,1361613632638,1361613635710,2035012158,2035015230,3072
1361613652,2035031512,3,189,63,1361613648645,1361613651717,2035028157,2035031229,3072
1361613652,2035031548,2,126,63,1361613639713,1361613647777,2035019261,2035027325,8064
1361613668,2035047528,3,138,46,1361613660468,1361613660532,2035039996,2035040060,64
1361613668,2035047540,5,264,52.8,1361613655721,1361613660521,2035035261,2035040061,4800
1361613668,2035047544,4,201,50.25,1361613660451,1361613660515,2035039995,2035040059,64
1361613688,2035067492,14,6280,448.5714286,1361613663320,1361613663640,2035042812,2035043132,320
1361613688,2035067492,9,861,95.66666667,1361613663703,1361613663895,2035043195,2035043387,192
1361613692,2035071436,9,861,95.66666667,1361613664016,1361613664208,2035043452,2035043644,192
1361613932,2035311860,3,189,63,1361613925156,1361613928228,2035305016,2035308088,3072
1361613948,2035327876,2,126,63,1361613932244,1361613940244,2035312120,2035320120,8000
1361613980,2035359968,3,189,63,1361613973241,1361613976313,2035353209,2035356281,3072
1361613984,2035363632,14,6617,472.6428571,1361613957001,1361613957257,2035336633,2035336889,256
1361613984,2035363636,9,861,95.66666667,1361613957894,1361613958086,2035337530,2035337722,192
1361613984,2035363672,9,861,95.66666667,1361613957281,1361613957473,2035336953,2035337145,192
1361613984,2035363672,9,861,95.66666667,1361613957536,1361613957792,2035337208,2035337464,256
1361613996,2035375928,2,126,63,1361613980384,1361613988384,2035360312,2035368312,8000
1361614084,2035464020,3,189,63,1361614079427,1361614082435,2035459447,2035462455,3008
1361614100,2035480060,2,126,63,1361614086425,1361614094489,2035466485,2035474549,8064
1361614216,2035595908,4,252,63,1361614203314,1361614210354,2035583222,2035590262,7040
1361614237,2035616160,4,252,63,1361614228189,1361614235293,2035607349,2035614453,7104
1361614244,2035623972,1,63,63,1361614218351,1361614218351,2035598323,2035598323,0
1361614253,2035632116,2,126,63,1361614250503,1361614251527,2035629619,2035630643,1024
1361614261,2035640128,2,126,63,1361614253564,1361614257596,2035632692,2035636724,4032
1361614261,2035640160,2,126,63,1361614259675,1361614260635,2035638835,2035639795,960
1361614268,2035648028,1,63,63,1361614242425,1361614242425,2035622453,2035622453,0
1361614269,2035648108,2,126,63,1361614262736,1361614266768,2035641844,2035645876,4032
1361614293,2035672264,1,63,63,1361614265523,1361614265523,2035644787,2035644787,0
1361614301,2035680244,1,63,63,1361614274697,1361614274697,2035653941,2035653941,0
1361615238,2036618004,14,6617,472.6428571,1361615211200,1361615211520,2036591204,2036591524,320
1361615238,2036618008,8,815,101.875,1361615211837,1361615212029,2036591845,2036592037,192
1361615238,2036618008,9,861,95.66666667,1361615211580,1361615211772,2036591588,2036591780,192
1361615238,2036618012,9,861,95.66666667,1361615212091,1361615212283,2036592103,2036592295,192
1361615437,2036816748,4,252,63,1361615428413,1361615435517,2036808161,2036815265,7104
1361615461,2036840748,3,189,63,1361615454078,1361615457086,2036833826,2036836834,3008
1361615461,2036840788,3,189,63,1361615454038,1361615457046,2036833826,2036836834,3008
1361615471,2036850928,1,63,63,1361615443337,1361615443337,2036823265,2036823265,0
1361615477,2036856756,2,126,63,1361615461109,1361615469173,2036840865,2036848929,8064
1361615477,2036856768,2,126,63,1361615461097,1361615469161,2036840865,2036848929,8064
1361615525,2036904820,4,252,63,1361615516980,1361615524020,2036896800,2036903840,7040
1361615559,2036938932,1,63,63,1361615531972,1361615531972,2036911904,2036911904,0
1361615632,2037011308,2,96,48,1361615606002,1361615608946,2036985310,2036988254,2944
1361615656,2037035376,2,96,48,1361615631149,1361615634093,2037010525,2037013469,2944
1361615800,2037179716,1,60,60,1361615772376,1361615772376,2037152092,2037152092,0
1361616037,2037416564,1,46,46,1361616010669,1361616010669,2037390233,2037390233,0
1361617014,2038393800,11,953,86.63636364,1361617003826,1361617013426,2038383626,2038393226,9600
1361617014,2038393800,12,999,83.25,1361617004082,1361617013426,2038383882,2038393226,9344
1361617014,2038393804,12,999,83.25,1361617004336,1361617013360,2038384140,2038393164,9024
1361617016,2038395340,17,6755,397.3529412,1361617003902,1361617013886,2038383242,2038393226,9984
1361617188,2038567884,1,46,46,1361617160734,1361617160734,2038540618,2038540618,0
1361617783,2039162468,1,48,48,1361617757556,1361617757556,2039137024,2039137024,0
1361618607,2039986792,9,861,95.66666667,1361618581793,1361618581985,2039961585,2039961777,192
1361618607,2039986796,8,815,101.875,1361618582047,1361618582239,2039961843,2039962035,192
1361618607,2039986796,8,815,101.875,1361618582366,1361618582558,2039962162,2039962354,192
1361618607,2039986832,13,6234,479.5384615,1361618581371,1361618581691,2039961203,2039961523,320
1361618751,2040130872,5,250,50,1361618724688,1361618746960,2040104560,2040126832,22272
1361618799,2040178980,1,48,48,1361618771362,1361618771362,2040151342,2040151342,0
1361618827,2040207016,1,48,48,1361618800509,1361618800509,2040180525,2040180525,0
1361618840,2040219548,3,189,63,1361618834580,1361618837588,2040214128,2040217136,3008
1361618840,2040219556,3,189,63,1361618834570,1361618837578,2040214126,2040217134,3008
1361618840,2040219556,3,189,63,1361618834570,1361618837578,2040214126,2040217134,3008
1361618856,2040235512,2,126,63,1361618841653,1361618849717,2040221165,2040229229,8064
1361618856,2040235516,2,126,63,1361618841648,1361618849712,2040221164,2040229228,8064
1361618856,2040235524,2,126,63,1361618841643,1361618849707,2040221167,2040229231,8064
1361618928,2040307532,4,252,63,1361618920354,1361618927458,2040299886,2040306990,7104
1361618960,2040339440,1,63,63,1361618935548,1361618935548,2040314988,2040314988,0
1361619064,2040443488,1,46,46,1361619036170,1361619036170,2040415658,2040415658,0
1361619415,679108204,4,1448,362,1361619413702,1361619413766,679106906,679106970,64
1361619415,679108204,5,451,90.2,1361619412996,1361619413828,679106200,679107032,832
1361619417,2040796148,5,1257,251.4,1361619414170,1361619414362,2040793318,2040793510,192
1361619417,2040796148,8,3492,436.5,1361619414361,1361619415001,2040793509,2040794149,640
1361619417,2040796148,8,3137,392.125,1361619410905,1361619412121,2040790053,2040791269,1216
1361619417,2040796152,11,3294,299.4545455,1361619415254,1361619416022,2040794406,2040795174,768
1361619417,2040796156,6,983,163.8333333,1361619416016,1361619416336,2040795172,2040795492,320
1361619417,2040796156,6,798,133,1361619416340,1361619416596,2040795496,2040795752,256
1361619417,2040796160,7,1966,280.8571429,1361619414414,1361619414862,2040793574,2040794022,448
1361619417,2040796160,5,2106,421.2,1361619410894,1361619411662,2040790054,2040790822,768
1361619417,2040796160,9,2064,229.3333333,1361619411725,1361619412237,2040790885,2040791397,512
1361619417,2040796196,7,1460,208.5714286,1361619416168,1361619416808,2040795364,2040796004,640
1361619423,679116204,5,451,90.2,1361619416711,1361619416839,679109915,679110043,128
1361619423,679116204,5,2109,421.8,1361619418181,1361619418181,679111385,679111385,0
1361619423,679116208,5,451,90.2,1361619419330,1361619420418,679112538,679113626,1088
1361619425,2040804144,11,2017,183.3636364,1361619417117,1361619418909,2040796261,2040798053,1792
1361619425,2040804148,11,2017,183.3636364,1361619421404,1361619422748,2040800552,2040801896,1344
1361619425,2040804152,5,609,121.8,1361619422679,1361619423127,2040801831,2040802279,448
1361619425,2040804152,11,2017,183.3636364,1361619423254,1361619424214,2040802406,2040803366,960
1361619425,2040804152,5,609,121.8,1361619419157,1361619419477,2040798309,2040798629,320
1361619425,2040804156,9,3035,337.2222222,1361619416657,1361619417553,2040795813,2040796709,896
1361619425,2040804156,11,2017,183.3636364,1361619420945,1361619422353,2040800101,2040801509,1408
1361619425,2040804164,4,724,181,1361619419274,1361619419466,2040798438,2040798630,192
1361619425,2040804188,9,1925,213.8888889,1361619424052,1361619424756,2040803240,2040803944,704
1361619431,679124204,5,451,90.2,1361619423047,1361619423815,679116251,679117019,768
1361619431,679124204,5,451,90.2,1361619425414,1361619425542,679118618,679118746,128
1361619431,679124204,4,445,111.25,1361619429699,1361619429827,679122903,679123031,128
1361619431,679124204,4,445,111.25,1361619429827,1361619429955,679123031,679123159,128
1361619431,679124204,4,445,111.25,1361619429955,1361619430147,679123159,679123351,192
1361619431,679124208,5,451,90.2,1361619427203,1361619427843,679120411,679121051,640
1361619433,2040812188,14,5071,362.2142857,1361619425841,1361619426609,2040805029,2040805797,768
1361619433,2040812192,5,609,121.8,1361619426798,1361619427246,2040805990,2040806438,448
1361619433,2040812192,14,5071,362.2142857,1361619427309,1361619427949,2040806501,2040807141,640
1361619433,2040812196,9,1913,212.5555556,1361619428330,1361619429162,2040807526,2040808358,832
1361619433,2040812196,11,2017,183.3636364,1361619424682,1361619425706,2040803878,2040804902,1024
1361619433,2040812200,2,92,46,1361619424872,1361619424872,2040804072,2040804072,0
1361619433,2040812200,5,609,121.8,1361619425191,1361619425511,2040804391,2040804711,320
1361619433,2040812200,5,609,121.8,1361619429095,1361619429607,2040808295,2040808807,512
1361619433,2040812204,12,4927,410.5833333,1361619429792,1361619430368,2040808996,2040809572,576
1361619433,2040812204,17,8469,498.1764706,1361619426211,1361619426915,2040805415,2040806119,704
1361619433,2040812204,14,4839,345.6428571,1361619430753,1361619431393,2040809957,2040810597,640
1361619433,2040812228,11,2017,183.3636364,1361619428105,1361619428745,2040807333,2040807973,640
1361619436,2040816056,2,216,108,1361619409871,1361619409999,2040789927,2040790055,128
1361619436,2040816056,2,216,108,1361619409998,1361619410062,2040790054,2040790118,64
1361619436,2040816056,2,216,108,1361619409741,1361619409869,2040789797,2040789925,128
1361619439,679132204,4,1448,362,1361619437382,1361619437446,679130586,679130650,64
1361619441,2040820172,10,1877,187.7,1361619433090,1361619434114,2040812262,2040813286,1024
1361619441,2040820176,9,3310,367.7777778,1361619437567,1361619439551,2040816743,2040818727,1984
1361619441,2040820176,11,2017,183.3636364,1361619435388,1361619436028,2040814564,2040815204,640
1361619441,2040820184,10,3397,339.7,1361619439540,1361619440756,2040818724,2040819940,1216
1361619441,2040820188,11,2017,183.3636364,1361619434227,1361619434931,2040813415,2040814119,704
1361619441,2040820212,9,2849,316.5555556,1361619436507,1361619437019,2040815719,2040816231,512
1361619445,2040824120,7,1877,268.1428571,1361619419576,1361619420344,2040798696,2040799464,768
1361619449,2040828176,4,715,178.75,1361619441981,1361619442173,2040821157,2040821349,192
1361619449,2040828180,11,3096,281.4545455,1361619442363,1361619443131,2040821543,2040822311,768
1361619449,2040828188,14,7501,535.7857143,1361619443185,1361619444145,2040822373,2040823333,960
1361619613,2040992208,1,46,46,1361619586075,1361619586075,2040965283,2040965283,0
1361620398,2041777452,15,6834,455.6,1361620371869,1361620372125,2041751321,2041751577,256
1361620398,2041777456,8,815,101.875,1361620373142,1361620373334,2041752598,2041752790,192
1361620398,2041777492,14,6617,472.6428571,1361620372211,1361620372467,2041751703,2041751959,256
1361620398,2041777492,9,861,95.66666667,1361620372530,1361620372722,2041752022,2041752214,192
1361620398,2041777496,9,861,95.66666667,1361620372845,1361620372973,2041752341,2041752469,128
1361620474,2041853652,1,46,46,1361620447506,1361620447506,2041827158,2041827158,0
1361620634,2042013252,4,252,63,1361620625887,1361620632991,2042005139,2042012243,7104
1361620634,2042013284,4,252,63,1361620625854,1361620632958,2042005138,2042012242,7104
1361620658,2042037308,3,189,63,1361620654503,1361620657575,2042033811,2042036883,3072
1361620666,2042045936,1,63,63,1361620640307,1361620640307,2042020243,2042020243,0
1361620666,2042045972,1,63,63,1361620640271,1361620640271,2042020243,2042020243,0
1361620674,2042053364,2,126,63,1361620661550,1361620669614,2042040914,2042048978,8064
1361620690,2042069372,3,189,63,1361620685158,1361620688230,2042064530,2042067602,3072
1361620706,2042085360,2,126,63,1361620692209,1361620700273,2042071569,2042079633,8064
1361620706,2042085968,3,144,48,1361620679250,1361620688210,2042059218,2042068178,8960
1361620714,2042093356,2,126,63,1361620711096,1361620712120,2042090452,2042091476,1024
1361620722,2042101360,2,126,63,1361620714097,1361620718129,2042093457,2042097489,4032
1361620751,2042130384,1,63,63,1361620726170,1361620726170,2042105554,2042105554,0
1361621276,2042655724,1,46,46,1361621251519,1361621251519,2042631243,2042631243,0
1361621284,2042663752,1,46,46,1361621258592,1361621258592,2042638344,2042638344,0
1361621581,2042960088,1,46,46,1361621554998,1361621554998,2042934086,2042934086,0
1361622179,2043558172,12,999,83.25,1361622163034,1361622174490,2043542206,2043553662,11456
1361622179,2043558184,12,999,83.25,1361622163341,1361622174477,2043542525,2043553661,11136
1361622179,2043558184,17,6755,397.3529412,1361622162381,1361622174477,2043541565,2043553661,12096
1361622179,2043558184,12,999,83.25,1361622162763,1361622174475,2043541947,2043553659,11712
1361623079,2044458784,13,6234,479.5384615,1361623051816,1361623052136,2044431600,2044431920,320
1361623079,2044458788,8,815,101.875,1361623052517,1361623052645,2044432305,2044432433,128
1361623079,2044458788,8,815,101.875,1361623052771,1361623052963,2044432559,2044432751,192
1361623079,2044458824,9,861,95.66666667,1361623052160,1361623052352,2044431984,2044432176,192
1361623283,2044663068,3,189,63,1361623276808,1361623279816,2044656876,2044659884,3008
1361623284,2044663076,3,189,63,1361623277673,1361623280681,2044656749,2044659757,3008
1361623300,2044679084,2,126,63,1361623284833,1361623292897,2044663917,2044671981,8064
1361623300,2044679096,2,126,63,1361623284693,1361623292757,2044663789,2044671853,8064
1361623308,2044687104,3,189,63,1361623302090,1361623305098,2044681194,2044684202,3008
1361623324,2044703120,2,126,63,1361623309117,1361623317181,2044688237,2044696301,8064
1361623436,2044815220,4,252,63,1361623428567,1361623435607,2044807787,2044814827,7040
1361623468,2044847896,1,63,63,1361623442994,1361623442994,2044822890,2044822890,0
1361624286,2045665528,1,95,95,1361624261589,1361624261589,2045641117,2045641117,0
1361624518,2045897696,1,46,46,1361624490473,1361624490473,2045870169,2045870169,0
1361624867,2046246736,14,6617,472.6428571,1361624842557,1361624842877,2046222293,2046222613,320
1361624871,2046250700,9,861,95.66666667,1361624843233,1361624843425,2046222933,2046223125,192
1361624871,2046250712,9,861,95.66666667,1361624842963,1361624843155,2046222675,2046222867,192
1361624871,2046250740,9,861,95.66666667,1361624843448,1361624843640,2046223188,2046223380,192
1361625061,2046440848,2,126,63,1361625059467,1361625060491,2046439315,2046440339,1024
1361625069,2046448836,2,126,63,1361625062550,1361625066582,2046442386,2046446418,4032
1361625100,2046479212,1,63,63,1361625075203,1361625075203,2046454415,2046454415,0
1361625128,2046507404,1,48,48,1361625103302,1361625103302,2046482706,2046482706,0
1361625149,2046528944,3,189,63,1361625143657,1361625146729,2046523601,2046526673,3072
1361625165,2046544980,2,126,63,1361625150723,1361625158723,2046530703,2046538703,8000
1361625181,2046560980,3,189,63,1361625174852,1361625177924,2046554832,2046557904,3072
1361625188,2046567472,3,152,50.66666667,1361625162816,1361625171840,2046542288,2046551312,9024
1361625197,2046576984,2,126,63,1361625181886,1361625189950,2046561870,2046569934,8064
1361625237,2046617024,4,252,63,1361625229206,1361625236310,2046609230,2046616334,7104
1361625272,2046651860,1,63,63,1361625244476,1361625244476,2046624336,2046624336,0
1361626542,2047921972,12,999,83.25,1361626528565,1361626538293,2047908537,2047918265,9728
1361626542,2047921976,16,6372,398.25,1361626528117,1361626538357,2047908093,2047918333,10240
1361626571,2047950832,9,861,95.66666667,1361626545409,1361626545537,2047925241,2047925369,128
1361626571,2047950832,8,815,101.875,1361626545667,1361626545795,2047925499,2047925627,128
1361626571,2047950832,8,815,101.875,1361626545922,1361626546050,2047925754,2047925882,128
1361626571,2047950836,9,861,95.66666667,1361626546176,1361626546368,2047926012,2047926204,192
1361626783,2048162104,2,126,63,1361626781783,1361626782807,2048160887,2048161911,1024
1361626787,2048167020,8,496,62,1361626759429,1361626771269,2048139449,2048151289,11840
1361626791,2048170100,2,126,63,1361626784857,1361626788889,2048163957,2048167989,4032
1361626807,2048186104,3,189,63,1361626802713,1361626805721,2048181817,2048184825,3008
1361626823,2048202128,2,126,63,1361626809727,1361626817791,2048188855,2048196919,8064
1361626824,2048203200,1,63,63,1361626796791,1361626796791,2048175991,2048175991,0
1361626871,2048250136,3,189,63,1361626866484,1361626869492,2048245620,2048248628,3008
1361626887,2048266172,2,126,63,1361626873492,1361626881556,2048252664,2048260728,8064
1361626892,2048271580,1,46,46,1361626867579,1361626867579,2048247159,2048247159,0
1361626892,2048271940,1,46,46,1361626867090,1361626867090,2048247030,2048247030,0
1361626893,2048272388,1,46,46,1361626867642,1361626867642,2048247030,2048247030,0
1361626943,2048322172,3,189,63,1361626937746,1361626940754,2048316918,2048319926,3008
1361626959,2048338172,2,126,63,1361626944847,1361626952847,2048324019,2048332019,8000
1361627289,2048668140,1,46,46,1361627263723,1361627263723,2048642863,2048642863,0
1361627401,2048780432,8,496,62,1361627374213,1361627386053,2048753645,2048765485,11840
1361627778,2049157664,1,46,46,1361627752986,1361627752986,2049132650,2049132650,0
1361627778,2049157704,1,46,46,1361627753010,1361627753010,2049132714,2049132714,0
1361627779,2049158136,1,46,46,1361627753513,1361627753513,2049132649,2049132649,0
1361628002,2049381348,8,496,62,1361627976466,1361627988626,2049355814,2049367974,12160
1361628294,2049674056,8,496,62,1361628266312,1361628277832,2049646368,2049657888,11520
1361628363,2049742484,13,6234,479.5384615,1361628338434,1361628338754,2049717918,2049718238,320
1361628363,2049742488,9,861,95.66666667,1361628338816,1361628339008,2049718304,2049718496,192
1361628367,2049746440,8,815,101.875,1361628339119,1361628339311,2049718559,2049718751,192
1361628367,2049746440,9,861,95.66666667,1361628339374,1361628339566,2049718814,2049719006,192
1361628560,2049939132,3,189,63,1361628556385,1361628559457,2049935517,2049938589,3072
1361628576,2049955136,2,126,63,1361628563484,1361628571484,2049942620,2049950620,8000
1361628608,2049987168,3,189,63,1361628601787,1361628604795,2049980955,2049983963,3008
1361628608,2049987168,3,189,63,1361628601787,1361628604859,2049980955,2049984027,3072
1361628624,2050003188,2,126,63,1361628608873,1361628616873,2049988061,2049996061,8000
1361628624,2050003196,2,126,63,1361628608798,1361628616798,2049987994,2049995994,8000
1361628680,2050059212,3,189,63,1361628673872,1361628676944,2050053084,2050056156,3072
1361628692,2050071356,3,152,50.66666667,1361628664447,1361628673407,2050043803,2050052763,8960
1361628696,2050075220,2,126,63,1361628680968,1361628688968,2050060188,2050068188,8000
1361630035,2051414992,1,46,46,1361630008944,1361630008944,2051388936,2051388936,0
1361630129,2051508488,12,999,83.25,1361630117925,1361630128869,2051497413,2051508357,10944
1361630129,2051508528,12,999,83.25,1361630118204,1361630128828,2051497732,2051508356,10624
1361630129,2051508532,12,999,83.25,1361630118459,1361630128827,2051497991,2051508359,10368
1361630228,2051607740,3,152,50.66666667,1361630201577,1361630210601,2051581317,2051590341,9024
1361631034,2052413720,9,861,95.66666667,1361631007536,1361631007728,2052387256,2052387448,192
1361631034,2052413720,9,861,95.66666667,1361631007855,1361631008047,2052387575,2052387767,192
1361631034,2052413756,13,6234,479.5384615,1361631006859,1361631007179,2052386615,2052386935,320
1361631034,2052413760,8,815,101.875,1361631007241,1361631007433,2052387001,2052387193,192
1361631274,2052653812,3,189,63,1361631270288,1361631273296,2052650100,2052653108,3008
1361631290,2052669860,2,126,63,1361631277278,1361631285342,2052657138,2052665202,8064
1361631338,2052717820,3,189,63,1361631332808,1361631335880,2052712628,2052715700,3072
1361631354,2052733836,2,126,63,1361631339830,1361631347894,2052719666,2052727730,8064
1361631410,2052790008,4,252,63,1361631401481,1361631408521,2052781489,2052788529,7040
1361631411,2052790044,4,252,63,1361631402445,1361631409485,2052781489,2052788529,7040
1361631443,2052822284,1,63,63,1361631417309,1361631417309,2052796593,2052796593,0
1361631443,2052822284,1,63,63,1361631417308,1361631417308,2052796592,2052796592,0
1361631774,2053153100,1,48,48,1361631745233,1361631745233,2053124333,2053124333,0
1361631774,2053153108,1,48,48,1361631745224,1361631745224,2053124332,2053124332,0
1361631775,2053154284,1,48,48,1361631744983,1361631744983,2053124267,2053124267,0
1361632112,2053491664,1,46,46,1361632087703,1361632087703,2053467367,2053467367,0
1361632374,2053753424,1,48,48,1361632345346,1361632345346,2053724770,2053724770,0
1361632374,2053753468,1,48,48,1361632345304,1361632345304,2053724772,2053724772,0
1361632375,2053754756,1,48,48,1361632345017,1361632345017,2053724773,2053724773,0
1361632417,2053796132,3,152,50.66666667,1361632389800,1361632398696,2053768932,2053777828,8896
1361632826,2054205336,14,6617,472.6428571,1361632798868,1361632799188,2054178204,2054178524,320
1361632826,2054205340,9,861,95.66666667,1361632799248,1361632799440,2054178588,2054178780,192
1361632826,2054205372,8,815,101.875,1361632799471,1361632799663,2054178843,2054179035,192
1361632826,2054205376,9,861,95.66666667,1361632799725,1361632799917,2054179101,2054179293,192
1361632826,2054205380,2,96,48,1361632801191,1361632804071,2054180571,2054183451,2880
1361633012,2054391592,2,126,63,1361633010514,1361633011538,2054390106,2054391130,1024
1361633020,2054399580,2,126,63,1361633013534,1361633017566,2054393114,2054397146,4032
1361633050,2054429536,1,63,63,1361633025675,1361633025675,2054405211,2054405211,0
1361633068,2054447568,3,189,63,1361633062184,1361633065192,2054441752,2054444760,3008
1361633084,2054463628,2,126,63,1361633069229,1361633077229,2054448857,2054456857,8000
1361633092,2054471596,3,189,63,1361633088075,1361633091083,2054467671,2054470679,3008
1361633092,2054471616,3,189,63,1361633088056,1361633091064,2054467672,2054470680,3008
1361633108,2054487612,2,126,63,1361633095099,1361633103163,2054474711,2054482775,8064
1361633108,2054487648,2,126,63,1361633095065,1361633103129,2054474713,2054482777,8064
1361633294,2054673808,9,861,95.66666667,1361633268277,1361633268469,2054648085,2054648277,192
1361633294,2054673820,9,861,95.66666667,1361633267435,1361633267691,2054647255,2054647511,256
1361633294,2054673824,8,815,101.875,1361633267750,1361633267942,2054647574,2054647766,192
1361633294,2054673844,9,861,95.66666667,1361633267984,1361633268176,2054647828,2054648020,192
1361633524,2054903828,3,189,63,1361633520862,1361633523934,2054900690,2054903762,3072
1361633540,2054919824,2,126,63,1361633527971,1361633536035,2054907795,2054915859,8064
1361633580,2054959872,3,189,63,1361633573298,1361633576306,2054953170,2054956178,3008
1361633580,2054959908,3,189,63,1361633573262,1361633576334,2054953170,2054956242,3072
1361633596,2054975888,2,126,63,1361633580386,1361633588386,2054960274,2054968274,8000
1361633596,2054975888,2,126,63,1361633580322,1361633588386,2054960210,2054968274,8064
1361633607,2054986728,1,46,46,1361633579457,1361633579457,2054959185,2054959185,0
1361633611,2054990684,1,46,46,1361633583662,1361633583662,2054963346,2054963346,0
1361633700,2055080000,4,252,63,1361633692145,1361633699249,2055072145,2055079249,7104
1361633719,2055099020,3,138,46,1361633694044,1361633695004,2055074064,2055075024,960
1361633735,2055115032,1,63,63,1361633707281,1361633707281,2055087313,2055087313,0
1361635083,2056462360,15,6832,455.4666667,1361635056987,1361635057243,2056436347,2056436603,256
1361635083,2056462360,9,861,95.66666667,1361635058010,1361635058202,2056437370,2056437562,192
1361635083,2056462388,8,815,101.875,1361635058239,1361635058431,2056437627,2056437819,192
1361635083,2056462404,13,6234,479.5384615,1361635057326,1361635057582,2056436730,2056436986,256
1361635083,2056462408,9,861,95.66666667,1361635057705,1361635057897,2056437113,2056437305,192
1361635261,2056640716,4,252,63,1361635252146,1361635259250,2056631862,2056638966,7104
1361635269,2056648704,3,189,63,1361635263232,1361635266240,2056642936,2056645944,3008
1361635285,2056664724,2,126,63,1361635270253,1361635278317,2056649977,2056658041,8064
1361635295,2056674864,1,63,63,1361635267103,1361635267103,2056646967,2056646967,0
1361635309,2056688852,4,252,63,1361635301805,1361635308845,2056681657,2056688697,7040
1361635325,2056704792,2,126,63,1361635323621,1361635324645,2056703413,2056704437,1024
1361635325,2056704800,3,189,63,1361635319391,1361635322399,2056699191,2056702199,3008
1361635333,2056712848,2,126,63,1361635326640,1361635330672,2056706488,2056710520,4032
1361635341,2056720828,2,126,63,1361635326404,1361635334468,2056706232,2056714296,8064
1361635344,2056723056,1,63,63,1361635317702,1361635317702,2056696758,2056696758,0
1361635364,2056743128,1,63,63,1361635339390,1361635339390,2056718518,2056718518,0
1361636763,2058142276,9,861,95.66666667,1361636737876,1361636738068,2058117152,2058117344,192
1361636763,2058142280,9,861,95.66666667,1361636738449,1361636738577,2058117729,2058117857,128
1361636763,2058142300,8,815,101.875,1361636738173,1361636738301,2058117473,2058117601,128
1361636891,2058270392,1,56,56,1361636865631,1361636865631,2058245023,2058245023,0
1361637007,2058386076,2,126,63,1361637004827,1361637005787,2058383903,2058384863,960
1361637015,2058394076,2,126,63,1361637007835,1361637011867,2058386911,2058390943,4032
1361637047,2058426672,1,63,63,1361637019334,1361637019334,2058399006,2058399006,0
1361637055,2058434072,3,189,63,1361637049309,1361637052317,2058428381,2058431389,3008
1361637055,2058434108,3,189,63,1361637049209,1361637052281,2058428317,2058431389,3072
1361637071,2058450056,2,126,63,1361637056366,1361637064366,2058435422,2058443422,8000
1361637071,2058450056,2,126,63,1361637056366,1361637064430,2058435422,2058443486,8064
1361637095,2058474108,11,953,86.63636364,1361637084729,1361637093177,2058463837,2058472285,8448
1361637095,2058474108,12,999,83.25,1361637084984,1361637093176,2058464092,2058472284,8192
1361638504,2059883708,12,999,83.25,1361638496332,1361638503756,2059876040,2059883464,7424
1361638899,2060278384,3,450,150,1361638873033,1361638879113,2060252417,2060258497,6080
1361639532,2060911528,1,56,56,1361639504176,1361639504176,2060883704,2060883704,0
1361639576,2060955504,3,152,50.66666667,1361639549321,1361639558345,2060928825,2060937849,9024
1361639913,2061292120,1,99,99,1361639886210,1361639886210,2061265330,2061265330,0
1361639945,2061324152,1,70,70,1361639917027,1361639917027,2061296179,2061296179,0
1361640133,2061512364,1,95,95,1361640105484,1361640105484,2061484848,2061484848,0
1361640257,2061636460,3,447,149,1361640231978,1361640238122,2061611438,2061617582,6144
1361640317,2061696484,13,6234,479.5384615,1361640291600,1361640291920,2061671084,2061671404,320
1361640317,2061696508,8,815,101.875,1361640292534,1361640292726,2061672042,2061672234,192
1361640317,2061696508,9,861,95.66666667,1361640292214,1361640292406,2061671722,2061671914,192
1361640317,2061696552,9,861,95.66666667,1361640291915,1361640292107,2061671467,2061671659,192
1361640530,2061909608,3,189,63,1361640523151,1361640526223,2061902759,2061905831,3072
1361640546,2061925600,2,126,63,1361640530200,1361640538264,2061909800,2061917864,8064
1361640554,2061933656,3,189,63,1361640548960,1361640551968,2061928616,2061931624,3008
1361640570,2061949668,2,126,63,1361640555987,1361640564051,2061935655,2061943719,8064
1361640578,2061957652,4,252,63,1361640569763,1361640576867,2061949415,2061956519,7104
1361640578,2061957656,4,252,63,1361640569824,1361640576928,2061949480,2061956584,7104
1361640609,2061988980,1,63,63,1361640584539,1361640584539,2061964519,2061964519,0
1361640610,2061989024,1,63,63,1361640585558,1361640585558,2061964582,2061964582,0
1361640878,2062257284,3,447,149,1361640850001,1361640856081,2062229285,2062235365,6080
1361641488,2062867108,3,450,150,1361641462392,1361641468408,2062841500,2062847516,6016
1361641788,2063167912,1,60,60,1361641760719,1361641760719,2063140631,2063140631,0
1361641800,2063179844,1,60,60,1361641774291,1361641774291,2063154135,2063154135,0
1361641979,2063358764,12,999,83.25,1361641968608,1361641978720,2063348372,2063358484,10112
1361641979,2063358768,12,999,83.25,1361641968857,1361641978713,2063348625,2063358481,9856
1361641979,2063358768,12,999,83.25,1361641969116,1361641978716,2063348884,2063358484,9600
1361642125,2063504084,3,450,150,1361642099973,1361642106053,2063479057,2063485137,6080
1361642229,2063608192,1,46,46,1361642203737,1361642203737,2063582929,2063582929,0
1361642229,2063608280,1,46,46,1361642203327,1361642203327,2063582607,2063582607,0
1361642461,2063840540,1,442,442,1361642436663,1361642436663,2063816203,2063816203,0
1361642465,2063844492,1,442,442,1361642439977,1361642439977,2063819469,2063819469,0
1361642473,2063852608,1,443,443,1361642447346,1361642447346,2063826954,2063826954,0
1361642738,2064117312,3,450,150,1361642711319,1361642717399,2064090631,2064096711,6080
1361642876,2064255324,11,953,86.63636364,1361642858891,1361642868939,2064238215,2064248263,10048
1361642876,2064255356,12,999,83.25,1361642858282,1361642868906,2064237638,2064248262,10624
1361642876,2064255360,12,999,83.25,1361642858532,1361642868900,2064237892,2064248260,10368
1361643348,2064727072,3,450,150,1361643323838,1361643329854,2064702910,2064708926,6016
1361643656,2065035612,2,92,46,1361643628446,1361643631454,2065008058,2065011066,3008
1361643960,2065339872,3,450,150,1361643935316,1361643941332,2065315188,2065321204,6016
1361644097,2065476644,1,46,46,1361644071415,1361644071415,2065451059,2065451059,0
1361644097,2065476644,1,46,46,1361644071415,1361644071415,2065451059,2065451059,0
1361644293,2065672920,1,46,46,1361644266720,1361644266720,2065646640,2065646640,0
1361644293,2065672920,1,46,46,1361644266719,1361644266719,2065646639,2065646639,0
1361644293,2065672956,1,46,46,1361644266813,1361644266813,2065646769,2065646769,0
1361644389,2065768564,6,298,49.66666667,1361644361285,1361644382853,2065740849,2065762417,21568
1361644427,2065806192,1,46,46,1361644397750,1361644397750,2065776942,2065776942,0
1361644433,2065812660,1,48,48,1361644407202,1361644407202,2065786862,2065786862,0
1361644461,2065840800,1,48,48,1361644436501,1361644436501,2065816301,2065816301,0
1361644505,2065884832,1,46,46,1361644479220,1361644479220,2065859052,2065859052,0
1361644545,2065924972,8,496,62,1361644517288,1361644529256,2065897260,2065909228,11968
1361644574,2065953056,3,450,150,1361644547834,1361644553850,2065926890,2065932906,6016
1361644614,2065993096,14,6617,472.6428571,1361644588114,1361644588434,2065967210,2065967530,320
1361644614,2065993100,9,861,95.66666667,1361644588496,1361644588688,2065967596,2065967788,192
1361644838,2066217392,3,189,63,1361644831400,1361644834408,2066210792,2066213800,3008
1361644854,2066233404,2,126,63,1361644838429,1361644846493,2066217833,2066225897,8064
1361644862,2066241392,7,390,55.71428571,1361644853672,1361644858856,2066233064,2066238248,5184
1361644862,2066241396,4,201,50.25,1361644858725,1361644858789,2066238121,2066238185,64
1361644886,2066265924,9,861,95.66666667,1361644859922,1361644860114,2066239846,2066240038,192
1361644886,2066265928,8,815,101.875,1361644860175,1361644860367,2066240103,2066240295,192
1361644886,2066265928,8,815,101.875,1361644860430,1361644860622,2066240358,2066240550,192
1361644886,2066266000,9,861,95.66666667,1361644860616,1361644860808,2066240616,2066240808,192
1361644971,2066350012,1,60,60,1361644945508,1361644945508,2066324520,2066324520,0
1361644975,2066354072,1,60,60,1361644950631,1361644950631,2066329703,2066329703,0
1361644991,2066370332,1,60,60,1361644964002,1361644964002,2066343334,2066343334,0
1361645094,2066473536,3,189,63,1361645090514,1361645093522,2066470050,2066473058,3008
1361645110,2066489572,2,126,63,1361645097521,1361645105585,2066477093,2066485157,8064
1361645134,2066513596,4,252,63,1361645124887,1361645131991,2066504483,2066511587,7104
1361645142,2066521588,2,126,63,1361645139105,1361645140129,2066518693,2066519717,1024
1361645150,2066529612,2,126,63,1361645142088,1361645146120,2066521700,2066525732,4032
1361645167,2066546900,1,63,63,1361645139688,1361645139688,2066519588,2066519588,0
1361645179,2066558920,1,63,63,1361645153874,1361645153874,2066533794,2066533794,0
1361645187,2066566868,3,450,150,1361645159302,1361645165318,2066539170,2066545186,6016
1361645246,2066625700,2,126,63,1361645242860,1361645243884,2066622560,2066623584,1024
1361645254,2066633608,2,126,63,1361645245962,1361645249994,2066625570,2066629602,4032
1361645284,2066663056,1,440,440,1361645257328,1361645257328,2066636384,2066636384,0
1361645284,2066663092,1,63,63,1361645258572,1361645258572,2066637664,2066637664,0
1361645288,2066667100,1,444,444,1361645261766,1361645261766,2066640866,2066640866,0
1361645392,2066771368,1,71,71,1361645366134,1361645366134,2066745502,2066745502,0
1361645500,2066879368,1,71,71,1361645472180,1361645472180,2066851548,2066851548,0
1361645524,2066903504,1,71,71,1361645496429,1361645496429,2066875933,2066875933,0
1361645796,2067175720,3,450,150,1361645771153,1361645777169,2067150873,2067156889,6016
1361646071,2067450372,11,953,86.63636364,1361646053544,1361646064040,2067432916,2067443412,10496
1361646071,2067450376,12,999,83.25,1361646053862,1361646064038,2067433238,2067443414,10176
1361646071,2067450412,17,6755,397.3529412,1361646053122,1361646064002,2067432534,2067443414,10880
1361646189,2067568044,1,46,46,1361646163376,1361646163376,2067542420,2067542420,0
1361646409,2067788200,3,450,150,1361646383569,1361646389649,2067762769,2067768849,6080
1361646679,2068058880,16,6372,398.25,1361646663397,1361646674789,2068043277,2068054669,11392
1361646679,2068058884,12,999,83.25,1361646663777,1361646674785,2068043661,2068054669,11008
1361646679,2068058888,11,953,86.63636364,1361646664094,1361646674782,2068043982,2068054670,10688
1361646679,2068058948,12,999,83.25,1361646664290,1361646674658,2068044238,2068054606,10368
1361646701,706394744,16,18752,1172,1361646686876,1361646698844,706380620,706392588,11968
1361646701,706394748,7,4808,686.8571429,1361646686870,1361646698902,706380618,706392650,12032
1361646703,2068082976,15,5538,369.2,1361646686726,1361646698758,2068066702,2068078734,12032
1361646733,2068112592,1,46,46,1361646707715,1361646707715,2068087307,2068087307,0
1361646813,2068192772,12,6151,512.5833333,1361646788301,1361646788685,2068168073,2068168457,384
1361646813,2068192780,9,861,95.66666667,1361646788743,1361646788935,2068168523,2068168715,192
1361646817,2068196744,9,861,95.66666667,1361646789035,1361646789227,2068168779,2068168971,192
1361646817,2068196748,8,815,101.875,1361646789285,1361646789477,2068169033,2068169225,192
1361646856,2068235024,11,953,86.63636364,1361646838713,1361646850489,2068217737,2068229513,11776
1361646856,2068235028,11,953,86.63636364,1361646838967,1361646850487,2068217995,2068229515,11520
1361646856,2068235068,12,999,83.25,1361646838351,1361646850511,2068217419,2068229579,12160
1361646856,2068235092,11,953,86.63636364,1361646839158,1361646850422,2068218250,2068229514,11264
1361647024,2068403180,2,126,63,1361647022746,1361647023770,2068401926,2068402950,1024
1361647032,2068411256,2,126,63,1361647025681,1361647029713,2068404937,2068408969,4032
1361647050,2068429848,1,46,46,1361647025472,1361647025472,2068405320,2068405320,0
1361647062,2068441564,1,63,63,1361647037465,1361647037465,2068417029,2068417029,0
1361647096,2068475228,3,189,63,1361647091307,1361647094379,2068470535,2068473607,3072
1361647096,2068475260,2,126,63,1361647094154,1361647095178,2068473414,2068474438,1024
1361647096,2068475300,2,126,63,1361647094049,1361647095073,2068473349,2068474373,1024
1361647104,2068483236,2,126,63,1361647097248,1361647101280,2068476484,2068480516,4032
1361647104,2068483240,2,126,63,1361647097180,1361647101212,2068476420,2068480452,4032
1361647112,2068491280,2,126,63,1361647098358,1361647106358,2068477638,2068485638,8000
1361647134,2068513652,1,63,63,1361647108929,1361647108929,2068488581,2068488581,0
1361647134,2068513656,1,63,63,1361647108799,1361647108799,2068488455,2068488455,0
1361647761,2069140064,12,999,83.25,1361647750149,1361647760069,2069129213,2069139133,9920
1361647761,2069140096,12,999,83.25,1361647749797,1361647760037,2069128893,2069139133,10240
1361647761,2069140120,11,953,86.63636364,1361647750347,1361647760011,2069129467,2069139131,9664
1361648137,2069516468,17,6418,377.5294118,1361648119466,1361648131562,2069498934,2069511030,12096
1361648137,2069516472,12,999,83.25,1361648119845,1361648131557,2069499317,2069511029,11712
1361648137,2069516512,12,999,83.25,1361648120063,1361648131519,2069499575,2069511031,11456
1361648140,2069519992,12,999,83.25,1361648119838,1361648131038,2069499830,2069511030,11200
1361648145,2069524484,18,9318,517.6666667,1361648138459,1361648138843,2069517943,2069518327,384
1361648153,2069532444,5,2327,465.4,1361648136513,1361648148481,2069515957,2069527925,11968
1361648185,2069564312,1,46,46,1361648159109,1361648159109,2069538421,2069538421,0
1361648289,2069668648,12,999,83.25,1361648276916,1361648288628,2069656564,2069668276,11712
1361648289,2069668656,11,953,86.63636364,1361648277486,1361648288622,2069657142,2069668278,11136
1361648289,2069668700,12,999,83.25,1361648277186,1361648288578,2069656886,2069668278,11392
1361648289,2069668732,8,5028,628.5,1361648275362,1361648287650,2069655094,2069667382,12288
1361648289,2069668736,16,6372,398.25,1361648276444,1361648288540,2069656180,2069668276,12096
1361648393,2069772652,3,152,50.66666667,1361648368816,1361648377776,2069748468,2069757428,8960
1361648441,2069820936,1,52,52,1361648414995,1361648414995,2069794931,2069794931,0
1361649115,2070494428,3,570,190,1361649090309,1361649096325,2070469737,2070475753,6016
1361649227,2070606684,1,95,95,1361649200900,1361649200900,2070580584,2070580584,0
1361649435,2070814944,3,174,58,1361649407675,1361649417083,2070787619,2070797027,9408
1361649544,2070923080,3,174,58,1361649519515,1361649528731,2070898595,2070907811,9216
1361649840,2071219392,3,174,58,1361649813279,1361649822751,2071192671,2071202143,9472
1361650401,2071780520,3,447,149,1361650374419,1361650380435,2071753939,2071759955,6016
1361650514,2071893660,1,48,48,1361650485830,1361650485830,2071865490,2071865490,0
1361650514,2071893700,1,48,48,1361650485853,1361650485853,2071865553,2071865553,0
1361650515,2071894784,1,48,48,1361650485707,1361650485707,2071865491,2071865491,0
1361651067,2072446316,3,447,149,1361651042007,1361651048023,2072421323,2072427339,6016
1361651680,2073059596,3,450,150,1361651654647,1361651660599,2073034243,2073040195,5952
1361652258,2073637684,1,48,48,1361652229846,1361652229846,2073609530,2073609530,0
1361652259,2073638900,1,48,48,1361652229629,1361652229629,2073609529,2073609529,0
1361652293,2073672360,3,450,150,1361652266776,1361652272856,2073646136,2073652216,6080
1361652473,2073852696,3,152,50.66666667,1361652447302,1361652456390,2073826998,2073836086,9088
1361652581,2073960752,2,120,60,1361652553548,1361652556556,2073933300,2073936308,3008
1361652846,2074225636,1,46,46,1361652820989,1361652820989,2074200625,2074200625,0
1361652906,2074285344,3,450,150,1361652879198,1361652885214,2074258542,2074264558,6016
1361653187,2074566872,1,46,46,1361653158604,1361653158604,2074538476,2074538476,0
1361653188,2074567648,1,46,46,1361653158892,1361653158892,2074538540,2074538540,0
1361653516,2074895084,3,450,150,1361653491418,1361653497434,2074870502,2074876518,6016
1361653592,2074971056,9,861,95.66666667,1361653567157,1361653567349,2074946213,2074946405,192
1361653592,2074971100,12,6151,512.5833333,1361653566089,1361653566473,2074945189,2074945573,384
1361653592,2074971184,9,861,95.66666667,1361653566451,1361653566643,2074945635,2074945827,192
1361653592,2074971208,9,861,95.66666667,1361653566748,1361653566940,2074945956,2074946148,192
1361653815,2075194472,3,189,63,1361653809939,1361653813011,2075189411,2075192483,3072
1361653831,2075210412,13,1045,80.38461538,1361653813644,1361653824780,2075193056,2075204192,11136
1361653831,2075210420,11,953,86.63636364,1361653814407,1361653824711,2075193827,2075204131,10304
1361653831,2075210440,12,999,83.25,1361653814705,1361653824689,2075194145,2075204129,9984
1361653831,2075210444,11,953,86.63636364,1361653814957,1361653824685,2075194401,2075204129,9728
1361653887,2075266456,3,189,63,1361653880416,1361653883488,2075259872,2075262944,3072
1361653903,2075282492,2,126,63,1361653887483,1361653895483,2075266975,2075274975,8000
1361653924,2075303892,1,63,63,1361653898733,1361653898733,2075278625,2075278625,0
1361653932,2075311696,1,63,63,1361653905840,1361653905840,2075285536,2075285536,0
1361654129,2075508568,3,450,150,1361654102444,1361654108460,2075482012,2075488028,6016
1361654425,2075804772,5,250,50,1361654399838,1361654421342,2075779610,2075801114,21504
1361654473,2075852796,1,48,48,1361654445508,1361654445508,2075825304,2075825304,0
1361654742,2076121412,3,450,150,1361654717694,1361654723774,2076097106,2076103186,6080
1361655355,2076734752,3,450,150,1361655329825,1361655335841,2076709577,2076715593,6016
1361655561,2076940428,44,57035,1296.25,1361655557986,1361655558370,2076937414,2076937798,384
1361655569,2076948328,11,953,86.63636364,1361655559814,1361655568902,2076939142,2076948230,9088
1361655569,2076948412,16,6709,419.3125,1361655559028,1361655568820,2076938440,2076948232,9792
1361655577,2076956348,12,999,83.25,1361655559539,1361655568947,2076938887,2076948295,9408
1361655595,2076974908,1,46,46,1361655568386,1361655568386,2076948294,2076948294,0
1361655596,2076974984,1,46,46,1361655569309,1361655569309,2076948293,2076948293,0
1361655968,2077347752,3,450,150,1361655941531,1361655947547,2077321283,2077327299,6016
1361656274,2077653408,1,46,46,1361656245483,1361656245483,2077624891,2077624891,0
1361656275,2077654644,1,46,46,1361656245186,1361656245186,2077624830,2077624830,0
1361656581,2077960692,3,450,150,1361656555853,1361656561869,2077935545,2077941561,6016
1361656999,2078377960,1,46,46,1361656971298,1361656971298,2078350258,2078350258,0
1361657199,2078578412,3,450,150,1361657171033,1361657177049,2078550445,2078556461,6016
1361657370,2078749956,12,999,83.25,1361657358199,1361657368695,2078738155,2078748651,10496
1361657370,2078749960,11,953,86.63636364,1361657358518,1361657368694,2078738478,2078748654,10176
1361657371,2078750000,12,999,83.25,1361657358901,1361657369653,2078737901,2078748653,10752
1361657403,2078782732,8,815,101.875,1361657376345,1361657376537,2078756077,2078756269,192
1361657403,2078782736,8,815,101.875,1361657376978,1361657377234,2078756714,2078756970,256
1361657403,2078782784,9,861,95.66666667,1361657375972,1361657376228,2078755756,2078756012,256
1361657403,2078782808,9,861,95.66666667,1361657376588,1361657376844,2078756396,2078756652,256
1361657467,2078846836,1,46,46,1361657441136,1361657441136,2078820972,2078820972,0
1361657636,2079015220,1,46,46,1361657609813,1361657609813,2078989033,2078989033,0
1361657659,2079038284,4,252,63,1361657651474,1361657658514,2079030758,2079037798,7040
1361657692,2079071200,1,63,63,1361657666662,1361657666662,2079045862,2079045862,0
1361657707,2079086480,4,252,63,1361657699536,1361657706640,2079079016,2079086120,7104
1361657707,2079086480,4,252,63,1361657699535,1361657706639,2079079015,2079086119,7104
1361657740,2079119248,1,63,63,1361657714869,1361657714869,2079094117,2079094117,0
1361657740,2079119332,1,63,63,1361657714786,1361657714786,2079094118,2079094118,0
1361657803,2079182336,3,189,63,1361657797533,1361657800541,2079176869,2079179877,3008
1361657812,2079191500,3,450,150,1361657785464,1361657791480,2079164964,2079170980,6016
1361657819,2079198380,2,126,63,1361657804531,1361657812595,2079183911,2079191975,8064
1361658425,2079804920,3,450,150,1361658398093,1361658404173,2079778013,2079784093,6080
1361658662,2080041252,1,46,46,1361658634470,1361658634470,2080013722,2080013722,0
1361658758,2080137468,1,46,46,1361658731402,1361658731402,2080110870,2080110870,0
1361659038,2080417760,3,450,150,1361659012772,1361659018788,2080392532,2080398548,6016
1361659194,2080573788,9,861,95.66666667,1361659167877,1361659168069,2080547665,2080547857,192
1361659194,2080573868,8,815,101.875,1361659168052,1361659168244,2080547920,2080548112,192
1361659194,2080573872,9,861,95.66666667,1361659168369,1361659168561,2080548241,2080548433,192
1361659267,2080646084,1,46,46,1361659239553,1361659239553,2080618637,2080618637,0
1361659452,2080831520,2,126,63,1361659449614,1361659450574,2080829134,2080830094,960
1361659452,2080831548,2,126,63,1361659449583,1361659450607,2080829131,2080830155,1024
1361659460,2080839504,2,126,63,1361659452637,1361659456669,2080832141,2080836173,4032
1361659460,2080839544,2,126,63,1361659452595,1361659456627,2080832139,2080836171,4032
1361659484,2080863520,3,189,63,1361659479628,1361659482636,2080859148,2080862156,3008
1361659491,2080870524,1,63,63,1361659464711,1361659464711,2080844235,2080844235,0
1361659491,2080870612,1,63,63,1361659464626,1361659464626,2080844238,2080844238,0
1361659500,2080879600,2,126,63,1361659486586,1361659494650,2080866186,2080874250,8064
1361659527,2080906616,9,861,95.66666667,1361659501994,1361659502186,2080881610,2080881802,192
1361659527,2080906696,14,6617,472.6428571,1361659501277,1361659501597,2080880973,2080881293,320
1361659527,2080906696,9,861,95.66666667,1361659501658,1361659501850,2080881354,2080881546,192
1361659652,2081031116,3,450,150,1361659626525,1361659632477,2081005641,2081011593,5952
1361659724,2081103912,4,184,46,1361659716160,1361659719168,2081096072,2081099080,3008
1361659724,2081103912,4,184,46,1361659716160,1361659719168,2081096072,2081099080,3008
1361659725,2081103960,4,235,58.75,1361659717114,1361659720122,2081096074,2081099082,3008
1361659744,2081123424,8,815,101.875,1361659719080,1361659719208,2081098504,2081098632,128
1361659744,2081123424,9,861,95.66666667,1361659718824,1361659718952,2081098248,2081098376,128
1361659744,2081123504,8,815,101.875,1361659719255,1361659719447,2081098759,2081098951,192
1361659744,2081123508,8,815,101.875,1361659719509,1361659719701,2081099017,2081099209,192
1361659941,2081320180,3,189,63,1361659935451,1361659938459,2081314631,2081317639,3008
1361659957,2081336228,2,126,63,1361659942439,1361659950503,2081321667,2081329731,8064
1361660013,2081392556,3,189,63,1361660008159,1361660011231,2081387715,2081390787,3072
1361660013,2081392556,3,189,63,1361660008095,1361660011167,2081387651,2081390723,3072
1361660013,2081392576,3,189,63,1361660008460,1361660011468,2081388036,2081391044,3008
1361660029,2081408484,2,126,63,1361660015270,1361660023334,2081394754,2081402818,8064
1361660029,2081408488,2,126,63,1361660015588,1361660023652,2081395076,2081403140,8064
1361660029,2081408544,2,126,63,1361660015210,1361660023274,2081394754,2081402818,8064
1361660266,2081645012,3,450,150,1361660238846,1361660244862,2081617858,2081623874,6016
1361660414,2081793372,1,46,46,1361660388881,1361660388881,2081768253,2081768253,0
1361660879,2082258300,3,450,150,1361660854739,1361660860755,2082234039,2082240055,6016
1361661040,2082419824,1,46,46,1361661012484,1361661012484,2082392308,2082392308,0
1361661042,2082421096,1,46,46,1361661013214,1361661013214,2082392310,2082392310,0
1361661276,2082655024,1,46,46,1361661250015,1361661250015,2082629039,2082629039,0
1361661302,2082681532,12,999,83.25,1361661288550,1361661298662,2082668082,2082678194,10112
1361661302,2082681572,12,999,83.25,1361661287997,1361661298685,2082667569,2082678257,10688
1361661302,2082681576,12,999,83.25,1361661288250,1361661298618,2082667826,2082678194,10368
1361661492,2082871784,3,450,150,1361661466406,1361661472422,2082846190,2082852206,6016
1361661617,2082996328,1,52,52,1361661589290,1361661589290,2082968618,2082968618,0
1361661617,2082996368,1,52,52,1361661589445,1361661589445,2082968813,2082968813,0
1361661677,2083056832,1,52,52,1361661651185,1361661651185,2083031017,2083031017,0
1361661678,2083057404,1,52,52,1361661651550,1361661651550,2083030954,2083030954,0
1361661765,2083144168,1,46,46,1361661737866,1361661737866,2083117034,2083117034,0
1361662106,2083485092,3,450,150,1361662079378,1361662085394,2083458470,2083464486,6016
1361662267,2083646524,1,46,46,1361662240480,1361662240480,2083620004,2083620004,0
1361662268,2083647328,1,46,46,1361662240675,1361662240675,2083620003,2083620003,0
1361662575,2083954044,3,144,48,1361662548859,1361662557819,2083927903,2083936863,8960
1361662719,2084098220,3,450,150,1361662692040,1361662698056,2084071260,2084077276,6016
1361663104,2084483044,12,999,83.25,1361663088498,1361663099378,2084467542,2084478422,10880
1361663104,2084483044,11,953,86.63636364,1361663088753,1361663099313,2084467797,2084478357,10560
1361663104,2084483084,12,999,83.25,1361663089035,1361663099275,2084468119,2084478359,10240
1361663332,2084711108,3,450,150,1361663304941,1361663310957,2084684049,2084690065,6016
1361663945,2085324800,3,450,150,1361663918194,1361663924210,2085297994,2085304010,6016
1361664558,2085937416,3,450,150,1361664532394,1361664538474,2085911810,2085917890,6080
1361664907,2086286296,12,999,83.25,1361664888028,1361664899164,2086267324,2086278460,11136
1361664907,2086286296,12,999,83.25,1361664888283,1361664899163,2086267579,2086278459,10880
1361664907,2086286336,16,6372,398.25,1361664887282,1361664899122,2086266618,2086278458,11840
1361664907,2086286340,12,999,83.25,1361664887727,1361664899119,2086267067,2086278459,11392
1361665171,2086550388,3,450,150,1361665144825,1361665150841,2086524213,2086530229,6016
1361665623,2087002928,4,202,50.5,1361665597721,1361665619801,2086977649,2086999729,22080
1361665672,2087050972,1,48,48,1361665645202,1361665645202,2087024174,2087024174,0
1361665784,2087163440,3,450,150,1361665758718,1361665764734,2087138158,2087144174,6016
1361665788,2087167332,16,6372,398.25,1361665772459,1361665784107,2087151791,2087163439,11648
1361665788,2087167332,12,999,83.25,1361665772841,1361665784105,2087152173,2087163437,11264
1361665788,2087167408,12,999,83.25,1361665773343,1361665784031,2087152751,2087163439,10688
1361665788,2087167444,12,999,83.25,1361665772986,1361665783994,2087152430,2087163438,11008
1361666397,2087776532,3,450,150,1361666372378,1361666378394,2087751910,2087757926,6016
1361666678,2088057140,2,104,52,1361666649948,1361666652892,2088029088,2088032032,2944
1361667014,2088393920,3,450,150,1361666987530,1361666993546,2088367450,2088373466,6016
1361667589,2088968324,11,953,86.63636364,1361667574164,1361667584404,2088953488,2088963728,10240
1361667589,2088968356,17,6755,397.3529412,1361667573237,1361667584373,2088952593,2088963729,11136
1361667589,2088968360,18,6971,387.2777778,1361667572276,1361667584308,2088951636,2088963668,12032
1361667589,2088968360,11,953,86.63636364,1361667573619,1361667584371,2088952979,2088963731,10752
1361667589,2088968360,12,999,83.25,1361667573873,1361667584369,2088953233,2088963729,10496
1361667628,2089007036,3,450,150,1361667603063,1361667609079,2088982099,2088988115,6016
1361668137,2089516808,1,46,46,1361668110827,1361668110827,2089490635,2089490635,0
1361668245,2089624812,3,450,150,1361668217828,1361668223844,2089597640,2089603656,6016
1361668378,2089756944,1,46,46,1361668350468,1361668350468,2089729412,2089729412,0
1361668538,2089917144,1,46,46,1361668512829,1361668512829,2089891973,2089891973,0
1361668766,2090145620,3,450,150,1361668738077,1361668744093,2090117697,2090123713,6016
1361669039,2090418540,1,48,48,1361669013738,1361669013738,2090393278,2090393278,0
1361669043,2090422512,2,96,48,1361669015747,1361669017027,2090395259,2090396539,1280
1361669187,2090566680,1,60,60,1361669161755,1361669161755,2090541435,2090541435,0
1361669203,2090582648,1,60,60,1361669176184,1361669176184,2090555832,2090555832,0
1361669391,2090770324,12,999,83.25,1361669373435,1361669384251,2090752759,2090763575,10816
1361669391,2090770368,12,999,83.25,1361669373645,1361669384205,2090753013,2090763573,10560
1361669391,2090770368,12,999,83.25,1361669373967,1361669384143,2090753335,2090763511,10176
1361670140,729833224,5,574,114.8,1361670138810,1361670138874,729832034,729832098,64
1361670143,2091522760,11,953,86.63636364,1361670127676,1361670138940,2091507436,2091518700,11264
1361670143,2091522764,12,999,83.25,1361670127928,1361670138936,2091507692,2091518700,11008
1361670143,2091522796,17,6755,397.3529412,1361670127000,1361670138904,2091506796,2091518700,11904
1361670143,2091522800,11,953,86.63636364,1361670127379,1361670138899,2091507179,2091518699,11520
1361670678,2092057844,1,52,52,1361670652001,1361670652001,2092031845,2092031845,0
1361670690,2092069848,1,52,52,1361670663389,1361670663389,2092043237,2092043237,0
1361671128,2092507072,3,162,54,1361671102174,1361671108126,2092481246,2092487198,5952
1361671548,2092927868,2,106,53,1361671521978,1361671521978,2092901846,2092901846,0
1361671705,2093084464,17,6755,397.3529412,1361671688654,1361671698894,2093068118,2093078358,10240
1361671705,2093084464,12,999,83.25,1361671689035,1361671698891,2093068499,2093078355,9856
1361671705,2093084468,11,953,86.63636364,1361671689289,1361671698889,2093068757,2093078357,9600
1361671733,2093111936,8,815,101.875,1361671706909,1361671707101,2093085845,2093086037,192
1361671733,2093111940,9,861,95.66666667,1361671707222,1361671707350,2093086162,2093086290,128
1361671733,2093111988,8,815,101.875,1361671706601,1361671706793,2093085589,2093085781,192
1361671733,2093112016,8,815,101.875,1361671707405,1361671707597,2093086421,2093086613,192
1361671841,2093220496,3,138,46,1361671836715,1361671836779,2093216211,2093216275,64
1361671841,2093220496,3,138,46,1361671836715,1361671836779,2093216211,2093216275,64
1361671841,2093220548,3,138,46,1361671836664,1361671836728,2093216212,2093216276,64
1361671841,2093220548,3,138,46,1361671836664,1361671836728,2093216212,2093216276,64
1361671865,2093243996,9,861,95.66666667,1361671838048,1361671838240,2093217044,2093217236,192
1361671865,2093244000,9,861,95.66666667,1361671838299,1361671838491,2093217299,2093217491,192
1361671865,2093244064,13,6197,476.6923077,1361671837273,1361671837593,2093216337,2093216657,320
1361671865,2093244068,9,861,95.66666667,1361671837718,1361671837910,2093216786,2093216978,192
1361672097,2093476868,4,252,63,1361672088882,1361672095922,2093468750,2093475790,7040
1361672113,2093492904,3,189,63,1361672107278,1361672110350,2093487182,2093490254,3072
1361672129,2093508660,1,63,63,1361672104195,1361672104195,2093483855,2093483855,0
1361672130,2093508952,2,126,63,1361672115335,1361672123335,2093494287,2093502287,8000
1361672146,2093525004,3,189,63,1361672139665,1361672142673,2093518669,2093521677,3008
1361672154,2093532964,3,189,63,1361672147578,1361672150586,2093526542,2093529550,3008
1361672162,2093540960,2,126,63,1361672146748,1361672154812,2093525708,2093533772,8064
1361672170,2093548968,2,126,63,1361672154613,1361672162677,2093533581,2093541645,8064
1361672739,2094118448,1,60,60,1361672712334,1361672712334,2094091782,2094091782,0
1361672751,2094130500,1,60,60,1361672726104,1361672726104,2094105604,2094105604,0
1361673096,2094475784,1,46,46,1361673068214,1361673068214,2094447998,2094447998,0
1361673097,2094476108,1,46,46,1361673068379,1361673068379,2094447487,2094447487,0
1361673515,2094894304,17,6755,397.3529412,1361673498515,1361673509267,2094877819,2094888571,10752
1361673515,2094894320,11,953,86.63636364,1361673498880,1361673509248,2094878200,2094888568,10368
1361673515,2094894332,12,999,83.25,1361673499123,1361673509171,2094878455,2094888503,10048
1361673713,2095092556,1,46,46,1361673688531,1361673688531,2095068087,2095068087,0
1361674570,734263828,1,46,46,1361674545021,1361674545021,734238849,734238849,0
1361674571,734263952,1,46,46,1361674545958,1361674545958,734238910,734238910,0
1361675028,2096407408,17,6755,397.3529412,1361675013972,1361675024020,2096393380,2096403428,10048
1361675028,2096407408,12,999,83.25,1361675014418,1361675024018,2096393826,2096403426,9600
1361675381,2096760200,1,46,46,1361675354141,1361675354141,2096733341,2096733341,0
1361676043,2097422700,1,48,48,1361676015391,1361676015391,2097395091,2097395091,0
1361676043,2097422736,1,48,48,1361676015612,1361676015612,2097395348,2097395348,0
1361676712,2098091640,3,144,48,1361676686930,1361676695954,2098066570,2098075594,9024
1361676829,2098208840,12,999,83.25,1361676813830,1361676823750,2098193670,2098203590,9920
1361676829,2098208880,17,6755,397.3529412,1361676813342,1361676823774,2098193222,2098203654,10432
1361677013,2098392312,1,60,60,1361676987347,1361676987347,2098366659,2098366659,0
1361677013,2098392432,1,60,60,1361676986395,1361676986395,2098365827,2098365827,0
1361677166,2098544912,1,60,60,1361677140129,1361677140129,2098519041,2098519041,0
1361677214,2098593368,2,120,60,1361677189272,1361677190232,2098568640,2098569600,960
1361677218,2098597096,2,120,60,1361677190378,1361677191402,2098569474,2098570498,1024
1361677987,2099366696,3,570,190,1361677962311,1361677968327,2099342007,2099348023,6016
1361678631,2100010308,17,6755,397.3529412,1361678614142,1361678624382,2099993450,2100003690,10240
1361678631,2100010348,12,999,83.25,1361678614487,1361678624343,2099993835,2100003691,9856
1361679257,2100636760,3,447,149,1361679232306,1361679238322,2100612066,2100618082,6016
1361679330,2100709124,1,46,46,1361679305388,1361679305388,2100684512,2100684512,0
1361679887,2101266640,3,447,149,1361679860130,1361679866146,2101239770,2101245786,6016
1361680432,2101811752,17,6755,397.3529412,1361680413673,1361680423977,2101793425,2101803729,10304
1361680432,2101811756,12,999,83.25,1361680414051,1361680423971,2101793807,2101803727,9920
1361680432,2101811776,12,999,83.25,1361680414354,1361680423954,2101794130,2101803730,9600
1361680460,2101839720,9,861,95.66666667,1361680432392,1361680432584,2101812112,2101812304,192
1361680460,2101839724,9,861,95.66666667,1361680432963,1361680433155,2101812687,2101812879,192
1361680460,2101839728,8,815,101.875,1361680433215,1361680433407,2101812943,2101813135,192
1361680460,2101839804,9,861,95.66666667,1361680432628,1361680432756,2101812432,2101812560,128
1361680500,2101879824,3,450,150,1361680471968,1361680477984,2101851792,2101857808,6016
1361680801,2102180304,3,189,63,1361680796066,1361680799138,2102175370,2102178442,3072
1361680801,2102180348,3,189,63,1361680796021,1361680799029,2102175369,2102178377,3008
1361680809,2102188300,3,189,63,1361680802024,1361680805032,2102181324,2102184332,3008
1361680817,2102196340,2,126,63,1361680803072,1361680811136,2102182412,2102190476,8064
1361680817,2102196340,2,126,63,1361680803136,1361680811136,2102182476,2102190476,8000
1361680825,2102204292,2,126,63,1361680809071,1361680817071,2102188363,2102196363,8000
1361680833,2102212384,3,189,63,1361680828372,1361680831380,2102207756,2102210764,3008
1361680849,2102228308,2,126,63,1361680835487,1361680843551,2102214795,2102222859,8064
1361681110,2102489492,3,450,150,1361681084898,1361681090914,2102464390,2102470406,6016
1361682212,2103591076,3,462,154,1361682186480,1361682192560,2103565556,2103571636,6080
1361682242,2103621212,17,6755,397.3529412,1361682223785,1361682234729,2103602997,2103613941,10944
1361682242,2103621212,12,999,83.25,1361682224744,1361682234728,2103603956,2103613940,9984
1361682242,2103621260,12,999,83.25,1361682224120,1361682234680,2103603380,2103613940,10560
1361682242,2103621260,11,953,86.63636364,1361682224443,1361682234683,2103603703,2103613943,10240
1361682272,2103651220,2,122,61,1361682244259,1361682246435,2103623479,2103625655,2176
1361682601,2103980032,2,122,61,1361682575192,1361682577560,2103954224,2103956592,2368
1361682837,2104216628,3,462,154,1361682811905,1361682817921,2104191533,2104197549,6016
1361683450,2104829432,3,462,154,1361683424506,1361683430586,2104803938,2104810018,6080
1361684036,2105415200,12,999,83.25,1361684025242,1361684034458,2105404442,2105413658,9216
1361684036,2105415244,11,953,86.63636364,1361684024686,1361684034478,2105403930,2105413722,9792
1361684036,2105415244,11,953,86.63636364,1361684024941,1361684034413,2105404185,2105413657,9472
1361684068,2105447044,9,861,95.66666667,1361684041975,1361684042167,2105421019,2105421211,192
1361684068,2105447048,8,815,101.875,1361684042800,1361684042992,2105421848,2105422040,192
1361684068,2105447100,8,815,101.875,1361684042175,1361684042367,2105421275,2105421467,192
1361684068,2105447124,8,815,101.875,1361684042404,1361684042660,2105421528,2105421784,256
1361684228,2105607640,3,189,63,1361684224031,1361684227103,2105603671,2105606743,3072
1361684228,2105607640,3,189,63,1361684224031,1361684227103,2105603671,2105606743,3072
1361684228,2105607644,3,189,63,1361684224090,1361684227098,2105603734,2105606742,3008
1361684244,2105623636,2,126,63,1361684231139,1361684239203,2105610775,2105618839,8064
1361684244,2105623636,2,126,63,1361684231139,1361684239139,2105610775,2105618775,8000
1361684244,2105623680,2,126,63,1361684231094,1361684239094,2105610774,2105618774,8000
1361684340,2105719848,4,252,63,1361684331408,1361684338448,2105711256,2105718296,7040
1361684373,2105751880,1,63,63,1361684347476,1361684347476,2105726356,2105726356,0
1361684577,2105956444,1,46,46,1361684549981,1361684549981,2105929425,2105929425,0
1361684673,2106052588,3,462,154,1361684654223,1361684660303,2106033811,2106039891,6080
1361685508,2106887204,1,46,46,1361685482048,1361685482048,2106861252,2106861252,0
1361685846,2107224976,12,999,83.25,1361685833120,1361685844832,2107212096,2107223808,11712
1361685846,2107225016,11,953,86.63636364,1361685833399,1361685844791,2107212415,2107223807,11392
1361685846,2107225680,12,999,83.25,1361685832990,1361685844126,2107212670,2107223806,11136
1361685847,2107226016,16,6372,398.25,1361685832695,1361685844791,2107211711,2107223807,12096
1361685981,2107360548,1,46,46,1361685954978,1361685954978,2107334526,2107334526,0
1361685985,2107364588,3,462,154,1361685960311,1361685966327,2107339899,2107345915,6016
1361687212,2108591528,3,462,154,1361687185571,1361687191587,2108565099,2108571115,6016
1361687340,2108719620,1,46,46,1361687312582,1361687312582,2108692202,2108692202,0
1361687648,2109027064,12,999,83.25,1361687634221,1361687644333,2109013285,2109023397,10112
1361687648,2109027064,11,953,86.63636364,1361687634475,1361687644331,2109013539,2109023395,9856
1361687648,2109027064,12,999,83.25,1361687634731,1361687644331,2109013795,2109023395,9600
1361687918,2109296912,3,152,50.66666667,1361687891073,1361687900097,2109269985,2109279009,9024
1361687922,2109300976,3,152,50.66666667,1361687895104,1361687904128,2109274080,2109283104,9024
1361687930,2109308984,3,654,218,1361687905528,1361687911544,2109284512,2109290528,6016
1361689088,2110467680,1,58,58,1361689062062,1361689062062,2110441742,2110441742,0
1361689217,2110596128,3,152,50.66666667,1361689190996,1361689200020,2110570124,2110579148,9024
1361689221,2110599988,1,58,58,1361689193186,1361689193186,2110572174,2110572174,0
1361689265,2110644716,11,953,86.63636364,1361689254537,1361689264201,2110634253,2110643917,9664
1361689265,2110644756,16,6372,398.25,1361689253857,1361689264161,2110633613,2110643917,10304
1361689265,2110644756,12,999,83.25,1361689254240,1361689264160,2110633996,2110643916,9920
1361689502,2110880948,1,46,46,1361689476613,1361689476613,2110855561,2110855561,0
1361689774,2111153820,3,152,50.66666667,1361689749016,1361689758040,2111128836,2111137860,9024
1361691059,2112438724,12,999,83.25,1361691049126,1361691058918,2112428850,2112438642,9792
1361691059,2112438724,12,999,83.25,1361691049381,1361691058917,2112429105,2112438641,9536
1361691059,2112438768,11,953,86.63636364,1361691049592,1361691058808,2112429360,2112438576,9216
1361691322,2112701292,1,46,46,1361691294288,1361691294288,2112673580,2112673580,0
1361692861,2114239936,12,999,83.25,1361692849500,1361692859484,2114228436,2114238420,9984
1361692861,2114239936,12,999,83.25,1361692849180,1361692859484,2114228116,2114238420,10304
1361692861,2114239960,11,953,86.63636364,1361692849734,1361692859462,2114228694,2114238422,9728
1361692969,2114348708,1,60,60,1361692943833,1361692943833,2114323541,2114323541,0
1361692981,2114360788,1,60,60,1361692956744,1361692956744,2114336532,2114336532,0
1361693453,2114832176,17,6418,377.5294118,1361693440421,1361693452517,2114819597,2114831693,12096
1361693453,2114832208,12,999,83.25,1361693440773,1361693452485,2114819981,2114831693,11712
1361693453,2114832208,11,953,86.63636364,1361693441028,1361693452484,2114820236,2114831692,11456
1361693453,2114832212,12,999,83.25,1361693441282,1361693452418,2114820494,2114831630,11136
1361693943,2115322812,3,441,147,1361693918816,1361693924832,2115298628,2115304644,6016
1361694557,2115936652,3,441,147,1361694532728,1361694538744,2115912380,2115918396,6016
1361695166,2116545748,3,444,148,1361695140878,1361695146894,2116520626,2116526642,6016
1361695255,2116634308,11,953,86.63636364,1361695238791,1361695249287,2116618099,2116628595,10496
1361695255,2116634308,12,999,83.25,1361695239110,1361695249222,2116618418,2116628530,10112
1361695255,2116634320,17,6755,397.3529412,1361695238394,1361695249274,2116617714,2116628594,10880
1361695716,2117094888,3,162,54,1361695688033,1361695694049,2117066921,2117072937,6016
1361696526,2117905492,1,48,48,1361696498105,1361696498105,2117877597,2117877597,0
1361696526,2117905532,1,48,48,1361696498130,1361696498130,2117877662,2117877662,0
1361696533,2117912188,3,444,148,1361696507756,1361696513772,2117886944,2117892960,6016
1361697057,2118435904,12,999,83.25,1361697039487,1361697049471,2118418391,2118428375,9984
1361697057,2118435916,11,953,86.63636364,1361697038964,1361697049524,2118417880,2118428440,10560
1361697057,2118435916,12,999,83.25,1361697039219,1361697049523,2118418135,2118428439,10304
1361697057,2118435944,17,6755,397.3529412,1361697038551,1361697049495,2118417495,2118428439,10944
1361697147,2118525928,3,444,148,1361697121511,1361697127527,2118500439,2118506455,6016
1361697303,2118682032,1,46,46,1361697278201,1361697278201,2118657233,2118657233,0
1361698373,2119752044,3,444,148,1361698346720,1361698352800,2119725764,2119731844,6080
1361698401,2119780132,1,46,46,1361698375751,1361698375751,2119754883,2119754883,0
1361698842,2120221396,43,55063,1280.534884,1361698839288,1361698839928,2120218684,2120219324,640
1361698850,2120229408,12,999,83.25,1361698838250,1361698849130,2120217658,2120228538,10880
1361698850,2120229436,12,999,83.25,1361698838541,1361698849101,2120217977,2120228537,10560
1361698850,2120229440,12,999,83.25,1361698838793,1361698849097,2120218233,2120228537,10304
1361698986,2120365012,3,444,148,1361698958709,1361698964789,2120337721,2120343801,6080
1361699096,2120475100,1,46,46,1361699066525,1361699066525,2120445625,2120445625,0
1361699096,2120475140,1,46,46,1361699066549,1361699066549,2120445689,2120445689,0
1361699122,2120501316,1,46,46,1361699097795,1361699097795,2120477111,2120477111,0
1361700156,2121535204,1,48,48,1361700131811,1361700131811,2121511015,2121511015,0
1361700208,2121587432,3,444,148,1361700182717,1361700188733,2121562149,2121568165,6016
1361700283,2121662472,12,999,83.25,1361700267798,1361700278934,2121647270,2121658406,11136
1361700283,2121662476,12,999,83.25,1361700267536,1361700278992,2121647012,2121658468,11456
1361700283,2121662484,16,6372,398.25,1361700266890,1361700278986,2121646374,2121658470,12096
1361700283,2121662488,12,999,83.25,1361700267270,1361700278982,2121646758,2121658470,11712
1361700304,2121683436,2,152,76,1361700277753,1361700292793,2121657189,2121672229,15040
1361700332,2121711676,2,152,76,1361700307593,1361700322633,2121687269,2121702309,15040
1361700352,2121731680,1,46,46,1361700326788,1361700326788,2121706468,2121706468,0
1361700364,2121743680,1,76,76,1361700337670,1361700337670,2121717350,2121717350,0
1361700492,2121871804,5,320,64,1361700465734,1361700468358,2121845538,2121848162,2624
1361700500,2121879828,5,320,64,1361700474541,1361700476973,2121854369,2121856801,2432
1361700553,2121931856,1,46,46,1361700525560,1361700525560,2121904416,2121904416,0
1361701172,2122550956,11,953,86.63636364,1361701154446,1361701164622,2122533402,2122543578,10176
1361701172,2122550956,11,953,86.63636364,1361701154829,1361701164621,2122533785,2122543577,9792
1361701182,2122561412,2,152,76,1361701155203,1361701170243,2122534615,2122549655,15040
1361701210,2122589440,2,152,76,1361701185254,1361701200294,2122564694,2122579734,15040
1361701242,2122621412,1,76,76,1361701215362,1361701215362,2122594774,2122594774,0
1361701554,2122933756,5,250,50,1361701527974,1361701550118,2122907730,2122929874,22144
1361701603,2122981828,1,48,48,1361701575495,1361701575495,2122954323,2122954323,0
1361701631,2123010116,1,48,48,1361701604644,1361701604644,2122983760,2122983760,0
1361702638,2124016868,1,60,60,1361702613133,1361702613133,2123992001,2123992001,0
1361702642,2124020892,1,60,60,1361702616246,1361702616246,2123995138,2123995138,0
1361702965,2124344140,17,6755,397.3529412,1361702948217,1361702959545,2124327357,2124338685,11328
1361702965,2124344140,11,953,86.63636364,1361702948601,1361702959545,2124327741,2124338685,10944
1361702965,2124344148,16,6372,398.25,1361702947762,1361702959538,2124326910,2124338686,11776
1361702965,2124344152,12,999,83.25,1361702948847,1361702959535,2124327999,2124338687,10688
1361702978,2124357716,2,152,76,1361702949946,1361702964986,2124329662,2124344702,15040
1361703006,2124385780,2,152,76,1361702979962,1361702995002,2124359742,2124374782,15040
1361703035,2124413984,1,76,76,1361703010837,1361703010837,2124389821,2124389821,0
1361703139,2124518080,1,46,46,1361703112882,1361703112882,2124491962,2124491962,0
1361703677,2125056240,1,46,46,1361703650123,1361703650123,2125029363,2125029363,0
1361703677,2125056284,1,46,46,1361703650204,1361703650204,2125029488,2125029488,0
1361703886,2125265464,12,999,83.25,1361703869545,1361703879273,2125249009,2125258737,9728
1361703886,2125265468,12,999,83.25,1361703870116,1361703879268,2125249584,2125258736,9152
1361703886,2125265472,16,6372,398.25,1361703869152,1361703879328,2125248624,2125258800,10176
1361703886,2125265472,12,999,83.25,1361703869854,1361703879262,2125249326,2125258734,9408
1361703896,2125275392,2,152,76,1361703870192,1361703885232,2125249584,2125264624,15040
1361703928,2125307444,2,152,76,1361703900220,1361703915260,2125279664,2125294704,15040
1361703956,2125335460,1,76,76,1361703930281,1361703930281,2125309741,2125309741,0
1361704946,2126324860,1,46,46,1361704920821,1361704920821,2126299681,2126299681,0
1361705576,2126955496,12,999,83.25,1361705557870,1361705569262,2126937366,2126948758,11392
1361705576,2126955504,16,6372,398.25,1361705557222,1361705569318,2126936726,2126948822,12096
1361705576,2126955504,12,999,83.25,1361705557606,1361705569318,2126937110,2126948822,11712
1361705576,2126955504,11,953,86.63636364,1361705558181,1361705569253,2126937685,2126948757,11072
1361705587,2126965848,2,152,76,1361705560820,1361705575860,2126939668,2126954708,15040
1361705615,2126993888,2,152,76,1361705590861,1361705605901,2126969749,2126984789,15040
1361705647,2127025908,1,76,76,1361705620858,1361705620858,2126999766,2126999766,0
1361705811,765504172,4,1448,362,1361705813015,1361705813079,765506187,765506251,64
1361705811,765504172,2,112,56,1361705812951,1361705812951,765506123,765506123,0
1361705813,765506640,3,339,113,1361705812932,1361705812932,765506572,765506572,0
1361705815,2127194232,7,7841,1120.142857,1361705812852,1361705813044,2127192084,2127192276,192
1361705815,2127194232,1,108,108,1361705812980,1361705812980,2127192212,2127192212,0
1361705815,2127194232,1,108,108,1361705813044,1361705813044,2127192276,2127192276,0
1361705817,2127195980,11,3294,299.4545455,1361705815664,1361705816496,2127194644,2127195476,832
1361705817,2127195984,6,983,163.8333333,1361705816491,1361705816939,2127195475,2127195923,448
1361705817,2127195988,5,1257,251.4,1361705813928,1361705814120,2127192916,2127193108,192
1361705817,2127195988,7,1952,278.8571429,1361705814504,1361705815208,2127193492,2127194196,704
1361705817,2127195992,25,33796,1351.84,1361705813282,1361705813602,2127192274,2127192594,320
1361705817,2127196016,8,3492,436.5,1361705814220,1361705815180,2127193236,2127194196,960
1361705821,765514640,5,451,90.2,1361705816580,1361705817284,765510220,765510924,704
1361705821,765514640,5,451,90.2,1361705819202,1361705820354,765512842,765513994,1152
1361705821,765514644,5,2109,421.8,1361705817345,1361705817473,765510989,765511117,128
1361705825,2127203996,7,1966,280.8571429,1361705817245,1361705817693,2127196241,2127196689,448
1361705825,2127204000,9,1913,212.5555556,1361705818010,1361705818522,2127197010,2127197522,512
1361705825,2127204000,9,1913,212.5555556,1361705821146,1361705821850,2127200146,2127200850,704
1361705825,2127204000,6,798,133,1361705816922,1361705817178,2127195922,2127196178,256
1361705825,2127204000,9,3035,337.2222222,1361705816922,1361705817946,2127195922,2127196946,1024
1361705825,2127204000,5,609,121.8,1361705819096,1361705819544,2127198096,2127198544,448
1361705825,2127204004,5,609,121.8,1361705822164,1361705822612,2127201168,2127201616,448
1361705825,2127204004,9,1913,212.5555556,1361705823190,1361705823766,2127202194,2127202770,576
1361705825,2127204004,9,1913,212.5555556,1361705823254,1361705823894,2127202258,2127202898,640
1361705825,2127204004,4,724,181,1361705819861,1361705820053,2127198865,2127199057,192
1361705825,2127204008,5,609,121.8,1361705824276,1361705824660,2127203284,2127203668,384
1361705825,2127204008,7,1460,208.5714286,1361705816595,1361705817171,2127195603,2127196179,576
1361705825,2127204008,9,1913,212.5555556,1361705822224,1361705822736,2127201232,2127201744,512
1361705829,765522640,4,445,111.25,1361705828036,1361705828164,765521676,765521804,128
1361705829,765522640,4,445,111.25,1361705828675,1361705828867,765522315,765522507,192
1361705829,765522644,4,445,111.25,1361705828289,1361705828545,765521933,765522189,256
1361705829,765522644,5,451,90.2,1361705824129,1361705824257,765517773,765517901,128
1361705829,765522644,5,451,90.2,1361705822016,1361705822592,765515660,765516236,576
1361705829,765522644,5,451,90.2,1361705825856,1361705826624,765519500,765520268,768
1361705833,2127211996,9,1913,212.5555556,1361705827357,1361705827933,2127206353,2127206929,576
1361705833,2127212000,10,1877,187.7,1361705831515,1361705832539,2127210515,2127211539,1024
1361705833,2127212000,9,1913,212.5555556,1361705828250,1361705828762,2127207250,2127207762,512
1361705833,2127212000,11,5273,479.3636364,1361705825562,1361705826458,2127204562,2127205458,896
1361705833,2127212004,9,1913,212.5555556,1361705824532,1361705825044,2127203536,2127204048,512
1361705833,2127212004,12,4927,410.5833333,1361705829464,1361705830104,2127208468,2127209108,640
1361705833,2127212004,12,4967,413.9166667,1361705826901,1361705827541,2127205905,2127206545,640
1361705833,2127212008,12,4967,413.9166667,1361705824980,1361705825812,2127203988,2127204820,832
1361705833,2127212008,5,609,121.8,1361705828241,1361705828625,2127207249,2127207633,384
1361705833,2127212012,5,609,121.8,1361705825999,1361705826383,2127205011,2127205395,384
1361705833,2127212012,12,4735,394.5833333,1361705830477,1361705831117,2127209489,2127210129,640
1361705837,765530652,4,1448,362,1361705835065,1361705835129,765528717,765528781,64
1361705839,2127218292,1,108,108,1361705813044,1361705813044,2127192336,2127192336,0
1361705841,2127219988,9,1913,212.5555556,1361705832744,1361705833256,2127211732,2127212244,512
1361705841,2127219992,9,3310,367.7777778,1361705836321,1361705837985,2127215313,2127216977,1664
1361705841,2127219996,4,715,178.75,1361705840540,1361705840732,2127219536,2127219728,192
1361705841,2127219996,9,1913,212.5555556,1361705833760,1361705834272,2127212756,2127213268,512
1361705841,2127219996,10,3397,339.7,1361705837981,1361705839197,2127216977,2127218193,1216
1361705841,2127220000,9,2849,316.5555556,1361705834776,1361705835352,2127213776,2127214352,576
1361705847,2127226568,7,1877,268.1428571,1361705819618,1361705820322,2127199186,2127199890,704
1361705849,2127228020,14,7501,535.7857143,1361705841670,1361705842438,2127220690,2127221458,768
1361705849,2127228032,11,3096,281.4545455,1361705840891,1361705841659,2127219923,2127220691,768
1361706152,2127531168,1,46,46,1361706125612,1361706125612,2127504780,2127504780,0
1361707386,2128765168,12,999,83.25,1361707370585,1361707381337,2128749753,2128760505,10752
1361707386,2128765172,11,953,86.63636364,1361707371096,1361707381336,2128750268,2128760508,10240
1361707386,2128765180,12,999,83.25,1361707370831,1361707381327,2128750011,2128760507,10496
1361707406,2128785340,14,6617,472.6428571,1361707381680,1361707382000,2128761020,2128761340,320
1361707410,2128789372,9,861,95.66666667,1361707382285,1361707382477,2128761657,2128761849,192
1361707410,2128789376,8,815,101.875,1361707382603,1361707382795,2128761979,2128762171,192
1361707410,2128789384,8,815,101.875,1361707382017,1361707382209,2128761401,2128761593,192
1361707706,2129085284,3,189,63,1361707700578,1361707703586,2129079862,2129082870,3008
1361707706,2129085292,3,189,63,1361707700635,1361707703643,2129079927,2129082935,3008
1361707722,2129101292,2,126,63,1361707707672,1361707715672,2129086964,2129094964,8000
1361707722,2129101292,2,126,63,1361707707608,1361707715672,2129086900,2129094964,8064
1361707810,2129189384,4,252,63,1361707802811,1361707809851,2129182195,2129189235,7040
1361707810,2129189384,4,252,63,1361707802811,1361707809851,2129182195,2129189235,7040
1361707839,2129218128,5,250,50,1361707813500,1361707835324,2129192628,2129214452,21824
1361707843,2129222108,1,63,63,1361707818192,1361707818192,2129197300,2129197300,0
1361707843,2129222140,1,63,63,1361707818159,1361707818159,2129197299,2129197299,0
1361707939,2129318164,1,46,46,1361707911573,1361707911573,2129290737,2129290737,0
1361708083,2129462556,1,46,46,1361708058254,1361708058254,2129437810,2129437810,0
1361709146,2130525120,2,122,61,1361709119343,1361709121775,2130498463,2130500895,2432
1361709187,2130566156,12,999,83.25,1361709172108,1361709183820,2130551264,2130562976,11712
1361709187,2130566156,11,953,86.63636364,1361709172364,1361709183820,2130551520,2130562976,11456
1361709187,2130566156,12,999,83.25,1361709172620,1361709183820,2130551776,2130562976,11200
1361709187,2130566164,17,6755,397.3529412,1361709171717,1361709183813,2130550881,2130562977,12096
1361709410,2130789496,2,122,61,1361709383538,1361709385906,2130763034,2130765402,2368
1361709631,2131010280,1,46,46,1361709606410,1361709606410,2130985690,2130985690,0
1361709723,2131102364,1,46,46,1361709697650,1361709697650,2131077014,2131077014,0
1361709803,2131182648,3,144,48,1361709775702,1361709784662,2131155350,2131164310,8960
1361710998,2132377360,14,6617,472.6428571,1361710973028,1361710973348,2132352388,2132352708,320
1361710998,2132377364,9,861,95.66666667,1361710973406,1361710973598,2132352770,2132352962,192
1361710998,2132377364,9,861,95.66666667,1361710973664,1361710973856,2132353028,2132353220,192
1361711157,2132535952,2,126,63,1361711154875,1361711155899,2132533827,2132534851,1024
1361711165,2132544000,2,126,63,1361711157834,1361711161866,2132536834,2132540866,4032
1361711195,2132574168,1,63,63,1361711169760,1361711169760,2132548928,2132548928,0
1361711229,2132607980,3,189,63,1361711222557,1361711225629,2132601537,2132604609,3072
1361711245,2132624012,2,126,63,1361711229629,1361711237629,2132608641,2132616641,8000
1361711287,2132666172,9,861,95.66666667,1361711259036,1361711259228,2132638208,2132638400,192
1361711287,2132666176,9,861,95.66666667,1361711259290,1361711259482,2132638466,2132638658,192
1361711287,2132666212,8,815,101.875,1361711259508,1361711259764,2132638720,2132638976,256
1361711287,2132666212,8,815,101.875,1361711259828,1361711260020,2132639040,2132639232,192
1361711317,2132696060,3,189,63,1361711312013,1361711315085,2132691073,2132694145,3072
1361711333,2132712044,2,126,63,1361711319131,1361711327131,2132698175,2132706175,8000
1361711557,2132936472,3,189,63,1361711553004,1361711556012,2132932476,2132935484,3008
1361711557,2132936472,3,189,63,1361711553003,1361711556075,2132932475,2132935547,3072
1361711573,2132952452,2,126,63,1361711560065,1361711568129,2132939517,2132947581,8064
1361711573,2132952460,2,126,63,1361711560119,1361711568119,2132939579,2132947579,8000
1361711581,2132960444,3,189,63,1361711575752,1361711578760,2132955196,2132958204,3008
1361711581,2132960444,3,189,63,1361711575624,1361711578632,2132955068,2132958076,3008
1361711597,2132976480,2,126,63,1361711582627,1361711590691,2132962107,2132970171,8064
1361711597,2132976488,2,126,63,1361711582747,1361711590811,2132962235,2132970299,8064
1361711960,2133339248,1,46,46,1361711933255,1361711933255,2133312503,2133312503,0
1361712790,2134168888,14,6617,472.6428571,1361712762785,1361712763105,2134141673,2134141993,320
1361712790,2134168888,8,815,101.875,1361712763424,1361712763616,2134142312,2134142504,192
1361712790,2134168888,9,861,95.66666667,1361712763168,1361712763360,2134142056,2134142248,192
1361712790,2134168892,9,861,95.66666667,1361712763677,1361712763869,2134142569,2134142761,192
1361712958,2134337224,3,189,63,1361712952336,1361712955408,2134331560,2134334632,3072
1361712974,2134353216,2,126,63,1361712959447,1361712967447,2134338663,2134346663,8000
1361712998,2134377204,4,252,63,1361712990818,1361712997922,2134370022,2134377126,7104
1361712998,2134377204,3,189,63,1361712991266,1361712994274,2134370470,2134373478,3008
1361712998,2134377216,2,126,63,1361712996565,1361712997589,2134375781,2134376805,1024
1361713006,2134385252,2,126,63,1361712999601,1361713003569,2134378853,2134382821,3968
1361713014,2134393388,2,126,63,1361712998124,1361713006124,2134377512,2134385512,8000
1361713034,2134413176,1,63,63,1361713005950,1361713005950,2134385126,2134385126,0
1361713038,2134417168,1,63,63,1361713011717,1361713011717,2134390885,2134390885,0
1361713046,2134425196,9,861,95.66666667,1361713018603,1361713018731,2134397799,2134397927,128
1361713046,2134425196,8,815,101.875,1361713018858,1361713019050,2134398054,2134398246,192
1361713046,2134425208,14,6617,472.6428571,1361713017950,1361713018206,2134397158,2134397414,256
1361713046,2134425208,8,815,101.875,1361713018333,1361713018461,2134397541,2134397669,128
1361713230,2134609460,2,126,63,1361713228509,1361713229533,2134607969,2134608993,1024
1361713230,2134609464,2,126,63,1361713228764,1361713229788,2134608228,2134609252,1024
1361713238,2134617476,2,126,63,1361713231760,1361713235792,2134611236,2134615268,4032
1361713238,2134617484,2,126,63,1361713231495,1361713235527,2134610979,2134615011,4032
1361713270,2134649756,1,63,63,1361713243319,1361713243319,2134623075,2134623075,0
1361713270,2134649756,1,63,63,1361713243574,1361713243574,2134623330,2134623330,0
1361713334,2134713492,2,126,63,1361713331518,1361713332542,2134711010,2134712034,1024
1361713334,2134713492,2,126,63,1361713331518,1361713332542,2134711010,2134712034,1024
1361713342,2134721528,2,126,63,1361713334488,1361713338520,2134714016,2134718048,4032
1361713342,2134721536,2,126,63,1361713334480,1361713338512,2134714016,2134718048,4032
1361713375,2134754004,1,63,63,1361713347108,1361713347108,2134726112,2134726112,0
1361713375,2134754004,1,63,63,1361713347107,1361713347107,2134726111,2134726111,0
1361714312,2135691684,1,52,52,1361714285103,1361714285103,2135664787,2135664787,0
1361714577,2135956036,9,861,95.66666667,1361714552370,1361714552498,2135931406,2135931534,128
1361714577,2135956056,9,861,95.66666667,1361714552861,1361714553053,2135931917,2135932109,192
1361714577,2135956068,14,6617,472.6428571,1361714551955,1361714552275,2135931023,2135931343,320
1361714577,2135956072,8,815,101.875,1361714552590,1361714552718,2135931662,2135931790,128
1361714807,2136186376,3,189,63,1361714800155,1361714803227,2136179531,2136182603,3072
1361714823,2136202376,2,126,63,1361714807259,1361714815259,2136186635,2136194635,8000
1361714825,2136204644,2,126,63,1361714820879,1361714821903,2136200523,2136201547,1024
1361714831,2136210404,2,126,63,1361714824128,1361714828160,2136203532,2136207564,4032
1361714861,2136240692,1,63,63,1361714835936,1361714835936,2136215628,2136215628,0
1361714879,2136258416,2,126,63,1361714877105,1361714878129,2136256521,2136257545,1024
1361714879,2136258416,2,126,63,1361714877105,1361714878065,2136256521,2136257481,960
1361714887,2136266392,2,126,63,1361714880138,1361714884170,2136259530,2136263562,4032
1361714887,2136266396,2,126,63,1361714880196,1361714884228,2136259592,2136263624,4032
1361714918,2136296928,1,63,63,1361714892696,1361714892696,2136271624,2136271624,0
1361714918,2136296932,1,63,63,1361714892695,1361714892695,2136271627,2136271627,0
1361715070,2136449532,8,815,101.875,1361715043324,1361715043516,2136422856,2136423048,192
1361715070,2136449532,9,861,95.66666667,1361715043578,1361715043770,2136423110,2136423302,192
1361715070,2136449532,9,861,95.66666667,1361715043834,1361715044026,2136423366,2136423558,192
1361715247,2136626620,4,252,63,1361715238049,1361715245089,2136617669,2136624709,7040
1361715279,2136658044,1,63,63,1361715253728,1361715253728,2136632772,2136632772,0
1361715287,2136666616,3,189,63,1361715282274,1361715285346,2136661890,2136664962,3072
1361715303,2136682616,2,126,63,1361715289380,1361715297380,2136668996,2136676996,8000
1361715335,2136714636,2,92,46,1361715330128,1361715330128,2136709764,2136709764,0
1361715335,2136714636,2,92,46,1361715330128,1361715330128,2136709764,2136709764,0
1361715355,2136734196,2,109,54.5,1361715330566,1361715330566,2136709762,2136709762,0
1361715359,2136738208,8,815,101.875,1361715332538,1361715332730,2136711746,2136711938,192
1361715359,2136738212,9,861,95.66666667,1361715333112,1361715333240,2136712324,2136712452,128
1361715359,2136738244,14,6617,472.6428571,1361715332182,1361715332438,2136711426,2136711682,256
1361715359,2136738248,9,861,95.66666667,1361715332753,1361715332945,2136712001,2136712193,192
1361715519,2136898708,3,189,63,1361715513413,1361715516485,2136893121,2136896193,3072
1361715535,2136914680,2,126,63,1361715520545,1361715528545,2136900225,2136908225,8000
1361715655,2137034728,3,189,63,1361715649262,1361715652270,2137028990,2137031998,3008
1361715655,2137034736,3,189,63,1361715649254,1361715652262,2137028990,2137031998,3008
1361715663,2137042736,3,189,63,1361715656296,1361715659304,2137036032,2137039040,3008
1361715671,2137050736,2,126,63,1361715656293,1361715664357,2137036029,2137044093,8064
1361715671,2137050736,2,126,63,1361715656357,1361715664357,2137036093,2137044093,8000
1361715679,2137058732,2,126,63,1361715663337,1361715671401,2137043069,2137051133,8064
1361716069,2137448368,1,60,60,1361716043856,1361716043856,2137423224,2137423224,0
1361716069,2137448380,1,60,60,1361716040902,1361716040902,2137420282,2137420282,0
1361716863,2138241920,14,6617,472.6428571,1361716838788,1361716839108,2138217708,2138218028,320
1361716867,2138245896,9,861,95.66666667,1361716839517,1361716839645,2138218413,2138218541,128
1361716867,2138245932,9,861,95.66666667,1361716839160,1361716839352,2138218092,2138218284,192
1361717073,2138451792,3,189,63,1361717065984,1361717069056,2138444776,2138447848,3072
1361717089,2138467808,2,126,63,1361717073071,1361717081071,2138451879,2138459879,8000
1361717105,2138483816,3,189,63,1361717101864,1361717104936,2138480680,2138483752,3072
1361717121,2138499796,3,189,63,1361717116538,1361717119610,2138495334,2138498406,3072
1361717135,2138514388,1,63,63,1361717108396,1361717108396,2138487784,2138487784,0
1361717137,2138515804,9,861,95.66666667,1361717111477,1361717111669,2138490281,2138490473,192
1361717137,2138515804,2,126,63,1361717123636,1361717131700,2138502440,2138510504,8064
1361717139,2138518412,8,815,101.875,1361717111380,1361717111572,2138490792,2138490984,192
1361717139,2138518428,8,815,101.875,1361717111108,1361717111300,2138490536,2138490728,192
1361717345,2138723920,4,184,46,1361717338686,1361717341758,2138717606,2138720678,3072
1361717361,2138739948,3,189,63,1361717354594,1361717357602,2138733542,2138736550,3008
1361717363,2138742616,1,46,46,1361717338054,1361717338054,2138717670,2138717670,0
1361717367,2138746616,9,861,95.66666667,1361717340998,1361717341190,2138720614,2138720806,192
1361717367,2138746648,9,861,95.66666667,1361717340067,1361717340259,2138719715,2138719907,192
1361717367,2138746652,9,1198,133.1111111,1361717340386,1361717341602,2138720038,2138721254,1216
1361717367,2138746652,8,815,101.875,1361717340641,1361717340833,2138720293,2138720485,192
1361717377,2138755940,2,126,63,1361717361640,1361717369704,2138740580,2138748644,8064
1361717417,2138795984,3,189,63,1361717410557,1361717413629,2138789541,2138792613,3072
1361717433,2138811932,2,126,63,1361717417712,1361717425712,2138796644,2138804644,8000
1361717529,2138908028,3,189,63,1361717522831,1361717525903,2138901859,2138904931,3072
1361717545,2138923996,2,126,63,1361717529964,1361717538028,2138908960,2138917024,8064
1361717585,2138964008,4,252,63,1361717576607,1361717583647,2138955615,2138962655,7040
1361717585,2138964016,2,126,63,1361717583130,1361717584154,2138962146,2138963170,1024
1361717585,2138964024,2,126,63,1361717583247,1361717584271,2138962271,2138963295,1024
1361717593,2138972024,2,126,63,1361717586195,1361717590163,2138965219,2138969187,3968
1361717593,2138972024,2,126,63,1361717586322,1361717590354,2138965346,2138969378,4032
1361717616,2138994908,1,63,63,1361717591812,1361717591812,2138970720,2138970720,0
1361717624,2139002872,1,63,63,1361717598506,1361717598506,2138977378,2138977378,0
1361717624,2139002872,1,63,63,1361717598377,1361717598377,2138977249,2138977249,0
1361717918,2139297632,1,46,46,1361717890542,1361717890542,2139270174,2139270174,0
1361717918,2139297640,1,46,46,1361717890597,1361717890597,2139270237,2139270237,0
1361718922,2140301492,14,6617,472.6428571,1361718896295,1361718896615,2140275787,2140276107,320
1361718922,2140301536,9,861,95.66666667,1361718896637,1361718896829,2140276173,2140276365,192
1361718922,2140301536,9,861,95.66666667,1361718896957,1361718897085,2140276493,2140276621,128
1361718922,2140301540,8,815,101.875,1361718897207,1361718897335,2140276747,2140276875,128
1361719130,2140509068,3,189,63,1361719126604,1361719129612,2140505672,2140508680,3008
1361719146,2140525040,2,126,63,1361719133672,1361719141736,2140512712,2140520776,8064
1361719154,2140533020,2,126,63,1361719152575,1361719153535,2140531595,2140532555,960
1361719154,2140533028,2,126,63,1361719152372,1361719153396,2140531400,2140532424,1024
1361719162,2140541012,2,126,63,1361719155463,1361719159495,2140534475,2140538507,4032
1361719162,2140541012,2,126,63,1361719155590,1361719159622,2140534602,2140538634,4032
1361719178,2140557036,4,252,63,1361719170157,1361719177197,2140549193,2140556233,7040
1361719195,2140574268,1,63,63,1361719167237,1361719167237,2140546505,2140546505,0
1361719195,2140574268,1,63,63,1361719167428,1361719167428,2140546696,2140546696,0
1361719211,2140590316,1,63,63,1361719184979,1361719184979,2140564295,2140564295,0
1361720364,780056872,1,46,46,1361720336163,1361720336163,780029035,780029035,0
1361720458,2141837256,2,122,61,1361720431294,1361720433534,2141810550,2141812790,2240
1361720715,2142094056,14,6617,472.6428571,1361720688513,1361720688769,2142067569,2142067825,256
1361720715,2142094060,9,861,95.66666667,1361720688894,1361720689022,2142067954,2142068082,128
1361720715,2142094100,9,861,95.66666667,1361720689109,1361720689237,2142068209,2142068337,128
1361720907,2142286060,3,189,63,1361720900538,1361720903546,2142279598,2142282606,3008
1361720923,2142302052,2,126,63,1361720907588,1361720915652,2142286640,2142294704,8064
1361720939,2142318044,3,189,63,1361720934281,1361720937289,2142313325,2142316333,3008
1361720955,2142334048,2,126,63,1361720941319,1361720949383,2142320367,2142328431,8064
1361720963,2142342084,2,126,63,1361720960354,1361720961378,2142339438,2142340462,1024
1361720971,2142350048,2,126,63,1361720963462,1361720967494,2142342510,2142346542,4032
1361721003,2142382524,1,63,63,1361720975018,1361720975018,2142354542,2142354542,0
1361721231,2142610728,9,861,95.66666667,1361721204572,1361721204764,2142584300,2142584492,192
1361721231,2142610732,9,861,95.66666667,1361721205463,1361721205655,2142585195,2142585387,192
1361721232,2142610764,9,861,95.66666667,1361721205790,1361721206046,2142584554,2142584810,256
1361721232,2142610768,9,861,95.66666667,1361721206107,1361721206299,2142584875,2142585067,192
1361721404,2142783156,4,252,63,1361721394898,1361721401938,2142774054,2142781094,7040
1361721436,2142815260,1,63,63,1361721409897,1361721409897,2142789157,2142789157,0
1361721451,2142830444,4,252,63,1361721442226,1361721449266,2142821670,2142828710,7040
1361721483,2142862432,4,252,63,1361721475709,1361721482813,2142855141,2142862245,7104
1361721484,2142863288,1,63,63,1361721457488,1361721457488,2142836776,2142836776,0
1361721516,2142895396,1,63,63,1361721490851,1361721490851,2142870247,2142870247,0
1361721523,2142902428,4,252,63,1361721515394,1361721522434,2142894822,2142901862,7040
1361721556,2142935700,1,63,63,1361721530225,1361721530225,2142909925,2142909925,0
1361721665,2143043816,1,60,60,1361721636965,1361721636965,2143015781,2143015781,0
1361721669,2143047844,1,60,60,1361721643527,1361721643527,2143022371,2143022371,0
1361721781,2143160140,1,60,60,1361721753310,1361721753310,2143132450,2143132450,0
1361721789,2143168272,1,60,60,1361721762969,1361721762969,2143142241,2143142241,0
1361721793,2143172244,1,60,60,1361721765813,1361721765813,2143145057,2143145057,0
1361721805,2143184268,1,60,60,1361721777884,1361721777884,2143157152,2143157152,0
1361721829,2143208300,1,60,60,1361721802878,1361721802878,2143182178,2143182178,0
1361721845,2143224204,1,60,60,1361721818140,1361721818140,2143197344,2143197344,0
1361721869,2143248240,1,60,60,1361721843383,1361721843383,2143222623,2143222623,0
1361721881,2143260264,1,60,60,1361721855711,1361721855711,2143234975,2143234975,0
1361722025,2143404336,1,60,60,1361721996949,1361721996949,2143376285,2143376285,0
1361722049,2143428512,1,60,60,1361722023526,1361722023526,2143403038,2143403038,0
1361722114,2143493728,1,46,46,1361722085901,1361722085901,2143465629,2143465629,0
1361722116,2143494908,1,46,46,1361722086786,1361722086786,2143465694,2143465694,0
1361722210,2143588936,9,756,84,1361722183395,1361722208867,2143562331,2143587803,25472
1361722254,2143633004,3,252,84,1361722229150,1361722233054,2143608154,2143612058,3904
1361722286,2143665068,3,252,84,1361722258655,1361722262239,2143637723,2143641307,3584
1361722579,2143957800,3,152,50.66666667,1361722554662,1361722563686,2143933462,2143942486,9024
1361722787,2144166036,3,144,48,1361722762358,1361722771382,2144141394,2144150418,9024
1361723023,2144402236,14,6617,472.6428571,1361722998252,1361722998508,2144377488,2144377744,256
1361723023,2144402284,9,861,95.66666667,1361722998586,1361722998714,2144377870,2144377998,128
1361723027,2144406220,9,861,95.66666667,1361722998906,1361722999098,2144378126,2144378318,192
1361723229,2144608072,3,189,63,1361723224586,1361723227594,2144603658,2144606666,3008
1361723243,2144622588,1,46,46,1361723216841,1361723216841,2144596429,2144596429,0
1361723245,2144624084,2,126,63,1361723231616,1361723239680,2144610700,2144618764,8064
1361723259,2144638688,3,444,148,1361723234085,1361723240101,2144613773,2144619789,6016
1361723261,2144640076,3,189,63,1361723252616,1361723255688,2144631692,2144634764,3072
1361723277,2144656184,2,126,63,1361723274205,1361723275229,2144653389,2144654413,1024
1361723279,2144658660,8,815,101.875,1361723254719,1361723254911,2144634379,2144634571,192
1361723283,2144662608,9,861,95.66666667,1361723255538,1361723255730,2144635146,2144635338,192
1361723283,2144662644,8,815,101.875,1361723254990,1361723255182,2144634634,2144634826,192
1361723283,2144662648,8,815,101.875,1361723255244,1361723255436,2144634892,2144635084,192
1361723285,2144664144,2,126,63,1361723277315,1361723281347,2144656459,2144660491,4032
1361723315,2144694716,1,63,63,1361723288839,1361723288839,2144668555,2144668555,0
1361723445,2144824208,3,189,63,1361723441279,1361723444351,2144820487,2144823559,3072
1361723461,2144840232,2,126,63,1361723448360,1361723456360,2144827592,2144835592,8000
1361723493,2144872256,2,126,63,1361723491729,1361723492753,2144870985,2144872009,1024
1361723501,2144880308,2,126,63,1361723494748,1361723498780,2144874056,2144878088,4032
1361723517,2144896288,2,126,63,1361723514288,1361723515248,2144893576,2144894536,960
1361723525,2144904272,2,126,63,1361723517311,1361723521343,2144896583,2144900615,4032
1361723532,2144910992,1,63,63,1361723507096,1361723507096,2144886088,2144886088,0
1361723556,2144935020,1,63,63,1361723529659,1361723529659,2144908679,2144908679,0
1361723573,2144952332,3,189,63,1361723569477,1361723572485,2144948809,2144951817,3008
1361723589,2144968336,2,126,63,1361723576512,1361723584576,2144955848,2144963912,8064
1361723676,2145055196,1,46,46,1361723651080,1361723651080,2145030276,2145030276,0
1361724172,2145551712,1,46,46,1361724145660,1361724145660,2145525372,2145525372,0
1361724689,2146068512,1,46,46,1361724664255,1361724664255,2146043767,2146043767,0
1361724733,2146112520,1,46,46,1361724708471,1361724708471,2146087991,2146087991,0
1361724806,2146185184,11,953,86.63636364,1361724788805,1361724798789,2146167989,2146177973,9984
1361724806,2146185184,12,999,83.25,1361724788549,1361724798789,2146167733,2146177973,10240
1361724806,2146185256,12,999,83.25,1361724788987,1361724798715,2146168243,2146177971,9728
1361724822,2146201132,11,953,86.63636364,1361724806008,1361724817848,2146185140,2146196980,11840
1361724822,2146201140,11,953,86.63636364,1361724806510,1361724817838,2146185650,2146196978,11328
1361724822,2146201140,12,999,83.25,1361724805745,1361724817841,2146184885,2146196981,12096
1361724822,2146201172,12,999,83.25,1361724806224,1361724817808,2146185396,2146196980,11584
1361725455,2146834060,2,122,61,1361725429494,1361725429750,2146808554,2146808810,256
1361725710,2147089716,12,999,83.25,1361725693924,1361725703076,2147073640,2147082792,9152
1361725711,2147089760,11,953,86.63636364,1361725694622,1361725704030,2147073382,2147082790,9408
1361725735,2147114504,9,861,95.66666667,1361725710388,1361725710580,2147089892,2147090084,192
1361725735,2147114556,9,861,95.66666667,1361725710592,1361725710784,2147090148,2147090340,192
1361725739,2147118500,9,861,95.66666667,1361725710970,1361725711098,2147090470,2147090598,128
1361725739,2147118552,9,861,95.66666667,1361725711176,1361725711368,2147090728,2147090920,192
1361725943,2147321888,4,252,63,1361725934042,1361725941146,2147312930,2147320034,7104
1361725976,2147354760,1,63,63,1361725949276,1361725949276,2147328036,2147328036,0
1361725983,2147361964,3,189,63,1361725978382,1361725981454,2147357346,2147360418,3072
1361725999,2147377888,2,126,63,1361725985497,1361725993561,2147364385,2147372449,8064
1361726015,2147393904,3,189,63,1361726010248,1361726013256,2147389152,2147392160,3008
1361726031,2147410000,3,189,63,1361726027178,1361726030250,2147406178,2147409250,3072
1361726031,2147410012,2,126,63,1361726017182,1361726025246,2147396194,2147404258,8064
1361726047,2147426016,2,126,63,1361726034203,1361726042267,2147413219,2147421283,8064
1361726457,2147835852,3,444,148,1361726431417,1361726437433,2147810269,2147816285,6016
1361727070,2148449556,3,444,148,1361727043437,1361727049453,2148422993,2148429009,6016
1361727520,2148898956,11,953,86.63636364,1361727504576,1361727514432,2148883532,2148893388,9856
1361727520,2148898996,17,6755,397.3529412,1361727503577,1361727514457,2148882573,2148893453,10880
1361727520,2148898996,12,999,83.25,1361727503959,1361727514455,2148882955,2148893451,10496
1361727520,2148898996,12,999,83.25,1361727504214,1361727514390,2148883210,2148893386,10176
1361727524,2148902852,1,46,46,1361727498662,1361727498662,2148877514,2148877514,0
1361727557,2148936128,1,48,48,1361727531539,1361727531539,2148910667,2148910667,0
1361727557,2148936160,1,48,48,1361727531506,1361727531506,2148910666,2148910666,0
1361728129,2149507920,1,46,46,1361728103002,1361728103002,2149481922,2149481922,0
1361728297,2149675808,3,444,148,1361728270407,1361728276487,2149649215,2149655295,6080
1361728846,2150225328,1,46,46,1361728820342,1361728820342,2150199670,2150199670,0
1361728910,2150289640,3,444,148,1361728882047,1361728888063,2150261687,2150267703,6016
1361729328,2150706776,9,861,95.66666667,1361729303385,1361729303577,2150682161,2150682353,192
1361729328,2150706844,13,6234,479.5384615,1361729302294,1361729302614,2150681138,2150681458,320
1361729328,2150706848,9,861,95.66666667,1361729302671,1361729302927,2150681519,2150681775,256
1361729328,2150706852,9,861,95.66666667,1361729302990,1361729303182,2150681842,2150682034,192
1361729514,2150893200,3,189,63,1361729510189,1361729513197,2150889389,2150892397,3008
1361729522,2150901160,2,126,63,1361729519251,1361729520275,2150898411,2150899435,1024
1361729530,2150909096,2,126,63,1361729522323,1361729526355,2150901419,2150905451,4032
1361729530,2150909144,2,126,63,1361729517284,1361729525284,2150896428,2150904428,8000
1361729546,2150925188,3,189,63,1361729541751,1361729544759,2150920939,2150923947,3008
1361729560,2150939080,1,63,63,1361729534438,1361729534438,2150913518,2150913518,0
1361729562,2150941100,3,189,63,1361729556750,1361729559758,2150935850,2150938858,3008
1361729562,2150941100,2,126,63,1361729548881,1361729556945,2150927981,2150936045,8064
1361729578,2150957152,2,126,63,1361729563741,1361729571805,2150942893,2150950957,8064
1361730133,2151512444,3,444,148,1361730107694,1361730113774,2151487138,2151493218,6080
1361731043,2152422712,1,46,46,1361731018261,1361731018261,2152397973,2152397973,0
1361731120,2152498808,14,6617,472.6428571,1361731093789,1361731094109,2152472597,2152472917,320
1361731120,2152498808,9,861,95.66666667,1361731094171,1361731094363,2152472979,2152473171,192
1361731120,2152498896,8,815,101.875,1361731094341,1361731094533,2152473237,2152473429,192
1361731136,2152515048,1,46,46,1361731111470,1361731111470,2152490518,2152490518,0
1361731307,2152686500,3,189,63,1361731302885,1361731305893,2152682385,2152685393,3008
1361731323,2152702552,4,218,54.5,1361731309873,1361731318705,2152689425,2152698257,8832
1361731323,2152702556,3,138,46,1361731318703,1361731318767,2152698259,2152698323,64
1361731344,2152723416,2,109,54.5,1361731318843,1361731318843,2152698259,2152698259,0
1361731344,2152723488,3,152,50.66666667,1361731318128,1361731319664,2152697616,2152699152,1536
1361731348,2152727364,8,815,101.875,1361731320620,1361731320812,2152699984,2152700176,192
1361731348,2152727372,9,861,95.66666667,1361731321124,1361731321316,2152700496,2152700688,192
1361731348,2152727444,9,861,95.66666667,1361731320285,1361731320477,2152699729,2152699921,192
1361731348,2152727452,9,861,95.66666667,1361731320790,1361731320982,2152700242,2152700434,192
1361731360,2152739492,3,444,148,1361731333867,1361731339883,2152713359,2152719375,6016
1361731571,2152950700,2,126,63,1361731569307,1361731570267,2152949007,2152949967,960
1361731579,2152958664,4,252,63,1361731570623,1361731577663,2152950287,2152957327,7040
1361731579,2152958692,2,126,63,1361731572323,1361731576355,2152952015,2152956047,4032
1361731580,2152958728,3,189,63,1361731576550,1361731579558,2152955278,2152958286,3008
1361731596,2152974748,2,126,63,1361731583570,1361731591570,2152962318,2152970318,8000
1361731613,2152991992,1,63,63,1361731586398,1361731586398,2152965390,2152965390,0
1361731613,2152992028,1,63,63,1361731585018,1361731585018,2152964046,2152964046,0
1361731660,2153038760,3,189,63,1361731653061,1361731656133,2153031821,2153034893,3072
1361731675,2153054692,2,126,63,1361731659169,1361731667233,2153038861,2153046925,8064
1361731974,2153352780,3,444,148,1361731947117,1361731953197,2153325897,2153331977,6080
1361732468,2153847180,11,953,86.63636364,1361732454100,1361732463764,2153833280,2153842944,9664
1361732468,2153847228,17,6755,397.3529412,1361732453668,1361732463716,2153832896,2153842944,10048
1361732468,2153847232,12,999,83.25,1361732454305,1361732463649,2153833537,2153842881,9344
1361732468,2153847252,12,999,83.25,1361732454605,1361732463629,2153833857,2153842881,9024
1361732704,2154082788,1,48,48,1361732679065,1361732679065,2154057853,2154057853,0
1361732784,2154163208,1,78,78,1361732758771,1361732758771,2154137979,2154137979,0
1361732916,2154295632,1,78,78,1361732888651,1361732888651,2154268283,2154268283,0
1361733169,2154548144,3,138,46,1361733141550,1361733150638,2154520694,2154529782,9088
1361733197,2154576616,3,444,148,1361733169747,1361733175763,2154549363,2154555379,6016
1361734001,2155380504,1,46,46,1361733971449,1361733971449,2155350953,2155350953,0
1361734001,2155380544,1,46,46,1361733971535,1361733971535,2155351079,2155351079,0
1361734030,2155408828,11,953,86.63636364,1361734014108,1361734024156,2155392936,2155402984,10048
1361734030,2155408836,12,999,83.25,1361734014423,1361734024151,2155393259,2155402987,9728
1361734030,2155408880,12,999,83.25,1361734014632,1361734024104,2155393512,2155402984,9472
1361734056,2155434828,8,815,101.875,1361734031452,1361734031644,2155410280,2155410472,192
1361734056,2155434832,9,861,95.66666667,1361734031769,1361734031897,2155410601,2155410729,128
1361734056,2155434912,9,861,95.66666667,1361734030856,1361734031048,2155409768,2155409960,192
1361734056,2155434912,9,861,95.66666667,1361734031111,1361734031303,2155410023,2155410215,192
1361734222,2155600940,4,252,63,1361734214120,1361734221160,2155593060,2155600100,7040
1361734256,2155635320,1,63,63,1361734228846,1361734228846,2155608166,2155608166,0
1361734302,2155680932,2,126,63,1361734299378,1361734300402,2155678310,2155679334,1024
1361734302,2155680932,2,126,63,1361734299442,1361734300402,2155678374,2155679334,960
1361734310,2155688928,2,126,63,1361734302453,1361734306421,2155681381,2155685349,3968
1361734310,2155688928,2,126,63,1361734302452,1361734306484,2155681380,2155685412,4032
1361734340,2155719668,1,63,63,1361734313743,1361734313743,2155693411,2155693411,0
1361734340,2155719668,1,63,63,1361734313807,1361734313807,2155693475,2155693475,0
1361734358,2155736984,2,126,63,1361734355133,1361734356157,2155734117,2155735141,1024
1361734366,2155744944,2,126,63,1361734358244,1361734362276,2155737188,2155741220,4032
1361734397,2155775728,1,63,63,1361734370492,1361734370492,2155749220,2155749220,0
1361734473,2155852072,2,120,60,1361734446818,1361734449826,2155825890,2155828898,3008
1361734857,2156236432,1,48,48,1361734831988,1361734831988,2156211420,2156211420,0
1361735218,2156597424,1,46,46,1361735192247,1361735192247,2156571671,2156571671,0
1361735299,2156678688,1,46,46,1361735271279,1361735271279,2156650967,2156650967,0
1361735300,2156679916,1,46,46,1361735271114,1361735271114,2156651030,2156651030,0
1361735687,2157066144,1,46,46,1361735659142,1361735659142,2157038286,2157038286,0
1361735823,2157202420,2,92,46,1361735820208,1361735820208,2157199628,2157199628,0
1361735823,2157202484,2,92,46,1361735820144,1361735820144,2157199628,2157199628,0
1361735823,2157202488,2,92,46,1361735820140,1361735820140,2157199628,2157199628,0
1361735823,2157202488,2,92,46,1361735820140,1361735820140,2157199628,2157199628,0
1361735839,2157218436,12,999,83.25,1361735821666,1361735833314,2157201102,2157212750,11648
1361735839,2157218440,12,999,83.25,1361735821916,1361735833308,2157201356,2157212748,11392
1361735839,2157218444,11,953,86.63636364,1361735822170,1361735833306,2157201614,2157212750,11136
1361735839,2157218484,16,6372,398.25,1361735821169,1361735833265,2157200653,2157212749,12096
1361736664,2158042808,17,6755,397.3529412,1361736646153,1361736656841,2158024961,2158035649,10688
1361736664,2158042812,12,999,83.25,1361736646788,1361736656772,2158025600,2158035584,9984
1361736664,2158042864,12,999,83.25,1361736646483,1361736656787,2158025347,2158035651,10304
1361736690,2158069076,8,815,101.875,1361736663676,1361736663868,2158042752,2158042944,192
1361736690,2158069084,9,861,95.66666667,1361736663925,1361736664117,2158043009,2158043201,192
1361736690,2158069116,9,861,95.66666667,1361736664148,1361736664340,2158043264,2158043456,192
1361736690,2158069148,9,861,95.66666667,1361736664499,1361736664627,2158043647,2158043775,128
1361736904,2158282976,3,189,63,1361736896988,1361736899996,2158275964,2158278972,3008
1361736920,2158299004,2,126,63,1361736917313,1361736918337,2158296317,2158297341,1024
1361736920,2158299016,2,126,63,1361736903989,1361736912053,2158283005,2158291069,8064
1361736928,2158307156,2,126,63,1361736920169,1361736924201,2158299325,2158303357,4032
1361736959,2158337876,1,63,63,1361736932545,1361736932545,2158311421,2158311421,0
1361736976,2158355088,3,189,63,1361736969067,1361736972075,2158348155,2158351163,3008
1361736992,2158371080,2,126,63,1361736976114,1361736984178,2158355194,2158363258,8064
1361736997,2158376348,1,46,46,1361736968423,1361736968423,2158347771,2158347771,0
1361736997,2158376356,1,46,46,1361736968418,1361736968418,2158347774,2158347774,0
1361737008,2158387012,4,252,63,1361737000185,1361737007289,2158379197,2158386301,7104
1361737043,2158421868,1,63,63,1361737015496,1361737015496,2158394364,2158394364,0
1361738028,2159406920,1,46,46,1361737999876,1361737999876,2159378796,2159378796,0
1361738028,2159406928,1,46,46,1361737999932,1361737999932,2159378860,2159378860,0
1361738458,2159837420,2,92,46,1361738450249,1361738450249,2159829669,2159829669,0
1361738458,2159837420,2,92,46,1361738450313,1361738450313,2159829733,2159829733,0
1361738458,2159837420,2,92,46,1361738450313,1361738450313,2159829733,2159829733,0
1361738458,2159837420,2,92,46,1361738450312,1361738450312,2159829732,2159829732,0
1361738478,2159856808,13,6234,479.5384615,1361738451951,1361738452335,2159830759,2159831143,384
1361738478,2159856812,9,861,95.66666667,1361738452395,1361738452587,2159831207,2159831399,192
1361738478,2159856812,9,861,95.66666667,1361738452648,1361738452840,2159831460,2159831652,192
1361738478,2159856932,9,861,95.66666667,1361738452785,1361738452977,2159831717,2159831909,192
1361738514,2159892888,1,46,46,1361738489756,1361738489756,2159868644,2159868644,0
1361738514,2159892976,1,46,46,1361738488261,1361738488261,2159867237,2159867237,0
1361738666,2160045696,3,189,63,1361738660916,1361738663924,2160040612,2160043620,3008
1361738682,2160061644,2,126,63,1361738668008,1361738676008,2160047652,2160055652,8000
1361738690,2160069624,3,189,63,1361738683961,1361738687033,2160063585,2160066657,3072
1361738706,2160085640,2,126,63,1361738691052,1361738699052,2160070692,2160078692,8000
1361738714,2160093628,4,252,63,1361738706679,1361738713719,2160086307,2160093347,7040
1361738731,2160109700,3,189,63,1361738725844,1361738728916,2160104544,2160107616,3072
1361738746,2160125644,2,126,63,1361738731942,1361738740006,2160111586,2160119650,8064
1361738750,2160129052,1,63,63,1361738722359,1361738722359,2160101411,2160101411,0
1361739050,798743624,2,128,64,1361739023211,1361739024171,798716835,798717795,960
1361739050,798743760,2,128,64,1361739024101,1361739025125,798717861,798718885,1024
1361739363,2160742248,14,6617,472.6428571,1361739336808,1361739337128,2160716056,2160716376,320
1361739363,2160742256,9,861,95.66666667,1361739337182,1361739337374,2160716438,2160716630,192
1361739363,2160742344,9,861,95.66666667,1361739337352,1361739337544,2160716696,2160716888,192
1361739363,2160742368,8,815,101.875,1361739337584,1361739337776,2160716952,2160717144,192
1361739660,2161039164,3,189,63,1361739656758,1361739659766,2161035922,2161038930,3008
1361739660,2161039208,3,189,63,1361739656587,1361739659659,2161035795,2161038867,3072
1361739660,2161039228,3,189,63,1361739656569,1361739659577,2161035797,2161038805,3008
1361739668,2161047164,3,189,63,1361739662327,1361739665335,2161041491,2161044499,3008
1361739676,2161055172,2,126,63,1361739663793,1361739671857,2161042965,2161051029,8064
1361739676,2161055220,2,126,63,1361739663614,1361739671678,2161042834,2161050898,8064
1361739676,2161055224,2,126,63,1361739663678,1361739671678,2161042902,2161050902,8000
1361739684,2161063252,2,126,63,1361739669280,1361739677344,2161048532,2161056596,8064
1361740223,2161602308,1,46,46,1361740195552,1361740195552,2161574860,2161574860,0
1361740223,2161602380,1,46,46,1361740195608,1361740195608,2161574988,2161574988,0
1361740465,2161844180,1,46,46,1361740438876,1361740438876,2161818056,2161818056,0
1361740645,2162024580,2,120,60,1361740619272,1361740620296,2161998852,2161999876,1024
1361740649,2162028560,2,120,60,1361740621340,1361740622300,2162000900,2162001860,960
1361740790,2162168776,1,445,445,1361740763115,1361740763115,2162141891,2162141891,0
1361740794,2162172716,1,445,445,1361740768997,1361740768997,2162147713,2162147713,0
1361741142,2162521624,16,6372,398.25,1361741127508,1361741138260,2162507132,2162517884,10752
1361741142,2162521624,12,999,83.25,1361741127893,1361741138261,2162507517,2162517885,10368
1361741142,2162521628,11,953,86.63636364,1361741128208,1361741138256,2162507836,2162517884,10048
1361741817,2163195868,1,48,48,1361741791742,1361741791742,2163170610,2163170610,0
1361741817,2163195876,1,48,48,1361741791928,1361741791928,2163170804,2163170804,0
1361742365,2163744096,2,122,61,1361742339985,1361742342097,2163719081,2163721193,2112
1361742447,2163826680,44,56507,1284.25,1361742439690,1361742440138,2163819370,2163819818,448
1361742455,802148464,8,7208,901,1361742442596,1361742454564,802136060,802148028,11968
1361742455,802148480,7,4810,687.1428571,1361742442577,1361742454545,802136057,802148025,11968
1361742455,2163834616,13,1045,80.38461538,1361742440971,1361742452043,2163820587,2163831659,11072
1361742455,2163834652,12,999,83.25,1361742442855,1361742451047,2163822507,2163830699,8192
1361742455,2163834660,15,6326,421.7333333,1361742440350,1361742450974,2163820010,2163830634,10624
1361742455,2163834668,12,999,83.25,1361742441239,1361742451031,2163820907,2163830699,9792
1361742456,2163834700,17,7121,418.8823529,1361742443296,1361742455328,2163821996,2163834028,12032
1361742456,2163834700,18,6972,387.3333333,1361742440672,1361742451936,2163819372,2163830636,11264
1361742465,2163844604,1,46,46,1361742440534,1361742440534,2163820138,2163820138,0
1361742465,2163844676,1,46,46,1361742439694,1361742439694,2163819370,2163819370,0
1361742658,2164036748,2,122,61,1361742633130,1361742636522,2164011878,2164015270,3392
1361743323,2164702092,2,96,48,1361743296777,1361743302793,2164675869,2164681885,6016
1361744277,2165656336,12,6151,512.5833333,1361744250502,1361744250886,2165629838,2165630222,384
1361744277,2165656348,9,861,95.66666667,1361744251513,1361744251641,2165630861,2165630989,128
1361744277,2165656432,8,815,101.875,1361744250855,1361744251047,2165630287,2165630479,192
1361744277,2165656456,8,815,101.875,1361744251086,1361744251278,2165630542,2165630734,192
1361744482,2165861096,3,189,63,1361744477938,1361744480946,2165857034,2165860042,3008
1361744498,2165877164,2,126,63,1361744484911,1361744492975,2165864075,2165872139,8064
1361744571,2165950216,1,52,52,1361744545146,1361744545146,2165924362,2165924362,0
1361744572,2165950824,1,52,52,1361744545730,1361744545730,2165924554,2165924554,0
1361744595,2165973748,3,189,63,1361744588111,1361744591183,2165966859,2165969931,3072
1361744595,2165973748,3,189,63,1361744588111,1361744591183,2165966859,2165969931,3072
1361744595,2165973748,3,189,63,1361744588239,1361744591247,2165966987,2165969995,3008
1361744611,2165989772,2,126,63,1361744595188,1361744603188,2165973960,2165981960,8000
1361744611,2165989772,2,126,63,1361744595188,1361744603188,2165973960,2165981960,8000
1361744611,2165989776,2,126,63,1361744595248,1361744603312,2165974024,2165982088,8064
1361744623,2166002100,1,52,52,1361744597357,1361744597357,2165976457,2165976457,0
1361744623,2166002128,1,52,52,1361744597457,1361744597457,2165976585,2165976585,0
1361744760,2166138772,1,48,48,1361744732404,1361744732404,2166111176,2166111176,0
1361744863,2166242164,11,4651,422.8181818,1361744838633,1361744838953,2166217797,2166218117,320
1361744867,2166246084,9,861,95.66666667,1361744839099,1361744839291,2166218183,2166218375,192
1361744867,2166246224,9,861,95.66666667,1361744839213,1361744839405,2166218437,2166218629,192
1361745052,2166430908,3,189,63,1361745047014,1361745050022,2166425922,2166428930,3008
1361745068,2166446896,2,126,63,1361745054068,1361745062132,2166432964,2166441028,8064
1361745092,2166471016,4,252,63,1361745083836,1361745090876,2166462852,2166469892,7040
1361745124,2166502760,1,63,63,1361745099130,1361745099130,2166477890,2166477890,0
1361745132,2166511036,2,126,63,1361745130019,1361745131043,2166509055,2166510079,1024
1361745140,2166519000,2,126,63,1361745133066,1361745137098,2166512066,2166516098,4032
1361745172,2166551320,1,63,63,1361745144841,1361745144841,2166524161,2166524161,0
1361745264,2166643220,8,815,101.875,1361745236522,1361745236714,2166615742,2166615934,192
1361745441,2166819796,1,439,439,1361745413327,1361745413327,2166792123,2166792123,0
1361745509,2166887988,9,861,95.66666667,1361745484433,1361745484625,2166863421,2166863613,192
1361745509,2166888016,9,861,95.66666667,1361745484661,1361745484853,2166863677,2166863869,192
1361745509,2166888068,8,815,101.875,1361745484095,1361745484287,2166863163,2166863355,192
1361745513,2166891984,9,861,95.66666667,1361745484949,1361745485141,2166863933,2166864125,192
1361745548,2166927064,3,189,63,1361745541955,1361745544963,2166921019,2166924027,3008
1361745564,2166943064,2,126,63,1361745548994,1361745557058,2166928058,2166936122,8064
1361745692,2167071156,2,126,63,1361745689318,1361745690342,2167068474,2167069498,1024
1361745700,2167079252,2,126,63,1361745692227,1361745696259,2167071479,2167075511,4032
1361745729,2167108488,1,63,63,1361745704089,1361745704089,2167083577,2167083577,0
1361745764,2167143208,3,189,63,1361745759152,1361745762160,2167138360,2167141368,3008
1361745780,2167159208,2,126,63,1361745766193,1361745774257,2167145401,2167153465,8064
1361745812,2167191224,3,189,63,1361745807326,1361745810334,2167186550,2167189558,3008
1361745820,2167199304,3,189,63,1361745813008,1361745816080,2167192312,2167195384,3072
1361745828,2167207228,2,126,63,1361745814365,1361745822429,2167193593,2167201657,8064
1361745836,2167215264,2,126,63,1361745820152,1361745828152,2167199416,2167207416,8000
1361746070,2167449420,1,46,46,1361746044888,1361746044888,2167424308,2167424308,0
1361746460,2167839196,1,48,48,1361746432239,1361746432239,2167811435,2167811435,0
1361746461,2167840044,1,48,48,1361746432393,1361746432393,2167811437,2167811437,0
1361746724,2168102860,1,60,60,1361746698559,1361746698559,2168077419,2168077419,0
1361746732,2168110788,1,60,60,1361746705157,1361746705157,2168083945,2168083945,0
1361746740,2168118760,1,60,60,1361746711971,1361746711971,2168090731,2168090731,0
1361746744,2168122704,1,60,60,1361746718363,1361746718363,2168097067,2168097067,0
1361746905,2168283768,1,48,48,1361746876885,1361746876885,2168255653,2168255653,0
1361747045,2168424124,11,953,86.63636364,1361747036145,1361747043057,2168415269,2168422181,6912
1361747064,2168443520,9,861,95.66666667,1361747036005,1361747036645,2168415525,2168416165,640
1361747064,2168443524,9,861,95.66666667,1361747036704,1361747036960,2168416228,2168416484,256
1361747285,2168664340,3,189,63,1361747279638,1361747282710,2168658978,2168662050,3072
1361747301,2168680416,2,126,63,1361747286665,1361747294665,2168666081,2168674081,8000
1361747389,2168768524,3,189,63,1361747382620,1361747385628,2168762144,2168765152,3008
1361747405,2168784532,2,126,63,1361747389649,1361747397713,2168769181,2168777245,8064
1361747810,2169189340,1,46,46,1361747784078,1361747784078,2169163418,2169163418,0
1361748861,2170239984,9,861,95.66666667,1361748834913,1361748835105,2170213897,2170214089,192
1361748861,2170240068,11,1290,117.2727273,1361748835086,1361748836942,2170214154,2170216010,1856
1361749071,2170450436,3,189,63,1361749064283,1361749067355,2170443719,2170446791,3072
1361749087,2170466480,2,126,63,1361749071342,1361749079342,2170450822,2170458822,8000
1361749095,2170474436,3,189,63,1361749090778,1361749093850,2170470214,2170473286,3072
1361749111,2170490448,2,126,63,1361749097868,1361749105868,2170477316,2170485316,8000
1361749150,2170528716,9,861,95.66666667,1361749123176,1361749123752,2170501892,2170502468,576
1361749150,2170528952,8,815,101.875,1361749124095,1361749124287,2170503047,2170503239,192
1361749150,2170529196,8,815,101.875,1361749123336,1361749123528,2170502532,2170502724,192
1361749150,2170529236,8,815,101.875,1361749123552,1361749123744,2170502788,2170502980,192
1361749407,2170786656,3,189,63,1361749403449,1361749406521,2170783105,2170786177,3072
1361749423,2170802624,2,126,63,1361749410587,1361749418587,2170790211,2170798211,8000
1361749463,2170842640,3,189,63,1361749459335,1361749462343,2170838975,2170841983,3008
1361749463,2170842640,3,189,63,1361749459335,1361749462343,2170838975,2170841983,3008
1361749463,2170842644,3,189,63,1361749459398,1361749462406,2170839042,2170842050,3008
1361749479,2170858656,2,126,63,1361749466423,1361749474487,2170846079,2170854143,8064
1361749480,2170858700,2,126,63,1361749467317,1361749475381,2170846017,2170854081,8064
1361749480,2170858700,2,126,63,1361749467316,1361749475380,2170846016,2170854080,8064
1361750657,2172036480,10,907,90.7,1361750629398,1361750630038,2172008878,2172009518,640
1361750657,2172036488,9,861,95.66666667,1361750630157,1361750630285,2172009645,2172009773,128
1361750657,2172036564,14,6617,472.6428571,1361750628932,1361750629316,2172008496,2172008880,384
1361750857,2172236372,3,138,46,1361750849471,1361750849535,2172228843,2172228907,64
1361750857,2172236412,4,218,54.5,1361750848216,1361750849432,2172227628,2172228844,1216
1361750857,2172236416,3,138,46,1361750849428,1361750849492,2172228844,2172228908,64
1361750878,2172256956,8,815,101.875,1361750852829,1361750853021,2172231785,2172231977,192
1361750878,2172257024,9,861,95.66666667,1361750851482,1361750851674,2172230506,2172230698,192
1361750878,2172257028,8,815,101.875,1361750851735,1361750852439,2172230763,2172231467,704
1361750878,2172257036,9,861,95.66666667,1361750852493,1361750852685,2172231529,2172231721,192
1361751129,2172508580,3,189,63,1361751121898,1361751124906,2172501478,2172504486,3008
1361751129,2172508648,3,189,63,1361751121830,1361751124838,2172501478,2172504486,3008
1361751146,2172524688,2,126,63,1361751129832,1361751137896,2172508520,2172516584,8064
1361751146,2172524728,2,126,63,1361751129791,1361751137855,2172508519,2172516583,8064
1361751154,2172532772,3,189,63,1361751148561,1361751151633,2172527333,2172530405,3072
1361751170,2172548716,2,126,63,1361751155658,1361751163722,2172534374,2172542438,8064
1361751178,2172556840,4,252,63,1361751169103,1361751176143,2172547943,2172554983,7040
1361751211,2172590048,1,63,63,1361751183997,1361751183997,2172563045,2172563045,0
1361752450,2173829100,1,46,46,1361752422582,1361752422582,2173801682,2173801682,0
1361752450,2173829100,14,6617,472.6428571,1361752422646,1361752422966,2173801746,2173802066,320
1361752450,2173829108,8,815,101.875,1361752423025,1361752423153,2173802133,2173802261,128
1361752450,2173829132,9,861,95.66666667,1361752423510,1361752423702,2173802642,2173802834,192
1361752450,2173829220,9,861,95.66666667,1361752423165,1361752423357,2173802385,2173802577,192
1361752683,2174062276,3,189,63,1361752679237,1361752682309,2174058513,2174061585,3072
1361752683,2174062276,3,189,63,1361752679300,1361752682308,2174058576,2174061584,3008
1361752691,2174070192,3,189,63,1361752684374,1361752687382,2174063566,2174066574,3008
1361752699,2174078244,2,126,63,1361752686371,1361752694435,2174065615,2174073679,8064
1361752699,2174078248,2,126,63,1361752686305,1361752694369,2174065553,2174073617,8064
1361752707,2174086228,2,126,63,1361752691379,1361752699443,2174070607,2174078671,8064
1361752707,2174086316,4,252,63,1361752697948,1361752704988,2174077264,2174084304,7040
1361752739,2174117968,1,63,63,1361752713398,1361752713398,2174092366,2174092366,0
1361752763,2174142452,1,46,46,1361752738388,1361752738388,2174117840,2174117840,0
1361752764,2174142924,1,46,46,1361752738917,1361752738917,2174117841,2174117841,0
1361752963,2174342288,1,60,60,1361752937074,1361752937074,2174316362,2174316362,0
1361752979,2174358244,1,60,60,1361752952414,1361752952414,2174331658,2174331658,0
1361753516,2174895232,12,999,83.25,1361753504164,1361753513828,2174883396,2174893060,9664
1361753516,2174895272,12,999,83.25,1361753503612,1361753513788,2174882884,2174893060,10176
1361753516,2174895272,11,953,86.63636364,1361753503866,1361753513786,2174883138,2174893058,9920
1361753668,2175047428,16,6372,398.25,1361753654622,1361753666718,2175034050,2175046146,12096
1361753668,2175047484,11,953,86.63636364,1361753654951,1361753666663,2175034435,2175046147,11712
1361753668,2175047488,12,999,83.25,1361753655712,1361753666656,2175035200,2175046144,10944
1361753668,2175047488,12,999,83.25,1361753656032,1361753666656,2175035520,2175046144,10624
1361753693,2175072200,11,3267,297,1361753665154,1361753665602,2175044354,2175044802,448
1361753748,2175127456,3,193,64.33333333,1361753739903,1361753739903,2175119359,2175119359,0
1361753769,2175148204,8,815,101.875,1361753743933,1361753744125,2175123137,2175123329,192
1361753769,2175148224,9,861,95.66666667,1361753744166,1361753744422,2175123390,2175123646,256
1361753769,2175148280,8,815,101.875,1361753743278,1361753743470,2175122558,2175122750,192
1361753769,2175148284,8,815,101.875,1361753743531,1361753743723,2175122815,2175123007,192
1361753853,2175231704,3,138,46,1361753849198,1361753849262,2175227902,2175227966,64
1361753853,2175231752,3,138,46,1361753849151,1361753849215,2175227903,2175227967,64
1361753853,2175231752,3,138,46,1361753849151,1361753849215,2175227903,2175227967,64
1361753853,2175231752,3,138,46,1361753849150,1361753849214,2175227902,2175227966,64
1361754557,2175936392,17,6755,397.3529412,1361754544242,1361754553458,2175923634,2175932850,9216
1361754557,2175936460,12,999,83.25,1361754544814,1361754553390,2175924274,2175932850,8576
1361754586,2175965340,9,861,95.66666667,1361754561639,1361754561831,2175940979,2175941171,192
1361754586,2175965416,9,861,95.66666667,1361754560732,1361754560924,2175940148,2175940340,192
1361754586,2175965424,8,815,101.875,1361754561300,1361754561428,2175940724,2175940852,128
1361754586,2175965424,8,815,101.875,1361754561044,1361754561172,2175940468,2175940596,128
1361754846,2176224756,4,252,63,1361754836969,1361754844009,2176215725,2176222765,7040
1361754879,2176258020,1,63,63,1361754851810,1361754851810,2176230830,2176230830,0
1361754894,2176272680,2,126,63,1361754891320,1361754892280,2176270000,2176270960,960
1361754894,2176272732,2,126,63,1361754891204,1361754892228,2176269936,2176270960,1024
1361754902,2176280688,2,126,63,1361754894253,1361754898285,2176272941,2176276973,4032
1361754902,2176280740,2,126,63,1361754894265,1361754898297,2176273005,2176277037,4032
1361754902,2176280776,4,252,63,1361754893397,1361754900501,2176272173,2176279277,7104
1361754931,2176310136,1,63,63,1361754905902,1361754905902,2176285038,2176285038,0
1361754931,2176310136,1,63,63,1361754905965,1361754905965,2176285101,2176285101,0
1361754935,2176314228,1,63,63,1361754908050,1361754908050,2176287278,2176287278,0
1361754963,2176342500,3,144,48,1361754938176,1361754947200,2176317676,2176326700,9024
1361756066,2177444808,1,46,46,1361756041127,1361756041127,2177419935,2177419935,0
1361756074,2177453468,1,46,46,1361756046735,1361756046735,2177426203,2177426203,0
1361756075,2177454072,1,46,46,1361756047259,1361756047259,2177426331,2177426331,0
1361756378,2177757212,9,861,95.66666667,1361756353740,1361756353932,2177732952,2177733144,192
1361756378,2177757324,8,815,101.875,1361756353308,1361756353500,2177732632,2177732824,192
1361756382,2177761100,9,861,95.66666667,1361756354108,1361756354364,2177733208,2177733464,256
1361756527,2177905728,3,138,46,1361756523246,1361756523310,2177901974,2177902038,64
1361756527,2177905804,3,138,46,1361756523172,1361756523236,2177901976,2177902040,64
1361756527,2177905804,3,138,46,1361756523171,1361756523235,2177901975,2177902039,64
1361756543,2177921708,12,999,83.25,1361756526402,1361756538242,2177905110,2177916950,11840
1361756543,2177921760,11,953,86.63636364,1361756526092,1361756538188,2177904852,2177916948,12096
1361756543,2177921780,17,6755,397.3529412,1361756526649,1361756538169,2177905429,2177916949,11520
1361756543,2177921784,12,999,83.25,1361756527095,1361756538167,2177905879,2177916951,11072
1361756547,816240104,5,574,114.8,1361756539559,1361756539623,816232663,816232727,64
1361757452,2178830712,3,156,52,1361757424174,1361757433454,2178802886,2178812166,9280
1361757793,2179171736,1,46,46,1361757765011,1361757765011,2179143747,2179143747,0
1361758354,2179732924,9,861,95.66666667,1361758329805,1361758329997,2179708729,2179708921,192
1361758354,2179732928,9,861,95.66666667,1361758329547,1361758329739,2179708475,2179708667,192
1361758358,2179736920,9,861,95.66666667,1361758330066,1361758330258,2179708986,2179709178,192
1361758521,2179900532,3,189,63,1361758514282,1361758517354,2179893814,2179896886,3072
1361758537,2179916540,2,126,63,1361758521381,1361758529381,2179900921,2179908921,8000
1361758577,2179956580,2,92,46,1361758576313,1361758576313,2179955893,2179955893,0
1361758577,2179956628,3,138,46,1361758576204,1361758576332,2179955832,2179955960,128
1361758593,2179972552,12,999,83.25,1361758578584,1361758590040,2179958136,2179969592,11456
1361758593,2179972556,11,953,86.63636364,1361758578836,1361758590036,2179958392,2179969592,11200
1361758593,2179972608,17,6755,397.3529412,1361758577885,1361758589981,2179957493,2179969589,12096
1361758593,2179972612,12,999,83.25,1361758578265,1361758589977,2179957877,2179969589,11712
1361758602,2179981268,2,109,54.5,1361758576628,1361758576628,2179955896,2179955896,0
1361759359,819052420,1,46,46,1361759331067,1361759331067,819024487,819024487,0
1361759833,2181212408,1,46,46,1361759805461,1361759805461,2181184869,2181184869,0
1361760375,2181754368,1,48,48,1361760349493,1361760349493,2181728861,2181728861,0
1361760403,2181782448,11,953,86.63636364,1361760390881,1361760398817,2181770329,2181778265,7936
1361762219,2183597944,9,861,95.66666667,1361762194239,1361762194431,2183573183,2183573375,192
1361762219,2183598060,9,861,95.66666667,1361762194443,1361762194571,2183573503,2183573631,128
1361762223,2183601888,8,815,101.875,1361762194871,1361762194999,2183573759,2183573887,128
1361762416,2183795048,1,46,46,1361762387927,1361762387927,2183766975,2183766975,0
1361762477,2183856408,3,189,63,1361762473195,1361762476267,2183852603,2183855675,3072
1361762493,2183872332,2,126,63,1361762480376,1361762488376,2183859708,2183867708,8000
1361762501,2183880400,4,252,63,1361762493554,1361762500594,2183872954,2183879994,7040
1361762525,2183904376,3,189,63,1361762519498,1361762522570,2183898874,2183901946,3072
1361762536,2183914728,1,63,63,1361762509331,1361762509331,2183888059,2183888059,0
1361762541,2183920376,2,126,63,1361762526602,1361762534666,2183905978,2183914042,8064
1361762784,2184163140,13,6234,479.5384615,1361762758452,1361762758772,2184137592,2184137912,320
1361762784,2184163156,8,815,101.875,1361762759525,1361762759717,2184138681,2184138873,192
1361762784,2184163328,8,815,101.875,1361762758646,1361762758838,2184137974,2184138166,192
1361762784,2184163336,9,861,95.66666667,1361762759089,1361762759281,2184138425,2184138617,192
1361762974,2184352668,3,189,63,1361762970503,1361762973511,2184349171,2184352179,3008
1361762990,2184368668,2,126,63,1361762977546,1361762985610,2184356214,2184364278,8064
1361763046,2184424756,4,252,63,1361763038575,1361763045615,2184417331,2184424371,7040
1361763046,2184424756,4,252,63,1361763038638,1361763045678,2184417394,2184424434,7040
1361763054,2184432708,3,189,63,1361763046880,1361763049952,2184425588,2184428660,3072
1361763070,2184448788,2,126,63,1361763053841,1361763061905,2184432629,2184440693,8064
1361763081,2184459648,1,63,63,1361763053786,1361763053786,2184432434,2184432434,0
1361763081,2184459648,1,63,63,1361763053786,1361763053786,2184432434,2184432434,0
1361763265,2184644024,1,46,46,1361763239713,1361763239713,2184618737,2184618737,0
1361763505,2184884352,1,52,52,1361763478485,1361763478485,2184857837,2184857837,0
1361763666,2185044936,3,441,147,1361763639476,1361763645556,2185018412,2185024492,6080
1361764347,2185726612,14,6617,472.6428571,1361764322626,1361764322882,2185702238,2185702494,256
1361764351,2185730400,9,861,95.66666667,1361764323223,1361764323351,2185702623,2185702751,128
1361764351,2185730520,9,861,95.66666667,1361764323361,1361764323489,2185702881,2185703009,128
1361764544,2185923212,2,126,63,1361764541712,1361764542736,2185920924,2185921948,1024
1361764552,2185931128,2,126,63,1361764544805,1361764548837,2185923933,2185927965,4032
1361764576,2185955188,4,252,63,1361764568042,1361764575082,2185947230,2185954270,7040
1361764584,2185962824,1,63,63,1361764557206,1361764557206,2185936030,2185936030,0
1361764608,2185986972,1,52,52,1361764581695,1361764581695,2185960667,2185960667,0
1361764608,2185987012,1,63,63,1361764583322,1361764583322,2185962334,2185962334,0
1361764632,2186011192,2,92,46,1361764629413,1361764629413,2186008605,2186008605,0
1361764632,2186011264,2,92,46,1361764629341,1361764629341,2186008605,2186008605,0
1361764656,2186035040,2,109,54.5,1361764629563,1361764629627,2186008603,2186008667,64
1361764656,2186035088,8,815,101.875,1361764631178,1361764631370,2186010266,2186010458,192
1361764656,2186035088,8,815,101.875,1361764631437,1361764631629,2186010525,2186010717,192
1361764656,2186035208,9,861,95.66666667,1361764631573,1361764631765,2186010781,2186010973,192
1361764660,2186038912,8,815,101.875,1361764632125,1361764632317,2186011037,2186011229,192
1361764736,2186115600,3,138,46,1361764727818,1361764727882,2186107418,2186107482,64
1361764737,2186115656,3,138,46,1361764728764,1361764728828,2186107420,2186107484,64
1361764737,2186115656,3,138,46,1361764728763,1361764728827,2186107419,2186107483,64
1361764756,2186135352,3,475,158.3333333,1361764728068,1361764728068,2186107420,2186107420,0
1361764756,2186135356,8,815,101.875,1361764728447,1361764728639,2186107803,2186107995,192
1361764756,2186135472,9,861,95.66666667,1361764728073,1361764728201,2186107545,2186107673,128
1361764756,2186135480,9,861,95.66666667,1361764728577,1361764728833,2186108057,2186108313,256
1361764985,2186364120,2,126,63,1361764983591,1361764984615,2186362711,2186363735,1024
1361764993,2186372052,3,189,63,1361764989356,1361764992364,2186368408,2186371416,3008
1361764993,2186372060,2,126,63,1361764986659,1361764990691,2186365719,2186369751,4032
1361765001,2186380096,2,126,63,1361764999039,1361765000063,2186378135,2186379159,1024
1361765009,2186388052,2,126,63,1361765002089,1361765006121,2186381141,2186385173,4032
1361765009,2186388092,2,126,63,1361764996353,1361765004417,2186375445,2186383509,8064
1361765025,2186404292,1,63,63,1361764998522,1361764998522,2186377814,2186377814,0
1361765041,2186419820,1,63,63,1361765014418,1361765014418,2186393238,2186393238,0
1361765049,2186428004,1,46,46,1361765024409,1361765024409,2186403413,2186403413,0
1361765065,2186444280,3,189,63,1361765058948,1361765061956,2186438228,2186441236,3008
1361765081,2186460336,2,126,63,1361765065932,1361765073996,2186445268,2186453332,8064
1361765093,2186471868,2,112,56,1361765066273,1361765066273,2186445141,2186445141,0
1361766139,2187517836,14,6617,472.6428571,1361766112306,1361766112626,2187491142,2187491462,320
1361766139,2187517844,8,815,101.875,1361766113000,1361766113128,2187491844,2187491972,128
1361766139,2187517848,9,861,95.66666667,1361766113252,1361766113444,2187492100,2187492292,192
1361766139,2187517932,1,46,46,1361766112211,1361766112211,2187491143,2187491143,0
1361766139,2187517956,9,861,95.66666667,1361766112568,1361766112760,2187491524,2187491716,192
1361766348,2187727092,3,189,63,1361766342063,1361766345135,2187721155,2187724227,3072
1361766364,2187742888,2,126,63,1361766349307,1361766357371,2187728195,2187736259,8064
1361766420,2187799048,2,126,63,1361766418330,1361766419354,2187797378,2187798402,1024
1361766428,2187807020,2,126,63,1361766421363,1361766425395,2187800383,2187804415,4032
1361766444,2187823008,4,252,63,1361766436031,1361766443071,2187815039,2187822079,7040
1361766444,2187823008,4,252,63,1361766435838,1361766442942,2187814846,2187821950,7104
1361766460,2187838700,1,63,63,1361766433780,1361766433780,2187812480,2187812480,0
1361766476,2187854772,1,63,63,1361766451181,1361766451181,2187829953,2187829953,0
1361766476,2187854884,1,63,63,1361766451261,1361766451261,2187830145,2187830145,0
1361766532,2187910860,1,60,60,1361766506771,1361766506771,2187885631,2187885631,0
1361766544,2187922968,1,60,60,1361766519461,1361766519461,2187898429,2187898429,0
1361766580,2187958832,3,441,147,1361766552816,1361766558832,2187931648,2187937664,6016
1361767321,2188700060,1,46,46,1361767294784,1361767294784,2188673844,2188673844,0
1361767362,2188741404,1,46,46,1361767334117,1361767334117,2188713521,2188713521,0
1361767362,2188741436,1,46,46,1361767334215,1361767334215,2188713651,2188713651,0
1361767930,2189309156,14,6617,472.6428571,1361767903126,1361767903446,2189282282,2189282602,320
1361767930,2189309184,9,861,95.66666667,1361767903480,1361767903672,2189282664,2189282856,192
1361767930,2189309188,9,861,95.66666667,1361767903732,1361767903924,2189282920,2189283112,192
1361767930,2189309296,9,861,95.66666667,1361767903881,1361767904073,2189283177,2189283369,192
1361767960,2189338724,1,48,48,1361767932997,1361767932997,2189311721,2189311721,0
1361767960,2189338756,1,48,48,1361767932964,1361767932964,2189311720,2189311720,0
1361768095,2189474416,3,189,63,1361768091663,1361768094671,2189471079,2189474087,3008
1361768103,2189482456,2,126,63,1361768100969,1361768101929,2189480425,2189481385,960
1361768111,2189490484,2,126,63,1361768098633,1361768106697,2189478117,2189486181,8064
1361768111,2189490508,2,126,63,1361768103922,1361768107954,2189483430,2189487462,4032
1361768135,2189514424,3,189,63,1361768128711,1361768131719,2189508135,2189511143,3008
1361768143,2189521732,1,63,63,1361768116793,1361768116793,2189495525,2189495525,0
1361768151,2189530416,2,126,63,1361768135759,1361768143823,2189515175,2189523239,8064
1361768159,2189538468,3,189,63,1361768154201,1361768157209,2189533669,2189536677,3008
1361768175,2189554500,2,126,63,1361768161211,1361768169211,2189540711,2189548711,8000
1361768577,2189955784,1,46,46,1361768548352,1361768548352,2189927136,2189927136,0
1361768578,2189957148,1,46,46,1361768547926,1361768547926,2189927074,2189927074,0
1361768964,2190342836,3,162,54,1361768939334,1361768945350,2190318170,2190324186,6016
1361769670,2191049032,3,162,54,1361769643065,1361769649081,2191022097,2191028113,6016
1361769718,2191097000,9,861,95.66666667,1361769692312,1361769692504,2191071312,2191071504,192
1361769718,2191097080,14,6617,472.6428571,1361769691911,1361769692167,2191070991,2191071247,256
1361769718,2191097116,9,861,95.66666667,1361769692515,1361769692707,2191071631,2191071823,192
1361769718,2191097116,9,861,95.66666667,1361769692770,1361769692962,2191071886,2191072078,192
1361769963,2191341868,3,189,63,1361769959765,1361769962837,2191338633,2191341705,3072
1361769979,2191357892,2,126,63,1361769966848,1361769974912,2191345740,2191353804,8064
1361769979,2191357936,2,126,63,1361769977491,1361769978515,2191356427,2191357451,1024
1361769987,2191365876,2,126,63,1361769980622,1361769984654,2191359498,2191363530,4032
1361770018,2191397568,1,63,63,1361769991961,1361769991961,2191371529,2191371529,0
1361770059,2191437936,3,189,63,1361770054160,1361770057168,2191433096,2191436104,3008
1361770075,2191453956,2,126,63,1361770061180,1361770069244,2191440136,2191448200,8064
1361770115,2191493972,4,252,63,1361770106348,1361770113452,2191485320,2191492424,7104
1361770131,2191509632,1,48,48,1361770103168,1361770103168,2191481800,2191481800,0
1361770147,2191525684,1,63,63,1361770121742,1361770121742,2191500426,2191500426,0
1361770203,2191581868,1,46,46,1361770175892,1361770175892,2191554760,2191554760,0
1361770604,2191983060,9,861,95.66666667,1361770577870,1361770578062,2191956930,2191957122,192
1361770604,2191983060,8,815,101.875,1361770578125,1361770578317,2191957185,2191957377,192
1361770604,2191983192,1,46,46,1361770577291,1361770577291,2191956483,2191956483,0
1361770604,2191983192,14,6617,472.6428571,1361770577354,1361770577674,2191956546,2191956866,320
1361770604,2191983224,8,815,101.875,1361770578283,1361770578475,2191957507,2191957699,192
1361770852,2192231536,3,189,63,1361770848045,1361770851053,2192227581,2192230589,3008
1361770852,2192231536,3,189,63,1361770848109,1361770851117,2192227645,2192230653,3008
1361770852,2192231536,3,189,63,1361770848045,1361770851053,2192227581,2192230589,3008
1361770868,2192247572,2,126,63,1361770855050,1361770863114,2192234622,2192242686,8064
1361770868,2192247572,2,126,63,1361770855113,1361770863177,2192234685,2192242749,8064
1361770869,2192247616,2,126,63,1361770856005,1361770864069,2192234621,2192242685,8064
1361770884,2192263588,3,189,63,1361770879352,1361770882360,2192258940,2192261948,3008
1361770901,2192279636,2,126,63,1361770887346,1361770895410,2192265982,2192274046,8064
1361771109,2192488048,12,999,83.25,1361771094356,1361771104340,2192473404,2192483388,9984
1361771109,2192488112,12,999,83.25,1361771094033,1361771104273,2192473145,2192483385,10240
1361771109,2192488116,12,999,83.25,1361771094542,1361771104270,2192473658,2192483386,9728
1361771109,2192488120,11,953,86.63636364,1361771094794,1361771104266,2192473914,2192483386,9472
1361771261,2192640436,3,180,60,1361771234253,1361771243405,2192613689,2192622841,9152
1361772910,2194289140,12,999,83.25,1361772901275,1361772908891,2194280415,2194288031,7616
1361774728,2196107160,11,4651,422.8181818,1361774703277,1361774703533,2196082437,2196082693,256
1361774728,2196107164,8,815,101.875,1361774703654,1361774703782,2196082818,2196082946,128
1361774732,2196111064,9,861,95.66666667,1361774704009,1361774704201,2196083073,2196083265,192
1361774921,2196299736,3,189,63,1361774915730,1361774918802,2196294466,2196297538,3072
1361774937,2196315764,2,126,63,1361774922804,1361774930868,2196301568,2196309632,8064
1361775009,2196388100,6,344,57.33333333,1361774999650,1361775006882,2196378750,2196385982,7232
1361775009,2196388104,6,344,57.33333333,1361774999649,1361775006881,2196378753,2196385985,7232
1361775009,2196388144,2,92,46,1361775006837,1361775006837,2196385981,2196385981,0
1361775032,2196411584,8,815,101.875,1361775007552,1361775007744,2196387136,2196387328,192
1361775033,2196411660,9,861,95.66666667,1361775008730,1361775008922,2196387390,2196387582,192
1361775036,2196415564,9,861,95.66666667,1361775008081,1361775009105,2196387645,2196388669,1024
1361775036,2196415568,8,815,101.875,1361775009165,1361775009357,2196388733,2196388925,192
1361775233,2196612384,2,126,63,1361775231683,1361775232707,2196611067,2196612091,1024
1361775241,2196620416,2,126,63,1361775234723,1361775238755,2196614139,2196618171,4032
1361775273,2196651768,1,63,63,1361775247468,1361775247468,2196626236,2196626236,0
1361775274,2196652712,3,189,63,1361775270371,1361775273379,2196649083,2196652091,3008
1361775274,2196652712,3,189,63,1361775270498,1361775273506,2196649210,2196652218,3008
1361775290,2196668712,3,189,63,1361775286691,1361775289699,2196665403,2196668411,3008
1361775290,2196668744,2,126,63,1361775277378,1361775285378,2196656122,2196664122,8000
1361775290,2196668744,2,126,63,1361775277441,1361775285505,2196656185,2196664249,8064
1361775306,2196684744,2,126,63,1361775293698,1361775301762,2196672442,2196680506,8064
1361775658,2197037236,2,92,46,1361775650706,1361775650706,2197029942,2197029942,0
1361775658,2197037236,2,92,46,1361775650706,1361775650706,2197029942,2197029942,0
1361775658,2197037236,2,92,46,1361775650705,1361775650705,2197029941,2197029941,0
1361775658,2197037280,2,92,46,1361775650663,1361775650663,2197029943,2197029943,0
1361775666,2197045228,17,6755,397.3529412,1361775651673,1361775663769,2197030901,2197042997,12096
1361775666,2197045228,12,999,83.25,1361775652056,1361775663768,2197031284,2197042996,11712
1361775666,2197045232,11,953,86.63636364,1361775652565,1361775663701,2197031797,2197042933,11136
1361775666,2197045252,11,953,86.63636364,1361775652288,1361775663744,2197031540,2197042996,11456
1361776255,2197634120,1,48,48,1361776227389,1361776227389,2197606509,2197606509,0
1361776255,2197634304,1,48,48,1361776226693,1361776226693,2197605997,2197605997,0
1361776480,2197858904,1,92,92,1361776455249,1361776455249,2197834153,2197834153,0
1361776612,2197990900,1,92,92,1361776585682,1361776585682,2197964582,2197964582,0
1361777241,2198620212,3,152,50.66666667,1361777212946,1361777221842,2198592158,2198601054,8896
1361777345,2198724460,2,100,50,1361777320345,1361777326425,2198699805,2198705885,6080
1361777433,2198812564,3,144,48,1361777406063,1361777415023,2198785627,2198794587,8960
1361777454,2198832740,3,152,50.66666667,1361777426021,1361777434981,2198804761,2198813721,8960
1361777474,2198852856,3,176,58.66666667,1361777449137,1361777458161,2198827993,2198837017,9024
1361777475,2198854496,12,999,83.25,1361777467123,1361777474355,2198846619,2198853851,7232
1361777475,2198854496,11,953,86.63636364,1361777467377,1361777474353,2198846873,2198853849,6976
1361777475,2198854544,12,999,83.25,1361777466753,1361777474369,2198846297,2198853913,7616
1361777498,2198876932,3,144,48,1361777472676,1361777481636,2198851608,2198860568,8960
1361777506,2198884912,8,815,101.875,1361777481658,1361777481850,2198860570,2198860762,192
1361777510,2198888852,8,815,101.875,1361777481974,1361777482166,2198860826,2198861018,192
1361777510,2198888856,8,815,101.875,1361777482225,1361777482417,2198861081,2198861273,192
1361777510,2198888860,8,815,101.875,1361777482540,1361777482732,2198861400,2198861592,192
1361777554,2198933012,3,176,58.66666667,1361777528342,1361777536790,2198907354,2198915802,8448
1361777590,2198968940,3,144,48,1361777563930,1361777572890,2198942870,2198951830,8960
1361777708,2199086696,3,189,63,1361777703821,1361777706893,2199082517,2199085589,3072
1361777724,2199102684,2,126,63,1361777710938,1361777719002,2199089622,2199097686,8064
1361777732,2199110664,2,126,63,1361777729072,1361777730096,2199107736,2199108760,1024
1361777740,2199118652,2,126,63,1361777732156,1361777736188,2199110808,2199114840,4032
1361777771,2199149756,1,63,63,1361777744083,1361777744083,2199122839,2199122839,0
1361777812,2199190724,2,126,63,1361777809713,1361777810737,2199188437,2199189461,1024
1361777812,2199190724,2,126,63,1361777809775,1361777810799,2199188499,2199189523,1024
1361777820,2199198752,2,126,63,1361777812694,1361777816726,2199191446,2199195478,4032
1361777820,2199198752,2,126,63,1361777812758,1361777816790,2199191510,2199195542,4032
1361777851,2199229836,1,63,63,1361777824769,1361777824769,2199203605,2199203605,0
1361777851,2199229836,1,63,63,1361777824704,1361777824704,2199203540,2199203540,0
1361777875,2199253936,3,152,50.66666667,1361777848987,1361777857947,2199227923,2199236883,8960
1361777999,2199378220,3,176,58.66666667,1361777971069,1361777979133,2199350289,2199358353,8064
1361778179,2199558440,1,46,46,1361778153822,1361778153822,2199533262,2199533262,0
1361778199,2199578432,3,152,50.66666667,1361778172774,1361778181734,2199552206,2199561166,8960
1361778304,2199682668,3,152,50.66666667,1361778278240,1361778287328,2199656908,2199665996,9088
1361778392,2199770832,3,144,48,1361778367612,1361778376508,2199746444,2199755340,8896
1361778412,2199790788,3,152,50.66666667,1361778387495,1361778396455,2199766283,2199775243,8960
1361778440,2199818888,2,116,58,1361778412162,1361778418114,2199791050,2199797002,5952
1361778460,2199838980,3,144,48,1361778434088,1361778443048,2199813068,2199822028,8960
1361778516,2199894976,2,116,58,1361778490028,1361778498284,2199869004,2199877260,8256
1361778552,2199930928,3,144,48,1361778524187,1361778533019,2199903115,2199911947,8832
1361778672,2200051104,3,176,58.66666667,1361778644455,1361778653415,2200023559,2200032519,8960
1361778956,2200335340,3,176,58.66666667,1361778931577,1361778940537,2200310917,2200319877,8960
1361779140,2200519524,3,152,50.66666667,1361779113469,1361779122429,2200492993,2200501953,8960
1361779160,2200539488,3,152,50.66666667,1361779132832,1361779141792,2200512320,2200521280,8960
1361779200,2200579556,1,46,46,1361779173594,1361779173594,2200553150,2200553150,0
1361779265,2200643940,3,152,50.66666667,1361779238212,1361779247236,2200617152,2200626176,9024
1361779301,2200679596,8,815,101.875,1361779274715,1361779274907,2200653311,2200653503,192
1361779301,2200679664,9,861,95.66666667,1361779274328,1361779274520,2200652992,2200653184,192
1361779301,2200679668,9,861,95.66666667,1361779274898,1361779275090,2200653566,2200653758,192
1361779353,2200731688,3,144,48,1361779328636,1361779337596,2200707324,2200716284,8960
1361779377,2200755664,3,152,50.66666667,1361779349013,1361779358037,2200727677,2200736701,9024
1361779397,2200775672,1,60,60,1361779369422,1361779369422,2200748094,2200748094,0
1361779421,2200799696,3,144,48,1361779395829,1361779404853,2200774525,2200783549,9024
1361779449,2200827752,1,48,48,1361779424699,1361779424699,2200803451,2200803451,0
1361779493,2200872068,3,189,63,1361779488513,1361779491521,2200867581,2200870589,3008
1361779509,2200887792,3,144,48,1361779484627,1361779493651,2200863419,2200872443,9024
1361779509,2200888052,2,126,63,1361779495569,1361779503633,2200874621,2200882685,8064
1361779509,2200888080,3,189,63,1361779505843,1361779508915,2200884923,2200887995,3072
1361779525,2200903800,14,6617,472.6428571,1361779497739,1361779497995,2200876539,2200876795,256
1361779525,2200903876,9,861,95.66666667,1361779498047,1361779498175,2200876923,2200877051,128
1361779525,2200903880,8,815,101.875,1361779498300,1361779498428,2200877180,2200877308,128
1361779525,2200903880,8,815,101.875,1361779498554,1361779498746,2200877434,2200877626,192
1361779525,2200904016,2,126,63,1361779512946,1361779521010,2200891962,2200900026,8064
1361779525,2200904024,3,189,63,1361779519211,1361779522219,2200898235,2200901243,3008
1361779541,2200920052,2,126,63,1361779526222,1361779534286,2200905274,2200913338,8064
1361779629,2201007924,3,176,58.66666667,1361779603853,1361779612749,2200982777,2200991673,8896
1361779813,2201192448,3,189,63,1361779805889,1361779808897,2201185337,2201188345,3008
1361779829,2201208352,2,126,63,1361779813022,1361779821086,2201192374,2201200438,8064
1361779837,2201216144,3,176,58.66666667,1361779808941,1361779817965,2201188085,2201197109,9024
1361779901,2201280388,3,189,63,1361779897723,1361779900795,2201277111,2201280183,3072
1361779901,2201280388,3,189,63,1361779897723,1361779900731,2201277111,2201280119,3008
1361779901,2201280388,3,189,63,1361779897787,1361779900859,2201277175,2201280247,3072
1361779917,2201296396,2,126,63,1361779904755,1361779912819,2201284151,2201292215,8064
1361779917,2201296396,2,126,63,1361779904818,1361779912882,2201284214,2201292278,8064
1361779917,2201296408,2,126,63,1361779904805,1361779912805,2201284213,2201292213,8000
1361780098,2201476896,3,152,50.66666667,1361780072162,1361780081186,2201451058,2201460082,9024
1361780118,2201497092,3,152,50.66666667,1361780093276,1361780102236,2201472368,2201481328,8960
1361780226,2201605112,3,152,50.66666667,1361780198089,1361780207049,2201577201,2201586161,8960
1361780314,2201693436,3,152,50.66666667,1361780309763,1361780313347,2201689199,2201692783,3584
1361780314,2201693436,3,144,48,1361780288835,1361780297667,2201668271,2201677103,8832
1361780318,2201697048,9,3357,373,1361780316168,1361780317256,2201695216,2201696304,1088
1361780321,840014696,4,478,119.5,1361780314865,1361780314865,840008561,840008561,0
1361780326,2201705036,10,1994,199.4,1361780322836,1361780323476,2201701872,2201702512,640
1361780326,2201705040,7,2878,411.1428571,1361780323791,1361780324175,2201702831,2201703215,384
1361780326,2201705044,8,1424,178,1361780320972,1361780321356,2201700016,2201700400,384
1361780326,2201705044,8,2021,252.625,1361780325450,1361780325770,2201704494,2201704814,320
1361780326,2201705052,8,2378,297.25,1361780323461,1361780323781,2201702513,2201702833,320
1361780326,2201705080,9,2686,298.4444444,1361780324136,1361780324520,2201703216,2201703600,384
1361780326,2201705080,9,1942,215.7777778,1361780324519,1361780324967,2201703599,2201704047,448
1361780326,2201705080,7,2646,378,1361780324966,1361780325350,2201704046,2201704430,384
1361780326,2201705084,7,2662,380.2857143,1361780325348,1361780325668,2201704432,2201704752,320
1361780330,840022744,5,1778,355.6,1361780322667,1361780323115,840015411,840015859,448
1361780334,2201713044,8,1890,236.25,1361780326539,1361780326859,2201705583,2201705903,320
1361780334,2201713048,8,1890,236.25,1361780331016,1361780331400,2201710064,2201710448,384
1361780334,2201713048,8,1890,236.25,1361780327623,1361780328007,2201706671,2201707055,384
1361780334,2201713052,8,1890,236.25,1361780328453,1361780328773,2201707505,2201707825,320
1361780334,2201713052,9,3246,360.6666667,1361780332419,1361780332803,2201711471,2201711855,384
1361780334,2201713052,8,2386,298.25,1361780328771,1361780329091,2201707823,2201708143,320
1361780334,2201713052,8,2506,313.25,1361780329091,1361780329475,2201708143,2201708527,384
1361780334,2201713056,10,1994,199.4,1361780329473,1361780329857,2201708529,2201708913,384
1361780334,2201713056,8,1890,236.25,1361780333185,1361780333505,2201712241,2201712561,320
1361780334,2201713056,9,1942,215.7777778,1361780332800,1361780333184,2201711856,2201712240,384
1361780334,2201713056,10,3261,326.1,1361780317822,1361780333182,2201696878,2201712238,15360
1361780334,2201713056,9,3494,388.2222222,1361780333502,1361780333886,2201712558,2201712942,384
1361780334,2201713060,10,2490,249,1361780326077,1361780326525,2201705137,2201705585,448
1361780334,2201713060,10,1994,199.4,1361780330556,1361780331004,2201709616,2201710064,448
1361780334,2201713060,7,1838,262.5714286,1361780326844,1361780327228,2201705904,2201706288,384
1361780334,2201713060,7,1838,262.5714286,1361780327226,1361780327610,2201706286,2201706670,384
1361780334,2201713064,10,4818,481.8,1361780331385,1361780331705,2201710449,2201710769,320
1361780334,2201713064,8,2394,299.25,1361780331704,1361780332088,2201710768,2201711152,384
1361780334,2201713064,9,1942,215.7777778,1361780327991,1361780328439,2201707055,2201707503,448
1361780334,2201713084,8,2922,365.25,1361780332067,1361780332387,2201711151,2201711471,320
1361780334,2201713088,7,2694,384.8571429,1361780329823,1361780330207,2201708911,2201709295,384
1361780334,2201713088,8,2378,297.25,1361780330206,1361780330526,2201709294,2201709614,320
1361780334,2201713092,7,2334,333.4285714,1361780325660,1361780326044,2201704752,2201705136,384
1361780338,840030748,5,1031,206.2,1361780315815,1361780330855,840008563,840023603,15040
1361780342,2201721040,8,1977,247.125,1361780325902,1361780334926,2201704942,2201713966,9024
1361780342,2201721044,12,3732,311,1361780335242,1361780338122,2201714286,2201717166,2880
1361780342,2201721048,4,700,175,1361780319879,1361780334919,2201698927,2201713967,15040
1361780342,2201721048,7,1401,200.1428571,1361780336645,1361780337285,2201715693,2201716333,640
1361780342,2201721052,9,1950,216.6666667,1361780333890,1361780334274,2201712942,2201713326,384
1361780342,2201721056,5,1275,255,1361780334976,1361780338176,2201714032,2201717232,3200
1361780342,2201721056,10,1994,199.4,1361780334272,1361780334720,2201713328,2201713776,448
1361780342,2201721056,13,3356,258.1538462,1361780318976,1361780334976,2201698032,2201714032,16000
1361780346,840038740,4,478,119.5,1361780340076,1361780340076,840032816,840032816,0
1361780350,2201729504,1,108,108,1361780324287,1361780324287,2201703791,2201703791,0
1361780350,2201729504,1,108,108,1361780324351,1361780324351,2201703855,2201703855,0
1361780351,2201729568,1,108,108,1361780325159,1361780325159,2201703727,2201703727,0
1361780362,2201741532,1,46,46,1361780334434,1361780334434,2201713966,2201713966,0
1361780365,840058156,1,52,52,1361780338126,1361780338126,840031282,840031282,0
1361780378,2201757536,2,96,48,1361780350176,1361780350240,2201729712,2201729776,64
1361780383,2201761648,3,144,48,1361780357270,1361780366230,2201735918,2201744878,8960
1361780471,2201849972,2,96,48,1361780444562,1361780453650,2201823534,2201832622,9088
1361780591,2201970052,2,120,60,1361780565246,1361780568126,2201944298,2201947178,2880
1361780639,2202018088,3,152,50.66666667,1361780612762,1361780621722,2201991850,2202000810,8960
1361780743,2202122236,3,176,58.66666667,1361780717703,1361780726663,2202096939,2202105899,8960
1361780867,2202246280,1,48,48,1361780840149,1361780840149,2202219429,2202219429,0
1361781024,2202402744,1,46,46,1361780999021,1361780999021,2202377765,2202377765,0
1361781060,2202438732,3,152,50.66666667,1361781032442,1361781041402,2202411174,2202420134,8960
1361781072,2202450744,3,176,58.66666667,1361781045613,1361781055277,2202424357,2202434021,9664
1361781080,2202459128,3,152,50.66666667,1361781053291,1361781062315,2202432419,2202441443,9024
1361781088,2202467040,9,861,95.66666667,1361781063685,1361781063877,2202442725,2202442917,192
1361781092,2202471076,9,861,95.66666667,1361781063903,1361781064095,2202442979,2202443171,192
1361781092,2202471076,9,861,95.66666667,1361781064158,1361781064350,2202443234,2202443426,192
1361781124,2202503100,1,52,52,1361781096838,1361781096838,2202475938,2202475938,0
1361781184,2202563216,3,152,50.66666667,1361781158036,1361781167060,2202537252,2202546276,9024
1361781277,2202655616,3,144,48,1361781250472,1361781259304,2202629088,2202637920,8832
1361781297,2202675620,3,152,50.66666667,1361781272035,1361781281059,2202650655,2202659679,9024
1361781311,2202689700,3,189,63,1361781306070,1361781309142,2202684770,2202687842,3072
1361781317,2202695628,3,176,58.66666667,1361781289373,1361781298461,2202668001,2202677089,9088
1361781327,2202705700,2,126,63,1361781313172,1361781321236,2202691872,2202699936,8064
1361781335,2202713700,3,189,63,1361781330386,1361781333458,2202709086,2202712158,3072
1361781345,2202723624,3,144,48,1361781318814,1361781327774,2202697438,2202706398,8960
1361781351,2202729680,2,126,63,1361781337512,1361781345576,2202716192,2202724256,8064
1361781359,2202737704,2,92,46,1361781358736,1361781358736,2202737440,2202737440,0
1361781359,2202737736,3,138,46,1361781358704,1361781358768,2202737440,2202737504,64
1361781367,2202745756,4,201,50.25,1361781358685,1361781359133,2202737441,2202737889,448
1361781385,2202763604,8,815,101.875,1361781359922,1361781360114,2202738526,2202738718,192
1361781385,2202763672,8,815,101.875,1361781360111,1361781360303,2202738783,2202738975,192
1361781385,2202763676,9,861,95.66666667,1361781360364,1361781361068,2202739040,2202739744,704
1361781389,2202767644,8,815,101.875,1361781361163,1361781361355,2202739807,2202739999,192
1361781431,2202809720,2,96,48,1361781405120,1361781408000,2202783840,2202786720,2880
1361781577,2202956104,2,128,64,1361781550588,1361781551548,2202929692,2202930652,960
1361781597,2202976140,3,152,50.66666667,1361781569494,1361781578454,2202948634,2202957594,8960
1361781599,2202977828,4,252,63,1361781590159,1361781597199,2202968987,2202976027,7040
1361781599,2202977828,4,252,63,1361781590223,1361781597327,2202969051,2202976155,7104
1361781633,2203012144,1,63,63,1361781604946,1361781604946,2202984090,2202984090,0
1361781633,2203012144,1,63,63,1361781605074,1361781605074,2202984218,2202984218,0
1361781679,2203057840,4,252,63,1361781671236,1361781678276,2203050076,2203057116,7040
1361781703,2203081872,3,189,63,1361781698466,1361781701474,2203077338,2203080346,3008
1361781705,2203084232,3,176,58.66666667,1361781678074,1361781685946,2203057306,2203065178,7872
1361781713,2203092260,1,63,63,1361781685918,1361781685918,2203065178,2203065178,0
1361781719,2203097876,2,126,63,1361781705502,1361781713566,2203084378,2203092442,8064
1361781765,2203144360,3,168,56,1361781740281,1361781748473,2203119641,2203127833,8192
1361782018,2203396740,3,152,50.66666667,1361781992481,1361782001441,2203371221,2203380181,8960
1361782034,2203412732,3,176,58.66666667,1361782007528,1361782015656,2203386260,2203394388,8128
1361782038,2203416764,3,152,50.66666667,1361782013769,1361782022665,2203392533,2203401429,8896
1361782238,2203616976,3,144,48,1361782211122,1361782219826,2203590098,2203598802,8704
1361782262,2203641068,3,152,50.66666667,1361782235094,1361782244118,2203614162,2203623186,9024
1361782306,2203685196,3,144,48,1361782280151,1361782288663,2203659347,2203667859,8512
1361782394,2203773460,2,96,48,1361782367500,1361782373580,2203746960,2203753040,6080
1361782555,2203933820,3,152,50.66666667,1361782529866,1361782538890,2203908686,2203917710,9024
1361782699,2204078068,3,176,58.66666667,1361782674704,1361782683600,2204053772,2204062668,8896
1361782719,2204098256,3,168,56,1361782691410,1361782700242,2204070666,2204079498,8832
1361782880,2204258732,9,861,95.66666667,1361782854045,1361782854237,2204232777,2204232969,192
1361782880,2204258776,9,861,95.66666667,1361782854257,1361782854449,2204233033,2204233225,192
1361782880,2204258780,9,861,95.66666667,1361782854510,1361782854702,2204233290,2204233482,192
1361782980,2204358800,3,152,50.66666667,1361782952470,1361782961430,2204331270,2204340230,8960
1361782996,2204374796,3,176,58.66666667,1361782968539,1361782976731,2204347335,2204355527,8192
1361783000,2204378824,3,152,50.66666667,1361782973760,1361782982656,2204352584,2204361480,8896
1361783128,2204507304,4,184,46,1361783125789,1361783126237,2204505093,2204505541,448
1361783128,2204507332,3,138,46,1361783125760,1361783125824,2204505092,2204505156,64
1361783152,2204531032,14,6617,472.6428571,1361783127212,1361783127596,2204506244,2204506628,384
1361783152,2204531060,9,861,95.66666667,1361783127823,1361783128015,2204506883,2204507075,192
1361783152,2204531068,2,109,54.5,1361783125959,1361783125959,2204505027,2204505027,0
1361783152,2204531076,9,861,95.66666667,1361783127553,1361783127745,2204506629,2204506821,192
1361783156,2204535088,9,861,95.66666667,1361783128118,1361783128310,2204507206,2204507398,192
1361783196,2204575120,3,144,48,1361783171666,1361783180562,2204550786,2204559682,8896
1361783224,2204603192,2,100,50,1361783197517,1361783203341,2204576709,2204582533,5824
1361783268,2204647184,3,144,48,1361783241171,1361783250131,2204620355,2204629315,8960
1361783360,2204739244,1,48,48,1361783333972,1361783333972,2204713216,2204713216,0
1361783441,2204819612,2,126,63,1361783438477,1361783439501,2204817089,2204818113,1024
1361783449,2204827584,4,252,63,1361783440744,1361783447784,2204819328,2204826368,7040
1361783449,2204827588,2,126,63,1361783441509,1361783445541,2204820097,2204824129,4032
1361783457,2204835608,3,189,63,1361783453393,1361783456401,2204832001,2204835009,3008
1361783473,2204851628,2,126,63,1361783460412,1361783468476,2204839040,2204847104,8064
1361783480,2204859472,1,63,63,1361783452721,1361783452721,2204832193,2204832193,0
1361783480,2204859480,1,63,63,1361783454953,1361783454953,2204834433,2204834433,0
1361783481,2204859620,2,126,63,1361783478403,1361783479427,2204857023,2204858047,1024
1361783489,2204867652,2,126,63,1361783481381,1361783485413,2204860033,2204864065,4032
1361783516,2204895552,3,152,50.66666667,1361783489246,1361783498270,2204868798,2204877822,9024
1361783520,2204899488,1,63,63,1361783492637,1361783492637,2204872125,2204872125,0
1361783661,2205039668,3,176,58.66666667,1361783633746,1361783642450,2205012414,2205021118,8704
1361783677,2205055664,3,168,56,1361783652628,1361783661588,2205031292,2205040252,8960
1361783937,2205316368,3,152,50.66666667,1361783911952,1361783920976,2205291320,2205300344,9024
1361783957,2205336412,3,176,58.66666667,1361783928930,1361783937570,2205308342,2205316982,8640
1361784158,2205536712,3,144,48,1361784132830,1361784141726,2205511542,2205520438,8896
1361784182,2205561048,3,152,50.66666667,1361784155980,1361784164940,2205535028,2205543988,8960
1361784195,2205574240,1,46,46,1361784166156,1361784166156,2205545396,2205545396,0
1361784195,2205574244,1,46,46,1361784166154,1361784166154,2205545398,2205545398,0
1361784230,2205609056,3,144,48,1361784202755,1361784211651,2205581811,2205590707,8896
1361784314,2205693216,1,48,48,1361784288357,1361784288357,2205667573,2205667573,0
1361784475,2205853960,3,152,50.66666667,1361784449889,1361784458913,2205828849,2205837873,9024
1361784651,2206030352,1,56,56,1361784625047,1361784625047,2206004399,2206004399,0
1361784671,2206050308,14,6617,472.6428571,1361784642945,1361784643265,2206022253,2206022573,320
1361784671,2206050312,9,861,95.66666667,1361784643581,1361784643773,2206022893,2206023085,192
1361784671,2206050328,9,861,95.66666667,1361784643309,1361784643501,2206022637,2206022829,192
1361784715,2206094424,3,176,58.66666667,1361784688716,1361784697612,2206068140,2206077036,8896
1361784759,2206138512,3,152,50.66666667,1361784731251,1361784740211,2206110763,2206119723,8960
1361784898,2206276704,2,126,63,1361784896409,1361784897433,2206275113,2206276137,1024
1361784900,2206278964,3,152,50.66666667,1361784872470,1361784881430,2206251434,2206260394,8960
1361784906,2206284720,2,126,63,1361784899464,1361784903496,2206278184,2206282216,4032
1361784930,2206308728,5,264,52.8,1361784911489,1361784927105,2206290217,2206305833,15616
1361784930,2206308732,3,138,46,1361784927038,1361784927102,2206305770,2206305834,64
1361784952,2206330984,2,109,54.5,1361784926785,1361784926785,2206305769,2206305769,0
1361784956,2206334992,9,861,95.66666667,1361784928761,1361784929017,2206307753,2206308009,256
1361784956,2206335024,8,815,101.875,1361784928472,1361784928600,2206307496,2206307624,128
1361784956,2206335028,8,815,101.875,1361784929364,1361784929556,2206308392,2206308584,192
1361784956,2206335028,9,861,95.66666667,1361784929107,1361784929235,2206308135,2206308263,128
1361785120,2206499400,3,144,48,1361785093021,1361785101853,2206472421,2206481253,8832
1361785144,2206523376,3,152,50.66666667,1361785117110,1361785126134,2206496486,2206505510,9024
1361785162,2206540900,3,189,63,1361785157075,1361785160147,2206535975,2206539047,3072
1361785178,2206556956,2,126,63,1361785164120,1361785172120,2206543076,2206551076,8000
1361785196,2206575444,3,144,48,1361785168816,1361785177776,2206548260,2206557220,8960
1361785202,2206580952,2,126,63,1361785200348,1361785201372,2206579300,2206580324,1024
1361785210,2206588976,2,126,63,1361785203335,1361785207367,2206582311,2206586343,4032
1361785240,2206619456,1,63,63,1361785214949,1361785214949,2206594405,2206594405,0
1361785250,2206629040,2,126,63,1361785247942,1361785248966,2206626982,2206628006,1024
1361785258,2206637048,2,126,63,1361785251006,1361785255038,2206630054,2206634086,4032
1361785289,2206667608,1,63,63,1361785263477,1361785263477,2206642085,2206642085,0
1361785290,2206669064,3,189,63,1361785286827,1361785289899,2206665891,2206668963,3072
1361785306,2206685068,2,126,63,1361785293864,1361785301928,2206672932,2206680996,8064
1361785434,2206812784,1,48,48,1361785406788,1361785406788,2206785572,2206785572,0
1361785435,2206813644,1,48,48,1361785406925,1361785406925,2206785569,2206785569,0
1361785435,2206813680,1,48,48,1361785407145,1361785407145,2206785825,2206785825,0
1361785437,2206816244,3,152,50.66666667,1361785409719,1361785418679,2206788963,2206797923,8960
1361785673,2207052528,3,176,58.66666667,1361785647830,1361785656790,2207027358,2207036318,8960
1361785718,2207096608,3,152,50.66666667,1361785692398,1361785701294,2207071006,2207079902,8896
1361786078,2207457504,3,144,48,1361786053798,1361786062758,2207433302,2207442262,8960
1361786107,2207485768,3,152,50.66666667,1361786079240,1361786088200,2207458008,2207466968,8960
1361786151,2207529824,3,144,48,1361786125710,1361786134734,2207504534,2207513558,9024
1361786339,2207717708,45,56553,1256.733333,1361786333312,1361786334016,2207712020,2207712724,704
1361786347,2207725708,12,999,83.25,1361786334910,1361786343678,2207713618,2207722386,8768
1361786347,2207725720,17,6755,397.3529412,1361786334262,1361786343670,2207712982,2207722390,9408
1361786347,2207725720,12,999,83.25,1361786334581,1361786343669,2207713301,2207722389,9088
1361786347,2207725720,12,999,83.25,1361786335156,1361786343668,2207713876,2207722388,8512
1361786395,2207774444,3,152,50.66666667,1361786369568,1361786378592,2207749012,2207758036,9024
1361786544,2207923524,1,48,48,1361786517452,1361786517452,2207896976,2207896976,0
1361786545,2207923552,1,48,48,1361786518425,1361786518425,2207896977,2207896977,0
1361786680,2208059164,3,152,50.66666667,1361786651955,1361786660915,2208031119,2208040079,8960
1361786716,2208095484,3,176,58.66666667,1361786691379,1361786700211,2208070863,2208079695,8832
1361787041,2208420024,3,144,48,1361787014969,1361787023801,2208393993,2208402825,8832
1361787045,2208424012,3,144,48,1361787019015,1361787027911,2208398027,2208406923,8896
1361787065,2208444064,3,152,50.66666667,1361787040402,1361787049426,2208419466,2208428490,9024
1361787113,2208492020,3,144,48,1361787087163,1361787095931,2208466183,2208474951,8768
1361787357,2208736296,3,152,50.66666667,1361787329828,1361787338788,2208709124,2208718084,8960
1361787638,2209016612,3,152,50.66666667,1361787612684,1361787621644,2208991296,2209000256,8960
1361787678,2209056628,2,120,60,1361787652029,1361787654397,2209030657,2209033025,2368
1361787874,2209253360,14,6758,482.7142857,1361787847197,1361787847453,2209226557,2209226813,256
1361787874,2209253368,8,815,101.875,1361787848532,1361787848724,2209227900,2209228092,192
1361787874,2209253400,14,6617,472.6428571,1361787847478,1361787847798,2209226878,2209227198,320
1361787874,2209253404,9,861,95.66666667,1361787847859,1361787848051,2209227263,2209227455,192
1361787874,2209253404,9,861,95.66666667,1361787848178,1361787848370,2209227582,2209227774,192
1361787994,2209373488,1,48,48,1361787968220,1361787968220,2209347708,2209347708,0
1361788006,2209385428,3,144,48,1361787980311,1361787989143,2209359739,2209368571,8832
1361788027,2209405784,3,152,50.66666667,1361788002139,1361788011099,2209380923,2209389883,8960
1361788044,2209422916,3,138,46,1361788041365,1361788041429,2209420281,2209420345,64
1361788044,2209422916,3,138,46,1361788041365,1361788041429,2209420281,2209420345,64
1361788044,2209422920,7,2447,349.5714286,1361788042642,1361788042706,2209421562,2209421626,64
1361788044,2209422928,3,138,46,1361788041291,1361788041355,2209420219,2209420283,64
1361788060,847752768,35,43794,1251.257143,1361788041539,1361788053507,847734307,847746275,11968
1361788060,2209438892,12,999,83.25,1361788044015,1361788055343,2209422907,2209434235,11328
1361788060,2209438892,12,999,83.25,1361788044333,1361788055341,2209423225,2209434233,11008
1361788060,2209438904,21,15651,745.2857143,1361788042596,1361788053348,2209421500,2209432252,10752
1361788060,2209438904,17,6755,397.3529412,1361788043426,1361788055330,2209422330,2209434234,11904
1361788060,2209438904,11,953,86.63636364,1361788043745,1361788055329,2209422649,2209434233,11584
1361788066,2209445536,9,4896,544,1361788041450,1361788059434,2209420986,2209438970,17984
1361788067,2209445572,2,109,54.5,1361788041709,1361788041709,2209420281,2209420281,0
1361788067,2209445572,2,109,54.5,1361788041709,1361788041709,2209420281,2209420281,0
1361788074,2209453512,3,144,48,1361788047938,1361788057090,2209427450,2209436602,9152
1361788076,2209454916,8,5388,673.5,1361788054167,1361788072151,2209433083,2209451067,17984
1361788315,2209693860,3,152,50.66666667,1361788290316,1361788299340,2209669176,2209678200,9024
1361788600,2209978584,3,152,50.66666667,1361788572890,1361788581786,2209951474,2209960370,8896
1361788672,2210050680,3,176,58.66666667,1361788646777,1361788655801,2210025457,2210034481,9024
1361788989,2210367568,3,152,50.66666667,1361788963813,1361788972837,2210342381,2210351405,9024
1361789037,2210415848,3,144,48,1361789010124,1361789019084,2210388972,2210397932,8960
1361789277,2210656404,3,152,50.66666667,1361789249882,1361789258906,2210629286,2210638310,9024
1361789382,2210761096,3,152,50.66666667,1361789357328,1361789366288,2210736424,2210745384,8960
1361789558,2210937392,3,152,50.66666667,1361789532197,1361789541157,2210911589,2210920549,8960
1361789631,2211009692,3,176,58.66666667,1361789605982,1361789614942,2210984674,2210993634,8960
1361789869,2211247868,17,6755,397.3529412,1361789856106,1361789865194,2211234974,2211244062,9088
1361789869,2211247880,12,999,83.25,1361789856477,1361789865181,2211235357,2211244061,8704
1361789869,2211247884,12,999,83.25,1361789856733,1361789865181,2211235617,2211244065,8448
1361789955,2211333904,3,152,50.66666667,1361789924935,1361789934023,2211303839,2211312927,9088
1361789959,2211337948,3,152,50.66666667,1361789934809,1361789943641,2211313757,2211322589,8832
1361789999,2211377932,3,144,48,1361789971432,1361789980456,2211350364,2211359388,9024
1361790005,2211383976,12,999,83.25,1361789991485,1361790003389,2211370461,2211382365,11904
1361790005,2211383984,11,953,86.63636364,1361789991219,1361790003379,2211370203,2211382363,12160
1361790005,2211383988,12,999,83.25,1361789991730,1361790003378,2211370718,2211382366,11648
1361790005,2211383988,12,999,83.25,1361789992050,1361790003314,2211371038,2211382302,11264
1361790236,2211614564,3,152,50.66666667,1361790210773,1361790219797,2211589337,2211598361,9024
1361790340,2211718880,3,152,50.66666667,1361790315479,1361790324503,2211694359,2211703383,9024
1361790348,2211726888,4,202,50.5,1361790322769,1361790331921,2211701657,2211710809,9152
1361790396,2211774924,1,48,48,1361790368365,1361790368365,2211747289,2211747289,0
1361790424,2211802976,1,48,48,1361790397751,1361790397751,2211776727,2211776727,0
1361790520,2211899344,3,152,50.66666667,1361790492420,1361790501316,2211871764,2211880660,8896
1361790629,2212007768,3,176,58.66666667,1361790603331,1361790612227,2211982099,2211990995,8896
1361790914,2212292580,2,100,50,1361790889722,1361790895802,2212268302,2212274382,6080
1361790918,2212296616,2,104,52,1361790893529,1361790896409,2212272145,2212275025,2880
1361790958,2212336640,3,144,48,1361790933182,1361790942142,2212311822,2212320782,8960
1361791198,2212576828,3,152,50.66666667,1361791170625,1361791179649,2212549453,2212558477,9024
1361791302,2212680940,3,152,50.66666667,1361791275532,1361791284492,2212654472,2212663432,8960
1361791478,2212857364,3,152,50.66666667,1361791452515,1361791461475,2212831879,2212840839,8960
1361791591,2212969760,3,176,58.66666667,1361791563006,1361791571326,2212941766,2212950086,8320
1361791751,2213130184,1,52,52,1361791725332,1361791725332,2213104516,2213104516,0
1361791875,2213254256,3,152,50.66666667,1361791847562,1361791856586,2213226818,2213235842,9024
1361791879,2213258220,2,100,50,1361791854381,1361791863277,2213233601,2213242497,8896
1361791919,2213298304,3,144,48,1361791893975,1361791902935,2213273279,2213282239,8960
1361792156,2213534552,3,152,50.66666667,1361792131012,1361792139972,2213509564,2213518524,8960
1361792168,2213546648,3,152,50.66666667,1361792140453,1361792149477,2213519101,2213528125,9024
1361792205,851897724,4,1448,362,1361792200713,1361792200777,851893437,851893501,64
1361792205,851897724,5,451,90.2,1361792204552,1361792204744,851897276,851897468,192
1361792205,851897728,5,451,90.2,1361792200262,1361792200902,851892990,851893630,640
1361792205,851897728,5,2109,421.8,1361792204741,1361792204805,851897469,851897533,64
1361792206,2213585336,6,2158,359.6666667,1361792198067,1361792198579,2213577403,2213577915,512
1361792206,2213585344,6,983,163.8333333,1361792202861,1361792203117,2213582205,2213582461,256
1361792206,2213585344,8,3137,392.125,1361792198124,1361792199020,2213577468,2213578364,896
1361792206,2213585344,8,3492,436.5,1361792200043,1361792200875,2213579387,2213580219,832
1361792206,2213585344,5,1257,251.4,1361792200362,1361792200554,2213579706,2213579898,192
1361792206,2213585348,9,1913,212.5555556,1361792204265,1361792204777,2213583613,2213584125,512
1361792206,2213585348,4,724,181,1361792204713,1361792204905,2213584061,2213584253,192
1361792206,2213585348,11,3294,299.4545455,1361792201512,1361792202792,2213580860,2213582140,1280
1361792206,2213585348,5,609,121.8,1361792205095,1361792205479,2213584443,2213584827,384
1361792206,2213585352,8,2983,372.875,1361792203106,1361792203938,2213582458,2213583290,832
1361792208,2213586648,7,1460,208.5714286,1361792203814,1361792204518,2213582462,2213583166,704
1361792208,2213586648,6,798,133,1361792203813,1361792204133,2213582461,2213582781,320
1361792210,851903000,5,451,90.2,1361792206008,1361792207160,851899008,851900160,1152
1361792213,851905724,5,451,90.2,1361792208842,1361792210250,851901566,851902974,1408
1361792213,851905728,5,451,90.2,1361792211783,1361792212039,851904511,851904767,256
1361792214,2213593332,10,3421,342.1,1361792211384,1361792211960,2213590716,2213591292,576
1361792214,2213593332,5,609,121.8,1361792207671,1361792208055,2213587003,2213587387,384
1361792214,2213593336,9,1913,212.5555556,1361792206516,1361792207028,2213585852,2213586364,512
1361792214,2213593336,9,1913,212.5555556,1361792212532,1361792213108,2213591868,2213592444,576
1361792214,2213593340,5,609,121.8,1361792210608,1361792210928,2213589948,2213590268,320
1361792214,2213593340,12,4967,413.9166667,1361792211183,1361792211823,2213590523,2213591163,640
1361792214,2213593340,9,1913,212.5555556,1361792207791,1361792208367,2213587131,2213587707,576
1361792214,2213593344,5,609,121.8,1361792212333,1361792212781,2213591677,2213592125,448
1361792214,2213593344,9,1913,212.5555556,1361792206765,1361792207277,2213586109,2213586621,512
1361792214,2213593344,9,1913,212.5555556,1361792208813,1361792209389,2213588157,2213588733,576
1361792214,2213593344,9,1913,212.5555556,1361792209644,1361792210284,2213588988,2213589628,640
1361792214,2213593344,16,8468,529.25,1361792209900,1361792210796,2213589244,2213590140,896
1361792221,851913724,4,445,111.25,1361792215819,1361792215947,851908543,851908671,128
1361792221,851913724,5,451,90.2,1361792213515,1361792214219,851906239,851906943,704
1361792221,851913724,4,445,111.25,1361792216074,1361792216266,851908798,851908990,192
1361792221,851913724,4,445,111.25,1361792215946,1361792216074,851908670,851908798,128
1361792222,2213601332,10,1877,187.7,1361792215992,1361792217080,2213595324,2213596412,1088
1361792222,2213601336,9,1913,212.5555556,1361792217204,1361792217780,2213596540,2213597116,576
1361792222,2213601336,12,4735,394.5833333,1361792215090,1361792215666,2213594426,2213595002,576
1361792222,2213601340,9,1913,212.5555556,1361792218225,1361792218801,2213597565,2213598141,576
1361792222,2213601344,5,609,121.8,1361792214509,1361792214957,2213593853,2213594301,448
1361792222,2213601344,9,1913,212.5555556,1361792213611,1361792214187,2213592955,2213593531,576
1361792222,2213601344,12,4927,410.5833333,1361792213802,1361792214634,2213593146,2213593978,832
1361792224,2213602808,9,2849,316.5555556,1361792219781,1361792220357,2213598589,2213599165,576
1361792229,851921732,4,1448,362,1361792220932,1361792220996,851913664,851913728,64
1361792230,2213609340,10,3397,339.7,1361792222065,1361792223281,2213601405,2213602621,1216
1361792230,2213609340,9,3310,367.7777778,1361792220335,1361792222063,2213599675,2213601403,1728
1361792230,2213609340,4,715,178.75,1361792224623,1361792224879,2213603963,2213604219,256
1361792230,2213609340,11,3096,281.4545455,1361792224942,1361792225646,2213604282,2213604986,704
1361792230,2213609344,14,7501,535.7857143,1361792225708,1361792226476,2213605052,2213605820,768
1361792232,2213610872,7,1877,268.1428571,1361792205443,1361792206019,2213584315,2213584891,576
1361792260,2213638884,3,152,50.66666667,1361792235705,1361792244665,2213614589,2213623549,8960
1361792420,2213799300,3,152,50.66666667,1361792392021,1361792400981,2213771321,2213780281,8960
1361792440,2213819332,3,152,50.66666667,1361792412722,1361792421682,2213792054,2213801014,8960
1361792575,2213953528,15,6289,419.2666667,1361792564116,1361792574228,2213942644,2213952756,10112
1361792575,2213953528,12,999,83.25,1361792564503,1361792574231,2213943031,2213952759,9728
1361792577,2213955740,12,999,83.25,1361792564548,1361792573956,2213943288,2213952696,9408
1361792577,2213955740,12,999,83.25,1361792564867,1361792573955,2213943607,2213952695,9088
1361792657,2214035840,3,176,58.66666667,1361792632732,1361792641884,2214011572,2214020724,9152
1361792711,2214089588,12,999,83.25,1361792693208,1361792704600,2214071796,2214083188,11392
1361792711,2214089624,12,999,83.25,1361792693430,1361792704502,2214072054,2214083126,11072
1361792711,2214089624,11,953,86.63636364,1361792692915,1361792704563,2214071539,2214083187,11648
1361792711,2214089624,16,6372,398.25,1361792692467,1361792704563,2214071091,2214083187,12096
1361792730,2214108700,1,48,48,1361792703206,1361792703206,2214081906,2214081906,0
1361792730,2214108704,1,48,48,1361792703268,1361792703268,2214081972,2214081972,0
1361792730,2214108736,1,48,48,1361792703427,1361792703427,2214082163,2214082163,0
1361792775,2214153688,5,2520,504,1361792761906,1361792773554,2214140594,2214152242,11648
1361792775,2214153692,7,4762,680.2857143,1361792763630,1361792770542,2214142322,2214149234,6912
1361792783,2214161680,11,953,86.63636364,1361792765562,1361792777146,2214144242,2214155826,11584
1361792783,2214161684,11,953,86.63636364,1361792765881,1361792777145,2214144565,2214155829,11264
1361792783,2214161688,12,999,83.25,1361792765043,1361792777139,2214143731,2214155827,12096
1361792783,2214161688,12,999,83.25,1361792765298,1361792777138,2214143986,2214155826,11840
1361792797,2214175936,1,46,46,1361792769978,1361792769978,2214148914,2214148914,0
1361792837,2214215944,3,152,50.66666667,1361792809330,1361792818482,2214188274,2214197426,9152
1361792841,2214219960,2,104,52,1361792815010,1361792817890,2214193970,2214196850,2880
1361792881,2214260160,3,144,48,1361792856475,1361792864603,2214235635,2214243763,8128
1361792894,2214273436,1,46,46,1361792865735,1361792865735,2214245171,2214245171,0
1361792896,2214274580,1,46,46,1361792866525,1361792866525,2214245105,2214245105,0
1361792896,2214274584,1,46,46,1361792866522,1361792866522,2214245106,2214245106,0
1361793117,2214496492,3,152,50.66666667,1361793090121,1361793099145,2214469613,2214478637,9024
1361793125,2214504512,3,152,50.66666667,1361793097333,1361793106229,2214476845,2214485741,8896
1361793222,2214600868,3,152,50.66666667,1361793195831,1361793204791,2214574699,2214583659,8960
1361793230,2214608904,2,100,50,1361793202389,1361793208341,2214581293,2214587245,5952
1361793262,2214640932,1,46,46,1361793236535,1361793236535,2214615467,2214615467,0
1361793378,2214757028,3,152,50.66666667,1361793350296,1361793359256,2214729324,2214738284,8960
1361793398,2214776992,3,152,50.66666667,1361793373240,1361793382200,2214752232,2214761192,8960
1361793486,2214865076,3,152,50.66666667,1361793458084,1361793467044,2214837160,2214846120,8960
1361793618,2214997176,3,176,58.66666667,1361793593021,1361793601341,2214972197,2214980517,8320
1361793799,2215177564,3,152,50.66666667,1361793771233,1361793780193,2215149797,2215158757,8960
1361793803,2215181620,2,104,52,1361793775464,1361793778408,2215154084,2215157028,2944
1361793843,2215221680,3,144,48,1361793817516,1361793826476,2215196196,2215205156,8960
1361794075,2215453912,2,92,46,1361794048959,1361794051967,2215427871,2215430879,3008
1361794075,2215453920,3,152,50.66666667,1361794050808,1361794059768,2215429728,2215438688,8960
1361794079,2215458332,165,238341,1444.490909,1361794072475,1361794073627,2215451807,2215452959,1152
1361794083,2215462004,3,152,50.66666667,1361794057829,1361794066853,2215436833,2215445857,9024
1361794087,2215466356,11,953,86.63636364,1361794074500,1361794085380,2215453856,2215464736,10880
1361794087,2215466360,15,6289,419.2666667,1361794073405,1361794085373,2215452765,2215464733,11968
1361794087,2215466364,12,999,83.25,1361794073916,1361794085372,2215453280,2215464736,11456
1361794087,2215466372,12,999,83.25,1361794074227,1361794085363,2215453599,2215464735,11136
1361794183,2215562028,3,152,50.66666667,1361794157322,1361794166282,2215536350,2215545310,8960
1361794183,2215562064,3,152,50.66666667,1361794155686,1361794164646,2215534750,2215543710,8960
1361794335,2215714308,3,152,50.66666667,1361794310065,1361794319025,2215689373,2215698333,8960
1361794360,2215738636,3,152,50.66666667,1361794333777,1361794342673,2215712413,2215721309,8896
1361794444,2215822744,3,152,50.66666667,1361794418466,1361794427490,2215797210,2215806234,9024
1361794520,2215898580,15,6289,419.2666667,1361794507270,1361794517894,2215885850,2215896474,10624
1361794520,2215898580,12,999,83.25,1361794508933,1361794517829,2215887513,2215896409,8896
1361794520,2215898588,11,953,86.63636364,1361794508540,1361794517820,2215887128,2215896408,9280
1361794520,2215898588,12,999,83.25,1361794508284,1361794517820,2215886872,2215896408,9536
1361794568,2215946620,7,2448,349.7142857,1361794563548,1361794564060,2215942168,2215942680,512
1361794597,2215976264,1,60,60,1361794590167,1361794590167,2215969431,2215969431,0
1361794624,2216003240,1,56,56,1361794599089,1361794599089,2215978329,2215978329,0
1361794741,2216119608,2,104,52,1361794732582,1361794735590,2216111190,2216114198,3008
1361794741,2216119608,1,52,52,1361794737254,1361794737254,2216115862,2216115862,0
1361794741,2216119608,1,52,52,1361794736486,1361794736486,2216115094,2216115094,0
1361794769,2216147696,1,48,48,1361794741518,1361794741518,2216120214,2216120214,0
1361794776,2216154676,6,3996,666,1361794771296,1361794771616,2216149972,2216150292,320
1361794776,2216154684,10,2776,277.6,1361794774170,1361794774682,2216152854,2216153366,512
1361794776,2216154684,6,3996,666,1361794771352,1361794772248,2216150036,2216150932,896
1361794776,2216154688,6,3996,666,1361794772247,1361794772503,2216150935,2216151191,256
1361794784,2216162684,12,4812,401,1361794771610,1361794783322,2216150294,2216162006,11712
1361794784,2216162684,68,89783,1320.338235,1361794773336,1361794783192,2216152020,2216161876,9856
1361794784,2216162692,11,5422,492.9090909,1361794772498,1361794783186,2216151190,2216161878,10688
1361794784,2216162692,11,5102,463.8181818,1361794772242,1361794783186,2216150934,2216161878,10944
1361794789,854482528,18,21926,1218.111111,1361794772344,1361794784376,854465872,854477904,12032
1361794792,2216170688,23,14767,642.0434783,1361794773782,1361794785174,2216152470,2216163862,11392
1361794797,2216175660,1,60,60,1361794771376,1361794771376,2216150036,2216150036,0
1361794797,2216175660,1,60,60,1361794771440,1361794771440,2216150100,2216150100,0
1361794805,2216183696,3,144,48,1361794778956,1361794787916,2216157652,2216166612,8960
1361794816,2216194712,6,3996,666,1361794815419,1361794815739,2216194131,2216194451,320
1361794816,2216194712,6,3996,666,1361794815419,1361794815739,2216194131,2216194451,320
1361794816,2216194712,6,3996,666,1361794815419,1361794815803,2216194131,2216194515,384
1361794824,2216202740,6,3996,666,1361794815391,1361794816095,2216194131,2216194835,704
1361794832,2216210740,15,6767,451.1333333,1361794815712,1361794827232,2216194452,2216205972,11520
1361794832,2216210740,13,5666,435.8461538,1361794815775,1361794827167,2216194515,2216205907,11392
1361794832,2216210744,10,930,93,1361794816094,1361794827166,2216194838,2216205910,11072
1361794832,2216210748,4,377,94.25,1361794827928,1361794828120,2216206676,2216206868,192
1361794832,2216210748,17,6316,371.5294118,1361794815704,1361794827224,2216194452,2216205972,11520
1361794840,2216218748,13,5910,454.6153846,1361794828122,1361794839898,2216206870,2216218646,11776
1361794848,2216226752,670,992003,1480.601493,1361794835860,1361794845844,2216214612,2216224596,9984
1361794865,2216243948,1,64,64,1361794839760,1361794839760,2216218708,2216218708,0
1361794880,2216258772,4,377,94.25,1361794879165,1361794879357,2216257937,2216258129,192
1361794896,2216274768,13,4674,359.5384615,1361794879363,1361794891203,2216258131,2216269971,11840
1361794896,2216274768,4,377,94.25,1361794892034,1361794892226,2216270802,2216270994,192
1361794896,2216274768,775,1145626,1478.227097,1361794879874,1361794891138,2216258642,2216269906,11264
1361794909,2216288020,1,46,46,1361794884038,1361794884038,2216263058,2216263058,0
1361794912,2216290780,504,741312,1470.857143,1361794896630,1361794910006,2216275410,2216288786,13376
1361794912,2216290796,16,5619,351.1875,1361794892200,1361794904040,2216270996,2216282836,11840
1361795000,2216378872,6,3996,666,1361794993435,1361794993755,2216372307,2216372627,320
1361795000,2216378872,13,4882,375.5384615,1361794993754,1361794995098,2216372626,2216373970,1344
1361795037,2216416460,3,152,50.66666667,1361795010318,1361795019278,2216389778,2216398738,8960
1361795128,2216506940,4,650,162.5,1361795125843,1361795125971,2216504783,2216504911,128
1361795136,2216514960,41,54048,1318.243902,1361795134977,1361795135681,2216513937,2216514641,704
1361795142,2216520824,2,104,52,1361795117510,1361795120518,2216496334,2216499342,3008
1361795144,2216522952,10,3692,369.2,1361795125958,1361795137798,2216504910,2216516750,11840
1361795144,2216522956,133,193688,1456.300752,1361795139460,1361795142852,2216518416,2216521808,3392
1361795152,2216530972,128,176842,1381.578125,1361795135667,1361795146995,2216514639,2216525967,11328
1361795152,2216530988,4,356,89,1361795137573,1361795146917,2216516561,2216525905,9344
1361795174,2216552892,1,52,52,1361795147010,1361795147010,2216525902,2216525902,0
1361795298,2216677268,3,152,50.66666667,1361795270152,1361795279112,2216649420,2216658380,8960
1361795318,2216697312,3,152,50.66666667,1361795293214,1361795302110,2216672526,2216681422,8896
1361795391,2216769532,1,56,56,1361795365991,1361795365991,2216744523,2216744523,0
1361795402,2216781472,3,152,50.66666667,1361795377851,1361795386811,2216757323,2216766283,8960
1361795499,2216877980,2,120,60,1361795474280,1361795477288,2216853260,2216856268,3008
1361795507,2216885952,2,120,60,1361795479298,1361795482306,2216858250,2216861258,3008
1361795511,2216889912,2,120,60,1361795484328,1361795487336,2216863240,2216866248,3008
1361795551,2216930020,3,176,58.66666667,1361795526460,1361795535484,2216905480,2216914504,9024
1361795579,2216958028,3,176,58.66666667,1361795551223,1361795558135,2216930251,2216937163,6912
1361795651,2217030304,11,3267,297,1361795624930,1361795625826,2217004234,2217005130,896
1361795719,2217098416,3,152,50.66666667,1361795693295,1361795702255,2217072711,2217081671,8960
1361795723,2217102360,1,52,52,1361795695525,1361795695525,2217074885,2217074885,0
1361795752,2217131296,2,141,70.5,1361795744488,1361795744488,2217123784,2217123784,0
1361795767,2217146448,3,144,48,1361795739726,1361795748622,2217119174,2217128070,8896
1361795771,2217150452,11,3267,297,1361795743756,1361795744460,2217123208,2217123912,704
1361795812,2217191220,1,48,48,1361795785330,1361795785330,2217164550,2217164550,0
1361796004,2217382604,3,152,50.66666667,1361795976277,1361795985237,2217354881,2217363841,8960
1361796065,2217443536,2,141,70.5,1361796059354,1361796059354,2217437890,2217437890,0
1361796104,2217482928,3,152,50.66666667,1361796077519,1361796086479,2217456447,2217465407,8960
1361796256,2217635456,2,104,52,1361796230016,1361796233024,2217609472,2217612480,3008
1361796280,2217659460,3,152,50.66666667,1361796253177,1361796262073,2217632637,2217641533,8896
1361796329,2217707664,11,953,86.63636364,1361796313044,1361796324564,2217691708,2217703228,11520
1361796329,2217707668,12,999,83.25,1361796313299,1361796324499,2217691967,2217703167,11200
1361796329,2217707668,12,999,83.25,1361796313554,1361796324498,2217692222,2217703166,10944
1361796330,2217708904,15,6289,419.2666667,1361796312229,1361796324325,2217691133,2217703229,12096
1361796365,2217743548,3,152,50.66666667,1361796338826,1361796347850,2217717374,2217726398,9024
1361796385,2217763724,11,953,86.63636364,1361796370970,1361796382810,2217749694,2217761534,11840
1361796385,2217763724,11,953,86.63636364,1361796371672,1361796382744,2217750396,2217761468,11072
1361796385,2217763736,12,999,83.25,1361796370702,1361796382798,2217749438,2217761534,12096
1361796385,2217763736,11,953,86.63636364,1361796371277,1361796382797,2217750013,2217761533,11520
1361796509,2217887944,3,176,58.66666667,1361796484857,1361796493817,2217863801,2217872761,8960
1361796577,2217955996,1,60,60,1361796550085,1361796550085,2217929081,2217929081,0
1361796681,2218060096,3,152,50.66666667,1361796655072,1361796664096,2218034168,2218043192,9024
1361796717,2218096120,1,46,46,1361796691017,1361796691017,2218070137,2218070137,0
1361796729,2218108152,3,144,48,1361796701417,1361796710313,2218080569,2218089465,8896
1361796954,2218332592,1,46,46,1361796927059,1361796927059,2218305651,2218305651,0
1361796958,2218336544,3,152,50.66666667,1361796931394,1361796940418,2218309938,2218318962,9024
1361797119,2218498036,1,48,48,1361797092375,1361797092375,2218471411,2218471411,0
1361797119,2218498036,1,48,48,1361797092373,1361797092373,2218471409,2218471409,0
1361797120,2218498844,1,48,48,1361797092694,1361797092694,2218471538,2218471538,0
1361797138,2218517100,3,152,50.66666667,1361797112788,1361797121812,2218491888,2218500912,9024
1361797218,2218597056,3,152,50.66666667,1361797190463,1361797199423,2218569519,2218578479,8960
1361797238,2218617156,3,152,50.66666667,1361797213659,1361797222555,2218592815,2218601711,8896
1361797326,2218705224,3,152,50.66666667,1361797298261,1361797307285,2218677485,2218686509,9024
1361797366,2218745340,2,100,50,1361797339812,1361797348708,2218719152,2218728048,8896
1361797535,2218913520,3,176,58.66666667,1361797508949,1361797515733,2218887469,2218894253,6784
1361797643,2219021768,1,52,52,1361797616284,1361797616284,2218995052,2218995052,0
1361797647,2219025772,3,152,50.66666667,1361797621910,1361797630998,2219000682,2219009770,9088
1361797691,2219069860,3,144,48,1361797663164,1361797672124,2219042024,2219050984,8960
1361797831,2219210284,1,46,46,1361797803989,1361797803989,2219183273,2219183273,0
1361797915,2219294296,3,152,50.66666667,1361797890693,1361797899717,2219269989,2219279013,9024
1361797935,2219314332,5,250,50,1361797909346,1361797931938,2219288678,2219311270,22592
1361797983,2219362392,1,48,48,1361797955941,1361797955941,2219335333,2219335333,0
1361797995,2219374440,3,152,50.66666667,1361797968691,1361797977715,2219348131,2219357155,9024
1361798011,2219390456,1,48,48,1361797985379,1361797985379,2219364835,2219364835,0
1361798019,2219398396,3,176,58.66666667,1361797990942,1361797999966,2219370338,2219379362,9024
1361798096,2219474692,3,152,50.66666667,1361798071263,1361798080223,2219449955,2219458915,8960
1361798194,2219573068,12,999,83.25,1361798175717,1361798187301,2219554785,2219566369,11584
1361798194,2219573072,12,999,83.25,1361798175970,1361798187298,2219555042,2219566370,11328
1361798194,2219573072,11,953,86.63636364,1361798176225,1361798187297,2219555297,2219566369,11072
1361798194,2219573084,15,6289,419.2666667,1361798175254,1361798187286,2219554338,2219566370,12032
1361798200,2219578872,3,152,50.66666667,1361798174123,1361798183019,2219552995,2219561891,8896
1361798258,2219637116,11,953,86.63636364,1361798240500,1361798252084,2219619616,2219631200,11584
1361798258,2219637128,12,999,83.25,1361798239977,1361798252073,2219619105,2219631201,12096
1361798258,2219637128,11,953,86.63636364,1361798240233,1361798252073,2219619361,2219631201,11840
1361798258,2219637156,11,953,86.63636364,1361798240717,1361798252045,2219619873,2219631201,11328
1361798284,2219663092,3,152,50.66666667,1361798258508,1361798267468,2219637600,2219646560,8960
1361798352,2219731208,2,100,50,1361798326553,1361798335513,2219705761,2219714721,8960
1361798360,2219739320,1,46,46,1361798334888,1361798334888,2219714208,2219714208,0
1361798533,2219911780,3,176,58.66666667,1361798506368,1361798515072,2219885148,2219893852,8704
1361798605,2219984052,3,152,50.66666667,1361798578095,1361798587055,2219957147,2219966107,8960
1361798649,2220028108,3,144,48,1361798624376,1361798633336,2220003484,2220012444,8960
1361798878,2220256884,3,152,50.66666667,1361798851218,1361798860178,2220230102,2220239062,8960
1361799058,2220437252,3,152,50.66666667,1361799030754,1361799039842,2220410006,2220419094,9088
1361799158,2220537384,3,152,50.66666667,1361799133786,1361799142682,2220513170,2220522066,8896
1361799246,2220625472,3,152,50.66666667,1361799218177,1361799227201,2220597649,2220606673,9024
1361799335,2220713544,1,46,46,1361799307874,1361799307874,2220686418,2220686418,0
1361799339,2220717612,2,104,52,1361799311515,1361799314459,2220690127,2220693071,2944
1361799403,2220781652,3,152,50.66666667,1361799378677,1361799387637,2220757329,2220766289,8960
1361799491,2220869732,2,120,60,1361799464545,1361799466593,2220843277,2220845325,2048
1361799567,2220946072,2,100,50,1361799542542,1361799548494,2220921614,2220927566,5952
1361799611,2220990264,3,144,48,1361799585675,1361799594763,2220964939,2220974027,9088
1361799836,2221214888,3,152,50.66666667,1361799811267,1361799820291,2221190155,2221199179,9024
1361799868,2221246924,2,100,50,1361799842077,1361799851037,2221221001,2221229961,8960
1361800016,2221395360,3,152,50.66666667,1361799990692,1361799999716,2221370052,2221379076,9024
1361800059,2221438176,15,6289,419.2666667,1361800044574,1361800056606,2221423750,2221435782,12032
1361800059,2221438180,12,999,83.25,1361800045402,1361800056602,2221424582,2221435782,11200
1361800059,2221438216,12,999,83.25,1361800045046,1361800056566,2221424262,2221435782,11520
1361800059,2221438220,12,999,83.25,1361800045682,1361800056562,2221424902,2221435782,10880
1361800120,2221499428,3,152,50.66666667,1361800094111,1361800103071,2221473539,2221482499,8960
1361800123,2221502220,11,953,86.63636364,1361800110001,1361800122481,2221489221,2221501701,12480
1361800123,2221502220,11,953,86.63636364,1361800110511,1361800122479,2221489731,2221501699,11968
1361800123,2221502256,11,953,86.63636364,1361800110219,1361800122443,2221489475,2221501699,12224
1361800123,2221502260,12,999,83.25,1361800110730,1361800122442,2221489990,2221501702,11712
1361800361,2221739820,3,152,50.66666667,1361800336763,1361800345723,2221715583,2221724543,8960
1361800485,2221864004,3,176,58.66666667,1361800457413,1361800467013,2221836417,2221846017,9600
1361800529,2221908220,3,152,50.66666667,1361800500843,1361800509803,2221880063,2221889023,8960
1361800573,2221952180,3,144,48,1361800547472,1361800556432,2221926652,2221935612,8960
1361800874,2222253172,1,46,46,1361800849303,1361800849303,2222228475,2222228475,0
1361801020,2222398852,5,714,142.8,1361801012821,1361801012885,2222391673,2222391737,64
1361801036,2222414820,33,12489,378.4545455,1361801012915,1361801030771,2222391735,2222409591,17856
1361801036,2222414864,57,71232,1249.684211,1361801021957,1361801033861,2222400821,2222412725,11904
1361801050,2222429416,9,2681,297.8888889,1361801024096,1361801045344,2222403512,2222424760,21248
1361801052,2222431140,4,704,176,1361801034226,1361801045618,2222413366,2222424758,11392
1361801052,2222431144,23,22634,984.0869565,1361801034800,1361801045616,2222413944,2222424760,10816
1361801084,2222463148,22,22499,1022.681818,1361801075944,1361801079912,2222455092,2222459060,3968
1361801084,2222463152,5,1273,254.6,1361801068071,1361801079591,2222447223,2222458743,11520
1361801084,2222463160,7,2214,316.2857143,1361801067805,1361801079581,2222446965,2222458741,11776
1361801084,2222463192,4,351,87.75,1361801081149,1361801081277,2222460341,2222460469,128
1361801084,2222463228,3,430,143.3333333,1361801081114,1361801081242,2222460342,2222460470,128
1361801084,2222463228,3,608,202.6666667,1361801081880,1361801081944,2222461108,2222461172,64
1361801092,2222471172,3,281,93.66666667,1361801082386,1361801091346,2222461558,2222470518,8960
1361801092,2222471184,10,5144,514.4,1361801080071,1361801091271,2222459255,2222470455,11200
1361801092,2222471184,6,2296,382.6666667,1361801080261,1361801091269,2222459445,2222470453,11008
1361801092,2222471216,13,6687,514.3846154,1361801082982,1361801086822,2222462198,2222466038,3840
1361801092,2222471216,19,8333,438.5789474,1361801067238,1361801085286,2222446454,2222464502,18048
1361801092,2222471216,4,736,184,1361801079524,1361801091236,2222458740,2222470452,11712
1361801092,2222471220,15,15474,1031.6,1361801079715,1361801091299,2222458935,2222470519,11584
1361801092,2222471220,12,7237,603.0833333,1361801079970,1361801091298,2222459190,2222470518,11328
1361801092,2222471220,9,3658,406.4444444,1361801079970,1361801091234,2222459190,2222470454,11264
1361801092,2222471220,33,37003,1121.30303,1361801079970,1361801091234,2222459190,2222470454,11264
1361801092,2222471220,13,11304,869.5384615,1361801079970,1361801085282,2222459190,2222464502,5312
1361801092,2222471220,12,8703,725.25,1361801079970,1361801085282,2222459190,2222464502,5312
1361801092,2222471220,8,3561,445.125,1361801079970,1361801091234,2222459190,2222470454,11264
1361801092,2222471220,6,2029,338.1666667,1361801080225,1361801091233,2222459445,2222470453,11008
1361801092,2222471224,4,592,148,1361801081757,1361801091229,2222460981,2222470453,9472
1361801396,2222775404,41,51879,1265.341463,1361801388260,1361801393892,2222767664,2222773296,5632
1361801404,2222783456,17,18071,1063,1361801395185,1361801399537,2222774641,2222778993,4352
1361801404,2222783460,9,5629,625.4444444,1361801395503,1361801398959,2222774963,2222778419,3456
1361801427,2222805984,1,52,52,1361801399431,1361801399431,2222778415,2222778415,0
1361801431,2222809984,1,52,52,1361801405448,1361801405448,2222784432,2222784432,0
1361801575,2222954236,1,46,46,1361801547530,1361801547530,2222926766,2222926766,0
1361801933,2223311720,12,999,83.25,1361801916937,1361801928393,2223295657,2223307113,11456
1361801933,2223311724,12,999,83.25,1361801917254,1361801928390,2223295978,2223307114,11136
1361801933,2223311724,15,6289,419.2666667,1361801916293,1361801928389,2223295017,2223307113,12096
1361801933,2223311760,12,999,83.25,1361801917471,1361801928287,2223296231,2223307047,10816
1361802013,2223391768,15,6289,419.2666667,1361802003480,1361802012632,2223382248,2223391400,9152
1361802064,2223442892,1,46,46,1361802038873,1361802038873,2223417765,2223417765,0
1361802240,2223619464,1,48,48,1361802215198,1361802215198,2223594662,2223594662,0
1361802349,2223728008,6,3996,666,1361802346533,1361802346853,2223725541,2223725861,320
1361802349,2223728044,6,3996,666,1361802345153,1361802346497,2223724197,2223725541,1344
1361802357,2223736000,12,999,83.25,1361802344617,1361802354409,2223723617,2223733409,9792
1361802357,2223736016,16,6335,395.9375,1361802343579,1361802354459,2223722595,2223733475,10880
1361802357,2223736016,12,999,83.25,1361802344026,1361802354458,2223723042,2223733474,10432
1361802357,2223736084,11,953,86.63636364,1361802344277,1361802354325,2223723361,2223733409,10048
1361802365,2223744076,25,17767,710.68,1361802350879,1361802361631,2223729955,2223740707,10752
1361802365,2223744096,8,1678,209.75,1361802346762,1361802357194,2223725858,2223736290,10432
1361802368,862060712,18,21928,1218.222222,1361802350103,1361802362071,862042815,862054783,11968
1361802369,2223747756,1,46,46,1361802343774,1361802343774,2223722530,2223722530,0
1361802373,2223751824,21,8260,393.3333333,1361802346713,1361802363353,2223725537,2223742177,16640
1361802373,2223752116,14,3460,247.1428571,1361802351030,1361802368374,2223730146,2223747490,17344
1361802381,2223760096,4,220,55,1361802375113,1361802375177,2223754209,2223754273,64
1361802397,2223776104,6,3996,666,1361802396481,1361802396673,2223775585,2223775777,192
1361802405,2223784048,11,4766,433.2727273,1361802396732,1361802398204,2223775780,2223777252,1472
1361802797,2224176480,15,6289,419.2666667,1361802783750,1361802795206,2224163230,2224174686,11456
1361802797,2224176500,11,953,86.63636364,1361802784367,1361802795183,2224163867,2224174683,10816
1361802797,2224176500,12,999,83.25,1361802784623,1361802795119,2224164123,2224174619,10496
1361802798,2224176548,11,953,86.63636364,1361802785063,1361802796135,2224163611,2224174683,11072
1361802885,2224264456,16,6372,398.25,1361802866713,1361802878809,2224246169,2224258265,12096
1361802885,2224264460,12,999,83.25,1361802867157,1361802878805,2224246617,2224258265,11648
1361802885,2224264464,11,953,86.63636364,1361802867412,1361802878804,2224246876,2224258268,11392
1361802885,2224264532,11,953,86.63636364,1361802867661,1361802878733,2224247193,2224258265,11072
1361803110,2224488672,11,953,86.63636364,1361803094887,1361803106023,2224473559,2224484695,11136
1361803110,2224488724,15,6289,419.2666667,1361803093876,1361803105972,2224472600,2224484696,12096
1361803110,2224488728,12,999,83.25,1361803094256,1361803105968,2224472984,2224484696,11712
1361803110,2224488752,12,999,83.25,1361803094489,1361803105945,2224473241,2224484697,11456
1361803192,862884968,11,2350,213.6363636,1361803190940,1361803191132,862883908,862884100,192
1361803192,862884972,28,33745,1205.178571,1361803191387,1361803191515,862884359,862884487,128
1361803192,862884972,32,42334,1322.9375,1361803191323,1361803191771,862884295,862884743,448
1361803192,862884972,10,2122,212.2,1361803191323,1361803191899,862884295,862884871,576
1361803192,862884972,7,1582,226,1361803191515,1361803191963,862884487,862884935,448
1361803192,862884972,10,2682,268.2,1361803191515,1361803191835,862884487,862884807,320
1361803192,862884972,10,2426,242.6,1361803191642,1361803191770,862884614,862884742,128
1361803192,862884972,11,2350,213.6363636,1361803191642,1361803191898,862884614,862884870,256
1361803192,862884976,13,8742,672.4615385,1361803189655,1361803189783,862882631,862882759,128
1361803192,862884976,9,2246,249.5555556,1361803190933,1361803191061,862883909,862884037,128
1361803192,862884976,8,1122,140.25,1361803190933,1361803191061,862883909,862884037,128
1361803192,862884976,44,54595,1240.795455,1361803191060,1361803191828,862884036,862884804,768
1361803192,862884976,17,15707,923.9411765,1361803191124,1361803191252,862884100,862884228,128
1361803192,862884980,9,1718,190.8888889,1361803191315,1361803191699,862884295,862884679,384
1361803192,862884980,17,16171,951.2352941,1361803191315,1361803191571,862884295,862884551,256
1361803192,862884980,9,1958,217.5555556,1361803191699,1361803191955,862884679,862884935,256
1361803192,862884980,11,4678,425.2727273,1361803189392,1361803189648,862882372,862882628,256
1361803192,862884980,5,859,171.8,1361803189264,1361803189328,862882244,862882308,64
1361803200,862892968,10,3504,350.4,1361803192030,1361803192222,862884998,862885190,192
1361803200,862892968,8,1768,221,1361803192030,1361803192286,862884998,862885254,256
1361803200,862892968,8,1752,219,1361803192030,1361803192350,862884998,862885318,320
1361803200,862892968,9,6412,712.4444444,1361803192158,1361803192286,862885126,862885254,128
1361803200,862892972,8,1464,183,1361803192857,1361803192985,862885829,862885957,128
1361803200,862892972,10,2458,245.8,1361803193433,1361803193561,862886405,862886533,128
1361803200,862892976,9,1516,168.4444444,1361803192022,1361803192278,862884998,862885254,256
1361803200,862892976,13,10145,780.3846154,1361803192022,1361803192278,862884998,862885254,256
1361803200,862892976,10,6928,692.8,1361803192022,1361803192342,862884998,862885318,320
1361803200,862892980,10,2618,261.8,1361803191314,1361803192082,862884294,862885062,768
1361803200,862892980,8,10525,1315.625,1361803191953,1361803192017,862884933,862884997,64
1361803216,862908968,8,1192,149,1361803213791,1361803213855,862906759,862906823,64
1361803216,862908968,9,4134,459.3333333,1361803213727,1361803213791,862906695,862906759,64
1361803216,862908968,8,1384,173,1361803214430,1361803214494,862907398,862907462,64
1361803216,862908968,9,1196,132.8888889,1361803214494,1361803214622,862907462,862907590,128
1361803216,862908968,8,1368,171,1361803214557,1361803214749,862907525,862907717,192
1361803216,862908968,8,1192,149,1361803214621,1361803214685,862907589,862907653,64
1361803216,862908968,8,1304,163,1361803214685,1361803214813,862907653,862907781,128
1361803216,862908968,9,1164,129.3333333,1361803214557,1361803214685,862907525,862907653,128
1361803216,862908968,8,1368,171,1361803214621,1361803214749,862907589,862907717,128
1361803216,862908968,9,1404,156,1361803214812,1361803215068,862907780,862908036,256
1361803216,862908968,10,2378,237.8,1361803215200,1361803215712,862908168,862908680,512
1361803216,862908968,9,2134,237.1111111,1361803215008,1361803215072,862907976,862908040,64
1361803216,862908972,10,3018,301.8,1361803215195,1361803215515,862908167,862908487,320
1361803216,862908972,14,12463,890.2142857,1361803215387,1361803215899,862908359,862908871,512
1361803216,862908972,17,13915,818.5294118,1361803215515,1361803215899,862908487,862908871,384
1361803216,862908972,15,12707,847.1333333,1361803215707,1361803215899,862908679,862908871,192
1361803216,862908972,9,1558,173.1111111,1361803211290,1361803211802,862904262,862904774,512
1361803216,862908972,8,1490,186.25,1361803211801,1361803211929,862904773,862904901,128
1361803216,862908972,9,3782,420.2222222,1361803212377,1361803212505,862905349,862905477,128
1361803216,862908972,9,4502,500.2222222,1361803212632,1361803212696,862905604,862905668,64
1361803216,862908976,12,7954,662.8333333,1361803212888,1361803213144,862905864,862906120,256
1361803216,862908976,14,12997,928.3571429,1361803213783,1361803213911,862906759,862906887,128
1361803216,862908976,9,4940,548.8888889,1361803213783,1361803213847,862906759,862906823,64
1361803216,862908976,23,26515,1152.826087,1361803214421,1361803214741,862907397,862907717,320
1361803216,862908976,9,1196,132.8888889,1361803214485,1361803214677,862907461,862907653,192
1361803216,862908976,8,1464,183,1361803214808,1361803215064,862907784,862908040,256
1361803216,862908976,9,1516,168.4444444,1361803214936,1361803215448,862907912,862908424,512
1361803216,862908980,8,1576,197,1361803214932,1361803215188,862907912,862908168,256
1361803216,862908980,8,1576,197,1361803214932,1361803215060,862907912,862908040,128
1361803216,862908980,8,1986,248.25,1361803215187,1361803215443,862908167,862908423,256
1361803216,862908980,18,18148,1008.222222,1361803215187,1361803215827,862908167,862908807,640
1361803216,862908980,12,10087,840.5833333,1361803215187,1361803215507,862908167,862908487,320
1361803216,862908980,13,9979,767.6153846,1361803215187,1361803215507,862908167,862908487,320
1361803216,862908980,10,3866,386.6,1361803215379,1361803215827,862908359,862908807,448
1361803216,862908980,16,14231,889.4375,1361803215442,1361803215890,862908422,862908870,448
1361803216,862908980,10,3994,399.4,1361803215570,1361803215890,862908550,862908870,320
1361803216,862908992,10,7098,709.8,1361803211912,1361803212104,862904904,862905096,192
1361803216,862908992,9,5574,619.3333333,1361803212487,1361803212615,862905479,862905607,128
1361803216,862908992,9,5270,585.5555556,1361803212358,1361803212422,862905350,862905414,64
1361803216,862908992,14,12703,907.3571429,1361803212422,1361803212550,862905414,862905542,128
1361803216,862908992,11,8142,740.1818182,1361803212550,1361803212614,862905542,862905606,64
1361803216,862908992,9,4086,454,1361803212614,1361803212742,862905606,862905734,128
1361803216,862908992,9,6310,701.1111111,1361803212678,1361803212806,862905670,862905798,128
1361803216,862908992,15,12259,817.2666667,1361803212870,1361803213126,862905862,862906118,256
1361803216,2224595012,1,46,46,1361803187411,1361803187411,2224566423,2224566423,0
1361803217,2224596120,1,46,46,1361803187302,1361803187302,2224566422,2224566422,0
1361803216,862908992,1,52,52,1361803191942,1361803191942,862884934,862884934,0
1361803217,862910508,1,52,52,1361803191426,1361803191426,862884934,862884934,0
1361803217,862910536,1,52,52,1361803191397,1361803191397,862884933,862884933,0
1361803224,862916968,9,1350,150,1361803221663,1361803221727,862914631,862914695,64
1361803224,862916968,12,1634,136.1666667,1361803217823,1361803218463,862910791,862911431,640
1361803224,862916968,12,1922,160.1666667,1361803218142,1361803218526,862911110,862911494,384
1361803224,862916968,12,1490,124.1666667,1361803218142,1361803218462,862911110,862911430,320
1361803224,862916968,9,1516,168.4444444,1361803216221,1361803216413,862909189,862909381,192
1361803224,862916968,10,2336,233.6,1361803216221,1361803216413,862909189,862909381,192
1361803224,862916968,8,1384,173,1361803218653,1361803218781,862911621,862911749,128
1361803224,862916968,9,2294,254.8888889,1361803218717,1361803218781,862911685,862911749,64
1361803224,862916972,21,22432,1068.190476,1361803215578,1361803216218,862908550,862909190,640
1361803224,862916972,10,4874,487.4,1361803215770,1361803216346,862908742,862909318,576
1361803224,862916972,12,7138,594.8333333,1361803223577,1361803223705,862916549,862916677,128
1361803224,862916972,13,10875,836.5384615,1361803215833,1361803216345,862908805,862909317,512
1361803224,862916972,9,3436,381.7777778,1361803217241,1361803217305,862910213,862910277,64
1361803224,862916972,9,1638,182,1361803215836,1361803216348,862908808,862909320,512
1361803224,862916976,8,1576,197,1361803221207,1361803221335,862914183,862914311,128
1361803224,862916976,8,1688,211,1361803221527,1361803221591,862914503,862914567,64
1361803224,862916976,10,4864,486.4,1361803221783,1361803221847,862914759,862914823,64
1361803224,862916976,12,1922,160.1666667,1361803217878,1361803218134,862910854,862911110,256
1361803224,862916976,12,1714,142.8333333,1361803217814,1361803218518,862910790,862911494,704
1361803224,862916976,13,2694,207.2307692,1361803217942,1361803218582,862910918,862911558,640
1361803224,862916976,12,1922,160.1666667,1361803217942,1361803218134,862910918,862911110,192
1361803224,862916976,13,2630,202.3076923,1361803218005,1361803218325,862910981,862911301,320
1361803224,862916976,9,1756,195.1111111,1361803216213,1361803216405,862909189,862909381,192
1361803224,862916976,8,1736,217,1361803216213,1361803216405,862909189,862909381,192
1361803224,862916976,12,1698,141.5,1361803218325,1361803218709,862911301,862911685,384
1361803224,862916976,15,10035,669,1361803218388,1361803221268,862911364,862914244,2880
1361803224,862916976,9,1958,217.5555556,1361803218452,1361803219668,862911428,862912644,1216
1361803224,862916980,9,4694,521.5555556,1361803215698,1361803216082,862908678,862909062,384
1361803224,862916980,10,5306,530.6,1361803215762,1361803216274,862908742,862909254,512
1361803224,862916980,10,2442,244.2,1361803215761,1361803216337,862908741,862909317,576
1361803224,862916980,9,2470,274.4444444,1361803215825,1361803216081,862908805,862909061,256
1361803224,862916992,8,1576,197,1361803221190,1361803221382,862914182,862914374,192
1361803224,862916992,8,1576,197,1361803221190,1361803221382,862914182,862914374,192
1361803224,862916992,8,1576,197,1361803221190,1361803221318,862914182,862914310,128
1361803224,862916992,10,2298,229.8,1361803221446,1361803223558,862914438,862916550,2112
1361803230,2224608784,41,49270,1201.707317,1361803219829,1361803229301,2224598613,2224608085,9472
1361803232,862924976,8,1576,197,1361803229655,1361803229783,862922631,862922759,128
1361803232,862924976,8,1576,197,1361803229719,1361803229783,862922695,862922759,64
1361803232,862924976,8,1576,197,1361803229719,1361803229847,862922695,862922823,128
1361803232,862924976,8,1576,197,1361803229783,1361803229847,862922759,862922823,64
1361803232,862924976,10,1658,165.8,1361803225814,1361803225942,862918790,862918918,128
1361803232,862924976,9,1350,150,1361803229910,1361803230102,862922886,862923078,192
1361803232,862924976,17,14507,853.3529412,1361803225942,1361803226326,862918918,862919302,384
1361803232,862924976,8,1538,192.25,1361803224404,1361803224532,862917380,862917508,128
1361803232,862924980,12,7954,662.8333333,1361803224403,1361803224595,862917383,862917575,192
1361803232,862924980,9,2790,310,1361803226963,1361803227091,862919943,862920071,128
1361803232,862924980,9,3510,390,1361803227091,1361803227155,862920071,862920135,64
1361803232,862924980,9,2630,292.2222222,1361803227091,1361803227219,862920071,862920199,128
1361803232,862924980,8,1410,176.25,1361803227218,1361803227282,862920198,862920262,64
1361803232,862924980,9,2806,311.7777778,1361803227154,1361803227218,862920134,862920198,64
1361803232,862924980,12,9943,828.5833333,1361803227346,1361803227538,862920326,862920518,192
1361803232,862924980,13,11643,895.6153846,1361803227409,1361803227537,862920389,862920517,128
1361803232,862924980,8,1144,143,1361803227665,1361803227985,862920645,862920965,320
1361803232,862924980,8,1144,143,1361803227601,1361803227857,862920581,862920837,256
1361803232,862924984,8,1144,143,1361803227728,1361803227920,862920712,862920904,192
1361803232,862924984,8,1144,143,1361803227792,1361803227984,862920776,862920968,192
1361803232,862924984,9,2796,310.6666667,1361803227855,1361803228047,862920839,862921031,192
1361803232,862924984,9,2284,253.7777778,1361803225359,1361803225423,862918343,862918407,64
1361803232,862924984,8,1554,194.25,1361803225358,1361803225806,862918342,862918790,448
1361803232,862924984,9,1510,167.7777778,1361803229198,1361803229390,862922182,862922374,192
1361803232,862924984,14,8778,627,1361803229262,1361803229646,862922246,862922630,384
1361803232,862924988,9,1782,198,1361803230474,1361803230602,862923462,862923590,128
1361803232,862924988,9,1350,150,1361803230601,1361803230665,862923589,862923653,64
1361803232,862924988,8,1586,198.25,1361803226953,1361803227017,862919941,862920005,64
1361803232,862924988,9,3942,438,1361803227017,1361803227081,862920005,862920069,64
1361803232,862924988,8,1282,160.25,1361803226889,1361803226953,862919877,862919941,64
1361803232,862925004,8,1298,162.25,1361803227196,1361803227324,862920200,862920328,128
1361803232,862925004,11,7182,652.9090909,1361803227259,1361803227451,862920263,862920455,192
1361803232,862925004,9,1494,166,1361803227387,1361803227643,862920391,862920647,256
1361803232,862925004,8,1426,178.25,1361803227387,1361803227515,862920391,862920519,128
1361803232,862925004,8,1240,155,1361803227578,1361803227770,862920582,862920774,192
1361803232,862925004,8,1144,143,1361803227642,1361803227706,862920646,862920710,64
1361803232,862925004,8,1144,143,1361803227578,1361803227898,862920582,862920902,320
1361803232,862925004,8,1160,145,1361803227578,1361803227898,862920582,862920902,320
1361803232,862925004,9,1398,155.3333333,1361803228280,1361803228408,862921284,862921412,128
1361803232,862925004,8,1320,165,1361803228344,1361803228408,862921348,862921412,64
1361803232,862925004,9,1558,173.1111111,1361803229048,1361803229240,862922052,862922244,192
1361803232,862925004,9,1494,166,1361803229116,1361803229308,862922120,862922312,192
1361803240,862932980,14,10943,781.6428571,1361803235795,1361803236563,862928775,862929543,768
1361803240,862932984,9,2780,308.8888889,1361803237199,1361803237263,862930183,862930247,64
1361803240,862932984,9,2796,310.6666667,1361803237262,1361803237390,862930246,862930374,128
1361803240,862932984,8,1400,175,1361803237326,1361803237390,862930310,862930374,64
1361803240,862932988,9,1350,150,1361803238412,1361803238476,862931400,862931464,64
1361803240,862933000,8,1240,155,1361803237181,1361803237309,862930181,862930309,128
1361803240,862933000,12,10743,895.25,1361803237116,1361803237180,862930116,862930180,64
1361803240,862933000,8,1128,141,1361803237248,1361803237312,862930248,862930312,64
1361803248,862940988,28,31066,1109.5,1361803243340,1361803243724,862936328,862936712,384
1361803248,862941004,7,1071,153,1361803242811,1361803242939,862935815,862935943,128
1361805474,2226853308,9,861,95.66666667,1361805448713,1361805448905,2226828021,2226828213,192
1361805474,2226853384,8,815,101.875,1361805448890,1361805449082,2226828274,2226828466,192
1361805474,2226853412,8,942,117.75,1361805449310,1361805464542,2226828722,2226843954,15232
1361805506,2226885376,1,162,162,1361805480706,1361805480706,2226860082,2226860082,0
1361805538,2226917444,1,162,162,1361805512768,1361805512768,2226892212,2226892212,0
1361805571,2226949660,3,441,147,1361805543629,1361805549709,2226922289,2226928369,6080
1361805603,2226981672,1,162,162,1361805577859,1361805577859,2226956531,2226956531,0
1361805632,2227011320,2,126,63,1361805630394,1361805631418,2227009714,2227010738,1024
1361805632,2227011364,2,126,63,1361805630348,1361805631372,2227009712,2227010736,1024
1361805640,2227019352,2,126,63,1361805633434,1361805637466,2227012786,2227016818,4032
1361805640,2227019412,2,126,63,1361805633375,1361805637407,2227012787,2227016819,4032
1361805671,2227049808,1,63,63,1361805646010,1361805646010,2227024818,2227024818,0
1361805671,2227049884,1,63,63,1361805645934,1361805645934,2227024818,2227024818,0
1361805960,2227338928,1,60,60,1361805933822,1361805933822,2227312750,2227312750,0
1361805960,2227339124,1,60,60,1361805932982,1361805932982,2227312106,2227312106,0
1361806349,2227727652,1,46,46,1361806321674,1361806321674,2227700326,2227700326,0
1361806653,2228031920,1,52,52,1361806625273,1361806625273,2228004193,2228004193,0
1361806938,2228316912,3,441,147,1361806913727,1361806919743,2228292639,2228298655,6016
1361807118,2228497192,1,46,46,1361807091492,1361807091492,2228470684,2228470684,0
1361807300,2228679088,1,48,48,1361807273350,1361807273350,2228652438,2228652438,0
1361807301,2228680332,1,48,48,1361807273106,1361807273106,2228652438,2228652438,0
1361807592,2228970588,3,441,147,1361807567606,1361807573622,2228946194,2228952210,6016
1361807652,2229030548,1,46,46,1361807624160,1361807624160,2229002708,2229002708,0
1361807722,2229101016,14,4789,342.0714286,1361807708618,1361807720714,2229087634,2229099730,12096
1361807722,2229101024,14,4789,342.0714286,1361807709825,1361807720705,2229088849,2229099729,10880
1361807722,2229101048,12,1336,111.3333333,1361807710249,1361807720681,2229089297,2229099729,10432
1361807722,2229101052,12,999,83.25,1361807710629,1361807720677,2229089681,2229099729,10048
1361807732,2229110728,12,3319,276.5833333,1361807705899,1361807706539,2229084627,2229085267,640
1361807736,2229114716,1,46,46,1361807710196,1361807710196,2229088912,2229088912,0
1361807856,2229234776,1,46,46,1361807828151,1361807828151,2229206927,2229206927,0
1361807984,2229363384,1,46,46,1361807959063,1361807959063,2229338447,2229338447,0
1361808365,2229744468,1,46,46,1361808338236,1361808338236,2229717704,2229717704,0
1361808374,2229752504,6,324,54,1361808346751,1361808371775,2229725255,2229750279,25024
1361808377,2229756484,1,134,134,1361808349098,1361808349098,2229728582,2229728582,0
1361808381,2229760412,4,734,183.5,1361808354932,1361808355124,2229734344,2229734536,192
1361808381,2229760436,5,804,160.8,1361808355101,1361808356957,2229734537,2229736393,1856
1361808381,2229760436,3,387,129,1361808355101,1361808355101,2229734537,2229734537,0
1361808381,2229760484,6,324,54,1361808354476,1361808377964,2229733960,2229757448,23488
1361808381,2229760492,3,387,129,1361808355043,1361808355043,2229734535,2229734535,0
1361808385,2229764444,1,46,46,1361808359315,1361808359315,2229738759,2229738759,0
1361808386,2229764528,1,46,46,1361808360234,1361808360234,2229738762,2229738762,0
1361808389,2229768472,1,52,52,1361808362870,1361808362870,2229742342,2229742342,0
1361808393,2229772428,1,46,46,1361808364899,1361808364899,2229744327,2229744327,0
1361808394,2229772512,2,265,132.5,1361808365880,1361808366008,2229744392,2229744520,128
1361808401,2229780464,6,324,54,1361808375807,1361808400767,2229755271,2229780231,24960
1361808406,2229784568,1,52,52,1361808381633,1361808381633,2229760201,2229760201,0
1361808410,2229788488,6,324,54,1361808383953,1361808408977,2229762441,2229787465,25024
1361808410,2229788488,1,46,46,1361808384206,1361808384206,2229762694,2229762694,0
1361808417,2229796416,1,134,134,1361808389168,1361808389168,2229768584,2229768584,0
1361808434,2229812600,6,324,54,1361808406688,1361808431648,2229785288,2229810248,24960
1361808434,2229812724,1,52,52,1361808408674,1361808408674,2229787398,2229787398,0
1361808438,2229816680,5,270,54,1361808413839,1361808433807,2229792519,2229812487,19968
1361808438,2229816716,1,46,46,1361808410666,1361808410666,2229789382,2229789382,0
1361808446,2229824632,1,46,46,1361808420285,1361808420285,2229798917,2229798917,0
1361808446,2229824716,2,265,132.5,1361808421034,1361808421226,2229799750,2229799942,192
1361808451,2229829680,4,272,68,1361808429904,1361808446608,2229808584,2229825288,16704
1361808454,2229832704,1,52,52,1361808426486,1361808426486,2229805190,2229805190,0
1361808459,2229837744,2,98,49,1361808445646,1361808455630,2229824390,2229834374,9984
1361808462,2229840736,6,324,54,1361808436504,1361808459864,2229815240,2229838600,23360
1361808466,2229844604,7,378,54,1361808438940,1361808463132,2229817544,2229841736,24192
1361808470,2229848684,5,364,72.8,1361808445641,1361808454729,2229824325,2229833413,9088
1361808470,2229848848,4,1158,289.5,1361808445285,1361808445477,2229824133,2229824325,192
1361808470,2229848852,4,930,232.5,1361808445537,1361808463393,2229824389,2229842245,17856
1361808474,2229852640,9,1926,214,1361808446519,1361808466679,2229825159,2229845319,20160
1361808474,2229852640,11,2395,217.7272727,1361808446518,1361808464950,2229825158,2229843590,18432
1361808474,2229852724,11,2397,217.9090909,1361808446434,1361808464930,2229825158,2229843654,18496
1361808474,2229852724,27,5146,190.5925926,1361808446434,1361808466978,2229825158,2229845702,20544
1361808474,2229852728,50,19649,392.98,1361808446432,1361808465760,2229825160,2229844488,19328
1361808474,2229852728,21,3235,154.047619,1361808446432,1361808464928,2229825160,2229843656,18496
1361808475,2229853744,7,473,67.57142857,1361808453709,1361808469005,2229832453,2229847749,15296
1361808490,2229868760,6,324,54,1361808463999,1361808489023,2229842759,2229867783,25024
1361808494,2229872676,6,324,54,1361808467218,1361808491410,2229845894,2229870086,24192
1361808498,2229876656,1,52,52,1361808471590,1361808471590,2229850246,2229850246,0
1361808502,2229880720,10,1909,190.9,1361808475684,1361808500900,2229854404,2229879620,25216
1361808502,2229880812,9,2838,315.3333333,1361808475593,1361808499721,2229854405,2229878533,24128
1361808502,2229880820,3,484,161.3333333,1361808476482,1361808476994,2229855302,2229855814,512
1361808507,2229885680,15,5995,399.6666667,1361808486797,1361808500685,2229865477,2229879365,13888
1361808507,2229885684,3,138,46,1361808499723,1361808500683,2229878407,2229879367,960
1361808507,2229885684,6,511,85.16666667,1361808499722,1361808503306,2229878406,2229881990,3584
1361808507,2229885684,4,184,46,1361808499722,1361808503114,2229878406,2229881798,3392
1361808507,2229885684,5,248,49.6,1361808499913,1361808501449,2229878597,2229880133,1536
1361808507,2229885688,5,230,46,1361808490692,1361808503108,2229869380,2229881796,12416
1361808507,2229885688,3,355,118.3333333,1361808500358,1361808500486,2229879046,2229879174,128
1361808507,2229885752,3,138,46,1361808499652,1361808503876,2229878404,2229882628,4224
1361808507,2229885756,4,184,46,1361808499652,1361808503044,2229878408,2229881800,3392
1361808507,2229885756,4,184,46,1361808499652,1361808503044,2229878408,2229881800,3392
1361808507,2229885756,2,92,46,1361808499651,1361808499651,2229878407,2229878407,0
1361808507,2229885756,2,98,49,1361808499842,1361808499970,2229878598,2229878726,128
1361808507,2229885760,4,196,49,1361808500412,1361808501052,2229879172,2229879812,640
1361808515,2229893652,9,2531,281.2222222,1361808508073,1361808511657,2229886725,2229890309,3584
1361808518,2229896836,7,378,54,1361808493106,1361808516466,2229871942,2229895302,23360
1361808522,2229900824,6,324,54,1361808495420,1361808517180,2229874244,2229896004,21760
1361808530,2229908728,37,30218,816.7027027,1361808504412,1361808529436,2229883140,2229908164,25024
1361808530,2229908728,2,581,290.5,1361808504412,1361808504540,2229883140,2229883268,128
1361808530,2229908728,2,916,458,1361808504413,1361808504477,2229883141,2229883205,64
1361808530,2229908732,2,123,61.5,1361808504667,1361808504667,2229883399,2229883399,0
1361808530,2229908800,13,3566,274.3076923,1361808504276,1361808504724,2229883076,2229883524,448
1361808534,2229912812,3,279,93,1361808506953,1361808529865,2229885765,2229908677,22912
1361808538,2229916768,5,248,49.6,1361808510517,1361808534581,2229889285,2229913349,24064
1361808538,2229916776,1,46,46,1361808511404,1361808511404,2229890180,2229890180,0
1361808538,2229916840,5,1452,290.4,1361808510189,1361808524973,2229889029,2229903813,14784
1361808539,2229917752,6,646,107.6666667,1361808527429,1361808533509,2229906181,2229912261,6080
1361808542,2229920896,1,267,267,1361808515572,1361808515572,2229894468,2229894468,0
1361808546,2229924892,4,1020,255,1361808521528,1361808524664,2229900420,2229903556,3136
1361808546,2229924896,4,208,52,1361808521335,1361808542327,2229900231,2229921223,20992
1361808546,2229924952,7,378,54,1361808520510,1361808543038,2229899462,2229921990,22528
1361808547,2229925784,4,202,50.5,1361808528165,1361808544677,2229906949,2229923461,16512
1361808550,2229928796,7,378,54,1361808522200,1361808548952,2229900996,2229927748,26752
1361808554,2229932804,33,22460,680.6060606,1361808527055,1361808544271,2229905859,2229923075,17216
1361808554,2229932804,11,2127,193.3636364,1361808527377,1361808544273,2229906181,2229923077,16896
1361808554,2229932804,22,4782,217.3636364,1361808527377,1361808544273,2229906181,2229923077,16896
1361808554,2229932908,9,1681,186.7777778,1361808527271,1361808544039,2229906179,2229922947,16768
1361808554,2229932948,4,930,232.5,1361808528258,1361808536898,2229907206,2229915846,8640
1361808555,2229933756,2,98,49,1361808547458,1361808547586,2229926214,2229926342,128
1361808558,2229936848,4,369,92.25,1361808532644,1361808533668,2229911492,2229912516,1024
1361808558,2229936924,62,49710,801.7741935,1361808531416,1361808557144,2229910340,2229936068,25728
1361808574,2229952936,1,46,46,1361808549389,1361808549389,2229928325,2229928325,0
1361808574,2229952940,1,52,52,1361808549642,1361808549642,2229928582,2229928582,0
1361808574,2229952980,7,378,54,1361808546337,1361808570529,2229925317,2229949509,24192
1361808574,2229953024,1,46,46,1361808549299,1361808549299,2229928323,2229928323,0
1361808582,2229960872,8,432,54,1361808553934,1361808579854,2229932806,2229958726,25920
1361808586,2229965036,50,43814,876.28,1361808558248,1361808584552,2229937284,2229963588,26304
1361808586,2229965168,1,93,93,1361808559974,1361808559974,2229939142,2229939142,0
1361808587,2229965768,13,11430,879.2307692,1361808583667,1361808585587,2229962435,2229964355,1920
1361808587,2229965808,3,271,90.33333333,1361808586251,1361808586443,2229965059,2229965251,192
1361808587,2229965836,7,1995,285,1361808583151,1361808583599,2229961987,2229962435,448
1361808590,2229969080,14,2978,212.7142857,1361808564477,1361808581053,2229943557,2229960133,16576
1361808590,2229969080,18,3884,215.7777778,1361808564540,1361808570492,2229943620,2229949572,5952
1361808590,2229969160,23,4469,194.3043478,1361808564459,1361808572587,2229943619,2229951747,8128
1361808590,2229969160,8,1796,224.5,1361808564459,1361808581035,2229943619,2229960195,16576
1361808590,2229969164,10,2258,225.8,1361808564459,1361808573739,2229943623,2229952903,9280
1361808593,868286484,4,1388,347,1361808585979,1361808586107,868279463,868279591,128
1361808594,2229973152,1,46,46,1361808569653,1361808569653,2229948805,2229948805,0
1361808598,2229977036,1,46,46,1361808569896,1361808569896,2229948932,2229948932,0
1361808602,2229981072,6,324,54,1361808575492,1361808597188,2229954564,2229976260,21696
1361808610,2229989116,1,52,52,1361808581848,1361808581848,2229960964,2229960964,0
1361808610,2229989160,6,324,54,1361808583725,1361808606253,2229962885,2229985413,22528
1361808611,2229989860,18,17112,950.6666667,1361808603672,1361808606744,2229982532,2229985604,3072
1361808614,2229993044,1,46,46,1361808587488,1361808587488,2229966532,2229966532,0
1361808614,2229993076,3,317,105.6666667,1361808588158,1361808590398,2229967234,2229969474,2240
1361808619,2229997796,3,150,50,1361808603735,1361808614551,2229982531,2229993347,10816
1361808619,2229997796,3,150,50,1361808603734,1361808614550,2229982530,2229993346,10816
1361808619,2229997876,3,150,50,1361808603658,1361808614474,2229982534,2229993350,10816
1361808619,2229997876,5,254,50.8,1361808603658,1361808614474,2229982534,2229993350,10816
1361808622,2230001036,1,46,46,1361808594343,1361808594343,2229973379,2229973379,0
1361808622,2230001120,1,46,46,1361808594261,1361808594261,2229973381,2229973381,0
1361808622,2230001124,97,117787,1214.298969,1361808594513,1361808606289,2229973637,2229985413,11776
1361808626,2230005064,6,2498,416.3333333,1361808599437,1361808599501,2229978501,2229978565,64
1361808626,2230005064,6,3101,516.8333333,1361808599501,1361808599565,2229978565,2229978629,64
1361808627,2230005892,4,202,50.5,1361808603642,1361808624442,2229982534,2230003334,20800
1361808630,2230009036,8,432,54,1361808602216,1361808629736,2229981252,2230008772,27520
1361808630,2230009132,25,15797,631.88,1361808603145,1361808604425,2229982277,2229983557,1280
1361808638,2230017152,6,324,54,1361808610485,1361808633845,2229989637,2230012997,23360
1361808642,2230021064,1,46,46,1361808614924,1361808614924,2229993988,2229993988,0
1361808642,2230021092,1,46,46,1361808615537,1361808615537,2229994629,2229994629,0
1361808642,2230021140,1,46,46,1361808614208,1361808614208,2229993348,2229993348,0
1361808642,2230021172,1,46,46,1361808614945,1361808614945,2229994117,2229994117,0
1361808642,2230021212,1,46,46,1361808617592,1361808617592,2229996804,2229996804,0
1361808646,2230025124,1,46,46,1361808618896,1361808618896,2229998020,2229998020,0
1361808654,2230033060,1,46,46,1361808626319,1361808626319,2230005379,2230005379,0
1361808654,2230033136,42,33991,809.3095238,1361808629506,1361808648450,2230008642,2230027586,18944
1361808654,2230033148,1,46,46,1361808626105,1361808626105,2230005253,2230005253,0
1361808654,2230033176,1,52,52,1361808627099,1361808627099,2230006275,2230006275,0
1361808658,2230037168,5,270,54,1361808633763,1361808652963,2230012931,2230032131,19200
1361808666,2230045108,1,46,46,1361808639327,1361808639327,2230018435,2230018435,0
1361808666,2230045184,7,378,54,1361808638802,1361808664658,2230017986,2230043842,25856
1361808666,2230045212,1,46,46,1361808639222,1361808639222,2230018434,2230018434,0
1361808670,2230049232,2,265,132.5,1361808643940,1361808644004,2230023172,2230023236,64
1361808674,2230053184,1,52,52,1361808649426,1361808649426,2230028610,2230028610,0
1361808678,2230057248,1,52,52,1361808651219,1361808651219,2230030467,2230030467,0
1361808686,2230065172,1,46,46,1361808660000,1361808660000,2230039172,2230039172,0
1361808686,2230065208,7,378,54,1361808657914,1361808682106,2230037122,2230061314,24192
1361808686,2230065212,72,60607,841.7638889,1361808658678,1361808682550,2230037890,2230061762,23872
1361808686,2230065224,1,46,46,1361808659627,1361808659627,2230038851,2230038851,0
1361808686,2230065252,1,46,46,1361808660431,1361808660431,2230039683,2230039683,0
1361808690,2230069136,1,46,46,1361808662724,1361808662724,2230041860,2230041860,0
1361808690,2230069252,1,46,46,1361808663760,1361808663760,2230043012,2230043012,0
1361808694,2230073168,6,324,54,1361808668834,1361808691426,2230048002,2230070594,22592
1361808698,2230077124,7,4775,682.1428571,1361808671182,1361808687374,2230050306,2230066498,16192
1361808698,2230077156,1,52,52,1361808671857,1361808671857,2230051013,2230051013,0
1361808698,2230077228,1,46,46,1361808671206,1361808671206,2230050434,2230050434,0
1361808710,2230089156,1,46,46,1361808684334,1361808684334,2230063490,2230063490,0
1361808710,2230089244,1,46,46,1361808684249,1361808684249,2230063493,2230063493,0
1361808714,2230093192,2,447,223.5,1361808687500,1361808687628,2230066692,2230066820,128
1361808714,2230093236,7,378,54,1361808686237,1361808713757,2230065473,2230092993,27520
1361808722,2230101136,1,52,52,1361808694532,1361808694532,2230073668,2230073668,0
1361808722,2230101180,7,378,54,1361808696408,1361808720664,2230075588,2230099844,24256
1361808722,2230101264,1,52,52,1361808696259,1361808696259,2230075523,2230075523,0
1361808726,2230105280,2,265,132.5,1361808699505,1361808699633,2230078785,2230078913,128
1361808730,2230109416,1,46,46,1361808704491,1361808704491,2230083907,2230083907,0
1361808730,2230109420,1,46,46,1361808704808,1361808704808,2230084228,2230084228,0
1361808730,2230109424,1,46,46,1361808705315,1361808705315,2230084739,2230084739,0
1361808734,2230113200,1,46,46,1361808708867,1361808708867,2230088067,2230088067,0
1361808734,2230113268,1,46,46,1361808707648,1361808707648,2230086916,2230086916,0
1361808743,2230121536,1,46,46,1361808717082,1361808717082,2230095618,2230095618,0
1361808746,2230125260,7,378,54,1361808717895,1361808743815,2230097155,2230123075,25920
1361808750,2230129320,7,378,54,1361808724683,1361808748875,2230104003,2230128195,24192
1361808754,2230133240,1,46,46,1361808729371,1361808729371,2230108611,2230108611,0
1361808754,2230133244,1,46,46,1361808729368,1361808729368,2230108612,2230108612,0
1361808758,2230137248,1,46,46,1361808732627,1361808732627,2230111875,2230111875,0
1361808758,2230137360,1,46,46,1361808732320,1361808732320,2230111680,2230111680,0
1361808766,2230145272,1,52,52,1361808739386,1361808739386,2230118658,2230118658,0
1361808766,2230145312,1,52,52,1361808741203,1361808741203,2230120515,2230120515,0
1361808774,2230153212,6,324,54,1361808748020,1361808773044,2230127232,2230152256,25024
1361808774,2230153264,1,46,46,1361808749699,1361808749699,2230128963,2230128963,0
1361808778,2230157160,1,46,46,1361808750184,1361808750184,2230129344,2230129344,0
1361808778,2230157168,1,46,46,1361808750627,1361808750627,2230129795,2230129795,0
1361808778,2230157208,7,378,54,1361808752312,1361808777656,2230131520,2230156864,25344
1361808778,2230157292,1,46,46,1361808752678,1361808752678,2230131970,2230131970,0
1361808779,2230157988,2,98,49,1361808762004,1361808776852,2230140992,2230155840,14848
1361808782,2230161152,1,46,46,1361808753970,1361808753970,2230133122,2230133122,0
1361808782,2230161272,3,317,105.6666667,1361808754872,1361808755256,2230134144,2230134528,384
1361808786,2230165264,45,59746,1327.688889,1361808761282,1361808779586,2230140546,2230158850,18304
1361808794,2230173228,41,42786,1043.560976,1361808769702,1361808774822,2230148930,2230154050,5120
1361808802,2230181164,1,46,46,1361808774500,1361808774500,2230153664,2230153664,0
1361808802,2230181244,1,46,46,1361808777751,1361808777751,2230156995,2230156995,0
1361808802,2230181252,1,46,46,1361808774415,1361808774415,2230153667,2230153667,0
1361808806,2230185228,7,378,54,1361808778021,1361808802213,2230157249,2230181441,24192
1361808810,2230189164,7,378,54,1361808782758,1361808809446,2230161922,2230188610,26688
1361808810,2230189208,8,1126,140.75,1361808784506,1361808786874,2230163714,2230166082,2368
1361808810,2230189284,1,46,46,1361808784044,1361808784044,2230163328,2230163328,0
1361808811,2230189888,2,92,46,1361808804472,1361808804472,2230183360,2230183360,0
1361808811,2230189968,2,92,46,1361808804393,1361808804393,2230183361,2230183361,0
1361808814,2230193188,1,52,52,1361808786573,1361808786573,2230165761,2230165761,0
1361808822,2230201224,1,46,46,1361808795626,1361808795626,2230174850,2230174850,0
1361808822,2230201272,1,46,46,1361808794681,1361808794681,2230173953,2230173953,0
1361808822,2230201304,1,46,46,1361808794969,1361808794969,2230174273,2230174273,0
1361808822,2230201376,1,46,46,1361808797647,1361808797647,2230177023,2230177023,0
1361808826,2230205316,1,46,46,1361808798924,1361808798924,2230178240,2230178240,0
1361808834,2230213284,7,378,54,1361808806317,1361808832173,2230185601,2230211457,25856
1361808835,2230213884,2,92,46,1361808834495,1361808834495,2230213379,2230213379,0
1361808835,2230213884,2,92,46,1361808834495,1361808834495,2230213379,2230213379,0
1361808838,2230217232,5,421,84.2,1361808810146,1361808816546,2230189378,2230195778,6400
1361808838,2230217388,7,378,54,1361808812611,1361808835907,2230191999,2230215295,23296
1361808846,2230225308,14,11584,827.4285714,1361808819862,1361808842646,2230199170,2230221954,22784
1361808850,2230229224,1,46,46,1361808823336,1361808823336,2230202560,2230202560,0
1361808850,2230229256,1,46,46,1361808824649,1361808824649,2230203905,2230203905,0
1361808851,2230230004,5,326,65.2,1361808831811,1361808846467,2230210815,2230225471,14656
1361808858,2230237260,1,52,52,1361808831879,1361808831879,2230211139,2230211139,0
1361808862,2230241228,6,324,54,1361808836388,1361808858916,2230215616,2230238144,22528
1361808862,2230241300,1,46,46,1361808835229,1361808835229,2230214529,2230214529,0
1361808866,2230245236,1,46,46,1361808840286,1361808840286,2230219522,2230219522,0
1361808866,2230245240,1,46,46,1361808840793,1361808840793,2230220033,2230220033,0
1361808866,2230245244,6,324,54,1361808841109,1361808864469,2230220353,2230243713,23360
1361808870,2230249228,1,46,46,1361808842852,1361808842852,2230222080,2230222080,0
1361808870,2230249384,1,46,46,1361808845256,1361808845256,2230224640,2230224640,0
1361808875,2230253900,2,92,46,1361808874413,1361808874413,2230253313,2230253313,0
1361808875,2230253956,2,92,46,1361808874358,1361808874358,2230253314,2230253314,0
1361808875,2230253956,2,92,46,1361808874358,1361808874358,2230253314,2230253314,0
1361808890,2230269236,6,324,54,1361808863900,1361808887260,2230243136,2230266496,23360
1361808890,2230269276,2,265,132.5,1361808865396,1361808865524,2230244672,2230244800,128
1361808894,2230273248,6,1603,267.1666667,1361808867278,1361808870542,2230246526,2230249790,3264
1361808894,2230273256,6,324,54,1361808868680,1361808893704,2230247936,2230272960,25024
1361808894,2230273260,1,46,46,1361808868293,1361808868293,2230247553,2230247553,0
1361808894,2230273292,1,46,46,1361808869667,1361808869667,2230248959,2230248959,0
1361808898,2230277204,4,1458,364.5,1361808870270,1361808870654,2230249474,2230249858,384
1361808898,2230277292,4,1936,484,1361808870179,1361808870563,2230249471,2230249855,384
1361808902,2230281352,1,52,52,1361808876776,1361808876776,2230256128,2230256128,0
1361808914,2230293300,1,46,46,1361808887707,1361808887707,2230267007,2230267007,0
1361808918,2230297384,7,378,54,1361808892104,1361808917128,2230271488,2230296512,25024
1361808926,2230305196,7,378,54,1361808898821,1361808925701,2230278017,2230304897,26880
1361808939,2230317796,1,46,46,1361808912275,1361808912275,2230291071,2230291071,0
1361808939,2230317804,1,46,46,1361808912397,1361808912397,2230291201,2230291201,0
1361808939,2230318272,1,46,46,1361808913337,1361808913337,2230292609,2230292609,0
1361808943,2230321748,1,52,52,1361808915907,1361808915907,2230294655,2230294655,0
1361808943,2230321756,1,52,52,1361808916155,1361808916155,2230294911,2230294911,0
1361808943,2230321888,1,46,46,1361808915126,1361808915126,2230294014,2230294014,0
1361808943,2230322088,1,52,52,1361808915569,1361808915569,2230294657,2230294657,0
1361808946,2230325328,1,52,52,1361808921790,1361808921790,2230301118,2230301118,0
1361808947,2230325808,6,324,54,1361808921926,1361808946054,2230300734,2230324862,24128
1361808947,2230325944,2,265,132.5,1361808921085,1361808921213,2230300029,2230300157,128
1361808955,2230333600,6,324,54,1361808930454,1361808952214,2230309054,2230330814,21760
1361808959,2230337604,1,46,46,1361808933524,1361808933524,2230312128,2230312128,0
1361808970,2230349464,3,952,317.3333333,1361808943225,1361808943289,2230322689,2230322753,64
1361808971,2230349564,4,1234,308.5,1361808944125,1361808944573,2230322689,2230323137,448
1361808971,2230350072,7,2544,363.4285714,1361808954944,1361808964928,2230334016,2230344000,9984
1361808971,2230350076,51,66229,1298.607843,1361808962618,1361808969722,2230341694,2230348798,7104
1361808971,2230350128,7,3768,538.2857143,1361808962567,1361808968071,2230341695,2230347199,5504
1361808971,2230350128,7,3068,438.2857143,1361808962567,1361808963271,2230341695,2230342399,704
1361808971,2230350132,8,3005,375.625,1361808954819,1361808964867,2230333951,2230343999,10048
1361808971,2230350132,8,3240,405,1361808954819,1361808964867,2230333951,2230343999,10048
1361808978,2230357472,8,432,54,1361808950447,1361808976303,2230329919,2230355775,25856
1361808979,2230358060,27,28283,1047.518519,1361808962633,1361808973641,2230341693,2230352701,11008
1361808979,2230358064,56,69305,1237.589286,1361808962632,1361808975944,2230341696,2230355008,13312
1361808979,2230358112,9,4877,541.8888889,1361808962581,1361808973589,2230341693,2230352701,11008
1361808982,2230361484,94,109836,1168.468085,1361808955427,1361808963619,2230334911,2230343103,8192
1361808983,2230361496,7,378,54,1361808957313,1361808982465,2230335809,2230360961,25152
1361808987,2230365476,1,46,46,1361808960595,1361808960595,2230339071,2230339071,0
1361808987,2230365524,1,46,46,1361808959075,1361808959075,2230337599,2230337599,0
1361808987,2230365564,1,52,52,1361808961081,1361808961081,2230339645,2230339645,0
1361808990,2230369460,19,8906,468.7368421,1361808962169,1361808962425,2230341629,2230341885,256
1361808995,2230374080,2,92,46,1361808994614,1361808994614,2230373694,2230373694,0
1361808999,2230377572,1,46,46,1361808974132,1361808974132,2230352704,2230352704,0
1361808999,2230377632,2,1472,736,1361808972406,1361808972470,2230351038,2230351102,64
1361809003,2230381668,2,265,132.5,1361808977297,1361808977361,2230355965,2230356029,64
1361809003,2230381680,1,46,46,1361808978374,1361808978374,2230357054,2230357054,0
1361809007,2230385536,6,324,54,1361808981397,1361809006421,2230359933,2230384957,25024
1361809011,2230389680,6,324,54,1361808986502,1361809009926,2230365182,2230388606,23424
1361809015,2230393532,1,52,52,1361808989339,1361808989339,2230367871,2230367871,0
1361809015,2230393532,1,52,52,1361808989658,1361808989658,2230368190,2230368190,0
1361809031,2230409548,1,46,46,1361809005514,1361809005514,2230384062,2230384062,0
1361809031,2230409660,1,52,52,1361809006105,1361809006105,2230384765,2230384765,0
1361809035,2230413512,1,52,52,1361809008493,1361809008493,2230387005,2230387005,0
1361809035,2230413548,1,52,52,1361809009609,1361809009609,2230388157,2230388157,0
1361809039,2230417524,6,324,54,1361809011427,1361809036451,2230389951,2230414975,25024
1361809039,2230417692,6,324,54,1361809014074,1361809036730,2230392766,2230415422,22656
1361809051,2230429600,1,46,46,1361809023444,1361809023444,2230402044,2230402044,0
1361809059,2230437648,2,265,132.5,1361809032550,1361809032678,2230411198,2230411326,128
1361809059,2230437688,1,52,52,1361809034108,1361809034108,2230412796,2230412796,0
1361809059,2230437808,1,52,52,1361809034374,1361809034374,2230413182,2230413182,0
1361809063,2230441788,7,4462,637.4285714,1361809038171,1361809056667,2230416959,2230435455,18496
1361809063,2230441824,4,208,52,1361809038135,1361809059127,2230416959,2230437951,20992
1361809067,2230445656,6,324,54,1361809040926,1361809062750,2230419582,2230441406,21824
1361809067,2230445660,7,378,54,1361809041308,1361809065500,2230419968,2230444160,24192
1361809073,2230452044,174,241770,1389.482759,1361808686936,1361808770200,2230065980,2230149244,83264
1361809075,2230453700,1,46,46,1361809050417,1361809050417,2230429117,2230429117,0
1361809079,2230457692,1,52,52,1361809054522,1361809054522,2230433214,2230433214,0
1361809079,2230457704,1,52,52,1361809051183,1361809051183,2230429887,2230429887,0
1361809079,2230457736,7,658,94,1361809053261,1361809071373,2230431997,2230450109,18112
1361809091,2230470264,2,92,46,1361809084094,1361809084094,2230463358,2230463358,0
1361809095,2230473820,7,378,54,1361809067576,1361809091768,2230446396,2230470588,24192
1361809095,2230473852,7,378,54,1361809068635,1361809094491,2230447487,2230473343,25856
1361809095,2230473940,1,46,46,1361809068160,1361809068160,2230447100,2230447100,0
1361809095,2230473944,15,20518,1367.866667,1361809068667,1361809073147,2230447611,2230452091,4480
1361809095,2230473980,47,61794,1314.765957,1361809069659,1361809072987,2230448639,2230451967,3328
1361809095,2230473980,48,59113,1231.520833,1361809069659,1361809072283,2230448639,2230451263,2624
1361809107,2230485904,1,52,52,1361809078947,1361809078947,2230457851,2230457851,0
1361809107,2230485908,1,52,52,1361809079264,1361809079264,2230458172,2230458172,0
1361809115,2230493828,10,1310,131,1361809087343,1361809090223,2230466171,2230469051,2880
1361809115,2230493832,7,1193,170.4285714,1361809087853,1361809093037,2230466685,2230471869,5184
1361809123,2230501896,1,52,52,1361809096046,1361809096046,2230474942,2230474942,0
1361809123,2230501972,7,378,54,1361809095008,1361809119328,2230473980,2230498300,24320
1361809123,2230502080,6,324,54,1361809098485,1361809119349,2230477565,2230498429,20864
1361809127,2230505976,1,52,52,1361809099293,1361809099293,2230478269,2230478269,0
1361809139,2230518036,1,46,46,1361809113055,1361809113055,2230492091,2230492091,0
1361809147,2230526352,3,138,46,1361809144290,1361809145506,2230523642,2230524858,1216
1361809151,2230529920,7,378,54,1361809123669,1361809148693,2230502589,2230527613,25024
1361809151,2230529924,7,378,54,1361809124432,1361809147920,2230503356,2230526844,23488
1361809151,2230530032,1,52,52,1361809124004,1361809124004,2230503036,2230503036,0
1361809151,2230530036,1,52,52,1361809124193,1361809124193,2230503229,2230503229,0
1361809159,2230537928,1,52,52,1361809132557,1361809132557,2230511485,2230511485,0
1361809167,2230545976,1,52,52,1361809141022,1361809141022,2230519998,2230519998,0
1361809171,2230549980,1,52,52,1361809144663,1361809144663,2230523643,2230523643,0
1361809171,2230550356,7,671,95.85714286,1361809164576,1361809165600,2230543932,2230544956,1024
1361809171,2230550428,12,8110,675.8333333,1361809169562,1361809170394,2230548990,2230549822,832
1361809175,2230553936,2,265,132.5,1361809148740,1361809148868,2230527676,2230527804,128
1361809179,2230557892,6,324,54,1361809151407,1361809174831,2230530299,2230553723,23424
1361809179,2230557936,7,378,54,1361809153668,1361809178692,2230532604,2230557628,25024
1361809179,2230557940,26,18473,710.5,1361809153985,1361809175489,2230532925,2230554429,21504
1361809179,2230558324,19,17230,906.8421053,1361809173696,1361809174592,2230553020,2230553916,896
1361809179,2230558332,2,98,49,1361809174583,1361809174583,2230553915,2230553915,0
1361809179,2230558384,16,14460,903.75,1361809178052,1361809178564,2230557436,2230557948,512
1361809187,2230566360,13,7877,605.9230769,1361809182235,1361809183835,2230561595,2230563195,1600
1361809187,2230566368,17,20361,1197.705882,1361809186645,1361809186773,2230566013,2230566141,128
1361809187,2230566400,16,11157,697.3125,1361809183794,1361809185586,2230563194,2230564986,1792
1361809187,2230566404,19,19979,1051.526316,1361809180337,1361809182193,2230559741,2230561597,1856
1361809191,2230569920,6,2352,392,1361809164117,1361809164245,2230543037,2230543165,128
1361809191,2230569948,4,661,165.25,1361809164345,1361809164857,2230543293,2230543805,512
1361809191,2230570036,1,46,46,1361809164001,1361809164001,2230543037,2230543037,0
1361809195,2230574060,2,98,49,1361809169033,1361809192393,2230548093,2230571453,23360
1361809195,2230574080,3,144,48,1361809169204,1361809192948,2230548284,2230572028,23744
1361809195,2230574300,2,92,46,1361809192151,1361809192151,2230571451,2230571451,0
1361809195,2230574304,3,150,50,1361809192277,1361809192597,2230571581,2230571901,320
1361809195,2230574304,2,92,46,1361809192148,1361809192148,2230571452,2230571452,0
1361809195,2230574304,2,92,46,1361809192148,1361809192148,2230571452,2230571452,0
1361809195,2230574304,3,144,48,1361809192786,1361809192850,2230572090,2230572154,64
1361809195,2230574332,2,98,49,1361809177143,1361809192119,2230556475,2230571451,14976
1361809195,2230574332,2,98,49,1361809189366,1361809192118,2230568698,2230571450,2752
1361809195,2230574332,29,31690,1092.758621,1361809189686,1361809192118,2230569018,2230571450,2432
1361809195,2230574344,7,4319,617,1361809187052,1361809189420,2230566396,2230568764,2368
1361809195,2230574372,27,28952,1072.296296,1361809187728,1361809189392,2230567100,2230568764,1664
1361809195,2230574376,2,92,46,1361809192078,1361809192078,2230571454,2230571454,0
1361809195,2230574376,2,98,49,1361809192141,1361809192269,2230571517,2230571645,128
1361809195,2230574380,3,355,118.3333333,1361809192585,1361809193033,2230571965,2230572413,448
1361809207,2230585996,7,378,54,1361809178951,1361809202375,2230557947,2230581371,23424
1361809207,2230586080,7,378,54,1361809181873,1361809202737,2230560953,2230581817,20864
1361809211,2230590352,11,8733,793.9090909,1361809203235,1361809203363,2230582587,2230582715,128
1361809211,2230590352,11,9148,831.6363636,1361809207201,1361809207265,2230586553,2230586617,64
1361809211,2230590472,15,14542,969.4666667,1361809210285,1361809210413,2230589757,2230589885,128
1361809219,2230598348,27,32031,1186.333333,1361809214568,1361809214760,2230593916,2230594108,192
1361809219,2230598360,15,13943,929.5333333,1361809212443,1361809212635,2230591803,2230591995,192
1361809219,2230598360,8,2393,299.125,1361809207962,1361809217242,2230587322,2230596602,9280
1361809219,2230598388,71,94859,1336.042254,1361809216639,1361809217151,2230596027,2230596539,512
1361809219,2230598428,37,46324,1252,1361809215512,1361809215768,2230594940,2230595196,256
1361809219,2230598468,101,138609,1372.366337,1361809217710,1361809218158,2230597178,2230597626,448
1361809223,2230601964,1,77,77,1361809197479,1361809197479,2230576443,2230576443,0
1361809223,2230602044,7,825,117.8571429,1361809197078,1361809197142,2230576122,2230576186,64
1361809223,2230602044,11,9342,849.2727273,1361809197078,1361809197526,2230576122,2230576570,448
1361809227,2230606032,1,46,46,1361809200226,1361809200226,2230579258,2230579258,0
1361809227,2230606356,199,276435,1389.120603,1361809223200,1361809224864,2230602556,2230604220,1664
1361809227,2230606396,224,313665,1400.290179,1361809222136,1361809222840,2230601532,2230602236,704
1361809227,2230606400,125,172377,1379.016,1361809218737,1361809219185,2230598137,2230598585,448
1361809227,2230606424,183,250394,1368.273224,1361809219802,1361809224154,2230599226,2230603578,4352
1361809227,2230606432,165,228117,1382.527273,1361809221010,1361809222226,2230600442,2230601658,1216
1361809227,2230606436,178,248529,1396.230337,1361809224783,1361809226511,2230604219,2230605947,1728
1361809231,2230610016,2,265,132.5,1361809204659,1361809204787,2230583675,2230583803,128
1361809235,2230613960,7,378,54,1361809207467,1361809231659,2230586427,2230610619,24192
1361809235,2230613972,5,248,49.6,1361809208352,1361809227616,2230587324,2230606588,19264
1361809235,2230613972,3,144,48,1361809208352,1361809227616,2230587324,2230606588,19264
1361809235,2230613972,5,248,49.6,1361809208352,1361809227616,2230587324,2230606588,19264
1361809235,2230614076,7,378,54,1361809207735,1361809234423,2230586811,2230613499,26688
1361809235,2230614084,3,144,48,1361809208241,1361809227505,2230587325,2230606589,19264
1361809235,2230614084,3,144,48,1361809208240,1361809227504,2230587324,2230606588,19264
1361809235,2230614356,134,185035,1380.858209,1361809226592,1361809227040,2230605948,2230606396,448
1361809235,2230614368,183,255058,1393.759563,1361809231700,1361809232404,2230611068,2230611772,704
1361809235,2230614396,187,260509,1393.096257,1361809232758,1361809234550,2230612154,2230613946,1792
1361809235,2230614404,213,296021,1389.769953,1361809230320,1361809231664,2230609724,2230611068,1344
1361809235,2230614428,241,338279,1403.647303,1361809227544,1361809229272,2230606972,2230608700,1728
1361809235,2230614440,131,180668,1379.145038,1361809229259,1361809229643,2230608699,2230609083,384
1361809244,2230622572,302,425091,1407.586093,1361809239535,1361809243631,2230618107,2230622203,4096
1361809244,2230622576,137,189747,1385.014599,1361809236393,1361809237417,2230614969,2230615993,1024
1361809244,2230622588,119,162865,1368.613445,1361809237405,1361809238429,2230615993,2230617017,1024
1361809244,2230622628,145,200315,1381.482759,1361809235511,1361809236279,2230614139,2230614907,768
1361809244,2230622692,115,158577,1378.930435,1361809238391,1361809238647,2230617083,2230617339,256
1361809251,2230630432,152,210766,1386.618421,1361809242772,1361809243796,2230622204,2230623228,1024
1361809251,2230630436,196,273016,1392.938776,1361809243791,1361809244751,2230623227,2230624187,960
1361809259,2230638448,172,237589,1381.331395,1361809255427,1361809256899,2230634875,2230636347,1472
1361809259,2230638472,208,288678,1387.875,1361809244842,1361809251306,2230624314,2230630778,6464
1361809260,2230638488,186,258923,1392.05914,1361809255363,1361809256259,2230633851,2230634747,896
1361809260,2230638520,100,136609,1366.09,1361809252260,1361809252836,2230630780,2230631356,576
1361809260,2230638528,125,173030,1384.24,1361809253212,1361809254236,2230631740,2230632764,1024
1361809260,2230638560,161,223897,1390.664596,1361809254268,1361809254652,2230632828,2230633212,384
1361809263,2230642056,6,324,54,1361809238604,1361809261964,2230617660,2230641020,23360
1361809263,2230642084,6,324,54,1361809235693,1361809259949,2230614777,2230639033,24256
1361809267,2230646056,1,46,46,1361809242571,1361809242571,2230621627,2230621627,0
1361809267,2230646144,1,52,52,1361809242099,1361809242099,2230621243,2230621243,0
1361809267,2230646444,106,143312,1352,1361809260871,1361809261831,2230640315,2230641275,960
1361809268,2230646524,104,140983,1355.605769,1361809262815,1361809267743,2230641339,2230646267,4928
1361809268,2230646524,149,205795,1381.174497,1361809257887,1361809261727,2230636411,2230640251,3840
1361809276,2230654508,70,92936,1327.657143,1361809267759,1361809268399,2230646267,2230646907,640
1361809276,2230654508,209,289269,1384.062201,1361809271917,1361809274925,2230650425,2230653433,3008
1361809276,2230654516,158,216943,1373.056962,1361809268776,1361809270184,2230647292,2230648700,1408
1361809276,2230654548,163,224838,1379.374233,1361809273798,1361809275206,2230652346,2230653754,1408
1361809276,2230654552,113,153881,1361.778761,1361809270850,1361809271426,2230649402,2230649978,576
1361809276,2230654596,131,179309,1368.770992,1361809270101,1361809271893,2230648697,2230650489,1792
1361809287,2230666088,2,265,132.5,1361809259946,1361809260074,2230639034,2230639162,128
1361809291,2230670100,7,378,54,1361809264158,1361809290014,2230643258,2230669114,25856
1361809291,2230670256,6,324,54,1361809265988,1361809289284,2230645244,2230668540,23296
1361809299,2230678156,5,2155,431,1361809274277,1361809277349,2230653433,2230656505,3072
1361809303,2230682100,1,46,46,1361809275295,1361809275295,2230654395,2230654395,0
1361809315,2230694076,1,52,52,1361809287220,1361809287220,2230666296,2230666296,0
1361809315,2230694104,1,46,46,1361809287579,1361809287579,2230666683,2230666683,0
1361809319,2230698052,7,378,54,1361809293391,1361809318543,2230672443,2230697595,25152
1361809319,2230698084,5,270,54,1361809294511,1361809314543,2230673595,2230693627,20032
1361809340,2230718520,4,196,49,1361809319265,1361809338145,2230697785,2230716665,18880
1361809343,2230722032,2,265,132.5,1361809316065,1361809316129,2230695097,2230695161,64
1361809343,2230722104,16,17813,1113.3125,1361809318170,1361809319066,2230697274,2230698170,896
1361809347,2230726060,7,378,54,1361809319685,1361809343813,2230698745,2230722873,24128
1361809347,2230726132,2,608,304,1361809318780,1361809318908,2230697912,2230698040,128
1361809351,2230730112,9,486,54,1361809323538,1361809347794,2230702650,2230726906,24256
1361809359,2230738060,1,46,46,1361809332676,1361809332676,2230711736,2230711736,0
1361809359,2230738140,1,52,52,1361809332212,1361809332212,2230711352,2230711352,0
1361809375,2230754168,6,324,54,1361809347865,1361809372953,2230727033,2230752121,25088
1361809379,2230758076,6,324,54,1361809351991,1361809376247,2230731067,2230755323,24256
1361809391,2230770236,1,46,46,1361809363860,1361809363860,2230743096,2230743096,0
1361809391,2230770240,1,46,46,1361809363987,1361809363987,2230743227,2230743227,0
1361809399,2230778232,2,265,132.5,1361809371417,1361809371545,2230750649,2230750777,128
1361809403,2230782132,27,21277,788.037037,1361809375163,1361809393915,2230754295,2230773047,18752
1361809403,2230782380,1,52,52,1361809377028,1361809377028,2230756408,2230756408,0
1361809403,2230782388,7,378,54,1361809377723,1361809401979,2230757111,2230781367,24256
1361809407,2230786164,6,324,54,1361809381276,1361809406300,2230760440,2230785464,25024
1361809415,2230794104,10,1612,161.2,1361809387416,1361809387672,2230766520,2230766776,256
1361809431,2230810296,6,324,54,1361809406230,1361809430422,2230785526,2230809718,24192
1361809435,2230814200,1,46,46,1361809408953,1361809408953,2230788153,2230788153,0
1361809435,2230814292,1,46,46,1361809408986,1361809408986,2230788278,2230788278,0
1361809439,2230818252,6,324,54,1361809411269,1361809436613,2230790521,2230815865,25344
1361809439,2230818340,65,61742,949.8769231,1361809414445,1361809438381,2230793785,2230817721,23936
1361809444,2230822648,9,600,66.66666667,1361809422880,1361809438368,2230801528,2230817016,15488
1361809451,2230830252,2,265,132.5,1361809426691,1361809426755,2230805943,2230806007,64
1361809459,2230838264,6,324,54,1361809434614,1361809457206,2230813878,2230836470,22592
1361809459,2230838436,1,52,52,1361809432396,1361809432396,2230811832,2230811832,0
1361809467,2230846320,8,4917,614.625,1361809439615,1361809443647,2230818935,2230822967,4032
1361809467,2230846364,6,324,54,1361809441619,1361809464147,2230820983,2230843511,22528
1361809479,2230858292,3,138,46,1361809453979,1361809476123,2230833271,2230855415,22144
1361809479,2230858292,3,138,46,1361809454043,1361809476123,2230833335,2230855415,22080
1361809484,2230862688,2,92,46,1361809476727,1361809476727,2230855415,2230855415,0
1361809484,2230862688,2,98,49,1361809476790,1361809476918,2230855478,2230855606,128
1361809484,2230862688,2,98,49,1361809476853,1361809476853,2230855541,2230855541,0
1361809484,2230862692,4,401,100.25,1361809476917,1361809477045,2230855609,2230855737,128
1361809484,2230862692,3,144,48,1361809476980,1361809477044,2230855672,2230855736,64
1361809487,2230866288,6,324,54,1361809462175,1361809483935,2230841463,2230863223,21760
1361809495,2230874276,7,378,54,1361809468523,1361809493739,2230847799,2230873015,25216
1361809503,2230882248,1,46,46,1361809476165,1361809476165,2230855413,2230855413,0
1361809507,2230886280,83,97844,1178.843373,1361809481127,1361809506855,2230860407,2230886135,25728
1361809507,2230886280,1,77,77,1361809481126,1361809481126,2230860406,2230860406,0
1361809507,2230886316,2,265,132.5,1361809482436,1361809482500,2230861752,2230861816,64
1361809515,2230894288,6,324,54,1361809488926,1361809512286,2230868214,2230891574,23360
1361809516,2230894668,3,421,140.3333333,1361809507787,1361809511435,2230886455,2230890103,3648
1361809516,2230894668,4,2932,733,1361809512010,1361809512138,2230890678,2230890806,128
1361809516,2230894676,5,414,82.8,1361809512962,1361809513026,2230891638,2230891702,64
1361809516,2230894708,3,395,131.6666667,1361809511396,1361809511460,2230890104,2230890168,64
1361809516,2230894712,3,649,216.3333333,1361809507742,1361809510878,2230886454,2230889590,3136
1361809516,2230894712,42,53120,1264.761905,1361809507742,1361809514590,2230886454,2230893302,6848
1361809516,2230894748,4,409,102.25,1361809512316,1361809512444,2230891064,2230891192,128
1361809516,2230894748,24,28710,1196.25,1361809512506,1361809512826,2230891254,2230891574,320
1361809516,2230894752,5,414,82.8,1361809512886,1361809512950,2230891638,2230891702,64
1361809523,2230902404,5,270,54,1361809498665,1361809518697,2230878069,2230898101,20032
1361809524,2230902676,2,98,49,1361809507779,1361809517763,2230886455,2230896439,9984
1361809524,2230902684,5,2327,465.4,1361809512444,1361809523132,2230891128,2230901816,10688
1361809524,2230902684,2,98,49,1361809512507,1361809523579,2230891191,2230902263,11072
1361809524,2230902728,8,2144,268,1361809511502,1361809523854,2230890230,2230902582,12352
1361809531,2230910356,6,2866,477.6666667,1361809505946,1361809506074,2230885302,2230885430,128
1361809531,2230910356,6,3101,516.8333333,1361809505945,1361809506009,2230885301,2230885365,64
1361809531,2230910444,21,9051,431,1361809505859,1361809507203,2230885303,2230886647,1344
1361809531,2230910444,6,2498,416.3333333,1361809505859,1361809505987,2230885303,2230885431,128
1361809532,2230910680,2,98,49,1361809507773,1361809527805,2230886453,2230906485,20032
1361809532,2230910684,2,98,49,1361809507771,1361809527739,2230886455,2230906423,19968
1361809532,2230910684,2,98,49,1361809507899,1361809527803,2230886583,2230906487,19904
1361809532,2230910684,2,98,49,1361809507771,1361809527803,2230886455,2230906487,20032
1361809532,2230910688,3,144,48,1361809508600,1361809527800,2230887288,2230906488,19200
1361809532,2230910688,3,144,48,1361809508599,1361809527799,2230887287,2230906487,19200
1361809532,2230910688,2,98,49,1361809512503,1361809524855,2230891191,2230903543,12352
1361809532,2230910688,2,98,49,1361809512502,1361809523958,2230891190,2230902646,11456
1361809532,2230910688,3,144,48,1361809512566,1361809527798,2230891254,2230906486,15232
1361809532,2230910720,2,98,49,1361809511255,1361809527703,2230889975,2230906423,16448
1361809532,2230910720,2,98,49,1361809511319,1361809527703,2230890039,2230906423,16384
1361809532,2230910720,3,144,48,1361809511254,1361809527702,2230889974,2230906422,16448
1361809532,2230910720,2,98,49,1361809511254,1361809527702,2230889974,2230906422,16448
1361809532,2230910728,2,98,49,1361809507856,1361809527760,2230886584,2230906488,19904
1361809532,2230910728,3,144,48,1361809507726,1361809527694,2230886454,2230906422,19968
1361809532,2230910728,2,98,49,1361809507726,1361809527758,2230886454,2230906486,20032
1361809532,2230910728,2,98,49,1361809507726,1361809527758,2230886454,2230906486,20032
1361809532,2230910728,2,98,49,1361809507726,1361809527694,2230886454,2230906422,19968
1361809532,2230910728,2,98,49,1361809507725,1361809527757,2230886453,2230906485,20032
1361809532,2230910756,3,144,48,1361809508530,1361809527730,2230887286,2230906486,19200
1361809532,2230910760,2,98,49,1361809512432,1361809524144,2230891192,2230902904,11712
1361809532,2230910800,2,279,139.5,1361809511236,1361809527684,2230890036,2230906484,16448
1361809535,2230914256,4,768,192,1361809507135,1361809512511,2230886391,2230891767,5376
1361809535,2230914256,9,6524,724.8888889,1361809507198,1361809507454,2230886454,2230886710,256
1361809535,2230914260,9,6524,724.8888889,1361809507196,1361809507452,2230886456,2230886712,256
1361809535,2230914260,3,298,99.33333333,1361809507196,1361809509628,2230886456,2230888888,2432
1361809535,2230914352,8,4064,508,1361809510110,1361809510942,2230889462,2230890294,832
1361809535,2230914356,3,1239,413,1361809510618,1361809516058,2230889974,2230895414,5440
1361809535,2230914356,8,5636,704.5,1361809510682,1361809511258,2230890038,2230890614,576
1361809535,2230914360,4,898,224.5,1361809510679,1361809510999,2230890039,2230890359,320
1361809535,2230914364,3,298,99.33333333,1361809507090,1361809510674,2230886454,2230890038,3584
1361809535,2230914364,3,386,128.6666667,1361809507090,1361809510226,2230886454,2230889590,3136
1361809535,2230914364,4,930,232.5,1361809507089,1361809512785,2230886453,2230892149,5696
1361809535,2230914364,3,309,103,1361809507089,1361809513169,2230886453,2230892533,6080
1361809535,2230914396,24,23884,995.1666667,1361809507890,1361809529330,2230887286,2230908726,21440
1361809535,2230914432,17,20952,1232.470588,1361809509584,1361809509648,2230889016,2230889080,64
1361809535,2230914440,6,2032,338.6666667,1361809510216,1361809510408,2230889656,2230889848,192
1361809535,2230914444,8,978,122.25,1361809510532,1361809512004,2230889976,2230891448,1472
1361809535,2230914444,9,3535,392.7777778,1361809510596,1361809510660,2230890040,2230890104,64
1361809535,2230914444,15,15968,1064.533333,1361809510531,1361809515907,2230889975,2230895351,5376
1361809535,2230914444,6,946,157.6666667,1361809510595,1361809511939,2230890039,2230891383,1344
1361809538,869231500,4,606,151.5,1361809510770,1361809511026,869204270,869204526,256
1361809538,869231524,4,1048,262,1361809512986,1361809513242,869206510,869206766,256
1361809538,869231544,6,2245,374.1666667,1361809511625,1361809513353,869205169,869206897,1728
1361809538,869231552,7,2473,353.2857143,1361809512957,1361809529597,869206509,869223149,16640
1361809539,2230918268,13,10761,827.7692308,1361809511410,1361809514162,2230890678,2230893430,2752
1361809539,2230918268,8,4558,569.75,1361809511409,1361809514161,2230890677,2230893429,2752
1361809539,2230918272,11,9601,872.8181818,1361809511536,1361809511728,2230890808,2230891000,192
1361809539,2230918272,6,2923,487.1666667,1361809511599,1361809511663,2230890871,2230890935,64
1361809539,2230918276,9,2818,313.1111111,1361809511980,1361809512556,2230891256,2230891832,576
1361809539,2230918360,6,5051,841.8333333,1361809511512,1361809511512,2230890872,2230890872,0
1361809539,2230918380,3,610,203.3333333,1361809511873,1361809511937,2230891253,2230891317,64
1361809539,2230918388,33,44095,1336.212121,1361809512569,1361809512761,2230891957,2230892149,192
1361809543,2230922396,6,324,54,1361809516401,1361809541425,2230895797,2230920821,25024
1361809543,2230922404,1,46,46,1361809517034,1361809517034,2230896438,2230896438,0
1361809551,2230930308,6,324,54,1361809523787,1361809548875,2230903095,2230928183,25088
1361809555,2230934384,1,46,46,1361809527101,1361809527101,2230906485,2230906485,0
1361809563,2230942368,2,398,199,1361809536718,1361809545486,2230916086,2230924854,8768
1361809563,2230942372,2,92,46,1361809537097,1361809545993,2230916469,2230925365,8896
1361809563,2230942376,2,92,46,1361809537096,1361809545992,2230916472,2230925368,8896
1361809563,2230942400,2,265,132.5,1361809538028,1361809538156,2230917428,2230917556,128
1361809564,2230942692,3,291,97,1361809563697,1361809563761,2230942389,2230942453,64
1361809570,869262800,2,521,260.5,1361809542768,1361809569648,869235568,869262448,26880
1361809571,2230950428,7,378,54,1361809546384,1361809569808,2230925812,2230949236,23424
1361809572,2230950636,1,46,46,1361809546728,1361809546728,2230925364,2230925364,0
1361809572,2230950796,6,431,71.83333333,1361809569545,1361809571593,2230948341,2230950389,2048
1361809572,2230950836,2,92,46,1361809564385,1361809565985,2230943221,2230944821,1600
1361809572,2230950844,2,98,49,1361809552859,1361809569435,2230931703,2230948279,16576
1361809572,2230950848,2,92,46,1361809569431,1361809569431,2230948279,2230948279,0
1361809572,2230950848,3,138,46,1361809569431,1361809570647,2230948279,2230949495,1216
1361809572,2230950848,2,92,46,1361809569495,1361809569751,2230948343,2230948599,256
1361809572,2230950848,2,92,46,1361809569495,1361809569687,2230948343,2230948535,192
1361809572,2230950848,5,313,62.6,1361809569430,1361809569942,2230948278,2230948790,512
1361809572,2230950848,2,92,46,1361809569494,1361809569750,2230948342,2230948598,256
1361809579,2230958416,11,594,54,1361809553758,1361809578014,2230933174,2230957430,24256
1361809592,2230970624,1,46,46,1361809565239,1361809565239,2230943863,2230943863,0
1361809592,2230970624,1,77,77,1361809565365,1361809565365,2230943989,2230943989,0
1361809595,869287772,1,46,46,1361809569677,1361809569677,869262449,869262449,0
1361809595,869287812,1,46,46,1361809569634,1361809569634,869262446,869262446,0
1361809595,869287812,1,46,46,1361809569633,1361809569633,869262445,869262445,0
1361809596,2230974660,1,46,46,1361809569553,1361809569553,2230948213,2230948213,0
1361809596,2230974660,1,46,46,1361809569617,1361809569617,2230948277,2230948277,0
1361809596,2230974660,1,46,46,1361809569616,1361809569616,2230948276,2230948276,0
1361809596,2230974660,1,46,46,1361809569616,1361809569616,2230948276,2230948276,0
1361809596,2230974660,1,46,46,1361809569616,1361809569616,2230948276,2230948276,0
1361809596,2230974664,1,46,46,1361809569679,1361809569679,2230948343,2230948343,0
1361809596,2230974812,1,46,46,1361809569466,1361809569466,2230948278,2230948278,0
1361809596,2230974812,1,46,46,1361809569466,1361809569466,2230948278,2230948278,0
1361809596,2230974812,1,46,46,1361809569402,1361809569402,2230948214,2230948214,0
1361809596,2230974812,1,46,46,1361809569466,1361809569466,2230948278,2230948278,0
1361809599,869291768,3,505,168.3333333,1361809574223,1361809574287,869266991,869267055,64
1361809600,2230978576,46,2484,54,1361809572326,1361809599718,2230950902,2230978294,27392
1361809600,2230978624,3,231,77,1361809573943,1361809587063,2230952567,2230965687,13120
1361809600,2230978712,8,1060,132.5,1361809573342,1361809573534,2230952054,2230952246,192
1361809604,2230982568,46,2484,54,1361809579693,1361809603885,2230958261,2230982453,24192
1361809604,2230982580,5,542,108.4,1361809576673,1361809591905,2230955253,2230970485,15232
1361809604,2230982664,7,352,50.28571429,1361809576399,1361809593295,2230955063,2230971959,16896
1361809604,2230982832,25,27390,1095.6,1361809597478,1361809598438,2230976310,2230977270,960
1361809616,2230994620,10,3190,319,1361809590329,1361809595641,2230968949,2230974261,5312
1361809620,2230998592,7,812,116,1361809592083,1361809593107,2230970675,2230971699,1024
1361809620,2230998604,9,1044,116,1361809593095,1361809594439,2230971699,2230973043,1344
1361809620,2230998604,2,232,116,1361809593095,1361809593351,2230971699,2230971955,256
1361809620,2230998644,2,265,132.5,1361809593952,1361809594080,2230972596,2230972724,128
1361809620,2230998648,2,232,116,1361809594398,1361809594526,2230973046,2230973174,128
1361809620,2230998652,4,464,116,1361809594647,1361809595927,2230973299,2230974579,1280
1361809620,2230998716,9,1044,116,1361809592985,1361809594329,2230971701,2230973045,1344
1361809620,2230998720,2,232,116,1361809593237,1361809593621,2230971957,2230972341,384
1361809620,2230998732,7,1680,240,1361809593867,1361809597963,2230972599,2230976695,4096
1361809624,2231002704,10,540,54,1361809599524,1361809623652,2230978228,2231002356,24128
1361809628,2231006696,54,2916,54,1361809600110,1361809627438,2230978806,2231006134,27328
1361809632,2231010636,53,2862,54,1361809604329,1361809631593,2230982965,2231010229,27264
1361809632,2231010724,1,77,77,1361809604435,1361809604435,2230983159,2230983159,0
1361809636,2231014780,4,490,122.5,1361809610199,1361809631959,2230988979,2231010739,21760
1361809636,2231014804,1,52,52,1361809611137,1361809611137,2230989941,2230989941,0
1361809640,2231018756,10,540,54,1361809614576,1361809637872,2230993332,2231016628,23296
1361809644,2231022764,1,52,52,1361809618537,1361809618537,2230997301,2230997301,0
1361809647,869339888,4,912,228,1361809619223,1361809632791,869312111,869325679,13568
1361809656,2231034756,55,2970,54,1361809627890,1361809655666,2231006646,2231034422,27776
1361809656,2231034764,7,378,54,1361809628584,1361809651944,2231007348,2231030708,23360
1361809660,2231038696,54,2916,54,1361809632044,1361809659756,2231010740,2231038452,27712
1361809660,2231038996,3,138,46,1361809656769,1361809657985,2231035765,2231036981,1216
1361809668,2231046672,25,23663,946.52,1361809640964,1361809659716,2231019636,2231038388,18752
1361809668,2231046720,5,270,54,1361809642901,1361809662933,2231021621,2231041653,20032
1361809672,2231050736,1,52,52,1361809647238,1361809647238,2231025974,2231025974,0
1361809676,2231054716,2,265,132.5,1361809649625,1361809649689,2231028341,2231028405,64
1361809684,2231062904,27,1458,54,1361809656027,1361809669403,2231034931,2231048307,13376
1361809684,2231062932,6,324,54,1361809656768,1361809681792,2231035700,2231060724,25024
1361809684,2231062968,5,542,108.4,1361809658011,1361809683099,2231036979,2231062067,25088
1361809684,2231063140,3,150,50,1361809670001,1361809680433,2231049141,2231059573,10432
1361809688,2231066692,21,1134,54,1361809660207,1361809670767,2231038899,2231049459,10560
1361809688,2231066856,93,115811,1245.27957,1361809663434,1361809674186,2231042290,2231053042,10752
1361809696,2231074708,9,3482,386.8888889,1361809670239,1361809672095,2231048947,2231050803,1856
1361809696,2231074708,7,3113,444.7142857,1361809670239,1361809670431,2231048947,2231049139,192
1361809696,2231074716,6,3101,516.8333333,1361809671191,1361809671255,2231049907,2231049971,64
1361809696,2231074748,6,324,54,1361809667894,1361809692918,2231046642,2231071666,25024
1361809696,2231074796,27,11616,430.2222222,1361809670282,1361809688202,2231049078,2231066998,17920
1361809700,2231078740,4,202,50.5,1361809674304,1361809694208,2231053044,2231072948,19904
1361809700,2231078740,5,248,49.6,1361809674304,1361809697152,2231053044,2231075892,22848
1361809700,2231078740,3,150,50,1361809674304,1361809694208,2231053044,2231072948,19904
1361809700,2231078740,6,300,50,1361809674303,1361809697151,2231053043,2231075891,22848
1361809700,2231078824,5,248,49.6,1361809674220,1361809697068,2231053044,2231075892,22848
1361809700,2231078824,3,150,50,1361809674220,1361809694124,2231053044,2231072948,19904
1361809703,869395896,1,52,52,1361809677841,1361809677841,869370737,869370737,0
1361809708,2231086780,47,46341,985.9787234,1361809683223,1361809694935,2231062003,2231073715,11712
1361809712,2231090760,2,92,46,1361809684141,1361809685357,2231062901,2231064117,1216
1361809712,2231090760,1,46,46,1361809684141,1361809684141,2231062901,2231062901,0
1361809712,2231090836,6,324,54,1361809686878,1361809709342,2231065714,2231088178,22464
1361809716,2231094748,6,294,49,1361809690809,1361809714297,2231069557,2231093045,23488
1361809716,2231094856,7,787,112.4285714,1361809690890,1361809694346,2231069746,2231073202,3456
1361809720,2231098756,41,55178,1345.804878,1361809694320,1361809696368,2231073076,2231075124,2048
1361809724,2231102768,7,378,54,1361809697890,1361809721186,2231076658,2231099954,23296
1361809724,2231103068,2,92,46,1361809715767,1361809720311,2231094835,2231099379,4544
1361809732,2231110716,2,265,132.5,1361809704728,1361809704856,2231083444,2231083572,128
1361809732,2231110872,1,52,52,1361809707133,1361809707133,2231086005,2231086005,0
1361809740,2231118736,7,378,54,1361809712771,1361809739459,2231091507,2231118195,26688
1361809744,2231123132,1,52,52,1361809718966,1361809718966,2231098098,2231098098,0
1361809744,2231123188,1,52,52,1361809716669,1361809716669,2231095857,2231095857,0
1361809751,869443996,1,52,52,1361809722926,1361809722926,869415922,869415922,0
1361809752,2231131088,7,378,54,1361809725028,1361809749220,2231104116,2231128308,24192
1361809756,2231135296,3,297,99,1361809731476,1361809731924,2231110772,2231111220,448
1361809756,2231135340,2,92,46,1361809728999,1361809731431,2231108339,2231110771,2432
1361809760,2231139080,1,52,52,1361809732971,1361809732971,2231112051,2231112051,0
1361809764,2231143296,14,10815,772.5,1361809739477,1361809754325,2231118773,2231133621,14848
1361809768,2231147160,1,46,46,1361809741017,1361809741017,2231120177,2231120177,0
1361809772,2231151284,6,324,54,1361809743901,1361809768925,2231123185,2231148209,25024
1361809780,2231159360,8,432,54,1361809752275,1361809775635,2231131635,2231154995,23360
1361809784,2231163136,2,92,46,1361809757108,1361809763764,2231136244,2231142900,6656
1361809784,2231163208,3,317,105.6666667,1361809759723,1361809760107,2231138931,2231139315,384
1361809789,2231167496,1,52,52,1361809762354,1361809762354,2231140850,2231140850,0
1361809792,2231171152,1,46,46,1361809766882,1361809766882,2231146034,2231146034,0
1361809792,2231171188,1,52,52,1361809764160,1361809764160,2231143348,2231143348,0
1361809795,869488264,1,52,52,1361809767457,1361809767457,869460721,869460721,0
1361809796,2231175364,3,310,103.3333333,1361809768589,1361809768845,2231147953,2231148209,256
1361809796,2231175404,22,20001,909.1363636,1361809770150,1361809790950,2231149554,2231170354,20800
1361809800,2231179200,6,324,54,1361809774003,1361809796531,2231153203,2231175731,22528
1361809804,2231183196,6562,8968227,1366.6911,1361809278070,1361809499766,2230657266,2230878962,221696
1361809804,2231183276,5,389,77.8,1361809776935,1361809803623,2231156211,2231182899,26688
1361809804,2231183364,1,52,52,1361809777741,1361809777741,2231157105,2231157105,0
1361809810,2231188488,1,48,48,1361809782458,1361809782458,2231160946,2231160946,0
1361809810,2231189408,6,324,54,1361809780577,1361809805537,2231159985,2231184945,24960
1361809811,2231189800,1,48,48,1361809782146,1361809782146,2231160946,2231160946,0
1361809813,2231191532,14,5956,425.4285714,1361809796621,1361809812173,2231175153,2231190705,15552
1361809813,2231191688,1,46,46,1361809786481,1361809786481,2231165169,2231165169,0
1361809828,2231207420,7,378,54,1361809800471,1361809827095,2231179891,2231206515,26624
1361809832,2231211172,18,14339,796.6111111,1361809807308,1361809830988,2231186480,2231210160,23680
1361809832,2231211252,1,52,52,1361809806590,1361809806590,2231185842,2231185842,0
1361809836,2231215364,1,52,52,1361809809039,1361809809039,2231188403,2231188403,0
1361809836,2231215396,6,324,54,1361809810540,1361809833068,2231189936,2231212464,22528
1361809839,869532252,2,453,226.5,1361809812205,1361809812205,869505457,869505457,0
1361809840,2231219112,1,46,46,1361809812361,1361809812361,2231191473,2231191473,0
1361809840,2231219188,2,265,132.5,1361809815550,1361809815614,2231194738,2231194802,64
1361809840,2231219196,3,525,175,1361809812024,1361809812024,2231191220,2231191220,0
1361809848,2231227268,1,52,52,1361809822830,1361809822830,2231202098,2231202098,0
1361809856,2231235268,1,46,46,1361809831084,1361809831084,2231210352,2231210352,0
1361809856,2231235304,2,92,46,1361809828745,1361809828873,2231208049,2231208177,128
1361809856,2231235352,5,542,108.4,1361809831002,1361809832154,2231210354,2231211506,1152
1361809861,2231239480,8,432,54,1361809833091,1361809860547,2231211571,2231239027,27456
1361809864,2231243308,8,432,54,1361809836486,1361809860678,2231215794,2231239986,24192
1361809877,2231255512,1,52,52,1361809852387,1361809852387,2231230899,2231230899,0
1361809880,2231259400,1,52,52,1361809854056,1361809854056,2231233456,2231233456,0
1361809883,869576348,1,52,52,1361809857167,1361809857167,869550515,869550515,0
1361809884,2231263368,2,92,46,1361809856011,1361809863563,2231235379,2231242931,7552
1361809884,2231263372,13,10653,819.4615385,1361809856199,1361809859207,2231235571,2231238579,3008
1361809888,2231267420,7,378,54,1361809862100,1361809884628,2231241520,2231264048,22528
1361809893,2231271484,1,52,52,1361809868735,1361809868735,2231247219,2231247219,0
1361809893,2231271508,8,432,54,1361809865638,1361809892262,2231244146,2231270770,26624
1361809896,2231275472,3,484,161.3333333,1361809871009,1361809871393,2231250481,2231250865,384
1361809901,2231279708,1,46,46,1361809876702,1361809876702,2231255410,2231255410,0
1361809909,2231287688,11,6203,563.9090909,1361809880944,1361809881072,2231259632,2231259760,128
1361809916,2231295188,5,381,76.2,1361809897084,1361809910396,2231276272,2231289584,13312
1361809916,2231295208,8,554,69.25,1361809899434,1361809914346,2231278642,2231293554,14912
1361809917,2231295632,7,378,54,1361809890410,1361809913706,2231269042,2231292338,23296
1361809917,2231295748,15,10834,722.2666667,1361809891955,1361809894323,2231270703,2231273071,2368
1361809921,2231299704,7,378,54,1361809894561,1361809919585,2231273265,2231298289,25024
1361809925,2231303760,4,349,87.25,1361809899496,1361809901352,2231278256,2231280112,1856
1361809927,869620352,1,52,52,1361809902218,1361809902218,869595570,869595570,0
1361809932,2231311132,11,692,62.90909091,1361809913142,1361809930422,2231292274,2231309554,17280
1361809945,2231323596,7,378,54,1361809917131,1361809943755,2231295727,2231322351,26624
1361809945,2231323796,1,46,46,1361809920325,1361809920325,2231299121,2231299121,0
1361809948,2231327152,4,196,49,1361809933152,1361809943776,2231312304,2231322928,10624
1361809948,2231327160,8,5448,681,1361809941784,1361809947544,2231320944,2231326704,5760
1361809948,2231327164,17,19130,1125.294118,1361809942483,1361809947667,2231321647,2231326831,5184
1361809948,2231327164,5,1834,366.8,1361809942547,1361809947603,2231321711,2231326767,5056
1361809948,2231327184,43,56744,1319.627907,1361809942463,1361809947583,2231321647,2231326767,5120
1361809948,2231327204,5,248,49.6,1361809932908,1361809946988,2231312112,2231326192,14080
1361809948,2231327232,5,689,137.8,1361809941714,1361809941970,2231320946,2231321202,256
1361809948,2231327236,7,4920,702.8571429,1361809942412,1361809947532,2231321648,2231326768,5120
1361809948,2231327240,9,5791,643.4444444,1361809938824,1361809940232,2231318064,2231319472,1408
1361809949,2231327592,6,324,54,1361809924690,1361809946386,2231303282,2231324978,21696
1361809949,2231327596,1,46,46,1361809921676,1361809921676,2231300272,2231300272,0
1361809953,2231331744,1,52,52,1361809926071,1361809926071,2231304815,2231304815,0
1361809953,2231331772,3,138,46,1361809926363,1361809937691,2231305135,2231316463,11328
1361809953,2231331788,5,922,184.4,1361809927309,1361809931853,2231306097,2231310641,4544
1361809956,2231335124,2,92,46,1361809947900,1361809953788,2231327024,2231332912,5888
1361809956,2231335136,4,196,49,1361809941807,1361809953775,2231320943,2231332911,11968
1361809956,2231335136,65,83837,1289.8,1361809941807,1361809953775,2231320943,2231332911,11968
1361809956,2231335176,7,3147,449.5714286,1361809939785,1361809949257,2231318961,2231328433,9472
1361809956,2231335176,8,3159,394.875,1361809939784,1361809949256,2231318960,2231328432,9472
1361809956,2231335208,5,242,48.4,1361809941735,1361809953703,2231320943,2231332911,11968
1361809956,2231335208,22,19392,881.4545455,1361809941735,1361809953703,2231320943,2231332911,11968
1361809964,2231343136,26,25907,996.4230769,1361809940017,1361809963825,2231319153,2231342961,23808
1361809964,2231343228,10,1460,146,1361809942422,1361809963734,2231321650,2231342962,21312
1361809965,2231343616,27,12641,468.1851852,1361809940857,1361809941177,2231319473,2231319793,320
1361809965,2231343680,6,2866,477.6666667,1361809939385,1361809939769,2231318065,2231318449,384
1361809965,2231343796,9,3173,352.5555556,1361809940034,1361809940162,2231318830,2231318958,128
1361809973,2231351624,99,138420,1398.181818,1361809948719,1361809972783,2231327343,2231351407,24064
1361809973,2231351700,7,378,54,1361809947812,1361809970340,2231326512,2231349040,22528
1361809975,869668296,1,52,52,1361809947202,1361809947202,869640498,869640498,0
1361809977,2231355748,7,378,54,1361809949556,1361809975348,2231328304,2231354096,25792
1361809981,2231359692,1,46,46,1361809954221,1361809954221,2231332913,2231332913,0
1361809981,2231359692,1,46,46,1361809954221,1361809954221,2231332913,2231332913,0
1361809981,2231359808,1,46,46,1361809954105,1361809954105,2231332913,2231332913,0
1361809981,2231359808,1,46,46,1361809954105,1361809954105,2231332913,2231332913,0
1361809981,2231359808,1,46,46,1361809954104,1361809954104,2231332912,2231332912,0
1361809988,2231367152,2,98,49,1361809980382,1361809980510,2231359534,2231359662,128
1361809988,2231367156,3,144,48,1361809980381,1361809981021,2231359537,2231360177,640
1361809988,2231367156,4,190,47.5,1361809980507,1361809980891,2231359663,2231360047,384
1361809988,2231367204,2,98,49,1361809970668,1361809980204,2231349872,2231359408,9536
1361809988,2231367240,3,138,46,1361809980169,1361809981385,2231359409,2231360625,1216
1361809988,2231367240,168,136868,814.6904762,1361809933001,1361809980489,2231312241,2231359729,47488
1361809988,2231367272,4,184,46,1361809966057,1361809982377,2231345329,2231361649,16320
1361809988,2231367276,16,2932,183.25,1361809974436,1361809980132,2231353712,2231359408,5696
1361810001,2231379664,8,432,54,1361809973705,1361809997065,2231352369,2231375729,23360
1361810004,2231383204,5,242,48.4,1361809986669,1361809998637,2231365873,2231377841,11968
1361810004,2231383208,5,528,105.6,1361810000039,1361810000487,2231379247,2231379695,448
1361810005,2231383636,7,378,54,1361809980449,1361810002145,2231359085,2231380781,21696
1361810005,2231383764,1,46,46,1361809980645,1361809980645,2231359409,2231359409,0
1361810007,869700348,1,46,46,1361809980238,1361809980238,869673586,869673586,0
1361810009,2231387712,1,52,52,1361809980886,1361809980886,2231359598,2231359598,0
1361810013,2231391640,1,77,77,1361809985825,1361809985825,2231364465,2231364465,0
1361810013,2231391788,14,3856,275.4285714,1361809987147,1361809987915,2231365935,2231366703,768
1361810013,2231391788,10,2941,294.1,1361809987082,1361809987210,2231365870,2231365998,128
1361810013,2231391792,2,265,132.5,1361809987209,1361809987337,2231366001,2231366129,128
1361810029,2231407696,6,324,54,1361810002023,1361810025319,2231380719,2231404015,23296
1361810033,2231411784,7,378,54,1361810006158,1361810032014,2231384942,2231410798,25856
1361810057,2231436096,1,52,52,1361810032664,1361810032664,2231411760,2231411760,0
1361810057,2231436100,6,324,54,1361810029075,1361810053267,2231408175,2231432367,24192
1361810057,2231436176,1,52,52,1361810031813,1361810031813,2231410989,2231410989,0
1361810061,2231440164,6,324,54,1361810035796,1361810058260,2231414960,2231437424,22464
1361810069,2231448048,2,265,132.5,1361810042182,1361810042246,2231421230,2231421294,64
1361810081,2231460228,1,60,60,1361810056592,1361810056592,2231435820,2231435820,0
1361810085,2231464076,6,324,54,1361810058283,1361810083307,2231437359,2231462383,25024
1361810089,2231468012,1,60,60,1361810064872,1361810064872,2231443884,2231443884,0
1361810089,2231468072,6,324,54,1361810063342,1361810088366,2231442414,2231467438,25024
1361810097,2231476036,222,301847,1359.671171,1361808867667,1361809791955,2230246703,2231170991,924288
1361810097,2231476236,14,10369,740.6428571,1361810071817,1361810075593,2231451053,2231454829,3776
1361810105,2231484060,1,52,52,1361810077818,1361810077818,2231456878,2231456878,0
1361810105,2231484144,1,52,52,1361810076904,1361810076904,2231456048,2231456048,0
1361810113,2231492332,6,324,54,1361810088044,1361810109676,2231467376,2231489008,21632
1361810116,2231495232,4,196,49,1361810113999,1361810114575,2231493231,2231493807,576
1361810116,2231495232,2,98,49,1361810113807,1361810114575,2231493039,2231493807,768
1361810116,2231495304,3,144,48,1361810113607,1361810114055,2231492911,2231493359,448
1361810116,2231495304,3,150,50,1361810113797,1361810114181,2231493101,2231493485,384
1361810116,2231495340,18,12527,695.9444444,1361810098913,1361810113569,2231478253,2231492909,14656
1361810117,2231496048,6,324,54,1361810092549,1361810113413,2231471597,2231492461,20864
1361810125,2231504080,5,755,151,1361810097831,1361810099175,2231476911,2231478255,1344
1361810129,2231508248,1,60,60,1361810104511,1361810104511,2231483759,2231483759,0
1361810132,2231511284,3,150,50,1361810118298,1361810128794,2231497582,2231508078,10496
1361810137,2231516100,1,60,60,1361810111635,1361810111635,2231490735,2231490735,0
1361810141,2231520080,1,52,52,1361810114087,1361810114087,2231493167,2231493167,0
1361810141,2231520084,7,378,54,1361810114080,1361810140768,2231493164,2231519852,26688
1361810141,2231520188,1,46,46,1361810113720,1361810113720,2231492908,2231492908,0
1361810145,2231524108,3,200,66.66666667,1361810118986,1361810119754,2231498094,2231498862,768
1361810145,2231524216,6,324,54,1361810118237,1361810143197,2231497453,2231522413,24960
1361810145,2231524224,7,825,117.8571429,1361810118615,1361810118807,2231497839,2231498031,192
1361810156,2231535280,4,196,49,1361810133854,1361810154782,2231513134,2231534062,20928
1361810161,2231540200,35,32833,938.0857143,1361810134189,1361810154541,2231513389,2231533741,20352
1361810169,2231548188,7,378,54,1361810143993,1361810168185,2231523181,2231547373,24192
1361810173,2231552240,6,324,54,1361810148228,1361810169028,2231527468,2231548268,20800
1361810181,2231560284,2,265,132.5,1361810154265,1361810154329,2231533549,2231533613,64
1361810188,869881168,1,46,46,1361810162949,1361810162949,869856117,869856117,0
1361810188,869881448,1,46,46,1361810162730,1361810162730,869856178,869856178,0
1361810189,2231568148,38,37250,980.2631579,1361810163936,1361810187232,2231543084,2231566380,23296
1361810196,2231575264,8,3199,399.875,1361810186603,1361810194411,2231565867,2231573675,7808
1361810197,2231576144,1,60,60,1361810169253,1361810169253,2231548397,2231548397,0
1361810197,2231576152,6,324,54,1361810172382,1361810196510,2231551534,2231575662,24128
1361810201,2231580252,6,324,54,1361810173175,1361810198199,2231552427,2231577451,25024
1361810212,2231591376,4,202,50.5,1361810194366,1361810204670,2231573742,2231584046,10304
1361810212,2231591376,3,150,50,1361810194366,1361810204670,2231573742,2231584046,10304
1361810212,2231591376,3,150,50,1361810194364,1361810204668,2231573740,2231584044,10304
1361810212,2231591376,4,202,50.5,1361810194364,1361810204668,2231573740,2231584044,10304
1361810212,2231591460,3,150,50,1361810194278,1361810204582,2231573738,2231584042,10304
1361810212,2231591460,4,202,50.5,1361810194278,1361810204582,2231573738,2231584042,10304
1361810214,2231592508,6,2498,416.3333333,1361810188320,1361810188448,2231566828,2231566956,128
1361810214,2231592544,65,82669,1271.830769,1361810189758,1361810195134,2231568302,2231573678,5376
1361810214,2231592628,6,3101,516.8333333,1361810188201,1361810188329,2231566829,2231566957,128
1361810222,2231600496,24,12927,538.625,1361810195182,1361810196526,2231573678,2231575022,1344
1361810226,2231604512,60,53886,898.1,1361810200284,1361810225692,2231578796,2231604204,25408
1361810226,2231604520,7,378,54,1361810201298,1361810223826,2231579818,2231602346,22528
1361810230,2231608504,6,324,54,1361810203940,1361810228900,2231582444,2231607404,24960
1361810237,2231616468,2,265,132.5,1361810209633,1361810209697,2231589101,2231589165,64
1361810250,2231628600,10,3998,399.8,1361810224646,1361810241222,2231603246,2231619822,16576
1361810254,2231632508,6,324,54,1361810228831,1361810253855,2231607339,2231632363,25024
1361810262,2231640628,8,432,54,1361810233830,1361810260454,2231612458,2231639082,26624
1361810266,2231644532,29,27399,944.7931034,1361810238151,1361810242503,2231616683,2231621035,4352
1361810266,2231644704,1,52,52,1361810240029,1361810240029,2231618733,2231618733,0
1361810266,2231644736,16,1975,123.4375,1361810241084,1361810243708,2231619820,2231622444,2624
1361810274,2231652532,11,2973,270.2727273,1361810246729,1361810254793,2231625261,2231633325,8064
1361810286,2231664600,6,324,54,1361810258757,1361810283781,2231637357,2231662381,25024
1361810290,2231668616,6,324,54,1361810265460,1361810287988,2231644076,2231666604,22528
1361810294,2231672548,2,265,132.5,1361810266422,1361810266550,2231644970,2231645098,128
1361810310,2231688664,87,106190,1220.574713,1361810285122,1361810306434,2231663786,2231685098,21312
1361810314,2231692576,1,46,46,1361810286365,1361810286365,2231664941,2231664941,0
1361810314,2231692608,1,46,46,1361810287481,1361810287481,2231666089,2231666089,0
1361810314,2231692648,16,8515,532.1875,1361810288851,1361810306899,2231667499,2231685547,18048
1361810314,2231692732,6,324,54,1361810288640,1361810310272,2231667372,2231689004,21632
1361810316,2231695416,3,150,50,1361810304530,1361810315026,2231683946,2231694442,10496
1361810316,2231695416,8,2637,329.625,1361810304721,1361810314833,2231684137,2231694249,10112
1361810316,2231695424,5,796,159.2,1361810307981,1361810314125,2231687405,2231693549,6144
1361810316,2231695464,4,2911,727.75,1361810308708,1361810312356,2231688172,2231691820,3648
1361810317,2231695500,8,1043,130.375,1361810313512,1361810314664,2231692012,2231693164,1152
1361810318,2231696736,6,324,54,1361810291194,1361810313722,2231669930,2231692458,22528
1361810322,870014916,3,144,48,1361810310464,1361810321280,870003380,870014196,10816
1361810322,870014932,3,144,48,1361810310446,1361810321262,870003378,870014194,10816
1361810324,2231703356,2,94,47,1361810309839,1361810320719,2231689195,2231700075,10880
1361810324,2231703356,3,140,46.66666667,1361810305807,1361810320655,2231685163,2231700011,14848
1361810324,2231703356,2,98,49,1361810305806,1361810320654,2231685162,2231700010,14848
1361810324,2231703356,3,140,46.66666667,1361810305806,1361810320654,2231685162,2231700010,14848
1361810324,2231703356,3,144,48,1361810305806,1361810320590,2231685162,2231699946,14784
1361810324,2231703356,3,144,48,1361810305870,1361810320654,2231685226,2231700010,14784
1361810324,2231703356,4,190,47.5,1361810308302,1361810322062,2231687658,2231701418,13760
1361810324,2231703356,2,98,49,1361810305806,1361810320654,2231685162,2231700010,14848
1361810324,2231703356,2,98,49,1361810305806,1361810320654,2231685162,2231700010,14848
1361810324,2231703356,2,98,49,1361810305806,1361810320654,2231685162,2231700010,14848
1361810324,2231703356,2,98,49,1361810305870,1361810320718,2231685226,2231700074,14848
1361810324,2231703356,2,98,49,1361810305806,1361810320654,2231685162,2231700010,14848
1361810324,2231703356,2,98,49,1361810305806,1361810320654,2231685162,2231700010,14848
1361810324,2231703356,2,98,49,1361810305869,1361810320717,2231685225,2231700073,14848
1361810324,2231703388,2,94,47,1361810308783,1361810317487,2231688171,2231696875,8704
1361810324,2231703388,2,94,47,1361810308781,1361810320621,2231688169,2231700009,11840
1361810324,2231703392,2,92,46,1361810308844,1361810319404,2231688236,2231698796,10560
1361810324,2231703392,3,144,48,1361810306730,1361810320554,2231686122,2231699946,13824
1361810324,2231703392,2,98,49,1361810306794,1361810320618,2231686186,2231700010,13824
1361810324,2231703428,2,98,49,1361810306758,1361810320582,2231686186,2231700010,13824
1361810324,2231703428,2,94,47,1361810309765,1361810320517,2231689193,2231699945,10752
1361810324,2231703432,3,140,46.66666667,1361810305731,1361810320579,2231685163,2231700011,14848
1361810324,2231703432,2,98,49,1361810305730,1361810320578,2231685162,2231700010,14848
1361810324,2231703432,2,98,49,1361810305730,1361810320578,2231685162,2231700010,14848
1361810324,2231703432,2,98,49,1361810305730,1361810320578,2231685162,2231700010,14848
1361810324,2231703432,2,98,49,1361810305730,1361810320578,2231685162,2231700010,14848
1361810324,2231703432,2,98,49,1361810305794,1361810320642,2231685226,2231700074,14848
1361810324,2231703432,3,144,48,1361810305794,1361810320578,2231685226,2231700010,14784
1361810324,2231703432,3,144,48,1361810305793,1361810320577,2231685225,2231700009,14784
1361810324,2231703460,4,190,47.5,1361810306662,1361810322534,2231686122,2231701994,15872
1361810324,2231703464,3,144,48,1361810306660,1361810320548,2231686124,2231700012,13888
1361810324,2231703464,2,98,49,1361810306723,1361810320547,2231686187,2231700011,13824
1361810326,2231704844,1,52,52,1361810299471,1361810299471,2231678315,2231678315,0
1361810332,2231711468,3,150,50,1361810308510,1361810330462,2231687978,2231709930,21952
1361810332,2231711468,3,150,50,1361810308509,1361810330461,2231687977,2231709929,21952
1361810333,2231711508,3,150,50,1361810313436,1361810331420,2231691944,2231709928,17984
1361810334,2231712692,9,3490,387.7777778,1361810308709,1361810309541,2231687401,2231688233,832
1361810334,2231712700,3,386,128.6666667,1361810306462,1361810308766,2231685162,2231687466,2304
1361810334,2231712700,35,32743,935.5142857,1361810306525,1361810329949,2231685225,2231708649,23424
1361810334,2231712704,8,6234,779.25,1361810306524,1361810306780,2231685228,2231685484,256
1361810334,2231712736,3,498,166,1361810309241,1361810309369,2231687977,2231688105,128
1361810334,2231712736,17,15168,892.2352941,1361810309242,1361810319738,2231687978,2231698474,10496
1361810334,2231712736,8,2260,282.5,1361810309242,1361810311034,2231687978,2231689770,1792
1361810334,2231712816,10,9086,908.6,1361810306410,1361810309738,2231685226,2231688554,3328
1361810334,2231712852,4,208,52,1361810309192,1361810330184,2231688044,2231709036,20992
1361810334,2231712860,6,2667,444.5,1361810309439,1361810312703,2231688299,2231691563,3264
1361810334,2231712864,4,2810,702.5,1361810309499,1361810312571,2231688363,2231691435,3072
1361810336,870028764,7,6735,962.1428571,1361810309465,1361810309529,870002229,870002293,64
1361810338,2231716772,5,2287,457.4,1361810312726,1361810315094,2231691498,2231693866,2368
1361810338,2231716772,10,7842,784.2,1361810312726,1361810314134,2231691498,2231692906,1408
1361810338,2231716772,11,9601,872.8181818,1361810312726,1361810313046,2231691498,2231691818,320
1361810338,2231716776,5,855,171,1361810312916,1361810313108,2231691692,2231691884,192
1361810338,2231716816,2,770,385,1361810310379,1361810310443,2231689195,2231689259,64
1361810338,2231716972,12,9796,816.3333333,1361810312524,1361810314892,2231691496,2231693864,2368
1361810338,2231716972,7,4828,689.7142857,1361810312528,1361810312848,2231691500,2231691820,320
1361810338,2231716980,4,325,81.25,1361810313222,1361810313222,2231692202,2231692202,0
1361810340,2231719396,2,98,49,1361810333543,1361810333543,2231712939,2231712939,0
1361810340,2231719436,2,92,46,1361810335805,1361810336061,2231715241,2231715497,256
1361810340,2231719440,3,700,233.3333333,1361810320059,1361810332091,2231699499,2231711531,12032
1361810342,2231720828,7,378,54,1361810314336,1361810341024,2231693164,2231719852,26688
1361810346,2231724712,4,930,232.5,1361810318737,1361810318993,2231697449,2231697705,256
1361810346,2231724712,37,49799,1345.918919,1361810318737,1361810319313,2231697449,2231698025,576
1361810346,2231724712,6,324,54,1361810318737,1361810343697,2231697449,2231722409,24960
1361810346,2231724824,5,700,140,1361810318435,1361810318435,2231697259,2231697259,0
1361810346,2231724896,1,46,46,1361810321115,1361810321115,2231700011,2231700011,0
1361810350,2231728716,2,265,132.5,1361810322190,1361810322318,2231700906,2231701034,128
1361810351,2231730244,202,284798,1409.891089,1361809972224,1361810048384,2231351468,2231427628,76160
1361810358,2231736748,1,46,46,1361810331311,1361810331311,2231710059,2231710059,0
1361810358,2231736812,3,309,103,1361810332717,1361810332717,2231711529,2231711529,0
1361810358,2231736856,1,46,46,1361810331073,1361810331073,2231709929,2231709929,0
1361810358,2231736896,56,59066,1054.75,1361810332249,1361810347545,2231711145,2231726441,15296
1361810362,2231740816,2,98,49,1361810334120,1361810334120,2231712936,2231712936,0
1361810362,2231740868,2,92,46,1361810336372,1361810345396,2231715240,2231724264,9024
1361810362,2231740900,6,888,148,1361810337238,1361810357654,2231716138,2231736554,20416
1361810370,2231749000,6,324,54,1361810344176,1361810367536,2231723176,2231746536,23360
1361810370,2231749028,1,52,52,1361810344341,1361810344341,2231723369,2231723369,0
1361810370,2231749164,1,46,46,1361810345100,1361810345100,2231724264,2231724264,0
1361810373,2231751480,3,421,140.3333333,1361810369595,1361810370619,2231748075,2231749099,1024
1361810373,2231751552,2,92,46,1361810364786,1361810371762,2231743338,2231750314,6976
1361810374,2231752932,6,324,54,1361810348469,1361810370165,2231727401,2231749097,21696
1361810378,2231756948,17,9907,582.7647059,1361810351652,1361810369764,2231730600,2231748712,18112
1361810378,2231756988,3,386,128.6666667,1361810353534,1361810370110,2231732522,2231749098,16576
1361810380,870072752,1,52,52,1361810354531,1361810354531,870047283,870047283,0
1361810380,2231759448,3,175,58.33333333,1361810357488,1361810376496,2231736936,2231755944,19008
1361810380,2231759456,3,175,58.33333333,1361810358507,1361810378475,2231737963,2231757931,19968
1361810381,2231759480,2,98,49,1361810360505,1361810374457,2231738985,2231752937,13952
1361810381,2231759480,7,3147,449.5714286,1361810368312,1361810375736,2231746792,2231754216,7424
1361810381,2231759488,2,94,47,1361810369585,1361810379953,2231748073,2231758441,10368
1361810381,2231759488,2,94,47,1361810369585,1361810379953,2231748073,2231758441,10368
1361810381,2231759496,5,329,65.8,1361810358379,1361810377451,2231736875,2231755947,19072
1361810381,2231759540,2,98,49,1361810360380,1361810374396,2231738920,2231752936,14016
1361810381,2231759568,2,94,47,1361810369506,1361810379874,2231748074,2231758442,10368
1361810381,2231759568,2,94,47,1361810369504,1361810379872,2231748072,2231758440,10368
1361810381,2231759568,6,2352,392,1361810369568,1361810373984,2231748136,2231752552,4416
1361810382,2231760912,3,498,166,1361810354185,1361810370761,2231733097,2231749673,16576
1361810382,2231760984,1,52,52,1361810355329,1361810355329,2231734313,2231734313,0
1361810382,2231760988,1,46,46,1361810357503,1361810357503,2231736491,2231736491,0
1361810382,2231760992,4,522,130.5,1361810355772,1361810370748,2231734764,2231749740,14976
1361810382,2231761000,5,2645,529,1361810357681,1361810370737,2231736681,2231749737,13056
1361810382,2231761024,8,3541,442.625,1361810354266,1361810370842,2231733290,2231749866,16576
1361810386,2231765040,1,52,52,1361810357899,1361810357899,2231736939,2231736939,0
1361810386,2231765044,1,52,52,1361810358213,1361810358213,2231737257,2231737257,0
1361810388,2231767452,4,196,49,1361810370284,1361810380844,2231749736,2231760296,10560
1361810388,2231767452,4,196,49,1361810370284,1361810381100,2231749736,2231760552,10816
1361810388,2231767452,3,140,46.66666667,1361810370284,1361810380844,2231749736,2231760296,10560
1361810388,2231767456,2,98,49,1361810370281,1361810380457,2231749737,2231759913,10176
1361810388,2231767456,3,150,50,1361810370281,1361810380841,2231749737,2231760297,10560
1361810388,2231767456,2,98,49,1361810370281,1361810380457,2231749737,2231759913,10176
1361810389,2231767492,3,150,50,1361810369583,1361810381807,2231748075,2231760299,12224
1361810389,2231767492,3,150,50,1361810369647,1361810381807,2231748139,2231760299,12160
1361810389,2231767492,3,150,50,1361810369647,1361810381807,2231748139,2231760299,12160
1361810389,2231767492,4,190,47.5,1361810369647,1361810381807,2231748139,2231760299,12160
1361810389,2231767492,4,190,47.5,1361810369583,1361810381807,2231748075,2231760299,12224
1361810389,2231767492,3,150,50,1361810369647,1361810381807,2231748139,2231760299,12160
1361810389,2231767492,4,190,47.5,1361810369647,1361810381807,2231748139,2231760299,12160
1361810389,2231767492,5,248,49.6,1361810369711,1361810383087,2231748203,2231761579,13376
1361810389,2231767528,2,98,49,1361810371208,1361810381384,2231749736,2231759912,10176
1361810389,2231767528,3,150,50,1361810371208,1361810381768,2231749736,2231760296,10560
1361810389,2231767528,2,98,49,1361810371208,1361810381384,2231749736,2231759912,10176
1361810389,2231767532,3,140,46.66666667,1361810371208,1361810381768,2231749740,2231760300,10560
1361810389,2231767532,2,98,49,1361810371207,1361810381383,2231749739,2231759915,10176
1361810389,2231767532,2,98,49,1361810371207,1361810381383,2231749739,2231759915,10176
1361810389,2231767532,2,94,47,1361810371271,1361810381767,2231749803,2231760299,10496
1361810389,2231767568,3,150,50,1361810369505,1361810381729,2231748073,2231760297,12224
1361810389,2231767568,4,196,49,1361810369569,1361810381729,2231748137,2231760297,12160
1361810389,2231767568,3,150,50,1361810369569,1361810381729,2231748137,2231760297,12160
1361810389,2231767568,4,190,47.5,1361810369568,1361810381728,2231748136,2231760296,12160
1361810389,2231767568,4,190,47.5,1361810369504,1361810381728,2231748072,2231760296,12224
1361810389,2231767568,3,144,48,1361810369568,1361810381600,2231748136,2231760168,12032
1361810389,2231767568,4,190,47.5,1361810369568,1361810381728,2231748136,2231760296,12160
1361810389,2231767568,4,196,49,1361810369632,1361810382048,2231748200,2231760616,12416
1361810390,2231768988,87,100064,1150.16092,1361810363261,1361810369405,2231742249,2231748393,6144
1361810390,2231769016,1,52,52,1361810363489,1361810363489,2231742505,2231742505,0
1361810390,2231769052,1,52,52,1361810364412,1361810364412,2231743464,2231743464,0
1361810390,2231769140,1,52,52,1361810363878,1361810363878,2231743018,2231743018,0
1361810394,2231773036,33,32004,969.8181818,1361810369102,1361810392078,2231748138,2231771114,22976
1361810394,2231773036,3,190,63.33333333,1361810369038,1361810371342,2231748074,2231750378,2304
1361810394,2231773040,3,150,50,1361810369224,1361810390920,2231748264,2231769960,21696
1361810394,2231773040,4,202,50.5,1361810369224,1361810390920,2231748264,2231769960,21696
1361810394,2231773108,6,2498,416.3333333,1361810367687,1361810367751,2231746795,2231746859,64
1361810394,2231773232,3,150,50,1361810369032,1361810390728,2231748264,2231769960,21696
1361810397,2231775532,2,98,49,1361810371396,1361810391428,2231749928,2231769960,20032
1361810398,2231776968,6,324,54,1361810372563,1361810397523,2231751531,2231776491,24960
1361810398,2231777012,12,8183,681.9166667,1361810370790,1361810397670,2231749802,2231776682,26880
1361810402,870094916,3,144,48,1361810397697,1361810398145,870090613,870091061,448
1361810402,2231781028,5,230,46,1361810375958,1361810400790,2231754986,2231779818,24832
1361810402,2231781076,3,484,161.3333333,1361810377381,1361810377765,2231756457,2231756841,384
1361810402,2231781116,7,378,54,1361810374143,1361810399999,2231753259,2231779115,25856
1361810405,2231783496,3,144,48,1361810390443,1361810398187,2231768939,2231776683,7744
1361810405,2231783536,3,144,48,1361810397889,1361810398209,2231776425,2231776745,320
1361810405,2231783536,2,92,46,1361810397889,1361810398209,2231776425,2231776745,320
1361810405,2231783536,2,92,46,1361810397888,1361810398336,2231776424,2231776872,448
1361810405,2231783536,2,92,46,1361810397888,1361810398336,2231776424,2231776872,448
1361810405,2231783536,2,92,46,1361810397887,1361810398399,2231776423,2231776935,512
1361810405,2231783540,3,138,46,1361810397951,1361810398847,2231776491,2231777387,896
1361810405,2231783544,5,230,46,1361810393210,1361810401274,2231771754,2231779818,8064
1361810405,2231783544,4,202,50.5,1361810398201,1361810398777,2231776745,2231777321,576
1361810405,2231783580,13,1645,126.5384615,1361810394774,1361810400982,2231773354,2231779562,6208
1361810405,2231783620,3,138,46,1361810397804,1361810398828,2231776424,2231777448,1024
1361810405,2231783620,2,92,46,1361810397803,1361810398251,2231776423,2231776871,448
1361810405,2231783620,3,138,46,1361810397803,1361810402795,2231776423,2231781415,4992
1361810405,2231783620,4,184,46,1361810397803,1361810401195,2231776423,2231779815,3392
1361810405,2231783620,2,92,46,1361810397807,1361810398127,2231776427,2231776747,320
1361810405,2231783624,2,98,49,1361810398058,1361810398186,2231776682,2231776810,128
1361810406,2231785016,1,46,46,1361810380897,1361810380897,2231759913,2231759913,0
1361810406,2231785020,1,46,46,1361810380895,1361810380895,2231759915,2231759915,0
1361810406,2231785028,2,92,46,1361810381268,1361810381268,2231760296,2231760296,0
1361810406,2231785148,1,46,46,1361810380764,1361810380764,2231759912,2231759912,0
1361810406,2231785148,1,46,46,1361810380764,1361810380764,2231759912,2231759912,0
1361810406,2231785188,1,46,46,1361810380727,1361810380727,2231759915,2231759915,0
1361810406,2231785196,2,92,46,1361810381102,1361810381102,2231760298,2231760298,0
1361810410,2231789004,1,46,46,1361810385261,1361810385261,2231764265,2231764265,0
1361810410,2231789012,1,46,46,1361810385319,1361810385319,2231764331,2231764331,0
1361810410,2231789012,1,46,46,1361810385319,1361810385319,2231764331,2231764331,0
1361810413,2231791480,3,150,50,1361810404922,1361810411130,2231783402,2231789610,6208
1361810413,2231791532,7,2037,291,1361810404741,1361810410181,2231783273,2231788713,5440
1361810413,2231791568,8,3005,375.625,1361810403809,1361810412833,2231782377,2231791401,9024
1361810413,2231791572,5,2562,512.4,1361810406237,1361810411357,2231784809,2231789929,5120
1361810413,2231791572,54,71547,1324.944444,1361810406236,1361810411356,2231784808,2231789928,5120
1361810413,2231791576,4,196,49,1361810404314,1361810404954,2231782890,2231783530,640
1361810413,2231791576,18,17963,997.9444444,1361810404696,1361810410200,2231783272,2231788776,5504
1361810413,2231791576,14,12786,913.2857143,1361810404696,1361810410200,2231783272,2231788776,5504
1361810421,2231799516,4,196,49,1361810402709,1361810414997,2231781225,2231793513,12288
1361810421,2231799548,7,3147,449.5714286,1361810403828,1361810412852,2231782376,2231791400,9024
1361810421,2231799564,5,248,49.6,1361810402660,1361810416804,2231781224,2231795368,14144
1361810421,2231799596,3,150,50,1361810402887,1361810413447,2231781483,2231792043,10560
1361810422,2231801024,1,46,46,1361810397403,1361810397403,2231776427,2231776427,0
1361810422,2231801128,1,46,46,1361810397296,1361810397296,2231776424,2231776424,0
1361810422,2231801128,1,46,46,1361810397296,1361810397296,2231776424,2231776424,0
1361810422,2231801132,1,46,46,1361810397295,1361810397295,2231776427,2231776427,0
1361810426,2231804988,2,104,52,1361810398334,1361810400830,2231777322,2231779818,2496
1361810426,2231805072,8,432,54,1361810401642,1361810424938,2231780714,2231804010,23296
1361810429,2231807500,8,1369,171.125,1361810406311,1361810426279,2231784811,2231804779,19968
1361810429,2231807504,4,343,85.75,1361810402786,1361810427810,2231781290,2231806314,25024
1361810429,2231807592,18,19635,1090.833333,1361810404234,1361810423882,2231782826,2231802474,19648
1361810430,2231809024,5,488,97.6,1361810402202,1361810402650,2231781226,2231781674,448
1361810430,2231809028,2,123,61.5,1361810402455,1361810402455,2231781483,2231781483,0
1361810430,2231809028,28,11805,421.6071429,1361810402454,1361810406294,2231781482,2231785322,3840
1361810430,2231809096,7,378,54,1361810404179,1361810429139,2231783275,2231808235,24960
1361810430,2231809140,7,3113,444.7142857,1361810402469,1361810402597,2231781609,2231781737,128
1361810430,2231809140,1,46,46,1361810404900,1361810404900,2231784040,2231784040,0
1361810430,2231809140,1,46,46,1361810404900,1361810404900,2231784040,2231784040,0
1361810430,2231809140,1,46,46,1361810404836,1361810404836,2231783976,2231783976,0
1361810430,2231809176,18,7262,403.4444444,1361810403009,1361810420481,2231782185,2231799657,17472
1361810437,2231815496,11,4721,429.1818182,1361810434537,1361810434985,2231813033,2231813481,448
1361810437,2231815500,6,501,83.5,1361810431395,1361810434595,2231809895,2231813095,3200
1361810437,2231815504,5,690,138,1361810429536,1361810429856,2231808040,2231808360,320
1361810437,2231815508,10,2055,205.5,1361810429726,1361810430046,2231808234,2231808554,320
1361810437,2231815508,6,831,138.5,1361810429789,1361810434717,2231808297,2231813225,4928
1361810437,2231815508,2,298,149,1361810429852,1361810431900,2231808360,2231810408,2048
1361810437,2231815508,3,144,48,1361810429852,1361810432924,2231808360,2231811432,3072
1361810437,2231815508,11,2274,206.7272727,1361810432092,1361810433244,2231810600,2231811752,1152
1361810437,2231815508,3,144,48,1361810429851,1361810432923,2231808359,2231811431,3072
1361810437,2231815540,3,138,46,1361810432893,1361810433789,2231811433,2231812329,896
1361810437,2231815544,6,588,98,1361810433402,1361810433786,2231811946,2231812330,384
1361810437,2231815552,12,7283,606.9166667,1361810430963,1361810434419,2231809515,2231812971,3456
1361810437,2231815552,14,1123,80.21428571,1361810431026,1361810433266,2231809578,2231811818,2240
1361810437,2231815572,11,5486,498.7272727,1361810429660,1361810429980,2231808232,2231808552,320
1361810437,2231815576,4,562,140.5,1361810429719,1361810429847,2231808295,2231808423,128
1361810437,2231815576,3,144,48,1361810429786,1361810432858,2231808362,2231811434,3072
1361810437,2231815576,3,144,48,1361810429786,1361810432858,2231808362,2231811434,3072
1361810437,2231815576,6,4292,715.3333333,1361810429847,1361810430103,2231808423,2231808679,256
1361810437,2231815584,2,92,46,1361810432849,1361810433233,2231811433,2231811817,384
1361810437,2231815584,2,304,152,1361810433359,1361810436431,2231811943,2231815015,3072
1361810438,2231817012,1,46,46,1361810412452,1361810412452,2231791464,2231791464,0
1361810438,2231817012,1,46,46,1361810412452,1361810412452,2231791464,2231791464,0
1361810438,2231817012,1,46,46,1361810412452,1361810412452,2231791464,2231791464,0
1361810438,2231817012,3,138,46,1361810412452,1361810413348,2231791464,2231792360,896
1361810438,2231817104,1,46,46,1361810412362,1361810412362,2231791466,2231791466,0
1361810438,2231817104,1,46,46,1361810412362,1361810412362,2231791466,2231791466,0
1361810445,2231823516,7,3335,476.4285714,1361810429013,1361810442965,2231807529,2231821481,13952
1361810445,2231823516,27,32000,1185.185185,1361810429012,1361810442964,2231807528,2231821480,13952
1361810445,2231823524,10,4445,444.5,1361810434763,1361810438475,2231813287,2231816999,3712
1361810445,2231823524,3,355,118.3333333,1361810429453,1361810442957,2231807977,2231821481,13504
1361810445,2231823528,3,150,50,1361810431562,1361810444554,2231810090,2231823082,12992
1361810445,2231823528,3,144,48,1361810431562,1361810442890,2231810090,2231821418,11328
1361810445,2231823528,2,98,49,1361810429704,1361810442888,2231808232,2231821416,13184
1361810445,2231823528,2,98,49,1361810429704,1361810442888,2231808232,2231821416,13184
1361810445,2231823528,2,98,49,1361810429703,1361810442887,2231808231,2231821415,13184
1361810445,2231823528,2,98,49,1361810429767,1361810442887,2231808295,2231821415,13120
1361810445,2231823532,4,196,49,1361810429703,1361810443527,2231808235,2231822059,13824
1361810445,2231823532,3,350,116.6666667,1361810429766,1361810442886,2231808298,2231821418,13120
1361810445,2231823532,2,98,49,1361810429828,1361810442884,2231808360,2231821416,13056
1361810445,2231823560,2,98,49,1361810428519,1361810442855,2231807079,2231821415,14336
1361810445,2231823564,13,5178,398.3076923,1361810428709,1361810444517,2231807273,2231823081,15808
1361810445,2231823564,3,150,50,1361810428773,1361810442917,2231807337,2231821481,14144
1361810445,2231823564,3,150,50,1361810428772,1361810442916,2231807336,2231821480,14144
1361810445,2231823564,3,144,48,1361810428708,1361810442916,2231807272,2231821480,14208
1361810445,2231823568,7,3546,506.5714286,1361810428960,1361810442912,2231807528,2231821480,13952
1361810445,2231823568,7,3143,449,1361810428959,1361810442911,2231807527,2231821479,13952
1361810445,2231823592,3,150,50,1361810431495,1361810444487,2231810087,2231823079,12992
1361810445,2231823592,4,196,49,1361810434951,1361810442823,2231813543,2231821415,7872
1361810445,2231823596,4,196,49,1361810429636,1361810443460,2231808232,2231822056,13824
1361810445,2231823596,4,407,101.75,1361810427332,1361810442884,2231805928,2231821480,15552
1361810445,2231823596,2,98,49,1361810429699,1361810442819,2231808295,2231821415,13120
1361810445,2231823596,2,98,49,1361810429699,1361810442819,2231808295,2231821415,13120
1361810445,2231823600,2,98,49,1361810429823,1361810442815,2231808423,2231821415,12992
1361810445,2231823608,2,98,49,1361810428473,1361810442809,2231807081,2231821417,14336
1361810445,2231823636,3,144,48,1361810428639,1361810442847,2231807275,2231821483,14208
1361810445,2231823636,13,6472,497.8461538,1361810428638,1361810444446,2231807274,2231823082,15808
1361810445,2231823636,4,196,49,1361810428702,1361810442846,2231807338,2231821482,14144
1361810445,2231823636,3,150,50,1361810428702,1361810442846,2231807338,2231821482,14144
1361810446,2231825044,9,2950,327.7777778,1361810421252,1361810421572,2231800296,2231800616,320
1361810446,2231825156,1,46,46,1361810421139,1361810421139,2231800295,2231800295,0
1361810450,870142908,3,144,48,1361810429513,1361810442697,870122421,870135605,13184
1361810450,870142928,3,144,48,1361810429494,1361810442678,870122422,870135606,13184
1361810450,2231829012,2,92,46,1361810422371,1361810422499,2231801383,2231801511,128
1361810450,2231829016,1,46,46,1361810422434,1361810422434,2231801450,2231801450,0
1361810453,2231831580,4,190,47.5,1361810429652,1361810451028,2231808232,2231829608,21376
1361810454,2231833080,12,9647,803.9166667,1361810429151,1361810429599,2231808231,2231808679,448
1361810454,2231833084,5,2000,400,1361810429149,1361810430493,2231808233,2231809577,1344
1361810454,2231833088,3,189,63,1361810429271,1361810437911,2231808359,2231816999,8640
1361810454,2231833088,28,27458,980.6428571,1361810427032,1361810438360,2231806120,2231817448,11328
1361810454,2231833124,32,38577,1205.53125,1361810429621,1361810429941,2231808745,2231809065,320
1361810454,2231833124,4,796,199,1361810427956,1361810429108,2231807080,2231808232,1152
1361810454,2231833128,7,378,54,1361810428209,1361810450737,2231807337,2231829865,22528
1361810454,2231833168,3,881,293.6666667,1361810428810,1361810428874,2231807978,2231808042,64
1361810454,2231833168,2,92,46,1361810428872,1361810431880,2231808040,2231811048,3008
1361810454,2231833188,24,22908,954.5,1361810429043,1361810434739,2231808231,2231813927,5696
1361810454,2231833192,7,4828,689.7142857,1361810429041,1361810429169,2231808233,2231808361,128
1361810454,2231833192,3,1076,358.6666667,1361810429041,1361810434033,2231808233,2231813225,4992
1361810454,2231833196,4,184,46,1361810429166,1361810438190,2231808362,2231817386,9024
1361810454,2231833200,3,150,50,1361810429226,1361810452266,2231808426,2231831466,23040
1361810454,2231833232,11,10801,981.9090909,1361810429447,1361810430535,2231808679,2231809767,1088
1361810456,870148820,9,2004,222.6666667,1361810428834,1361810432994,870121654,870125814,4160
1361810458,2231837172,3,138,46,1361810430918,1361810452358,2231810090,2231831530,21440
1361810458,2231837204,1,46,46,1361810432228,1361810432228,2231811432,2231811432,0
1361810458,2231837244,2,265,132.5,1361810433597,1361810433661,2231812841,2231812905,64
1361810461,2231839608,16,14924,932.75,1361810438776,1361810457528,2231817384,2231836136,18752
1361810461,2231839656,2,92,46,1361810452808,1361810455816,2231831464,2231834472,3008
1361810461,2231839688,5,1738,347.6,1361810443112,1361810453160,2231821800,2231831848,10048
1361810462,2231841072,6,324,54,1361810434152,1361810459176,2231813224,2231838248,25024
1361810469,2231847552,2,98,49,1361810455921,1361810462001,2231834473,2231840553,6080
1361810470,2231849060,1,46,46,1361810442357,1361810442357,2231821417,2231821417,0
1361810470,2231849168,2,92,46,1361810444551,1361810452359,2231823719,2231831527,7808
1361810474,2231853060,2,92,46,1361810447028,1361810452404,2231826088,2231831464,5376
1361810474,2231853176,2,92,46,1361810446914,1361810452290,2231826090,2231831466,5376
1361810474,2231853180,1,52,52,1361810447293,1361810447293,2231826473,2231826473,0
1361810477,2231855548,6,276,46,1361810471476,1361810474740,2231850024,2231853288,3264
1361810478,2231857048,2,92,46,1361810452482,1361810452930,2231831530,2231831978,448
1361810478,2231857140,1,46,46,1361810452325,1361810452325,2231831465,2231831465,0
1361810478,2231857220,1,52,52,1361810451158,1361810451158,2231830378,2231830378,0
1361810482,2231861132,7,378,54,1361810454060,1361810478188,2231833192,2231857320,24128
1361810490,2231869184,3,138,46,1361810464121,1361810468345,2231843305,2231847529,4224
1361810490,2231869264,7,378,54,1361810463145,1361810487337,2231842409,2231866601,24192
1361810490,2231869288,1,46,46,1361810463506,1361810463506,2231842794,2231842794,0
1361810490,2231869296,3,138,46,1361810464008,1361810464136,2231843304,2231843432,128
1361810493,2231871596,5,236,47.2,1361810481475,1361810492355,2231860071,2231870951,10880
1361810494,2231873200,1,52,52,1361810468394,1361810468394,2231847594,2231847594,0
1361810498,2231877156,7,2299,328.4285714,1361810470676,1361810487956,2231849832,2231867112,17280
1361810501,2231879572,5,236,47.2,1361810491293,1361810500445,2231869865,2231879017,9152
1361810501,2231879608,8,529,66.125,1361810481462,1361810496054,2231860070,2231874662,14592
1361810501,2231879612,5,230,46,1361810494451,1361810500723,2231873063,2231879335,6272
1361810501,2231879616,6,282,47,1361810486833,1361810498097,2231865449,2231876713,11264
1361810501,2231879660,8,498,62.25,1361810481414,1361810498246,2231860074,2231876906,16832
1361810506,2231885236,1,52,52,1361810480837,1361810480837,2231860073,2231860073,0
1361810506,2231885236,1,52,52,1361810480773,1361810480773,2231860009,2231860009,0
1361810506,2231885404,1,52,52,1361810480668,1361810480668,2231860072,2231860072,0
1361810506,2231885404,1,52,52,1361810480603,1361810480603,2231860007,2231860007,0
1361810508,870201004,1,52,52,1361810481194,1361810481194,870174198,870174198,0
1361810510,2231889304,7,378,54,1361810482175,1361810508863,2231861479,2231888167,26688
1361810514,2231893372,9,1130,125.5555556,1361810488762,1361810500026,2231868134,2231879398,11264
1361810518,2231897356,1,52,52,1361810490506,1361810490506,2231869862,2231869862,0
1361810518,2231897376,6,324,54,1361810491384,1361810514680,2231870760,2231894056,23296
1361810523,2231902268,1,46,46,1361810497509,1361810497509,2231876777,2231876777,0
1361810524,2231903088,1,46,46,1361810497623,1361810497623,2231876711,2231876711,0
1361810528,2231906484,2,92,46,1361810502132,1361810504820,2231880616,2231883304,2688
1361810528,2231906744,1,52,52,1361810500590,1361810500590,2231879334,2231879334,0
1361810530,2231909380,2,92,46,1361810503029,1361810506421,2231882409,2231885801,3392
1361810531,2231909484,1,52,52,1361810504755,1361810504755,2231883239,2231883239,0
1361810531,2231909488,2,92,46,1361810505072,1361810506992,2231883560,2231885480,1920
1361810533,2231911580,4,184,46,1361810528851,1361810532115,2231907431,2231910695,3264
1361810534,2231913392,1,46,46,1361810506088,1361810506088,2231885480,2231885480,0
1361810534,2231913392,6,1180,196.6666667,1361810506150,1361810515814,2231885542,2231895206,9664
1361810535,2231913504,1,46,46,1361810506974,1361810506974,2231885478,2231885478,0
1361810539,2231917480,6,324,54,1361810514679,1361810536375,2231893159,2231914855,21696
1361810543,2231921612,1,52,52,1361810516274,1361810516274,2231894886,2231894886,0
1361810547,2231925476,7,378,54,1361810519740,1361810545596,2231898216,2231924072,25856
1361810554,2231933456,1,52,52,1361810529703,1361810529703,2231909159,2231909159,0
1361810556,870249068,1,52,52,1361810530280,1361810530280,870223348,870223348,0
1361810558,2231937404,1,52,52,1361810532445,1361810532445,2231911849,2231911849,0
1361810558,2231937444,1,52,52,1361810531505,1361810531505,2231910949,2231910949,0
1361810559,2231937516,1,52,52,1361810533332,1361810533332,2231911848,2231911848,0
1361810562,2231941388,4,184,46,1361810535017,1361810540649,2231914405,2231920037,5632
1361810566,2231945392,39,30858,791.2307692,1361810538280,1361810550056,2231917672,2231929448,11776
1361810566,2231945420,7,378,54,1361810538761,1361810565449,2231918181,2231944869,26688
1361810567,2231945512,1,46,46,1361810541591,1361810541591,2231920103,2231920103,0
1361810571,2231949528,1,52,52,1361810546375,1361810546375,2231924903,2231924903,0
1361810574,2231953412,2,265,132.5,1361810548561,1361810548689,2231927973,2231928101,128
1361810574,2231953452,1,52,52,1361810548843,1361810548843,2231928295,2231928295,0
1361810575,2231953492,6,324,54,1361810550570,1361810573930,2231929062,2231952422,23360
1361810587,2231965620,1,52,52,1361810561450,1361810561450,2231940070,2231940070,0
1361810589,2231967912,5,794,158.8,1361810584582,1361810588422,2231963494,2231967334,3840
1361810589,2231967980,8,3970,496.25,1361810579841,1361810582401,2231958821,2231961381,2560
1361810595,2231973524,6,324,54,1361810570506,1361810592138,2231949030,2231970662,21632
1361810597,2231975608,2,94,47,1361810584885,1361810595829,2231963493,2231974437,10944
1361810597,2231975628,2,94,47,1361810585060,1361810595812,2231963688,2231974440,10752
1361810597,2231975680,2,94,47,1361810584941,1361810595757,2231963621,2231974437,10816
1361810597,2231975680,2,94,47,1361810585005,1361810595757,2231963685,2231974437,10752
1361810600,870293128,1,52,52,1361810575213,1361810575213,870268341,870268341,0
1361810603,2231981600,7,1066,152.2857143,1361810578493,1361810587581,2231957093,2231966181,9088
1361810603,2231981600,1,52,52,1361810578493,1361810578493,2231957093,2231957093,0
1361810603,2231981716,6,324,54,1361810577867,1361810599499,2231956583,2231978215,21632
1361810603,2231981720,1,52,52,1361810578373,1361810578373,2231957093,2231957093,0
1361810605,2231983596,2,98,49,1361810586818,1361810602818,2231965414,2231981414,16000
1361810605,2231983600,2,98,49,1361810586812,1361810602812,2231965412,2231981412,16000
1361810605,2231983600,3,150,50,1361810586880,1361810602880,2231965480,2231981480,16000
1361810605,2231983600,3,144,48,1361810586879,1361810602815,2231965479,2231981415,15936
1361810605,2231983604,2,98,49,1361810589436,1361810602812,2231968040,2231981416,13376
1361810605,2231983608,2,98,49,1361810588022,1361810602806,2231966630,2231981414,14784
1361810605,2231983612,3,144,48,1361810584817,1361810602801,2231963429,2231981413,17984
1361810605,2231983612,2,98,49,1361810584884,1361810602804,2231963496,2231981416,17920
1361810605,2231983612,4,196,49,1361810584884,1361810602804,2231963496,2231981416,17920
1361810605,2231983612,2,98,49,1361810584884,1361810602804,2231963496,2231981416,17920
1361810605,2231983612,3,144,48,1361810584884,1361810602804,2231963496,2231981416,17920
1361810605,2231983612,2,98,49,1361810584884,1361810602804,2231963496,2231981416,17920
1361810605,2231983612,3,144,48,1361810584819,1361810602803,2231963431,2231981415,17984
1361810605,2231983612,2,98,49,1361810584883,1361810602803,2231963495,2231981415,17920
1361810605,2231983628,2,98,49,1361810584929,1361810602785,2231963557,2231981413,17856
1361810605,2231983628,2,98,49,1361810584929,1361810602785,2231963557,2231981413,17856
1361810605,2231983636,2,98,49,1361810585819,1361810602779,2231964455,2231981415,16960
1361810605,2231983684,2,98,49,1361810587946,1361810602730,2231966630,2231981414,14784
1361810605,2231983688,2,98,49,1361810584870,1361810602726,2231963558,2231981414,17856
1361810605,2231983688,2,98,49,1361810584870,1361810602726,2231963558,2231981414,17856
1361810605,2231983688,3,144,48,1361810584742,1361810602726,2231963430,2231981414,17984
1361810605,2231983688,3,150,50,1361810584805,1361810602725,2231963493,2231981413,17920
1361810605,2231983688,3,144,48,1361810584869,1361810602725,2231963557,2231981413,17856
1361810605,2231983692,2,98,49,1361810585761,1361810602721,2231964453,2231981413,16960
1361810605,2231983716,2,98,49,1361810585739,1361810602699,2231964455,2231981415,16960
1361810610,870303024,5,248,49.6,1361810587734,1361810602582,870280758,870295606,14848
1361810611,2231989508,3,470,156.6666667,1361810586778,1361810586906,2231965286,2231965414,128
1361810611,2231989552,14,8632,616.5714286,1361810584812,1361810585132,2231963364,2231963684,320
1361810611,2231989556,7,512,73.14285714,1361810584939,1361810600747,2231963495,2231979303,15808
1361810611,2231989556,9,6524,724.8888889,1361810585131,1361810585515,2231963687,2231964071,384
1361810611,2231989556,8,6234,779.25,1361810585128,1361810585256,2231963684,2231963812,128
1361810611,2231989584,4,550,137.5,1361810585614,1361810586766,2231964198,2231965350,1152
1361810611,2231989584,8,3541,442.625,1361810585869,1361810587021,2231964453,2231965605,1152
1361810611,2231989660,30,29606,986.8666667,1361810584771,1361810605635,2231963431,2231984295,20864
1361810611,2231989664,9,6524,724.8888889,1361810585023,1361810585407,2231963687,2231964071,384
1361810612,870305092,5,602,120.4,1361810587473,1361810589009,870280565,870282101,1536
1361810613,2231991688,4,184,46,1361810587238,1361810612774,2231965926,2231991462,25536
1361810615,2231993532,11,7930,720.9090909,1361810587076,1361810587460,2231965608,2231965992,384
1361810615,2231993624,5,2608,521.6,1361810586856,1361810586984,2231965480,2231965608,128
1361810615,2231993648,3,1164,388,1361810587213,1361810587277,2231965861,2231965925,64
1361810615,2231993652,2,829,414.5,1361810589388,1361810589516,2231968040,2231968168,128
1361810615,2231993652,11,11119,1010.818182,1361810587401,1361810587721,2231966053,2231966373,320
1361810619,2231997624,1,52,52,1361810591398,1361810591398,2231970022,2231970022,0
1361810623,2232001508,8,432,54,1361810597146,1361810621338,2231975654,2231999846,24192
1361810623,2232001552,1,46,46,1361810595949,1361810595949,2231974501,2231974501,0
1361810627,2232005540,2,92,46,1361810598906,1361810602874,2231977446,2231981414,3968
1361810627,2232005744,1,46,46,1361810602671,1361810602671,2231981415,2231981415,0
1361810631,2232009540,1,46,46,1361810602874,1361810602874,2231981414,2231981414,0
1361810631,2232009540,1,46,46,1361810602874,1361810602874,2231981414,2231981414,0
1361810631,2232009588,7,378,54,1361810603787,1361810627979,2231982375,2232006567,24192
1361810631,2232009628,1,52,52,1361810606560,1361810606560,2231985188,2231985188,0
1361810631,2232009668,2,265,132.5,1361810605308,1361810605500,2231983976,2231984168,192
1361810631,2232009700,1,46,46,1361810605721,1361810605721,2231984421,2231984421,0
1361810639,2232017528,15,9735,649,1361810613126,1361810638150,2231991654,2232016678,25024
1361810643,2232021544,2,92,46,1361810615158,1361810622902,2231993702,2232001446,7744
1361810643,2232021544,2,92,46,1361810615157,1361810622901,2231993701,2232001445,7744
1361810643,2232021636,2,92,46,1361810615065,1361810622809,2231993701,2232001445,7744
1361810645,2232023696,4,280,70,1361810636508,1361810642716,2232015204,2232021412,6208
1361810648,870341064,1,52,52,1361810620655,1361810620655,870313719,870313719,0
1361810651,2232029524,1,52,52,1361810622921,1361810622921,2232001445,2232001445,0
1361810651,2232029572,6,324,54,1361810625433,1361810649625,2232004005,2232028197,24192
1361810651,2232029648,1,52,52,1361810623628,1361810623628,2232002276,2232002276,0
1361810653,2232031636,4,188,47,1361810645403,1361810652891,2232024039,2232031527,7488
1361810653,2232031676,3,421,140.3333333,1361810644978,1361810645106,2232023654,2232023782,128
1361810653,2232031684,4,188,47,1361810645483,1361810652843,2232024167,2232031527,7360
1361810655,2232033704,1,52,52,1361810629973,1361810629973,2232008677,2232008677,0
1361810659,2232037572,19,9444,497.0526316,1361810632539,1361810648859,2232011111,2232027431,16320
1361810659,2232037648,8,3311,413.875,1361810631692,1361810645580,2232010340,2232024228,13888
1361810659,2232037652,3,498,166,1361810631881,1361810645321,2232010533,2232023973,13440
1361810659,2232037652,6,946,157.6666667,1361810631881,1361810645897,2232010533,2232024549,14016
1361810659,2232037656,1,46,46,1361810632070,1361810632070,2232010726,2232010726,0
1361810659,2232037660,1,46,46,1361810632449,1361810632449,2232011109,2232011109,0
1361810659,2232037664,3,386,128.6666667,1361810632575,1361810645055,2232011239,2232023719,12480
1361810659,2232037664,3,138,46,1361810632702,1361810657598,2232011366,2232036262,24896
1361810659,2232037688,6,324,54,1361810632869,1361810657893,2232011557,2232036581,25024
1361810659,2232037736,1,46,46,1361810634487,1361810634487,2232013223,2232013223,0
1361810660,870353060,1,52,52,1361810634098,1361810634098,870327158,870327158,0
1361810661,2232039684,15,9100,606.6666667,1361810645351,1361810654567,2232024035,2232033251,9216
1361810661,2232039696,6,427,71.16666667,1361810651677,1361810660573,2232030373,2232039269,8896
1361810663,2232041688,1,46,46,1361810636196,1361810636196,2232014884,2232014884,0
1361810667,2232045512,48,59141,1232.104167,1361810638934,1361810664662,2232017446,2232043174,25728
1361810667,2232045564,1,46,46,1361810641186,1361810641186,2232019750,2232019750,0
1361810669,2232047632,8,2637,329.625,1361810655964,1361810666076,2232034596,2232044708,10112
1361810669,2232047636,3,150,50,1361810645339,1361810663451,2232023975,2232042087,18112
1361810669,2232047636,3,150,50,1361810648089,1361810663513,2232026725,2232042149,15424
1361810671,2232049640,4,930,232.5,1361810645013,1361810645333,2232023653,2232023973,320
1361810671,2232049652,10,2335,233.5,1361810645322,1361810647946,2232023974,2232026598,2624
1361810675,2232053556,3,190,63.33333333,1361810648489,1361810648553,2232027045,2232027109,64
1361810675,2232053720,44,52800,1200,1361810647878,1361810649094,2232026598,2232027814,1216
1361810675,2232053720,11,4862,442,1361810647877,1361810648197,2232026597,2232026917,320
1361810679,2232057600,1,46,46,1361810652861,1361810652861,2232031461,2232031461,0
1361810679,2232057640,1,46,46,1361810653142,1361810653142,2232031782,2232031782,0
1361810679,2232057716,7,378,54,1361810652809,1361810676105,2232031525,2232054821,23296
1361810683,2232061988,34,16696,491.0588235,1361810657977,1361810675001,2232036965,2232053989,17024
1361810687,2232065512,1,46,46,1361810661077,1361810661077,2232039589,2232039589,0
1361810687,2232065676,3,317,105.6666667,1361810660723,1361810661171,2232039399,2232039847,448
1361810691,2232069532,2,92,46,1361810663297,1361810663745,2232041829,2232042277,448
1361810691,2232069532,2,92,46,1361810663297,1361810663745,2232041829,2232042277,448
1361810691,2232069608,8,432,54,1361810662963,1361810690483,2232041571,2232069091,27520
1361810692,870385260,1,52,52,1361810665130,1361810665130,870358390,870358390,0
1361810693,2232071684,4,196,49,1361810674408,1361810692712,2232053092,2232071396,18304
1361810695,2232073536,8,10028,1253.5,1361810667260,1361810684156,2232045796,2232062692,16896
1361810695,2232073620,1,52,52,1361810668970,1361810668970,2232047590,2232047590,0
1361810695,2232073660,1,52,52,1361810667839,1361810667839,2232046499,2232046499,0
1361810699,2232077548,7,3113,444.7142857,1361810674866,1361810674930,2232053414,2232053478,64
1361810701,2232079672,6,420,70,1361810697268,1361810697524,2232075940,2232076196,256
1361810701,2232079712,4,748,187,1361810696012,1361810699084,2232074724,2232077796,3072
1361810701,2232079728,2,92,46,1361810682110,1361810693438,2232060838,2232072166,11328
1361810703,2232081628,3,138,46,1361810678051,1361810702819,2232056679,2232081447,24768
1361810703,2232081688,1,46,46,1361810677157,1361810677157,2232055845,2232055845,0
1361810704,870397288,1,52,52,1361810678863,1361810678863,870372151,870372151,0
1361810707,2232085624,6,324,54,1361810681252,1361810705380,2232059876,2232084004,24128
1361810707,2232085684,1,46,46,1361810679656,1361810679656,2232058340,2232058340,0
1361810709,2232087656,4,188,47,1361810696517,1361810705925,2232075173,2232084581,9408
1361810709,2232087656,14,5909,422.0714286,1361810696516,1361810703812,2232075172,2232082468,7296
1361810709,2232087656,3,142,47.33333333,1361810696516,1361810702916,2232075172,2232081572,6400
1361810709,2232087656,5,242,48.4,1361810700163,1361810706307,2232078819,2232084963,6144
1361810709,2232087688,4,190,47.5,1361810697126,1361810703654,2232075814,2232082342,6528
1361810709,2232087688,32,23202,725.0625,1361810697126,1361810703974,2232075814,2232082662,6848
1361810709,2232087736,2,98,49,1361810693747,1361810707827,2232072483,2232086563,14080
1361810709,2232087736,4,188,47,1361810696438,1361810705846,2232075174,2232084582,9408
1361810709,2232087736,3,144,48,1361810700085,1361810705397,2232078821,2232084133,5312
1361810709,2232087740,2,98,49,1361810697073,1361810707121,2232075813,2232085861,10048
1361810709,2232087740,14,3679,262.7857143,1361810697073,1361810704561,2232075813,2232083301,7488
1361810711,2232089732,1,46,46,1361810686135,1361810686135,2232064867,2232064867,0
1361810715,2232093620,10,1950,195,1361810690088,1361810699048,2232068708,2232077668,8960
1361810715,2232093640,3,514,171.3333333,1361810690134,1361810696086,2232068774,2232074726,5952
1361810715,2232093644,8,4604,575.5,1361810690706,1361810696530,2232069350,2232075174,5824
1361810715,2232093644,4,898,224.5,1361810690513,1361810697361,2232069157,2232076005,6848
1361810715,2232093732,7,1494,213.4285714,1361810690423,1361810698935,2232069155,2232077667,8512
1361810717,2232095652,5,648,129.6,1361810699017,1361810713801,2232077669,2232092453,14784
1361810717,2232095664,3,150,50,1361810696443,1361810712763,2232075107,2232091427,16320
1361810717,2232095664,3,144,48,1361810696443,1361810712763,2232075107,2232091427,16320
1361810717,2232095680,3,144,48,1361810697132,1361810712748,2232075812,2232091428,15616
1361810717,2232095680,4,196,49,1361810697132,1361810713324,2232075812,2232092004,16192
1361810717,2232095680,13,5340,410.7692308,1361810697132,1361810716524,2232075812,2232095204,19392
1361810717,2232095736,12,2207,183.9166667,1361810704630,1361810709814,2232083366,2232088550,5184
1361810717,2232095736,3,144,48,1361810696374,1361810712694,2232075110,2232091430,16320
1361810717,2232095740,2,92,46,1361810712690,1361810715698,2232091430,2232094438,3008
1361810717,2232095740,3,138,46,1361810710129,1361810716145,2232088869,2232094885,6016
1361810717,2232095744,2,98,49,1361810697069,1361810712685,2232075813,2232091429,15616
1361810717,2232095744,2,98,49,1361810697069,1361810712685,2232075813,2232091429,15616
1361810719,2232097568,1,52,52,1361810693084,1361810693084,2232071652,2232071652,0
1361810719,2232097620,7,5007,715.2857143,1361810694248,1361810698024,2232072868,2232076644,3776
1361810719,2232097684,24,29408,1225.333333,1361810693287,1361810697767,2232071971,2232076451,4480
1361810719,2232097728,1,46,46,1361810694140,1361810694140,2232072868,2232072868,0
1361810723,2232101572,32,28623,894.46875,1361810695320,1361810719448,2232073892,2232098020,24128
1361810723,2232101576,6,324,54,1361810695506,1361810719634,2232074082,2232098210,24128
1361810723,2232101608,10,510,51,1361810696628,1361810722804,2232075236,2232101412,26176
1361810723,2232101612,22,23452,1066,1361810696754,1361810699570,2232075366,2232078182,2816
1361810723,2232101700,8,4060,507.5,1361810697114,1361810698010,2232075814,2232076710,896
1361810723,2232101700,24,28839,1201.625,1361810697114,1361810712986,2232075814,2232091686,15872
1361810725,2232103724,4,190,47.5,1361810711810,1361810722882,2232090534,2232101606,11072
1361810731,2232109804,2,373,186.5,1361810704943,1361810705263,2232083747,2232084067,320
1361810731,2232109808,2,1472,736,1361810705130,1361810719466,2232083938,2232098274,14336
1361810731,2232109844,16,2750,171.875,1361810706311,1361810709255,2232085155,2232088099,2944
1361810733,2232111656,2,98,49,1361810712902,1361810732806,2232091558,2232111462,19904
1361810733,2232111732,2,98,49,1361810713913,1361810732793,2232092645,2232111525,18880
1361810735,2232113700,7,378,54,1361810709530,1361810732826,2232088230,2232111526,23296
1361810736,870429260,1,52,52,1361810710250,1361810710250,870403510,870403510,0
1361810739,2232117592,2,92,46,1361810712003,1361810712835,2232090595,2232091427,832
1361810739,2232117624,1,46,46,1361810712806,1361810712806,2232091430,2232091430,0
1361810739,2232117672,12,3514,292.8333333,1361810711606,1361810719606,2232090278,2232098278,8000
1361810739,2232117676,2,92,46,1361810711920,1361810712752,2232090596,2232091428,832
1361810739,2232117704,1,46,46,1361810712725,1361810712725,2232091429,2232091429,0
1361810741,2232119656,2,98,49,1361810733124,1361810733892,2232111780,2232112548,768
1361810741,2232119772,2,92,46,1361810721680,1361810733648,2232100452,2232112420,11968
1361810743,2232121616,4,703,175.75,1361810716461,1361810717485,2232095077,2232096101,1024
1361810747,2232125652,1,46,46,1361810722760,1361810722760,2232101412,2232101412,0
1361810747,2232125736,1,46,46,1361810722293,1361810722293,2232101029,2232101029,0
1361810751,2232129624,1,46,46,1361810724770,1361810724770,2232103394,2232103394,0
1361810751,2232129656,19,27136,1428.210526,1361810723013,1361810743877,2232101669,2232122533,20864
1361810751,2232129660,1,1364,1364,1361810723201,1361810723201,2232101861,2232101861,0
1361810751,2232129688,6,324,54,1361810723683,1361810747043,2232102371,2232125731,23360
1361810752,870445252,1,52,52,1361810723956,1361810723956,870417208,870417208,0
1361810754,870446948,3,144,48,1361810742626,1361810746914,870435574,870439862,4288
1361810755,2232133692,1,46,46,1361810728160,1361810728160,2232106852,2232106852,0
1361810755,2232133700,7,1087,155.2857143,1361810728601,1361810751641,2232107301,2232130341,23040
1361810757,2232135692,17,4598,270.4705882,1361810747871,1361810756703,2232126563,2232135395,8832
1361810759,2232137576,12,5069,422.4166667,1361810731347,1361810757139,2232109923,2232135715,25792
1361810763,2232141636,1,52,52,1361810738007,1361810738007,2232116643,2232116643,0
1361810763,2232141748,6,324,54,1361810737766,1361810760294,2232116514,2232139042,22528
1361810767,2232145616,2,104,52,1361810739948,1361810742700,2232118564,2232121316,2752
1361810767,2232145652,1,52,52,1361810742409,1361810742409,2232121061,2232121061,0
1361810767,2232145660,1,52,52,1361810741121,1361810741121,2232119781,2232119781,0
1361810767,2232145700,1,52,52,1361810741466,1361810741466,2232120166,2232120166,0
1361810771,2232149600,1,52,52,1361810744187,1361810744187,2232122787,2232122787,0
1361810771,2232149600,1,52,52,1361810744058,1361810744058,2232122658,2232122658,0
1361810771,2232149628,1,52,52,1361810744606,1361810744606,2232123234,2232123234,0
1361810771,2232149672,1,52,52,1361810742834,1361810742834,2232121506,2232121506,0
1361810771,2232149676,1,52,52,1361810743024,1361810743024,2232121700,2232121700,0
1361810771,2232149676,1,52,52,1361810743024,1361810743024,2232121700,2232121700,0
1361810773,2232151744,2,92,46,1361810767852,1361810768556,2232146596,2232147300,704
1361810775,2232153604,2,1472,736,1361810747703,1361810764599,2232126307,2232143203,16896
1361810775,2232153620,3,309,103,1361810749607,1361810749607,2232128227,2232128227,0
1361810775,2232153624,1,46,46,1361810747874,1361810747874,2232126498,2232126498,0
1361810778,870470992,2,98,49,1361810769209,1361810776633,870462201,870469625,7424
1361810779,2232157708,7,378,54,1361810752017,1361810778705,2232130725,2232157413,26688
1361810779,2232157724,11,15728,1429.818182,1361810753472,1361810773632,2232132196,2232152356,20160
1361810779,2232157748,1,1364,1364,1361810753511,1361810753511,2232132259,2232132259,0
1361810779,2232157756,2,98,49,1361810754398,1361810776670,2232133154,2232155426,22272
1361810781,2232159680,5,248,49.6,1361810777005,1361810778349,2232155685,2232157029,1344
1361810781,2232159708,6,582,97,1361810762128,1361810776784,2232140836,2232155492,14656
1361810781,2232159716,326,310457,952.3220859,1361810402504,1361810776776,2231781220,2232155492,374272
1361810781,2232159716,3,1518,506,1361810765191,1361810776775,2232143907,2232155491,11584
1361810781,2232159716,2,92,46,1361810767430,1361810776774,2232146146,2232155490,9344
1361810781,2232159748,2,92,46,1361810776681,1361810777193,2232155429,2232155941,512
1361810781,2232159748,2,92,46,1361810776681,1361810776681,2232155429,2232155429,0
1361810781,2232159748,2,98,49,1361810776808,1361810776872,2232155556,2232155620,64
1361810781,2232159748,2,98,49,1361810776808,1361810776936,2232155556,2232155684,128
1361810781,2232159748,3,355,118.3333333,1361810776870,1361810777254,2232155618,2232156002,384
1361810781,2232159756,2,98,49,1361810764703,1361810776799,2232143459,2232155555,12096
1361810781,2232159756,2,92,46,1361810769695,1361810776671,2232148451,2232155427,6976
1361810791,2232169644,6,324,54,1361810764560,1361810787024,2232143204,2232165668,22464
1361810797,2232175744,10,11831,1183.1,1361810783595,1361810793707,2232162339,2232172451,10112
1361810797,2232175768,3,150,50,1361810781714,1361810792146,2232160482,2232170914,10432
1361810799,2232177600,1,46,46,1361810773562,1361810773562,2232152162,2232152162,0
1361810799,2232177640,3,484,161.3333333,1361810772628,1361810773972,2232151268,2232152612,1344
1361810803,2232181684,1,46,46,1361810776745,1361810776745,2232155429,2232155429,0
1361810803,2232181688,1,46,46,1361810776741,1361810776741,2232155429,2232155429,0
1361810803,2232181688,1,46,46,1361810776741,1361810776741,2232155429,2232155429,0
1361810803,2232181688,1,46,46,1361810776741,1361810776741,2232155429,2232155429,0
1361810803,2232181688,1,46,46,1361810776741,1361810776741,2232155429,2232155429,0
1361810803,2232181772,1,46,46,1361810776656,1361810776656,2232155428,2232155428,0
1361810803,2232181772,1,46,46,1361810776656,1361810776656,2232155428,2232155428,0
1361810803,2232181772,1,46,46,1361810776656,1361810776656,2232155428,2232155428,0
1361810803,2232181772,1,46,46,1361810776656,1361810776656,2232155428,2232155428,0
1361810807,2232185764,1,77,77,1361810781719,1361810781719,2232160483,2232160483,0
1361810807,2232185768,5,542,108.4,1361810781780,1361810798164,2232160548,2232176932,16384
1361810807,2232185772,70,83199,1188.557143,1361810781969,1361810806801,2232160741,2232185573,24832
1361810811,2232189640,1,1364,1364,1361810783698,1361810783698,2232162338,2232162338,0
1361810811,2232189716,7,378,54,1361810782853,1361810808645,2232161569,2232187361,25792
1361810813,2232191716,4,1901,475.25,1361810810054,1361810810246,2232188770,2232188962,192
1361810813,2232191724,6,736,122.6666667,1361810807168,1361810808768,2232185892,2232187492,1600
1361810813,2232191724,5,608,121.6,1361810807294,1361810808702,2232186018,2232187426,1408
1361810813,2232191748,5,536,107.2,1361810808294,1361810808678,2232187042,2232187426,384
1361810815,2232193688,1,46,46,1361810787429,1361810787429,2232166117,2232166117,0
1361810815,2232193804,2,104,52,1361810788014,1361810790702,2232166818,2232169506,2688
1361810815,2232193828,29,28915,997.0689655,1361810788312,1361810798360,2232167140,2232177188,10048
1361810819,2232197752,7,378,54,1361810791075,1361810816931,2232169827,2232195683,25856
1361810821,2232199672,2,94,47,1361810807283,1361810818355,2232185955,2232197027,11072
1361810821,2232199672,2,98,49,1361810807219,1361810818355,2232185891,2232197027,11136
1361810821,2232199672,2,98,49,1361810807347,1361810818355,2232186019,2232197027,11008
1361810821,2232199672,3,144,48,1361810807347,1361810818355,2232186019,2232197027,11008
1361810821,2232199672,3,144,48,1361810807219,1361810818355,2232185891,2232197027,11136
1361810821,2232199672,5,248,49.6,1361810807219,1361810818355,2232185891,2232197027,11136
1361810821,2232199672,7,3156,450.8571429,1361810807282,1361810818354,2232185954,2232197026,11072
1361810821,2232199672,6,2467,411.1666667,1361810807282,1361810818354,2232185954,2232197026,11072
1361810821,2232199672,3,140,46.66666667,1361810807282,1361810818354,2232185954,2232197026,11072
1361810821,2232199672,2,98,49,1361810807345,1361810818353,2232186017,2232197025,11008
1361810821,2232199672,2,98,49,1361810807345,1361810818353,2232186017,2232197025,11008
1361810821,2232199676,6,786,131,1361810807408,1361810814384,2232186084,2232193060,6976
1361810821,2232199680,3,350,116.6666667,1361810808170,1361810818346,2232186850,2232197026,10176
1361810821,2232199708,5,455,91,1361810814094,1361810814286,2232192802,2232192994,192
1361810821,2232199712,2,304,152,1361810809228,1361810819276,2232187940,2232197988,10048
1361810821,2232199712,5,683,136.6,1361810814347,1361810814731,2232193059,2232193443,384
1361810821,2232199724,4,202,50.5,1361810807166,1361810818302,2232185890,2232197026,11136
1361810821,2232199724,2,94,47,1361810807230,1361810818302,2232185954,2232197026,11072
1361810821,2232199724,3,144,48,1361810807166,1361810818302,2232185890,2232197026,11136
1361810821,2232199724,3,144,48,1361810807166,1361810818302,2232185890,2232197026,11136
1361810821,2232199724,2,94,47,1361810807230,1361810818302,2232185954,2232197026,11072
1361810821,2232199724,2,98,49,1361810807230,1361810818302,2232185954,2232197026,11072
1361810821,2232199724,2,98,49,1361810807230,1361810818302,2232185954,2232197026,11072
1361810821,2232199728,2,98,49,1361810807289,1361810818297,2232186017,2232197025,11008
1361810821,2232199728,3,144,48,1361810807289,1361810818297,2232186017,2232197025,11008
1361810821,2232199752,6,3094,515.6666667,1361810811493,1361810813797,2232190245,2232192549,2304
1361810821,2232199756,3,350,116.6666667,1361810808096,1361810818272,2232186852,2232197028,10176
1361810821,2232199756,3,350,116.6666667,1361810808096,1361810818272,2232186852,2232197028,10176
1361810821,2232199760,4,196,49,1361810797978,1361810818266,2232176738,2232197026,20288
1361810821,2232199764,2,304,152,1361810809174,1361810819222,2232187938,2232197986,10048
1361810821,2232199768,2,304,152,1361810809172,1361810819220,2232187940,2232197988,10048
1361810826,870518972,2,98,49,1361810807116,1361810818188,870500088,870511160,11072
1361810826,870518972,3,144,48,1361810807115,1361810818187,870500087,870511159,11072
1361810826,870518992,2,98,49,1361810807097,1361810818169,870500089,870511161,11072
1361810826,870518996,2,98,49,1361810807093,1361810818165,870500089,870511161,11072
1361810829,2232207668,15,6098,406.5333333,1361810807221,1361810828341,2232185889,2232207009,21120
1361810829,2232207672,4,188,47,1361810811571,1361810828339,2232190243,2232207011,16768
1361810829,2232207700,2,92,46,1361810808853,1361810828309,2232187553,2232207009,19456
1361810829,2232207700,2,98,49,1361810808853,1361810828245,2232187553,2232206945,19392
1361810829,2232207700,3,138,46,1361810808853,1361810828309,2232187553,2232207009,19456
1361810829,2232207700,2,92,46,1361810808853,1361810828309,2232187553,2232207009,19456
1361810829,2232207704,4,196,49,1361810809237,1361810828629,2232187941,2232207333,19392
1361810829,2232207712,3,138,46,1361810823180,1361810828300,2232201892,2232207012,5120
1361810829,2232207712,12,5412,451,1361810807179,1361810828299,2232185891,2232207011,21120
1361810829,2232207712,4,196,49,1361810807369,1361810828297,2232186081,2232207009,20928
1361810829,2232207732,3,150,50,1361810813493,1361810828277,2232192225,2232207009,14784
1361810829,2232207740,3,355,118.3333333,1361810808240,1361810828272,2232186980,2232207012,20032
1361810829,2232207740,3,355,118.3333333,1361810808240,1361810828272,2232186980,2232207012,20032
1361810829,2232207744,2,92,46,1361810808811,1361810828267,2232187555,2232207011,19456
1361810829,2232207744,3,138,46,1361810808810,1361810828266,2232187554,2232207010,19456
1361810829,2232207744,2,92,46,1361810808810,1361810828266,2232187554,2232207010,19456
1361810829,2232207748,2,98,49,1361810809192,1361810828264,2232187940,2232207012,19072
1361810829,2232207748,3,150,50,1361810809192,1361810828584,2232187940,2232207332,19392
1361810831,2232209708,21,11710,557.6190476,1361810805327,1361810807439,2232184035,2232186147,2112
1361810831,2232209708,6,2498,416.3333333,1361810805261,1361810805389,2232183969,2232184097,128
1361810834,870526960,2,98,49,1361810809752,1361810828184,870502712,870521144,18432
1361810834,870526964,3,150,50,1361810813457,1361810828177,870506421,870521141,14720
1361810834,870526968,2,98,49,1361810809743,1361810828175,870502711,870521143,18432
1361810834,870526968,2,98,49,1361810809743,1361810828175,870502711,870521143,18432
1361810835,2232213688,25,20966,838.64,1361810806945,1361810812449,2232185633,2232191137,5504
1361810835,2232213696,30,38345,1278.166667,1361810807260,1361810815260,2232185956,2232193956,8000
1361810835,2232213696,1,46,46,1361810807323,1361810807323,2232186019,2232186019,0
1361810835,2232213700,1,1426,1426,1361810807576,1361810807576,2232186276,2232186276,0
1361810835,2232213708,3,881,293.6666667,1361810808272,1361810808784,2232186980,2232187492,512
1361810835,2232213768,4,1855,463.75,1361810808788,1361810808916,2232187556,2232187684,128
1361810835,2232213776,11,5487,498.8181818,1361810809802,1361810813450,2232188578,2232192226,3648
1361810835,2232213812,4,796,199,1361810807080,1361810808360,2232185892,2232187172,1280
1361810835,2232213812,22,21719,987.2272727,1361810807144,1361810814312,2232185956,2232193124,7168
1361810835,2232213812,1,46,46,1361810807207,1361810807207,2232186019,2232186019,0
1361810835,2232213848,19,15249,802.5789474,1361810808706,1361810817794,2232187554,2232196642,9088
1361810839,2232217688,11,9755,886.8181818,1361810813538,1361810815010,2232192226,2232193698,1472
1361810839,2232217720,6,5051,841.8333333,1361810813828,1361810813892,2232192548,2232192612,64
1361810839,2232217764,7,2700,385.7142857,1361810813463,1361810814935,2232192227,2232193699,1472
1361810839,2232217764,11,9601,872.8181818,1361810813463,1361810813783,2232192227,2232192547,320
1361810839,2232217796,6,324,54,1361810813624,1361810838584,2232192420,2232217380,24960
1361810839,2232217800,38,51289,1349.710526,1361810813747,1361810815411,2232192547,2232194211,1664
1361810840,870533400,5,2183,436.6,1361810812321,1361810812833,870505721,870506233,512
1361810840,870533404,10,11335,1133.5,1361810813211,1361810813275,870506615,870506679,64
1361810847,2232225672,6,324,54,1361810821170,1361810843698,2232199842,2232222370,22528
1361810853,2232231728,2,92,46,1361810850745,1361810851513,2232229473,2232230241,768
1361810855,2232233700,2,265,132.5,1361810829462,1361810829590,2232208162,2232208290,128
1361810855,2232233736,1,46,46,1361810828275,1361810828275,2232207011,2232207011,0
1361810855,2232233816,1,46,46,1361810828194,1361810828194,2232207010,2232207010,0
1361810855,2232233816,1,46,46,1361810828194,1361810828194,2232207010,2232207010,0
1361810859,2232237704,1,46,46,1361810831314,1361810831314,2232210018,2232210018,0
1361810859,2232237788,1,46,46,1361810831230,1361810831230,2232210018,2232210018,0
1361810861,2232239684,2,92,46,1361810859048,1361810859048,2232237732,2232237732,0
1361810861,2232239684,2,92,46,1361810853093,1361810856101,2232231777,2232234785,3008
1361810866,870558968,2,92,46,1361810865489,1361810865745,870558457,870558713,256
1361810867,2232245772,7,378,54,1361810842766,1361810865294,2232221538,2232244066,22528
1361810867,2232245800,1,46,46,1361810839155,1361810839155,2232217955,2232217955,0
1361810869,2232247712,2,98,49,1361810858955,1361810861515,2232237667,2232240227,2560
1361810869,2232247716,2,98,49,1361810859461,1361810861509,2232238177,2232240225,2048
1361810869,2232247716,9,2406,267.3333333,1361810843525,1361810867717,2232222241,2232246433,24192
1361810869,2232247724,2,98,49,1361810860157,1361810861501,2232238881,2232240225,1344
1361810869,2232247760,3,175,58.33333333,1361810858842,1361810861466,2232237602,2232240226,2624
1361810869,2232247788,2,92,46,1361810861501,1361810862013,2232240289,2232240801,512
1361810869,2232247792,2,98,49,1361810860092,1361810863548,2232238884,2232242340,3456
1361810869,2232247796,2,98,49,1361810860472,1361810861432,2232239268,2232240228,960
1361810875,2232253820,16,864,54,1361810847712,1361810874528,2232226532,2232253348,26816
1361810887,2232265740,1,77,77,1361810859372,1361810859372,2232238112,2232238112,0
1361810887,2232265748,1,46,46,1361810861476,1361810861476,2232240224,2232240224,0
1361810887,2232265816,1,46,46,1361810862754,1361810862754,2232241570,2232241570,0
1361810887,2232265852,1,46,46,1361810861374,1361810861374,2232240226,2232240226,0
1361810887,2232265852,1,46,46,1361810861374,1361810861374,2232240226,2232240226,0
1361810888,870581592,1,46,46,1361810860833,1361810860833,870554425,870554425,0
1361810891,2232269772,1,46,46,1361810863629,1361810863629,2232242401,2232242401,0
1361810891,2232269848,9,1047,116.3333333,1361810866755,1361810867203,2232245603,2232246051,448
1361810891,2232269936,4,208,52,1361810866667,1361810887659,2232245603,2232266595,20992
1361810893,2232271832,26,27442,1055.461538,1361810888400,1361810892496,2232267232,2232271328,4096
1361810895,2232273800,49,2646,54,1361810866930,1361810894578,2232245730,2232273378,27648
1361810895,2232273804,24,23263,969.2916667,1361810867054,1361810883310,2232245858,2232262114,16256
1361810895,2232273844,1,46,46,1361810869830,1361810869830,2232248674,2232248674,0
1361810903,2232281728,56,3024,54,1361810875130,1361810902650,2232253858,2232281378,27520
1361810907,2232285744,7,812,116,1361810880427,1361810882283,2232259171,2232261027,1856
1361810907,2232285780,7,812,116,1361810882245,1361810882437,2232261025,2232261217,192
1361810907,2232285784,2,232,116,1361810882435,1361810882627,2232261219,2232261411,192
1361810907,2232285808,9,1044,116,1361810882539,1361810883883,2232261347,2232262691,1344
1361810907,2232285860,7,812,116,1361810882166,1361810882358,2232261026,2232261218,192
1361810907,2232285860,9,1044,116,1361810882356,1361810883828,2232261216,2232262688,1472
1361810907,2232285884,7,812,116,1361810882141,1361810882333,2232261025,2232261217,192
1361810907,2232285888,1,116,116,1361810882585,1361810882585,2232261473,2232261473,0
1361810909,2232287840,10,8336,833.6,1361810897674,1361810908234,2232276514,2232287074,10560
1361810911,2232289756,3,348,116,1361810885532,1361810886684,2232264288,2232265440,1152
1361810911,2232289760,1,116,116,1361810883865,1361810883865,2232262625,2232262625,0
1361810911,2232289788,2,232,116,1361810884029,1361810884221,2232262817,2232263009,192
1361810911,2232289836,2,232,116,1361810885263,1361810885391,2232264099,2232264227,128
1361810911,2232289836,5,1630,326,1361810883278,1361810883406,2232262114,2232262242,128
1361810911,2232289868,8,928,116,1361810883759,1361810885103,2232262627,2232263971,1344
1361810911,2232289868,8,928,116,1361810883758,1361810885166,2232262626,2232264034,1408
1361810911,2232289880,4,536,134,1361810884448,1361810885088,2232263328,2232263968,640
1361810917,2232295744,10,8253,825.3,1361810915049,1361810916137,2232293793,2232294881,1088
1361810917,2232295748,14,8059,575.6428571,1361810915238,1361810916390,2232293986,2232295138,1152
1361810917,2232295760,2,92,46,1361810902104,1361810913112,2232280864,2232291872,11008
1361810917,2232295764,3,421,140.3333333,1361810913175,1361810913943,2232291939,2232292707,768
1361810917,2232295836,6,996,166,1361810913742,1361810915790,2232292578,2232294626,2048
1361810919,2232297752,1,54,54,1361810893537,1361810893537,2232272289,2232272289,0
1361810919,2232297832,8,432,54,1361810893458,1361810914322,2232272290,2232293154,20864
1361810923,2232301792,6,2498,416.3333333,1361810897723,1361810897851,2232276515,2232276643,128
1361810923,2232301796,9,486,54,1361810898485,1361810920117,2232277281,2232298913,21632
1361810923,2232301824,56,3024,54,1361810895066,1361810922586,2232273890,2232301410,27520
1361810925,2232303784,3,142,47.33333333,1361810918082,1361810924802,2232296866,2232303586,6720
1361810925,2232303784,3,140,46.66666667,1361810913088,1361810923392,2232291872,2232302176,10304
1361810925,2232303788,3,150,50,1361810913086,1361810923646,2232291874,2232302434,10560
1361810925,2232303788,3,144,48,1361810913150,1361810923454,2232291938,2232302242,10304
1361810925,2232303788,3,144,48,1361810913150,1361810923454,2232291938,2232302242,10304
1361810925,2232303788,2,98,49,1361810913150,1361810923390,2232291938,2232302178,10240
1361810925,2232303788,3,140,46.66666667,1361810913150,1361810923390,2232291938,2232302178,10240
1361810925,2232303788,2,98,49,1361810913213,1361810923389,2232292001,2232302177,10176
1361810925,2232303808,2,98,49,1361810913193,1361810923369,2232292001,2232302177,10176
1361810925,2232303820,14,6150,439.2857143,1361810914975,1361810923423,2232293795,2232302243,8448
1361810925,2232303856,3,140,46.66666667,1361810913016,1361810923320,2232291872,2232302176,10304
1361810925,2232303856,4,202,50.5,1361810913016,1361810924216,2232291872,2232303072,11200
1361810925,2232303856,3,140,46.66666667,1361810913016,1361810923320,2232291872,2232302176,10304
1361810925,2232303856,3,144,48,1361810913080,1361810923384,2232291936,2232302240,10304
1361810925,2232303856,3,144,48,1361810913080,1361810923384,2232291936,2232302240,10304
1361810925,2232303860,3,140,46.66666667,1361810913076,1361810923316,2232291936,2232302176,10240
1361810925,2232303860,2,98,49,1361810913076,1361810923316,2232291936,2232302176,10240
1361810925,2232303860,2,98,49,1361810913075,1361810923315,2232291935,2232302175,10240
1361810925,2232303860,3,140,46.66666667,1361810913075,1361810923315,2232291935,2232302175,10240
1361810925,2232303860,2,98,49,1361810913075,1361810923315,2232291935,2232302175,10240
1361810925,2232303860,2,98,49,1361810913139,1361810923315,2232291999,2232302175,10176
1361810925,2232303860,2,98,49,1361810913139,1361810923315,2232291999,2232302175,10176
1361810925,2232303860,2,98,49,1361810913143,1361810923319,2232292003,2232302179,10176
1361810931,2232309764,56,3024,54,1361810903123,1361810930643,2232281887,2232309407,27520
1361810933,2232311804,2,98,49,1361810918124,1361810930988,2232296928,2232309792,12864
1361810933,2232311832,7,466,66.57142857,1361810921235,1361810927379,2232300067,2232306211,6144
1361810933,2232311876,2,98,49,1361810918054,1361810930534,2232296930,2232309410,12480
1361810933,2232311876,2,98,49,1361810918052,1361810931812,2232296928,2232310688,13760
1361810935,2232313892,1,1364,1364,1361810907671,1361810907671,2232286563,2232286563,0
1361810939,2232317804,4,196,49,1361810913134,1361810933358,2232291938,2232312162,20224
1361810939,2232317804,5,254,50.8,1361810913068,1361810933356,2232291872,2232312160,20288
1361810939,2232317804,4,202,50.5,1361810913195,1361810933355,2232291999,2232312159,20160
1361810939,2232317804,3,150,50,1361810913195,1361810933355,2232291999,2232312159,20160
1361810939,2232317812,2,98,49,1361810913956,1361810933348,2232292768,2232312160,19392
1361810939,2232317812,3,386,128.6666667,1361810913956,1361810914020,2232292768,2232292832,64
1361810939,2232317812,14,6157,439.7857143,1361810914020,1361810917988,2232292832,2232296800,3968
1361810939,2232317816,2,98,49,1361810913952,1361810933344,2232292768,2232312160,19392
1361810939,2232317816,2,98,49,1361810913952,1361810933344,2232292768,2232312160,19392
1361810939,2232317880,43,54784,1274.046512,1361810913056,1361810936288,2232291936,2232315168,23232
1361810939,2232317884,4,202,50.5,1361810913119,1361810933279,2232292003,2232312163,20160
1361810939,2232317888,2,98,49,1361810913880,1361810933272,2232292768,2232312160,19392
1361810939,2232317888,2,98,49,1361810913880,1361810933272,2232292768,2232312160,19392
1361810939,2232317888,2,98,49,1361810913880,1361810933272,2232292768,2232312160,19392
1361810939,2232317888,2,98,49,1361810913880,1361810933272,2232292768,2232312160,19392
1361810939,2232317888,2,98,49,1361810913880,1361810933272,2232292768,2232312160,19392
1361810941,2232319780,2,98,49,1361810915012,1361810933380,2232293792,2232312160,18368
1361810941,2232319780,2,98,49,1361810915012,1361810933380,2232293792,2232312160,18368
1361810941,2232319796,2,98,49,1361810915955,1361810933363,2232294751,2232312159,17408
1361810941,2232319796,2,98,49,1361810915955,1361810933363,2232294751,2232312159,17408
1361810941,2232319796,4,467,116.75,1361810940277,1361810940661,2232319073,2232319457,384
1361810941,2232319796,2,98,49,1361810918068,1361810933364,2232296864,2232312160,15296
1361810941,2232319800,3,138,46,1361810918131,1361810933683,2232296931,2232312483,15552
1361810941,2232319828,2,98,49,1361810914965,1361810933333,2232293793,2232312161,18368
1361810941,2232319828,2,98,49,1361810914964,1361810933332,2232293792,2232312160,18368
1361810941,2232319828,3,150,50,1361810915027,1361810933331,2232293855,2232312159,18304
1361810941,2232319832,3,144,48,1361810919187,1361810933331,2232298019,2232312163,14144
1361810941,2232319856,2,98,49,1361810915897,1361810933305,2232294753,2232312161,17408
1361810941,2232319860,2,98,49,1361810918005,1361810933301,2232296865,2232312161,15296
1361810941,2232319860,2,98,49,1361810918005,1361810933301,2232296865,2232312161,15296
1361810941,2232319860,5,254,50.8,1361810918005,1361810937013,2232296865,2232315873,19008
1361810941,2232319868,3,138,46,1361810918383,1361810933615,2232297251,2232312483,15232
1361810943,2232321740,7,1817,259.5714286,1361810914927,1361810918127,2232293667,2232296867,3200
1361810943,2232321788,3,498,166,1361810918013,1361810918077,2232296801,2232296865,64
1361810943,2232321796,3,138,46,1361810918452,1361810918516,2232297248,2232297312,64
1361810943,2232321864,30,36084,1202.8,1361810918131,1361810919923,2232296995,2232298787,1792
1361810947,2232325764,7,378,54,1361810919380,1361810944404,2232298144,2232323168,25024
1361810949,2232327832,2,92,46,1361810943312,1361810946320,2232322144,2232325152,3008
1361810951,2232329788,6,324,54,1361810925117,1361810950141,2232303905,2232328929,25024
1361810951,2232329836,1,46,46,1361810926411,1361810926411,2232305247,2232305247,0
1361810951,2232329864,56,3024,54,1361810922992,1361810950512,2232301856,2232329376,27520
1361810951,2232329916,1,46,46,1361810926332,1361810926332,2232305248,2232305248,0
1361810955,2232333792,1,46,46,1361810928248,1361810928248,2232307040,2232307040,0
1361810955,2232333796,3,138,46,1361810928375,1361810949623,2232307171,2232328419,21248
1361810955,2232333796,3,138,46,1361810928565,1361810949621,2232307361,2232328417,21056
1361810957,2232335784,3,291,97,1361810943425,1361810949633,2232322209,2232328417,6208
1361810957,2232335792,2,334,167,1361810940025,1361810949625,2232318817,2232328417,9600
1361810957,2232335792,2,98,49,1361810949817,1361810949817,2232328609,2232328609,0
1361810957,2232335796,113,142234,1258.707965,1361810896758,1361810949622,2232275554,2232328418,52864
1361810957,2232335832,5,282,56.4,1361810941009,1361810949585,2232319841,2232328417,8576
1361810957,2232335864,4,196,49,1361810949682,1361810952882,2232328546,2232331746,3200
1361810957,2232335864,5,976,195.2,1361810939952,1361810949552,2232318816,2232328416,9600
1361810957,2232335864,5,236,47.2,1361810939952,1361810949552,2232318816,2232328416,9600
1361810957,2232335868,3,355,118.3333333,1361810949807,1361810949871,2232328675,2232328739,64
1361810957,2232335868,3,144,48,1361810949933,1361810949997,2232328801,2232328865,64
1361810959,2232337908,56,3024,54,1361810931011,1361810958531,2232309919,2232337439,27520
1361810959,2232337912,1,46,46,1361810933250,1361810933250,2232312162,2232312162,0
1361810959,2232337912,1,46,46,1361810933249,1361810933249,2232312161,2232312161,0
1361810967,2232345892,1,46,46,1361810941333,1361810941333,2232320225,2232320225,0
1361810967,2232345924,3,484,161.3333333,1361810940213,1361810940917,2232319137,2232319841,704
1361810975,2232353788,1,46,46,1361810949630,1361810949630,2232328418,2232328418,0
1361810975,2232353788,1,46,46,1361810949627,1361810949627,2232328415,2232328415,0
1361810975,2232353868,6,324,54,1361810947694,1361810970222,2232326562,2232349090,22528
1361810975,2232353868,1,46,46,1361810949550,1361810949550,2232328418,2232328418,0
1361810975,2232353868,1,46,46,1361810949548,1361810949548,2232328416,2232328416,0
1361810979,2232357844,7,378,54,1361810954244,1361810976772,2232333088,2232355616,22528
1361810979,2232357848,1,77,77,1361810954626,1361810954626,2232333474,2232333474,0
1361810979,2232357864,24,1296,54,1361810951023,1361810962543,2232329887,2232341407,11520
1361810983,2232361844,8,1139,142.375,1361810956613,1361810976325,2232335457,2232355169,19712
1361810983,2232361920,7,825,117.8571429,1361810956536,1361810956664,2232335456,2232335584,128
1361810983,2232361920,30,25666,855.5333333,1361810956599,1361810965879,2232335519,2232344799,9280
1361810987,2232365824,8,432,54,1361810959130,1361810962650,2232337954,2232341474,3520
1361811003,2232381912,7,378,54,1361810975169,1361811002753,2232354081,2232381665,27584
1361811005,2232383816,4,490,122.5,1361810985250,1361810997666,2232364066,2232376482,12416
1361811005,2232383876,2,92,46,1361810997605,1361810997605,2232376481,2232376481,0
1361811007,2232385848,7,378,54,1361810980926,1361811003390,2232359774,2232382238,22464
1361811023,2232401948,3,311,103.6666667,1361810996573,1361811011037,2232375521,2232389985,14464
1361811023,2232402024,1,46,46,1361810997393,1361810997393,2232376417,2232376417,0
1361811031,2232410288,6,324,54,1361811005705,1361811027401,2232384993,2232406689,21696
1361811035,2232414152,6,324,54,1361811007248,1361811031440,2232386400,2232410592,24192
1361811051,2232430180,1,46,46,1361811023860,1361811023860,2232403040,2232403040,0
1361811051,2232430288,2,98,49,1361811024712,1361811024776,2232404000,2232404064,64
1361811053,2232431888,2,523,261.5,1361811052185,1361811052185,2232431073,2232431073,0
1361811059,2232438376,7,378,54,1361811032304,1361811057392,2232411680,2232436768,25088
1361811063,2232442284,7,378,54,1361811035466,1361811058826,2232414750,2232438110,23360
1361811079,2232458192,5,250,50,1361811050918,1361811073062,2232430110,2232452254,22144
1361811088,2232466480,10,540,54,1361811063343,1361811086703,2232441823,2232465183,23360
1361811091,2232470368,12,648,54,1361811063734,1361811089590,2232443102,2232468958,25856
1361811093,2232471844,3,144,48,1361811089857,1361811089921,2232468701,2232468765,64
1361811093,2232471848,4,196,49,1361811086720,1361811089856,2232465568,2232468704,3136
1361811093,2232471900,6,294,49,1361811086665,1361811088585,2232465565,2232467485,1920
1361811093,2232471900,4,407,101.75,1361811086733,1361811089805,2232465633,2232468705,3072
1361811099,2232478368,4,703,175.75,1361811074807,1361811083895,2232454175,2232463263,9088
1361811109,2232487872,4,401,100.25,1361811107237,1361811107621,2232486109,2232486493,384
1361811109,2232487924,3,150,50,1361811107124,1361811107636,2232486048,2232486560,512
1361811109,2232487924,2,98,49,1361811107123,1361811107123,2232486047,2232486047,0
1361811109,2232487948,5,248,49.6,1361811107226,1361811108442,2232486174,2232487390,1216
1361811115,2232494408,9,486,54,1361811087438,1361811112526,2232466846,2232491934,25088
1361811119,2232498356,2,123,61.5,1361811091138,1361811091394,2232470494,2232470750,256
1361811119,2232498448,8,432,54,1361811091176,1361811116968,2232470624,2232496416,25792
1361811123,2232502440,1,48,48,1361811097136,1361811097136,2232476576,2232476576,0
1361811136,2232514484,1,46,46,1361811110697,1361811110697,2232489181,2232489181,0
1361811136,2232514488,1,257,257,1361811111012,1361811111012,2232489500,2232489500,0
1361811143,2232522376,2,514,257,1361811116078,1361811128110,2232495454,2232507486,12032
1361811143,2232522456,17,918,54,1361811117470,1361811142750,2232496926,2232522206,25280
1361811147,2232526428,29,1566,54,1361811122044,1361811146876,2232501472,2232526304,24832
1361811152,2232530496,1,48,48,1361811127198,1361811127198,2232505694,2232505694,0
1361811167,2232546380,2,438,219,1361811139371,1361811151339,2232518751,2232530719,11968
1361811171,2232550416,54,2916,54,1361811143300,1361811170628,2232522716,2232550044,27328
1361811176,2232554480,55,2970,54,1361811148268,1361811175340,2232526748,2232553820,27072
1361811180,2232558528,1,257,257,1361811152958,1361811152958,2232531486,2232531486,0
1361811196,2232574720,47,2538,54,1361811171836,1361811195516,2232550556,2232574236,23680
1361811200,2232578708,49,2646,54,1361811175625,1361811199753,2232554333,2232578461,24128
1361811204,2232582608,1,219,219,1361811176173,1361811176173,2232554781,2232554781,0
1361811224,2232602744,55,2970,54,1361811196003,1361811223779,2232574747,2232602523,27776
1361811228,2232606792,56,3024,54,1361811200181,1361811227701,2232578973,2232606493,27520
1361811228,2232606800,1,257,257,1361811200687,1361811200687,2232579487,2232579487,0
1361811229,2232607868,2,265,132.5,1361811224042,1361811224874,2232602910,2232603742,832
1361811252,2232630956,15,810,54,1361811224082,1361811231314,2232603038,2232610270,7232
1361811485,2232863980,5,354,70.8,1361811479414,1361811484534,2232858394,2232863514,5120
1361811509,2232888080,2,154,77,1361811490255,1361811501903,2232869335,2232880983,11648
1361811553,2232931704,1,77,77,1361811525640,1361811525640,2232904344,2232904344,0
1361811597,2232975640,1,77,77,1361811572360,1361811572360,2232951000,2232951000,0
1361811693,2233071992,1,77,77,1361811665317,1361811665317,2233044309,2233044309,0
1361811966,2233344888,5,574,114.8,1361811958601,1361811958857,2233337489,2233337745,256
1361811985,2233364312,16,7585,474.0625,1361811964833,1361811976865,2233344145,2233356177,12032
1361812446,2233825308,16,6372,398.25,1361812428575,1361812440671,2233807883,2233819979,12096
1361812446,2233825316,12,999,83.25,1361812429013,1361812440661,2233808329,2233819977,11648
1361812446,2233825320,12,999,83.25,1361812429265,1361812440657,2233808585,2233819977,11392
1361812446,2233825420,11,953,86.63636364,1361812429486,1361812440558,2233808906,2233819978,11072
1361812671,2234050168,1,48,48,1361812645670,1361812645670,2234024838,2234024838,0
1361812976,2234355160,1,46,46,1361812949418,1361812949418,2234328578,2234328578,0
1361814015,2235394188,16,6372,398.25,1361814002238,1361814014462,2235381426,2235393650,12224
1361814015,2235394192,12,999,83.25,1361814002746,1361814014458,2235381938,2235393650,11712
1361814015,2235394196,11,953,86.63636364,1361814003064,1361814014392,2235382260,2235393588,11328
1361814015,2235394276,12,999,83.25,1361814003239,1361814014311,2235382515,2235393587,11072
1361814215,2235593504,1,46,46,1361814188520,1361814188520,2235567024,2235567024,0
1361814387,2235765724,1,447,447,1361814361225,1361814361225,2235739949,2235739949,0
1361814536,2235914744,16,6372,398.25,1361814516722,1361814528818,2235895466,2235907562,12096
1361814536,2235914776,12,999,83.25,1361814517330,1361814528722,2235896106,2235907498,11392
1361814536,2235914832,12,999,83.25,1361814517020,1361814528732,2235895852,2235907564,11712
1361814536,2235914856,12,999,83.25,1361814517506,1361814528642,2235896362,2235907498,11136
1361814961,2236339620,12,999,83.25,1361814946408,1361814956648,2236325028,2236335268,10240
1361814961,2236339684,18,6801,377.8333333,1361814945703,1361814956583,2236324387,2236335267,10880
1361814961,2236339688,11,953,86.63636364,1361814946084,1361814956580,2236324772,2236335268,10496
1361815053,2236431712,9,861,95.66666667,1361815025930,1361815026186,2236404642,2236404898,256
1361815053,2236431744,8,815,101.875,1361815026346,1361815026730,2236405090,2236405474,384
1361815053,2236431836,6,723,120.5,1361815026703,1361815027343,2236405539,2236406179,640
1361815053,2236431868,9,861,95.66666667,1361815027569,1361815028017,2236406437,2236406885,448
1361815337,2236715804,7,2448,349.7142857,1361815335274,1361815335338,2236714078,2236714142,64
1361815346,2236724620,1,63,63,1361815320995,1361815320995,2236699615,2236699615,0
1361815390,2236768552,1,63,63,1361815363109,1361815363109,2236741661,2236741661,0
1361815390,2236768740,1,63,63,1361815362922,1361815362922,2236741662,2236741662,0
1361815434,2236812648,1,63,63,1361815408196,1361815408196,2236786844,2236786844,0
1361815730,2237109048,1,46,46,1361815704495,1361815704495,2237083543,2237083543,0
1361815826,2237205360,1,60,60,1361815800438,1361815800438,2237179798,2237179798,0
1361815916,875608684,267743,401174561,1498.356861,1361815335310,1361815611982,875027994,875304666,276672
1361815929,2237308400,13,3408,262.1538462,1361815918733,1361815922701,2237298133,2237302101,3968
1361815950,2237329432,11,3267,297,1361815922094,1361815922734,2237301526,2237302166,640
1361816034,2237413296,26005,38998592,1499.65745,1361815926709,1361816032629,2237306005,2237411925,105920
1361816035,2237414292,118009,176983273,1499.743859,1361815610871,1361815923447,2236990163,2237302739,312576
1361816125,2237504340,21377,32063084,1499.886981,1361816032647,1361816124295,2237411987,2237503635,91648
1361816242,2237621088,2,141,70.5,1361816238272,1361816238272,2237617360,2237617360,0
1361816444,876136736,187596,281130352,1498.594597,1361816234524,1361816437276,875927260,876130012,202752
1361816538,2237917332,23101,34650661,1499.963681,1361816124296,1361816236104,2237503628,2237615436,111808
1361816681,2238059988,11,3267,297,1361816655647,1361816656543,2238034635,2238035531,896
1361816843,2238221720,2,141,70.5,1361816836009,1361816836009,2238214729,2238214729,0
1361816851,2238229644,11,953,86.63636364,1361816833971,1361816844083,2238212615,2238222727,10112
1361816851,2238229688,15,6289,419.2666667,1361816832326,1361816844038,2238211014,2238222726,11712
1361816851,2238229716,17,6755,397.3529412,1361816833451,1361816844011,2238212167,2238222727,10560
1361816851,2238229768,17,6889,405.2352941,1361816831865,1361816843897,2238210633,2238222665,12032
1361816851,2238229804,11,953,86.63636364,1361816832982,1361816843926,2238211786,2238222730,10944
1361817647,2239026424,1,46,46,1361817621469,1361817621469,2239000893,2239000893,0
1361818822,2240201080,1,46,46,1361818794785,1361818794785,2240173865,2240173865,0
1361818919,2240297460,1,48,48,1361818894669,1361818894669,2240273129,2240273129,0
1361819062,2240441220,5,456,91.2,1361819061459,1361819061587,2240440679,2240440807,128
1361819334,2240713432,5,456,91.2,1361819327420,1361819327484,2240706852,2240706916,64
1361819350,2240729384,5,456,91.2,1361819345900,1361819345964,2240725284,2240725348,64
1361820302,2241680736,1,127,127,1361820277860,1361820277860,2241656596,2241656596,0
1361822081,2243459980,5,362,72.4,1361822078100,1361822079124,2243457080,2243458104,1024
1361822081,2243460044,6,404,67.33333333,1361822078039,1361822079447,2243457083,2243458491,1408
1361822089,2243467936,4,190,47.5,1361822087167,1361822087423,2243466103,2243466359,256
1361822089,2243467940,4,190,47.5,1361822087167,1361822087423,2243466107,2243466363,256
1361822089,2243467944,4,190,47.5,1361822087418,1361822087674,2243466362,2243466618,256
1361822089,2243467972,4,190,47.5,1361822084829,1361822086877,2243463801,2243465849,2048
1361822089,2243467976,4,190,47.5,1361822084826,1361822085530,2243463802,2243464506,704
1361822089,2243467976,4,190,47.5,1361822088218,1361822088666,2243467194,2243467642,448
1361822089,2243467976,4,190,47.5,1361822088282,1361822088730,2243467258,2243467706,448
1361822089,2243467976,4,190,47.5,1361822088282,1361822088794,2243467258,2243467770,512
1361822089,2243467976,4,190,47.5,1361822088472,1361822088600,2243467448,2243467576,128
1361822089,2243467976,4,190,47.5,1361822088600,1361822088664,2243467576,2243467640,64
1361822089,2243467980,4,190,47.5,1361822088787,1361822088851,2243467767,2243467831,64
1361822089,2243467980,4,190,47.5,1361822088599,1361822088663,2243467579,2243467643,64
1361822089,2243467980,4,190,47.5,1361822085335,1361822085591,2243464315,2243464571,256
1361822089,2243467980,4,190,47.5,1361822088662,1361822088790,2243467642,2243467770,128
1361822089,2243467980,4,190,47.5,1361822085334,1361822085974,2243464314,2243464954,640
1361822089,2243467980,4,190,47.5,1361822085588,1361822085844,2243464568,2243464824,256
1361822089,2243467984,4,190,47.5,1361822086034,1361822086290,2243465018,2243465274,256
1361822089,2243467984,4,190,47.5,1361822086034,1361822086354,2243465018,2243465338,320
1361822089,2243467984,4,190,47.5,1361822086289,1361822086545,2243465273,2243465529,256
1361822089,2243467984,28,33141,1183.607143,1361822080977,1361822082577,2243459961,2243461561,1600
1361822089,2243467984,4,190,47.5,1361822086544,1361822086800,2243465528,2243465784,256
1361822089,2243467984,4,190,47.5,1361822086608,1361822086864,2243465592,2243465848,256
1361822089,2243468004,4,190,47.5,1361822086782,1361822087038,2243465786,2243466042,256
1361822089,2243468004,4,190,47.5,1361822086845,1361822087101,2243465849,2243466105,256
1361822089,2243468016,4,190,47.5,1361822087346,1361822087602,2243466362,2243466618,256
1361822089,2243468020,4,190,47.5,1361822087724,1361822088172,2243466744,2243467192,448
1361822089,2243468020,4,190,47.5,1361822087724,1361822088172,2243466744,2243467192,448
1361822089,2243468020,4,190,47.5,1361822084716,1361822085356,2243463736,2243464376,640
1361822089,2243468024,4,190,47.5,1361822084715,1361822085291,2243463739,2243464315,576
1361822089,2243468048,4,190,47.5,1361822085137,1361822085393,2243464185,2243464441,256
1361822089,2243468052,4,190,47.5,1361822088462,1361822088526,2243467514,2243467578,64
1361822089,2243468052,4,190,47.5,1361822088590,1361822088718,2243467642,2243467770,128
1361822089,2243468052,4,190,47.5,1361822088526,1361822088654,2243467578,2243467706,128
1361822089,2243468052,4,190,47.5,1361822088718,1361822088782,2243467770,2243467834,64
1361822089,2243468052,4,190,47.5,1361822085262,1361822087630,2243464314,2243466682,2368
1361822089,2243468052,4,190,47.5,1361822088654,1361822088718,2243467706,2243467770,64
1361822089,2243468052,4,190,47.5,1361822085388,1361822085708,2243464440,2243464760,320
1361822089,2243468056,4,190,47.5,1361822085706,1361822085962,2243464762,2243465018,256
1361822089,2243468056,4,190,47.5,1361822085770,1361822088074,2243464826,2243467130,2304
1361822089,2243468056,4,190,47.5,1361822085705,1361822085961,2243464761,2243465017,256
1361822089,2243468056,4,190,47.5,1361822086280,1361822086536,2243465336,2243465592,256
1361822093,881786344,2,98,49,1361822084002,1361822089058,881777346,881782402,5056
1361822093,881786344,2,98,49,1361822084002,1361822087842,881777346,881781186,3840
1361822093,881786360,2,98,49,1361822083280,1361822086800,881776640,881780160,3520
1361822093,881786360,2,98,49,1361822083280,1361822087824,881776640,881781184,4544
1361822097,2243475948,4,190,47.5,1361822088947,1361822089331,2243467895,2243468279,384
1361822097,2243475952,4,190,47.5,1361822090546,1361822090930,2243469498,2243469882,384
1361822097,2243475952,4,190,47.5,1361822089010,1361822089394,2243467962,2243468346,384
1361822097,2243475952,4,190,47.5,1361822090546,1361822090994,2243469498,2243469946,448
1361822097,2243475956,4,190,47.5,1361822089388,1361822089772,2243468344,2243468728,384
1361822097,2243475956,4,190,47.5,1361822089452,1361822089836,2243468408,2243468792,384
1361822097,2243475988,4,190,47.5,1361822090124,1361822090508,2243469112,2243469496,384
1361822097,2243475992,7,2548,364,1361822095498,1361822095626,2243474490,2243474618,128
1361822097,2243475992,4,190,47.5,1361822090122,1361822090506,2243469114,2243469498,384
1361822097,2243475992,4,312,78,1361822095498,1361822095626,2243474490,2243474618,128
1361822097,2243475992,4,190,47.5,1361822090186,1361822090634,2243469178,2243469626,448
1361822097,2243476004,4,190,47.5,1361822088958,1361822089342,2243467962,2243468346,384
1361822097,2243476004,4,190,47.5,1361822089276,1361822089724,2243468280,2243468728,448
1361822097,2243476028,4,190,47.5,1361822089703,1361822090151,2243468731,2243469179,448
1361822097,2243476028,4,190,47.5,1361822089700,1361822090020,2243468728,2243469048,320
1361822097,2243476032,4,190,47.5,1361822089763,1361822090147,2243468795,2243469179,384
1361822097,2243476036,4,190,47.5,1361822087582,1361822089886,2243466618,2243468922,2304
1361822097,2243476036,4,190,47.5,1361822089949,1361822092381,2243468985,2243471417,2432
1361822097,2243476036,7,2504,357.7142857,1361822095644,1361822095772,2243474680,2243474808,128
1361822097,2243476036,4,313,78.25,1361822095644,1361822095772,2243474680,2243474808,128
1361822097,2243476040,4,312,78,1361822095898,1361822096026,2243474938,2243475066,128
1361822103,2243481640,5,3947,789.4,1361822078186,1361822079274,2243456826,2243457914,1088
1361822105,2243483972,4,310,77.5,1361822098142,1361822098206,2243477114,2243477178,64
1361822105,2243483972,11,5602,509.2727273,1361822082078,1361822097374,2243461050,2243476346,15296
1361822105,2243484000,1243,1854225,1491.733709,1361822082306,1361822102018,2243461306,2243481018,19712
1361822105,2243484040,11,6050,550,1361822082202,1361822097498,2243461242,2243476538,15296
1361822105,2243484076,4,730,182.5,1361822104054,1361822104182,2243483130,2243483258,128
1361822107,2243485508,30,35512,1183.733333,1361822079342,1361822095150,2243457850,2243473658,15808
1361822108,881801216,4,612,153,1361822080864,1361822081120,881774080,881774336,256
1361822108,881801272,4,640,160,1361822082791,1361822083047,881776063,881776319,256
1361822115,2243493664,2,98,49,1361822090386,1361822090450,2243469050,2243469114,64
1361822121,2243499980,4,312,78,1361822114132,1361822114260,2243493112,2243493240,128
1361822121,2243499984,4,312,78,1361822114258,1361822114322,2243493242,2243493306,64
1361822121,2243499988,4,449,112.25,1361822117195,1361822117259,2243496183,2243496247,64
1361822121,2243499992,5,1055,211,1361822120586,1361822120650,2243499578,2243499642,64
1361822121,2243499992,4,312,78,1361822120586,1361822120650,2243499578,2243499642,64
1361822121,2243500036,4,312,78,1361822113947,1361822114075,2243492983,2243493111,128
1361822121,2243500036,6,622,103.6666667,1361822114011,1361822117403,2243493047,2243496439,3392
1361822121,2243500036,4,312,78,1361822114014,1361822114142,2243493050,2243493178,128
1361822121,2243500036,4,312,78,1361822114141,1361822114205,2243493177,2243493241,64
1361822121,2243500036,4,312,78,1361822114204,1361822114332,2243493240,2243493368,128
1361822121,2243500060,4,292,73,1361822117123,1361822117251,2243496183,2243496311,128
1361822121,2243500060,4,312,78,1361822120133,1361822120197,2243499193,2243499257,64
1361822121,2243500060,5,1055,211,1361822120197,1361822120325,2243499257,2243499385,128
1361822121,2243500060,4,312,78,1361822120260,1361822120388,2243499320,2243499448,128
1361822121,2243500064,4,312,78,1361822120513,1361822120641,2243499577,2243499705,128
1361822129,2243507972,4,312,78,1361822122780,1361822122908,2243501752,2243501880,128
1361822129,2243507976,4,651,162.75,1361822121495,1361822121559,2243500471,2243500535,64
1361822129,2243507980,4,395,98.75,1361822121685,1361822121813,2243500665,2243500793,128
1361822129,2243507980,4,292,73,1361822121876,1361822121940,2243500856,2243500920,64
1361822129,2243507980,2,98,49,1361822121875,1361822127891,2243500855,2243506871,6016
1361822129,2243507984,4,292,73,1361822121873,1361822121937,2243500857,2243500921,64
1361822129,2243507984,4,312,78,1361822121936,1361822122000,2243500920,2243500984,64
1361822129,2243507988,4,313,78.25,1361822124238,1361822124366,2243503226,2243503354,128
1361822129,2243508008,6,2682,447,1361822124153,1361822124217,2243503161,2243503225,64
1361822129,2243508008,3,144,48,1361822124409,1361822124601,2243503417,2243503609,192
1361822129,2243508008,4,312,78,1361822128185,1361822128313,2243507193,2243507321,128
1361822129,2243508008,4,312,78,1361822128248,1361822128312,2243507256,2243507320,64
1361822129,2243508008,3,144,48,1361822124407,1361822124599,2243503415,2243503607,192
1361822129,2243508016,4,312,78,1361822128690,1361822128754,2243507706,2243507770,64
1361822129,2243508016,12,2877,239.75,1361822125169,1361822125425,2243504185,2243504441,256
1361822129,2243508016,14,5248,374.8571429,1361822125232,1361822125360,2243504248,2243504376,128
1361822129,2243508044,4,292,73,1361822121427,1361822121491,2243500471,2243500535,64
1361822129,2243508056,5,1797,359.4,1361822128073,1361822128265,2243507129,2243507321,192
1361822129,2243508096,4,312,78,1361822126369,1361822126433,2243505465,2243505529,64
1361822131,2243509716,1,46,46,1361822103710,1361822103710,2243482426,2243482426,0
1361822133,881826352,11,4262,387.4545455,1361822120536,1361822125720,881813888,881819072,5184
1361822133,881826352,8,501,62.625,1361822120536,1361822125720,881813888,881819072,5184
1361822133,881826380,10,4216,421.6,1361822120510,1361822125694,881813890,881819074,5184
1361822133,881826380,10,4216,421.6,1361822120510,1361822125694,881813890,881819074,5184
1361822133,881826400,8,550,68.75,1361822123626,1361822129642,881817026,881823042,6016
1361822137,2243515964,2,98,49,1361822126499,1361822131875,2243505463,2243510839,5376
1361822137,2243515964,4,312,78,1361822130467,1361822130595,2243509431,2243509559,128
1361822137,2243515984,4,1105,276.25,1361822132306,1361822132434,2243511290,2243511418,128
1361822137,2243516004,8,544,68,1361822124027,1361822129851,2243503031,2243508855,5824
1361822137,2243516008,3,150,50,1361822124154,1361822129850,2243503162,2243508858,5696
1361822137,2243516012,2,98,49,1361822128627,1361822133875,2243507639,2243512887,5248
1361822137,2243516020,4,312,78,1361822130475,1361822130539,2243509495,2243509559,64
1361822137,2243516052,4,312,78,1361822131597,1361822131661,2243510649,2243510713,64
1361822137,2243516064,4,312,78,1361822130305,1361822130369,2243509369,2243509433,64
1361822139,2243517548,2,98,49,1361822126851,1361822132291,2243505399,2243510839,5440
1361822140,881833360,6,1164,194,1361822113811,1361822114003,881807171,881807363,192
1361822142,2243520852,3,935,311.6666667,1361822130581,1361822130645,2243509433,2243509497,64
1361822142,2243520884,26,9776,376,1361822130676,1361822140916,2243509560,2243519800,10240
1361822142,881835136,17,20652,1214.823529,1361822124146,1361822124274,881817282,881817410,128
1361822142,2243520968,9,4966,551.7777778,1361822121184,1361822121312,2243500152,2243500280,128
1361822142,881835232,139,196491,1413.604317,1361822120978,1361822124306,881814210,881817538,3328
1361822142,881835236,165,230665,1397.969697,1361822121100,1361822124876,881814336,881818112,3776
1361822142,881835252,54,71211,1318.722222,1361822121086,1361822124222,881814338,881817474,3136
1361822142,2243520972,22,17478,794.4545455,1361822122779,1361822125211,2243501751,2243504183,2432
1361822142,881835348,11,7996,726.9090909,1361822122652,1361822124508,881816000,881817856,1856
1361822142,2243520972,14,8606,614.7142857,1361822122845,1361822124061,2243501817,2243503033,1216
1361822142,2243520972,12,5192,432.6666667,1361822122844,1361822124124,2243501816,2243503096,1280
1361822142,881835356,24,23544,981,1361822122710,1361822123926,881816066,881817282,1216
1361822142,2243521160,2,265,132.5,1361822131233,1361822131489,2243510393,2243510649,256
1361822142,2243521184,425,538024,1265.938824,1361822122826,1361822141002,2243502010,2243520186,18176
1361822142,2243521184,4,1304,326,1361822118665,1361822120073,2243497849,2243499257,1408
1361822142,881835404,7,2972,424.5714286,1361822123811,1361822124003,881817215,881817407,192
1361822142,881835408,8,5198,649.75,1361822123810,1361822123874,881817218,881817282,64
1361822142,2243521276,19,12328,648.8421053,1361822131758,1361822140142,2243511034,2243519418,8384
1361822142,881835532,96,130020,1354.375,1361822120806,1361822124006,881814338,881817538,3200
1361822142,2243521356,26,24040,924.6153846,1361822121499,1361822140635,2243500855,2243519991,19136
1361822142,2243521360,8,5032,629,1361822127641,1361822128025,2243507001,2243507385,384
1361822142,881835624,81,108293,1336.950617,1361822121927,1361822124295,881815551,881817919,2368
1361822142,2243521428,9,5168,574.2222222,1361822123604,1361822123924,2243503032,2243503352,320
1361822143,881835648,55,66985,1217.909091,1361822123545,1361822124761,881816193,881817409,1216
1361822143,2243521436,4,1234,308.5,1361822130867,1361822130995,2243509303,2243509431,128
1361822143,2243521460,4,336,84,1361822138908,1361822138972,2243517368,2243517432,64
1361822143,2243521476,254,364813,1436.271654,1361822122830,1361822124686,2243501306,2243503162,1856
1361822143,2243521476,311,451065,1450.369775,1361822122829,1361822125389,2243501305,2243503865,2560
1361822143,881835696,49,54089,1103.857143,1361822120361,1361822122665,881813057,881815361,2304
1361822143,881835704,7,3686,526.5714286,1361822124515,1361822124707,881817219,881817411,192
1361822143,2243521504,8,3168,396,1361822141424,1361822141616,2243519928,2243520120,192
1361822143,2243521508,980,1451193,1480.809184,1361822096430,1361822120622,2243474938,2243499130,24192
1361822143,2243521548,8,5737,717.125,1361822141507,1361822141635,2243520055,2243520183,128
1361822143,2243521552,3864,5754825,1489.343944,1361822088640,1361822111936,2243467192,2243490488,23296
1361822143,2243521588,7,4769,681.2857143,1361822122779,1361822126875,2243501367,2243505463,4096
1361822143,2243521596,155,152186,981.8451613,1361822120662,1361822126166,2243499258,2243504762,5504
1361822143,2243521700,43,44146,1026.651163,1361822126444,1361822132652,2243505144,2243511352,6208
1361822143,2243521704,18,14515,806.3888889,1361822126697,1361822126953,2243505401,2243505657,256
1361822143,2243521704,9,5548,616.4444444,1361822126633,1361822126825,2243505337,2243505529,192
1361822143,2243521796,27,26029,964.037037,1361822121356,1361822125452,2243500152,2243504248,4096
1361822143,2243521832,21,17189,818.5238095,1361822122985,1361822124201,2243501817,2243503033,1216
1361822143,2243521840,15,12474,831.6,1361822122977,1361822124193,2243501817,2243503033,1216
1361822143,2243521840,12,10237,853.0833333,1361822122977,1361822124193,2243501817,2243503033,1216
1361822143,2243521876,10,5018,501.8,1361822123070,1361822124158,2243501946,2243503034,1088
1361822143,2243521940,43,36776,855.255814,1361822131770,1361822140346,2243510710,2243519286,8576
1361822143,2243521984,10,3214,321.4,1361822132050,1361822141074,2243511034,2243520058,9024
1361822143,2243522120,9,4966,551.7777778,1361822123910,1361822123974,2243503030,2243503094,64
1361822143,2243522148,6,2115,352.5,1361822123886,1361822124270,2243503034,2243503418,384
1361822143,2243522156,7,2507,358.1428571,1361822123877,1361822124005,2243503033,2243503161,128
1361822143,2243522272,12,6316,526.3333333,1361822122097,1361822140721,2243501369,2243519993,18624
1361822143,2243522284,3,300,100,1361822128357,1361822128421,2243507641,2243507705,64
1361822143,2243522388,11,4846,440.5454545,1361822120060,1361822121084,2243499448,2243500472,1024
1361822144,2243522436,8,5702,712.75,1361822126707,1361822126899,2243505143,2243505335,192
1361822144,2243522436,10,5917,591.7,1361822126899,1361822127091,2243505335,2243505527,192
1361822145,2243523912,14,11286,806.1428571,1361822126489,1361822126809,2243505401,2243505721,320
1361822145,2243523916,10,3371,337.1,1361822141906,1361822141970,2243520822,2243520886,64
1361822145,2243523920,11,3433,312.0909091,1361822143058,1361822143122,2243521978,2243522042,64
1361822153,2243531996,4,292,73,1361822152389,1361822152453,2243531385,2243531449,64
1361822153,2243532068,4,447,111.75,1361822152253,1361822152381,2243531321,2243531449,128
1361822161,2243539960,4,779,194.75,1361822153000,1361822153064,2243531960,2243532024,64
1361822161,2243539972,4,312,78,1361822154142,1361822154270,2243533114,2243533242,128
1361822161,2243540004,3,144,48,1361822156602,1361822156858,2243535606,2243535862,256
1361822161,2243540020,4,312,78,1361822153006,1361822153070,2243532026,2243532090,64
1361822161,2243540044,4,312,78,1361822153493,1361822153557,2243532537,2243532601,64
1361822161,2243540044,5,570,114,1361822153939,1361822154003,2243532983,2243533047,64
1361822161,2243540044,4,312,78,1361822154003,1361822154067,2243533047,2243533111,64
1361822161,2243540052,3,144,48,1361822154574,1361822154766,2243533626,2243533818,192
1361822167,2243545552,12,3913,326.0833333,1361822142337,1361822146689,2243520889,2243525241,4352
1361822167,2243545592,24,22160,923.3333333,1361822142042,1361822142746,2243520634,2243521338,704
1361822167,2243545592,64,78527,1226.984375,1361822142042,1361822148698,2243520634,2243527290,6656
1361822167,2243545592,11,3995,363.1818182,1361822142041,1361822146329,2243520633,2243524921,4288
1361822167,2243545592,20,1657,82.85,1361822142167,1361822148183,2243520759,2243526775,6016
1361822168,881861360,1,46,46,1361822142739,1361822142739,881836099,881836099,0
1361822168,881861408,1,46,46,1361822143776,1361822143776,881837184,881837184,0
1361822171,2243549708,10,9064,906.4,1361822145957,1361822156581,2243524665,2243535289,10624
1361822171,2243549736,4,914,228.5,1361822146119,1361822148487,2243524855,2243527223,2368
1361822175,2243553756,95,90018,947.5578947,1361822148020,1361822156468,2243526776,2243535224,8448
1361822177,2243555976,2,123,61.5,1361822171480,1361822171480,2243550456,2243550456,0
1361822177,2243555988,7,2504,357.7142857,1361822175757,1361822176077,2243554745,2243555065,320
1361822177,2243555988,4,443,110.75,1361822176332,1361822176396,2243555320,2243555384,64
1361822177,2243556028,8,482,60.25,1361822167268,1361822175780,2243546296,2243554808,8512
1361822177,2243556056,11484,17218732,1499.367119,1361822153993,1361822175241,2243533049,2243554297,21248
1361822179,2243557624,5,2418,483.6,1361822153593,1361822177593,2243532217,2243556217,24000
1361822179,2243557624,4,1068,267,1361822153846,1361822154102,2243532470,2243532726,256
1361822185,2243563980,4,445,111.25,1361822177106,1361822177170,2243556086,2243556150,64
1361822185,2243563988,4,292,73,1361822179085,1361822179213,2243558073,2243558201,128
1361822185,2243563988,4,443,110.75,1361822177866,1361822177994,2243556854,2243556982,128
1361822185,2243564020,3,144,48,1361822180717,1361822180909,2243559737,2243559929,192
1361822185,2243564020,3,144,48,1361822180717,1361822180909,2243559737,2243559929,192
1361822185,2243564020,4,1208,302,1361822182571,1361822182699,2243561591,2243561719,128
1361822185,2243564020,6,359,59.83333333,1361822169834,1361822177770,2243548854,2243556790,7936
1361822185,2243564024,4,312,78,1361822181926,1361822182054,2243560950,2243561078,128
1361822185,2243564024,4,312,78,1361822182058,1361822182122,2243561082,2243561146,64
1361822185,2243564024,4,312,78,1361822182057,1361822182121,2243561081,2243561145,64
1361822185,2243564032,4,292,73,1361822177057,1361822177185,2243556089,2243556217,128
1361822185,2243564032,4,860,215,1361822177120,1361822177184,2243556152,2243556216,64
1361822185,2243564064,7,3216,459.4285714,1361822179839,1361822181055,2243558903,2243560119,1216
1361822185,2243564068,3,169,56.33333333,1361822169724,1361822177724,2243548792,2243556792,8000
1361822185,2243564068,4,312,78,1361822181883,1361822182011,2243560951,2243561079,128
1361822185,2243564068,4,312,78,1361822182074,1361822182138,2243561142,2243561206,64
1361822187,2243565604,6,359,59.83333333,1361822169227,1361822178187,2243547831,2243556791,8960
1361822193,2243571984,3,200,66.66666667,1361822186063,1361822191055,2243565047,2243570039,4992
1361822193,2243572012,2,123,61.5,1361822183988,1361822188980,2243563000,2243567992,4992
1361822193,2243572016,4,507,126.75,1361822189678,1361822189742,2243568694,2243568758,64
1361822193,2243572020,4,469,117.25,1361822191020,1361822191148,2243570040,2243570168,128
1361822193,2243572020,4,446,111.5,1361822191786,1361822191850,2243570806,2243570870,64
1361822193,2243572148,4,292,73,1361822190636,1361822190700,2243569784,2243569848,64
1361822193,2243572172,4,488,122,1361822190290,1361822190354,2243569462,2243569526,64
1361822193,2243572176,4,457,114.25,1361822192017,1361822192145,2243571193,2243571321,128
1361822193,2243572176,4,292,73,1361822192208,1361822192272,2243571384,2243571448,64
1361822195,2243573664,2,123,61.5,1361822170126,1361822170126,2243548790,2243548790,0
1361822195,2243573748,2,123,61.5,1361822170109,1361822170109,2243548857,2243548857,0
1361822195,2243573748,2,123,61.5,1361822170109,1361822170109,2243548857,2243548857,0
1361822195,2243573772,7,3120,445.7142857,1361822168483,1361822176163,2243547255,2243554935,7680
1361822199,2243577876,2,154,77,1361822171578,1361822171770,2243550454,2243550646,192
1361822199,2243577880,1,77,77,1361822171577,1361822171577,2243550457,2243550457,0
1361822199,2243577984,1,77,77,1361822170831,1361822170831,2243549815,2243549815,0
1361822199,2243577992,2,154,77,1361822171464,1361822171656,2243550456,2243550648,192
1361822201,2243579976,12,9399,783.25,1361822194774,1361822194838,2243573750,2243573814,64
1361822201,2243579980,2,123,61.5,1361822198802,1361822198802,2243577782,2243577782,0
1361822201,2243580024,4,1047,261.75,1361822196710,1361822196774,2243575734,2243575798,64
1361822201,2243580024,4,312,78,1361822194345,1361822194409,2243573369,2243573433,64
1361822201,2243580032,4,312,78,1361822194526,1361822194590,2243573558,2243573622,64
1361822201,2243580064,4,2869,717.25,1361822194238,1361822194494,2243573302,2243573558,256
1361822203,2243582008,1,77,77,1361822176761,1361822176761,2243555769,2243555769,0
1361822207,2243585840,2,92,46,1361822180255,1361822181087,2243559095,2243559927,832
1361822207,2243585904,59,83521,1415.610169,1361822182049,1361822182305,2243560953,2243561209,256
1361822207,2243585908,19,24280,1277.894737,1361822182109,1361822182173,2243561017,2243561081,64
1361822207,2243585960,8,4107,513.375,1361822181288,1361822202728,2243560248,2243581688,21440
1361822207,2243585960,63,83522,1325.746032,1361822181478,1361822181798,2243560438,2243560758,320
1361822207,2243585988,14,17396,1242.571429,1361822181898,1361822182282,2243560886,2243561270,384
1361822207,2243585992,3,712,237.3333333,1361822181897,1361822181961,2243560889,2243560953,64
1361822209,2243587988,9,4674,519.3333333,1361822202634,1361822203274,2243581622,2243582262,640
1361822209,2243587996,9,4654,517.1111111,1361822203266,1361822203714,2243582262,2243582710,448
1361822209,2243588000,8,3363,420.375,1361822202174,1361822202622,2243581174,2243581622,448
1361822209,2243588000,8,2495,311.875,1361822202302,1361822202622,2243581302,2243581622,320
1361822209,2243588048,7,3216,459.4285714,1361822203023,1361822203215,2243582071,2243582263,192
1361822211,2243589840,1,77,77,1361822185248,1361822185248,2243564088,2243564088,0
1361822211,2243589848,2,154,77,1361822185944,1361822186136,2243564792,2243564984,192
1361822211,2243589848,2,92,46,1361822186071,1361822186967,2243564919,2243565815,896
1361822211,2243589920,1,77,77,1361822185168,1361822185168,2243564088,2243564088,0
1361822215,2243593824,2,123,61.5,1361822186927,1361822186927,2243565751,2243565751,0
1361822215,2243593832,2,265,132.5,1361822187750,1361822188006,2243566582,2243566838,256
1361822215,2243593920,2,92,46,1361822187792,1361822187856,2243566712,2243566776,64
1361822219,2243597824,37,51513,1392.243243,1361822194672,1361822194736,2243573496,2243573560,64
1361822219,2243597868,2,154,77,1361822190916,1361822191108,2243569784,2243569976,192
1361822219,2243597876,2,123,61.5,1361822191931,1361822191931,2243570807,2243570807,0
1361822219,2243597908,1,77,77,1361822192859,1361822192859,2243571767,2243571767,0
1361822219,2243597908,2,154,77,1361822192859,1361822193115,2243571767,2243572023,256
1361822219,2243597936,43,35934,835.6744186,1361822193983,1361822202111,2243572919,2243581047,8128
1361822219,2243597984,2,154,77,1361822191825,1361822192017,2243570809,2243571001,192
1361822223,2243601940,7,4469,638.4285714,1361822194812,1361822194876,2243573752,2243573816,64
1361822223,2243601940,5,926,185.2,1361822194875,1361822194939,2243573815,2243573879,64
1361822225,2243604044,9,4628,514.2222222,1361822223443,1361822223635,2243602487,2243602679,192
1361822225,2243604052,11,5339,485.3636364,1361822203721,1361822221001,2243582773,2243600053,17280
1361822225,2243604092,11,4836,439.6363636,1361822221025,1361822222305,2243600117,2243601397,1280
1361822225,2243604092,9,4674,519.3333333,1361822221025,1361822222305,2243600117,2243601397,1280
1361822225,2243604096,9,3007,334.1111111,1361822221217,1361822222305,2243600313,2243601401,1088
1361822225,2243604096,16,12159,759.9375,1361822221345,1361822221921,2243600441,2243601017,576
1361822225,2243604096,9,3891,432.3333333,1361822221983,1361822222303,2243601079,2243601399,320
1361822225,2243604172,2,98,49,1361822220821,1361822220821,2243599993,2243599993,0
1361822225,2243604172,7,3222,460.2857143,1361822220565,1361822220885,2243599737,2243600057,320
1361822225,2243604172,9,4667,518.5555556,1361822220948,1361822221268,2243600120,2243600440,320
1361822227,2243605960,1,46,46,1361822202086,1361822202086,2243581046,2243581046,0
1361822227,2243606040,1,46,46,1361822200726,1361822200726,2243579766,2243579766,0
1361822227,2243606040,1,77,77,1361822200726,1361822200726,2243579766,2243579766,0
1361822227,2243606052,2,1480,740,1361822202316,1361822202636,2243581368,2243581688,320
1361822233,2243612044,13,10302,792.4615385,1361822225108,1361822226580,2243604152,2243605624,1472
1361822233,2243612048,3,144,48,1361822230993,1361822231185,2243610041,2243610233,192
1361822233,2243612048,3,144,48,1361822230992,1361822231184,2243610040,2243610232,192
1361822233,2243612048,4,311,77.75,1361822227855,1361822227919,2243606903,2243606967,64
1361822233,2243612048,4,292,73,1361822227983,1361822228047,2243607031,2243607095,64
1361822233,2243612052,68,89338,1313.794118,1361822225225,1361822226569,2243604277,2243605621,1344
1361822233,2243612056,9,4667,518.5555556,1361822225480,1361822226568,2243604536,2243605624,1088
1361822233,2243612120,10,4716,471.6,1361822223301,1361822226501,2243602421,2243605621,3200
1361822233,2243612120,10,4722,472.2,1361822223366,1361822226502,2243602486,2243605622,3136
1361822233,2243612140,42,51053,1215.547619,1361822225653,1361822226485,2243604793,2243605625,832
1361822233,2243612164,643,934166,1452.824261,1361822223706,1361822226458,2243602870,2243605622,2752
1361822239,2243617940,2,123,61.5,1361822214845,1361822214845,2243593785,2243593785,0
1361822239,2243618096,2,123,61.5,1361822214688,1361822214688,2243593784,2243593784,0
1361822241,2243620092,3,169,56.33333333,1361822239715,1361822239715,2243618807,2243618807,0
1361822241,2243620092,2,123,61.5,1361822239715,1361822239715,2243618807,2243618807,0
1361822241,2243620092,2,123,61.5,1361822239715,1361822239715,2243618807,2243618807,0
1361822241,2243620092,2,123,61.5,1361822239715,1361822239715,2243618807,2243618807,0
1361822241,2243620096,3,169,56.33333333,1361822240671,1361822240671,2243619767,2243619767,0
1361822241,2243620148,3,169,56.33333333,1361822239661,1361822239661,2243618809,2243618809,0
1361822241,2243620148,3,169,56.33333333,1361822239661,1361822239661,2243618809,2243618809,0
1361822241,2243620168,2,123,61.5,1361822240663,1361822240663,2243619831,2243619831,0
1361822243,2243621912,1,77,77,1361822215830,1361822215830,2243594742,2243594742,0
1361822243,2243621912,2,154,77,1361822215830,1361822216086,2243594742,2243594998,256
1361822243,2243621916,2,92,46,1361822216147,1361822216851,2243595063,2243595767,704
1361822243,2243621956,9,2087,231.8888889,1361822214828,1361822238060,2243593784,2243617016,23232
1361822243,2243622000,2,154,77,1361822215743,1361822215999,2243594743,2243594999,256
1361822243,2243622016,1,77,77,1361822215727,1361822215727,2243594743,2243594743,0
1361822245,881938424,3,169,56.33333333,1361822240594,1361822240594,881934018,881934018,0
1361822245,881938424,3,138,46,1361822237714,1361822237714,881931138,881931138,0
1361822245,881938424,3,169,56.33333333,1361822239571,1361822239571,881932995,881932995,0
1361822245,881938424,3,169,56.33333333,1361822239571,1361822239571,881932995,881932995,0
1361822245,881938424,3,169,56.33333333,1361822239571,1361822239571,881932995,881932995,0
1361822245,881938428,3,169,56.33333333,1361822239567,1361822239567,881932995,881932995,0
1361822245,881938428,3,169,56.33333333,1361822239567,1361822239567,881932995,881932995,0
1361822245,881938428,3,169,56.33333333,1361822239631,1361822239695,881933059,881933123,64
1361822245,881938448,3,169,56.33333333,1361822239545,1361822239545,881932993,881932993,0
1361822245,881938448,3,169,56.33333333,1361822239545,1361822239545,881932993,881932993,0
1361822245,881938448,3,169,56.33333333,1361822239545,1361822239545,881932993,881932993,0
1361822245,881938448,3,169,56.33333333,1361822239545,1361822239545,881932993,881932993,0
1361822245,881938448,3,169,56.33333333,1361822239545,1361822239545,881932993,881932993,0
1361822247,2243626000,24,6579,274.125,1361822221119,1361822225343,2243600119,2243604343,4224
1361822247,2243626012,1,77,77,1361822222068,1361822222068,2243601080,2243601080,0
1361822255,2243633836,1,77,77,1361822230946,1361822230946,2243609782,2243609782,0
1361822255,2243634040,1,77,77,1361822229719,1361822229719,2243608759,2243608759,0
1361822255,2243634048,2,154,77,1361822230671,1361822230927,2243609719,2243609975,256
1361822257,2243636104,4,292,73,1361822252693,1361822252757,2243631797,2243631861,64
1361822257,2243636184,4,456,114,1361822252552,1361822252616,2243631736,2243631800,64
1361822259,2243638044,1,77,77,1361822231699,1361822231699,2243610743,2243610743,0
1361822260,881953532,1,46,46,1361822233638,1361822233638,881927170,881927170,0
1361822263,2243641900,1,46,46,1361822234914,1361822234914,2243613814,2243613814,0
1361822263,2243641948,1,46,46,1361822236915,1361822236915,2243615863,2243615863,0
1361822263,2243642024,1,77,77,1361822235814,1361822235814,2243614838,2243614838,0
1361822263,2243642024,1,46,46,1361822235814,1361822235814,2243614838,2243614838,0
1361822263,2243642032,1,77,77,1361822236701,1361822236701,2243615733,2243615733,0
1361822263,2243642032,1,77,77,1361822236701,1361822236701,2243615733,2243615733,0
1361822263,2243642072,1,77,77,1361822237621,1361822237621,2243616693,2243616693,0
1361822263,2243642072,1,77,77,1361822237685,1361822237685,2243616757,2243616757,0
1361822263,2243642072,2,1435,717.5,1361822237878,1361822237942,2243616950,2243617014,64
1361822265,2243644084,223,328905,1474.910314,1361822258729,1361822259945,2243637813,2243639029,1216
1361822265,2243644092,3,144,48,1361822263137,1361822263329,2243642229,2243642421,192
1361822265,2243644100,7,412,58.85714286,1361822260571,1361822260635,2243639671,2243639735,64
1361822265,2243644100,7,412,58.85714286,1361822260571,1361822260635,2243639671,2243639735,64
1361822265,2243644128,4,2870,717.5,1361822258494,1361822258686,2243637622,2243637814,192
1361822265,2243644160,4,312,78,1361822258720,1361822258784,2243637880,2243637944,64
1361822265,2243644164,16,8049,503.0625,1361822255578,1361822257050,2243634742,2243636214,1472
1361822265,2243644168,3,144,48,1361822263062,1361822263190,2243642230,2243642358,128
1361822265,2243644172,4,494,123.5,1361822260243,1361822260307,2243639415,2243639479,64
1361822265,2243644172,4,292,73,1361822260370,1361822260434,2243639542,2243639606,64
1361822265,2243644172,7,412,58.85714286,1361822260497,1361822260561,2243639669,2243639733,64
1361822265,2243644172,6,366,61,1361822260497,1361822260561,2243639669,2243639733,64
1361822265,2243644200,4,456,114,1361822260789,1361822260853,2243639989,2243640053,64
1361822265,2243644200,4,456,114,1361822260917,1361822261045,2243640117,2243640245,128
1361822265,2243644208,6,2983,497.1666667,1361822258160,1361822258224,2243637368,2243637432,64
1361822265,2243644208,4,312,78,1361822258160,1361822258288,2243637368,2243637496,128
1361822267,2243645928,1,46,46,1361822242182,1361822242182,2243621110,2243621110,0
1361822267,2243645928,1,46,46,1361822242245,1361822242245,2243621173,2243621173,0
1361822267,2243646016,1,46,46,1361822242160,1361822242160,2243621176,2243621176,0
1361822271,2243649896,2,265,132.5,1361822243879,1361822243943,2243622775,2243622839,64
1361822271,2243649940,1,46,46,1361822245882,1361822245882,2243624822,2243624822,0
1361822271,2243650020,1,77,77,1361822245675,1361822245675,2243624695,2243624695,0
1361822271,2243650020,1,46,46,1361822245738,1361822245738,2243624758,2243624758,0
1361822273,2243652112,5,320,64,1361822266573,1361822266573,2243645685,2243645685,0
1361822275,2243653928,1,46,46,1361822247239,1361822247239,2243626167,2243626167,0
1361822279,2243657924,2,123,61.5,1361822251914,1361822273482,2243630838,2243652406,21568
1361822281,2243660048,271,364553,1345.214022,1361822141583,1361822277647,2243520631,2243656695,136064
1361822281,2243660060,5,320,64,1361822275649,1361822275649,2243654709,2243654709,0
1361822281,2243660132,6,366,61,1361822275577,1361822275577,2243654709,2243654709,0
1361822281,2243660140,6,366,61,1361822274548,1361822274548,2243653688,2243653688,0
1361822281,2243660176,6,366,61,1361822276495,1361822276559,2243655671,2243655735,64
1361822281,2243660180,7,412,58.85714286,1361822280523,1361822280523,2243659703,2243659703,0
1361822283,2243661928,1,46,46,1361822257224,1361822257224,2243636152,2243636152,0
1361822283,2243662016,1,46,46,1361822257135,1361822257135,2243636151,2243636151,0
1361822287,2243665912,2,123,61.5,1361822259797,1361822259797,2243638709,2243638709,0
1361822287,2243666000,2,123,61.5,1361822259710,1361822259710,2243638710,2243638710,0
1361822287,2243666072,1,46,46,1361822262135,1361822262135,2243641207,2243641207,0
1361822289,2243668056,113,113043,1000.380531,1361822142149,1361822281669,2243521205,2243660725,139520
1361822289,2243668064,269,355764,1322.542751,1361822145469,1361822282685,2243524533,2243661749,137216
1361822289,2243668104,5,320,64,1361822282581,1361822282581,2243661685,2243661685,0
1361822289,2243668140,5,320,64,1361822281521,1361822281585,2243660661,2243660725,64
1361822289,2243668144,6,366,61,1361822281520,1361822281584,2243660664,2243660728,64
1361822289,2243668152,5,320,64,1361822282533,1361822282597,2243661685,2243661749,64
1361822297,2243676124,6,366,61,1361822290562,1361822290626,2243669686,2243669750,64
1361822303,2243682008,2,473,236.5,1361822278132,1361822278196,2243657140,2243657204,64
1361822305,2243684224,8,451,56.375,1361822304415,1361822304543,2243683639,2243683767,128
1361822307,2243685976,1,46,46,1361822281877,1361822281877,2243660853,2243660853,0
1361822307,2243686012,2,123,61.5,1361822282739,1361822282739,2243661751,2243661751,0
1361822311,2243689992,1,46,46,1361822285767,1361822285767,2243664759,2243664759,0
1361822313,2243692296,9,497,55.22222222,1361822304342,1361822310230,2243683638,2243689526,5888
1361822327,2243706068,2,265,132.5,1361822299515,1361822299643,2243678583,2243678711,128
1361822337,2243716216,6,1360,226.6666667,1361822325477,1361822330533,2243704693,2243709749,5056
1361822337,2243716300,8,1505,188.125,1361822325395,1361822330451,2243704695,2243709751,5056
1361822339,2243718144,1,46,46,1361822311726,1361822311726,2243690870,2243690870,0
1361822339,2243718152,1,46,46,1361822312102,1361822312102,2243691254,2243691254,0
1361822343,2243722128,2,473,236.5,1361822318462,1361822318526,2243697590,2243697654,64
1361822343,2243722132,1,46,46,1361822318586,1361822318586,2243697718,2243697718,0
1361822351,2243730068,6,1825,304.1666667,1361822325047,1361822325239,2243704115,2243704307,192
1361822367,2243746416,1,46,46,1361822341405,1361822341405,2243720821,2243720821,0
1361822369,2243748184,4,312,78,1361822367109,1361822367173,2243746293,2243746357,64
1361822369,2243748192,4,312,78,1361822367933,1361822367997,2243747125,2243747189,64
1361822369,2243748196,4,312,78,1361822368314,1361822368378,2243747510,2243747574,64
1361822369,2243748200,4,312,78,1361822364406,1361822364470,2243743606,2243743670,64
1361822369,2243748228,4,312,78,1361822368473,1361822368601,2243747701,2243747829,128
1361822369,2243748268,4,312,78,1361822363568,1361822363632,2243742836,2243742900,64
1361822369,2243748308,4,312,78,1361822364871,1361822364999,2243744179,2243744307,128
1361822369,2243748316,4,312,78,1361822365698,1361822365762,2243745014,2243745078,64
1361822379,2243758432,2,265,132.5,1361822354574,1361822354638,2243734006,2243734070,64
1361822384,2243762508,6,1870,311.6666667,1361822359529,1361822376361,2243738037,2243754869,16832
1361822385,2243764316,6,452,75.33333333,1361822375807,1361822381183,2243755123,2243760499,5376
1361822391,2243770412,5,4081,816.2,1361822363360,1361822363424,2243742772,2243742836,64
1361822395,2243774340,2,123,61.5,1361822369256,1361822369256,2243748596,2243748596,0
1361822397,882090464,2,98,49,1361822389674,1361822393130,882083138,882086594,3456
1361822397,882090464,2,98,49,1361822389738,1361822394154,882083202,882087618,4416
1361822399,2243778360,1,46,46,1361822371477,1361822371477,2243750837,2243750837,0
1361822401,2243780268,4,312,78,1361822398830,1361822398894,2243778098,2243778162,64
1361822423,2243802420,1,46,46,1361822398553,1361822398553,2243777973,2243777973,0
1361822423,2243802420,5,3829,765.8,1361822398616,1361822398680,2243778036,2243778100,64
1361822428,2243806476,1,46,46,1361822402374,1361822402374,2243780850,2243780850,0
1361822433,2243812240,9,621,69,1361822425674,1361822431242,2243804914,2243810482,5568
1361822433,2243812272,4,312,78,1361822429546,1361822429674,2243808818,2243808946,128
1361822433,2243812276,4,312,78,1361822429992,1361822430120,2243809268,2243809396,128
1361822433,2243812276,4,312,78,1361822430119,1361822430183,2243809395,2243809459,64
1361822433,2243812280,4,312,78,1361822430434,1361822430562,2243809714,2243809842,128
1361822433,2243812300,4,312,78,1361822430736,1361822430800,2243810036,2243810100,64
1361822433,2243812308,4,312,78,1361822431241,1361822431497,2243810549,2243810805,256
1361822433,2243812356,4,312,78,1361822429974,1361822430038,2243809330,2243809394,64
1361822433,2243812380,4,312,78,1361822430273,1361822430401,2243809653,2243809781,128
1361822436,2243814480,2,265,132.5,1361822411395,1361822411523,2243789875,2243790003,128
1361822440,2243818520,12,3194,266.1666667,1361822415003,1361822426075,2243793523,2243804595,11072
1361822443,2243822376,2,473,236.5,1361822415429,1361822415493,2243794805,2243794869,64
1361822459,2243838396,1,46,46,1361822431472,1361822431472,2243810868,2243810868,0
1361822481,2243860272,4,312,78,1361822478825,1361822478889,2243858097,2243858161,64
1361822484,2243862480,2,473,236.5,1361822456772,1361822456836,2243835252,2243835316,64
1361822488,2243866556,1,46,46,1361822462326,1361822462326,2243840882,2243840882,0
1361822492,2243870560,2,265,132.5,1361822466994,1361822467122,2243845554,2243845682,128
1361822496,2243874592,2,123,61.5,1361822470868,1361822470868,2243849460,2243849460,0
1361822497,2243876296,47,57741,1228.531915,1361822477906,1361822495314,2243857202,2243874610,17408
1361822504,2243882536,1,46,46,1361822479433,1361822479433,2243857969,2243857969,0
1361822504,2243882540,6,2502,417,1361822479496,1361822479688,2243858036,2243858228,192
1361822504,2243882616,6,2598,433,1361822478907,1361822479099,2243857523,2243857715,192
1361822516,2243894692,1,76,76,1361822490221,1361822490221,2243868913,2243868913,0
1361822520,2243898784,1,46,46,1361822492115,1361822492115,2243870899,2243870899,0
1361822524,2243902820,4,1058,264.5,1361822496494,1361822497646,2243875314,2243876466,1152
1361822540,2243918876,2,123,61.5,1361822515512,1361822515512,2243894388,2243894388,0
1361822548,2243926816,2,265,132.5,1361822521971,1361822522099,2243900787,2243900915,128
1361822548,2243926816,1,46,46,1361822522096,1361822522096,2243900912,2243900912,0
1361822553,2243932324,946,1368219,1446.320296,1361822364212,1361822546676,2243743536,2243926000,182464
1361822556,2243934892,4,2092,523,1361822528228,1361822531492,2243907120,2243910384,3264
1361822580,2243958804,2,123,61.5,1361822552125,1361822575933,2243930929,2243954737,23808
1361822588,2243966768,2,123,61.5,1361822560544,1361822560544,2243939312,2243939312,0
1361822596,2243974820,4,1059,264.75,1361822571118,1361822586350,2243949938,2243965170,15232
1361822604,2243982792,2,265,132.5,1361822577417,1361822577545,2243956209,2243956337,128
1361822608,2243986824,1,46,46,1361822582121,1361822582121,2243960945,2243960945,0
1361822610,2243988588,7,2056,293.7142857,1361822598611,1361822604755,2243977199,2243983343,6144
1361822620,2243998808,1,46,46,1361822594425,1361822594425,2243973233,2243973233,0
1361822620,2243998824,1,46,46,1361822595370,1361822595370,2243974194,2243974194,0
1361822632,2244010808,3,685,228.3333333,1361822605113,1361822605177,2243983921,2243983985,64
1361822640,2244018808,1,46,46,1361822612153,1361822612153,2243990961,2243990961,0
1361822652,2244030872,2,473,236.5,1361822626554,1361822626618,2244005426,2244005490,64
1361822660,2244039008,2,265,132.5,1361822633074,1361822633202,2244012082,2244012210,128
1361822668,2244047364,1,46,46,1361822641612,1361822641612,2244020976,2244020976,0
1361822676,2244055180,2,123,61.5,1361822648964,1361822648964,2244028144,2244028144,0
1361822692,2244071264,2,473,236.5,1361822665840,1361822665904,2244045104,2244045168,64
1361822696,2244075248,1,46,46,1361822671744,1361822671744,2244050992,2244050992,0
1361822716,2244095232,2,265,132.5,1361822688848,1361822688976,2244068080,2244068208,128
1361822720,2244099340,2,123,61.5,1361822693732,1361822693732,2244073072,2244073072,0
1361822728,2244107384,1,46,46,1361822701624,1361822701624,2244081008,2244081008,0
1361822732,2244111260,4,1909,477.25,1361822705394,1361822730418,2244084654,2244109678,25024
1361822738,2244116776,8,1505,188.125,1361822726488,1361822731544,2244105264,2244110320,5056
1361822753,2244131468,6,1856,309.3333333,1361822726220,1361822726348,2244104688,2244104816,128
1361822753,2244131472,7,4562,651.7142857,1361822726791,1361822726855,2244105263,2244105327,64
1361822757,2244135512,1,46,46,1361822732510,1361822732510,2244111022,2244111022,0
1361822773,2244151500,2,265,132.5,1361822745642,1361822745770,2244124142,2244124270,128
1361822778,2244156712,1,46,46,1361822752150,1361822752150,2244130862,2244130862,0
1361822788,2244167396,1,46,46,1361822761643,1361822761643,2244141039,2244141039,0
1361822796,2244175400,2,123,61.5,1361822769576,1361822769576,2244148976,2244148976,0
1361822797,2244175552,2,473,236.5,1361822771830,1361822771894,2244150382,2244150446,64
1361822817,2244195584,1,46,46,1361822792469,1361822792469,2244171053,2244171053,0
1361822825,2244203824,2,265,132.5,1361822800613,1361822800741,2244179437,2244179565,128
1361822837,2244215744,9,3731,414.5555556,1361822811638,1361822818166,2244190382,2244196910,6528
1361822841,2244219808,2,123,61.5,1361822815094,1361822815094,2244193902,2244193902,0
1361822849,2244227848,1,46,46,1361822822222,1361822822222,2244201070,2244201070,0
1361822850,2244228724,3,169,56.33333333,1361822842633,1361822842633,2244221357,2244221357,0
1361822877,2244255800,1,46,46,1361822852285,1361822852285,2244231085,2244231085,0
1361822881,2244259908,2,265,132.5,1361822856017,1361822856081,2244234925,2244234989,64
1361822885,2244263732,2,473,236.5,1361822858114,1361822858178,2244236846,2244236910,64
1361822885,2244263892,2,123,61.5,1361822859937,1361822859937,2244238829,2244238829,0
1361822905,2244283904,2,123,61.5,1361822878292,1361822882196,2244257196,2244261100,3904
1361822906,2244284752,4,184,46,1361822899307,1361822900907,2244278059,2244279659,1600
1361822914,2244292732,8,451,56.375,1361822905025,1361822906689,2244283757,2244285421,1664
1361822925,2244303788,2,473,236.5,1361822897927,1361822897991,2244276715,2244276779,64
1361822937,2244315896,2,265,132.5,1361822911131,1361822911259,2244290027,2244290155,128
1361822937,2244315932,1,46,46,1361822912182,1361822912182,2244291114,2244291114,0
1361822965,2244343964,2,473,236.5,1361822938202,1361822938266,2244317166,2244317230,64
1361822969,2244348044,1,46,46,1361822942089,1361822942089,2244321133,2244321133,0
1361822978,2244356924,3,144,48,1361822971775,1361822971775,2244350699,2244350699,0
1361822986,2244364840,120,153323,1277.691667,1361822974741,1361822983061,2244353581,2244361901,8320
1361822993,2244372264,2,265,132.5,1361822966125,1361822966253,2244345389,2244345517,128
1361822994,2244372824,111,141181,1271.900901,1361822983138,1361822993506,2244361962,2244372330,10368
1361822994,2244372860,3,144,48,1361822991808,1361822992000,2244370668,2244370860,192
1361822997,2244376356,4,1110,277.5,1361822971790,1361822990158,2244351146,2244369514,18368
1361823002,2244380852,4,311,77.75,1361822997830,1361822997894,2244376682,2244376746,64
1361823002,2244380932,50,53574,1071.48,1361822993464,1361822994936,2244372396,2244373868,1472
1361823002,2244380936,4,292,73,1361822997877,1361822997941,2244376813,2244376877,64
1361823002,2244380936,41,40671,991.9756098,1361822997877,1361822999157,2244376813,2244378093,1280
1361823002,2244380940,54,62879,1164.425926,1361822994990,1361822996526,2244373930,2244375466,1536
1361823002,2244380972,58,67763,1168.327586,1361822999184,1361823000464,2244378156,2244379436,1280
1361823002,2244380976,98,122823,1253.295918,1361822996555,1361822997835,2244375531,2244376811,1280
1361823005,2244384304,2,473,236.5,1361822977476,1361822977540,2244356780,2244356844,64
1361823010,2244388844,5,248,49.6,1361823001870,1361823005070,2244380714,2244383914,3200
1361823010,2244388844,5,248,49.6,1361823001869,1361823005069,2244380713,2244383913,3200
1361823010,2244388856,319,430429,1349.30721,1361823003525,1361823007557,2244382381,2244386413,4032
1361823010,2244388892,96,119334,1243.0625,1361823000606,1361823003422,2244379498,2244382314,2816
1361823017,2244396208,10,4962,496.2,1361822989730,1361822990306,2244368938,2244369514,576
1361823017,2244396236,8,4571,571.375,1361822990278,1361822990470,2244369514,2244369706,192
1361823018,2244396840,135,183357,1358.2,1361823011732,1361823015380,2244390572,2244394220,3648
1361823018,2244396940,121,162577,1343.61157,1361823007662,1361823011438,2244386602,2244390378,3776
1361823026,2244404856,160,219813,1373.83125,1361823019205,1361823022853,2244398061,2244401709,3648
1361823026,2244405272,142,191780,1350.56338,1361823015075,1361823018659,2244394347,2244397931,3584
1361823029,2244408256,1,46,46,1361823001907,1361823001907,2244381163,2244381163,0
1361823034,2244412840,106,139626,1317.226415,1361823026325,1361823029845,2244405165,2244408685,3520
1361823034,2244412840,56,61313,1094.875,1361823029972,1361823032596,2244408812,2244411436,2624
1361823034,2244412884,3,144,48,1361823029031,1361823029095,2244407915,2244407979,64
1361823034,2244412912,3,144,48,1361823025995,1361823026059,2244404907,2244404971,64
1361823034,2244412928,8,1505,188.125,1361823027003,1361823033019,2244405931,2244411947,6016
1361823034,2244412952,143,195353,1366.104895,1361823022947,1361823026083,2244401899,2244405035,3136
1361823042,2244420892,28,28431,1015.392857,1361823036768,1361823040992,2244415660,2244419884,4224
1361823042,2244420916,28,29525,1054.464286,1361823032710,1361823036550,2244411626,2244415466,3840
1361823045,2244424380,2,473,236.5,1361823018231,1361823018295,2244397611,2244397675,64
1361823049,2244428272,2,265,132.5,1361823021729,1361823021793,2244401001,2244401065,64
1361823049,2244428360,1,46,46,1361823021321,1361823021321,2244400681,2244400681,0
1361823050,2244428976,24,26834,1118.083333,1361823044106,1361823048330,2244423082,2244427306,4224
1361823053,2244432248,13,4445,341.9230769,1361823025721,1361823026297,2244404969,2244405545,576
1361823053,2244432288,7,4631,661.5714286,1361823026641,1361823026705,2244405929,2244405993,64
1361823057,2244436428,1,46,46,1361823031750,1361823031750,2244411178,2244411178,0
1361823058,2244436976,82,101747,1240.817073,1361823051848,1361823055688,2244430824,2244434664,3840
1361823058,2244437016,62,73921,1192.274194,1361823048484,1361823051684,2244427500,2244430700,3200
1361823066,2244444976,104,139520,1341.538462,1361823060362,1361823064266,2244439338,2244443242,3904
1361823066,2244444984,105,142346,1355.67619,1361823055874,1361823060162,2244434858,2244439146,4288
1361823074,2244452904,36,34308,953,1361823064532,1361823068628,2244443436,2244447532,4096
1361823074,2244452976,39,37146,952.4615385,1361823068680,1361823072712,2244447656,2244451688,4032
1361823074,2244452980,11,5698,518,1361823056901,1361823072197,2244435881,2244451177,15296
1361823078,2244457140,1,46,46,1361823062055,1361823062055,2244441195,2244441195,0
1361823078,2244457296,1680,2461220,1465.011905,1361822990537,1361822994185,2244369833,2244373481,3648
1361823079,2244457476,37,53527,1446.675676,1361823077182,1361823077822,2244455658,2244456298,640
1361823079,2244457476,2,123,61.5,1361823072189,1361823072189,2244450665,2244450665,0
1361823079,2244457660,38,36527,961.2368421,1361823073156,1361823076804,2244451816,2244455464,3648
1361823079,2244457996,2,473,236.5,1361823058934,1361823058998,2244437930,2244437994,64
1361823082,2244460804,854,1237873,1449.5,1361823077558,1361823080566,2244456362,2244459370,3008
1361823090,2244468884,26,21993,845.8846154,1361823080487,1361823082279,2244459371,2244461163,1792
1361823090,2244468964,3,144,48,1361823088980,1361823088980,2244467944,2244467944,0
1361823098,2244476860,738,1040679,1410.134146,1361823082559,1361823095295,2244461419,2244474155,12736
1361823102,2244480984,2,265,132.5,1361823077891,1361823078019,2244456875,2244457003,128
1361823107,2244485444,856,1204503,1407.129673,1361823096414,1361823101278,2244474858,2244479722,4864
1361823107,2244485448,207,281362,1359.236715,1361823101339,1361823105179,2244479787,2244483627,3840
1361823111,2244489452,2,639,319.5,1361823085589,1361823085845,2244464041,2244464297,256
1361823114,2244492956,93,114752,1233.892473,1361823108893,1361823110173,2244487849,2244489129,1280
1361823114,2244492960,254,344551,1356.5,1361823110169,1361823111769,2244489129,2244490729,1600
1361823114,2244492964,274,367879,1342.624088,1361823111829,1361823113429,2244490793,2244492393,1600
1361823114,2244493000,756,1068744,1413.68254,1361823104690,1361823108786,2244483690,2244487786,4096
1361823119,2244497536,4,1110,277.5,1361823092672,1361823101632,2244471208,2244480168,8960
1361823122,2244500904,23,9491,412.6521739,1361823114961,1361823116241,2244493865,2244495145,1280
1361823122,2244500944,207,268072,1295.033816,1361823119272,1361823121064,2244498216,2244500008,1792
1361823122,2244500992,145,182683,1259.882759,1361823113466,1361823114810,2244492458,2244493802,1344
1361823122,2244501016,84,94525,1125.297619,1361823116129,1361823117665,2244495145,2244496681,1536
1361823122,2244501024,23,9708,422.0869565,1361823117722,1361823119194,2244496746,2244498218,1472
1361823126,2244505372,2,473,236.5,1361823099004,1361823099068,2244478376,2244478440,64
1361823126,2244505412,10,5262,526.2,1361823100245,1361823100885,2244479657,2244480297,640
1361823130,2244508948,157,202362,1288.929936,1361823124516,1361823125412,2244503464,2244504360,896
1361823130,2244508992,80,98458,1230.725,1361823122811,1361823124411,2244501803,2244503403,1600
1361823130,2244509024,207,281329,1359.077295,1361823120987,1361823122779,2244500011,2244501803,1792
1361823138,2244516956,4,190,47.5,1361823137245,1361823137885,2244516201,2244516841,640
1361823138,2244516956,4,190,47.5,1361823137245,1361823137821,2244516201,2244516777,576
1361823138,2244517036,4,190,47.5,1361823137167,1361823137807,2244516203,2244516843,640
1361823138,2244517036,4,190,47.5,1361823137167,1361823137807,2244516203,2244516843,640
1361823146,2244524948,4,190,47.5,1361823138148,1361823138532,2244517096,2244517480,384
1361823146,2244524948,4,190,47.5,1361823138148,1361823138532,2244517096,2244517480,384
1361823146,2244524952,4,190,47.5,1361823142497,1361823142561,2244521449,2244521513,64
1361823146,2244524952,4,190,47.5,1361823138719,1361823139167,2244517671,2244518119,448
1361823146,2244524956,4,190,47.5,1361823142686,1361823142750,2244521642,2244521706,64
1361823146,2244524956,4,190,47.5,1361823142749,1361823142877,2244521705,2244521833,128
1361823146,2244524956,4,190,47.5,1361823142749,1361823142877,2244521705,2244521833,128
1361823146,2244524956,6,282,47,1361823138972,1361823140060,2244517928,2244519016,1088
1361823146,2244524960,3,169,56.33333333,1361823143002,1361823143002,2244521962,2244521962,0
1361823146,2244524960,4,190,47.5,1361823143001,1361823143385,2244521961,2244522345,384
1361823146,2244524964,4,190,47.5,1361823140246,1361823142678,2244519210,2244521642,2432
1361823146,2244524964,4,190,47.5,1361823140502,1361823142870,2244519466,2244521834,2368
1361823146,2244524988,4,190,47.5,1361823141179,1361823141691,2244520167,2244520679,512
1361823146,2244524988,4,190,47.5,1361823143421,1361823143805,2244522409,2244522793,384
1361823146,2244524988,4,190,47.5,1361823143420,1361823143868,2244522408,2244522856,448
1361823146,2244524992,4,190,47.5,1361823144249,1361823144633,2244523241,2244523625,384
1361823146,2244524996,4,190,47.5,1361823142133,1361823142645,2244521129,2244521641,512
1361823146,2244525000,4,190,47.5,1361823137648,1361823138096,2244516648,2244517096,448
1361823146,2244525000,4,190,47.5,1361823137647,1361823140079,2244516647,2244519079,2432
1361823146,2244525000,4,190,47.5,1361823137839,1361823138415,2244516839,2244517415,576
1361823146,2244525028,4,190,47.5,1361823138454,1361823138902,2244517482,2244517930,448
1361823146,2244525028,4,190,47.5,1361823138453,1361823138901,2244517481,2244517929,448
1361823146,2244525032,4,190,47.5,1361823138258,1361823138642,2244517290,2244517674,384
1361823146,2244525032,4,190,47.5,1361823142482,1361823142994,2244521514,2244522026,512
1361823146,2244525032,4,190,47.5,1361823142481,1361823142609,2244521513,2244521641,128
1361823146,2244525032,4,190,47.5,1361823142481,1361823142609,2244521513,2244521641,128
1361823146,2244525036,4,190,47.5,1361823142607,1361823142671,2244521643,2244521707,64
1361823146,2244525036,4,190,47.5,1361823142798,1361823142862,2244521834,2244521898,64
1361823146,2244525036,4,190,47.5,1361823142734,1361823142798,2244521770,2244521834,64
1361823146,2244525036,4,190,47.5,1361823138893,1361823139277,2244517929,2244518313,384
1361823146,2244525036,4,190,47.5,1361823142796,1361823142860,2244521832,2244521896,64
1361823146,2244525036,5,236,47.2,1361823139084,1361823139980,2244518120,2244519016,896
1361823146,2244525040,4,190,47.5,1361823139275,1361823140171,2244518315,2244519211,896
1361823146,2244525040,4,190,47.5,1361823139275,1361823140171,2244518315,2244519211,896
1361823146,2244525040,4,190,47.5,1361823142922,1361823143306,2244521962,2244522346,384
1361823146,2244525040,4,190,47.5,1361823142986,1361823143370,2244522026,2244522410,384
1361823146,2244525040,4,190,47.5,1361823142986,1361823143370,2244522026,2244522410,384
1361823146,2244525040,4,190,47.5,1361823139976,1361823140424,2244519016,2244519464,448
1361823146,2244525040,4,190,47.5,1361823140040,1361823142408,2244519080,2244521448,2368
1361823146,2244525044,4,190,47.5,1361823140163,1361823140611,2244519207,2244519655,448
1361823146,2244525044,4,190,47.5,1361823140678,1361823141126,2244519722,2244520170,448
1361823146,2244525064,4,190,47.5,1361823143280,1361823143600,2244522344,2244522664,320
1361823146,2244525064,4,190,47.5,1361823141616,1361823142064,2244520680,2244521128,448
1361823146,2244525064,4,190,47.5,1361823143344,1361823143664,2244522408,2244522728,320
1361823146,2244525068,3,144,48,1361823143598,1361823143790,2244522666,2244522858,192
1361823146,2244525068,4,190,47.5,1361823143790,1361823144174,2244522858,2244523242,384
1361823146,2244525068,4,190,47.5,1361823143726,1361823144174,2244522794,2244523242,448
1361823146,2244525068,4,190,47.5,1361823144045,1361823144429,2244523113,2244523497,384
1361823146,2244525068,4,190,47.5,1361823144172,1361823144620,2244523240,2244523688,448
1361823146,2244525324,4,190,47.5,1361823137327,1361823137775,2244516651,2244517099,448
1361823146,2244525368,1,46,46,1361823121857,1361823121857,2244501225,2244501225,0
1361823154,2244533068,4,190,47.5,1361823143726,1361823146094,2244522794,2244525162,2368
1361823155,2244533472,2,123,61.5,1361823129986,1361823129986,2244508458,2244508458,0
1361823159,2244537572,2,265,132.5,1361823134107,1361823134171,2244512679,2244512743,64
1361823167,2244545568,2,473,236.5,1361823139234,1361823139298,2244517802,2244517866,64
1361823170,2244549048,3,144,48,1361823163904,1361823163904,2244542952,2244542952,0
1361823179,2244557488,1,46,46,1361823152751,1361823152751,2244531239,2244531239,0
1361823203,2244581460,2,123,61.5,1361823174925,1361823174925,2244553385,2244553385,0
1361823207,2244585576,2,473,236.5,1361823179736,1361823179800,2244558312,2244558376,64
1361823207,2244585684,2,123,61.5,1361823180331,1361823182571,2244559015,2244561255,2240
1361823215,2244593736,2,265,132.5,1361823189625,1361823189753,2244568361,2244568489,128
1361823235,2244613832,2,92,46,1361823207383,1361823212439,2244586215,2244591271,5056
1361823242,2244621180,3,144,48,1361823238780,1361823238780,2244617960,2244617960,0
1361823247,2244625668,2,473,236.5,1361823219261,1361823219325,2244597929,2244597993,64
1361823247,2244625692,2,123,61.5,1361823219620,1361823219620,2244598312,2244598312,0
1361823259,2244637584,1,46,46,1361823230929,1361823230929,2244609513,2244609513,0
1361823259,2244637588,1,46,46,1361823231180,1361823231180,2244609768,2244609768,0
1361823259,2244637668,1,46,46,1361823234426,1361823234426,2244613094,2244613094,0
1361823266,2244645228,8,451,56.375,1361823264010,1361823265738,2244643238,2244644966,1728
1361823267,2244645828,1,46,46,1361823242461,1361823242461,2244621289,2244621289,0
1361823271,2244649916,2,265,132.5,1361823244677,1361823244741,2244623593,2244623657,64
1361823287,2244665828,2,473,236.5,1361823259163,1361823259227,2244637991,2244638055,64
1361823290,2244669328,4,311,77.75,1361823285735,1361823285799,2244665063,2244665127,64
1361823298,2244677228,3,144,48,1361823294986,1361823295178,2244674214,2244674406,192
1361823298,2244677340,3,144,48,1361823297116,1361823297372,2244676456,2244676712,256
1361823298,2244677364,4,292,73,1361823294531,1361823294659,2244673895,2244674023,128
1361823298,2244677412,3,144,48,1361823297042,1361823297234,2244676454,2244676646,192
1361823299,2244678032,10,4968,496.8,1361823274511,1361823274959,2244653543,2244653991,448
1361823299,2244678044,4,1110,277.5,1361823272258,1361823275010,2244651302,2244654054,2752
1361823303,2244681892,10,5956,595.6,1361823275163,1361823275547,2244654055,2244654439,384
1361823314,2244693288,3,144,48,1361823313681,1361823313681,2244692969,2244692969,0
1361823327,2244705904,2,473,236.5,1361823299278,1361823299342,2244678182,2244678246,64
1361823327,2244706032,2,265,132.5,1361823300301,1361823300429,2244679333,2244679461,128
1361823327,2244706080,1,46,46,1361823302239,1361823302239,2244681319,2244681319,0
1361823330,2244709300,3,144,48,1361823326340,1361823326404,2244705640,2244705704,64
1361823338,2244717272,8,1505,188.125,1361823327324,1361823332380,2244706596,2244711652,5056
1361823338,2244717272,8,1505,188.125,1361823327328,1361823332384,2244706600,2244711656,5056
1361823351,2244730148,14,4007,286.2142857,1361823326617,1361823327001,2244705765,2244706149,384
1361823359,2244737964,1,46,46,1361823332369,1361823332369,2244711333,2244711333,0
1361823367,2244745932,2,473,236.5,1361823339506,1361823339570,2244718438,2244718502,64
1361823367,2244745976,1,46,46,1361823341317,1361823341317,2244720293,2244720293,0
1361823375,2244754036,1,46,46,1361823350473,1361823350473,2244729509,2244729509,0
1361823375,2244754040,1,46,46,1361823350726,1361823350726,2244729766,2244729766,0
1361823379,2244758132,1,46,46,1361823353962,1361823353962,2244733094,2244733094,0
1361823383,2244761968,2,265,132.5,1361823355598,1361823355662,2244734566,2244734630,64
1361823387,2244766040,1,46,46,1361823362311,1361823362311,2244741351,2244741351,0
1361823394,2244773328,3,144,48,1361823388646,1361823388646,2244767974,2244767974,0
1361823399,2244778108,2,123,61.5,1361823372034,1361823372034,2244751142,2244751142,0
1361823407,2244785984,2,473,236.5,1361823379134,1361823379262,2244758118,2244758246,128
1361823419,2244798284,1,46,46,1361823392081,1361823392081,2244771365,2244771365,0
1361823439,2244818236,2,265,132.5,1361823411202,1361823411266,2244790438,2244790502,64
1361823443,2244822272,2,123,61.5,1361823416795,1361823416795,2244796067,2244796067,0
1361823443,2244822344,2,473,236.5,1361823418773,1361823418837,2244798117,2244798181,64
1361823447,2244826264,1,46,46,1361823422054,1361823422054,2244801318,2244801318,0
1361823467,2244845576,3,144,48,1361823464340,1361823464404,2244842916,2244842980,64
1361823479,2244858264,1,46,46,1361823452067,1361823452067,2244831331,2244831331,0
1361823483,2244862308,2,473,236.5,1361823458615,1361823458679,2244837923,2244837987,64
1361823487,2244866332,1,46,46,1361823461023,1361823461023,2244840355,2244840355,0
1361823487,2244866344,2,123,61.5,1361823461652,1361823461652,2244840996,2244840996,0
1361823495,2244874276,2,265,132.5,1361823467030,1361823467094,2244846306,2244846370,64
1361823508,2244886476,2,123,61.5,1361823482102,1361823482934,2244860578,2244861410,832
1361823515,2244893616,8,451,56.375,1361823507308,1361823507884,2244885924,2244886500,576
1361823523,2244901656,2632,3858638,1466.047872,1361823275906,1361823522434,2244654562,2244901090,246528
1361823523,2244902420,2,473,236.5,1361823498246,1361823498310,2244877666,2244877730,64
1361823539,2244918388,1,46,46,1361823514600,1361823514600,2244893988,2244893988,0
1361823539,2244918416,1,46,46,1361823511948,1361823511948,2244891364,2244891364,0
1361823543,2244922340,1,46,46,1361823515096,1361823515096,2244894436,2244894436,0
1361823547,2244925568,3,144,48,1361823539355,1361823539419,2244917923,2244917987,64
1361823547,2244926420,2,265,132.5,1361823522183,1361823522247,2244901603,2244901667,64
1361823568,2244946480,2,473,236.5,1361823540082,1361823540146,2244918562,2244918626,64
1361823568,2244946564,1,46,46,1361823542815,1361823542815,2244921379,2244921379,0
1361823571,2244949648,3,144,48,1361823565708,1361823565836,2244944356,2244944484,128
1361823592,2244970728,8,1121,140.125,1361823565756,1361823565948,2244944484,2244944676,192
1361823600,2244978836,1,46,46,1361823572557,1361823572557,2244951393,2244951393,0
1361823604,2244982800,2,265,132.5,1361823578417,1361823578545,2244957217,2244957345,128
1361823608,2244986696,2,473,236.5,1361823580123,1361823580187,2244958819,2244958883,64
1361823619,2244997708,3,144,48,1361823616908,1361823616972,2244995616,2244995680,64
1361823628,2245006804,1,46,46,1361823602605,1361823602605,2244981409,2244981409,0
1361823635,2245013644,7,1459,208.4285714,1361823628238,1361823633294,2245006882,2245011938,5056
1361823635,2245013644,8,1505,188.125,1361823628237,1361823633293,2245006881,2245011937,5056
1361823636,2245014696,9,2324,258.2222222,1361823610842,1361823628058,2244989538,2245006754,17216
1361823648,2245026916,2,473,236.5,1361823619837,1361823619901,2244998753,2244998817,64
1361823656,2245034920,7,4407,629.5714286,1361823627962,1361823628026,2245006882,2245006946,64
1361823660,2245038832,1,46,46,1361823632594,1361823632594,2245011426,2245011426,0
1361823660,2245038940,1,46,46,1361823635110,1361823635110,2245014050,2245014050,0
1361823660,2245038948,1,46,46,1361823635485,1361823635485,2245014433,2245014433,0
1361823660,2245038984,2,265,132.5,1361823633531,1361823633659,2245012515,2245012643,128
1361823668,2245046900,1,46,46,1361823642254,1361823642254,2245021154,2245021154,0
1361823688,2245066828,2,473,236.5,1361823660246,1361823660374,2245039074,2245039202,128
1361823688,2245066876,1,46,46,1361823662566,1361823662566,2245041442,2245041442,0
1361823691,2245069796,3,144,48,1361823689205,1361823689205,2245068001,2245068001,0
1361823700,2245078888,2,123,61.5,1361823672536,1361823672536,2245051424,2245051424,0
1361823716,2245095056,3,317,105.6666667,1361823689585,1361823689969,2245068641,2245069025,384
1361823720,2245098904,1,46,46,1361823692553,1361823692553,2245071457,2245071457,0
1361823728,2245106876,2,473,236.5,1361823699942,1361823700006,2245078818,2245078882,64
1361823744,2245123188,2,123,61.5,1361823717162,1361823717162,2245096350,2245096350,0
1361823747,2245125840,3,169,56.33333333,1361823744137,1361823744137,2245122977,2245122977,0
1361823748,2245127208,1,46,46,1361823722263,1361823722263,2245101471,2245101471,0
1361823764,2245143192,2,473,236.5,1361823739689,1361823739753,2245118881,2245118945,64
1361823771,2245149856,3,144,48,1361823764086,1361823764150,2245142942,2245143006,64
1361823772,2245151292,2,265,132.5,1361823744451,1361823744579,2245123743,2245123871,128
1361823780,2245159228,1,46,46,1361823752258,1361823752258,2245131486,2245131486,0
1361823788,2245167300,2,123,61.5,1361823761980,1361823761980,2245141280,2245141280,0
1361823808,2245187236,2,473,236.5,1361823780027,1361823780091,2245159263,2245159327,64
1361823808,2245187368,2,123,61.5,1361823782135,1361823782903,2245161503,2245162271,768
1361823811,2245189856,8,451,56.375,1361823807349,1361823808181,2245186205,2245187037,832
1361823828,2245207380,2,265,132.5,1361823799913,1361823799977,2245179293,2245179357,64
1361823841,2245219436,1,46,46,1361823813081,1361823813081,2245191517,2245191517,0
1361823843,2245221864,3,144,48,1361823839085,1361823839085,2245217949,2245217949,0
1361823845,2245223484,2,473,236.5,1361823820584,1361823820648,2245199068,2245199132,64
1361823868,2245247424,1,46,46,1361823842109,1361823842109,2245221533,2245221533,0
1361823881,2245259468,2,265,132.5,1361823856697,1361823856761,2245235165,2245235229,64
1361823884,2245263364,2,473,236.5,1361823859898,1361823859962,2245239262,2245239326,64
1361823891,2245269984,4,1082,270.5,1361823886902,1361823887030,2245265886,2245266014,128
1361823899,2245277864,4,190,47.5,1361823896620,1361823896684,2245275484,2245275548,64
1361823899,2245277864,4,190,47.5,1361823896687,1361823896815,2245275551,2245275679,128
1361823899,2245277864,4,190,47.5,1361823892655,1361823893295,2245271519,2245272159,640
1361823899,2245277864,4,190,47.5,1361823896686,1361823896878,2245275550,2245275742,192
1361823899,2245277868,4,190,47.5,1361823893096,1361823893352,2245271964,2245272220,256
1361823899,2245277868,4,492,123,1361823891115,1361823891179,2245269983,2245270047,64
1361823899,2245277868,4,616,154,1361823893099,1361823893163,2245271967,2245272031,64
1361823899,2245277868,4,190,47.5,1361823893099,1361823895467,2245271967,2245274335,2368
1361823899,2245277868,4,190,47.5,1361823897002,1361823897322,2245275870,2245276190,320
1361823899,2245277868,4,190,47.5,1361823893226,1361823893802,2245272094,2245272670,576
1361823899,2245277868,4,190,47.5,1361823893354,1361823893610,2245272222,2245272478,256
1361823899,2245277868,4,310,77.5,1361823897192,1361823897320,2245276060,2245276188,128
1361823899,2245277868,4,544,136,1361823897192,1361823897320,2245276060,2245276188,128
1361823899,2245277872,4,190,47.5,1361823893604,1361823893860,2245272476,2245272732,256
1361823899,2245277872,4,190,47.5,1361823897255,1361823897703,2245276127,2245276575,448
1361823899,2245277872,4,190,47.5,1361823893670,1361823893926,2245272542,2245272798,256
1361823899,2245277872,4,190,47.5,1361823893925,1361823894181,2245272797,2245273053,256
1361823899,2245277872,4,190,47.5,1361823897381,1361823897765,2245276253,2245276637,384
1361823899,2245277876,4,190,47.5,1361823894433,1361823894689,2245273309,2245273565,256
1361823899,2245277876,4,190,47.5,1361823897760,1361823898144,2245276636,2245277020,384
1361823899,2245277880,4,190,47.5,1361823897760,1361823898208,2245276640,2245277088,448
1361823899,2245277908,4,190,47.5,1361823897985,1361823898433,2245276893,2245277341,448
1361823899,2245277912,4,190,47.5,1361823898108,1361823898556,2245277020,2245277468,448
1361823899,2245277912,4,190,47.5,1361823894910,1361823895166,2245273822,2245274078,256
1361823899,2245277916,4,190,47.5,1361823895416,1361823895672,2245274332,2245274588,256
1361823899,2245277920,4,190,47.5,1361823895412,1361823895668,2245274332,2245274588,256
1361823899,2245277920,4,190,47.5,1361823895798,1361823896246,2245274718,2245275166,448
1361823899,2245277920,4,190,47.5,1361823896117,1361823896245,2245275037,2245275165,128
1361823899,2245277920,4,190,47.5,1361823896244,1361823896756,2245275164,2245275676,512
1361823899,2245277920,4,190,47.5,1361823896308,1361823896564,2245275228,2245275484,256
1361823899,2245277924,4,190,47.5,1361823896627,1361823896755,2245275551,2245275679,128
1361823899,2245277924,4,190,47.5,1361823892595,1361823893107,2245271519,2245272031,512
1361823899,2245277924,4,190,47.5,1361823892595,1361823893171,2245271519,2245272095,576
1361823899,2245277940,4,190,47.5,1361823896802,1361823897186,2245275742,2245276126,384
1361823899,2245277940,4,190,47.5,1361823896864,1361823897312,2245275804,2245276252,448
1361823899,2245277944,4,190,47.5,1361823896861,1361823897309,2245275805,2245276253,448
1361823899,2245277948,4,190,47.5,1361823897304,1361823897688,2245276252,2245276636,384
1361823899,2245277952,4,190,47.5,1361823897303,1361823897751,2245276255,2245276703,448
1361823899,2245277952,4,190,47.5,1361823893846,1361823896150,2245272798,2245275102,2304
1361823899,2245277956,4,190,47.5,1361823894096,1361823894352,2245273052,2245273308,256
1361823899,2245277956,4,190,47.5,1361823897555,1361823897939,2245276511,2245276895,384
1361823899,2245277980,4,190,47.5,1361823894584,1361823894840,2245273564,2245273820,256
1361823899,2245277980,4,190,47.5,1361823894584,1361823894840,2245273564,2245273820,256
1361823899,2245277984,4,190,47.5,1361823898039,1361823898487,2245277023,2245277471,448
1361823899,2245277984,4,190,47.5,1361823894839,1361823895095,2245273823,2245274079,256
1361823899,2245277988,4,190,47.5,1361823895091,1361823895347,2245274079,2245274335,256
1361823899,2245277988,4,190,47.5,1361823895600,1361823895856,2245274588,2245274844,256
1361823899,2245277988,4,190,47.5,1361823895088,1361823895344,2245274076,2245274332,256
1361823899,2245277992,4,190,47.5,1361823895724,1361823896172,2245274716,2245275164,448
1361823899,2245277992,4,190,47.5,1361823895983,1361823896431,2245274975,2245275423,448
1361823899,2245277992,4,190,47.5,1361823895342,1361823895598,2245274334,2245274590,256
1361823899,2245277992,4,190,47.5,1361823896173,1361823896685,2245275165,2245275677,512
1361823899,2245277996,4,190,47.5,1361823896171,1361823896235,2245275167,2245275231,64
1361823899,2245277996,4,190,47.5,1361823896235,1361823896363,2245275231,2245275359,128
1361823899,2245277996,4,190,47.5,1361823896363,1361823896555,2245275359,2245275551,192
1361823901,2245279616,4,190,47.5,1361823896871,1361823896999,2245275487,2245275615,128
1361823901,2245279624,1,46,46,1361823872925,1361823872925,2245251549,2245251549,0
1361823907,2245285908,4,190,47.5,1361823897728,1361823900160,2245276636,2245279068,2432
1361823915,2245293888,4,414,103.5,1361823909205,1361823909269,2245288093,2245288157,64
1361823915,2245293892,4,311,77.75,1361823913234,1361823913298,2245292126,2245292190,64
1361823915,2245293928,3,144,48,1361823914031,1361823914031,2245292959,2245292959,0
1361823915,2245293960,4,572,143,1361823909133,1361823909197,2245288093,2245288157,64
1361823921,2245299760,2,104,52,1361823895765,1361823895765,2245274525,2245274525,0
1361823923,2245302076,4,311,77.75,1361823919066,1361823919130,2245298142,2245298206,64
1361823925,2245303800,2,473,236.5,1361823900459,1361823900587,2245279259,2245279387,128
1361823929,2245307828,1,46,46,1361823902739,1361823902739,2245281567,2245281567,0
1361823931,2245309896,4,311,77.75,1361823925262,1361823925390,2245304158,2245304286,128
1361823931,2245309896,3,144,48,1361823923405,1361823926669,2245302301,2245305565,3264
1361823931,2245309900,4,376,94,1361823929291,1361823929419,2245308191,2245308319,128
1361823931,2245309976,3,144,48,1361823924989,1361823925053,2245303965,2245304029,64
1361823937,2245315816,2,265,132.5,1361823912028,1361823912156,2245290844,2245290972,128
1361823939,2245317908,4,722,180.5,1361823931329,1361823931393,2245310237,2245310301,64
1361823939,2245317952,8,544,68,1361823927189,1361823933205,2245306141,2245312157,6016
1361823939,2245317988,4,628,157,1361823937266,1361823937330,2245316254,2245316318,64
1361823947,2245325984,4,376,94,1361823943283,1361823943411,2245322267,2245322395,128
1361823953,2245331764,47,45269,963.1702128,1361823925267,1361823928211,2245304031,2245306975,2944
1361823953,2245331808,10,7000,700,1361823927331,1361823927459,2245306139,2245306267,128
1361823953,2245331808,10,7560,756,1361823927331,1361823927459,2245306139,2245306267,128
1361823953,2245331812,9,5931,659,1361823927327,1361823927455,2245306139,2245306267,128
1361823953,2245331912,16,14142,883.875,1361823926973,1361823927293,2245305885,2245306205,320
1361823953,2245331912,16,17584,1099,1361823926972,1361823927484,2245305884,2245306396,512
1361823953,2245331916,8,5843,730.375,1361823927225,1361823927353,2245306141,2245306269,128
1361823953,2245331916,7,3670,524.2857143,1361823927225,1361823927289,2245306141,2245306205,64
1361823955,2245334036,4,515,128.75,1361823949314,1361823949378,2245328350,2245328414,64
1361823955,2245334036,4,460,115,1361823949313,1361823949377,2245328349,2245328413,64
1361823961,2245339820,1,46,46,1361823932889,1361823932889,2245311709,2245311709,0
1361823963,2245341924,4,376,94,1361823957424,1361823957552,2245336348,2245336476,128
1361823963,2245341928,4,311,77.75,1361823961453,1361823961581,2245340381,2245340509,128
1361823963,2245342004,4,311,77.75,1361823955359,1361823955487,2245334363,2245334491,128
1361823965,2245343900,2,473,236.5,1361823939912,1361823939976,2245318812,2245318876,64
1361823971,2245350032,4,413,103.25,1361823965379,1361823965443,2245344411,2245344475,64
1361823971,2245350100,4,628,157,1361823967360,1361823967424,2245346460,2245346524,64
1361823989,2245367884,1,46,46,1361823962713,1361823962713,2245341597,2245341597,0
1361823993,2245371960,2,265,132.5,1361823967629,1361823967693,2245346589,2245346653,64
1361823995,2245373932,3,144,48,1361823988970,1361823989034,2245367902,2245367966,64
1361823995,2245373936,4,413,103.25,1361823989603,1361823989731,2245368539,2245368667,128
1361823995,2245374016,4,292,73,1361823989524,1361823989652,2245368540,2245368668,128
1361823997,2245375880,2,123,61.5,1361823972382,1361823972382,2245351262,2245351262,0
1361824005,2245383844,2,473,236.5,1361823980162,1361823980226,2245359006,2245359070,64
1361824011,2245390000,4,452,113,1361824003682,1361824003746,2245382682,2245382746,64
1361824017,2245395976,1,46,46,1361823992636,1361823992636,2245371612,2245371612,0
1361824019,2245398020,4,698,174.5,1361824013711,1361824013775,2245392731,2245392795,64
1361824019,2245398064,4,432,108,1361824015652,1361824015780,2245394716,2245394844,128
1361824027,2245405996,4,617,154.25,1361824019753,1361824019817,2245398749,2245398813,64
1361824027,2245406048,4,292,73,1361824021750,1361824021814,2245400798,2245400862,64
1361824045,2245424180,2,123,61.5,1361824017009,1361824017009,2245396189,2245396189,0
1361824045,2245424244,2,473,236.5,1361824019887,1361824019951,2245399131,2245399195,64
1361824049,2245428072,1,46,46,1361824022556,1361824022556,2245401628,2245401628,0
1361824049,2245428160,2,265,132.5,1361824022916,1361824023044,2245402076,2245402204,128
1361824051,2245429952,3,169,56.33333333,1361824043220,1361824043220,2245422172,2245422172,0
1361824051,2245429952,3,169,56.33333333,1361824043220,1361824043220,2245422172,2245422172,0
1361824051,2245429952,3,169,56.33333333,1361824043219,1361824043219,2245422171,2245422171,0
1361824051,2245429952,3,169,56.33333333,1361824043219,1361824043219,2245422171,2245422171,0
1361824051,2245429952,3,169,56.33333333,1361824043219,1361824043219,2245422171,2245422171,0
1361824051,2245429960,4,310,77.5,1361824045965,1361824046029,2245424925,2245424989,64
1361824051,2245429968,4,311,77.75,1361824049989,1361824050053,2245428957,2245429021,64
1361824051,2245429992,4,813,203.25,1361824043884,1361824044012,2245422876,2245423004,128
1361824051,2245430036,3,169,56.33333333,1361824043135,1361824043135,2245422171,2245422171,0
1361824051,2245430036,4,215,53.75,1361824043135,1361824043135,2245422171,2245422171,0
1361824059,2245437976,6,1030,171.6666667,1361824054013,1361824054077,2245432989,2245433053,64
1361824059,2245438084,3,144,48,1361824051919,1361824051919,2245431003,2245431003,0
1361824067,2245446116,4,310,77.5,1361824065903,1361824066031,2245445019,2245445147,128
1361824067,2245446120,4,292,73,1361824059884,1361824059948,2245439004,2245439068,64
1361824073,2245452092,3,685,228.3333333,1361824045639,1361824045895,2245424731,2245424987,256
1361824075,2245454044,4,376,94,1361824068023,1361824068151,2245447067,2245447195,128
1361824077,2245456248,1,46,46,1361824052396,1361824052396,2245431644,2245431644,0
1361824083,2245462016,4,310,77.5,1361824082132,1361824082196,2245461148,2245461212,64
1361824083,2245462072,4,376,94,1361824076058,1361824076122,2245455130,2245455194,64
1361824083,2245462088,4,414,103.5,1361824076042,1361824076106,2245455130,2245455194,64
1361824083,2245462088,4,460,115,1361824082057,1361824082121,2245461145,2245461209,64
1361824085,2245464128,4,1237,309.25,1361824060068,1361824075236,2245439196,2245454364,15168
1361824091,2245470040,4,311,77.75,1361824088124,1361824088188,2245467164,2245467228,64
1361824099,2245478124,4,376,94,1361824098085,1361824098213,2245477209,2245477337,128
1361824105,2245484136,2,265,132.5,1361824078619,1361824078747,2245457755,2245457883,128
1361824107,2245486056,4,699,174.75,1361824104234,1361824104298,2245483290,2245483354,64
1361824107,2245486088,4,292,73,1361824102154,1361824102282,2245481242,2245481370,128
1361824109,2245488264,2,123,61.5,1361824082393,1361824085785,2245461657,2245465049,3392
1361824115,2245494036,275,378086,1374.858182,1361823926848,1361824114752,2245305884,2245493788,187904
1361824115,2245494076,4,544,136,1361824110231,1361824110295,2245489307,2245489371,64
1361824115,2245494112,4,414,103.5,1361824112241,1361824112305,2245491353,2245491417,64
1361824117,2245496144,2,123,61.5,1361824089939,1361824089939,2245469083,2245469083,0
1361824131,2245510040,3,144,48,1361824123900,1361824123900,2245502940,2245502940,0
1361824137,2245516312,1,46,46,1361824112362,1361824112362,2245491674,2245491674,0
1361824141,2245520320,2,473,236.5,1361824114980,1361824115044,2245494300,2245494364,64
1361824161,2245540268,2,123,61.5,1361824134741,1361824134741,2245514009,2245514009,0
1361824161,2245540352,2,265,132.5,1361824133891,1361824134019,2245513243,2245513371,128
1361824163,2245542184,4,515,128.75,1361824160427,1361824160555,2245539611,2245539739,128
1361824169,2245548372,1,46,46,1361824142318,1361824142318,2245521690,2245521690,0
1361824171,2245550128,4,720,180,1361824168547,1361824168611,2245547675,2245547739,64
1361824179,2245558096,2,114,57,1361824176640,1361824176640,2245555736,2245555736,0
1361824179,2245558140,4,413,103.25,1361824178134,1361824178262,2245557274,2245557402,128
1361824181,2245560408,2,473,236.5,1361824155211,1361824155275,2245534619,2245534683,64
1361824187,2245566120,4,413,103.25,1361824180649,1361824180713,2245559769,2245559833,64
1361824195,2245574096,4,312,78,1361824191874,1361824192002,2245570970,2245571098,128
1361824195,2245574096,4,312,78,1361824192002,1361824192066,2245571098,2245571162,64
1361824195,2245574096,4,312,78,1361824192065,1361824192129,2245571161,2245571225,64
1361824195,2245574176,4,503,125.75,1361824188593,1361824188721,2245567769,2245567897,128
1361824195,2245574180,4,312,78,1361824191726,1361824191790,2245570906,2245570970,64
1361824195,2245574180,4,312,78,1361824191853,1361824191917,2245571033,2245571097,64
1361824197,2245576372,1,46,46,1361824172333,1361824172333,2245551705,2245551705,0
1361824203,2245582180,5,1538,307.6,1361824198699,1361824198827,2245577879,2245578007,128
1361824203,2245582180,3,144,48,1361824198766,1361824198766,2245577946,2245577946,0
1361824203,2245582188,4,501,125.25,1361824196643,1361824196771,2245575831,2245575959,128
1361824206,2245584552,2,123,61.5,1361824180384,1361824180384,2245558936,2245558936,0
1361824211,2245590180,4,578,144.5,1361824208747,1361824208811,2245587927,2245587991,64
1361824218,2245596496,2,265,132.5,1361824190041,1361824190105,2245568537,2245568601,64
1361824218,2245596544,3,1176,392,1361824192169,1361824192233,2245570713,2245570777,64
1361824218,2245596656,14,13703,978.7857143,1361824192186,1361824192698,2245570842,2245571354,512
1361824219,2245598104,4,310,77.5,1361824214841,1361824214905,2245593945,2245594009,64
1361824222,2245600572,2,473,236.5,1361824196815,1361824196879,2245575387,2245575451,64
1361824227,2245606164,4,310,77.5,1361824225534,1361824225598,2245604698,2245604762,64
1361824227,2245606208,8,451,56.375,1361824224657,1361824226577,2245603865,2245605785,1920
1361824230,2245608688,1,46,46,1361824203034,1361824203034,2245581722,2245581722,0
1361824235,2245614096,3,144,48,1361824227967,1361824228031,2245607063,2245607127,64
1361824235,2245614208,8,1505,188.125,1361824228624,1361824233744,2245607832,2245612952,5120
1361824243,2245622076,5,1498,299.6,1361824238996,1361824239188,2245618072,2245618264,192
1361824243,2245622116,4,807,201.75,1361824241004,1361824241068,2245620120,2245620184,64
1361824250,2245628596,2,765,382.5,1361824223926,1361824224054,2245602522,2245602650,128
1361824251,2245630072,4,414,103.5,1361824247066,1361824247194,2245626138,2245626266,128
1361824254,2245632716,10,2177,217.7,1361824228411,1361824228795,2245607127,2245607511,384
1361824258,2245636724,1,46,46,1361824233011,1361824233011,2245611735,2245611735,0
1361824259,2245638224,4,540,135,1361824256959,1361824257087,2245636183,2245636311,128
1361824270,2245648796,2,265,132.5,1361824245162,1361824245290,2245623958,2245624086,128
1361824275,2245654068,3,144,48,1361824273885,1361824273885,2245652953,2245652953,0
1361824275,2245654116,4,731,182.75,1361824273197,1361824273261,2245652313,2245652377,64
1361824275,2245654144,5,1038,207.6,1361824267154,1361824267218,2245646298,2245646362,64
1361824283,2245662188,4,532,133,1361824281188,1361824281252,2245660376,2245660440,64
1361824290,2245668620,2,473,236.5,1361824264347,1361824264411,2245642967,2245643031,64
1361824290,2245668692,1,46,46,1361824263060,1361824263060,2245641752,2245641752,0
1361824298,2245676664,2,123,61.5,1361824273201,1361824273201,2245651865,2245651865,0
1361824299,2245678104,4,693,173.25,1361824291319,1361824291383,2245670423,2245670487,64
1361824299,2245678220,4,612,153,1361824295235,1361824295299,2245674455,2245674519,64
1361824307,2245686084,4,723,180.75,1361824301387,1361824301515,2245680471,2245680599,128
1361824315,2245694212,4,311,77.75,1361824306763,1361824306891,2245685975,2245686103,128
1361824315,2245694212,4,472,118,1361824306763,1361824306891,2245685975,2245686103,128
1361824318,2245696908,1,46,46,1361824292861,1361824292861,2245671769,2245671769,0
1361824326,2245704852,2,265,132.5,1361824300468,1361824300532,2245679320,2245679384,64
1361824330,2245708768,2,473,236.5,1361824304521,1361824304585,2245683289,2245683353,64
1361824334,2245712748,1,46,46,1361824308187,1361824308187,2245686935,2245686935,0
1361824334,2245712864,1,46,46,1361824307112,1361824307112,2245685976,2245685976,0
1361824346,2245724840,2,123,61.5,1361824317951,1361824317951,2245696791,2245696791,0
1361824350,2245728768,1,46,46,1361824323015,1361824323015,2245701783,2245701783,0
1361824355,2245734224,3,144,48,1361824348737,1361824348737,2245727961,2245727961,0
1361824370,2245748996,2,473,236.5,1361824343715,1361824343779,2245722711,2245722775,64
1361824378,2245756992,1,46,46,1361824352806,1361824352806,2245731798,2245731798,0
1361824379,2245758260,7,2075,296.4285714,1361824377690,1361824377818,2245756950,2245757078,128
1361824382,2245761196,2,265,132.5,1361824355994,1361824356122,2245735190,2245735318,128
1361824390,2245769088,2,123,61.5,1361824362630,1361824362630,2245741718,2245741718,0
1361824395,2245774212,7,2539,362.7142857,1361824387340,1361824387468,2245766552,2245766680,128
1361824395,2245774284,4,880,220,1361824389698,1361824389826,2245768982,2245769110,128
1361824395,2245774288,4,716,179,1361824393728,1361824393856,2245773016,2245773144,128
1361824410,2245789188,3,169,56.33333333,1361824382562,1361824408290,2245761750,2245787478,25728
1361824410,2245789224,2,473,236.5,1361824383679,1361824383743,2245762903,2245762967,64
1361824411,2245790292,7,405,57.85714286,1361824407355,1361824408699,2245786647,2245787991,1344
1361824411,2245790292,4,722,180.5,1361824403835,1361824403899,2245783127,2245783191,64
1361824418,2245797136,1,46,46,1361824389974,1361824389974,2245769110,2245769110,0
1361824427,2245806340,3,144,48,1361824423563,1361824423627,2245802903,2245802967,64
1361824435,2245814232,4,513,128.25,1361824430007,1361824430135,2245809239,2245809367,128
1361824438,2245817172,2,265,132.5,1361824411891,1361824411955,2245791063,2245791127,64
1361824438,2245817184,1,46,46,1361824412582,1361824412582,2245791766,2245791766,0
1361824450,2245829184,2,473,236.5,1361824423975,1361824424039,2245803159,2245803223,64
1361824470,2245849196,1,46,46,1361824442587,1361824442587,2245821783,2245821783,0
1361824490,2245869212,2,473,236.5,1361824463944,1361824464008,2245843156,2245843220,64
1361824494,2245873204,2,265,132.5,1361824467472,1361824467536,2245846676,2245846740,64
1361824498,2245877348,1,46,46,1361824472449,1361824472449,2245851797,2245851797,0
1361824499,2245878352,3,144,48,1361824498556,1361824498620,2245877908,2245877972,64
1361824531,2245909624,1,46,46,1361824503186,1361824503186,2245881810,2245881810,0
1361824531,2245909632,2,473,236.5,1361824504205,1361824504269,2245882837,2245882901,64
1361824531,2245910396,3,144,48,1361824525712,1361824525776,2245905108,2245905172,64
1361824539,2245918336,7,1406,200.8571429,1361824528844,1361824533900,2245908180,2245913236,5056
1361824551,2245929512,2,265,132.5,1361824523843,1361824523971,2245902355,2245902483,128
1361824551,2245929624,13,2865,220.3846154,1361824526549,1361824529173,2245905173,2245907797,2624
1361824559,2245937604,1,46,46,1361824533286,1361824533286,2245911890,2245911890,0
1361824571,2245949500,2,473,236.5,1361824544336,1361824544400,2245922836,2245922900,64
1361824579,2245958372,3,144,48,1361824573545,1361824573609,2245952917,2245952981,64
1361824591,2245969508,1,46,46,1361824563337,1361824563337,2245941845,2245941845,0
1361824599,2245977568,2,123,61.5,1361824574221,1361824574221,2245952789,2245952789,0
1361824607,2245985584,2,265,132.5,1361824579002,1361824579130,2245957586,2245957714,128
1361824611,2245989636,2,473,236.5,1361824584904,1361824584968,2245963540,2245963604,64
1361824619,2245997520,1,46,46,1361824593338,1361824593338,2245971858,2245971858,0
1361824647,2246025604,2,123,61.5,1361824619176,1361824619176,2245997780,2245997780,0
1361824651,2246029576,2,473,236.5,1361824625411,1361824625539,2246003987,2246004115,128
1361824651,2246029640,1,46,46,1361824623232,1361824623232,2246001872,2246001872,0
1361824652,2246030512,3,144,48,1361824649411,1361824649475,2246027923,2246027987,64
1361824663,2246041544,2,265,132.5,1361824634851,1361824634979,2246013395,2246013523,128
1361824679,2246058004,1,46,46,1361824652885,1361824652885,2246031889,2246031889,0
1361824691,2246070084,2,123,61.5,1361824663556,1361824663556,2246042640,2246042640,0
1361824691,2246070124,2,473,236.5,1361824665180,1361824665244,2246044304,2246044368,64
1361824711,2246090020,2,123,61.5,1361824682885,1361824690181,2246061905,2246069201,7296
1361824715,2246094116,2,265,132.5,1361824690406,1361824690470,2246069522,2246069586,64
1361824716,2246094508,8,451,56.375,1361824709060,1361824709444,2246087568,2246087952,384
1361824731,2246110076,2,473,236.5,1361824704525,1361824704589,2246083601,2246083665,64
1361824732,2246110428,3,144,48,1361824724502,1361824724502,2246102930,2246102930,0
1361824739,2246118008,1,46,46,1361824712913,1361824712913,2246091921,2246091921,0
1361824771,2246149972,1,46,46,1361824742966,1361824742966,2246121938,2246121938,0
1361824771,2246150108,2,473,236.5,1361824745262,1361824745326,2246124370,2246124434,64
1361824771,2246150136,2,265,132.5,1361824745873,1361824745937,2246125009,2246125073,64
1361824788,2246166548,3,144,48,1361824784412,1361824784412,2246162960,2246162960,0
1361824788,2246166612,4,498,124.5,1361824782812,1361824782876,2246161424,2246161488,64
1361824799,2246178208,1,46,46,1361824772744,1361824772744,2246151952,2246151952,0
1361824811,2246190204,2,473,236.5,1361824784588,1361824784588,2246163792,2246163792,0
1361824827,2246206324,1,46,46,1361824802645,1361824802645,2246181969,2246181969,0
1361824827,2246206372,2,265,132.5,1361824800867,1361824800931,2246180239,2246180303,64
1361824836,2246214772,3,144,48,1361824829052,1361824829180,2246207824,2246207952,128
1361824836,2246214784,7,1459,208.4285714,1361824830255,1361824835375,2246209039,2246214159,5120
1361824852,2246230472,2,473,236.5,1361824825639,1361824825703,2246204111,2246204175,64
1361824856,2246234592,12,2337,194.75,1361824829359,1361824830191,2246207951,2246208783,832
1361824860,2246238616,1,46,46,1361824833368,1361824833368,2246211984,2246211984,0
1361824868,2246246744,5,808,161.6,1361824859737,1361824860569,2246238481,2246239313,832
1361824868,2246246832,15,5833,388.8666667,1361824859775,1361824860479,2246238607,2246239311,704
1361824868,2246246872,3,144,48,1361824861717,1361824861781,2246240589,2246240653,64
1361824868,2246246872,4,312,78,1361824861784,1361824861848,2246240656,2246240720,64
1361824884,2246262720,2,265,132.5,1361824857456,1361824857520,2246236176,2246236240,64
1361824888,2246266504,1,46,46,1361824863494,1361824863494,2246241998,2246241998,0
1361824892,2246270476,2,473,236.5,1361824865828,1361824865892,2246244304,2246244368,64
1361824900,2246278576,2,123,61.5,1361824874559,1361824874559,2246253135,2246253135,0
1361824900,2246278840,11,5601,509.1818182,1361824878584,1361824894008,2246257424,2246272848,15424
1361824920,2246298504,1,46,46,1361824893509,1361824893509,2246272013,2246272013,0
1361824924,2246302800,3,144,48,1361824919133,1361824919133,2246297933,2246297933,0
1361824932,2246310584,2,473,236.5,1361824905975,1361824906039,2246284559,2246284623,64
1361824940,2246318464,2,265,132.5,1361824913196,1361824913324,2246291660,2246291788,128
1361824944,2246322680,2,123,61.5,1361824919384,1361824919384,2246298064,2246298064,0
1361824948,2246326648,1,46,46,1361824923383,1361824923383,2246302031,2246302031,0
1361824972,2246350820,2,473,236.5,1361824945865,1361824945929,2246324685,2246324749,64
1361824980,2246358696,1,46,46,1361824953351,1361824953351,2246332047,2246332047,0
1361824992,2246370756,2,123,61.5,1361824964233,1361824964233,2246342989,2246342989,0
1361824996,2246374972,2,265,132.5,1361824968623,1361824968751,2246347595,2246347723,128
1361824996,2246375104,3,144,48,1361824993836,1361824993836,2246372940,2246372940,0
1361825008,2246386944,2,123,61.5,1361824983115,1361824992011,2246362059,2246370955,8896
1361825012,2246390832,2,473,236.5,1361824986430,1361824986494,2246365262,2246365326,64
1361825032,2246410844,3,685,228.3333333,1361825006577,1361825006833,2246385421,2246385677,256
1361825040,2246418792,1,46,46,1361825013285,1361825013285,2246392077,2246392077,0
1361825052,2246430864,2,473,236.5,1361825026525,1361825026589,2246405389,2246405453,64
1361825052,2246430880,2,265,132.5,1361825024268,1361825024332,2246403148,2246403212,64
1361825068,2246446892,1,46,46,1361825043200,1361825043200,2246422092,2246422092,0
1361825076,2246455008,2,123,61.5,1361825050829,1361825050829,2246429837,2246429837,0
1361825076,2246455188,3,144,48,1361825068824,1361825068824,2246448012,2246448012,0
1361825092,2246470952,2,473,236.5,1361825065860,1361825065924,2246444812,2246444876,64
1361825100,2246479032,1,46,46,1361825073076,1361825073076,2246452108,2246452108,0
1361825104,2246483108,2,265,132.5,1361825079529,1361825079657,2246458637,2246458765,128
1361825120,2246499088,2,123,61.5,1361825095677,1361825095677,2246474765,2246474765,0
1361825128,2246507056,1,46,46,1361825103067,1361825103067,2246482123,2246482123,0
1361825132,2246510980,2,473,236.5,1361825106281,1361825106345,2246485261,2246485325,64
1361825132,2246511400,8,1452,181.5,1361825130117,1361825130885,2246509517,2246510285,768
1361825141,2246519700,10,1597,159.7,1361825130816,1361825135936,2246509516,2246514636,5120
1361825141,2246519724,10,1597,159.7,1361825131113,1361825136937,2246509837,2246515661,5824
1361825149,2246527632,3,144,48,1361825144324,1361825144324,2246522956,2246522956,0
1361825156,2246535384,8,4038,504.75,1361825130451,1361825131155,2246509835,2246510539,704
1361825157,2246535468,6,1869,311.5,1361825130216,1361825130600,2246508684,2246509068,384
1361825160,2246539248,1,46,46,1361825132892,1361825132892,2246512140,2246512140,0
1361825160,2246539308,2,265,132.5,1361825134430,1361825134558,2246513738,2246513866,128
1361825172,2246551256,2,473,236.5,1361825145491,1361825145555,2246524747,2246524811,64
1361825189,2246567548,1,46,46,1361825163607,1361825163607,2246542155,2246542155,0
1361825201,2246579468,2,123,61.5,1361825175206,1361825175206,2246553674,2246553674,0
1361825212,2246591360,2,473,236.5,1361825185963,1361825186027,2246565323,2246565387,64
1361825217,2246595500,2,265,132.5,1361825190854,1361825190982,2246569354,2246569482,128
1361825220,2246599332,1,46,46,1361825192838,1361825192838,2246572170,2246572170,0
1361825221,2246599664,2,92,46,1361825213730,1361825213794,2246592394,2246592458,64
1361825221,2246599712,3,144,48,1361825219186,1361825219250,2246597898,2246597962,64
1361825245,2246623596,2,123,61.5,1361825220004,1361825220004,2246598600,2246598600,0
1361825249,2246627596,1,46,46,1361825223590,1361825223590,2246602186,2246602186,0
1361825253,2246631680,2,473,236.5,1361825226448,1361825226512,2246605128,2246605192,64
1361825273,2246651488,2,265,132.5,1361825246545,1361825246609,2246625033,2246625097,64
1361825281,2246659592,1,46,46,1361825253610,1361825253610,2246632202,2246632202,0
1361825285,2246663880,3,144,48,1361825279048,1361825279112,2246657928,2246657992,64
1361825293,2246671508,2,473,236.5,1361825266620,1361825266684,2246645128,2246645192,64
1361825293,2246671552,2,123,61.5,1361825264975,1361825264975,2246643527,2246643527,0
1361825309,2246687884,2,123,61.5,1361825283331,1361825293699,2246662215,2246672583,10368
1361825317,2246696000,8,451,56.375,1361825309519,1361825310543,2246688519,2246689543,1024
1361825329,2246707716,2,265,132.5,1361825302379,1361825302507,2246681095,2246681223,128
1361825333,2246711828,2,473,236.5,1361825306043,1361825306107,2246684871,2246684935,64
1361825341,2246719804,1,46,46,1361825313427,1361825313427,2246692231,2246692231,0
1361825357,2246736124,3,144,48,1361825353813,1361825353813,2246732937,2246732937,0
1361825369,2246747920,1,46,46,1361825343264,1361825343264,2246722184,2246722184,0
1361825373,2246751756,2,473,236.5,1361825345988,1361825346052,2246724744,2246724808,64
1361825385,2246763916,2,265,132.5,1361825358051,1361825358179,2246736967,2246737095,128
1361825401,2246779940,1,46,46,1361825373258,1361825373258,2246752198,2246752198,0
1361825413,2246791908,2,473,236.5,1361825386154,1361825386218,2246765062,2246765126,64
1361825429,2246807864,1,46,46,1361825403353,1361825403353,2246782217,2246782217,0
1361825429,2246808140,3,144,48,1361825428803,1361825428803,2246807943,2246807943,0
1361825437,2246816164,3,144,48,1361825430057,1361825430121,2246809221,2246809285,64
1361825437,2246816200,6,1360,226.6666667,1361825430920,1361825436040,2246810120,2246815240,5120
1361825441,2246819816,2,265,132.5,1361825413893,1361825414021,2246792709,2246792837,128
1361825453,2246832320,2,473,236.5,1361825425616,1361825425680,2246804936,2246805000,64
1361825457,2246836228,14,3991,285.0714286,1361825430057,1361825430505,2246809285,2246809733,448
1361825461,2246840320,1,46,46,1361825432909,1361825432909,2246812229,2246812229,0
1361825462,2246840508,4,312,78,1361825460474,1361825460538,2246838982,2246839046,64
1361825462,2246840508,5,688,137.6,1361825460665,1361825460729,2246839173,2246839237,64
1361825462,2246840524,4,312,78,1361825460713,1361825460777,2246839237,2246839301,64
1361825462,2246840524,4,312,78,1361825460969,1361825461033,2246839493,2246839557,64
1361825462,2246840528,5,579,115.8,1361825460904,1361825460968,2246839432,2246839496,64
1361825470,2246848488,16,11689,730.5625,1361825466128,1361825466448,2246844616,2246844936,320
1361825478,2246856576,18,15516,862,1361825471031,1361825471351,2246849607,2246849927,320
1361825478,2246856580,28,22230,793.9285714,1361825475057,1361825475313,2246853637,2246853893,256
1361825485,2246864184,3,609,203,1361825459733,1361825459733,2246838917,2246838917,0
1361825485,2246864360,5,2103,420.6,1361825459236,1361825459300,2246838596,2246838660,64
1361825486,2246864444,24,23176,965.6666667,1361825481722,1361825482298,2246860166,2246860742,576
1361825486,2246864460,43,51187,1190.395349,1361825483049,1361825483625,2246861509,2246862085,576
1361825486,2246864492,26,25984,999.3846154,1361825480392,1361825480968,2246858884,2246859460,576
1361825486,2246864500,118,163433,1385.025424,1361825484420,1361825485188,2246862920,2246863688,768
1361825486,2246864524,27,22152,820.4444444,1361825477739,1361825477995,2246856263,2246856519,256
1361825489,2246868172,1,46,46,1361825463072,1361825463072,2246842244,2246842244,0
1361825493,2246872232,2,473,236.5,1361825465575,1361825465639,2246844807,2246844871,64
1361825494,2246872440,290,420220,1449.034483,1361825485759,1361825486719,2246864199,2246865159,960
1361825494,2246872584,573,844051,1473.038394,1361825487087,1361825489071,2246865671,2246867655,1984
1361825494,2246872636,1170,1732706,1480.945299,1361825489020,1361825492604,2246867656,2246871240,3584
1361825494,2246872640,3,144,48,1361825491956,1361825492020,2246870596,2246870660,64
1361825497,2246876276,2,265,132.5,1361825468986,1361825469114,2246848262,2246848390,128
1361825501,2246880204,5,808,161.6,1361825474752,1361825486592,2246853956,2246865796,11840
1361825502,2246880548,1629,2419302,1485.145488,1361825495824,1361825500368,2246874372,2246878916,4544
1361825502,2246880584,1114,1645594,1477.193896,1361825492653,1361825495725,2246871237,2246874309,3072
1361825510,2246888492,4,395,98.75,1361825502601,1361825502729,2246881093,2246881221,128
1361825510,2246888504,4,292,73,1361825503484,1361825503548,2246881988,2246882052,64
1361825510,2246888528,4,446,111.5,1361825503847,1361825503975,2246882375,2246882503,128
1361825510,2246888528,4,292,73,1361825504039,1361825504167,2246882567,2246882695,128
1361825510,2246888528,4,444,111,1361825504356,1361825504420,2246882884,2246882948,64
1361825510,2246888532,3,144,48,1361825507427,1361825507683,2246885959,2246886215,256
1361825510,2246888532,4,292,73,1361825504547,1361825504611,2246883079,2246883143,64
1361825510,2246888540,615,905901,1473.009756,1361825500378,1361825502170,2246878918,2246880710,1792
1361825510,2246888620,3,144,48,1361825507337,1361825507593,2246885957,2246886213,256
1361825521,2246900176,1,46,46,1361825493087,1361825493087,2246872263,2246872263,0
1361825533,2246912356,2,473,236.5,1361825505896,1361825505960,2246885252,2246885316,64
1361825550,2246928424,1,46,46,1361825523852,1361825523852,2246902276,2246902276,0
1361825550,2246928528,2,265,132.5,1361825524902,1361825524966,2246903430,2246903494,64
1361825557,2246936404,2,123,61.5,1361825530490,1361825530490,2246909894,2246909894,0
1361825558,2246936596,3,144,48,1361825553632,1361825553824,2246932228,2246932420,192
1361825558,2246936600,3,144,48,1361825553691,1361825553883,2246932291,2246932483,192
1361825558,2246936600,4,444,111,1361825549919,1361825550047,2246928519,2246928647,128
1361825558,2246936600,4,292,73,1361825550107,1361825550235,2246928707,2246928835,128
1361825558,2246936608,4,860,215,1361825550547,1361825550611,2246929155,2246929219,64
1361825566,2246944748,3,144,48,1361825564167,1361825564231,2246942915,2246942979,64
1361825573,2246952256,2,473,236.5,1361825545867,1361825545931,2246925123,2246925187,64
1361825577,2246956304,1,46,46,1361825550046,1361825550046,2246929350,2246929350,0
1361825581,2246960352,1,46,46,1361825552939,1361825552939,2246932291,2246932291,0
1361825585,2246964308,1,46,46,1361825558425,1361825558425,2246937733,2246937733,0
1361825602,2246980448,2,123,61.5,1361825576372,1361825576372,2246954820,2246954820,0
1361825605,2246984364,2,265,132.5,1361825579808,1361825579872,2246959172,2246959236,64
1361825610,2246988776,2,123,61.5,1361825583533,1361825596141,2246962309,2246974917,12608
1361825614,2246992560,2,473,236.5,1361825586692,1361825586756,2246965252,2246965316,64
1361825638,2247016732,1,46,46,1361825613591,1361825613591,2246992323,2246992323,0
1361825646,2247024704,2,123,61.5,1361825621042,1361825621042,2246999746,2246999746,0
1361825646,2247024964,3,144,48,1361825638957,1361825638957,2247017921,2247017921,0
1361825654,2247032564,2,473,236.5,1361825626686,1361825626750,2247005250,2247005314,64
1361825662,2247040632,2,265,132.5,1361825636346,1361825636474,2247014978,2247015106,128
1361825670,2247048612,1,46,46,1361825643728,1361825643728,2247022340,2247022340,0
1361825670,2247048948,8,451,56.375,1361825665727,1361825666943,2247044675,2247045891,1216
1361825678,2247057016,4,1043,260.75,1361825672890,1361825673018,2247051906,2247052034,128
1361825694,2247072644,2,473,236.5,1361825666925,1361825666989,2247045569,2247045633,64
1361825699,2247077996,1,46,46,1361825673358,1361825673358,2247052354,2247052354,0
1361825702,2247080960,4,190,47.5,1361825700275,1361825700787,2247079235,2247079747,512
1361825702,2247080960,4,190,47.5,1361825700275,1361825700851,2247079235,2247079811,576
1361825702,2247080964,4,190,47.5,1361825700656,1361825700976,2247079620,2247079940,320
1361825702,2247080964,4,190,47.5,1361825700848,1361825701424,2247079812,2247080388,576
1361825702,2247080964,4,190,47.5,1361825701230,1361825701486,2247080194,2247080450,256
1361825702,2247081036,4,190,47.5,1361825700197,1361825700773,2247079233,2247079809,576
1361825702,2247081040,4,190,47.5,1361825700641,1361825700897,2247079681,2247079937,256
1361825702,2247081044,4,190,47.5,1361825700896,1361825701152,2247079940,2247080196,256
1361825702,2247081044,4,190,47.5,1361825700896,1361825701152,2247079940,2247080196,256
1361825702,2247081048,4,190,47.5,1361825701402,1361825701658,2247080450,2247080706,256
1361825710,2247088924,4,190,47.5,1361825701528,1361825701848,2247080452,2247080772,320
1361825710,2247088924,4,190,47.5,1361825701783,1361825702039,2247080707,2247080963,256
1361825710,2247088924,4,190,47.5,1361825701847,1361825702103,2247080771,2247081027,256
1361825710,2247088928,4,190,47.5,1361825702036,1361825702292,2247080964,2247081220,256
1361825710,2247088928,4,190,47.5,1361825706066,1361825706386,2247084994,2247085314,320
1361825710,2247088928,4,190,47.5,1361825702353,1361825702609,2247081281,2247081537,256
1361825710,2247088928,4,190,47.5,1361825702289,1361825702609,2247081217,2247081537,320
1361825710,2247088928,4,190,47.5,1361825702353,1361825702609,2247081281,2247081537,256
1361825710,2247088932,4,190,47.5,1361825706192,1361825706512,2247085124,2247085444,320
1361825710,2247088932,4,190,47.5,1361825702608,1361825704912,2247081540,2247083844,2304
1361825710,2247088932,4,190,47.5,1361825702607,1361825702863,2247081539,2247081795,256
1361825710,2247088936,4,190,47.5,1361825702924,1361825703372,2247081860,2247082308,448
1361825710,2247088936,4,190,47.5,1361825703369,1361825703881,2247082305,2247082817,512
1361825710,2247088940,4,190,47.5,1361825703815,1361825703879,2247082755,2247082819,64
1361825710,2247088940,4,190,47.5,1361825703751,1361825704199,2247082691,2247083139,448
1361825710,2247088940,4,190,47.5,1361825704006,1361825704070,2247082946,2247083010,64
1361825710,2247088940,4,190,47.5,1361825704005,1361825704133,2247082945,2247083073,128
1361825710,2247088940,4,190,47.5,1361825704133,1361825704197,2247083073,2247083137,64
1361825710,2247088944,4,190,47.5,1361825704196,1361825704260,2247083140,2247083204,64
1361825710,2247088960,4,190,47.5,1361825704436,1361825704756,2247083396,2247083716,320
1361825710,2247088960,4,190,47.5,1361825704753,1361825705073,2247083713,2247084033,320
1361825710,2247088960,4,190,47.5,1361825704945,1361825705265,2247083905,2247084225,320
1361825710,2247088964,4,190,47.5,1361825705136,1361825705520,2247084100,2247084484,384
1361825710,2247088964,4,190,47.5,1361825705071,1361825705391,2247084035,2247084355,320
1361825710,2247088964,4,190,47.5,1361825705262,1361825705646,2247084226,2247084610,384
1361825710,2247088964,4,190,47.5,1361825705453,1361825705837,2247084417,2247084801,384
1361825710,2247088968,4,190,47.5,1361825701226,1361825703594,2247080194,2247082562,2368
1361825710,2247088972,4,190,47.5,1361825705639,1361825705959,2247084611,2247084931,320
1361825710,2247088972,4,190,47.5,1361825705830,1361825706150,2247084802,2247085122,320
1361825710,2247088972,4,190,47.5,1361825702054,1361825702310,2247081026,2247081282,256
1361825710,2247089004,4,190,47.5,1361825705991,1361825706375,2247084995,2247085379,384
1361825710,2247089008,4,190,47.5,1361825702530,1361825702786,2247081538,2247081794,256
1361825710,2247089012,4,190,47.5,1361825702911,1361825703359,2247081923,2247082371,448
1361825710,2247089016,4,190,47.5,1361825703352,1361825703864,2247082368,2247082880,512
1361825710,2247089016,4,190,47.5,1361825703611,1361825705851,2247082627,2247084867,2240
1361825710,2247089016,4,190,47.5,1361825703610,1361825703738,2247082626,2247082754,128
1361825710,2247089016,4,190,47.5,1361825703802,1361825703930,2247082818,2247082946,128
1361825710,2247089020,4,190,47.5,1361825703992,1361825704120,2247083012,2247083140,128
1361825710,2247089020,4,190,47.5,1361825704120,1361825704184,2247083140,2247083204,64
1361825710,2247089020,4,190,47.5,1361825704310,1361825704694,2247083330,2247083714,384
1361825710,2247089048,4,190,47.5,1361825704664,1361825704984,2247083712,2247084032,320
1361825710,2247089052,4,190,47.5,1361825705367,1361825707735,2247084419,2247086787,2368
1361825718,2247096808,2,265,132.5,1361825691274,1361825691466,2247070082,2247070274,192
1361825718,2247097004,3,144,48,1361825713926,1361825713926,2247092930,2247092930,0
1361825730,2247108788,2,104,52,1361825703455,1361825703455,2247082243,2247082243,0
1361825730,2247108788,1,46,46,1361825703582,1361825703582,2247082370,2247082370,0
1361825734,2247112852,2,473,236.5,1361825707807,1361825707871,2247086659,2247086723,64
1361825734,2247112976,3,144,48,1361825730784,1361825730912,2247109760,2247109888,128
1361825750,2247129088,4,312,78,1361825746803,1361825746867,2247125891,2247125955,64
1361825758,2247136692,13,4077,313.6153846,1361825731197,1361825731709,2247109889,2247110401,512
1361825758,2247136768,1,46,46,1361825733617,1361825733617,2247112385,2247112385,0
1361825774,2247152736,2,265,132.5,1361825747091,1361825747155,2247125827,2247125891,64
1361825774,2247152772,2,473,236.5,1361825748397,1361825748461,2247127169,2247127233,64
1361825774,2247153140,4,336,84,1361825770300,1361825770364,2247149440,2247149504,64
1361825790,2247168740,2,92,46,1361825763662,1361825776014,2247142402,2247154754,12352
1361825790,2247169276,3,144,48,1361825788660,1361825788724,2247167936,2247168000,64
1361825802,2247180836,2,123,61.5,1361825775791,1361825775791,2247154627,2247154627,0
1361825814,2247192996,2,473,236.5,1361825788428,1361825788492,2247167424,2247167488,64
1361825818,2247196908,1,46,46,1361825793510,1361825793510,2247172418,2247172418,0
1361825830,2247208924,2,265,132.5,1361825802068,1361825802196,2247180992,2247181120,128
1361825846,2247225052,2,123,61.5,1361825820502,1361825820502,2247199554,2247199554,0
1361825850,2247228888,1,46,46,1361825823544,1361825823544,2247202432,2247202432,0
1361825854,2247232932,2,473,236.5,1361825828109,1361825828173,2247207041,2247207105,64
1361825870,2247249308,3,144,48,1361825863699,1361825863699,2247243007,2247243007,0
1361825878,2247257004,1,46,46,1361825853443,1361825853443,2247232447,2247232447,0
1361825882,2247260992,2,265,132.5,1361825857680,1361825857808,2247236672,2247236800,128
1361825890,2247269092,2,123,61.5,1361825865387,1361825865387,2247244479,2247244479,0
1361825894,2247273120,2,473,236.5,1361825867985,1361825868049,2247247105,2247247169,64
1361825903,2247282008,1,46,46,1361825877438,1361825877438,2247256446,2247256446,0
1361825910,2247289376,2,123,61.5,1361825883089,1361825897681,2247262465,2247277057,14592
1361825911,2247289672,4,312,78,1361825909774,1361825909838,2247288446,2247288510,64
1361825911,2247289672,4,312,78,1361825909710,1361825909774,2247288382,2247288446,64
1361825911,2247289752,4,312,78,1361825909376,1361825909440,2247288128,2247288192,64
1361825911,2247289780,4,312,78,1361825909475,1361825909603,2247288255,2247288383,128
1361825919,2247297568,8,451,56.375,1361825910838,1361825912694,2247289406,2247291262,1856
1361825927,2247305692,3,144,48,1361825924347,1361825924347,2247303039,2247303039,0
1361825934,2247313100,2,473,236.5,1361825908321,1361825908385,2247287421,2247287485,64
1361825934,2247313128,3,1037,345.6666667,1361825908805,1361825908869,2247287933,2247287997,64
1361825934,2247313224,11,10502,954.7272727,1361825908837,1361825909157,2247288061,2247288381,320
1361825938,2247317124,2,265,132.5,1361825912651,1361825912779,2247291775,2247291903,128
1361825938,2247317136,1,46,46,1361825913345,1361825913345,2247292481,2247292481,0
1361825967,2247345596,6,1746,291,1361825963482,1361825963610,2247342078,2247342206,128
1361825967,2247345748,4,312,78,1361825958849,1361825958977,2247337597,2247337725,128
1361825967,2247345760,4,312,78,1361825963381,1361825963445,2247342141,2247342205,64
1361825970,2247349084,1,46,46,1361825943409,1361825943409,2247322493,2247322493,0
1361825974,2247353220,2,473,236.5,1361825947818,1361825947882,2247327038,2247327102,64
1361825975,2247353592,3,144,48,1361825967327,1361825967391,2247345919,2247345983,64
1361825975,2247353592,17,11862,697.7647059,1361825959901,1361825972637,2247338493,2247351229,12736
1361825975,2247353596,8,5067,633.375,1361825959964,1361825968796,2247338560,2247347392,8832
1361825975,2247353596,9,2132,236.8888889,1361825960154,1361825970650,2247338750,2247349246,10496
1361825975,2247353596,9,1634,181.5555556,1361825960282,1361825970650,2247338878,2247349246,10368
1361825975,2247353672,9,2578,286.4444444,1361825960142,1361825970574,2247338814,2247349246,10432
1361825975,2247353672,9,2568,285.3333333,1361825960142,1361825970574,2247338814,2247349246,10432
1361825975,2247353672,9,1634,181.5555556,1361825960206,1361825972558,2247338878,2247351230,12352
1361825975,2247353672,3,144,48,1361825963406,1361825968526,2247342078,2247347198,5120
1361825983,2247361668,74,97338,1315.378378,1361825958673,1361825975889,2247337341,2247354557,17216
1361825986,2247365152,6,2467,411.1666667,1361825958382,1361825958574,2247337534,2247337726,192
1361825994,2247373096,2,265,132.5,1361825968357,1361825968485,2247347453,2247347581,128
1361825994,2247373168,8,1121,140.125,1361825966880,1361825967072,2247346048,2247346240,192
1361825998,2247377216,1,46,46,1361825973293,1361825973293,2247352509,2247352509,0
1361826007,2247385612,3,144,48,1361825999369,1361825999369,2247377981,2247377981,0
1361826014,2247393300,2,473,236.5,1361825988057,1361825988121,2247367357,2247367421,64
1361826030,2247409284,1,46,46,1361826003242,1361826003242,2247382526,2247382526,0
1361826038,2247417316,43,44233,1028.674419,1361826011723,1361826031435,2247391039,2247410751,19712
1361826039,2247417628,7,1406,200.8571429,1361826027130,1361826032250,2247405758,2247410878,5120
1361826050,2247429204,1,46,46,1361826024121,1361826024121,2247403325,2247403325,0
1361826050,2247429208,2,265,132.5,1361826024307,1361826024371,2247403515,2247403579,64
1361826050,2247429232,1,46,46,1361826025116,1361826025116,2247404348,2247404348,0
1361826054,2247433160,9,6520,724.4444444,1361826026854,1361826027238,2247406014,2247406398,384
1361826054,2247433160,56,72425,1293.303571,1361826026789,1361826027429,2247405949,2247406589,640
1361826054,2247433160,7,3656,522.2857143,1361826026788,1361826027236,2247405948,2247406396,448
1361826054,2247433160,6,3946,657.6666667,1361826026852,1361826027172,2247406012,2247406332,320
1361826054,2247433184,7,3606,515.1428571,1361826027084,1361826027148,2247406268,2247406332,64
1361826054,2247433184,6,2974,495.6666667,1361826027084,1361826027148,2247406268,2247406332,64
1361826054,2247433188,11,7489,680.8181818,1361826027081,1361826032009,2247406269,2247411197,4928
1361826054,2247433192,3,519,173,1361826027588,1361826027652,2247406780,2247406844,64
1361826054,2247433268,6,3050,508.3333333,1361826026491,1361826026619,2247405759,2247405887,128
1361826054,2247433268,8,4736,592,1361826026679,1361826027127,2247405947,2247406395,448
1361826054,2247433268,8,5024,628,1361826026679,1361826027127,2247405947,2247406395,448
1361826054,2247433268,7,4024,574.8571429,1361826026743,1361826027127,2247406011,2247406395,384
1361826054,2247433272,13,10007,769.7692308,1361826026675,1361826027123,2247405947,2247406395,448
1361826054,2247433272,9,6395,710.5555556,1361826026995,1361826027059,2247406267,2247406331,64
1361826054,2247433276,6,2862,477,1361826026995,1361826027123,2247406271,2247406399,128
1361826054,2247433304,5,2421,484.2,1361826027092,1361826027092,2247406396,2247406396,0
1361826058,2247437360,1,46,46,1361826033181,1361826033181,2247412541,2247412541,0
1361826079,2247457992,3,144,48,1361826073932,1361826073932,2247452924,2247452924,0
1361826090,2247469340,1,46,46,1361826063216,1361826063216,2247442556,2247442556,0
1361826094,2247473244,2,473,236.5,1361826067855,1361826067983,2247447099,2247447227,128
1361826098,2247477224,3,200,66.66666667,1361826071779,1361826072035,2247451003,2247451259,256
1361826102,2247481232,2,123,61.5,1361826075677,1361826075677,2247454909,2247454909,0
1361826106,2247485236,2,265,132.5,1361826080090,1361826080218,2247459326,2247459454,128
1361826119,2247497436,1,46,46,1361826094138,1361826094138,2247472574,2247472574,0
1361826127,2247505968,2,123,61.5,1361826123426,1361826123426,2247502394,2247502394,0
1361826135,2247513564,2,473,236.5,1361826108600,1361826108664,2247487164,2247487228,64
1361826143,2247521496,2,123,61.5,1361826117309,1361826117309,2247495805,2247495805,0
1361826143,2247521788,3,169,56.33333333,1361826139606,1361826142038,2247518394,2247520826,2432
1361826147,2247525552,2,123,61.5,1361826121282,1361826121282,2247499834,2247499834,0
1361826151,2247529420,1,46,46,1361826124169,1361826124169,2247502589,2247502589,0
1361826151,2247529772,4,215,53.75,1361826143080,1361826143080,2247521852,2247521852,0
1361826151,2247529772,4,215,53.75,1361826143080,1361826143080,2247521852,2247521852,0
1361826151,2247529772,3,169,56.33333333,1361826143079,1361826143079,2247521851,2247521851,0
1361826151,2247529772,3,169,56.33333333,1361826143079,1361826143079,2247521851,2247521851,0
1361826151,2247529772,4,215,53.75,1361826143079,1361826143079,2247521851,2247521851,0
1361826151,2247529772,3,169,56.33333333,1361826143079,1361826143079,2247521851,2247521851,0
1361826151,2247529772,3,169,56.33333333,1361826143079,1361826143079,2247521851,2247521851,0
1361826151,2247529784,3,169,56.33333333,1361826147612,1361826147612,2247526396,2247526396,0
1361826151,2247529856,4,215,53.75,1361826142996,1361826142996,2247521852,2247521852,0
1361826151,2247529856,3,169,56.33333333,1361826142996,1361826142996,2247521852,2247521852,0
1361826151,2247529856,4,215,53.75,1361826142995,1361826142995,2247521851,2247521851,0
1361826151,2247529864,12,5680,473.3333333,1361826135370,1361826150730,2247514234,2247529594,15360
1361826159,2247537864,3,144,48,1361826151754,1361826151754,2247530618,2247530618,0
1361826163,2247541472,2,265,132.5,1361826136789,1361826136917,2247515261,2247515389,128
1361826167,2247545644,1,46,46,1361826142182,1361826142182,2247520826,2247520826,0
1361826171,2247549532,1,46,46,1361826143445,1361826143445,2247521977,2247521977,0
1361826175,2247553596,2,473,236.5,1361826148693,1361826148757,2247527289,2247527353,64
1361826179,2247557556,1,46,46,1361826154048,1361826154048,2247532604,2247532604,0
1361826187,2247565528,2,123,61.5,1361826162201,1361826162265,2247540729,2247540793,64
1361826191,2247569636,2,123,61.5,1361826166127,1361826166127,2247544763,2247544763,0
1361826211,2247589528,2,123,61.5,1361826184090,1361826200474,2247562618,2247579002,16384
1361826215,2247593620,2,473,236.5,1361826188286,1361826188350,2247566906,2247566970,64
1361826215,2247593856,8,451,56.375,1361826206802,1361826208018,2247585658,2247586874,1216
1361826215,2247593860,8,451,56.375,1361826210830,1361826212046,2247589690,2247590906,1216
1361826219,2247597612,2,265,132.5,1361826192008,1361826192072,2247570620,2247570684,64
1361826231,2247609848,3,144,48,1361826224091,1361826224091,2247602939,2247602939,0
1361826239,2247617664,1,46,46,1361826213970,1361826213970,2247592634,2247592634,0
1361826243,2247621540,1,46,46,1361826215564,1361826215564,2247594104,2247594104,0
1361826255,2247633552,2,473,236.5,1361826228739,1361826228803,2247607291,2247607355,64
1361826271,2247650288,1,46,46,1361826243362,1361826243362,2247622650,2247622650,0
1361826275,2247654160,2,265,132.5,1361826247074,1361826247138,2247626234,2247626298,64
1361826287,2247666404,3,144,48,1361826283502,1361826283566,2247662906,2247662970,64
1361826295,2247674296,2,473,236.5,1361826267802,1361826267866,2247647098,2247647162,64
1361826299,2247678232,1,46,46,1361826273434,1361826273434,2247652666,2247652666,0
1361826328,2247706560,2,265,132.5,1361826302903,1361826302967,2247681463,2247681527,64
1361826331,2247710356,1,46,46,1361826303326,1361826303326,2247682682,2247682682,0
1361826335,2247714148,3,144,48,1361826331692,1361826331756,2247710840,2247710904,64
1361826335,2247714368,2,473,236.5,1361826307344,1361826307408,2247686712,2247686776,64
1361826343,2247722204,8,1505,188.125,1361826332535,1361826337655,2247711739,2247716859,5120
1361826343,2247722204,8,1505,188.125,1361826332534,1361826337654,2247711738,2247716858,5120
1361826359,2247738404,3,144,48,1361826358510,1361826358574,2247737914,2247737978,64
1361826360,2247738528,11,2292,208.3636364,1361826332376,1361826332824,2247710904,2247711352,448
1361826360,2247738568,1,46,46,1361826334127,1361826334127,2247712695,2247712695,0
1361826376,2247754552,2,473,236.5,1361826348287,1361826348351,2247726839,2247726903,64
1361826384,2247762728,2,265,132.5,1361826358095,1361826358159,2247736823,2247736887,64
1361826392,2247770552,1,46,46,1361826364160,1361826364160,2247742712,2247742712,0
1361826404,2247782612,2,123,61.5,1361826377093,1361826377093,2247755705,2247755705,0
1361826416,2247794700,2,473,236.5,1361826388522,1361826388586,2247767222,2247767286,64
1361826420,2247798760,1,46,46,1361826393969,1361826393969,2247772729,2247772729,0
1361826423,2247802328,3,144,48,1361826418615,1361826418615,2247797943,2247797943,0
1361826440,2247818836,2,265,132.5,1361826413348,1361826413476,2247792184,2247792312,128
1361826448,2247826868,5,808,161.6,1361826421764,1361826447620,2247800632,2247826488,25856
1361826452,2247830768,1,46,46,1361826423975,1361826423975,2247802743,2247802743,0
1361826456,2247834736,2,473,236.5,1361826428809,1361826428873,2247807545,2247807609,64
1361826480,2247858728,1,46,46,1361826454033,1361826454033,2247832761,2247832761,0
1361826496,2247874460,3,144,48,1361826494489,1361826494489,2247872949,2247872949,0
1361826496,2247874852,2,265,132.5,1361826468881,1361826469009,2247847733,2247847861,128
1361826496,2247874864,2,473,236.5,1361826469512,1361826469576,2247848376,2247848440,64
1361826512,2247890684,2,123,61.5,1361826484089,1361826502265,2247862773,2247880949,18176
1361826520,2247898816,2,123,61.5,1361826492725,1361826492725,2247871541,2247871541,0
1361826536,2247914780,2,473,236.5,1361826509273,1361826509337,2247888053,2247888117,64
1361826540,2247918908,1,46,46,1361826513817,1361826513817,2247892725,2247892725,0
1361826552,2247930792,2,265,132.5,1361826524559,1361826524687,2247903351,2247903479,128
1361826564,2247942960,2,123,61.5,1361826537508,1361826537508,2247916468,2247916468,0
1361826572,2247950788,1,46,46,1361826543955,1361826543955,2247922743,2247922743,0
1361826575,2247954396,3,144,48,1361826568562,1361826568562,2247947958,2247947958,0
1361826576,2247954956,2,473,236.5,1361826549160,1361826549224,2247928116,2247928180,64
1361826600,2247978864,1,46,46,1361826573892,1361826573892,2247952756,2247952756,0
1361826604,2247982804,2,265,132.5,1361826579905,1361826579969,2247958709,2247958773,64
1361826608,2247986960,2,123,61.5,1361826582436,1361826582436,2247961396,2247961396,0
1361826616,2247995060,2,473,236.5,1361826589375,1361826589439,2247968435,2247968499,64
1361826632,2248010700,8,451,56.375,1361826627625,1361826628713,2248006325,2248007413,1088
1361826632,2248010964,1,46,46,1361826603810,1361826603810,2247982774,2247982774,0
1361826640,2248018652,3,144,48,1361826632792,1361826632920,2248011444,2248011572,128
1361826640,2248018680,8,1505,188.125,1361826633596,1361826638716,2248012276,2248017396,5120
1361826648,2248026648,3,144,48,1361826644317,1361826644317,2248022965,2248022965,0
1361826656,2248034944,2,473,236.5,1361826629172,1361826629236,2248008116,2248008180,64
1361826660,2248038892,11,2233,203,1361826632681,1361826633001,2248011573,2248011893,320
1361826660,2248038932,1,46,46,1361826633855,1361826633855,2248012787,2248012787,0
1361826660,2248039092,2,265,132.5,1361826634849,1361826634913,2248013941,2248014005,64
1361826692,2248070908,1,46,46,1361826663897,1361826663897,2248042805,2248042805,0
1361826696,2248074960,2,473,236.5,1361826669411,1361826669475,2248048371,2248048435,64
1361826704,2248083060,2,123,61.5,1361826677055,1361826677055,2248056115,2248056115,0
1361826716,2248095172,2,265,132.5,1361826690320,1361826690448,2248069492,2248069620,128
1361826720,2248098632,3,144,48,1361826719274,1361826719338,2248097906,2248097970,64
1361826720,2248099000,1,46,46,1361826693881,1361826693881,2248072881,2248072881,0
1361826736,2248115368,2,473,236.5,1361826708746,1361826708810,2248088114,2248088178,64
1361826748,2248127140,2,123,61.5,1361826721902,1361826721902,2248101042,2248101042,0
1361826748,2248127176,1,46,46,1361826723661,1361826723661,2248102837,2248102837,0
1361826772,2248151268,2,265,132.5,1361826745839,1361826745903,2248125107,2248125171,64
1361826776,2248155288,2,473,236.5,1361826748314,1361826748378,2248127602,2248127666,64
1361826780,2248159264,1,46,46,1361826753585,1361826753585,2248132849,2248132849,0
1361826792,2248171304,2,123,61.5,1361826766668,1361826766668,2248145972,2248145972,0
1361826800,2248178832,3,144,48,1361826796898,1361826796898,2248175730,2248175730,0
1361826808,2248187272,2,123,61.5,1361826783592,1361826804648,2248162864,2248183920,21056
1361826816,2248194960,8,451,56.375,1361826811940,1361826813476,2248190900,2248192436,1536
1361826816,2248195288,2,473,236.5,1361826788378,1361826788442,2248167666,2248167730,64
1361826828,2248207204,2,265,132.5,1361826801071,1361826801135,2248180275,2248180339,64
1361826840,2248219316,1,46,46,1361826813564,1361826813564,2248192880,2248192880,0
1361826856,2248235316,2,473,236.5,1361826828861,1361826828925,2248208177,2248208241,64
1361826868,2248247356,1,46,46,1361826843541,1361826843541,2248222897,2248222897,0
1361826872,2248250972,3,144,48,1361826868948,1361826868948,2248247920,2248247920,0
1361826885,2248263428,2,265,132.5,1361826857715,1361826857779,2248236143,2248236207,64
1361826896,2248275396,2,473,236.5,1361826868971,1361826869035,2248248367,2248248431,64
1361826901,2248279532,1,46,46,1361826874380,1361826874380,2248252912,2248252912,0
1361826904,2248283360,9,3913,434.7777778,1361826879760,1361826880080,2248259120,2248259440,320
1361826928,2248307004,3,144,48,1361826927603,1361826927667,2248306607,2248306671,64
1361826929,2248307496,1,46,46,1361826904432,1361826904432,2248282928,2248282928,0
1361826936,2248314924,3,144,48,1361826929028,1361826929028,2248307952,2248307952,0
1361826936,2248315384,2,473,236.5,1361826908473,1361826908537,2248287857,2248287921,64
1361826940,2248319396,2,265,132.5,1361826912746,1361826912874,2248292142,2248292270,128
1361826953,2248331632,13,2857,219.7692308,1361826928039,1361826933543,2248306671,2248312175,5504
1361826961,2248339464,1,46,46,1361826934478,1361826934478,2248312942,2248312942,0
1361826961,2248339572,7,4530,647.1428571,1361826934115,1361826934307,2248312687,2248312879,192
1361826977,2248355584,2,473,236.5,1361826949783,1361826949847,2248328367,2248328431,64
1361826989,2248367560,1,46,46,1361826964401,1361826964401,2248342961,2248342961,0
1361826997,2248375484,2,265,132.5,1361826968955,1361826969083,2248347439,2248347567,128
1361827005,2248383512,2,123,61.5,1361826978336,1361826978336,2248356848,2248356848,0
1361827008,2248387108,3,144,48,1361827003851,1361827003851,2248382959,2248382959,0
1361827017,2248395532,2,473,236.5,1361826989321,1361826989385,2248367853,2248367917,64
1361827021,2248399596,1,46,46,1361826994380,1361826994380,2248372976,2248372976,0
1361827049,2248427568,2,265,132.5,1361827024743,1361827024871,2248403311,2248403439,128
1361827049,2248427728,2,123,61.5,1361827023045,1361827023045,2248401773,2248401773,0
1361827049,2248427756,1,46,46,1361827024233,1361827024233,2248402989,2248402989,0
1361827056,2248435176,3,169,56.33333333,1361827049608,1361827049608,2248428784,2248428784,0
1361827057,2248435592,2,473,236.5,1361827029389,1361827029453,2248407981,2248408045,64
1361827081,2248459716,3,144,48,1361827079184,1361827079248,2248457900,2248457964,64
1361827081,2248459892,2,92,46,1361827054112,1361827055328,2248433004,2248434220,1216
1361827093,2248471876,2,123,61.5,1361827067826,1361827067826,2248446702,2248446702,0
1361827097,2248475808,2,473,236.5,1361827069172,1361827069236,2248447980,2248448044,64
1361827105,2248483868,2,265,132.5,1361827080249,1361827080377,2248459117,2248459245,128
1361827109,2248487980,2,123,61.5,1361827084042,1361827107210,2248463022,2248486190,23168
1361827112,2248491316,4,336,84,1361827110267,1361827110395,2248489583,2248489711,128
1361827120,2248499284,8,451,56.375,1361827112344,1361827113496,2248491628,2248492780,1152
1361827137,2248515824,2,473,236.5,1361827109476,1361827109540,2248488300,2248488364,64
1361827141,2248519920,1,46,46,1361827114119,1361827114119,2248493039,2248493039,0
1361827145,2248523912,1,46,46,1361827120590,1361827120590,2248499502,2248499502,0
1361827160,2248539376,3,144,48,1361827153533,1361827153597,2248532909,2248532973,64
1361827161,2248539888,2,265,132.5,1361827135781,1361827135845,2248514669,2248514733,64
1361827169,2248548048,1,46,46,1361827144006,1361827144006,2248523054,2248523054,0
1361827173,2248551972,2,473,236.5,1361827148753,1361827148817,2248527725,2248527789,64
1361827201,2248580024,1,46,46,1361827174109,1361827174109,2248553133,2248553133,0
1361827213,2248592008,2,473,236.5,1361827188651,1361827188715,2248567659,2248567723,64
1361827217,2248595968,2,265,132.5,1361827191187,1361827191315,2248570155,2248570283,128
1361827229,2248608116,1,46,46,1361827203967,1361827203967,2248583083,2248583083,0
1361827232,2248611336,3,144,48,1361827228581,1361827228645,2248607917,2248607981,64
1361827240,2248619360,9,1557,173,1361827233869,1361827239309,2248613229,2248618669,5440
1361827240,2248619360,9,1535,170.5555556,1361827233868,1361827239308,2248613228,2248618668,5440
1361827241,2248619436,3,144,48,1361827233897,1361827234025,2248612333,2248612461,128
1361827241,2248619464,9,1557,173,1361827234763,1361827240203,2248613227,2248618667,5440
1361827257,2248636188,2,473,236.5,1361827229112,1361827229176,2248608300,2248608364,64
1361827261,2248640172,1,46,46,1361827233927,1361827233927,2248613099,2248613099,0
1361827261,2248640280,12,2433,202.75,1361827233179,1361827233499,2248612459,2248612779,320
1361827265,2248644148,1,46,46,1361827240413,1361827240413,2248619561,2248619561,0
1361827273,2248652352,2,265,132.5,1361827246801,1361827246865,2248626153,2248626217,64
1361827289,2248668392,1,46,46,1361827263721,1361827263721,2248643113,2248643113,0
1361827293,2248672264,2,473,236.5,1361827268521,1361827268585,2248647785,2248647849,64
1361827305,2248683436,3,144,48,1361827304488,1361827304552,2248682924,2248682988,64
1361827305,2248684272,2,123,61.5,1361827278050,1361827278050,2248657322,2248657322,0
1361827321,2248700344,1,46,46,1361827293785,1361827293785,2248673129,2248673129,0
1361827329,2248708252,2,265,132.5,1361827302262,1361827302326,2248681514,2248681578,64
1361827334,2248712440,2,473,236.5,1361827309217,1361827309345,2248687657,2248687785,128
1361827349,2248728312,1,46,46,1361827323834,1361827323834,2248703146,2248703146,0
1361827349,2248728396,2,123,61.5,1361827322852,1361827322852,2248702248,2248702248,0
1361827377,2248756292,2,473,236.5,1361827348878,1361827348942,2248728170,2248728234,64
1361827382,2248760416,1,46,46,1361827354746,1361827354746,2248733162,2248733162,0
1361827385,2248763708,3,144,48,1361827379221,1361827379221,2248757929,2248757929,0
1361827385,2248764332,2,265,132.5,1361827357863,1361827357927,2248737195,2248737259,64
1361827394,2248772844,2,123,61.5,1361827368332,1361827368332,2248747176,2248747176,0
1361827410,2248788424,1,46,46,1361827384751,1361827384751,2248763175,2248763175,0
1361827417,2248796408,2,473,236.5,1361827388823,1361827388887,2248768231,2248768295,64
1361827434,2248812508,3,685,228.3333333,1361827408477,1361827408541,2248786985,2248787049,64
1361827437,2248816316,2,123,61.5,1361827409206,1361827413878,2248788522,2248793194,4672
1361827442,2248820428,2,265,132.5,1361827413998,1361827414190,2248792426,2248792618,192
1361827449,2248827612,3,144,48,1361827442038,1361827442038,2248820650,2248820650,0
1361827453,2248832420,2,473,236.5,1361827428556,1361827428620,2248807976,2248808040,64
1361827470,2248848428,1,46,46,1361827444780,1361827444780,2248823208,2248823208,0
1361827478,2248856436,2,123,61.5,1361827453602,1361827453602,2248832038,2248832038,0
1361827494,2248872476,2,265,132.5,1361827469372,1361827469436,2248847848,2248847912,64
1361827498,2248876448,2,473,236.5,1361827469846,1361827469910,2248848294,2248848358,64
1361827501,2248880400,1,46,46,1361827473824,1361827473824,2248853224,2248853224,0
1361827513,2248891660,4,190,47.5,1361827509892,1361827510148,2248888552,2248888808,256
1361827513,2248891660,4,190,47.5,1361827509828,1361827510084,2248888488,2248888744,256
1361827513,2248891664,4,190,47.5,1361827510144,1361827510400,2248888808,2248889064,256
1361827513,2248891664,4,190,47.5,1361827510079,1361827510335,2248888743,2248888999,256
1361827513,2248891668,4,190,47.5,1361827510395,1361827512699,2248889063,2248891367,2304
1361827513,2248891672,4,190,47.5,1361827510389,1361827512693,2248889061,2248891365,2304
1361827513,2248891696,4,190,47.5,1361827511134,1361827511582,2248889830,2248890278,448
1361827513,2248891696,4,190,47.5,1361827508317,1361827508893,2248887013,2248887589,576
1361827513,2248891700,4,190,47.5,1361827508316,1361827508892,2248887016,2248887592,576
1361827513,2248891700,4,190,47.5,1361827511644,1361827512092,2248890344,2248890792,448
1361827513,2248891700,4,190,47.5,1361827511707,1361827511835,2248890407,2248890535,128
1361827513,2248891704,4,190,47.5,1361827508693,1361827510997,2248887397,2248889701,2304
1361827513,2248891704,4,190,47.5,1361827511897,1361827512025,2248890601,2248890729,128
1361827513,2248891704,4,190,47.5,1361827512087,1361827512215,2248890791,2248890919,128
1361827513,2248891704,4,190,47.5,1361827509270,1361827509590,2248887974,2248888294,320
1361827513,2248891708,4,190,47.5,1361827512209,1361827512273,2248890917,2248890981,64
1361827513,2248891708,4,190,47.5,1361827509525,1361827509781,2248888233,2248888489,256
1361827513,2248891732,4,190,47.5,1361827509755,1361827510011,2248888487,2248888743,256
1361827513,2248891736,4,190,47.5,1361827510005,1361827510389,2248888741,2248889125,384
1361827513,2248891748,4,190,47.5,1361827510445,1361827510957,2248889193,2248889705,512
1361827513,2248891772,4,190,47.5,1361827510930,1361827511378,2248889702,2248890150,448
1361827513,2248891780,4,190,47.5,1361827511372,1361827511820,2248890152,2248890600,448
1361827513,2248891784,4,190,47.5,1361827508165,1361827508741,2248886949,2248887525,576
1361827513,2248891784,4,190,47.5,1361827508233,1361827509833,2248887017,2248888617,1600
1361827513,2248891784,4,190,47.5,1361827511815,1361827511943,2248890599,2248890727,128
1361827513,2248891784,4,190,47.5,1361827511942,1361827512006,2248890726,2248890790,64
1361827513,2248891784,4,190,47.5,1361827508614,1361827508934,2248887398,2248887718,320
1361827513,2248891784,4,190,47.5,1361827508678,1361827508934,2248887462,2248887718,256
1361827513,2248891784,4,190,47.5,1361827511750,1361827511814,2248890534,2248890598,64
1361827513,2248891784,4,190,47.5,1361827508742,1361827509382,2248887526,2248888166,640
1361827513,2248891788,4,190,47.5,1361827508933,1361827509189,2248887721,2248887977,256
1361827513,2248891788,4,190,47.5,1361827511941,1361827512005,2248890729,2248890793,64
1361827513,2248891788,4,190,47.5,1361827508932,1361827509188,2248887720,2248887976,256
1361827513,2248891788,4,190,47.5,1361827512132,1361827512196,2248890920,2248890984,64
1361827513,2248891788,4,190,47.5,1361827512004,1361827512132,2248890792,2248890920,128
1361827513,2248891788,4,190,47.5,1361827509188,1361827509444,2248887976,2248888232,256
1361827513,2248891788,4,190,47.5,1361827509188,1361827509444,2248887976,2248888232,256
1361827513,2248891788,4,190,47.5,1361827509442,1361827509698,2248888230,2248888486,256
1361827513,2248891788,4,190,47.5,1361827509506,1361827509762,2248888294,2248888550,256
1361827513,2248891788,4,190,47.5,1361827512385,1361827512769,2248891173,2248891557,384
1361827521,2248899632,4,190,47.5,1361827513758,1361827514078,2248892390,2248892710,320
1361827521,2248899636,4,190,47.5,1361827513179,1361827513563,2248891815,2248892199,384
1361827521,2248899640,4,190,47.5,1361827513367,1361827513815,2248892007,2248892455,448
1361827521,2248899640,3,144,48,1361827514263,1361827514327,2248892903,2248892967,64
1361827521,2248899644,4,190,47.5,1361827513557,1361827513877,2248892201,2248892521,320
1361827521,2248899684,4,190,47.5,1361827512492,1361827512876,2248891176,2248891560,384
1361827521,2248899744,4,190,47.5,1361827512687,1361827513007,2248891431,2248891751,320
1361827521,2248899744,4,190,47.5,1361827512687,1361827513071,2248891431,2248891815,384
1361827521,2248899744,4,190,47.5,1361827512815,1361827513135,2248891559,2248891879,320
1361827521,2248899744,4,190,47.5,1361827512814,1361827513262,2248891558,2248892006,448
1361827521,2248899748,4,190,47.5,1361827513770,1361827514218,2248892518,2248892966,448
1361827521,2248899752,4,190,47.5,1361827513061,1361827513381,2248891813,2248892133,320
1361827521,2248899752,4,190,47.5,1361827513128,1361827513512,2248891880,2248892264,384
1361827521,2248899756,4,190,47.5,1361827513444,1361827513764,2248892200,2248892520,320
1361827521,2248899756,4,190,47.5,1361827513506,1361827513954,2248892262,2248892710,448
1361827525,2248904400,2,123,61.5,1361827497567,1361827497567,2248876967,2248876967,0
1361827530,2248908512,1,46,46,1361827504728,1361827504728,2248883240,2248883240,0
1361827538,2248916480,2,473,236.5,1361827509943,1361827510007,2248888423,2248888487,64
1361827550,2248928508,2,265,132.5,1361827524508,1361827524572,2248903016,2248903080,64
1361827562,2248940452,1,46,46,1361827534801,1361827534801,2248913253,2248913253,0
1361827562,2248940536,6,2926,487.6666667,1361827534335,1361827534591,2248912871,2248913127,256
1361827574,2248952624,2,473,236.5,1361827549477,1361827549541,2248928101,2248928165,64
1361827590,2248968528,1,46,46,1361827564740,1361827564740,2248943268,2248943268,0
1361827593,2248971876,3,144,48,1361827589033,1361827589097,2248967909,2248967973,64
1361827606,2248984556,2,123,61.5,1361827579307,1361827579307,2248957863,2248957863,0
1361827606,2248984560,2,265,132.5,1361827579749,1361827579877,2248958309,2248958437,128
1361827614,2248992828,2,473,236.5,1361827588890,1361827588954,2248967718,2248967782,64
1361827622,2249000592,1,46,46,1361827594692,1361827594692,2248973284,2248973284,0
1361827633,2249011820,4,312,78,1361827631393,1361827631457,2249010213,2249010277,64
1361827633,2249011824,4,312,78,1361827631583,1361827631711,2249010407,2249010535,128
1361827633,2249011824,4,312,78,1361827631710,1361827631774,2249010534,2249010598,64
1361827633,2249011828,4,312,78,1361827631514,1361827631578,2249010342,2249010406,64
1361827633,2249011828,4,312,78,1361827631640,1361827631704,2249010468,2249010532,64
1361827650,2249028784,2,123,61.5,1361827624005,1361827624005,2249002789,2249002789,0
1361827650,2249028816,1,46,46,1361827624486,1361827624486,2249003302,2249003302,0
1361827654,2249032820,2,473,236.5,1361827629407,1361827629471,2249008227,2249008291,64
1361827658,2249036652,3,1048,349.3333333,1361827631497,1361827631561,2249010149,2249010213,64
1361827658,2249036652,15,15658,1043.866667,1361827631624,1361827631816,2249010276,2249010468,192
1361827662,2249040776,2,265,132.5,1361827634828,1361827634956,2249013604,2249013732,128
1361827665,2249043816,3,144,48,1361827664100,1361827664164,2249042916,2249042980,64
1361827682,2249060760,1,46,46,1361827654558,1361827654558,2249033318,2249033318,0
1361827694,2249072716,2,473,236.5,1361827669706,1361827669770,2249048422,2249048486,64
1361827694,2249072800,2,123,61.5,1361827668916,1361827668916,2249047716,2249047716,0
1361827710,2249088876,1,46,46,1361827684458,1361827684458,2249063334,2249063334,0
1361827718,2249096708,2,265,132.5,1361827690577,1361827690705,2249069285,2249069413,128
1361827721,2249100156,8,451,56.375,1361827713487,1361827714063,2249092643,2249093219,576
1361827734,2249112776,2,473,236.5,1361827709451,1361827709515,2249088227,2249088291,64
1361827738,2249117100,2,123,61.5,1361827711242,1361827714250,2249090342,2249093350,3008
1361827745,2249124124,3,144,48,1361827738800,1361827738864,2249117924,2249117988,64
1361827770,2249149004,1,46,46,1361827744360,1361827744360,2249123364,2249123364,0
1361827774,2249152948,1,46,46,1361827747231,1361827747231,2249126179,2249126179,0
1361827774,2249153024,2,265,132.5,1361827745875,1361827746003,2249124899,2249125027,128
1361827774,2249153060,1,46,46,1361827747119,1361827747119,2249126179,2249126179,0
1361827774,2249153096,2,473,236.5,1361827748745,1361827748809,2249127841,2249127905,64
1361827802,2249180976,1,46,46,1361827774405,1361827774405,2249153381,2249153381,0
1361827814,2249193132,2,473,236.5,1361827789350,1361827789414,2249168482,2249168546,64
1361827817,2249196232,3,144,48,1361827813699,1361827813699,2249192931,2249192931,0
1361827826,2249205156,2,265,132.5,1361827801613,1361827801677,2249180769,2249180833,64
1361827830,2249209072,1,46,46,1361827804322,1361827804322,2249183394,2249183394,0
1361827841,2249220240,8,1505,188.125,1361827834939,1361827840059,2249214179,2249219299,5120
1361827841,2249220240,8,1505,188.125,1361827834939,1361827840059,2249214179,2249219299,5120
1361827841,2249220312,3,144,48,1361827833842,1361827833906,2249213154,2249213218,64
1361827854,2249233224,2,473,236.5,1361827828552,1361827828616,2249207776,2249207840,64
1361827862,2249241064,1,46,46,1361827834346,1361827834346,2249213410,2249213410,0
1361827862,2249241156,12,2429,202.4166667,1361827834062,1361827834894,2249213218,2249214050,832
1361827882,2249261208,2,265,132.5,1361827857177,1361827857241,2249236385,2249236449,64
1361827889,2249268428,3,144,48,1361827888511,1361827888511,2249267939,2249267939,0
1361827890,2249269328,1,46,46,1361827864096,1361827864096,2249243424,2249243424,0
1361827895,2249273704,2,473,236.5,1361827869136,1361827869200,2249247840,2249247904,64
1361827907,2249285428,5,808,161.6,1361827880294,1361827888870,2249258722,2249267298,8576
1361827922,2249301400,1,46,46,1361827894040,1361827894040,2249273440,2249273440,0
1361827935,2249313580,2,473,236.5,1361827909133,1361827909197,2249287713,2249287777,64
1361827939,2249317608,2,265,132.5,1361827913009,1361827913137,2249291617,2249291745,128
1361827951,2249329508,1,46,46,1361827924950,1361827924950,2249303458,2249303458,0
1361827959,2249337528,2,123,61.5,1361827933121,1361827933121,2249311649,2249311649,0
1361827969,2249348312,3,144,48,1361827963634,1361827963634,2249342946,2249342946,0
1361827975,2249353516,2,473,236.5,1361827949132,1361827949260,2249327648,2249327776,128
1361827983,2249361568,1,46,46,1361827954842,1361827954842,2249333410,2249333410,0
1361827995,2249373536,2,265,132.5,1361827968184,1361827968312,2249346720,2249346848,128
1361828003,2249381508,2,123,61.5,1361827978066,1361827978066,2249356574,2249356574,0
1361828011,2249389592,1,46,46,1361827984831,1361827984831,2249363423,2249363423,0
1361828015,2249393548,2,473,236.5,1361827989355,1361827989419,2249367903,2249367967,64
1361828025,2249404332,3,144,48,1361828023578,1361828023642,2249402910,2249402974,64
1361828039,2249417624,2,123,61.5,1361828014304,1361828014816,2249392928,2249393440,512
1361828051,2249429880,2,265,132.5,1361828023199,1361828023263,2249402079,2249402143,64
1361828051,2249429968,2,123,61.5,1361828022534,1361828022534,2249401502,2249401502,0
1361828055,2249434024,2,473,236.5,1361828029518,1361828029582,2249408542,2249408606,64
1361828071,2249449892,1,46,46,1361828044561,1361828044561,2249423453,2249423453,0
1361828074,2249452656,8,451,56.375,1361828067776,1361828069248,2249446432,2249447904,1472
1361828095,2249473988,5,2912,582.4,1361828070196,1361828081140,2249449184,2249460128,10944
1361828099,2249478068,1,46,46,1361828074403,1361828074403,2249453471,2249453471,0
1361828103,2249482076,2,265,132.5,1361828078618,1361828078746,2249457694,2249457822,128
1361828106,2249484640,3,144,48,1361828102094,1361828102094,2249480734,2249480734,0
1361828109,887801784,6,4015,669.1666667,1361828083576,1361828083896,887776360,887776680,320
1361828130,2249508648,3,144,48,1361828125382,1361828125510,2249504030,2249504158,128
1361828131,2249510012,1,46,46,1361828104473,1361828104473,2249483485,2249483485,0
1361828136,887829044,8,544,68,1361828127411,1361828133427,887820455,887826471,6016
1361828147,2249526144,2,473,236.5,1361828121173,1361828121237,2249500317,2249500381,64
1361828151,2249530104,37,32564,880.1081081,1361828125053,1361828135037,2249504157,2249514141,9984
1361828153,887845932,12,12602,1050.166667,1361828127334,1361828127526,887820266,887820458,192
1361828155,2249533972,6,3075,512.5,1361828127299,1361828127363,2249506271,2249506335,64
1361828155,2249533972,7,3723,531.8571429,1361828127299,1361828127363,2249506271,2249506335,64
1361828155,2249534084,9,7009,778.7777778,1361828126995,1361828127251,2249506079,2249506335,256
1361828155,2249534084,9,7260,806.6666667,1361828126994,1361828127250,2249506078,2249506334,256
1361828155,2249534088,7,5218,745.4285714,1361828127182,1361828127246,2249506270,2249506334,64
1361828155,2249534088,7,3798,542.5714286,1361828127182,1361828127246,2249506270,2249506334,64
1361828159,2249538064,1,46,46,1361828134439,1361828134439,2249513503,2249513503,0
1361828159,2249538176,2,265,132.5,1361828134388,1361828134452,2249513564,2249513628,64
1361828178,2249556676,3,144,48,1361828174249,1361828174313,2249552925,2249552989,64
1361828187,2249566076,2,473,236.5,1361828161049,1361828161113,2249540125,2249540189,64
1361828191,2249570144,1,46,46,1361828164374,1361828164374,2249543518,2249543518,0
1361828200,887893040,3,169,56.33333333,1361828199417,1361828199417,887892457,887892457,0
1361828207,2249586332,2,123,61.5,1361828178971,1361828178971,2249558303,2249558303,0
1361828211,2249590428,1,84,84,1361828185527,1361828185527,2249564955,2249564955,0
1361828215,2249594408,2,265,132.5,1361828189517,1361828189581,2249568925,2249568989,64
1361828220,2249598460,1,46,46,1361828195072,1361828195072,2249573532,2249573532,0
1361828228,2249606592,2,473,236.5,1361828201917,1361828202045,2249580509,2249580637,128
1361828248,887941056,3,169,56.33333333,1361828243431,1361828243431,887936487,887936487,0
1361828250,2249628660,3,169,56.33333333,1361828243576,1361828243576,2249622236,2249622236,0
1361828250,2249628660,3,169,56.33333333,1361828243576,1361828243576,2249622236,2249622236,0
1361828250,2249628660,3,169,56.33333333,1361828243576,1361828243576,2249622236,2249622236,0
1361828250,2249628788,3,144,48,1361828249145,1361828249145,2249627933,2249627933,0
1361828250,2249628788,2,123,61.5,1361828243447,1361828243447,2249622235,2249622235,0
1361828250,2249628788,3,169,56.33333333,1361828243447,1361828243447,2249622235,2249622235,0
1361828250,2249628788,2,123,61.5,1361828243447,1361828243447,2249622235,2249622235,0
1361828251,2249630416,2,123,61.5,1361828223813,1361828223813,2249603229,2249603229,0
1361828251,2249630424,1,46,46,1361828224126,1361828224126,2249603550,2249603550,0
1361828267,2249646380,2,473,236.5,1361828241513,1361828241577,2249620893,2249620957,64
1361828272,2249650448,2,265,132.5,1361828246219,1361828246347,2249624667,2249624795,128
1361828280,2249658488,1,46,46,1361828255075,1361828255075,2249633563,2249633563,0
1361828296,2249674584,2,123,61.5,1361828269572,1361828269572,2249648156,2249648156,0
1361828308,2249686576,2,473,236.5,1361828282443,1361828282507,2249661019,2249661083,64
1361828312,2249690436,1,46,46,1361828285143,1361828285143,2249663579,2249663579,0
1361828314,2249692732,323,451026,1396.365325,1361828127343,1361828309551,2249506075,2249688283,182208
1361828314,2249692856,524,752351,1435.784351,1361828127217,1361828311409,2249506073,2249690265,184192
1361828322,2249700724,8,451,56.375,1361828314361,1361828315577,2249693085,2249694301,1216
1361828328,2249706520,2,265,132.5,1361828301764,1361828301956,2249680284,2249680476,192
1361828330,2249708824,3,144,48,1361828324113,1361828324113,2249702937,2249702937,0
1361828340,2249718564,2,123,61.5,1361828315031,1361828316759,2249693595,2249695323,1728
1361828344,2249722516,1,46,46,1361828317127,1361828317127,2249695643,2249695643,0
1361828344,2249722552,1,46,46,1361828318369,1361828318369,2249696921,2249696921,0
1361828348,2249726548,2,473,236.5,1361828322533,1361828322597,2249701081,2249701145,64
1361828370,2249748816,3,144,48,1361828368602,1361828368666,2249747418,2249747482,64
1361828372,2249750776,1,46,46,1361828344835,1361828344835,2249723611,2249723611,0
1361828384,2249762760,2,265,132.5,1361828357073,1361828357201,2249735833,2249735961,128
1361828388,2249766848,2,473,236.5,1361828361785,1361828361849,2249740633,2249740697,64
1361828396,2249774792,11,4686,426,1361828368691,1361828369139,2249747483,2249747931,448
1361828400,2249778940,2,92,46,1361828374686,1361828376542,2249753626,2249755482,1856
1361828402,2249780820,3,144,48,1361828399124,1361828399124,2249777944,2249777944,0
1361828428,2249806812,2,473,236.5,1361828402141,1361828402205,2249780953,2249781017,64
1361828432,2249810948,1,46,46,1361828404692,1361828404692,2249783640,2249783640,0
1361828440,2249818828,2,265,132.5,1361828413005,1361828413133,2249791833,2249791961,128
1361828440,2249818980,8,1902,237.75,1361828413750,1361828435574,2249792730,2249814554,21824
1361828442,2249820916,3,144,48,1361828436084,1361828436212,2249815000,2249815128,128
1361828442,2249820920,13,5202,400.1538462,1361828436211,1361828436403,2249815131,2249815323,192
1361828442,2249820920,3,144,48,1361828436400,1361828436528,2249815320,2249815448,128
1361828460,2249838908,1,46,46,1361828434748,1361828434748,2249813656,2249813656,0
1361828464,2249842956,13,8125,625,1361828436494,1361828436750,2249815450,2249815706,256
1361828468,2249846952,2,473,236.5,1361828441681,1361828441745,2249820633,2249820697,64
1361828482,2249860956,3,144,48,1361828473995,1361828474059,2249852951,2249853015,64
1361828492,2249870900,1,46,46,1361828464771,1361828464771,2249843671,2249843671,0
1361828496,2249874988,2,265,132.5,1361828468842,1361828468906,2249847830,2249847894,64
1361828508,2249886904,2,123,61.5,1361828480640,1361828480640,2249859544,2249859544,0
1361828508,2249887100,2,473,236.5,1361828482365,1361828482557,2249861465,2249861657,192
1361828508,2249887148,2,123,61.5,1361828481484,1361828481484,2249860632,2249860632,0
1361828521,2249899476,1,46,46,1361828495213,1361828495213,2249873689,2249873689,0
1361828548,2249926948,2,473,236.5,1361828522770,1361828522834,2249901718,2249901782,64
1361828552,2249930908,2,265,132.5,1361828524027,1361828524091,2249902935,2249902999,64
1361828552,2249930952,2,123,61.5,1361828525520,1361828525520,2249904472,2249904472,0
1361828552,2249931032,1,46,46,1361828524670,1361828524670,2249903702,2249903702,0
1361828552,2249931080,2,123,61.5,1361828526414,1361828526414,2249905494,2249905494,0
1361828554,2249933024,3,144,48,1361828548873,1361828548937,2249927897,2249927961,64
1361828580,2249959032,1,46,46,1361828554687,1361828554687,2249933719,2249933719,0
1361828588,2249967048,2,473,236.5,1361828562733,1361828562797,2249941781,2249941845,64
1361828596,2249975012,2,123,61.5,1361828570388,1361828570388,2249949400,2249949400,0
1361828596,2249975084,2,123,61.5,1361828571341,1361828571341,2249950425,2249950425,0
1361828604,2249983232,2,265,132.5,1361828579640,1361828579704,2249958872,2249958936,64
1361828612,2249991068,1,46,46,1361828584665,1361828584665,2249963733,2249963733,0
1361828618,2249996952,8,451,56.375,1361828616397,1361828617101,2249995349,2249996053,704
1361828618,2249997024,8,451,56.375,1361828615302,1361828616006,2249994326,2249995030,704
1361828628,2250007060,3,144,48,1361828623841,1361828623905,2250002901,2250002965,64
1361828628,2250007228,2,473,236.5,1361828602876,1361828602940,2249982104,2249982168,64
1361828640,2250019228,2,123,61.5,1361828614522,1361828618170,2249993750,2249997398,3648
1361828660,2250039192,2,265,132.5,1361828634847,1361828634975,2250014039,2250014167,128
1361828668,2250047196,2,473,236.5,1361828642651,1361828642779,2250021847,2250021975,128
1361828672,2250051120,1,46,46,1361828644646,1361828644646,2250023766,2250023766,0
1361828700,2250079396,1,46,46,1361828674385,1361828674385,2250053781,2250053781,0
1361828706,2250085188,3,144,48,1361828698722,1361828698786,2250077910,2250077974,64
1361828709,2250087420,2,473,236.5,1361828683362,1361828683490,2250061782,2250061910,128
1361828716,2250095276,2,265,132.5,1361828690823,1361828690951,2250070099,2250070227,128
1361828732,2250111276,1,46,46,1361828704522,1361828704522,2250083798,2250083798,0
1361828738,2250117180,3,144,48,1361828735465,1361828735529,2250114645,2250114709,64
1361828746,2250125204,8,1505,188.125,1361828736401,1361828741521,2250115605,2250120725,5120
1361828748,2250127340,2,473,236.5,1361828723081,1361828723145,2250102421,2250102485,64
1361828760,2250139396,12,2348,195.6666667,1361828735310,1361828735822,2250114706,2250115218,512
1361828761,2250139484,1,46,46,1361828735329,1361828735329,2250113813,2250113813,0
1361828765,2250143436,9,4966,551.7777778,1361828737168,1361828737296,2250115604,2250115732,128
1361828772,2250151352,2,265,132.5,1361828746043,1361828746171,2250125395,2250125523,128
1361828778,2250157208,3,144,48,1361828776397,1361828776461,2250155605,2250155669,64
1361828789,2250167444,2,473,236.5,1361828763850,1361828763978,2250142294,2250142422,128
1361828793,2250171552,1,46,46,1361828765276,1361828765276,2250143828,2250143828,0
1361828794,2250173280,7,436,62.28571429,1361828781060,1361828790084,2250160340,2250169364,9024
1361828797,2250176040,1,48,48,1361828772211,1361828772211,2250151251,2250151251,0
1361828801,2250179624,1,48,48,1361828772756,1361828772756,2250151380,2250151380,0
1361828809,2250187564,2,123,61.5,1361828780816,1361828780816,2250159380,2250159380,0
1361828821,2250199440,1,46,46,1361828795404,1361828795404,2250173844,2250173844,0
1361828829,2250207456,2,473,236.5,1361828803388,1361828803452,2250181844,2250181908,64
1361828829,2250207488,2,265,132.5,1361828802331,1361828802459,2250180819,2250180947,128
1361828850,2250229144,3,144,48,1361828848778,1361828848778,2250227922,2250227922,0
1361828852,2250231404,1,46,46,1361828824456,1361828824456,2250203860,2250203860,0
1361828853,2250231524,5,808,161.6,1361828825785,1361828849721,2250204309,2250228245,23936
1361828869,2250247600,2,473,236.5,1361828843307,1361828843371,2250221907,2250221971,64
1361828881,2250259580,1,46,46,1361828855296,1361828855296,2250233876,2250233876,0
1361828885,2250263576,2,265,132.5,1361828858243,1361828858371,2250236819,2250236947,128
1361828909,2250287628,2,473,236.5,1361828883662,1361828883726,2250262290,2250262354,64
1361828913,2250291584,1,46,46,1361828885304,1361828885304,2250263888,2250263888,0
1361828921,2250299652,2,123,61.5,1361828894517,1361828894517,2250273169,2250273169,0
1361828930,2250309292,3,144,48,1361828923637,1361828923637,2250302929,2250302929,0
1361828941,2250319740,2,265,132.5,1361828913437,1361828913501,2250292177,2250292241,64
1361828941,2250319748,2,123,61.5,1361828915157,1361828920917,2250293905,2250299665,5760
1361828949,2250327840,2,473,236.5,1361828922936,1361828923000,2250301776,2250301840,64
1361828965,2250343760,2,123,61.5,1361828939339,1361828939339,2250318099,2250318099,0
1361828973,2250351868,1,46,46,1361828945052,1361828945052,2250323920,2250323920,0
1361828989,2250367812,2,473,236.5,1361828963412,1361828963476,2250342224,2250342288,64
1361828993,2250371956,2,265,132.5,1361828968518,1361828968646,2250347474,2250347602,128
1361829001,2250379852,1,46,46,1361828975083,1361828975083,2250353935,2250353935,0
1361829002,2250381240,3,144,48,1361828998697,1361828998697,2250377937,2250377937,0
1361829009,2250387916,2,123,61.5,1361828984108,1361828984108,2250363024,2250363024,0
1361829029,2250408220,1,46,46,1361829004733,1361829004733,2250383953,2250383953,0
1361829029,2250408256,2,473,236.5,1361829002648,1361829002712,2250381904,2250381968,64
1361829034,2250413292,8,451,56.375,1361829028658,1361829029042,2250407950,2250408334,384
1361829042,2250421268,3,144,48,1361829036044,1361829036172,2250415312,2250415440,128
1361829049,2250428184,2,265,132.5,1361829024095,1361829024223,2250403279,2250403407,128
1361829050,2250429312,8,1505,188.125,1361829036894,1361829042014,2250416206,2250421326,5120
1361829061,2250440136,1,46,46,1361829034832,1361829034832,2250413968,2250413968,0
1361829061,2250440176,11,2229,202.6363636,1361829036265,1361829036649,2250415441,2250415825,384
1361829069,2250448296,2,473,236.5,1361829042543,1361829042607,2250421839,2250421903,64
1361829074,2250453356,3,144,48,1361829073588,1361829073588,2250452944,2250452944,0
1361829089,2250468224,1,46,46,1361829064760,1361829064760,2250443984,2250443984,0
1361829105,2250484276,2,123,61.5,1361829080644,1361829080644,2250459920,2250459920,0
1361829105,2250484380,2,265,132.5,1361829079898,1361829079962,2250459278,2250459342,64
1361829109,2250488176,2,473,236.5,1361829082406,1361829082470,2250461582,2250461646,64
1361829114,2250493292,11,5602,509.2727273,1361829091569,1361829106865,2250470861,2250486157,15296
1361829121,2250500172,1,46,46,1361829094762,1361829094762,2250473934,2250473934,0
1361829149,2250528340,2,473,236.5,1361829122561,1361829122625,2250501901,2250501965,64
1361829149,2250528408,1,46,46,1361829124541,1361829124541,2250503949,2250503949,0
1361829153,2250532212,2,123,61.5,1361829125633,1361829125633,2250504845,2250504845,0
1361829155,2250533456,3,144,48,1361829149493,1361829149493,2250527949,2250527949,0
1361829161,2250540252,2,265,132.5,1361829135452,1361829135580,2250514704,2250514832,128
1361829182,2250560576,1,46,46,1361829155391,1361829155391,2250533967,2250533967,0
1361829190,2250568560,2,473,236.5,1361829163535,1361829163599,2250542095,2250542159,64
1361829190,2250568568,1,46,46,1361829163910,1361829163910,2250542478,2250542478,0
1361829198,2250576548,2,123,61.5,1361829171225,1361829171225,2250549773,2250549773,0
1361829210,2250588804,1,46,46,1361829185179,1361829185179,2250563983,2250563983,0
1361829218,2250596584,2,265,132.5,1361829191349,1361829191477,2250569933,2250570061,128
1361829219,2250597524,8,451,56.375,1361829216177,1361829217393,2250594701,2250595917,1216
1361829227,2250605520,3,144,48,1361829224436,1361829224436,2250602956,2250602956,0
1361829230,2250608664,2,473,236.5,1361829203111,1361829203175,2250581775,2250581839,64
1361829242,2250620824,2,123,61.5,1361829215173,1361829223429,2250593997,2250602253,8256
1361829270,2250648736,2,473,236.5,1361829243357,1361829243421,2250622093,2250622157,64
1361829270,2250648784,1,46,46,1361829245230,1361829245230,2250624014,2250624014,0
1361829274,2250652840,2,265,132.5,1361829246646,1361829246710,2250625486,2250625550,64
1361829275,2250653532,4,1043,260.75,1361829273447,1361829273639,2250651979,2250652171,192
1361829290,2250669400,4,292,73,1361829285507,1361829285635,2250664907,2250665035,128
1361829290,2250669408,4,442,110.5,1361829285950,1361829286014,2250665358,2250665422,64
1361829291,2250669412,4,292,73,1361829287457,1361829287521,2250665869,2250665933,64
1361829291,2250669412,4,444,111,1361829287519,1361829287647,2250665931,2250666059,128
1361829291,2250669416,4,292,73,1361829287774,1361829287838,2250666190,2250666254,64
1361829291,2250669436,4,461,115.25,1361829287817,1361829287945,2250666253,2250666381,128
1361829291,2250669440,4,728,182,1361829288006,1361829288134,2250666446,2250666574,128
1361829291,2250669440,4,414,103.5,1361829288260,1361829288324,2250666700,2250666764,64
1361829291,2250669440,4,292,73,1361829284995,1361829285059,2250663435,2250663499,64
1361829291,2250669444,4,435,108.75,1361829288577,1361829288641,2250667021,2250667085,64
1361829291,2250669444,4,292,73,1361829285246,1361829285310,2250663690,2250663754,64
1361829291,2250669448,4,292,73,1361829285500,1361829285564,2250663948,2250664012,64
1361829291,2250669452,5,236,47.2,1361829285751,1361829286071,2250664203,2250664523,320
1361829291,2250669452,4,292,73,1361829289464,1361829289592,2250667916,2250668044,128
1361829291,2250669452,4,448,112,1361829289464,1361829289528,2250667916,2250667980,64
1361829291,2250669456,4,311,77.75,1361829289779,1361829289843,2250668235,2250668299,64
1361829291,2250669476,4,292,73,1361829286241,1361829286305,2250664717,2250664781,64
1361829291,2250669476,4,480,120,1361829286303,1361829286431,2250664779,2250664907,128
1361829291,2250669480,4,434,108.5,1361829286556,1361829286684,2250665036,2250665164,128
1361829291,2250669484,4,292,73,1361829286745,1361829286873,2250665229,2250665357,128
1361829291,2250669484,4,463,115.75,1361829287127,1361829287191,2250665611,2250665675,64
1361829291,2250669484,4,292,73,1361829286999,1361829287127,2250665483,2250665611,128
1361829291,2250669516,4,476,119,1361829287866,1361829287930,2250666382,2250666446,64
1361829291,2250669516,4,460,115,1361829288056,1361829288120,2250666572,2250666636,64
1361829291,2250669520,4,461,115.25,1361829288244,1361829288372,2250666764,2250666892,128
1361829291,2250669520,4,469,117.25,1361829288372,1361829288500,2250666892,2250667020,128
1361829291,2250669520,5,236,47.2,1361829288435,1361829288819,2250666955,2250667339,384
1361829291,2250669524,4,439,109.75,1361829285042,1361829285106,2250663566,2250663630,64
1361829291,2250669524,4,394,98.5,1361829285297,1361829285361,2250663821,2250663885,64
1361829291,2250669524,4,394,98.5,1361829285615,1361829285679,2250664139,2250664203,64
1361829291,2250669528,4,292,73,1361829285678,1361829285806,2250664206,2250664334,128
1361829291,2250669528,4,509,127.25,1361829285870,1361829285934,2250664398,2250664462,64
1361829291,2250669528,4,442,110.5,1361829288942,1361829289070,2250667470,2250667598,128
1361829291,2250669556,4,386,96.5,1361829289489,1361829289553,2250668045,2250668109,64
1361829291,2250669556,4,311,77.75,1361829289552,1361829289680,2250668108,2250668236,128
1361829299,2250677456,3,144,48,1361829292661,1361829292789,2250671117,2250671245,128
1361829302,2250680872,1,46,46,1361829275157,1361829275157,2250654029,2250654029,0
1361829307,2250685440,4,292,73,1361829303941,1361829304069,2250682381,2250682509,128
1361829307,2250685488,3,144,48,1361829299410,1361829299410,2250677898,2250677898,0
1361829310,2250689032,2,473,236.5,1361829283190,1361829283318,2250662222,2250662350,128
1361829323,2250701416,4,190,47.5,1361829318365,1361829318749,2250696781,2250697165,384
1361829323,2250701420,4,190,47.5,1361829318682,1361829319066,2250697102,2250697486,384
1361829323,2250701420,4,190,47.5,1361829318745,1361829319065,2250697165,2250697485,320
1361829323,2250701420,4,190,47.5,1361829315097,1361829315417,2250693517,2250693837,320
1361829323,2250701420,4,190,47.5,1361829315287,1361829315863,2250693707,2250694283,576
1361829323,2250701424,4,190,47.5,1361829314710,1361829315286,2250693134,2250693710,576
1361829323,2250701424,4,190,47.5,1361829314710,1361829315286,2250693134,2250693710,576
1361829323,2250701424,4,190,47.5,1361829315413,1361829315669,2250693837,2250694093,256
1361829323,2250701424,4,190,47.5,1361829315667,1361829315923,2250694091,2250694347,256
1361829323,2250701424,4,190,47.5,1361829315667,1361829315987,2250694091,2250694411,320
1361829323,2250701428,4,190,47.5,1361829315921,1361829316177,2250694349,2250694605,256
1361829323,2250701428,4,190,47.5,1361829315921,1361829316177,2250694349,2250694605,256
1361829323,2250701428,4,190,47.5,1361829315985,1361829316241,2250694413,2250694669,256
1361829323,2250701428,4,190,47.5,1361829316176,1361829316432,2250694604,2250694860,256
1361829323,2250701428,4,190,47.5,1361829316240,1361829316560,2250694668,2250694988,320
1361829323,2250701428,4,190,47.5,1361829316431,1361829316687,2250694859,2250695115,256
1361829323,2250701428,4,190,47.5,1361829316558,1361829316814,2250694986,2250695242,256
1361829323,2250701452,4,190,47.5,1361829316663,1361829316919,2250695115,2250695371,256
1361829323,2250701456,4,190,47.5,1361829316853,1361829317301,2250695309,2250695757,448
1361829323,2250701456,4,190,47.5,1361829317043,1361829317491,2250695499,2250695947,448
1361829323,2250701460,4,190,47.5,1361829317362,1361829317426,2250695822,2250695886,64
1361829323,2250701460,4,190,47.5,1361829317360,1361829317808,2250695820,2250696268,448
1361829323,2250701460,4,190,47.5,1361829317360,1361829317424,2250695820,2250695884,64
1361829323,2250701460,4,190,47.5,1361829317488,1361829318000,2250695948,2250696460,512
1361829323,2250701460,4,190,47.5,1361829317424,1361829317488,2250695884,2250695948,64
1361829323,2250701464,4,190,47.5,1361829317482,1361829317610,2250695946,2250696074,128
1361829323,2250701464,4,190,47.5,1361829317613,1361829317677,2250696077,2250696141,64
1361829323,2250701464,4,190,47.5,1361829317613,1361829317741,2250696077,2250696205,128
1361829323,2250701464,4,190,47.5,1361829317931,1361829318251,2250696395,2250696715,320
1361829323,2250701464,4,190,47.5,1361829317931,1361829318315,2250696395,2250696779,384
1361829323,2250701492,4,190,47.5,1361829318287,1361829318671,2250696779,2250697163,384
1361829323,2250701496,4,190,47.5,1361829318540,1361829320908,2250697036,2250699404,2368
1361829323,2250701496,4,190,47.5,1361829318540,1361829318860,2250697036,2250697356,320
1361829323,2250701496,4,190,47.5,1361829315019,1361829315339,2250693515,2250693835,320
1361829323,2250701496,4,190,47.5,1361829315083,1361829317387,2250693579,2250695883,2304
1361829323,2250701500,4,190,47.5,1361829318856,1361829319240,2250697356,2250697740,384
1361829323,2250701500,4,190,47.5,1361829318983,1361829319367,2250697483,2250697867,384
1361829323,2250701500,4,190,47.5,1361829314631,1361829315207,2250693131,2250693707,576
1361829323,2250701500,4,190,47.5,1361829318983,1361829319367,2250697483,2250697867,384
1361829323,2250701500,4,190,47.5,1361829314630,1361829315142,2250693130,2250693642,512
1361829323,2250701504,4,190,47.5,1361829315334,1361829315590,2250693838,2250694094,256
1361829323,2250701504,4,190,47.5,1361829315586,1361829315842,2250694090,2250694346,256
1361829323,2250701508,4,190,47.5,1361829316095,1361829316351,2250694603,2250694859,256
1361829323,2250701512,4,190,47.5,1361829316348,1361829316604,2250694860,2250695116,256
1361829323,2250701536,4,190,47.5,1361829316581,1361829316837,2250695117,2250695373,256
1361829323,2250701536,4,190,47.5,1361829316963,1361829317411,2250695499,2250695947,448
1361829323,2250701540,4,190,47.5,1361829317344,1361829317472,2250695884,2250696012,128
1361829323,2250701540,4,190,47.5,1361829317471,1361829317535,2250696011,2250696075,64
1361829323,2250701540,4,190,47.5,1361829317535,1361829317663,2250696075,2250696203,128
1361829323,2250701540,4,190,47.5,1361829317598,1361829317726,2250696138,2250696266,128
1361829323,2250701544,4,190,47.5,1361829317786,1361829318106,2250696330,2250696650,320
1361829323,2250701544,4,190,47.5,1361829317789,1361829318109,2250696333,2250696653,320
1361829323,2250701544,4,190,47.5,1361829318108,1361829318492,2250696652,2250697036,384
1361829323,2250701544,4,190,47.5,1361829318107,1361829318427,2250696651,2250696971,320
1361829330,2250708924,2,265,132.5,1361829302560,1361829302624,2250681484,2250681548,64
1361829330,2250709000,1,46,46,1361829305043,1361829305043,2250684043,2250684043,0
1361829331,2250709580,3,144,48,1361829329784,1361829329848,2250708364,2250708428,64
1361829350,2250729024,2,473,236.5,1361829323259,1361829323323,2250702283,2250702347,64
1361829354,2250733168,16,5383,336.4375,1361829329258,1361829337322,2250708426,2250716490,8064
1361829362,2250741140,1,46,46,1361829334919,1361829334919,2250714059,2250714059,0
1361829363,2250741432,4,312,78,1361829358540,1361829358604,2250736972,2250737036,64
1361829379,2250757576,3,144,48,1361829374330,1361829374394,2250752906,2250752970,64
1361829382,2250760980,2,265,132.5,1361829357865,1361829357993,2250736845,2250736973,128
1361829390,2250769056,2,473,236.5,1361829362905,1361829362969,2250741961,2250742025,64
1361829390,2250769120,1,46,46,1361829364956,1361829364956,2250744076,2250744076,0
1361829410,2250789164,3,200,66.66666667,1361829382128,1361829382384,2250761292,2250761548,256
1361829422,2250801208,1,46,46,1361829394882,1361829394882,2250774090,2250774090,0
1361829430,2250809208,2,473,236.5,1361829402691,1361829402819,2250781899,2250782027,128
1361829438,2250817212,2,265,132.5,1361829413118,1361829413246,2250792330,2250792458,128
1361829450,2250829224,1,46,46,1361829424881,1361829424881,2250804105,2250804105,0
1361829454,2250833168,2,123,61.5,1361829427048,1361829427048,2250806216,2250806216,0
1361829459,2250837620,3,144,48,1361829451980,1361829452044,2250830600,2250830664,64
1361829470,2250849276,2,473,236.5,1361829442621,1361829442685,2250821897,2250821961,64
1361829482,2250861284,1,46,46,1361829454839,1361829454839,2250834123,2250834123,0
1361829495,2250873616,2,265,132.5,1361829469202,1361829469330,2250847818,2250847946,128
1361829499,2250877632,2,767,383.5,1361829471233,1361829471361,2250849865,2250849993,128
1361829499,2250877648,2,123,61.5,1361829472497,1361829472497,2250851145,2250851145,0
1361829511,2250889540,1,46,46,1361829485599,1361829485599,2250864139,2250864139,0
1361829515,2250893844,3,144,48,1361829509101,1361829509101,2250887945,2250887945,0
1361829515,2250893884,4,312,78,1361829514501,1361829514565,2250893385,2250893449,64
1361829523,2250901856,8,451,56.375,1361829517216,1361829518176,2250896072,2250897032,960
1361829523,2250901872,4,312,78,1361829514706,1361829514770,2250893578,2250893642,64
1361829523,2250901896,4,312,78,1361829514554,1361829514682,2250893450,2250893578,128
1361829523,2250901896,4,312,78,1361829514617,1361829514681,2250893513,2250893577,64
1361829539,2250917552,2,473,236.5,1361829511248,1361829511312,2250889800,2250889864,64
1361829539,2250917740,4,1962,490.5,1361829514453,1361829514773,2250893193,2250893513,320
1361829539,2250917752,16,17765,1110.3125,1361829514568,1361829514760,2250893320,2250893512,192
1361829543,2250921488,2,123,61.5,1361829515666,1361829526226,2250894154,2250904714,10560
1361829551,2250929564,2,265,132.5,1361829525317,1361829525381,2250903881,2250903945,64
1361829571,2250949552,1,46,46,1361829545616,1361829545616,2250924168,2250924168,0
1361829579,2250957536,2,473,236.5,1361829551966,1361829552030,2250930502,2250930566,64
1361829587,2250965992,3,144,48,1361829583960,1361829583960,2250962952,2250962952,0
1361829603,2250981568,1,46,46,1361829575617,1361829575617,2250954185,2250954185,0
1361829607,2250985588,2,265,132.5,1361829580588,1361829580716,2250959176,2250959304,128
1361829619,2250997692,2,473,236.5,1361829592067,1361829592131,2250970759,2250970823,64
1361829631,2251009716,1,46,46,1361829605483,1361829605483,2250984199,2250984199,0
1361829643,2251021904,3,144,48,1361829637679,1361829637743,2251016583,2251016647,64
1361829651,2251029888,8,1505,188.125,1361829638653,1361829643773,2251017541,2251022661,5120
1361829655,2251033632,1,46,46,1361829630333,1361829630333,2251008965,2251008965,0
1361829655,2251033728,1,46,46,1361829630241,1361829630241,2251008969,2251008969,0
1361829659,2251037612,2,473,236.5,1361829632915,1361829632979,2251011527,2251011591,64
1361829663,2251041676,1,46,46,1361829635539,1361829635539,2251014215,2251014215,0
1361829663,2251041684,2,265,132.5,1361829636106,1361829636234,2251014790,2251014918,128
1361829663,2251041748,11,2198,199.8181818,1361829637899,1361829638411,2251016647,2251017159,512
1361829667,2251045932,3,144,48,1361829658963,1361829659027,2251037895,2251037959,64
1361829691,2251069652,1,46,46,1361829665577,1361829665577,2251044229,2251044229,0
1361829699,2251077684,2,473,236.5,1361829673740,1361829673804,2251052424,2251052488,64
1361829707,2251085812,2,123,61.5,1361829682697,1361829682697,2251061509,2251061509,0
1361829719,2251097648,2,265,132.5,1361829692015,1361829692079,2251070663,2251070727,64
1361829723,2251101768,1,46,46,1361829695477,1361829695477,2251074245,2251074245,0
1361829739,2251118044,2,473,236.5,1361829713313,1361829713377,2251092357,2251092421,64
1361829739,2251118196,3,144,48,1361829733707,1361829733771,2251112903,2251112967,64
1361829751,2251129844,2,92,46,1361829725417,1361829737961,2251104261,2251116805,12544
1361829755,2251133700,2,123,61.5,1361829727737,1361829727737,2251106437,2251106437,0
1361829775,2251153860,2,265,132.5,1361829747609,1361829747673,2251126469,2251126533,64
1361829779,2251157780,2,473,236.5,1361829753002,1361829753066,2251131782,2251131846,64
1361829783,2251161764,1,46,46,1361829755514,1361829755514,2251134278,2251134278,0
1361829799,2251177760,2,123,61.5,1361829772603,1361829772603,2251151363,2251151363,0
1361829811,2251189804,1,46,46,1361829785488,1361829785488,2251164292,2251164292,0
1361829819,2251197912,2,473,236.5,1361829793317,1361829793445,2251172229,2251172357,128
1361829819,2251198224,3,144,48,1361829811691,1361829811755,2251190915,2251190979,64
1361829831,2251209852,2,265,132.5,1361829803617,1361829803681,2251182469,2251182533,64
1361829835,2251214056,3,685,228.3333333,1361829809747,1361829810003,2251188803,2251189059,256
1361829843,2251221996,3,200,66.66666667,1361829815311,1361829828047,2251194307,2251207043,12736
1361829859,2251237952,2,473,236.5,1361829832894,1361829832958,2251211846,2251211910,64
1361829871,2251249956,1,46,46,1361829845368,1361829845368,2251224324,2251224324,0
1361829879,2251257996,2,123,61.5,1361829854223,1361829854223,2251233219,2251233219,0
1361829887,2251266052,2,265,132.5,1361829858966,1361829859094,2251238018,2251238146,128
1361829891,2251270364,3,144,48,1361829883549,1361829883613,2251262913,2251262977,64
1361829899,2251278112,2,473,236.5,1361829873306,1361829873370,2251252418,2251252482,64
1361829903,2251282036,1,46,46,1361829875303,1361829875303,2251254339,2251254339,0
1361829927,2251306060,2,123,61.5,1361829899086,1361829899086,2251278146,2251278146,0
1361829931,2251310132,1,46,46,1361829905223,1361829905223,2251284355,2251284355,0
1361829939,2251318016,2,473,236.5,1361829913212,1361829913276,2251292228,2251292292,64
1361829943,2251322120,2,265,132.5,1361829914897,1361829915025,2251294017,2251294145,128
1361829963,2251341952,1,46,46,1361829935419,1361829935419,2251314371,2251314371,0
1361829963,2251342032,6,1603,267.1666667,1361829938156,1361829938540,2251317188,2251317572,384
1361829964,2251342504,3,144,48,1361829959417,1361829959417,2251337921,2251337921,0
1361829979,2251358024,2,473,236.5,1361829952947,1361829953011,2251331971,2251332035,64
1361829992,2251370504,1,46,46,1361829965883,1361829965883,2251344387,2251344387,0
1361829996,2251374444,2,265,132.5,1361829971447,1361829971575,2251349891,2251350019,128
1361830007,2251386284,2,123,61.5,1361829982765,1361829982765,2251362049,2251362049,0
1361830019,2251398328,2,473,236.5,1361829992579,1361829992643,2251371907,2251371971,64
1361830023,2251402380,1,46,46,1361829995023,1361829995023,2251374403,2251374403,0
1361830036,2251414788,3,144,48,1361830034206,1361830034206,2251412994,2251412994,0
1361830051,2251430364,1,46,46,1361830025054,1361830025054,2251404418,2251404418,0
1361830051,2251430392,2,265,132.5,1361830026047,1361830026111,2251405439,2251405503,64
1361830056,2251434436,2,123,61.5,1361830028541,1361830028541,2251406977,2251406977,0
1361830059,2251438380,2,473,236.5,1361830032715,1361830032779,2251412095,2251412159,64
1361830084,2251462440,1,46,46,1361830055994,1361830055994,2251434434,2251434434,0
1361830100,2251478436,2,123,61.5,1361830073468,1361830073468,2251451904,2251451904,0
1361830100,2251478528,2,473,236.5,1361830073249,1361830073313,2251451777,2251451841,64
1361830108,2251486540,2,265,132.5,1361830082387,1361830082451,2251460927,2251460991,64
1361830112,2251490464,1,46,46,1361830085984,1361830085984,2251464448,2251464448,0
1361830116,2251494788,3,144,48,1361830111835,1361830111835,2251490623,2251490623,0
1361830124,2251502784,8,451,56.375,1361830118049,1361830119201,2251496833,2251497985,1152
1361830140,2251518468,2,473,236.5,1361830114075,1361830114139,2251492543,2251492607,64
1361830143,2251522408,2,123,61.5,1361830115055,1361830129967,2251494463,2251509375,14912
1361830164,2251542532,2,265,132.5,1361830138076,1361830138204,2251516608,2251516736,128
1361830172,2251550476,1,46,46,1361830146002,1361830146002,2251524478,2251524478,0
1361830180,2251558640,3,900,300,1361830154095,1361830154479,2251532735,2251533119,384
1361830188,2251566980,3,144,48,1361830183963,1361830183963,2251562943,2251562943,0
1361830204,2251582584,1,46,46,1361830175847,1361830175847,2251554431,2251554431,0
1361830220,2251598596,2,473,236.5,1361830194522,1361830194650,2251573118,2251573246,128
1361830220,2251598692,2,265,132.5,1361830193721,1361830193785,2251572413,2251572477,64
1361830228,2251607124,3,144,48,1361830224970,1361830225034,2251604094,2251604158,64
1361830232,2251610572,1,46,46,1361830205875,1361830205875,2251584447,2251584447,0
1361830236,2251614936,8,544,68,1361830227528,1361830232584,2251606464,2251611520,5056
1361830236,2251615012,8,1452,181.5,1361830227196,1361830232508,2251606208,2251611520,5312
1361830252,2251630576,40,49891,1247.275,1361830227630,1361830227950,2251606206,2251606526,320
1361830252,2251630580,12,12150,1012.5,1361830227627,1361830228011,2251606207,2251606591,384
1361830252,2251630624,35,31062,887.4857143,1361830225533,1361830239229,2251604157,2251617853,13696
1361830252,889944956,11,10706,973.2727273,1361830227291,1361830227355,889920247,889920311,64
1361830256,2251634500,9,7388,820.8888889,1361830227962,1361830228090,2251606462,2251606590,128
1361830256,2251634500,10,8527,852.7,1361830227962,1361830228090,2251606462,2251606590,128
1361830256,2251634500,9,7340,815.5555556,1361830227962,1361830228090,2251606462,2251606590,128
1361830256,2251634500,7,5399,771.2857143,1361830227961,1361830228089,2251606461,2251606589,128
1361830256,2251634612,7,4866,695.1428571,1361830227851,1361830227979,2251606463,2251606591,128
1361830256,2251634612,9,6855,761.6666667,1361830227850,1361830227978,2251606462,2251606590,128
1361830260,2251638684,3,525,175,1361830233985,1361830234049,2251612669,2251612733,64
1361830260,2251639032,3,144,48,1361830258918,1361830258918,2251637950,2251637950,0
1361830264,2251642596,1,46,46,1361830235865,1361830235865,2251614461,2251614461,0
1361830276,2251654648,2,265,132.5,1361830249063,1361830249191,2251627711,2251627839,128
1361830292,2251670700,1,46,46,1361830265775,1361830265775,2251644475,2251644475,0
1361830300,2251678544,2,765,382.5,1361830272779,1361830272907,2251651323,2251651451,128
1361830300,2251678652,3,200,66.66666667,1361830272480,1361830272736,2251651132,2251651388,256
1361830308,2251686768,5,808,161.6,1361830283372,1361830290412,2251662140,2251669180,7040
1361830321,2251700024,1,48,48,1361830293675,1361830293675,2251672699,2251672699,0
1361830321,2251700028,1,48,48,1361830293673,1361830293673,2251672701,2251672701,0
1361830324,2251702528,1,46,46,1361830295964,1361830295964,2251674492,2251674492,0
1361830332,2251710540,2,265,132.5,1361830305169,1361830305233,2251683709,2251683773,64
1361830340,2251718752,2,473,236.5,1361830312382,1361830312446,2251691134,2251691198,64
1361830340,2251719028,3,144,48,1361830333864,1361830333928,2251712892,2251712956,64
1361830344,2251722784,2,123,61.5,1361830317275,1361830317275,2251696059,2251696059,0
1361830345,890037924,3,169,56.33333333,1361830342778,1361830342778,890035702,890035702,0
1361830348,2251726964,3,169,56.33333333,1361830343528,1361830343528,2251722492,2251722492,0
1361830348,2251726964,3,169,56.33333333,1361830343528,1361830343528,2251722492,2251722492,0
1361830348,2251726964,3,169,56.33333333,1361830343527,1361830343527,2251722491,2251722491,0
1361830348,2251726964,3,169,56.33333333,1361830343527,1361830343527,2251722491,2251722491,0
1361830348,2251727104,3,169,56.33333333,1361830343390,1361830343390,2251722494,2251722494,0
1361830348,2251727104,3,169,56.33333333,1361830343390,1361830343390,2251722494,2251722494,0
1361830348,2251727104,3,169,56.33333333,1361830343390,1361830343390,2251722494,2251722494,0
1361830352,2251730684,1,46,46,1361830325823,1361830325823,2251704507,2251704507,0
1361830360,2251738836,2,123,61.5,1361830335209,1361830335209,2251714045,2251714045,0
1361830380,2251758744,2,473,236.5,1361830351938,1361830352002,2251730682,2251730746,64
1361830380,2251758852,1,46,46,1361830355674,1361830355674,2251734526,2251734526,0
1361830388,2251766676,2,265,132.5,1361830360520,1361830360648,2251739196,2251739324,128
1361830388,2251766836,2,123,61.5,1361830362150,1361830362150,2251740986,2251740986,0
1361830408,2251786792,2,123,61.5,1361830380181,1361830380181,2251758973,2251758973,0
1361830412,2251790828,1,46,46,1361830385713,1361830385713,2251764541,2251764541,0
1361830412,2251791044,3,144,48,1361830408857,1361830408921,2251787901,2251787965,64
1361830412,2251791072,8,451,56.375,1361830406844,1361830408444,2251785916,2251787516,1600
1361830412,2251791108,136,175182,1288.102941,1361830227095,1361830408407,2251606203,2251787515,181312
1361830420,2251798772,2,473,236.5,1361830391912,1361830391976,2251770684,2251770748,64
1361830428,2251807060,83,103382,1245.566265,1361830412489,1361830422857,2251791549,2251801917,10368
1361830428,2251807100,109,140690,1290.733945,1361830422881,1361830425249,2251801981,2251804349,2368
1361830428,2251807100,3,144,48,1361830422944,1361830423136,2251802044,2251802236,192
1361830440,2251818784,1,46,46,1361830415261,1361830415261,2251794045,2251794045,0
1361830444,2251822740,2,123,61.5,1361830415816,1361830433224,2251794556,2251811964,17408
1361830444,2251822744,1,46,46,1361830416069,1361830416069,2251794813,2251794813,0
1361830444,2251822864,2,265,132.5,1361830415885,1361830415949,2251794749,2251794813,64
1361830452,2251830728,2,123,61.5,1361830425170,1361830425170,2251803898,2251803898,0
1361830460,2251838724,2,473,236.5,1361830432344,1361830432408,2251811068,2251811132,64
1361830472,2251850796,1,46,46,1361830445776,1361830445776,2251824572,2251824572,0
1361830476,2251855156,8,451,56.375,1361830469671,1361830470375,2251848827,2251849531,704
1361830484,2251863060,3,144,48,1361830483846,1361830483910,2251862906,2251862970,64
1361830496,2251874844,2,265,132.5,1361830471328,1361830471392,2251850172,2251850236,64
1361830500,2251878824,1,46,46,1361830475762,1361830475762,2251854586,2251854586,0
1361830500,2251878828,2,473,236.5,1361830471918,1361830471982,2251850746,2251850810,64
1361830512,2251890928,10,3978,397.8,1361830485576,1361830485768,2251864504,2251864696,192
1361830532,2251910948,1,46,46,1361830505653,1361830505653,2251884601,2251884601,0
1361830540,2251918812,2,473,236.5,1361830512575,1361830512639,2251891387,2251891451,64
1361830540,2251919400,5,236,47.2,1361830538611,1361830539571,2251918011,2251918971,960
1361830552,2251930960,2,265,132.5,1361830526826,1361830526954,2251905786,2251905914,128
1361830560,2251939012,1,46,46,1361830535603,1361830535603,2251914615,2251914615,0
1361830564,2251943040,13,2128,163.6923077,1361830539034,1361830540634,2251918074,2251919674,1600
1361830564,2251943360,3,144,48,1361830558552,1361830558616,2251937912,2251937976,64
1361830568,2251946944,5,430,86,1361830540473,1361830540665,2251919417,2251919609,192
1361830580,2251958908,2,473,236.5,1361830551899,1361830551963,2251930807,2251930871,64
1361830592,2251970900,1,46,46,1361830565735,1361830565735,2251944635,2251944635,0
1361830597,2251975468,7,405,57.85714286,1361830586006,1361830594902,2251964474,2251973370,8896
1361830608,2251987036,2,265,132.5,1361830582302,1361830582366,2251961338,2251961402,64
1361830612,2251990912,2,123,61.5,1361830585562,1361830585562,2251964474,2251964474,0
1361830620,2251998964,2,473,236.5,1361830592354,1361830592418,2251971318,2251971382,64
1361830620,2251999044,1,46,46,1361830595606,1361830595606,2251974650,2251974650,0
1361830637,2252015444,3,144,48,1361830634476,1361830634476,2252012920,2252012920,0
1361830652,2252031016,1,46,46,1361830625648,1361830625648,2252004664,2252004664,0
1361830656,2252034936,2,123,61.5,1361830630401,1361830630401,2252009337,2252009337,0
1361830660,2252038904,2,473,236.5,1361830632480,1361830632544,2252011384,2252011448,64
1361830664,2252043140,2,265,132.5,1361830637877,1361830637941,2252017017,2252017081,64
1361830680,2252059200,1,46,46,1361830655543,1361830655543,2252034743,2252034743,0
1361830700,2252079020,2,473,236.5,1361830672042,1361830672106,2252051062,2252051126,64
1361830700,2252079216,2,123,61.5,1361830675046,1361830675046,2252054262,2252054262,0
1361830700,2252079360,3,144,48,1361830693592,1361830693592,2252072952,2252072952,0
1361830712,2252091156,1,46,46,1361830685539,1361830685539,2252064695,2252064695,0
1361830720,2252099312,2,265,132.5,1361830693253,1361830693381,2252072565,2252072693,128
1361830725,2252103440,8,451,56.375,1361830720751,1361830721455,2252099191,2252099895,704
1361830740,2252119196,2,123,61.5,1361830715516,1361830735292,2252094712,2252114488,19776
1361830740,2252119220,2,473,236.5,1361830712162,1361830712226,2252091382,2252091446,64
1361830741,2252119568,4,336,84,1361830735856,1361830735984,2252114424,2252114552,128
1361830752,2252131100,1,46,46,1361830725594,1361830725594,2252104694,2252104694,0
1361830772,2252151228,1,46,46,1361830745499,1361830745499,2252124727,2252124727,0
1361830773,2252151456,3,144,48,1361830770783,1361830770847,2252149239,2252149303,64
1361830773,2252151500,3,144,48,1361830769395,1361830769459,2252147895,2252147959,64
1361830776,2252155120,2,265,132.5,1361830748807,1361830748871,2252127927,2252127991,64
1361830780,2252159084,2,473,236.5,1361830752425,1361830752489,2252131509,2252131573,64
1361830796,2252175276,8,1121,140.125,1361830770026,1361830770410,2252149302,2252149686,384
1361830800,2252179176,1,46,46,1361830775565,1361830775565,2252154741,2252154741,0
1361830820,2252199172,2,473,236.5,1361830792851,1361830792915,2252172023,2252172087,64
1361830832,2252211188,2,92,46,1361830805568,1361830829312,2252184756,2252208500,23744
1361830832,2252211276,2,265,132.5,1361830804715,1361830804779,2252183991,2252184055,64
1361830841,2252219648,2,123,61.5,1361830815836,1361830815836,2252194484,2252194484,0
1361830845,2252223896,3,144,48,1361830844007,1361830844071,2252222903,2252222967,64
1361830853,2252231792,8,1505,188.125,1361830841742,1361830846862,2252220534,2252225654,5120
1361830861,2252239656,2,473,236.5,1361830832981,1361830833045,2252211637,2252211701,64
1361830861,2252239740,1,46,46,1361830836034,1361830836034,2252214774,2252214774,0
1361830869,2252247476,7,1886,269.4285714,1361830841287,1361830841671,2252219763,2252220147,384
1361830869,2252247676,7,4450,635.7142857,1361830841857,1361830841985,2252220533,2252220661,128
1361830873,2252251620,1,46,46,1361830846136,1361830846136,2252224756,2252224756,0
1361830889,2252267676,2,265,132.5,1361830860994,1361830861058,2252239670,2252239734,64
1361830893,2252271696,1,46,46,1361830866091,1361830866091,2252244787,2252244787,0
1361830901,2252279676,2,473,236.5,1361830872960,1361830873024,2252251636,2252251700,64
1361830913,2252291596,2,123,61.5,1361830885778,1361830885778,2252264374,2252264374,0
1361830921,2252299828,1,46,46,1361830895975,1361830895975,2252274803,2252274803,0
1361830925,2252303976,3,144,48,1361830918932,1361830918996,2252297908,2252297972,64
1361830941,2252319832,2,473,236.5,1361830913060,1361830913124,2252291892,2252291956,64
1361830941,2252319932,2,265,132.5,1361830916350,1361830916478,2252295282,2252295410,128
1361830953,2252331764,1,46,46,1361830926054,1361830926054,2252304818,2252304818,0
1361830957,2252335876,2,123,61.5,1361830930424,1361830930424,2252309300,2252309300,0
1361830965,2252343972,3,169,56.33333333,1361830957656,1361830957656,2252336628,2252336628,0
1361830981,2252359704,2,473,236.5,1361830953057,1361830953121,2252331761,2252331825,64
1361830981,2252359792,1,46,46,1361830956043,1361830956043,2252334835,2252334835,0
1361830997,2252376128,2,265,132.5,1361830972153,1361830972217,2252351281,2252351345,64
1361830997,2252376184,3,144,48,1361830993732,1361830993732,2252372916,2252372916,0
1361831001,2252380152,2,123,61.5,1361830975075,1361830975075,2252354227,2252354227,0
1361831013,2252391928,1,46,46,1361830985924,1361830985924,2252364852,2252364852,0
1361831021,2252399960,2,473,236.5,1361830993060,1361830993124,2252372020,2252372084,64
1361831030,2252408424,8,451,56.375,1361831020729,1361831022265,2252399153,2252400689,1536
1361831041,2252419988,2,123,61.5,1361831015878,1361831038022,2252394866,2252417010,22144
1361831053,2252432260,2,265,132.5,1361831028086,1361831028150,2252407346,2252407410,64
1361831057,2252436032,2,473,236.5,1361831032665,1361831032729,2252411697,2252411761,64
1361831073,2252452100,1,46,46,1361831045782,1361831045782,2252424882,2252424882,0
1361831078,2252456440,3,144,48,1361831070506,1361831070506,2252448946,2252448946,0
1361831097,2252476160,2,473,236.5,1361831072792,1361831072856,2252451952,2252452016,64
1361831101,2252480276,1,46,46,1361831075620,1361831075620,2252454896,2252454896,0
1361831109,2252488232,2,265,132.5,1361831083856,1361831083984,2252463088,2252463216,128
1361831125,2252504380,4,190,47.5,1361831120766,1361831121342,2252500146,2252500722,576
1361831125,2252504380,4,190,47.5,1361831120893,1361831121149,2252500273,2252500529,256
1361831125,2252504380,4,190,47.5,1361831120892,1361831121148,2252500272,2252500528,256
1361831125,2252504384,4,190,47.5,1361831121210,1361831121466,2252500594,2252500850,256
1361831125,2252504384,4,190,47.5,1361831121210,1361831121466,2252500594,2252500850,256
1361831125,2252504384,4,190,47.5,1361831121210,1361831121466,2252500594,2252500850,256
1361831125,2252504384,4,190,47.5,1361831121463,1361831121719,2252500847,2252501103,256
1361831125,2252504384,4,190,47.5,1361831121463,1361831121719,2252500847,2252501103,256
1361831125,2252504388,4,190,47.5,1361831121717,1361831121973,2252501105,2252501361,256
1361831125,2252504388,4,190,47.5,1361831121717,1361831121973,2252501105,2252501361,256
1361831125,2252504392,4,190,47.5,1361831121971,1361831122227,2252501363,2252501619,256
1361831126,2252504420,4,190,47.5,1361831123196,1361831123452,2252501616,2252501872,256
1361831126,2252504424,4,190,47.5,1361831123323,1361831123771,2252501747,2252502195,448
1361831126,2252504428,4,190,47.5,1361831123574,1361831124022,2252502002,2252502450,448
1361831126,2252504428,4,190,47.5,1361831123764,1361831124276,2252502192,2252502704,512
1361831126,2252504428,4,190,47.5,1361831123955,1361831124019,2252502383,2252502447,64
1361831126,2252504432,4,190,47.5,1361831124082,1361831124146,2252502514,2252502578,64
1361831126,2252504432,4,190,47.5,1361831124016,1361831124464,2252502448,2252502896,448
1361831126,2252504432,4,190,47.5,1361831124016,1361831124144,2252502448,2252502576,128
1361831126,2252504432,4,190,47.5,1361831124207,1361831124335,2252502639,2252502767,128
1361831126,2252504436,4,190,47.5,1361831121134,1361831121710,2252499570,2252500146,576
1361831126,2252504436,4,190,47.5,1361831121198,1361831121710,2252499634,2252500146,512
1361831126,2252504436,4,190,47.5,1361831124269,1361831124333,2252502705,2252502769,64
1361831126,2252504436,4,190,47.5,1361831124461,1361831125101,2252502897,2252503537,640
1361831126,2252504436,4,190,47.5,1361831124460,1361831125100,2252502896,2252503536,640
1361831126,2252504436,4,190,47.5,1361831124524,1361831125100,2252502960,2252503536,576
1361831126,2252504440,4,190,47.5,1361831125098,1361831125482,2252503538,2252503922,384
1361831126,2252504460,4,190,47.5,1361831121555,1361831123859,2252500015,2252502319,2304
1361831126,2252504460,4,190,47.5,1361831121555,1361831121811,2252500015,2252500271,256
1361831126,2252504460,4,190,47.5,1361831121555,1361831121811,2252500015,2252500271,256
1361831126,2252504468,4,190,47.5,1361831122379,1361831122635,2252500847,2252501103,256
1361831126,2252504476,4,190,47.5,1361831122631,1361831122887,2252501107,2252501363,256
1361831126,2252504476,4,190,47.5,1361831122884,1361831123140,2252501360,2252501616,256
1361831126,2252504476,4,190,47.5,1361831122884,1361831123140,2252501360,2252501616,256
1361831126,2252504500,4,190,47.5,1361831123116,1361831123372,2252501616,2252501872,256
1361831126,2252504504,4,190,47.5,1361831123495,1361831123943,2252501999,2252502447,448
1361831126,2252504508,4,190,47.5,1361831123748,1361831123876,2252502256,2252502384,128
1361831126,2252504512,4,190,47.5,1361831124066,1361831124130,2252502578,2252502642,64
1361831126,2252504512,4,190,47.5,1361831124065,1361831124193,2252502577,2252502705,128
1361831126,2252504512,4,190,47.5,1361831121057,1361831121569,2252499569,2252500081,512
1361831126,2252504512,4,190,47.5,1361831121057,1361831121633,2252499569,2252500145,576
1361831126,2252504512,4,190,47.5,1361831124193,1361831124321,2252502705,2252502833,128
1361831126,2252504516,4,190,47.5,1361831125021,1361831125341,2252503537,2252503857,320
1361831126,2252504540,4,190,47.5,1361831124997,1361831125317,2252503537,2252503857,320
1361831133,2252512096,1,46,46,1361831105817,1361831105817,2252484913,2252484913,0
1361831133,2252512388,4,190,47.5,1361831124852,1361831125172,2252504240,2252504560,320
1361831133,2252512388,4,190,47.5,1361831124852,1361831125236,2252504240,2252504624,384
1361831133,2252512392,4,190,47.5,1361831125167,1361831125551,2252504559,2252504943,384
1361831133,2252512392,4,190,47.5,1361831125167,1361831125551,2252504559,2252504943,384
1361831134,2252512472,4,190,47.5,1361831125385,1361831125769,2252503857,2252504241,384
1361831134,2252512472,4,190,47.5,1361831125767,1361831126087,2252504239,2252504559,320
1361831134,2252512480,4,190,47.5,1361831126146,1361831126466,2252504626,2252504946,320
1361831134,2252512520,4,190,47.5,1361831123738,1361831125978,2252502258,2252504498,2240
1361831134,2252512552,4,190,47.5,1361831125371,1361831125691,2252503923,2252504243,320
1361831134,2252512552,4,190,47.5,1361831125371,1361831125691,2252503923,2252504243,320
1361831137,2252516224,2,473,236.5,1361831112410,1361831112474,2252491634,2252491698,64
1361831150,2252528828,3,144,48,1361831144100,1361831144100,2252522928,2252522928,0
1361831150,2252528868,3,144,48,1361831141372,1361831141436,2252520240,2252520304,64
1361831150,2252528876,8,1505,188.125,1361831142260,1361831147380,2252521136,2252526256,5120
1361831162,2252540440,1,46,46,1361831136488,1361831136488,2252514928,2252514928,0
1361831166,2252544604,2,265,132.5,1361831139779,1361831139843,2252518383,2252518447,64
1361831169,2252548368,12,3399,283.25,1361831140935,1361831141319,2252520303,2252520687,384
1361831178,2252556596,2,473,236.5,1361831153164,1361831153228,2252531760,2252531824,64
1361831194,2252572448,1,46,46,1361831166495,1361831166495,2252544943,2252544943,0
1361831214,2252592560,2,123,61.5,1361831187056,1361831187056,2252565616,2252565616,0
1361831218,2252596512,2,473,236.5,1361831193631,1361831193695,2252572143,2252572207,64
1361831222,2252600572,2,265,132.5,1361831195044,1361831195108,2252573616,2252573680,64
1361831222,2252600700,1,46,46,1361831196260,1361831196260,2252574960,2252574960,0
1361831222,2252600808,3,144,48,1361831219126,1361831219126,2252597934,2252597934,0
1361831254,2252632608,10,3238,323.8,1361831226367,1361831253119,2252604975,2252631727,26752
1361831258,2252636568,5,808,161.6,1361831231975,1361831251239,2252610543,2252629807,19264
1361831258,2252636688,2,473,236.5,1361831232941,1361831233005,2252611629,2252611693,64
1361831270,2252648736,10,4778,477.8,1361831243454,1361831243902,2252622190,2252622638,448
1361831274,2252652688,9,4912,545.7777778,1361831249006,1361831249198,2252627694,2252627886,192
1361831278,2252656548,2,265,132.5,1361831250361,1361831250425,2252628909,2252628973,64
1361831282,2252660564,10,4977,497.7,1361831254378,1361831254570,2252632942,2252633134,192
1361831282,2252660616,1,46,46,1361831256373,1361831256373,2252634989,2252634989,0
1361831302,2252680668,2,473,236.5,1361831273859,1361831273987,2252652527,2252652655,128
1361831302,2252680956,3,144,48,1361831293987,1361831293987,2252672943,2252672943,0
1361831314,2252692880,1,46,46,1361831286124,1361831286124,2252665004,2252665004,0
1361831322,2252700880,2,123,61.5,1361831295535,1361831295535,2252674415,2252674415,0
1361831330,2252709036,2,265,132.5,1361831305362,1361831305490,2252684398,2252684526,128
1361831334,2252713276,4,312,78,1361831328355,1361831328483,2252707631,2252707759,128
1361831334,2252713276,4,312,78,1361831328161,1361831328289,2252707437,2252707565,128
1361831334,2252713360,4,312,78,1361831328014,1361831328078,2252707374,2252707438,64
1361831334,2252713364,4,312,78,1361831328203,1361831328331,2252707567,2252707695,128
1361831334,2252713364,4,312,78,1361831328330,1361831328458,2252707694,2252707822,128
1361831342,2252720892,2,473,236.5,1361831314080,1361831314144,2252692972,2252693036,64
1361831342,2252721024,2,123,61.5,1361831315997,1361831340253,2252695021,2252719277,24256
1361831354,2252732968,16,18271,1141.9375,1361831328468,1361831328724,2252707436,2252707692,256
1361831354,2252733080,4,1976,494,1361831328230,1361831328486,2252707310,2252707566,256
1361831366,2252744960,2,123,61.5,1361831340380,1361831340380,2252719340,2252719340,0
1361831374,2252752920,1,46,46,1361831346117,1361831346117,2252725037,2252725037,0
1361831374,2252753340,3,144,48,1361831371297,1361831371297,2252750637,2252750637,0
1361831378,2252757036,2,473,236.5,1361831353555,1361831353619,2252732591,2252732655,64
1361831386,2252765156,2,265,132.5,1361831361304,1361831361432,2252740460,2252740588,128
1361831402,2252781048,1,46,46,1361831376005,1361831376005,2252755053,2252755053,0
1361831410,2252789112,2,123,61.5,1361831385156,1361831385156,2252764268,2252764268,0
1361831422,2252801044,2,473,236.5,1361831394311,1361831394375,2252773355,2252773419,64
1361831434,2252813064,1,46,46,1361831405939,1361831405939,2252785003,2252785003,0
1361831438,2252817336,8,451,56.375,1361831429861,1361831431013,2252809197,2252810349,1152
1361831442,2252821084,2,265,132.5,1361831416545,1361831416609,2252795629,2252795693,64
1361831447,2252825464,3,144,48,1361831444490,1361831444554,2252822954,2252823018,64
1361831447,2252825472,3,144,48,1361831442373,1361831442437,2252820845,2252820909,64
1361831455,2252833428,7,1406,200.8571429,1361831443248,1361831448880,2252821676,2252827308,5632
1361831455,2252833508,7,1406,200.8571429,1361831443168,1361831448800,2252821676,2252827308,5632
1361831462,2252841276,2,473,236.5,1361831434272,1361831434336,2252813548,2252813612,64
1361831462,2252841388,1,46,46,1361831435630,1361831435630,2252815018,2252815018,0
1361831467,2252845456,13,2446,188.1538462,1361831442451,1361831442835,2252820907,2252821291,384
1361831471,2252849432,1,46,46,1361831444908,1361831444908,2252823340,2252823340,0
1361831471,2252849640,1,46,46,1361831444699,1361831444699,2252823339,2252823339,0
1361831487,2252865640,44,56779,1290.431818,1361831480540,1361831480860,2252859180,2252859500,320
1361831491,2252869484,1,46,46,1361831466553,1361831466553,2252845037,2252845037,0
1361831495,2252873584,8,7207,900.875,1361831480340,1361831490004,2252858924,2252868588,9664
1361831495,2252873588,14,6021,430.0714286,1361831480592,1361831490128,2252859180,2252868716,9536
1361831495,2252873656,9,7808,867.5555556,1361831480266,1361831489994,2252858922,2252868650,9728
1361831499,2252877604,2,265,132.5,1361831472127,1361831472191,2252850731,2252850795,64
1361831503,2252881512,2,473,236.5,1361831475227,1361831475291,2252853739,2252853803,64
1361831506,2252885336,1,52,52,1361831479780,1361831479780,2252859116,2252859116,0
1361831507,2252885416,1,52,52,1361831480828,1361831480828,2252859244,2252859244,0
1361831511,2252889504,1,46,46,1361831484131,1361831484131,2252862635,2252862635,0
1361831514,2252893304,2,123,61.5,1361831486275,1361831486275,2252865579,2252865579,0
1361831514,2252893356,1,46,46,1361831488527,1361831488527,2252867883,2252867883,0
1361831519,2252897472,1,46,46,1361831494661,1361831494661,2252873133,2252873133,0
1361831523,2252901480,1,46,46,1361831496569,1361831496569,2252875049,2252875049,0
1361831527,2252905644,3,144,48,1361831519256,1361831519320,2252897900,2252897964,64
1361831543,2252921420,2,473,236.5,1361831515576,1361831515704,2252893996,2252894124,128
1361831551,2252929600,1,46,46,1361831526465,1361831526465,2252905065,2252905065,0
1361831555,2252933472,2,265,132.5,1361831527680,1361831527744,2252906152,2252906216,64
1361831558,2252937380,2,123,61.5,1361831531126,1361831531126,2252910506,2252910506,0
1361831582,2252961376,2,473,236.5,1361831554424,1361831554488,2252933800,2252933864,64
1361831583,2252961420,1,46,46,1361831556661,1361831556661,2252935081,2252935081,0
1361831599,2252977848,3,144,48,1361831594058,1361831594122,2252972906,2252972970,64
1361831603,2252981552,2,123,61.5,1361831576882,1361831576882,2252955434,2252955434,0
1361831611,2252989424,2,265,132.5,1361831582835,1361831582963,2252961259,2252961387,128
1361831611,2252989636,1,46,46,1361831586462,1361831586462,2252965098,2252965098,0
1361831623,2253001508,2,473,236.5,1361831595359,1361831595423,2252973867,2252973931,64
1361831631,2253009548,1,46,46,1361831604151,1361831604151,2252982699,2252982699,0
1361831631,2253009856,8,451,56.375,1361831621506,1361831622978,2253000362,2253001834,1472
1361831635,2253013576,1,46,46,1361831609370,1361831609370,2252987946,2252987946,0
1361831639,2253017492,1,46,46,1361831614635,1361831614635,2252993127,2252993127,0
1361831643,2253021436,1,46,46,1361831616676,1361831616676,2252995112,2252995112,0
1361831663,2253041476,2,473,236.5,1361831635901,1361831635965,2253014377,2253014441,64
1361831667,2253045560,2,265,132.5,1361831638823,1361831638887,2253017383,2253017447,64
1361831671,2253049524,2,123,61.5,1361831642893,1361831646605,2253021417,2253025129,3712
1361831671,2253049784,3,144,48,1361831669128,1361831669128,2253047912,2253047912,0
1361831703,2253081488,2,473,236.5,1361831675374,1361831675438,2253053862,2253053926,64
1361831703,2253081528,1,46,46,1361831676615,1361831676615,2253055143,2253055143,0
1361831719,2253097712,2,265,132.5,1361831694417,1361831694481,2253073129,2253073193,64
1361831731,2253109696,1,46,46,1361831706465,1361831706465,2253085161,2253085161,0
1361831735,2253114056,3,144,48,1361831730870,1361831730934,2253109926,2253109990,64
1361831743,2253121708,2,473,236.5,1361831715219,1361831715347,2253093927,2253094055,128
1361831751,2253130064,8,1505,188.125,1361831742896,1361831748080,2253121960,2253127144,5184
1361831751,2253130156,3,144,48,1361831743762,1361831743762,2253122918,2253122918,0
1361831759,2253137764,15,2974,198.2666667,1361831731229,1361831742813,2253109993,2253121577,11584
1361831763,2253141656,1,46,46,1361831736519,1361831736519,2253115175,2253115175,0
1361831775,2253153788,2,265,132.5,1361831750277,1361831750341,2253129065,2253129129,64
1361831783,2253161716,2,473,236.5,1361831755020,1361831755084,2253133736,2253133800,64
1361831791,2253169832,1,46,46,1361831766357,1361831766357,2253145189,2253145189,0
1361831815,2253193728,3,200,66.66666667,1361831787196,1361831787516,2253165924,2253166244,320
1361831823,2253201672,2,473,236.5,1361831795638,1361831795702,2253174310,2253174374,64
1361831823,2253201708,1,46,46,1361831796497,1361831796497,2253175205,2253175205,0
1361831823,2253202344,3,144,48,1361831818583,1361831818583,2253197927,2253197927,0
1361831831,2253209844,2,265,132.5,1361831805324,1361831805452,2253184168,2253184296,128
1361831851,2253229896,1,46,46,1361831826389,1361831826389,2253205285,2253205285,0
1361831859,2253237704,2,123,61.5,1361831832151,1361831832151,2253210855,2253210855,0
1361831863,2253241716,2,473,236.5,1361831835144,1361831835208,2253213860,2253213924,64
1361831883,2253261804,1,46,46,1361831856435,1361831856435,2253235239,2253235239,0
1361831887,2253265896,2,265,132.5,1361831860821,1361831860949,2253239717,2253239845,128
1361831891,2253269776,5,3263,652.6,1361831865359,1361831883535,2253244135,2253262311,18176
1361831896,2253274480,3,144,48,1361831894518,1361831894518,2253272998,2253272998,0
1361831903,2253281804,19,5930,312.1052632,1361831876976,1361831884016,2253255780,2253262820,7040
1361831910,891603068,10,10106,1010.6,1361831883701,1361831883765,891576769,891576833,64
1361831911,2253289932,1,46,46,1361831886322,1361831886322,2253265254,2253265254,0
1361831943,2253321812,2,265,132.5,1361831916456,1361831916584,2253295268,2253295396,128
1361831943,2253321912,1,46,46,1361831916358,1361831916358,2253295270,2253295270,0
1361831951,2253329844,2,473,236.5,1361831923080,1361831923144,2253301924,2253301988,64
1361831955,2253333912,2,123,61.5,1361831928771,1361831928771,2253307683,2253307683,0
1361831971,2253349996,2,123,61.5,1361831945073,1361831946289,2253324069,2253325285,1216
1361831976,2253354496,3,144,48,1361831969445,1361831969445,2253347941,2253347941,0
1361831987,2253365992,2,473,236.5,1361831962677,1361831962741,2253341669,2253341733,64
1361831999,2253377828,2,265,132.5,1361831972504,1361831972632,2253351332,2253351460,128
1361831999,2253377960,2,123,61.5,1361831973651,1361831973651,2253352611,2253352611,0
1361832001,891694300,2,123,61.5,1361831999886,1361831999886,891693186,891693186,0
1361832003,2253381916,1,46,46,1361831976385,1361831976385,2253355301,2253355301,0
1361832031,2253409840,2,473,236.5,1361832002892,1361832002956,2253381732,2253381796,64
1361832031,2253410044,1,46,46,1361832006269,1361832006269,2253385313,2253385313,0
1361832040,2253418544,3,144,48,1361832032050,1361832032114,2253410594,2253410658,64
1361832043,2253421956,5,267,53.4,1361832018581,1361832042709,2253397537,2253421665,24128
1361832055,2253433876,2,265,132.5,1361832028072,1361832028136,2253406948,2253407012,64
1361832063,2253442000,1,46,46,1361832036331,1361832036331,2253415331,2253415331,0
1361832071,2253449904,3,1498,499.3333333,1361832042954,1361832042954,2253421858,2253421858,0
1361832071,2253449912,2,473,236.5,1361832043524,1361832043588,2253422436,2253422500,64
1361832091,2253470024,1,46,46,1361832066321,1361832066321,2253445345,2253445345,0
1361832111,2253489976,2,473,236.5,1361832083457,1361832083521,2253462433,2253462497,64
1361832111,2253490108,2,265,132.5,1361832083904,1361832084032,2253463012,2253463140,128
1361832112,2253490668,3,144,48,1361832104245,1361832104245,2253482913,2253482913,0
1361832115,2253494052,2,123,61.5,1361832087414,1361832087414,2253466466,2253466466,0
1361832123,2253501964,1,46,46,1361832096397,1361832096397,2253475361,2253475361,0
1361832142,891835516,6,1667,277.8333333,1361832114615,1361832114935,891808131,891808451,320
1361832143,2253522076,3,2232,744,1361832114780,1361832114908,2253493856,2253493984,128
1361832151,2253530096,1,46,46,1361832126282,1361832126282,2253505378,2253505378,0
1361832159,2253538032,2,123,61.5,1361832132362,1361832132362,2253511394,2253511394,0
1361832167,2253546124,2,265,132.5,1361832139117,1361832139245,2253518241,2253518369,128
1361832168,2253546680,3,144,48,1361832164265,1361832164265,2253542945,2253542945,0
1361832183,2253562116,2,473,236.5,1361832154867,1361832154931,2253533983,2253534047,64
1361832183,2253562156,1,46,46,1361832156237,1361832156237,2253535393,2253535393,0
1361832203,2253582244,2,123,61.5,1361832177077,1361832177077,2253556321,2253556321,0
1361832211,2253590164,2,92,46,1361832186244,1361832189316,2253565408,2253568480,3072
1361832219,2253598152,2,473,236.5,1361832194575,1361832194639,2253573727,2253573791,64
1361832223,2253602096,2,265,132.5,1361832195144,1361832195272,2253574240,2253574368,128
1361832233,891926384,3,169,56.33333333,1361832230777,1361832230777,891924161,891924161,0
1361832239,2253618168,6,4285,714.1666667,1361832211134,1361832211326,2253590302,2253590494,192
1361832240,2253618940,3,144,48,1361832238947,1361832239011,2253617887,2253617951,64
1361832243,2253622308,1,46,46,1361832216116,1361832216116,2253595424,2253595424,0
1361832259,2253638348,5,3307,661.4,1361832234637,1361832255565,2253613985,2253634913,20928
1361832271,2253650372,2,123,61.5,1361832246069,1361832247349,2253625441,2253626721,1280
1361832275,2253654376,2,265,132.5,1361832249968,1361832250096,2253629344,2253629472,128
1361832283,2253662224,2,123,61.5,1361832256008,1361832256008,2253635232,2253635232,0
1361832303,2253682372,1,46,46,1361832276084,1361832276084,2253655456,2253655456,0
1361832304,2253683068,3,144,48,1361832298851,1361832298851,2253677919,2253677919,0
1361832323,2253702320,2,473,236.5,1361832295977,1361832296041,2253675297,2253675361,64
1361832327,2253706360,23,27210,1183.043478,1361832300801,1361832326081,2253680161,2253705441,25280
1361832331,2253710364,2,265,132.5,1361832305275,1361832305403,2253684639,2253684767,128
1361832331,2253710392,1,46,46,1361832306079,1361832306079,2253685471,2253685471,0
1361832337,892030412,7,498,71.14285714,1361832326559,1361832332575,892019971,892025987,6016
1361832352,2253730476,7,4583,654.7142857,1361832327025,1361832327281,2253705501,2253705757,256
1361832352,2253730480,7,3883,554.7142857,1361832327280,1361832327344,2253705760,2253705824,64
1361832352,2253730588,7,3542,506,1361832327170,1361832327234,2253705758,2253705822,64
1361832352,2253730588,6,3123,520.5,1361832327170,1361832327234,2253705758,2253705822,64
1361832352,2253730588,7,3718,531.1428571,1361832327170,1361832327234,2253705758,2253705822,64
1361832352,2253730592,7,3622,517.4285714,1361832327164,1361832327228,2253705756,2253705820,64
1361832355,892047700,38,51465,1354.342105,1361832327079,1361832327399,892019779,892020099,320
1361832364,2253742604,1,46,46,1361832336883,1361832336883,2253715487,2253715487,0
1361832364,2253742608,3,525,175,1361832336367,1361832336431,2253714975,2253715039,64
1361832368,2253746548,8,2243,280.375,1361832343401,1361832343593,2253721949,2253722141,192
1361832376,2253755252,3,144,48,1361832373675,1361832373675,2253752927,2253752927,0
1361832388,2253766680,2,265,132.5,1361832361956,1361832362084,2253740636,2253740764,128
1361832392,2253770708,1,46,46,1361832366728,1361832366728,2253745436,2253745436,0
1361832392,2253771276,4,336,84,1361832384594,1361832384722,2253763870,2253763998,128
1361832404,2253782536,2,473,236.5,1361832376308,1361832376372,2253754844,2253754908,64
1361832416,2253794548,2,123,61.5,1361832388456,1361832388456,2253767004,2253767004,0
1361832424,2253802560,1,46,46,1361832396892,1361832396892,2253775452,2253775452,0
1361832444,2253822564,2,473,236.5,1361832416984,1361832417048,2253795548,2253795612,64
1361832444,2253822608,2,265,132.5,1361832417901,1361832417965,2253796509,2253796573,64
1361832449,2253827520,3,169,56.33333333,1361832443271,1361832443271,2253821791,2253821791,0
1361832449,2253827520,3,169,56.33333333,1361832443271,1361832443271,2253821791,2253821791,0
1361832449,2253827572,3,169,56.33333333,1361832443218,1361832443218,2253821790,2253821790,0
1361832449,2253827572,3,169,56.33333333,1361832443218,1361832443218,2253821790,2253821790,0
1361832449,2253827572,3,169,56.33333333,1361832443217,1361832443217,2253821789,2253821789,0
1361832449,2253827572,3,169,56.33333333,1361832443217,1361832443217,2253821789,2253821789,0
1361832449,2253827596,11,5602,509.2727273,1361832431672,1361832446968,2253810268,2253825564,15296
1361832449,892142488,3,169,56.33333333,1361832442515,1361832442515,892136003,892136003,0
1361832452,2253830656,1,46,46,1361832426814,1361832426814,2253805470,2253805470,0
1361832457,2253835560,3,144,48,1361832449439,1361832449439,2253827999,2253827999,0
1361832460,2253838588,2,123,61.5,1361832433345,1361832433345,2253811933,2253811933,0
1361832464,2253842828,1,46,46,1361832438099,1361832438099,2253816927,2253816927,0
1361832484,2253862928,1,46,46,1361832456556,1361832456556,2253835484,2253835484,0
1361832484,2253862964,2,473,236.5,1361832457161,1361832457225,2253836125,2253836189,64
1361832500,2253878980,2,265,132.5,1361832472824,1361832472888,2253851804,2253851868,64
1361832504,2253882976,2,123,61.5,1361832477885,1361832477885,2253856861,2253856861,0
1361832512,2253890992,1,46,46,1361832486507,1361832486507,2253865499,2253865499,0
1361832524,2253902876,2,473,236.5,1361832497120,1361832497184,2253875996,2253876060,64
1361832529,2253907572,3,144,48,1361832524368,1361832524368,2253902940,2253902940,0
1361832529,2253907612,8,451,56.375,1361832523176,1361832524200,2253901788,2253902812,1024
1361832544,2253922888,1,46,46,1361832516628,1361832516628,2253895516,2253895516,0
1361832556,2253934952,2,265,132.5,1361832528597,1361832528661,2253907549,2253907613,64
1361832564,2253943008,2,473,236.5,1361832536797,1361832536925,2253915805,2253915933,128
1361832572,2253950952,2,123,61.5,1361832546580,1361832550100,2253925532,2253929052,3520
1361832601,2253979604,3,144,48,1361832599277,1361832599341,2253977881,2253977945,64
1361832604,2253982888,2,473,236.5,1361832576850,1361832576914,2253955738,2253955802,64
1361832604,2253982976,1,46,46,1361832576572,1361832576572,2253955548,2253955548,0
1361832612,2253990912,2,265,132.5,1361832584059,1361832584315,2253962971,2253963227,256
1361832632,2254011064,1,46,46,1361832606498,1361832606498,2253985562,2253985562,0
1361832644,2254022892,2,473,236.5,1361832616846,1361832616910,2253995738,2253995802,64
1361832649,2254027612,3,144,48,1361832643621,1361832643685,2254022233,2254022297,64
1361832657,2254035576,7,1459,208.4285714,1361832644682,1361832649866,2254023258,2254028442,5184
1361832664,2254043032,1,46,46,1361832636544,1361832636544,2254015576,2254015576,0
1361832668,2254046944,2,265,132.5,1361832640152,1361832640280,2254019096,2254019224,128
1361832668,2254047024,13,2615,201.1538462,1361832643272,1361832644104,2254022296,2254023128,832
1361832672,2254050956,6,3850,641.6666667,1361832644302,1361832644430,2254023258,2254023386,128
1361832681,2254059576,3,144,48,1361832677001,1361832677065,2254055577,2254055641,64
1361832684,2254063004,2,473,236.5,1361832657438,1361832657502,2254036442,2254036506,64
1361832692,2254071124,1,46,46,1361832666467,1361832666467,2254045591,2254045591,0
1361832716,2254094980,8,4437,554.625,1361832688694,1361832691958,2254067674,2254070938,3264
1361832720,2254099072,2,265,132.5,1361832695578,1361832695706,2254074650,2254074778,128
1361832724,2254103104,1,46,46,1361832696507,1361832696507,2254075611,2254075611,0
1361832724,2254103116,2,473,236.5,1361832697003,1361832697067,2254076119,2254076183,64
1361832752,2254131072,1,46,46,1361832726553,1361832726553,2254105625,2254105625,0
1361832753,2254131660,3,144,48,1361832749301,1361832749301,2254127961,2254127961,0
1361832761,2254139680,2,123,61.5,1361832760735,1361832760735,2254139415,2254139415,0
1361832764,2254143020,2,123,61.5,1361832736589,1361832736589,2254115609,2254115609,0
1361832764,2254143144,2,473,236.5,1361832737361,1361832737425,2254116505,2254116569,64
1361832776,2254155108,2,265,132.5,1361832750772,1361832750900,2254129880,2254130008,128
1361832784,2254163028,1,46,46,1361832756675,1361832756675,2254135703,2254135703,0
1361832804,2254183124,2,473,236.5,1361832778276,1361832778340,2254157400,2254157464,64
1361832808,2254187296,2,123,61.5,1361832781241,1361832781241,2254160537,2254160537,0
1361832813,2254191412,1,46,46,1361832787244,1361832787244,2254165656,2254165656,0
1361832825,2254204024,3,144,48,1361832823942,1361832824006,2254202966,2254203030,64
1361832832,2254211348,2,265,132.5,1361832806529,1361832806657,2254185877,2254186005,128
1361832844,2254223264,2,473,236.5,1361832818198,1361832818262,2254197462,2254197526,64
1361832844,2254223344,1,46,46,1361832816329,1361832816329,2254195673,2254195673,0
1361832853,2254231424,2,123,61.5,1361832827038,1361832827038,2254205462,2254205462,0
1361832873,2254251440,2,123,61.5,1361832847245,1361832852749,2254225685,2254231189,5504
1361832873,2254251972,8,451,56.375,1361832871417,1361832872441,2254250389,2254251413,1024
1361832881,2254260008,4,1043,260.75,1361832872983,1361832873111,2254251991,2254252119,128
1361832885,2254263452,2,473,236.5,1361832859716,1361832859780,2254238168,2254238232,64
1361832889,2254267456,2,265,132.5,1361832863229,1361832863357,2254241685,2254241813,128
1361832905,2254283432,1,46,46,1361832877271,1361832877271,2254255703,2254255703,0
1361832905,2254284120,3,144,48,1361832898790,1361832898790,2254277910,2254277910,0
1361832925,2254303532,2,473,236.5,1361832899824,1361832899888,2254278356,2254278420,64
1361832929,2254308028,4,190,47.5,1361832928770,1361832928834,2254307798,2254307862,64
1361832929,2254308040,4,190,47.5,1361832926135,1361832926711,2254305175,2254305751,576
1361832929,2254308040,4,190,47.5,1361832926135,1361832926711,2254305175,2254305751,576
1361832929,2254308060,4,190,47.5,1361832926560,1361832926816,2254305620,2254305876,256
1361832929,2254308064,4,190,47.5,1361832926622,1361832927262,2254305686,2254306326,640
1361832929,2254308068,4,190,47.5,1361832926811,1361832927067,2254305879,2254306135,256
1361832929,2254308068,4,190,47.5,1361832927320,1361832927576,2254306388,2254306644,256
1361832929,2254308072,4,190,47.5,1361832927575,1361832927831,2254306647,2254306903,256
1361832929,2254308072,4,190,47.5,1361832927957,1361832928405,2254307029,2254307477,448
1361832929,2254308072,4,190,47.5,1361832927957,1361832928405,2254307029,2254307477,448
1361832929,2254308076,4,190,47.5,1361832928211,1361832928659,2254307287,2254307735,448
1361832929,2254308112,4,190,47.5,1361832926063,1361832926575,2254305175,2254305687,512
1361832929,2254308112,4,190,47.5,1361832926063,1361832926639,2254305175,2254305751,576
1361832929,2254308116,4,190,47.5,1361832926440,1361832926696,2254305556,2254305812,256
1361832929,2254308136,4,190,47.5,1361832926487,1361832926743,2254305623,2254305879,256
1361832929,2254308140,4,190,47.5,1361832926672,1361832926992,2254305812,2254306132,320
1361832929,2254308144,4,190,47.5,1361832926736,1361832926992,2254305880,2254306136,256
1361832929,2254308144,4,190,47.5,1361832926991,1361832927247,2254306135,2254306391,256
1361832929,2254308144,4,190,47.5,1361832927246,1361832927502,2254306390,2254306646,256
1361832929,2254308144,4,190,47.5,1361832926989,1361832927245,2254306133,2254306389,256
1361832929,2254308144,4,190,47.5,1361832926989,1361832927245,2254306133,2254306389,256
1361832929,2254308144,4,190,47.5,1361832926989,1361832927245,2254306133,2254306389,256
1361832929,2254308144,4,190,47.5,1361832927501,1361832927757,2254306645,2254306901,256
1361832929,2254308148,4,190,47.5,1361832927243,1361832927499,2254306391,2254306647,256
1361832929,2254308148,4,190,47.5,1361832927243,1361832927499,2254306391,2254306647,256
1361832929,2254308148,4,190,47.5,1361832927499,1361832927819,2254306647,2254306967,320
1361832929,2254308148,4,190,47.5,1361832927754,1361832928010,2254306902,2254307158,256
1361832933,2254311512,1,46,46,1361832907207,1361832907207,2254285719,2254285719,0
1361832937,2254316032,4,190,47.5,1361832929023,1361832929151,2254308055,2254308183,128
1361832937,2254316032,4,190,47.5,1361832929087,1361832929151,2254308119,2254308183,64
1361832937,2254316032,4,190,47.5,1361832929151,1361832929215,2254308183,2254308247,64
1361832937,2254316032,4,190,47.5,1361832929213,1361832929341,2254308245,2254308373,128
1361832937,2254316036,4,190,47.5,1361832928763,1361832928955,2254307799,2254307991,192
1361832937,2254316036,4,190,47.5,1361832928826,1361832929018,2254307862,2254308054,192
1361832937,2254316040,4,190,47.5,1361832929782,1361832930102,2254308822,2254309142,320
1361832937,2254316040,4,190,47.5,1361832930101,1361832930421,2254309141,2254309461,320
1361832937,2254316068,4,190,47.5,1361832930842,1361832931226,2254309910,2254310294,384
1361832937,2254316072,4,190,47.5,1361832931287,1361832931607,2254310359,2254310679,320
1361832937,2254316072,4,190,47.5,1361832931604,1361832931924,2254310676,2254310996,320
1361832937,2254316072,4,190,47.5,1361832931540,1361832931924,2254310612,2254310996,384
1361832937,2254316076,4,190,47.5,1361832927569,1361832929937,2254306645,2254309013,2368
1361832937,2254316080,4,190,47.5,1361832928909,1361832929037,2254307989,2254308117,128
1361832937,2254316104,4,190,47.5,1361832928373,1361832928885,2254307477,2254307989,512
1361832937,2254316104,4,190,47.5,1361832928373,1361832928885,2254307477,2254307989,512
1361832937,2254316108,4,190,47.5,1361832928432,1361832930672,2254307540,2254309780,2240
1361832937,2254316108,4,190,47.5,1361832929075,1361832929203,2254308183,2254308311,128
1361832937,2254316112,4,190,47.5,1361832929389,1361832929709,2254308501,2254308821,320
1361832937,2254316112,4,190,47.5,1361832929325,1361832929645,2254308437,2254308757,320
1361832937,2254316116,4,190,47.5,1361832929642,1361832930026,2254308758,2254309142,384
1361832937,2254316116,4,190,47.5,1361832929897,1361832930281,2254309013,2254309397,384
1361832937,2254316116,5,236,47.2,1361832930024,1361832930856,2254309140,2254309972,832
1361832937,2254316120,4,190,47.5,1361832930340,1361832931236,2254309460,2254310356,896
1361832937,2254316148,4,190,47.5,1361832931145,1361832931465,2254310293,2254310613,320
1361832944,2254323396,2,265,132.5,1361832917843,1361832917907,2254297239,2254297303,64
1361832945,2254324160,3,144,48,1361832943804,1361832943932,2254322964,2254323092,128
1361832957,2254335440,3,156,52,1361832931085,1361832934093,2254309525,2254312533,3008
1361832957,2254335552,4,190,47.5,1361832930845,1361832933981,2254309397,2254312533,3136
1361832965,2254343748,1,46,46,1361832936987,1361832936987,2254315735,2254315735,0
1361832965,2254343792,2,473,236.5,1361832938860,1361832938924,2254317652,2254317716,64
1361832969,2254347768,14,4308,307.7142857,1361832944326,1361832944838,2254323094,2254323606,512
1361832977,2254356144,3,144,48,1361832973772,1361832973772,2254352916,2254352916,0
1361832977,2254356216,4,312,78,1361832973702,1361832973830,2254352918,2254353046,128
1361832993,2254371760,1,46,46,1361832966987,1361832966987,2254345747,2254345747,0
1361833001,2254379644,2,265,132.5,1361832974208,1361832974336,2254352852,2254352980,128
1361833005,2254383760,2,473,236.5,1361832979660,1361832979724,2254358420,2254358484,64
1361833017,2254395840,2,123,61.5,1361832988861,1361832988861,2254367701,2254367701,0
1361833025,2254403744,1,46,46,1361832997021,1361832997021,2254375765,2254375765,0
1361833045,2254423924,2,473,236.5,1361833019623,1361833019687,2254398547,2254398611,64
1361833049,2254428204,3,144,48,1361833048718,1361833048718,2254427922,2254427922,0
1361833053,2254431816,1,46,46,1361833026964,1361833026964,2254405780,2254405780,0
1361833057,2254435848,2,265,132.5,1361833029365,1361833029493,2254408213,2254408341,128
1361833061,2254439940,2,123,61.5,1361833033689,1361833033689,2254412629,2254412629,0
1361833065,2254444180,15,6289,419.2666667,1361833045288,1361833057384,2254424468,2254436564,12096
1361833065,2254444184,12,999,83.25,1361833045731,1361833057379,2254424915,2254436563,11648
1361833065,2254444188,11,953,86.63636364,1361833046049,1361833057377,2254425237,2254436565,11328
1361833065,2254444188,11,953,86.63636364,1361833046302,1361833057310,2254425490,2254436498,11008
1361833081,2254460204,12,999,83.25,1361833070225,1361833077713,2254449429,2254456917,7488
1361833081,2254460208,11,953,86.63636364,1361833070475,1361833077707,2254449683,2254456915,7232
1361833081,2254460260,16,6372,398.25,1361833069721,1361833077657,2254448981,2254456917,7936
1361833085,2254463836,1,46,46,1361833056960,1361833056960,2254435796,2254435796,0
1361833085,2254463916,2,473,236.5,1361833060528,1361833060592,2254439444,2254439508,64
1361833105,2254483964,2,123,61.5,1361833078590,1361833078590,2254457554,2254457554,0
1361833109,2254487928,2,265,132.5,1361833084773,1361833084837,2254463701,2254463765,64
1361833113,2254491976,1,46,46,1361833086833,1361833086833,2254465809,2254465809,0
1361833113,2254492220,3,144,48,1361833108670,1361833108734,2254487890,2254487954,64
1361833126,2254504600,2,473,236.5,1361833100843,1361833100907,2254479443,2254479507,64
1361833130,2254508500,8,451,56.375,1361833123983,1361833126031,2254502483,2254504531,2048
1361833142,2254520484,1,46,46,1361833117341,1361833117341,2254495825,2254495825,0
1361833166,2254544612,2,265,132.5,1361833140959,1361833141087,2254519571,2254519699,128
1361833166,2254544724,2,473,236.5,1361833140334,1361833140398,2254519058,2254519122,64
1361833174,2254552580,2,123,61.5,1361833147264,1361833155392,2254525844,2254533972,8128
1361833178,2254556436,3,144,48,1361833172620,1361833172684,2254551056,2254551120,64
1361833186,2254564556,3,144,48,1361833184340,1361833184404,2254562896,2254562960,64
1361833198,2254576696,9,1773,197,1361833172425,1361833172809,2254551121,2254551505,384
1361833202,2254580784,2,92,46,1361833177074,1361833201650,2254555858,2254580434,24576
1361833206,2254584984,2,473,236.5,1361833180585,1361833180649,2254559569,2254559633,64
1361833222,2254600968,2,265,132.5,1361833195833,1361833195961,2254574801,2254574929,128
1361833234,2254612968,1,46,46,1361833206904,1361833206904,2254585872,2254585872,0
1361833242,2254620572,4,312,78,1361833236996,1361833237124,2254615568,2254615696,128
1361833242,2254620572,4,312,78,1361833237124,1361833237252,2254615696,2254615824,128
1361833242,2254620572,4,312,78,1361833237254,1361833237318,2254615826,2254615890,64
1361833242,2254620572,4,312,78,1361833237189,1361833237317,2254615761,2254615889,128
1361833242,2254620648,4,312,78,1361833237240,1361833237304,2254615888,2254615952,64
1361833242,2254620652,4,312,78,1361833237303,1361833237367,2254615955,2254616019,64
1361833242,2254620652,4,312,78,1361833237238,1361833237366,2254615890,2254616018,128
1361833242,2254620916,2,123,61.5,1361833217069,1361833217069,2254595985,2254595985,0
1361833246,2254625200,2,473,236.5,1361833220434,1361833220562,2254599634,2254599762,128
1361833262,2254640920,1,46,46,1361833236970,1361833236970,2254615890,2254615890,0
1361833262,2254640996,3,1433,477.6666667,1361833236443,1361833236507,2254615439,2254615503,64
1361833262,2254641020,16,16117,1007.3125,1361833236484,1361833237124,2254615504,2254616144,640
1361833266,2254644520,3,144,48,1361833259386,1361833259386,2254637906,2254637906,0
1361833270,2254649024,6,1635,272.5,1361833244674,1361833245058,2254623698,2254624082,384
1361833272,892965272,6,3503,583.8333333,1361833245298,1361833245554,892938570,892938826,256
1361833278,2254656880,2,265,132.5,1361833251536,1361833251664,2254630416,2254630544,128
1361833286,2254665028,2,473,236.5,1361833261308,1361833261372,2254640336,2254640400,64
1361833294,2254673008,1,46,46,1361833266898,1361833266898,2254645906,2254645906,0
1361833318,2254696912,2,123,61.5,1361833289968,1361833289968,2254668880,2254668880,0
1361833322,2254700960,1,46,46,1361833296961,1361833296961,2254675921,2254675921,0
1361833326,2254705056,2,473,236.5,1361833301473,1361833301537,2254680529,2254680593,64
1361833334,2254713004,2,265,132.5,1361833307156,1361833307220,2254686160,2254686224,64
1361833338,2254716716,3,144,48,1361833336885,1361833336885,2254715601,2254715601,0
1361833354,2254733032,1,46,46,1361833326905,1361833326905,2254705937,2254705937,0
1361833362,893054688,3,169,56.33333333,1361833361850,1361833361850,893054538,893054538,0
1361833362,2254740924,2,123,61.5,1361833334885,1361833334885,2254713809,2254713809,0
1361833366,2254745144,2,473,236.5,1361833341512,1361833341576,2254720656,2254720720,64
1361833378,2254756968,1,46,46,1361833352375,1361833352375,2254731343,2254731343,0
1361833378,2254757052,1,46,46,1361833352289,1361833352289,2254731341,2254731341,0
1361833382,2254760992,1,46,46,1361833356961,1361833356961,2254735953,2254735953,0
1361833386,2254764644,4,336,84,1361833385401,1361833385529,2254764045,2254764173,128
1361833390,2254768932,2,265,132.5,1361833362905,1361833363033,2254741837,2254741965,128
1361833406,2254784984,2,123,61.5,1361833379750,1361833379750,2254758734,2254758734,0
1361833410,2254788748,3,144,48,1361833409169,1361833409169,2254787917,2254787917,0
1361833410,2254788968,2,473,236.5,1361833382582,1361833382646,2254761550,2254761614,64
1361833414,2254793080,1,46,46,1361833386885,1361833386885,2254765965,2254765965,0
1361833426,2254804732,8,451,56.375,1361833424929,1361833425633,2254803661,2254804365,704
1361833442,2254821248,1,46,46,1361833416734,1361833416734,2254795982,2254795982,0
1361833446,2254825124,2,265,132.5,1361833418266,1361833418330,2254797390,2254797454,64
1361833450,2254829092,2,473,236.5,1361833422651,1361833422715,2254801743,2254801807,64
1361833474,2254853144,2,123,61.5,1361833446852,1361833457604,2254825996,2254836748,10752
1361833490,2254868892,3,144,48,1361833484033,1361833484033,2254862925,2254862925,0
1361833490,2254869156,2,473,236.5,1361833463032,1361833463096,2254842188,2254842252,64
1361833498,2254877240,2,265,132.5,1361833473510,1361833473638,2254852750,2254852878,128
1361833502,2254881196,1,46,46,1361833476818,1361833476818,2254856014,2254856014,0
1361833530,2254909252,2,473,236.5,1361833503128,1361833503192,2254882380,2254882444,64
1361833534,2254913260,1,46,46,1361833506769,1361833506769,2254886029,2254886029,0
1361833546,2254925012,3,144,48,1361833545161,1361833545161,2254924173,2254924173,0
1361833554,2254933304,2,265,132.5,1361833528806,1361833528934,2254908110,2254908238,128
1361833562,2254941028,3,144,48,1361833558906,1361833558906,2254937934,2254937934,0
1361833562,2254941336,1,46,46,1361833536710,1361833536710,2254916046,2254916046,0
1361833570,2254949196,2,473,236.5,1361833543055,1361833543119,2254922251,2254922315,64
1361833570,2254949236,12,2174,181.1666667,1361833545001,1361833545513,2254924237,2254924749,512
1361833594,2254973220,1,46,46,1361833566841,1361833566841,2254946061,2254946061,0
1361833610,2254989328,2,473,236.5,1361833583052,1361833583116,2254962380,2254962444,64
1361833610,2254989364,2,265,132.5,1361833584421,1361833584549,2254963785,2254963913,128
1361833618,2254997356,2,123,61.5,1361833589873,1361833589873,2254969229,2254969229,0
1361833623,2255001428,1,46,46,1361833597648,1361833597648,2254976076,2254976076,0
1361833630,2255009376,1,46,46,1361833602717,1361833602717,2254982093,2254982093,0
1361833642,2255021100,3,144,48,1361833633841,1361833633841,2255012941,2255012941,0
1361833650,2255029300,2,473,236.5,1361833622889,1361833622953,2255002189,2255002253,64
1361833654,2255033324,1,46,46,1361833626765,1361833626765,2255006089,2255006089,0
1361833662,2255041396,5,808,161.6,1361833634757,1361833652357,2255014153,2255031753,17600
1361833667,2255045432,2,265,132.5,1361833641164,1361833641292,2255019596,2255019724,128
1361833682,2255061372,1,46,46,1361833656736,1361833656736,2255036108,2255036108,0
1361833690,2255069364,2,473,236.5,1361833662309,1361833662373,2255041673,2255041737,64
1361833714,2255093068,3,144,48,1361833708814,1361833708878,2255087882,2255087946,64
1361833714,2255093408,1,46,46,1361833686714,1361833686714,2255066122,2255066122,0
1361833723,2255101448,2,265,132.5,1361833696888,1361833696952,2255075336,2255075400,64
1361833723,2255101460,2,123,61.5,1361833697583,1361833697583,2255076043,2255076043,0
1361833731,2255109508,2,473,236.5,1361833703869,1361833703997,2255082377,2255082505,128
1361833743,2255121432,1,46,46,1361833717704,1361833717704,2255096136,2255096136,0
1361833767,2255145608,2,123,61.5,1361833742423,1361833742423,2255121031,2255121031,0
1361833771,2255149552,2,473,236.5,1361833743376,1361833743504,2255121928,2255122056,128
1361833775,2255153580,2,123,61.5,1361833747507,1361833761267,2255126087,2255139847,13760
1361833779,2255157660,2,265,132.5,1361833751971,1361833752099,2255130631,2255130759,128
1361833786,2255165348,3,144,48,1361833783540,1361833783604,2255162888,2255162952,64
1361833803,2255181724,1,46,46,1361833777381,1361833777381,2255156105,2255156105,0
1361833811,2255189672,2,473,236.5,1361833783896,1361833783960,2255162568,2255162632,64
1361833815,2255193568,2,123,61.5,1361833787392,1361833787392,2255165960,2255165960,0
1361833834,2255213376,8,451,56.375,1361833831513,1361833833113,2255210889,2255212489,1600
1361833835,2255213616,1,46,46,1361833807505,1361833807505,2255186121,2255186121,0
1361833835,2255213620,2,265,132.5,1361833807818,1361833807946,2255186438,2255186566,128
1361833851,2255229552,3,144,48,1361833846287,1361833846351,2255224839,2255224903,64
1361833851,2255229688,2,473,236.5,1361833824582,1361833824646,2255203270,2255203334,64
1361833863,2255241812,1,46,46,1361833837324,1361833837324,2255216136,2255216136,0
1361833867,2255245512,3,144,48,1361833859384,1361833859448,2255237896,2255237960,64
1361833871,2255249772,11,2089,189.9090909,1361833846131,1361833846643,2255224903,2255225415,512
1361833891,2255269776,2,265,132.5,1361833863088,1361833863216,2255241864,2255241992,128
1361833891,2255269808,2,473,236.5,1361833864527,1361833864591,2255243335,2255243399,64
1361833895,2255273688,1,46,46,1361833867461,1361833867461,2255246149,2255246149,0
1361833919,2255297844,2,123,61.5,1361833890924,1361833890924,2255269768,2255269768,0
1361833923,2255301876,1,46,46,1361833897291,1361833897291,2255276167,2255276167,0
1361833931,2255309812,2,473,236.5,1361833904587,1361833904651,2255283399,2255283463,64
1361833939,2255317532,3,144,48,1361833934372,1361833934372,2255312904,2255312904,0
1361833943,2255321980,2,265,132.5,1361833918308,1361833918436,2255297288,2255297416,128
1361833955,2255334016,1,46,46,1361833927167,1361833927167,2255306183,2255306183,0
1361833963,2255341940,2,123,61.5,1361833935755,1361833935755,2255314695,2255314695,0
1361833971,2255349972,2,473,236.5,1361833944233,1361833944297,2255323205,2255323269,64
1361833983,2255362012,1,46,46,1361833957184,1361833957184,2255336196,2255336196,0
1361833999,2255378056,2,265,132.5,1361833973911,1361833974039,2255352967,2255353095,128
1361834007,2255385992,2,123,61.5,1361833980628,1361833980628,2255359620,2255359620,0
1361834011,2255390048,2,473,236.5,1361833984220,1361833984348,2255363268,2255363396,128
1361834015,2255394076,1,46,46,1361833987138,1361833987138,2255366214,2255366214,0
1361834019,2255397548,3,144,48,1361834012049,1361834012049,2255390597,2255390597,0
1361834035,2255413612,8,451,56.375,1361834025938,1361834027794,2255404550,2255406406,1856
1361834043,2255422184,1,46,46,1361834017046,1361834017046,2255396230,2255396230,0
1361834051,2255430068,2,473,236.5,1361834023687,1361834023751,2255402755,2255402819,64
1361834055,2255434160,2,265,132.5,1361834029294,1361834029358,2255408454,2255408518,64
1361834075,2255454064,2,123,61.5,1361834047178,1361834063306,2255426242,2255442370,16128
1361834091,2255469588,3,144,48,1361834084328,1361834084328,2255462916,2255462916,0
1361834091,2255470360,2,473,236.5,1361834064099,1361834064163,2255443459,2255443523,64
1361834104,2255482452,1,46,46,1361834077809,1361834077809,2255456261,2255456261,0
1361834111,2255490364,2,265,132.5,1361834084254,1361834084382,2255463618,2255463746,128
1361834131,2255509656,3,144,48,1361834125412,1361834125476,2255504068,2255504132,64
1361834132,2255510472,1,46,46,1361834107805,1361834107805,2255486277,2255486277,0
1361834132,2255510504,2,473,236.5,1361834104442,1361834104570,2255482946,2255483074,128
1361834138,893830896,8,544,68,1361834127279,1361834133295,893820175,893826191,6016
1361834152,2255530444,40,32449,811.225,1361834125687,1361834147703,2255504131,2255526147,22016
1361834152,2255530484,10,8079,807.9,1361834127502,1361834127630,2255505986,2255506114,128
1361834152,2255530484,8,6863,857.875,1361834127502,1361834127630,2255505986,2255506114,128
1361834152,2255530484,10,9284,928.4,1361834127502,1361834127630,2255505986,2255506114,128
1361834152,2255530568,10,7599,759.9,1361834127418,1361834127546,2255505986,2255506114,128
1361834152,2255530568,9,7223,802.5555556,1361834127418,1361834127546,2255505986,2255506114,128
1361834152,2255530572,9,7047,783,1361834127416,1361834127544,2255505988,2255506116,128
1361834154,893846640,8,5141,642.625,1361834127278,1361834127534,893819918,893820174,256
1361834163,2255541736,3,144,48,1361834159185,1361834159185,2255537921,2255537921,0
1361834164,2255542540,1,46,46,1361834137752,1361834137752,2255516292,2255516292,0
1361834168,2255546420,2,265,132.5,1361834140432,1361834140496,2255518852,2255518916,64
1361834172,2255550408,2,473,236.5,1361834144221,1361834144285,2255522629,2255522693,64
1361834179,2255557616,2,123,61.5,1361834172746,1361834172746,2255551362,2255551362,0
1361834179,2255557644,2,123,61.5,1361834174703,1361834174703,2255553347,2255553347,0
1361834179,2255557684,2,123,61.5,1361834172680,1361834172680,2255551364,2255551364,0
1361834179,2255557700,2,123,61.5,1361834174648,1361834174648,2255553348,2255553348,0
1361834187,2255565648,2,123,61.5,1361834181740,1361834181740,2255560388,2255560388,0
1361834187,2255565720,2,123,61.5,1361834181668,1361834181668,2255560388,2255560388,0
1361834192,2255570476,1,46,46,1361834167833,1361834167833,2255546309,2255546309,0
1361834212,2255590492,2,473,236.5,1361834184775,1361834184839,2255563267,2255563331,64
1361834220,2255598624,2,123,61.5,1361834192321,1361834192321,2255570945,2255570945,0
1361834224,2255602488,2,265,132.5,1361834196104,1361834196232,2255574592,2255574720,128
1361834224,2255602528,1,46,46,1361834197795,1361834197795,2255576323,2255576323,0
1361834235,2255613972,3,144,48,1361834233958,1361834233958,2255612930,2255612930,0
1361834250,893942888,3,169,56.33333333,1361834243317,1361834243381,893936205,893936269,64
1361834252,2255630764,2,473,236.5,1361834224184,1361834224248,2255602948,2255603012,64
1361834252,2255630844,1,46,46,1361834227494,1361834227494,2255606338,2255606338,0
1361834264,2255642968,2,123,61.5,1361834236907,1361834236907,2255615875,2255615875,0
1361834268,2255646900,1,46,46,1361834242156,1361834242156,2255621056,2255621056,0
1361834268,2255646900,1,46,46,1361834242159,1361834242159,2255621059,2255621059,0
1361834268,2255647004,1,46,46,1361834242054,1361834242054,2255621058,2255621058,0
1361834268,2255647004,1,46,46,1361834242054,1361834242054,2255621058,2255621058,0
1361834268,2255647004,1,46,46,1361834242053,1361834242053,2255621057,2255621057,0
1361834268,2255647004,1,46,46,1361834242053,1361834242053,2255621057,2255621057,0
1361834276,2255654852,2,265,132.5,1361834251230,1361834251358,2255630082,2255630210,128
1361834284,2255662904,2,92,46,1361834257450,1361834282666,2255636354,2255661570,25216
1361834292,2255670976,2,473,236.5,1361834264225,1361834264289,2255643201,2255643265,64
1361834308,2255686952,2,123,61.5,1361834281848,1361834281848,2255660800,2255660800,0
1361834312,2255690976,1,46,46,1361834287393,1361834287393,2255666369,2255666369,0
1361834315,2255694044,3,144,48,1361834308893,1361834308893,2255687937,2255687937,0
1361834315,2255694084,323,451874,1398.990712,1361834126581,1361834312629,2255505665,2255691713,186048
1361834331,2255710088,8,451,56.375,1361834326642,1361834326898,2255705730,2255705986,256
1361834332,2255710924,2,265,132.5,1361834307027,1361834307219,2255685951,2255686143,192
1361834332,2255711096,2,473,236.5,1361834304298,1361834304362,2255683394,2255683458,64
1361834344,2255723072,1,46,46,1361834317314,1361834317314,2255696386,2255696386,0
1361834372,2255750988,2,473,236.5,1361834343956,1361834344020,2255722944,2255723008,64
1361834372,2255751112,2,123,61.5,1361834347289,1361834365593,2255726401,2255744705,18304
1361834387,2255765976,3,144,48,1361834383968,1361834383968,2255762944,2255762944,0
1361834388,2255767152,2,265,132.5,1361834362225,1361834362353,2255741377,2255741505,128
1361834404,2255783284,1,46,46,1361834377131,1361834377131,2255756415,2255756415,0
1361834408,2255787292,2,473,236.5,1361834383396,1361834383460,2255762688,2255762752,64
1361834432,2255811392,1,46,46,1361834407038,1361834407038,2255786430,2255786430,0
1361834444,2255823268,2,265,132.5,1361834417785,1361834417849,2255797053,2255797117,64
1361834451,2255830088,3,144,48,1361834446894,1361834446958,2255825982,2255826046,64
1361834452,2255831280,2,473,236.5,1361834424303,1361834424367,2255803583,2255803647,64
1361834459,2255838196,7,1459,208.4285714,1361834447813,1361834452997,2255827009,2255832193,5184
1361834460,2255839264,3,144,48,1361834458623,1361834458687,2255837887,2255837951,64
1361834464,2255843296,1,46,46,1361834437152,1361834437152,2255816448,2255816448,0
1361834472,2255851324,12,2270,189.1666667,1361834446723,1361834447299,2255826047,2255826623,576
1361834492,2255871276,1,46,46,1361834467186,1361834467186,2255846462,2255846462,0
1361834492,2255871392,2,473,236.5,1361834464832,1361834464896,2255844224,2255844288,64
1361834501,2255879420,2,265,132.5,1361834474124,1361834474188,2255852544,2255852608,64
1361834520,2255899296,2,123,61.5,1361834492254,1361834492254,2255871550,2255871550,0
1361834523,2255902192,3,144,48,1361834518725,1361834518725,2255897917,2255897917,0
1361834525,2255903444,1,46,46,1361834498034,1361834498034,2255876478,2255876478,0
1361834532,2255911328,2,473,236.5,1361834504318,1361834504382,2255883646,2255883710,64
1361834553,2255931404,1,46,46,1361834528087,1361834528087,2255906491,2255906491,0
1361834557,2255935500,2,265,132.5,1361834529720,1361834529848,2255908220,2255908348,128
1361834565,2255943524,2,123,61.5,1361834537954,1361834537954,2255916478,2255916478,0
1361834573,2255951544,2,473,236.5,1361834545807,1361834545871,2255924351,2255924415,64
1361834584,2255963408,1,46,46,1361834557101,1361834557101,2255936509,2255936509,0
1361834595,2255974248,3,144,48,1361834593678,1361834593678,2255972926,2255972926,0
1361834609,2255987572,2,123,61.5,1361834582830,1361834582830,2255961402,2255961402,0
1361834613,2255991512,2,265,132.5,1361834585069,1361834585197,2255963581,2255963709,128
1361834613,2255991512,2,473,236.5,1361834585195,1361834585259,2255963707,2255963771,64
1361834613,2255991536,1,46,46,1361834587987,1361834587987,2255966523,2255966523,0
1361834640,2256019604,3,685,228.3333333,1361834612521,1361834612713,2255992125,2255992317,192
1361834644,2256023516,1,46,46,1361834617022,1361834617022,2255996538,2255996538,0
1361834652,2256031600,2,473,236.5,1361834624940,1361834625004,2256004540,2256004604,64
1361834664,2256043612,2,265,132.5,1361834639329,1361834639457,2256018941,2256019069,128
1361834672,2256051552,2,123,61.5,1361834647005,1361834667869,2256026557,2256047421,20864
1361834675,2256054280,3,144,48,1361834671274,1361834671338,2256050554,2256050618,64
1361834685,2256063532,2,123,61.5,1361834658776,1361834658776,2256037308,2256037308,0
1361834693,2256071548,2,473,236.5,1361834666504,1361834666568,2256045052,2256045116,64
1361834705,2256083504,1,46,46,1361834678069,1361834678069,2256056573,2256056573,0
1361834721,2256099612,2,265,132.5,1361834696135,1361834696263,2256074747,2256074875,128
1361834729,2256107636,2,123,61.5,1361834703598,1361834703598,2256082234,2256082234,0
1361834733,2256111624,1,46,46,1361834707964,1361834707964,2256086588,2256086588,0
1361834733,2256111656,2,473,236.5,1361834706329,1361834706393,2256084985,2256085049,64
1361834739,2256118188,4,190,47.5,1361834736389,1361834736709,2256115577,2256115897,320
1361834739,2256118192,4,190,47.5,1361834736387,1361834736771,2256115579,2256115963,384
1361834739,2256118196,4,190,47.5,1361834732736,1361834733312,2256111932,2256112508,576
1361834739,2256118200,4,190,47.5,1361834733115,1361834733371,2256112315,2256112571,256
1361834739,2256118200,4,190,47.5,1361834733115,1361834733371,2256112315,2256112571,256
1361834739,2256118200,4,190,47.5,1361834733179,1361834733435,2256112379,2256112635,256
1361834739,2256118200,4,190,47.5,1361834736954,1361834737274,2256116154,2256116474,320
1361834739,2256118200,4,190,47.5,1361834733306,1361834733882,2256112506,2256113082,576
1361834739,2256118204,4,190,47.5,1361834733368,1361834733624,2256112572,2256112828,256
1361834739,2256118204,4,190,47.5,1361834733685,1361834733941,2256112889,2256113145,256
1361834739,2256118228,4,190,47.5,1361834733919,1361834734175,2256113147,2256113403,256
1361834739,2256118228,4,190,47.5,1361834733918,1361834734174,2256113146,2256113402,256
1361834739,2256118232,4,190,47.5,1361834734171,1361834734427,2256113403,2256113659,256
1361834739,2256118232,4,190,47.5,1361834734426,1361834734682,2256113658,2256113914,256
1361834739,2256118232,4,190,47.5,1361834734489,1361834734937,2256113721,2256114169,448
1361834739,2256118236,4,190,47.5,1361834735062,1361834735190,2256114298,2256114426,128
1361834739,2256118236,4,190,47.5,1361834735317,1361834735381,2256114553,2256114617,64
1361834739,2256118240,4,190,47.5,1361834735252,1361834735316,2256114492,2256114556,64
1361834739,2256118240,4,190,47.5,1361834735380,1361834735508,2256114620,2256114748,128
1361834739,2256118240,4,190,47.5,1361834735443,1361834735571,2256114683,2256114811,128
1361834739,2256118240,4,190,47.5,1361834735697,1361834736017,2256114937,2256115257,320
1361834739,2256118244,4,190,47.5,1361834736016,1361834736400,2256115260,2256115644,384
1361834739,2256118244,4,190,47.5,1361834735951,1361834736335,2256115195,2256115579,384
1361834739,2256118268,4,190,47.5,1361834736375,1361834736695,2256115643,2256115963,320
1361834739,2256118272,4,190,47.5,1361834732660,1361834733172,2256111932,2256112444,512
1361834739,2256118272,4,190,47.5,1361834732660,1361834733172,2256111932,2256112444,512
1361834739,2256118272,4,190,47.5,1361834736499,1361834736883,2256115771,2256116155,384
1361834739,2256118272,4,190,47.5,1361834732659,1361834733235,2256111931,2256112507,576
1361834739,2256118276,4,190,47.5,1361834736624,1361834736944,2256115900,2256116220,320
1361834739,2256118276,4,190,47.5,1361834736688,1361834737008,2256115964,2256116284,320
1361834739,2256118276,4,190,47.5,1361834736687,1361834737007,2256115963,2256116283,320
1361834739,2256118280,4,190,47.5,1361834733288,1361834733544,2256112568,2256112824,256
1361834739,2256118280,4,190,47.5,1361834733355,1361834733611,2256112635,2256112891,256
1361834739,2256118280,4,190,47.5,1361834736939,1361834737323,2256116219,2256116603,384
1361834739,2256118280,4,190,47.5,1361834733610,1361834733866,2256112890,2256113146,256
1361834739,2256118280,4,190,47.5,1361834733609,1361834733865,2256112889,2256113145,256
1361834739,2256118280,4,190,47.5,1361834733609,1361834733865,2256112889,2256113145,256
1361834739,2256118284,4,190,47.5,1361834733863,1361834734119,2256113147,2256113403,256
1361834739,2256118284,4,190,47.5,1361834733863,1361834734119,2256113147,2256113403,256
1361834739,2256118308,4,190,47.5,1361834734093,1361834734349,2256113401,2256113657,256
1361834739,2256118308,4,190,47.5,1361834734095,1361834734351,2256113403,2256113659,256
1361834739,2256118312,4,190,47.5,1361834734156,1361834736460,2256113468,2256115772,2304
1361834739,2256118312,4,190,47.5,1361834734476,1361834734924,2256113788,2256114236,448
1361834739,2256118312,4,190,47.5,1361834734730,1361834735178,2256114042,2256114490,448
1361834739,2256118316,4,190,47.5,1361834734920,1361834735368,2256114236,2256114684,448
1361834739,2256118316,4,190,47.5,1361834734919,1361834735431,2256114235,2256114747,512
1361834739,2256118320,4,190,47.5,1361834735300,1361834735364,2256114620,2256114684,64
1361834739,2256118320,4,190,47.5,1361834735106,1361834735170,2256114426,2256114490,64
1361834739,2256118320,4,190,47.5,1361834735169,1361834735297,2256114489,2256114617,128
1361834739,2256118320,4,190,47.5,1361834735553,1361834735873,2256114873,2256115193,320
1361834739,2256118324,4,190,47.5,1361834735232,1361834735360,2256114556,2256114684,128
1361834739,2256118324,4,190,47.5,1361834735359,1361834735423,2256114683,2256114747,64
1361834739,2256118324,4,190,47.5,1361834735934,1361834736254,2256115258,2256115578,320
1361834739,2256118324,4,190,47.5,1361834735549,1361834735933,2256114873,2256115257,384
1361834747,2256126300,3,144,48,1361834743637,1361834743637,2256122937,2256122937,0
1361834755,2256134232,8,1505,188.125,1361834748314,1361834753434,2256127546,2256132666,5120
1361834765,2256143712,1,46,46,1361834737891,1361834737891,2256116603,2256116603,0
1361834773,2256151664,8,2960,370,1361834748048,1361834748432,2256126712,2256127096,384
1361834773,2256151812,2,473,236.5,1361834746111,1361834746175,2256124923,2256124987,64
1361834777,2256155784,2,265,132.5,1361834751449,1361834751513,2256130233,2256130297,64
1361834793,2256171832,1,46,46,1361834767786,1361834767786,2256146618,2256146618,0
1361834813,2256191868,2,473,236.5,1361834786755,1361834786819,2256165623,2256165687,64
1361834819,2256198308,3,144,48,1361834818573,1361834818637,2256197881,2256197945,64
1361834821,2256199788,2,123,61.5,1361834793300,1361834793300,2256172088,2256172088,0
1361834825,2256203824,1,46,46,1361834797808,1361834797808,2256176632,2256176632,0
1361834833,2256211744,2,265,132.5,1361834806656,1361834806784,2256185400,2256185528,128
1361834853,2256231888,1,46,46,1361834827761,1361834827761,2256206649,2256206649,0
1361834853,2256231932,2,473,236.5,1361834826886,1361834826950,2256205818,2256205882,64
1361834865,2256243912,2,123,61.5,1361834838102,1361834838102,2256217014,2256217014,0
1361834883,2256262360,3,144,48,1361834878551,1361834878551,2256257911,2256257911,0
1361834885,2256263768,7,3317,473.8571429,1361834859432,1361834859752,2256238200,2256238520,320
1361834885,2256263772,8,4381,547.625,1361834859682,1361834859810,2256238454,2256238582,128
1361834885,2256263812,1,46,46,1361834857854,1361834857854,2256236666,2256236666,0
1361834889,2256267788,2,265,132.5,1361834862358,1361834862486,2256241146,2256241274,128
1361834893,2256271788,2,473,236.5,1361834867734,1361834867798,2256246522,2256246586,64
1361834909,2256288236,2,123,61.5,1361834882709,1361834882709,2256261945,2256261945,0
1361834913,2256292116,1,46,46,1361834887565,1361834887565,2256266681,2256266681,0
1361834932,2256310396,8,451,56.375,1361834928474,1361834929242,2256306870,2256307638,768
1361834933,2256312140,2,473,236.5,1361834907827,1361834907891,2256286967,2256287031,64
1361834945,2256324080,1,46,46,1361834917617,1361834917617,2256296697,2256296697,0
1361834945,2256324160,2,265,132.5,1361834917408,1361834917536,2256296568,2256296696,128
1361834955,2256334364,3,144,48,1361834953554,1361834953554,2256332918,2256332918,0
1361834973,2256352160,2,473,236.5,1361834948063,1361834948127,2256327223,2256327287,64
1361834973,2256352236,2,123,61.5,1361834947412,1361834971156,2256326648,2256350392,23744
1361835001,2256380256,2,265,132.5,1361834972799,1361834973055,2256352055,2256352311,256
1361835005,2256384144,1,46,46,1361834977520,1361834977520,2256356664,2256356664,0
1361835013,2256392336,2,473,236.5,1361834988077,1361834988141,2256367413,2256367477,64
1361835033,2256412348,1,46,46,1361835007328,1361835007328,2256386676,2256386676,0
1361835035,2256414312,4,312,78,1361835029510,1361835029638,2256408822,2256408950,128
1361835035,2256414352,3,144,48,1361835028573,1361835028573,2256407925,2256407925,0
1361835035,2256414376,4,312,78,1361835029383,1361835029447,2256408759,2256408823,64
1361835035,2256414380,4,312,78,1361835029570,1361835029698,2256408950,2256409078,128
1361835035,2256414380,4,312,78,1361835029697,1361835029761,2256409077,2256409141,64
1361835035,2256414380,4,312,78,1361835029633,1361835029697,2256409013,2256409077,64
1361835052,2256430400,3,144,48,1361835048791,1361835048855,2256427191,2256427255,64
1361835053,2256432368,2,473,236.5,1361835027663,1361835027727,2256407031,2256407095,64
1361835057,2256436240,10,8175,817.5,1361835029582,1361835029774,2256408822,2256409014,192
1361835057,2256436320,2,265,132.5,1361835028926,1361835029054,2256408246,2256408374,128
1361835057,2256436324,3,1051,350.3333333,1361835029368,1361835029432,2256408692,2256408756,64
1361835066,2256444612,1,46,46,1361835038080,1361835038080,2256416692,2256416692,0
1361835074,2256452612,11,2025,184.0909091,1361835048642,1361835049154,2256427254,2256427766,512
1361835094,2256472636,2,473,236.5,1361835068907,1361835069035,2256447543,2256447671,128
1361835094,2256472676,1,46,46,1361835068032,1361835068032,2256446708,2256446708,0
1361835108,2256486460,3,144,48,1361835104473,1361835104473,2256482933,2256482933,0
1361835110,2256488668,2,265,132.5,1361835085131,1361835085259,2256463799,2256463927,128
1361835118,2256496668,5,808,161.6,1361835093319,1361835093959,2256471987,2256472627,640
1361835126,2256504632,1,46,46,1361835099692,1361835099692,2256478324,2256478324,0
1361835126,2256504636,1,46,46,1361835098089,1361835098089,2256476725,2256476725,0
1361835126,2256504636,1,46,46,1361835099879,1361835099879,2256478515,2256478515,0
1361835134,2256512812,2,473,236.5,1361835109368,1361835109432,2256488180,2256488244,64
1361835154,2256532728,1,46,46,1361835128013,1361835128013,2256506741,2256506741,0
1361835166,2256544756,2,265,132.5,1361835141103,1361835141167,2256519859,2256519923,64
1361835166,2256544804,2,123,61.5,1361835138111,1361835138111,2256516915,2256516915,0
1361835172,2256550552,3,144,48,1361835165373,1361835165373,2256543925,2256543925,0
1361835174,2256552736,1,46,46,1361835145923,1361835145923,2256524659,2256524659,0
1361835174,2256552908,2,473,236.5,1361835148825,1361835148889,2256527733,2256527797,64
1361835174,2256552940,1,46,46,1361835145720,1361835145720,2256524660,2256524660,0
1361835186,2256564792,1,46,46,1361835157965,1361835157965,2256536757,2256536757,0
1361835196,2256574444,4,336,84,1361835188582,1361835188710,2256567026,2256567154,128
1361835210,2256588732,2,123,61.5,1361835183111,1361835183111,2256561843,2256561843,0
1361835214,2256592768,1,46,46,1361835188003,1361835188003,2256566771,2256566771,0
1361835214,2256592884,2,473,236.5,1361835188654,1361835188718,2256567538,2256567602,64
1361835222,2256601032,2,265,132.5,1361835196827,1361835196955,2256575859,2256575987,128
1361835242,2256621208,1,46,46,1361835217580,1361835217580,2256596788,2256596788,0
1361835244,2256622552,3,144,48,1361835239356,1361835239484,2256617908,2256618036,128
1361835246,2256625120,1,46,46,1361835219458,1361835219458,2256598578,2256598578,0
1361835246,2256625160,1,46,46,1361835219161,1361835219161,2256598321,2256598321,0
1361835254,2256633052,2,123,61.5,1361835227719,1361835227719,2256606771,2256606771,0
1361835254,2256633104,2,473,236.5,1361835229073,1361835229137,2256608177,2256608241,64
1361835274,2256653116,2,123,61.5,1361835247685,1361835273349,2256626801,2256652465,25664
1361835276,2256654532,8,451,56.375,1361835273168,1361835274256,2256651700,2256652788,1088
1361835278,2256657124,2,265,132.5,1361835252606,1361835252734,2256631730,2256631858,128
1361835294,2256673132,2,473,236.5,1361835268791,1361835268855,2256647923,2256647987,64
1361835302,2256681144,1,46,46,1361835277675,1361835277675,2256656819,2256656819,0
1361835324,2256702576,3,144,48,1361835317026,1361835317090,2256695602,2256695666,64
1361835334,2256713144,2,92,46,1361835307691,1361835330795,2256686835,2256709939,23104
1361835334,2256713204,2,473,236.5,1361835309165,1361835309293,2256688369,2256688497,128
1361835334,2256713256,2,265,132.5,1361835308152,1361835308344,2256687408,2256687600,192
1361835356,2256734500,8,1505,188.125,1361835350573,1361835355629,2256729073,2256734129,5056
1361835356,2256734500,8,1505,188.125,1361835350573,1361835355629,2256729073,2256734129,5056
1361835356,2256734544,3,144,48,1361835349375,1361835349439,2256727919,2256727983,64
1361835362,2256741292,1,46,46,1361835337557,1361835337557,2256716849,2256716849,0
1361835375,2256753528,12,2359,196.5833333,1361835349458,1361835349906,2256727986,2256728434,448
1361835375,2256753612,2,473,236.5,1361835349563,1361835349627,2256728175,2256728239,64
1361835391,2256769444,2,265,132.5,1361835364771,1361835364835,2256743215,2256743279,64
1361835395,2256773568,1,46,46,1361835368298,1361835368298,2256746866,2256746866,0
1361835396,2256774616,3,144,48,1361835389305,1361835389305,2256767921,2256767921,0
1361835415,2256793500,2,473,236.5,1361835389294,1361835389358,2256767794,2256767858,64
1361835419,2256797500,2,123,61.5,1361835394862,1361835394862,2256773362,2256773362,0
1361835423,2256801664,1,46,46,1361835398218,1361835398218,2256776882,2256776882,0
1361835447,2256825644,2,265,132.5,1361835420508,1361835420572,2256799152,2256799216,64
1361835455,2256833524,1,46,46,1361835428371,1361835428371,2256806895,2256806895,0
1361835455,2256833644,2,473,236.5,1361835429339,1361835429403,2256807983,2256808047,64
1361835467,2256845648,2,123,61.5,1361835439638,1361835439638,2256818286,2256818286,0
1361835468,2256846636,3,144,48,1361835464292,1361835464292,2256842928,2256842928,0
1361835483,2256861792,1,46,46,1361835458120,1361835458120,2256836912,2256836912,0
1361835495,2256873732,2,473,236.5,1361835469059,1361835469123,2256847791,2256847855,64
1361835503,2256881700,2,265,132.5,1361835476067,1361835476131,2256854767,2256854831,64
1361835511,2256889636,2,123,61.5,1361835484580,1361835484580,2256863216,2256863216,0
1361835515,2256893744,1,46,46,1361835488182,1361835488182,2256866926,2256866926,0
1361835532,2256910732,8,451,56.375,1361835529412,1361835530116,2256908144,2256908848,704
1361835535,2256914080,2,473,236.5,1361835508773,1361835508837,2256887853,2256887917,64
1361835540,2256918584,3,144,48,1361835539285,1361835539349,2256917869,2256917933,64
1361835543,2256922016,1,46,46,1361835517926,1361835517926,2256896942,2256896942,0
1361835559,2256937992,2,265,132.5,1361835530942,1361835531070,2256909934,2256910062,128
1361835575,2256953988,1,46,46,1361835547969,1361835547969,2256926957,2256926957,0
1361835575,2256954024,2,473,236.5,1361835548959,1361835549023,2256927983,2256928047,64
1361835580,2256958692,3,144,48,1361835573996,1361835574060,2256952688,2256952752,64
1361835599,2256978076,9,1773,197,1361835573673,1361835574057,2256952749,2256953133,384
1361835603,2256982140,2,123,61.5,1361835575850,1361835577770,2256954990,2256956910,1920
1361835604,2256982728,3,144,48,1361835599175,1361835599175,2256977903,2256977903,0
1361835611,2256990220,2,265,132.5,1361835586330,1361835586458,2256965550,2256965678,128
1361835615,2256994112,2,473,236.5,1361835589380,1361835589444,2256968492,2256968556,64
1361835628,2257006740,8,1505,188.125,1361835619130,1361835624314,2256997870,2257003054,5184
1361835635,2257014200,1,46,46,1361835607727,1361835607727,2256986927,2256986927,0
1361835643,2257022148,2,123,61.5,1361835618787,1361835618787,2256997935,2256997935,0
1361835643,2257022232,3,2494,831.3333333,1361835618510,1361835618702,2256997742,2256997934,192
1361835663,2257042228,1,46,46,1361835637711,1361835637711,2257016939,2257016939,0
1361835667,2257046268,2,265,132.5,1361835642218,1361835642282,2257021486,2257021550,64
1361835675,2257054160,7,1874,267.7142857,1361835649301,1361835649685,2257028461,2257028845,384
1361835676,2257054752,3,144,48,1361835674158,1361835674158,2257052910,2257052910,0
1361835688,2257066560,2,473,236.5,1361835659499,1361835659563,2257038059,2257038123,64
1361835696,2257074484,1,46,46,1361835668471,1361835668471,2257046955,2257046955,0
1361835720,2257098452,2,123,61.5,1361835695318,1361835695318,2257073770,2257073770,0
1361835724,2257102500,1,46,46,1361835698470,1361835698470,2257076970,2257076970,0
1361835724,2257102504,2,265,132.5,1361835698915,1361835699043,2257077419,2257077547,128
1361835727,2257106380,2,473,236.5,1361835699001,1361835699065,2257078381,2257078445,64
1361835756,2257134504,1,46,46,1361835728482,1361835728482,2257106986,2257106986,0
1361835756,2257134852,3,144,48,1361835749063,1361835749063,2257127915,2257127915,0
1361835764,2257142472,2,473,236.5,1361835739587,1361835739651,2257118059,2257118123,64
1361835768,2257146496,2,123,61.5,1361835740203,1361835740203,2257118699,2257118699,0
1361835780,2257158532,2,265,132.5,1361835754118,1361835754182,2257132650,2257132714,64
1361835784,2257162604,1,46,46,1361835758397,1361835758397,2257137001,2257137001,0
1361835808,2257186584,2,473,236.5,1361835779793,1361835779857,2257158377,2257158441,64
1361835812,2257190524,2,123,61.5,1361835785103,1361835785103,2257163627,2257163627,0
1361835816,2257194544,1,46,46,1361835788540,1361835788540,2257167084,2257167084,0
1361835828,2257206908,3,144,48,1361835824013,1361835824013,2257202921,2257202921,0
1361835836,2257214576,2,265,132.5,1361835809881,1361835809945,2257188457,2257188521,64
1361835836,2257214988,8,451,56.375,1361835829564,1361835830076,2257208552,2257209064,512
1361835844,2257222948,1,46,46,1361835818085,1361835818085,2257197033,2257197033,0
1361835844,2257222988,2,473,236.5,1361835819199,1361835819263,2257198187,2257198251,64
1361835876,2257254988,1,46,46,1361835848059,1361835848059,2257227047,2257227047,0
1361835884,2257262896,2,473,236.5,1361835859098,1361835859226,2257237994,2257238122,128
1361835892,2257270868,2,265,132.5,1361835864756,1361835864884,2257243624,2257243752,128
1361835900,2257279144,3,144,48,1361835898785,1361835898785,2257277929,2257277929,0
1361835904,2257282900,2,123,61.5,1361835878166,1361835878678,2257257066,2257257578,512
1361835924,2257303056,2,473,236.5,1361835899513,1361835899577,2257278569,2257278633,64
1361835936,2257314868,1,46,46,1361835908212,1361835908212,2257287080,2257287080,0
1361835948,2257326896,2,265,132.5,1361835920023,1361835920151,2257298919,2257299047,128
1361835956,2257335196,3,144,48,1361835949738,1361835949802,2257328934,2257328998,64
1361835964,2257342952,1,46,46,1361835938145,1361835938145,2257317097,2257317097,0
1361835964,2257343168,2,473,236.5,1361835939592,1361835939656,2257318760,2257318824,64
1361835976,2257354972,13,2225,171.1538462,1361835950026,1361835950794,2257328998,2257329766,768
1361835980,2257359252,3,144,48,1361835976371,1361835976371,2257355623,2257355623,0
1361835980,2257359360,11,5602,509.2727273,1361835962312,1361835977672,2257341672,2257357032,15360
1361835996,2257374964,1,46,46,1361835968148,1361835968148,2257347112,2257347112,0
1361836000,2257379328,2,265,132.5,1361835975593,1361835975721,2257354921,2257355049,128
1361836008,2257387288,11,3267,297,1361835980558,1361835981262,2257359846,2257360550,704
1361836008,2257387384,2,473,236.5,1361835980016,1361835980080,2257359400,2257359464,64
1361836021,2257399488,2,123,61.5,1361835995247,1361835995247,2257373735,2257373735,0
1361836025,2257403444,1,46,46,1361835998810,1361835998810,2257377254,2257377254,0
1361836045,2257423604,2,473,236.5,1361836020349,1361836020413,2257398953,2257399017,64
1361836052,2257431328,3,144,48,1361836048551,1361836048615,2257427879,2257427943,64
1361836053,2257431632,1,46,46,1361836027616,1361836027616,2257406248,2257406248,0
1361836053,2257431664,1,46,46,1361836028480,1361836028480,2257407144,2257407144,0
1361836057,2257435604,2,265,132.5,1361836031930,1361836032058,2257410534,2257410662,128
1361836065,2257443580,8,4412,551.5,1361836040084,1361836054932,2257418664,2257433512,14848
1361836085,2257463588,2,473,236.5,1361836060361,1361836060425,2257438949,2257439013,64
1361836085,2257463636,1,46,46,1361836058523,1361836058523,2257437159,2257437159,0
1361836113,2257491684,1,46,46,1361836088490,1361836088490,2257467174,2257467174,0
1361836113,2257491736,2,265,132.5,1361836086966,1361836087094,2257465702,2257465830,128
1361836125,2257503612,3,144,48,1361836124337,1361836124337,2257502949,2257502949,0
1361836125,2257503688,2,473,236.5,1361836100006,1361836100134,2257478694,2257478822,128
1361836125,2257503772,2,123,61.5,1361836099856,1361836099856,2257478628,2257478628,0
1361836132,2257511388,2,141,70.5,1361836130026,1361836130026,2257509414,2257509414,0
1361836145,2257523664,1,46,46,1361836118527,1361836118527,2257497191,2257497191,0
1361836165,2257543784,2,473,236.5,1361836140420,1361836140484,2257519204,2257519268,64
1361836169,2257547728,2,265,132.5,1361836143036,1361836143100,2257521764,2257521828,64
1361836169,2257547768,2,123,61.5,1361836144723,1361836144723,2257523491,2257523491,0
1361836173,2257551780,1,46,46,1361836148426,1361836148426,2257527206,2257527206,0
1361836204,2257583312,3,144,48,1361836198580,1361836198580,2257577892,2257577892,0
1361836205,2257583760,2,123,61.5,1361836178460,1361836181532,2257557220,2257560292,3072
1361836205,2257583804,2,473,236.5,1361836180466,1361836180530,2257559270,2257559334,64
1361836217,2257595712,2,123,61.5,1361836189708,1361836189708,2257568420,2257568420,0
1361836225,2257603860,2,265,132.5,1361836198265,1361836198329,2257577125,2257577189,64
1361836228,2257607352,3,144,48,1361836226636,1361836226636,2257605988,2257605988,0
1361836233,2257611892,1,46,46,1361836208345,1361836208345,2257587237,2257587237,0
1361836245,2257623824,2,473,236.5,1361836220314,1361836220378,2257599138,2257599202,64
1361836253,2257631772,30,30471,1015.7,1361836225297,1361836251217,2257604069,2257629989,25920
1361836253,2257631812,10,7775,777.5,1361836226921,1361836227177,2257605733,2257605989,256
1361836253,2257631812,8,6900,862.5,1361836226985,1361836227177,2257605797,2257605989,192
1361836253,2257631892,8,6927,865.875,1361836226839,1361836227095,2257605731,2257605987,256
1361836253,2257631892,7,4546,649.4285714,1361836226902,1361836227094,2257605794,2257605986,192
1361836253,2257631896,13,10641,818.5384615,1361836226901,1361836227093,2257605797,2257605989,192
1361836253,2257631896,7,5335,762.1428571,1361836226901,1361836227093,2257605797,2257605989,192
1361836253,2257631920,9,3644,404.8888889,1361836227067,1361836227195,2257605987,2257606115,128
1361836261,2257639772,1,46,46,1361836234254,1361836234254,2257613026,2257613026,0
1361836265,2257643812,1,46,46,1361836238438,1361836238438,2257617250,2257617250,0
1361836276,2257655328,3,144,48,1361836273571,1361836273571,2257652899,2257652899,0
1361836276,2257655356,2,123,61.5,1361836270985,1361836270985,2257650341,2257650341,0
1361836276,2257655356,2,123,61.5,1361836270983,1361836270983,2257650339,2257650339,0
1361836277,2257655412,2,123,61.5,1361836271925,1361836271925,2257650337,2257650337,0
1361836277,2257655436,2,123,61.5,1361836271903,1361836271903,2257650339,2257650339,0
1361836277,2257655436,2,123,61.5,1361836271903,1361836271903,2257650339,2257650339,0
1361836281,2257659860,2,265,132.5,1361836253365,1361836253493,2257632225,2257632353,128
1361836285,2257663788,2,473,236.5,1361836260672,1361836260736,2257639460,2257639524,64
1361836293,2257671880,1,46,46,1361836268386,1361836268386,2257647266,2257647266,0
1361836297,2257675828,3,200,66.66666667,1361836271448,1361836271640,2257650276,2257650468,192
1361836300,2257679384,2,123,61.5,1361836295978,1361836295978,2257675362,2257675362,0
1361836321,2257700032,2,123,61.5,1361836295177,1361836295177,2257674209,2257674209,0
1361836325,2257703856,1,46,46,1361836298425,1361836298425,2257677281,2257677281,0
1361836329,2257707836,2,473,236.5,1361836301712,1361836301776,2257680548,2257680612,64
1361836333,2257711892,2,265,132.5,1361836308438,1361836308630,2257687330,2257687522,192
1361836341,2257719924,2,123,61.5,1361836316279,1361836316279,2257695203,2257695203,0
1361836353,2257731984,1,46,46,1361836328314,1361836328314,2257707298,2257707298,0
1361836356,2257735368,3,144,48,1361836348538,1361836348538,2257727906,2257727906,0
1361836365,2257743884,2,123,61.5,1361836340254,1361836340254,2257719138,2257719138,0
1361836369,2257747852,1,46,46,1361836342143,1361836342143,2257720995,2257720995,0
1361836369,2257747852,1,46,46,1361836342078,1361836342078,2257720930,2257720930,0
1361836369,2257747852,2,473,236.5,1361836342269,1361836342333,2257721121,2257721185,64
1361836369,2257747932,1,46,46,1361836341999,1361836341999,2257720931,2257720931,0
1361836369,2257747932,1,46,46,1361836341999,1361836341999,2257720931,2257720931,0
1361836369,2257747932,1,46,46,1361836341998,1361836341998,2257720930,2257720930,0
1361836369,2257747932,1,46,46,1361836342062,1361836342062,2257720994,2257720994,0
1361836385,2257763996,1,46,46,1361836358319,1361836358319,2257737315,2257737315,0
1361836389,2257767928,2,123,61.5,1361836361201,1361836361201,2257740129,2257740129,0
1361836389,2257768008,2,265,132.5,1361836363875,1361836364003,2257742883,2257743011,128
1361836409,2257787976,2,473,236.5,1361836382018,1361836382082,2257760994,2257761058,64
1361836413,2257791476,8,451,56.375,1361836406582,1361836408502,2257785058,2257786978,1920
1361836413,2257791880,1,46,46,1361836388448,1361836388448,2257767328,2257767328,0
1361836413,2257791888,2,123,61.5,1361836385176,1361836385176,2257764064,2257764064,0
1361836429,2257807492,3,144,48,1361836424419,1361836424419,2257802911,2257802911,0
1361836437,2257815400,8,451,56.375,1361836430594,1361836432578,2257808994,2257810978,1984
1361836441,2257820008,1,46,46,1361836414049,1361836414049,2257793057,2257793057,0
1361836445,2257823940,1,46,46,1361836418404,1361836418404,2257797344,2257797344,0
1361836445,2257824056,2,265,132.5,1361836419120,1361836419248,2257798176,2257798304,128
1361836449,2257827944,2,473,236.5,1361836422434,1361836422498,2257801378,2257801442,64
1361836473,2257852004,1,46,46,1361836448354,1361836448354,2257827358,2257827358,0
1361836477,2257855428,4,1043,260.75,1361836473637,1361836473701,2257852065,2257852129,64
1361836485,2257863472,3,144,48,1361836484408,1361836484472,2257862880,2257862944,64
1361836485,2257863472,4,292,73,1361836484600,1361836484728,2257863072,2257863200,128
1361836485,2257863472,4,444,111,1361836484728,1361836484856,2257863200,2257863328,128
1361836489,2257868008,2,473,236.5,1361836461855,1361836461919,2257840863,2257840927,64
1361836493,2257871448,3,144,48,1361836486671,1361836486863,2257865119,2257865311,192
1361836493,2257871492,4,448,112,1361836484965,1361836485029,2257863457,2257863521,64
1361836493,2257871540,4,442,110.5,1361836484789,1361836484917,2257863329,2257863457,128
1361836501,2257880008,2,265,132.5,1361836474848,1361836474976,2257853856,2257853984,128
1361836505,2257883988,2,123,61.5,1361836478388,1361836484148,2257857376,2257863136,5760
1361836529,2257908040,2,473,236.5,1361836502399,1361836502463,2257881439,2257881503,64
1361836533,2257912020,1,46,46,1361836508370,1361836508370,2257887390,2257887390,0
1361836541,2257919444,4,190,47.5,1361836538324,1361836538836,2257916768,2257917280,512
1361836541,2257919444,4,190,47.5,1361836538324,1361836538900,2257916768,2257917344,576
1361836541,2257919444,4,190,47.5,1361836538258,1361836538834,2257916702,2257917278,576
1361836541,2257919444,4,190,47.5,1361836538322,1361836538834,2257916766,2257917278,512
1361836541,2257919448,4,190,47.5,1361836538958,1361836539214,2257917406,2257917662,256
1361836541,2257919448,4,190,47.5,1361836538702,1361836538958,2257917150,2257917406,256
1361836541,2257919448,4,190,47.5,1361836539022,1361836539278,2257917470,2257917726,256
1361836541,2257919452,4,190,47.5,1361836538956,1361836539212,2257917408,2257917664,256
1361836541,2257919452,4,190,47.5,1361836539276,1361836539532,2257917728,2257917984,256
1361836541,2257919452,4,190,47.5,1361836539466,1361836539786,2257917918,2257918238,320
1361836541,2257919472,4,190,47.5,1361836539190,1361836539446,2257917662,2257917918,256
1361836541,2257919476,4,190,47.5,1361836539764,1361836540084,2257918240,2257918560,320
1361836541,2257919476,4,190,47.5,1361836539508,1361836539764,2257917984,2257918240,256
1361836541,2257919476,4,190,47.5,1361836539508,1361836539764,2257917984,2257918240,256
1361836541,2257919476,4,190,47.5,1361836539762,1361836540018,2257918238,2257918494,256
1361836541,2257919480,4,190,47.5,1361836540016,1361836540272,2257918496,2257918752,256
1361836541,2257919480,4,190,47.5,1361836540080,1361836540528,2257918560,2257919008,448
1361836541,2257919480,4,190,47.5,1361836540143,1361836540655,2257918623,2257919135,512
1361836541,2257919480,4,190,47.5,1361836540398,1361836540526,2257918878,2257919006,128
1361836541,2257919480,4,190,47.5,1361836540526,1361836540590,2257919006,2257919070,64
1361836541,2257919480,4,190,47.5,1361836540526,1361836540654,2257919006,2257919134,128
1361836541,2257919480,4,190,47.5,1361836540654,1361836540718,2257919134,2257919198,64
1361836541,2257919480,4,190,47.5,1361836540718,1361836540846,2257919198,2257919326,128
1361836541,2257919512,4,190,47.5,1361836538638,1361836538894,2257917150,2257917406,256
1361836541,2257919512,3,144,48,1361836535118,1361836535182,2257913630,2257913694,64
1361836541,2257919512,4,190,47.5,1361836538702,1361836538958,2257917214,2257917470,256
1361836541,2257919516,3,144,48,1361836538764,1361836539340,2257917280,2257917856,576
1361836541,2257919516,4,190,47.5,1361836539146,1361836539402,2257917662,2257917918,256
1361836541,2257919516,4,190,47.5,1361836539210,1361836539466,2257917726,2257917982,256
1361836541,2257919520,4,190,47.5,1361836539400,1361836539656,2257917920,2257918176,256
1361836541,2257919520,4,190,47.5,1361836539654,1361836539974,2257918174,2257918494,320
1361836541,2257919520,4,190,47.5,1361836539718,1361836539974,2257918238,2257918494,256
1361836541,2257919524,4,190,47.5,1361836540099,1361836540547,2257918623,2257919071,448
1361836541,2257919524,4,190,47.5,1361836540290,1361836540802,2257918814,2257919326,512
1361836541,2257919528,4,190,47.5,1361836540417,1361836540481,2257918945,2257919009,64
1361836541,2257919528,4,190,47.5,1361836540609,1361836540673,2257919137,2257919201,64
1361836541,2257919528,4,190,47.5,1361836540609,1361836540673,2257919137,2257919201,64
1361836541,2257919528,4,190,47.5,1361836540673,1361836540801,2257919201,2257919329,128
1361836541,2257919528,4,190,47.5,1361836540672,1361836540736,2257919200,2257919264,64
1361836549,2257927432,4,190,47.5,1361836541024,1361836541344,2257919456,2257919776,320
1361836549,2257927432,4,190,47.5,1361836541728,1361836542112,2257920160,2257920544,384
1361836549,2257927432,4,190,47.5,1361836541728,1361836542048,2257920160,2257920480,320
1361836549,2257927432,4,190,47.5,1361836541023,1361836541407,2257919455,2257919839,384
1361836549,2257927436,4,190,47.5,1361836542045,1361836542365,2257920481,2257920801,320
1361836549,2257927436,4,190,47.5,1361836542044,1361836542364,2257920480,2257920800,320
1361836549,2257927436,4,190,47.5,1361836541339,1361836541723,2257919775,2257920159,384
1361836549,2257927436,4,190,47.5,1361836541338,1361836541658,2257919774,2257920094,320
1361836549,2257927476,4,190,47.5,1361836540595,1361836541107,2257919071,2257919583,512
1361836549,2257927480,4,190,47.5,1361836540913,1361836541297,2257919393,2257919777,384
1361836549,2257927480,4,190,47.5,1361836541617,1361836542001,2257920097,2257920481,384
1361836549,2257927480,4,190,47.5,1361836540976,1361836541296,2257919456,2257919776,320
1361836549,2257927480,4,190,47.5,1361836541616,1361836542000,2257920096,2257920480,384
1361836549,2257927480,4,190,47.5,1361836541998,1361836542318,2257920478,2257920798,320
1361836549,2257927484,4,190,47.5,1361836541293,1361836541613,2257919777,2257920097,320
1361836549,2257927484,4,190,47.5,1361836541356,1361836541676,2257919840,2257920160,320
1361836557,2257936076,2,265,132.5,1361836530331,1361836530459,2257909407,2257909535,128
1361836561,2257940096,17,5013,294.8823529,1361836534598,1361836551558,2257913694,2257930654,16960
1361836565,2257943528,3,144,48,1361836559360,1361836559360,2257937888,2257937888,0
1361836565,2257943532,8,1505,188.125,1361836552572,1361836557692,2257931104,2257936224,5120
1361836565,2257944200,1,46,46,1361836538208,1361836538208,2257917408,2257917408,0
1361836569,2257948096,2,473,236.5,1361836542599,1361836542663,2257921695,2257921759,64
1361836593,2257972188,1,46,46,1361836568234,1361836568234,2257947422,2257947422,0
1361836597,2257975468,4,312,78,1361836589050,1361836589178,2257967518,2257967646,128
1361836609,2257988208,2,473,236.5,1361836582742,1361836582806,2257961950,2257962014,64
1361836613,2257992200,2,265,132.5,1361836585568,1361836585696,2257964768,2257964896,128
1361836621,2257999488,3,144,48,1361836619431,1361836619431,2257997919,2257997919,0
1361836621,2258000340,2,123,61.5,1361836595988,1361836595988,2257975328,2257975328,0
1361836625,2258004184,1,46,46,1361836598252,1361836598252,2257977436,2257977436,0
1361836649,2258028320,2,473,236.5,1361836622308,1361836622500,2258001628,2258001820,192
1361836653,2258032292,1,46,46,1361836628162,1361836628162,2258007454,2258007454,0
1361836666,2258044412,2,123,61.5,1361836641904,1361836641904,2258020316,2258020316,0
1361836670,2258048416,2,265,132.5,1361836642285,1361836642349,2258020701,2258020765,64
1361836677,2258055488,4,336,84,1361836675684,1361836675748,2258054172,2258054236,64
1361836686,2258064488,1,46,46,1361836658980,1361836658980,2258037468,2258037468,0
1361836690,2258068596,2,473,236.5,1361836663800,1361836663864,2258042396,2258042460,64
1361836701,2258079500,3,144,48,1361836694490,1361836694490,2258072990,2258072990,0
1361836701,2258079508,12,999,83.25,1361836687571,1361836699219,2258066079,2258077727,11648
1361836701,2258079552,15,6289,419.2666667,1361836687140,1361836699236,2258065692,2258077788,12096
1361836701,2258079576,12,999,83.25,1361836687757,1361836699149,2258066333,2258077725,11392
1361836701,2258079580,12,999,83.25,1361836688074,1361836699146,2258066654,2258077726,11072
1361836714,2258092552,2,123,61.5,1361836686691,1361836686691,2258065243,2258065243,0
1361836714,2258092600,1,46,46,1361836688886,1361836688886,2258067486,2258067486,0
1361836722,2258100744,2,265,132.5,1361836697445,1361836697573,2258076189,2258076317,128
1361836730,2258108712,2,473,236.5,1361836703621,1361836703685,2258082333,2258082397,64
1361836733,2258111596,8,451,56.375,1361836731577,1361836732409,2258110173,2258111005,832
1361836746,2258124724,1,46,46,1361836718775,1361836718775,2258097499,2258097499,0
1361836770,2258148648,2,473,236.5,1361836743043,1361836743107,2258121691,2258121755,64
1361836773,2258151596,3,144,48,1361836769270,1361836769334,2258147866,2258147930,64
1361836774,2258152640,2,92,46,1361836748877,1361836760781,2258127517,2258139421,11904
1361836778,2258156840,2,265,132.5,1361836752644,1361836752708,2258131484,2258131548,64
1361836781,2258159588,4,312,78,1361836779329,1361836779457,2258157917,2258158045,128
1361836781,2258159660,4,312,78,1361836779385,1361836779449,2258158045,2258158109,64
1361836781,2258159660,4,312,78,1361836779448,1361836779576,2258158108,2258158236,128
1361836781,2258159660,4,312,78,1361836779447,1361836779511,2258158107,2258158171,64
1361836806,2258184720,3,1036,345.3333333,1361836779067,1361836779067,2258157787,2258157787,0
1361836806,2258184720,12,10712,892.6666667,1361836779130,1361836779386,2258157850,2258158106,256
1361836806,2258184800,2,123,61.5,1361836778729,1361836786665,2258157529,2258165465,7936
1361836810,2258188836,2,473,236.5,1361836783238,1361836783302,2258162074,2258162138,64
1361836834,2258213072,2,265,132.5,1361836808092,1361836808156,2258187164,2258187228,64
1361836834,2258213072,1,46,46,1361836808475,1361836808475,2258187547,2258187547,0
1361836845,2258223628,3,144,48,1361836844247,1361836844311,2258222875,2258222939,64
1361836850,2258229044,2,473,236.5,1361836823030,1361836823094,2258202074,2258202138,64
1361836853,2258231628,3,144,48,1361836852120,1361836852184,2258230748,2258230812,64
1361836866,2258245080,1,46,46,1361836838484,1361836838484,2258217564,2258217564,0
1361836878,2258257252,11,2053,186.6363636,1361836851560,1361836852072,2258230812,2258231324,512
1361836890,2258269108,2,473,236.5,1361836862581,1361836862645,2258241689,2258241753,64
1361836890,2258269220,2,265,132.5,1361836863431,1361836863559,2258242651,2258242779,128
1361836894,2258273084,1,46,46,1361836868495,1361836868495,2258247579,2258247579,0
1361836922,2258301128,1,46,46,1361836894626,1361836894626,2258273754,2258273754,0
1361836922,2258301180,2,123,61.5,1361836896878,1361836896878,2258276058,2258276058,0
1361836922,2258301216,1,46,46,1361836894537,1361836894537,2258273753,2258273753,0
1361836925,2258303636,3,144,48,1361836919247,1361836919311,2258297883,2258297947,64
1361836926,2258305144,1,46,46,1361836898449,1361836898449,2258277593,2258277593,0
1361836930,2258309212,2,473,236.5,1361836902735,1361836902799,2258281947,2258282011,64
1361836946,2258325224,2,265,132.5,1361836919105,1361836919169,2258298329,2258298393,64
1361836954,2258333176,1,46,46,1361836928434,1361836928434,2258307610,2258307610,0
1361836966,2258345204,2,123,61.5,1361836941782,1361836941782,2258320986,2258320986,0
1361836971,2258349600,2,473,236.5,1361836943535,1361836943599,2258322135,2258322199,64
1361836987,2258365460,1,46,46,1361836959099,1361836959099,2258337559,2258337559,0
1361836997,2258375820,3,144,48,1361836994069,1361836994133,2258372889,2258372953,64
1361837003,2258381488,2,265,132.5,1361836975137,1361836975265,2258353625,2258353753,128
1361837011,2258389516,2,473,236.5,1361836983684,1361836983748,2258362200,2258362264,64
1361837015,2258393620,2,123,61.5,1361836987294,1361836987294,2258365914,2258365914,0
1361837015,2258393684,1,46,46,1361836988891,1361836988891,2258367575,2258367575,0
1361837043,2258421616,3,685,228.3333333,1361837015456,1361837015648,2258394072,2258394264,192
1361837047,2258425612,1,46,46,1361837018980,1361837018980,2258397592,2258397592,0
1361837051,2258429640,2,473,236.5,1361837023241,1361837023305,2258401881,2258401945,64
1361837055,2258433612,2,265,132.5,1361837030181,1361837030245,2258408793,2258408857,64
1361837075,2258453688,1,46,46,1361837048917,1361837048917,2258427605,2258427605,0
1361837077,2258455804,3,144,48,1361837069092,1361837069092,2258447896,2258447896,0
1361837087,2258465620,2,123,61.5,1361837060188,1361837060188,2258438808,2258438808,0
1361837091,2258469560,2,473,236.5,1361837063254,1361837063382,2258441814,2258441942,128
1361837107,2258485568,2,123,61.5,1361837079056,1361837089872,2258457624,2258468440,10816
1361837111,2258489612,2,265,132.5,1361837085347,1361837085475,2258463959,2258464087,128
1361837131,2258509900,2,473,236.5,1361837103554,1361837103682,2258482454,2258482582,128
1361837131,2258509936,2,123,61.5,1361837104800,1361837104800,2258483736,2258483736,0
1361837133,2258511888,3,144,48,1361837129040,1361837129040,2258507928,2258507928,0
1361837135,2258513968,1,46,46,1361837108672,1361837108672,2258487640,2258487640,0
1361837163,2258542092,1,46,46,1361837138561,1361837138561,2258517653,2258517653,0
1361837167,2258546040,2,265,132.5,1361837140277,1361837140341,2258519317,2258519381,64
1361837171,2258550016,2,473,236.5,1361837143822,1361837143886,2258522838,2258522902,64
1361837175,2258554048,8,1721,215.125,1361837149615,1361837152687,2258528663,2258531735,3072
1361837195,2258574152,1,46,46,1361837168516,1361837168516,2258547668,2258547668,0
1361837205,2258583908,4,184,46,1361837198778,1361837199610,2258577686,2258578518,832
1361837205,2258583948,7,405,57.85714286,1361837197587,1361837199699,2258576535,2258578647,2112
1361837205,2258583948,3,144,48,1361837203922,1361837203986,2258582870,2258582934,64
1361837211,2258590072,4,565,141.25,1361837184470,1361837199574,2258563542,2258578646,15104
1361837223,2258602104,3,311,103.6666667,1361837196150,1361837199926,2258575254,2258579030,3776
1361837229,2258607980,6,1821,303.5,1361837224880,1361837226800,2258603860,2258605780,1920
1361837253,2258631912,4,961,240.25,1361837251764,1361837252724,2258630676,2258631636,960
1361837255,2258634172,3,1281,427,1361837228848,1361837242096,2258608020,2258621268,13248
1361837280,2258658520,4,876,219,1361837254395,1361837272123,2258632915,2258650643,17728
1361837287,2258666376,1,427,427,1361837259619,1361837259619,2258638995,2258638995,0
1361837320,2258698468,1,219,219,1361837292462,1361837292462,2258670930,2258670930,0
1361837320,2258698540,1,427,427,1361837295848,1361837295848,2258674388,2258674388,0
1361837360,2258738656,1,219,219,1361837332853,1361837332853,2258711509,2258711509,0
1361838181,2259560248,1,46,46,1361838154069,1361838154069,2259533317,2259533317,0
1361838510,2259889060,15,6289,419.2666667,1361838491277,1361838503373,2259870337,2259882433,12096
1361838510,2259889060,12,999,83.25,1361838491724,1361838503372,2259870784,2259882432,11648
1361838510,2259889148,11,953,86.63636364,1361838492023,1361838503287,2259871171,2259882435,11264
1361838510,2259889148,12,999,83.25,1361838492277,1361838503285,2259871425,2259882433,11008
1361839243,2260621784,1,46,46,1361839216021,1361839216021,2260594805,2260594805,0
1361840134,2261512876,1,48,48,1361840108268,1361840108268,2261487144,2261487144,0
1361840322,2261700660,9,861,95.66666667,1361840297409,1361840297601,2261676069,2261676261,192
1361840322,2261700744,9,861,95.66666667,1361840297071,1361840297263,2261675815,2261676007,192
1361840322,2261700772,8,815,101.875,1361840297620,1361840297812,2261676392,2261676584,192
1361840322,2261700816,12,6151,512.5833333,1361840296549,1361840296933,2261675365,2261675749,384
1361840513,2261891776,4,252,63,1361840505737,1361840512841,2261884513,2261891617,7104
1361840546,2261925284,1,63,63,1361840520333,1361840520333,2261899617,2261899617,0
1361840601,2261979816,3,189,63,1361840594020,1361840597028,2261972836,2261975844,3008
1361840601,2261979816,3,189,63,1361840594017,1361840597089,2261972833,2261975905,3072
1361840601,2261979860,3,189,63,1361840595188,1361840598196,2261974048,2261977056,3008
1361840617,2261995808,2,126,63,1361840601067,1361840609131,2261979875,2261987939,8064
1361840617,2261995856,2,126,63,1361840601084,1361840609084,2261979940,2261987940,8000
1361840617,2261995892,2,126,63,1361840602198,1361840610262,2261981090,2261989154,8064
1361841160,2262538564,9,861,95.66666667,1361841134231,1361841134423,2262512795,2262512987,192
1361841160,2262538592,8,815,101.875,1361841134776,1361841134968,2262513368,2262513560,192
1361841160,2262538668,13,6234,479.5384615,1361841133678,1361841133998,2262512346,2262512666,320
1361841160,2262538676,9,861,95.66666667,1361841134374,1361841134566,2262513050,2262513242,192
1361841362,2262740604,3,189,63,1361841357865,1361841360873,2262736469,2262739477,3008
1361841362,2262740604,3,189,63,1361841357993,1361841361001,2262736597,2262739605,3008
1361841378,2262756620,2,126,63,1361841364891,1361841372955,2262743511,2262751575,8064
1361841378,2262756688,2,126,63,1361841364949,1361841373013,2262743637,2262751701,8064
1361841410,2262788640,4,252,63,1361841401925,1361841409029,2262780565,2262787669,7104
1361841444,2262823172,1,63,63,1361841416497,1361841416497,2262795669,2262795669,0
1361841474,2262852684,4,252,63,1361841465498,1361841472538,2262844182,2262851222,7040
1361841509,2262887444,1,63,63,1361841480841,1361841480841,2262859285,2262859285,0
1361841817,2263196240,1,60,60,1361841789160,1361841789160,2263168400,2263168400,0
1361842953,2264331548,12,6151,512.5833333,1361842924940,1361842925772,2264303488,2264304320,832
1361842953,2264331560,9,861,95.66666667,1361842925885,1361842926589,2264304445,2264305149,704
1361842953,2264331596,8,815,101.875,1361842926620,1361842926812,2264305216,2264305408,192
1361843101,2264479876,1,48,48,1361843074113,1361843074113,2264452989,2264452989,0
1361843156,2264534580,3,138,46,1361843153193,1361843153257,2264531773,2264531837,64
1361843156,2264534580,3,138,46,1361843153193,1361843153257,2264531773,2264531837,64
1361843156,2264534660,3,138,46,1361843153113,1361843153177,2264531773,2264531837,64
1361843181,2264559848,8,815,101.875,1361843154969,1361843155097,2264533817,2264533945,128
1361843181,2264559924,9,861,95.66666667,1361843153998,1361843154254,2264532922,2264533178,256
1361843181,2264559928,1,46,46,1361843154124,1361843154124,2264533052,2264533052,0
1361843181,2264559932,9,861,95.66666667,1361843154312,1361843154504,2264533244,2264533436,192
1361843181,2264559936,9,861,95.66666667,1361843154565,1361843154757,2264533501,2264533693,192
1361843348,2264726752,3,189,63,1361843344760,1361843347768,2264723512,2264726520,3008
1361843356,2264734744,4,252,63,1361843346879,1361843353919,2264725623,2264732663,7040
1361843364,2264742772,2,126,63,1361843351782,1361843359846,2264730554,2264738618,8064
1361843388,2264766804,2,126,63,1361843386115,1361843387075,2264764919,2264765879,960
1361843389,2264768088,1,63,63,1361843361638,1361843361638,2264740726,2264740726,0
1361843396,2264774808,2,126,63,1361843389121,1361843393153,2264767929,2264771961,4032
1361843425,2264804336,1,63,63,1361843400686,1361843400686,2264780022,2264780022,0
1361843468,2264846796,3,189,63,1361843464266,1361843467274,2264843062,2264846070,3008
1361843484,2264862848,2,126,63,1361843471255,1361843479255,2264850103,2264858103,8000
1361843819,2265198116,1,46,46,1361843791172,1361843791172,2265170288,2265170288,0
1361844123,2265501548,1,60,60,1361844095483,1361844095483,2265474031,2265474031,0
1361844164,2265543148,15,6289,419.2666667,1361844144482,1361844156578,2265523630,2265535726,12096
1361844164,2265543148,17,6755,397.3529412,1361844145184,1361844156576,2265524332,2265535724,11392
1361844164,2265543148,12,999,83.25,1361844145631,1361844156575,2265524779,2265535723,10944
1361844164,2265543152,11,953,86.63636364,1361844146014,1361844156574,2265525166,2265535726,10560
1361844170,2265549188,11,3267,297,1361844145080,1361844145656,2265524268,2265524844,576
1361844188,2265567232,3,205,68.33333333,1361844187212,1361844187660,2265566444,2265566892,448
1361844656,2266034392,1,444,444,1361844628940,1361844628940,2266007332,2266007332,0
1361845053,2266431856,17,6755,397.3529412,1361845034553,1361845045177,2266413409,2266424033,10624
1361845053,2266431880,12,999,83.25,1361845034975,1361845045151,2266413855,2266424031,10176
1361845053,2266431884,11,953,86.63636364,1361845035227,1361845045147,2266414111,2266424031,9920
1361845077,2266455444,8,815,101.875,1361845052627,1361845052819,2266431071,2266431263,192
1361845080,2266459252,9,861,95.66666667,1361845052461,1361845052653,2266431713,2266431905,192
1361845080,2266459260,9,861,95.66666667,1361845052709,1361845052901,2266431969,2266432161,192
1361845081,2266459364,8,815,101.875,1361845052961,1361845053281,2266431325,2266431645,320
1361845081,2266459364,1,46,46,1361845053089,1361845053089,2266431453,2266431453,0
1361845309,2266687944,4,252,63,1361845301594,1361845308698,2266680538,2266687642,7104
1361845333,2266712124,3,189,63,1361845327081,1361845330089,2266706205,2266709213,3008
1361845345,2266723692,1,63,63,1361845317016,1361845317016,2266695708,2266695708,0
1361845349,2266728096,2,126,63,1361845334210,1361845342210,2266713306,2266721306,8000
1361845357,2266736024,4,252,63,1361845348937,1361845355977,2266727961,2266735001,7040
1361845389,2266768244,1,63,63,1361845363821,1361845363821,2266743065,2266743065,0
1361845397,2266776304,3,189,63,1361845390705,1361845393777,2266770009,2266773081,3072
1361845413,2266792332,2,126,63,1361845397784,1361845405784,2266777116,2266785116,8000
1361846287,2267666344,1,68,68,1361846260926,1361846260926,2267640270,2267640270,0
1361846428,2267806932,2,96,48,1361846402776,1361846405784,2267781708,2267784716,3008
1361846870,2268248484,13,6234,479.5384615,1361846844240,1361846844496,2268222724,2268222980,256
1361846870,2268248516,9,861,95.66666667,1361846844847,1361846844975,2268223363,2268223491,128
1361846870,2268248520,9,861,95.66666667,1361846845099,1361846845227,2268223619,2268223747,128
1361846870,2268248604,9,861,95.66666667,1361846844502,1361846844630,2268223106,2268223234,128
1361847129,2268507808,2,126,63,1361847127496,1361847128520,2268506304,2268507328,1024
1361847137,2268515792,4,218,54.5,1361847129624,1361847131096,2268508416,2268509888,1472
1361847137,2268515832,6,327,54.5,1361847129071,1361847131119,2268507903,2268509951,2048
1361847158,2268537048,3,155,51.66666667,1361847130265,1361847130841,2268509313,2268509889,576
1361847158,2268537056,2,109,54.5,1361847130832,1361847130832,2268509888,2268509888,0
1361847158,2268537124,9,861,95.66666667,1361847132874,1361847133066,2268511998,2268512190,192
1361847158,2268537128,9,861,95.66666667,1361847132553,1361847132745,2268511681,2268511873,192
1361847158,2268537132,8,815,101.875,1361847133186,1361847133378,2268512318,2268512510,192
1361847158,2268537216,14,6617,472.6428571,1361847132078,1361847132398,2268511294,2268511614,320
1361847193,2268571880,3,138,46,1361847189887,1361847189951,2268568767,2268568831,64
1361847193,2268571968,3,138,46,1361847189862,1361847189926,2268568830,2268568894,64
1361847193,2268571972,3,138,46,1361847189793,1361847189921,2268568765,2268568893,128
1361847214,2268593256,8,815,101.875,1361847188295,1361847188487,2268567551,2268567743,192
1361847214,2268593256,3,475,158.3333333,1361847188231,1361847188231,2268567487,2268567487,0
1361847214,2268593260,8,815,101.875,1361847188611,1361847188739,2268567871,2268567999,128
1361847214,2268593288,8,815,101.875,1361847188840,1361847189032,2268568128,2268568320,192
1361847449,2268828084,3,189,63,1361847441777,1361847444849,2268820861,2268823933,3072
1361847465,2268843984,2,126,63,1361847448980,1361847456980,2268827964,2268835964,8000
1361847497,2268876044,3,189,63,1361847491159,1361847494167,2268870203,2268873211,3008
1361847497,2268876104,3,189,63,1361847493274,1361847496282,2268872378,2268875386,3008
1361847505,2268884092,4,252,63,1361847496104,1361847503144,2268875196,2268882236,7040
1361847513,2268892096,2,126,63,1361847500322,1361847508386,2268879418,2268887482,8064
1361847513,2268892124,2,126,63,1361847498118,1361847506182,2268877242,2268885306,8064
1361847539,2268918028,1,63,63,1361847511271,1361847511271,2268890299,2268890299,0
1361848058,2269436416,11,953,86.63636364,1361848048640,1361848057728,2269427056,2269436144,9088
1361848058,2269436472,12,999,83.25,1361848048329,1361848057673,2269426801,2269436145,9344
1361848058,2269436548,15,6289,419.2666667,1361848047743,1361848057599,2269426291,2269436147,9856
1361848061,907754412,16,18750,1171.875,1361848047172,1361848059140,907740584,907752552,11968
1361848061,907754412,9,7805,867.2222222,1361848047172,1361848059140,907740584,907752552,11968
1361848066,2269444540,18,8092,449.5555556,1361848047815,1361848059847,2269426355,2269438387,12032
1361848383,908076136,1,46,46,1361848356443,1361848356443,908049579,908049579,0
1361849315,2270694064,12,999,83.25,1361849297895,1361849308519,2270676959,2270687583,10624
1361849315,2270694104,16,6372,398.25,1361849296382,1361849308542,2270675486,2270687646,12160
1361849315,2270694112,13,1382,106.3076923,1361849296824,1361849308472,2270675936,2270687584,11648
1361849315,2270694136,16,6372,398.25,1361849297247,1361849308447,2270676383,2270687583,11200
1361849664,2271042572,1,46,46,1361849638797,1361849638797,2271017369,2271017369,0
1361850649,2272028328,1,436,436,1361850624140,1361850624140,2272003468,2272003468,0
1361851351,2272730048,1,46,46,1361851322970,1361851322970,2272702018,2272702018,0
1361853480,2274858784,1,46,46,1361853455232,1361853455232,2274834016,2274834016,0
1361855284,2276663100,1,436,436,1361855257578,1361855257578,2276636678,2276636678,0
1361857624,2279003184,1,71,71,1361857599156,1361857599156,2278978340,2278978340,0
1361857677,2279056044,1,46,46,1361857651392,1361857651392,2279030436,2279030436,0
1361857765,2279143900,1,71,71,1361857740239,1361857740239,2279119139,2279119139,0
1361859066,2280444388,1,60,60,1361859038265,1361859038265,2280416653,2280416653,0
1361862242,2283620712,1,48,48,1361862217160,1361862217160,2283595872,2283595872,0
1361862542,2283920556,1,404,404,1361862517404,1361862517404,2283895960,2283895960,0
1361862578,2283956832,1,60,60,1361862551944,1361862551944,2283930776,2283930776,0
1361862846,2284225092,1,60,60,1361862821635,1361862821635,2284200727,2284200727,0
1361862991,2284369780,1,48,48,1361862964086,1361862964086,2284342866,2284342866,0
1361863244,2284622616,1,46,46,1361863217624,1361863217624,2284596240,2284596240,0
1361863490,2284869020,1,48,48,1361863461569,1361863461569,2284840589,2284840589,0
1361863540,2284919124,1,46,46,1361863513495,1361863513495,2284892619,2284892619,0
1361863905,2285284272,1,78,78,1361863879550,1361863879550,2285258822,2285258822,0
1361864694,2286072880,1,46,46,1361864667064,1361864667064,2286045944,2286045944,0
1361864864,2286242588,1,46,46,1361864835162,1361864835162,2286213750,2286213750,0
1361865111,2286490268,1,48,48,1361865082414,1361865082414,2286461682,2286461682,0
1361865969,2287348036,9,861,95.66666667,1361865944202,1361865944394,2287323238,2287323430,192
1361865969,2287348080,14,6751,482.2142857,1361865943197,1361865943453,2287322277,2287322533,256
1361865969,2287348080,9,861,95.66666667,1361865943901,1361865944093,2287322981,2287323173,192
1361865969,2287348084,14,6617,472.6428571,1361865943515,1361865943835,2287322599,2287322919,320
1361865969,2287348084,8,815,101.875,1361865944474,1361865944602,2287323558,2287323686,128
1361865991,2287369828,1,46,46,1361865962395,1361865962395,2287341223,2287341223,0
1361866172,2287550488,4,252,63,1361866163116,1361866170156,2287541604,2287548644,7040
1361866188,2287566484,3,189,63,1361866182576,1361866185648,2287561060,2287564132,3072
1361866196,2287574476,3,189,63,1361866189175,1361866192183,2287567651,2287570659,3008
1361866196,2287574476,3,189,63,1361866189239,1361866192247,2287567715,2287570723,3008
1361866204,2287582480,2,126,63,1361866189618,1361866197682,2287568098,2287576162,8064
1361866206,2287584380,1,63,63,1361866178329,1361866178329,2287556709,2287556709,0
1361866212,2287590484,2,126,63,1361866196206,1361866204270,2287574690,2287582754,8064
1361866212,2287590488,2,126,63,1361866196269,1361866204269,2287574757,2287582757,8000
1361866252,2287630500,2,126,63,1361866249887,1361866250911,2287628387,2287629411,1024
1361866260,2287638532,2,126,63,1361866252862,1361866256894,2287631394,2287635426,4032
1361866290,2287668624,1,63,63,1361866264866,1361866264866,2287643490,2287643490,0
1361867796,2289175272,1,46,46,1361867769090,1361867769090,2289148362,2289148362,0
1361868690,2290068324,1,46,46,1361868664811,1361868664811,2290043135,2290043135,0
1361869932,2291311180,1,46,46,1361869906176,1361869906176,2291285356,2291285356,0
1361871433,2292811460,1,46,46,1361871406779,1361871406779,2292785239,2292785239,0
1361873034,2294413232,2,92,46,1361873009822,1361873010334,2294389054,2294389566,512
1361873712,2295090336,2,122,61,1361873686420,1361873688596,2295064756,2295066932,2176
1361874193,2295571280,1,60,60,1361874166917,1361874166917,2295545197,2295545197,0
1361875696,2297074564,1,84,84,1361875670224,1361875670224,2297048788,2297048788,0
1361876506,2297885208,1,46,46,1361876480639,1361876480639,2297859847,2297859847,0
1361877160,2298538732,1,48,48,1361877134355,1361877134355,2298513087,2298513087,0
1361877995,2298780868,1,46,46,1361877970910,1361877970910,2298756778,2298756778,0
1361878607,2299985504,1,108,108,1361878606755,1361878606755,2299985259,2299985259,0
1361878607,2299985504,4,2054,513.5,1361878606435,1361878606435,2299984939,2299984939,0
1361878607,2299985504,2,216,108,1361878606562,1361878606626,2299985066,2299985130,64
1361878607,2299985504,3,2365,788.3333333,1361878606498,1361878606626,2299985002,2299985130,128
1361878607,2299985504,2,216,108,1361878606626,1361878606754,2299985130,2299985258,128
1361878610,2299395996,4,1448,362,1361878609384,1361878609448,2299395380,2299395444,64
1361878610,2299396008,5,451,90.2,1361878608736,1361878608992,2299394744,2299395000,256
1361878614,2299992692,5,1257,251.4,1361878609062,1361878609126,2299987754,2299987818,64
1361878614,2299992692,8,3492,436.5,1361878609700,1361878610468,2299988392,2299989160,768
1361878614,2299992692,8,2018,252.25,1361878609892,1361878610084,2299988584,2299988776,192
1361878614,2299992700,8,2004,250.5,1361878607328,1361878607520,2299986028,2299986220,192
1361878614,2299992700,5,772,154.4,1361878607391,1361878607775,2299986091,2299986475,384
1361878614,2299992704,11,3392,308.3636364,1361878612764,1361878613532,2299991468,2299992236,768
1361878614,2299992728,6,983,163.8333333,1361878613505,1361878613825,2299992233,2299992553,320
1361878618,2299403992,5,2109,421.8,1361878616300,1361878616300,2299402292,2299402292,0
1361878618,2299404004,5,451,90.2,1361878616161,1361878617697,2299402165,2299403701,1536
1361878622,2300000676,11,3294,299.4545455,1361878614519,1361878615287,2299993195,2299993963,768
1361878622,2300000676,9,1913,212.5555556,1361878620149,1361878620277,2299998825,2299998953,128
1361878622,2300000676,4,724,181,1361878616756,1361878616756,2299995432,2299995432,0
1361878622,2300000680,5,609,121.8,1361878620659,1361878621107,2299999339,2299999787,448
1361878622,2300000680,8,3492,436.5,1361878613617,1361878614321,2299992297,2299993001,704
1361878622,2300000680,15,8365,557.6666667,1361878621104,1361878621296,2299999784,2299999976,192
1361878622,2300000684,6,798,133,1361878613871,1361878614127,2299992555,2299992811,256
1361878622,2300000684,9,1913,212.5555556,1361878621806,1361878621934,2300000490,2300000618,128
1361878622,2300000684,9,1913,212.5555556,1361878618798,1361878618926,2299997482,2299997610,128
1361878622,2300000684,6,798,133,1361878615276,1361878615468,2299993960,2299994152,192
1361878622,2300000688,7,1460,208.5714286,1361878615336,1361878615912,2299994024,2299994600,576
1361878622,2300000688,11,3139,285.3636364,1361878615336,1361878615976,2299994024,2299994664,640
1361878622,2300000688,10,1965,196.5,1361878619372,1361878619628,2299998060,2299998316,256
1361878622,2300000688,10,3041,304.1,1361878620137,1361878620649,2299998825,2299999337,512
1361878622,2300000708,9,1913,212.5555556,1361878617556,1361878617684,2299996264,2299996392,128
1361878622,2300000708,5,609,121.8,1361878618070,1361878618518,2299996778,2299997226,448
1361878626,2299412008,5,451,90.2,1361878623008,1361878623136,2299409016,2299409144,128
1361878626,2299412024,5,451,90.2,1361878624336,1361878625104,2299410360,2299411128,768
1361878626,2299412024,5,451,90.2,1361878621261,1361878621837,2299407285,2299407861,576
1361878626,2299412024,5,451,90.2,1361878618893,1361878620109,2299404917,2299406133,1216
1361878630,2300008688,9,1913,212.5555556,1361878627305,1361878627497,2300005993,2300006185,192
1361878630,2300008692,12,4927,410.5833333,1361878624038,1361878624230,2300002730,2300002922,192
1361878630,2300008692,9,2849,316.5555556,1361878627941,1361878628133,2300006633,2300006825,192
1361878630,2300008692,12,4735,394.5833333,1361878624677,1361878624869,2300003369,2300003561,192
1361878630,2300008696,10,1877,187.7,1361878625698,1361878626530,2300004394,2300005226,832
1361878630,2300008696,5,609,121.8,1361878625762,1361878626210,2300004458,2300004906,448
1361878630,2300008696,9,1913,212.5555556,1361878626657,1361878626849,2300005353,2300005545,192
1361878630,2300008700,12,4967,413.9166667,1361878622943,1361878623327,2300001643,2300002027,384
1361878630,2300008700,5,609,121.8,1361878622301,1361878622813,2300001001,2300001513,512
1361878630,2300008700,5,609,121.8,1361878623772,1361878624156,2300002472,2300002856,384
1361878630,2300008704,9,1913,212.5555556,1361878622747,1361878622939,2300001451,2300001643,192
1361878630,2300008704,9,1913,212.5555556,1361878625048,1361878625368,2300003752,2300004072,320
1361878630,2300008728,12,4967,413.9166667,1361878621762,1361878622274,2300000490,2300001002,512
1361878631,2300009496,2,104,52,1361878606826,1361878606826,2299985322,2299985322,0
1361878631,2300009536,1,108,108,1361878606786,1361878606786,2299985322,2299985322,0
1361878634,2299419996,4,445,111.25,1361878626858,1361878626986,2299412854,2299412982,128
1361878634,2299419996,4,445,111.25,1361878626985,1361878627177,2299412981,2299413173,192
1361878634,2299420004,4,445,111.25,1361878626593,1361878626785,2299412597,2299412789,192
1361878634,2299420004,4,1448,362,1361878628769,1361878628833,2299414773,2299414837,64
1361878638,2300016692,10,3397,339.7,1361878630501,1361878631717,2300009193,2300010409,1216
1361878638,2300016700,14,7501,535.7857143,1361878634015,1361878634847,2300012715,2300013547,832
1361878638,2300016728,9,3310,367.7777778,1361878628609,1361878630465,2300007337,2300009193,1856
1361878638,2300016728,4,715,178.75,1361878632961,1361878633153,2300011689,2300011881,192
1361878638,2300016732,11,3096,281.4545455,1361878633212,1361878633980,2300011944,2300012712,768
1361878643,2300021528,7,1877,268.1428571,1361878617033,1361878617737,2299995561,2299996265,704
1361879681,2301059940,1,46,46,1361879655455,1361879655455,2301034395,2301034395,0
1361881734,2303113232,1,48,48,1361881706333,1361881706333,2303085565,2303085565,0
1361881783,2303161300,1,46,46,1361881755134,1361881755134,2303133434,2303133434,0
1361882103,2303481836,1,46,46,1361882075234,1361882075234,2303454070,2303454070,0
1361882311,2303690152,1,46,46,1361882285411,1361882285411,2303664563,2303664563,0
1361882696,2304074776,1,60,60,1361882670420,1361882670420,2304049196,2304049196,0
1361882749,2304127468,1,46,46,1361882722313,1361882722313,2304100781,2304100781,0
1361882749,2304127844,1,46,46,1361882721807,1361882721807,2304100651,2304100651,0
1361883070,2304448716,1,46,46,1361883042573,1361883042573,2304421289,2304421289,0
1361883071,2304449624,1,46,46,1361883042662,1361883042662,2304421286,2304421286,0
1361883101,2304479740,5,250,50,1361883074418,1361883096114,2304453158,2304474854,21696
1361883145,2304523752,1,48,48,1361883120166,1361883120166,2304498918,2304498918,0
1361883177,2304555948,1,48,48,1361883149091,1361883149091,2304528039,2304528039,0
1361884560,2305939172,1,46,46,1361884535211,1361884535211,2305914383,2305914383,0
1361884769,2305555176,1,46,46,1361884744043,1361884744043,2305530219,2305530219,0
1361884769,2305555200,1,46,46,1361884744084,1361884744084,2305530284,2305530284,0
1361884994,2306372548,1,46,46,1361884968151,1361884968151,2306346699,2306346699,0
1361885579,2306958204,1,46,46,1361885553469,1361885553469,2306932673,2306932673,0
1361886690,2308068716,1,56,56,1361886664405,1361886664405,2308043121,2308043121,0
1361886706,2308084788,1,56,56,1361886680781,1361886680781,2308059569,2308059569,0
1361886818,2308196928,1,46,46,1361886793088,1361886793088,2308172016,2308172016,0
1361886943,2308321612,1,48,48,1361886915127,1361886915127,2308293739,2308293739,0
1361886943,2308322012,1,48,48,1361886914664,1361886914664,2308293676,2308293676,0
1361888718,2310096984,1,56,56,1361888690091,1361888690091,2310069075,2310069075,0
1361889014,2310392408,44,56779,1290.431818,1361889011942,1361889012198,2310390350,2310390606,256
1361889030,2310408396,17,6755,397.3529412,1361889016304,1361889028144,2310394700,2310406540,11840
1361889030,2310408404,12,999,83.25,1361889016746,1361889028138,2310395150,2310406542,11392
1361889030,2310408404,12,999,83.25,1361889017001,1361889028073,2310395405,2310406477,11072
1361889030,2310408408,11,953,86.63636364,1361889017318,1361889028070,2310395726,2310406478,10752
1361889030,2310408440,18,6935,385.2777778,1361889015940,1361889028292,2310394380,2310406732,12352
1361889043,2310421996,1,46,46,1361889016537,1361889016537,2310395533,2310395533,0
1361889047,2310425988,2,152,76,1361889021024,1361889036064,2310400012,2310415052,15040
1361889076,2310454240,2,152,76,1361889051853,1361889066893,2310430093,2310445133,15040
1361889104,2310482292,1,46,46,1361889076503,1361889076503,2310454795,2310454795,0
1361889108,2310486292,1,76,76,1361889081880,1361889081880,2310460172,2310460172,0
1361889292,2310670612,1,46,46,1361889264725,1361889264725,2310643337,2310643337,0
1361889604,2310982964,1,48,48,1361889577072,1361889577072,2310956036,2310956036,0
1361889754,2311132420,1,46,46,1361889726480,1361889726480,2311104900,2311104900,0
1361889754,2311132468,1,46,46,1361889726429,1361889726429,2311104897,2311104897,0
1361889837,2311215580,1,46,46,1361889809711,1361889809711,2311188291,2311188291,0
1361889926,2311304976,17,6755,397.3529412,1361889911586,1361889923682,2311290562,2311302658,12096
1361889926,2311304976,12,999,83.25,1361889912287,1361889923615,2311291263,2311302591,11328
1361889926,2311305044,12,999,83.25,1361889911901,1361889923549,2311290945,2311302593,11648
1361889926,2311305044,11,953,86.63636364,1361889912475,1361889923547,2311291519,2311302591,11072
1361890001,2311379996,1,46,46,1361889973709,1361889973709,2311352705,2311352705,0
1361890058,2311436376,1,46,46,1361890030326,1361890030326,2311408702,2311408702,0
1361890623,2312001532,12,999,83.25,1361890612497,1361890622353,2311991029,2312000885,9856
1361890623,2312001600,11,953,86.63636364,1361890611919,1361890622287,2311990519,2312000887,10368
1361890623,2312001600,12,999,83.25,1361890612173,1361890622285,2311990773,2312000885,10112
1361891538,2312916736,1,46,46,1361891512566,1361891512566,2312891302,2312891302,0
1361891538,2312916772,1,46,46,1361891512660,1361891512660,2312891432,2312891432,0
1361891752,2313130552,21,15645,745,1361891740462,1361891747758,2313119014,2313126310,7296
1361891760,2313138576,12,999,83.25,1361891743315,1361891755027,2313121891,2313133603,11712
1361891760,2313138576,11,953,86.63636364,1361891743571,1361891755027,2313122147,2313133603,11456
1361891760,2313138580,12,999,83.25,1361891743825,1361891755025,2313122405,2313133605,11200
1361891760,2313138624,17,6755,397.3529412,1361891742949,1361891755045,2313121573,2313133669,12096
1361891800,2313178536,11,953,86.63636364,1361891781757,1361891793853,2313160293,2313172389,12096
1361891800,2313178536,12,999,83.25,1361891782010,1361891793850,2313160546,2313172386,11840
1361891800,2313178540,11,953,86.63636364,1361891782262,1361891793846,2313160802,2313172386,11584
1361891800,2313178544,11,953,86.63636364,1361891782579,1361891793843,2313161123,2313172387,11264
1361892234,2313613204,1,46,46,1361892206425,1361892206425,2313585629,2313585629,0
1361892291,2313669248,1,46,46,1361892264341,1361892264341,2313642589,2313642589,0
1361892380,2313758228,1,46,46,1361892353127,1361892353127,2313731355,2313731355,0
1361892380,2313758264,1,46,46,1361892353348,1361892353348,2313731612,2313731612,0
1361893421,2314799960,5,250,50,1361893395642,1361893416890,2314774602,2314795850,21248
1361893469,2314848100,1,48,48,1361893441133,1361893441133,2314820233,2314820233,0
1361893498,2314876236,1,48,48,1361893471437,1361893471437,2314849673,2314849673,0
1361893706,2315084964,1,46,46,1361893681523,1361893681523,2315060487,2315060487,0
1361893707,2315085716,1,46,46,1361893681643,1361893681643,2315060359,2315060359,0
1361897558,2318936592,1,48,48,1361897531116,1361897531116,2318909708,2318909708,0
1361897876,2319255084,1,46,46,1361897848700,1361897848700,2319227784,2319227784,0
1361898442,2319820468,2,326,163,1361898415003,1361898415067,2319793471,2319793535,64
1361898442,2319820572,1,46,46,1361898414517,1361898414517,2319793089,2319793089,0
1361898996,2320374240,1,46,46,1361898968439,1361898968439,2320346679,2320346679,0
1361899516,2320894300,1,48,48,1361899488244,1361899488244,2320866544,2320866544,0
1361899540,2320918364,1,56,56,1361899512498,1361899512498,2320890862,2320890862,0
1361899668,2321046568,2,122,61,1361899638502,1361899640870,2321017070,2321019438,2368
1361899977,2321355432,1,48,48,1361899951658,1361899951658,2321330090,2321330090,0
1361901837,2323215720,1,46,46,1361901810925,1361901810925,2323189645,2323189645,0
1361901913,2323291752,1,52,52,1361901887627,1361901887627,2323266379,2323266379,0
1361902120,2323498852,5,456,91.2,1361902114022,1361902114470,2323492874,2323493322,448
1361902443,2323821488,1,48,48,1361902418124,1361902418124,2323796612,2323796612,0
1361902495,2323873656,2,92,46,1361902467300,1361902470692,2323845956,2323849348,3392
1361902752,2324130376,2,122,61,1361902725496,1361902725752,2324103872,2324104128,256
1361903117,2324495580,2,92,46,1361903092838,1361903094502,2324471418,2324473082,1664
1361903221,2324599972,3,152,50.66666667,1361903194715,1361903203675,2324573687,2324582647,8960
1361903221,2324599984,3,152,50.66666667,1361903195790,1361903204750,2324574774,2324583734,8960
1361903225,2324603936,3,152,50.66666667,1361903196927,1361903205887,2324575863,2324584823,8960
1361903225,2324604020,3,152,50.66666667,1361903196842,1361903205802,2324575862,2324584822,8960
1361903249,2324628092,1,46,46,1361903223651,1361903223651,2324602743,2324602743,0
1361903253,2324631952,1,46,46,1361903226287,1361903226287,2324605239,2324605239,0
1361903253,2324631956,1,46,46,1361903226411,1361903226411,2324605367,2324605367,0
1361903253,2324632036,1,46,46,1361903226202,1361903226202,2324605238,2324605238,0
1361903486,2324864504,1,46,46,1361903461421,1361903461421,2324839925,2324839925,0
1361903518,2324896772,1,48,48,1361903492766,1361903492766,2324871538,2324871538,0
1361903530,2324908900,1,46,46,1361903503649,1361903503649,2324882549,2324882549,0
1361904594,2325972552,14,3460,247.1428571,1361904586217,1361904588905,2325964769,2325967457,2688
1361904613,2325992072,16,7743,483.9375,1361904588642,1361904588898,2325967714,2325967970,256
1361904617,2325996084,8,815,101.875,1361904589334,1361904589526,2325968418,2325968610,192
1361904617,2325996164,14,6617,472.6428571,1361904588934,1361904589190,2325968098,2325968354,256
1361904618,2325996172,9,861,95.66666667,1361904590566,1361904590758,2325968738,2325968930,192
1361904618,2325996208,9,861,95.66666667,1361904590788,1361904590980,2325968996,2325969188,192
1361904666,2326044460,4,184,46,1361904665605,1361904665669,2326044065,2326044129,64
1361904666,2326044460,4,184,46,1361904665605,1361904665669,2326044065,2326044129,64
1361904666,2326044464,4,184,46,1361904665667,1361904665731,2326044131,2326044195,64
1361904666,2326044540,4,184,46,1361904665589,1361904665653,2326044129,2326044193,64
1361904666,2326044540,4,184,46,1361904665525,1361904665589,2326044065,2326044129,64
1361905246,2326625024,1,52,52,1361905220873,1361905220873,2326599897,2326599897,0
1361905379,2326757668,1,48,48,1361905350762,1361905350762,2326729430,2326729430,0
1361905379,2326757712,1,48,48,1361905350973,1361905350973,2326729685,2326729685,0
1361905727,2327106016,1,46,46,1361905701259,1361905701259,2327080275,2327080275,0
1361905727,2327106048,1,60,60,1361905701674,1361905701674,2327080722,2327080722,0
1361905797,2327175556,1,46,46,1361905768659,1361905768659,2327147215,2327147215,0
1361905798,2327176636,1,46,46,1361905768516,1361905768516,2327147152,2327147152,0
1361905869,2327247744,1,46,46,1361905841175,1361905841175,2327219919,2327219919,0
1361905870,2327248908,1,46,46,1361905841074,1361905841074,2327219982,2327219982,0
1361906032,2327410636,1,46,46,1361906006081,1361906006081,2327384717,2327384717,0
1361906478,2327856316,12,999,83.25,1361906461498,1361906473082,2327839814,2327851398,11584
1361906478,2327856324,12,999,83.25,1361906462129,1361906473073,2327840453,2327851397,10944
1361906478,2327856400,12,999,83.25,1361906461736,1361906473000,2327840136,2327851400,11264
1361906478,2327856452,14,4789,342.0714286,1361906460917,1361906472949,2327839369,2327851401,12032
1361906493,2327872024,11,3267,297,1361906465846,1361906466486,2327844870,2327845510,640
1361906521,2327900092,1,52,52,1361906493300,1361906493300,2327872392,2327872392,0
1361906774,2328152864,2,141,70.5,1361906773650,1361906773650,2328152514,2328152514,0
1361906799,2328177276,11,3267,297,1361906773727,1361906774303,2328152003,2328152579,576
1361906871,2328249492,2,92,46,1361906844356,1361906867460,2328222848,2328245952,23104
1361907134,2328513152,2,141,70.5,1361907131244,1361907131244,2328510396,2328510396,0
1361907159,2328537824,11,3267,297,1361907131123,1361907131699,2328509947,2328510523,576
1361907247,2328625232,37,28054,758.2162162,1361907241093,1361907242309,2328619325,2328620541,1216
1361907254,2328633116,20,12939,646.95,1361907240206,1361907251470,2328619322,2328630586,11264
1361907254,2328633120,11,5633,512.0909091,1361907240201,1361907251465,2328619321,2328630585,11264
1361907255,2328633192,15,4005,267,1361907240619,1361907252395,2328618811,2328630587,11776
1361907255,2328633192,18,5177,287.6111111,1361907240618,1361907252458,2328618810,2328630650,11840
1361907255,2328633200,23,15863,689.6956522,1361907241121,1361907252385,2328619321,2328630585,11264
1361907255,2328633216,49,52361,1068.591837,1361907241109,1361907252373,2328619325,2328630589,11264
1361907255,2328633216,13,1231,94.69230769,1361907241108,1361907252436,2328619324,2328630652,11328
1361907263,2328641196,36,21424,595.1111111,1361907240424,1361907258408,2328618620,2328636604,17984
1361907268,2328646180,16,3596,224.75,1361907241527,1361907243447,2328619707,2328621627,1920
1361907388,2328766280,2,131,65.5,1361907362640,1361907362640,2328740920,2328740920,0
1361907416,2328794188,13,1512,116.3076923,1361907389419,1361907390315,2328767607,2328768503,896
1361907420,2328798192,1,191,191,1361907393255,1361907393255,2328771447,2328771447,0
1361907463,2328841440,2,141,70.5,1361907461873,1361907461873,2328840313,2328840313,0
1361907484,2328863068,1,46,46,1361907455483,1361907455483,2328834551,2328834551,0
1361907485,2328864176,1,46,46,1361907455503,1361907455503,2328834679,2328834679,0
1361907488,2328866248,11,3267,297,1361907461422,1361907462190,2328839670,2328840438,768
1361907536,2328914728,2,131,65.5,1361907509198,1361907509198,2328887926,2328887926,0
1361907568,2328946536,1,266,266,1361907539981,1361907539981,2328918517,2328918517,0
1361907588,2328966592,1,74,74,1361907560151,1361907560151,2328938743,2328938743,0
1361907664,2329043124,1,74,74,1361907636673,1361907636673,2329015797,2329015797,0
1361907672,2329050684,2,131,65.5,1361907647352,1361907647352,2329026036,2329026036,0
1361907711,2329089624,2,141,70.5,1361907703796,1361907703796,2329082420,2329082420,0
1361907716,2329094928,7,1848,264,1361907689411,1361907711811,2329068339,2329090739,22400
1361907728,2329106796,16,3643,227.6875,1361907703687,1361907704199,2329082483,2329082995,512
1361907839,2329217780,5,314,62.8,1361907824023,1361907837847,2329202803,2329216627,13824
1361908129,2329507500,11,3267,297,1361908103083,1361908103659,2329481583,2329482159,576
1361908183,2329561996,3,193,64.33333333,1361908177145,1361908177145,2329556141,2329556141,0
1361908293,2329671912,12,6151,512.5833333,1361908265293,1361908265677,2329644205,2329644589,384
1361908293,2329671916,9,861,95.66666667,1361908265799,1361908265927,2329644715,2329644843,128
1361908293,2329671920,8,815,101.875,1361908266051,1361908266179,2329644971,2329645099,128
1361908293,2329672036,14,6617,472.6428571,1361908266192,1361908266512,2329645228,2329645548,320
1361908350,2329728432,2,92,46,1361908324713,1361908328233,2329703145,2329706665,3520
1361908518,2329896432,2,230,115,1361908492454,1361908492454,2329870886,2329870886,0
1361908536,2329914168,4,252,63,1361908528433,1361908535537,2329906601,2329913705,7104
1361908536,2329914188,3,189,63,1361908528923,1361908531931,2329907111,2329910119,3008
1361908536,2329914244,4,252,63,1361908528293,1361908535397,2329906537,2329913641,7104
1361908551,2329930160,2,126,63,1361908534993,1361908543057,2329914153,2329922217,8064
1361908570,2329948488,1,63,63,1361908543150,1361908543150,2329921638,2329921638,0
1361908570,2329948596,1,63,63,1361908543107,1361908543107,2329921703,2329921703,0
1361908584,2329962224,11,953,86.63636364,1361908569526,1361908579702,2329947750,2329957926,10176
1361908584,2329962228,12,999,83.25,1361908569907,1361908579699,2329948135,2329957927,9792
1361908584,2329962312,12,999,83.25,1361908569121,1361908579617,2329947433,2329957929,10496
1361908626,2330004688,1,63,63,1361908601447,1361908601447,2329980135,2329980135,0
1361908959,2330337400,2,92,46,1361908931394,1361908958274,2330309794,2330336674,26880
1361909340,2330718620,3,138,46,1361909315678,1361909334174,2330694298,2330712794,18496
1361909380,2330758856,1,46,46,1361909353971,1361909353971,2330732827,2330732827,0
1361910001,2331379904,1,46,46,1361909972986,1361909972986,2331351890,2331351890,0
1361910182,2331560344,1,46,46,1361910155945,1361910155945,2331534289,2331534289,0
1361910803,2332181164,1,46,46,1361910776720,1361910776720,2332154884,2332154884,0
1361911023,2332401536,1,48,48,1361910998043,1361910998043,2332376579,2332376579,0
1361911027,2332405472,1,46,46,1361910999899,1361910999899,2332378371,2332378371,0
1361911047,2332425692,1,52,52,1361911022076,1361911022076,2332400768,2332400768,0
1361911285,2332663752,1,48,48,1361911256640,1361911256640,2332635392,2332635392,0
1361911285,2332663800,1,48,48,1361911256717,1361911256717,2332635517,2332635517,0
1361911439,2332817168,1,46,46,1361911420354,1361911420354,2332798522,2332798522,0
1361911441,2332819632,1,46,46,1361911419826,1361911419826,2332798458,2332798458,0
1361911549,2332927396,1,46,46,1361911520864,1361911520864,2332899260,2332899260,0
1361911581,2332959400,3,138,46,1361911554008,1361911576344,2332932408,2332954744,22336
1361911649,2333027640,1,46,46,1361911622055,1361911622055,2333000695,2333000695,0
1361911797,2333175860,1,56,56,1361911771468,1361911771468,2333150328,2333150328,0
1361911805,2333183820,1,56,56,1361911778866,1361911778866,2333157686,2333157686,0
1361911830,2333208148,1,46,46,1361911805394,1361911805394,2333183542,2333183542,0
1361911922,2333300160,1,46,46,1361911895879,1361911895879,2333274039,2333274039,0
1361912022,2333400712,16,6335,395.9375,1361912007645,1361912020317,2333386357,2333399029,12672
1361912022,2333400740,11,953,86.63636364,1361912008385,1361912020097,2333387125,2333398837,11712
1361912022,2333400816,11,953,86.63636364,1361912007989,1361912020021,2333386805,2333398837,12032
1361912022,2333400820,12,999,83.25,1361912008561,1361912020017,2333387381,2333398837,11456
1361912038,2333416564,11,3267,297,1361912013296,1361912014000,2333391860,2333392564,704
1361912046,2333425088,2,141,70.5,1361912040035,1361912040035,2333419123,2333419123,0
1361912150,2333528976,2,104,52,1361912125587,1361912128659,2333504563,2333507635,3072
1361912158,2333536976,1,52,52,1361912130128,1361912130128,2333509104,2333509104,0
1361912275,2333653400,1,46,46,1361912250257,1361912250257,2333628657,2333628657,0
1361912347,2333725500,2,92,46,1361912322474,1361912329642,2333700974,2333708142,7168
1361912451,2333829476,1,52,52,1361912425472,1361912425472,2333803948,2333803948,0
1361912623,2334001276,12,999,83.25,1361912606280,1361912616904,2333984556,2333995180,10624
1361912623,2334001296,12,999,83.25,1361912606514,1361912616882,2333984810,2333995178,10368
1361912623,2334001380,12,999,83.25,1361912606687,1361912616799,2333985067,2333995179,10112
1361912635,2334013720,11,3267,297,1361912608778,1361912609738,2333987498,2333988458,960
1361912647,2334025704,3,193,64.33333333,1361912646427,1361912646427,2334025131,2334025131,0
1361912695,2334073936,1,46,46,1361912668081,1361912668081,2334047017,2334047017,0
1361912707,2334086136,1,46,46,1361912681195,1361912681195,2334060331,2334060331,0
1361912759,2334138096,2,92,46,1361912734223,1361912739151,2334113319,2334118247,4928
1361912768,2334146212,1,46,46,1361912742342,1361912742342,2334120554,2334120554,0
1361912893,2334271556,1,60,60,1361912889195,1361912889195,2334267751,2334267751,0
1361912895,2334273828,1,60,60,1361912890457,1361912890457,2334269285,2334269285,0
1361912896,2334274728,1,60,60,1361912892160,1361912892160,2334270888,2334270888,0
1361913373,2334751988,2,92,46,1361913347252,1361913354676,2334726240,2334733664,7424
1361913782,2335161112,1,46,46,1361913753329,1361913753329,2335132441,2335132441,0
1361913782,2335161148,1,46,46,1361913753484,1361913753484,2335132632,2335132632,0
1361913786,2335165152,1,46,46,1361913758346,1361913758346,2335137498,2335137498,0
1361913991,2335369352,1,46,46,1361913965093,1361913965093,2335343445,2335343445,0
1361914027,2335405268,1,46,46,1361914001336,1361914001336,2335379604,2335379604,0
1361914364,2335742200,2,92,46,1361914336698,1361914342970,2335714898,2335721170,6272
1361914396,2335774320,2,92,46,1361914369919,1361914374975,2335748239,2335753295,5056
1361915458,2336837072,1,46,46,1361915429824,1361915429824,2336808896,2336808896,0
1361915487,2336865984,1,48,48,1361915458326,1361915458326,2336837310,2336837310,0
1361915489,2336867500,1,48,48,1361915458811,1361915458811,2336837311,2336837311,0
1361916324,2337702800,15,6289,419.2666667,1361916308546,1361916320642,2337687346,2337699442,12096
1361916324,2337702996,12,999,83.25,1361916308734,1361916320382,2337687730,2337699378,11648
1361916324,2337703000,12,999,83.25,1361916309051,1361916320379,2337688051,2337699379,11328
1361916324,2337703004,12,999,83.25,1361916309431,1361916320375,2337688435,2337699379,10944
1361916725,2338103636,1,48,48,1361916698658,1361916698658,2338077294,2338077294,0
1361917539,2338917936,3,405,135,1361917512615,1361917518631,2338891551,2338897567,6016
1361917719,2339098116,3,408,136,1361917691635,1361917697651,2339070751,2339076767,6016
1361917984,2339362712,1,52,52,1361917957888,1361917957888,2339336600,2339336600,0
1361919504,2340882572,17,6755,397.3529412,1361919489781,1361919501557,2340868353,2340880129,11776
1361919504,2340882596,11,953,86.63636364,1361919490462,1361919501470,2340869058,2340880066,11008
1361919504,2340882600,12,999,83.25,1361919490715,1361919501467,2340869315,2340880067,10752
1361919504,2340882644,17,6896,405.6470588,1361919489391,1361919501423,2340868035,2340880067,12032
1361919504,2340882652,12,999,83.25,1361919490088,1361919501480,2340868740,2340880132,11392
1361919685,2341063884,1,48,48,1361919658493,1361919658493,2341037377,2341037377,0
1361919872,2341251096,5,2453,490.6,1361919859943,1361919871399,2341239039,2341250495,11456
1361919872,2341251096,5,2453,490.6,1361919859943,1361919871399,2341239039,2341250495,11456
1361919872,2341251124,12,999,83.25,1361919861065,1361919870601,2341240189,2341249725,9536
1361919873,2341251140,12,999,83.25,1361919863650,1361919871586,2341241790,2341249726,7936
1361919873,2341251168,16,6372,398.25,1361919860931,1361919871555,2341239099,2341249723,10624
1361919873,2341251216,11,953,86.63636364,1361919862933,1361919871509,2341241149,2341249725,8576
1361919888,2341266868,1,60,60,1361919860106,1361919860106,2341238974,2341238974,0
1361919888,2341266904,1,46,46,1361919861540,1361919861540,2341240444,2341240444,0
1361919888,2341266948,1,46,46,1361919860090,1361919860090,2341239038,2341239038,0
1361920570,2341948324,12,999,83.25,1361920555807,1361920565343,2341934131,2341943667,9536
1361920570,2341948328,11,953,86.63636364,1361920556060,1361920565340,2341934388,2341943668,9280
1361920570,2341948344,12,999,83.25,1361920556361,1361920565321,2341934705,2341943665,8960
1361920614,2341992444,1,46,46,1361920586277,1361920586277,2341964721,2341964721,0
1361920834,2342212832,11,953,86.63636364,1361920816096,1361920827808,2342194928,2342206640,11712
1361920834,2342212976,17,6418,377.5294118,1361920815568,1361920827664,2342194544,2342206640,12096
1361920834,2342212980,12,999,83.25,1361920816201,1361920827657,2342195181,2342206637,11456
1361920834,2342212984,11,953,86.63636364,1361920816454,1361920827654,2342195438,2342206638,11200
1361921491,2342869276,16,6372,398.25,1361921473473,1361921484929,2342851749,2342863205,11456
1361921491,2342869300,12,999,83.25,1361921473897,1361921484905,2342852197,2342863205,11008
1361921491,2342869348,12,999,83.25,1361921474103,1361921484855,2342852451,2342863203,10752
1361921491,2342869348,12,999,83.25,1361921474362,1361921484858,2342852710,2342863206,10496
1361921811,2343189540,12,999,83.25,1361921793909,1361921805557,2343172449,2343184097,11648
1361921811,2343189544,12,999,83.25,1361921794417,1361921805553,2343172961,2343184097,11136
1361921811,2343189632,16,6372,398.25,1361921793368,1361921805464,2343172000,2343184096,12096
1361921811,2343189640,11,953,86.63636364,1361921794065,1361921805457,2343172705,2343184097,11392
1361921825,2343203184,11,3267,297,1361921798361,1361921799001,2343176545,2343177185,640
1361922107,2343485644,2,141,70.5,1361922101255,1361922101255,2343479899,2343479899,0
1361922123,2343501796,18,6801,377.8333333,1361922103536,1361922115632,2343482332,2343494428,12096
1361922123,2343501800,12,999,83.25,1361922104426,1361922115626,2343483226,2343494426,11200
1361922123,2343501800,12,999,83.25,1361922104682,1361922115626,2343483482,2343494426,10944
1361922123,2343501848,16,6372,398.25,1361922103994,1361922115578,2343482842,2343494426,11584
1361922126,2343504128,11,3267,297,1361922101195,1361922101899,2343479323,2343480027,704
1361922299,2343677960,2,141,70.5,1361922292554,1361922292554,2343671514,2343671514,0
1361922338,2343716564,14,6280,448.5714286,1361922312470,1361922312790,2343691034,2343691354,320
1361922338,2343716572,9,861,95.66666667,1361922313422,1361922313614,2343691994,2343692186,192
1361922338,2343716652,9,861,95.66666667,1361922312830,1361922313022,2343691482,2343691674,192
1361922338,2343716656,9,861,95.66666667,1361922313082,1361922313274,2343691738,2343691930,192
1361922531,2343910092,2,126,63,1361922526147,1361922527171,2343905239,2343906263,1024
1361922540,2343918152,3,138,46,1361922532205,1361922532269,2343910357,2343910421,64
1361922540,2343918152,3,138,46,1361922532205,1361922532269,2343910357,2343910421,64
1361922559,2343937412,2,109,54.5,1361922531946,1361922531946,2343910358,2343910358,0
1361922559,2343937488,2,92,46,1361922531868,1361922531868,2343910356,2343910356,0
1361924769,2346147380,1,46,46,1361924742951,1361924742951,2346121331,2346121331,0
1361925199,2346577916,1,46,46,1361925172937,1361925172937,2346551853,2346551853,0
1361925222,2346600768,14,6021,430.0714286,1361925208222,1361925218398,2346586990,2346597166,10176
1361925226,984918672,9,7806,867.3333333,1361925208603,1361925218715,984901275,984911387,10112
1361925226,984918696,8,7207,900.875,1361925209860,1361925218692,984902556,984911388,8832
1361925230,2346608760,15,6289,419.2666667,1361925210342,1361925222374,2346589102,2346601134,12032
1361925230,2346608764,12,999,83.25,1361925210721,1361925222369,2346589485,2346601133,11648
1361925230,2346608836,12,999,83.25,1361925210968,1361925222296,2346589804,2346601132,11328
1361925230,2346608840,12,999,83.25,1361925211284,1361925222292,2346590124,2346601132,11008
1361925238,2346616188,1,46,46,1361925210976,1361925210976,2346589164,2346589164,0
1361925338,2346716544,1,46,46,1361925313467,1361925313467,2346692011,2346692011,0
1361925350,2346728944,12,999,83.25,1361925335853,1361925347245,2346714797,2346726189,11392
1361925350,2346729008,15,6289,419.2666667,1361925335084,1361925347180,2346714092,2346726188,12096
1361925350,2346729012,11,953,86.63636364,1361925335529,1361925347177,2346714541,2346726189,11648
1361925350,2346729012,11,953,86.63636364,1361925336037,1361925347109,2346715049,2346726121,11072
1361925462,2346841048,12,999,83.25,1361925445953,1361925456513,2346825001,2346835561,10560
1361925462,2346841056,11,953,86.63636364,1361925446522,1361925456506,2346825578,2346835562,9984
1361925462,2346841096,15,6289,419.2666667,1361925444434,1361925456466,2346823530,2346835562,12032
1361925462,2346841100,12,999,83.25,1361925446155,1361925456459,2346825255,2346835559,10304
1361925470,2346848684,1,46,46,1361925444975,1361925444975,2346823659,2346823659,0
1361925727,2347105404,12,999,83.25,1361925711424,1361925722880,2347089828,2347101284,11456
1361925727,2347105408,12,999,83.25,1361925711742,1361925722878,2347090150,2347101286,11136
1361925727,2347105452,12,999,83.25,1361925711120,1361925722832,2347089572,2347101284,11712
1361925727,2347105520,12,999,83.25,1361925710670,1361925722766,2347089190,2347101286,12096
1361925735,2347113532,11,3267,297,1361925707712,1361925708288,2347086244,2347086820,576
1361925739,2347117360,1,46,46,1361925710957,1361925710957,2347089317,2347089317,0
1361925919,2347298100,1,46,46,1361925892357,1361925892357,2347271457,2347271457,0
1361926023,2347401968,3,230,76.66666667,1361926021131,1361926022603,2347400099,2347401571,1472
1361926052,2347430436,3,267,89,1361926026139,1361926043867,2347404575,2347422303,17728
1361926092,2347470552,1,89,89,1361926067494,1361926067494,2347446046,2347446046,0
1361926125,2347503328,1,89,89,1361926115144,1361926115144,2347493472,2347493472,0
1361926705,2348083820,14,6617,472.6428571,1361926680276,1361926680724,2348059096,2348059544,448
1361926709,2348087784,9,861,95.66666667,1361926680888,1361926681272,2348059672,2348060056,384
1361926709,2348087904,9,861,95.66666667,1361926681215,1361926681407,2348060119,2348060311,192
1361926709,2348087908,8,815,101.875,1361926681467,1361926681659,2348060375,2348060567,192
1361926744,2348122972,3,138,46,1361926741113,1361926742137,2348120085,2348121109,1024
1361926744,2348123028,3,138,46,1361926741058,1361926742082,2348120086,2348121110,1024
1361926744,2348123028,3,138,46,1361926741057,1361926742081,2348120085,2348121109,1024
1361926760,2348139008,11,953,86.63636364,1361926745109,1361926758997,2348124117,2348138005,13888
1361926760,2348139012,12,999,83.25,1361926745425,1361926758097,2348124437,2348137109,12672
1361926760,2348139016,14,1091,77.92857143,1361926745677,1361926758989,2348124693,2348138005,13312
1361926760,2348139096,16,6672,417,1361926744572,1361926759804,2348123668,2348138900,15232
1361926768,2348146996,2,92,46,1361926760800,1361926761952,2348139796,2348140948,1152
1361926768,2348147000,2,92,46,1361926759967,1361926762015,2348138967,2348141015,2048
1361926769,2348147852,1,46,46,1361926744241,1361926744241,2348123093,2348123093,0
1361926769,2348147948,1,46,46,1361926744147,1361926744147,2348123095,2348123095,0
1361926785,2348163964,1,46,46,1361926760194,1361926760194,2348139158,2348139158,0
1361926961,2348339216,12,999,83.25,1361926947564,1361926959660,2348325780,2348337876,12096
1361926961,2348339244,11,953,86.63636364,1361926948495,1361926959631,2348326739,2348337875,11136
1361926961,2348339288,12,999,83.25,1361926947874,1361926959586,2348326162,2348337874,11712
1361926961,2348339292,12,999,83.25,1361926948192,1361926959584,2348326484,2348337876,11392
1361926978,2348356328,5,3302,660.4,1361926953273,1361926965753,2348331601,2348344081,12480
1361927006,2348384404,2,1622,811,1361926978220,1361927002732,2348356624,2348381136,24512
1361927009,2348387364,2,126,63,1361927004630,1361927005654,2348382994,2348384018,1024
1361927058,2348436512,1,48,48,1361927031808,1361927031808,2348410320,2348410320,0
1361927315,2348693328,13,6197,476.6923077,1361927289526,1361927290038,2348667854,2348668366,512
1361927315,2348693364,9,861,95.66666667,1361927290065,1361927290321,2348668429,2348668685,256
1361927315,2348693368,10,907,90.7,1361927290383,1361927291919,2348668751,2348670287,1536
1361927319,2348697320,9,861,95.66666667,1361927292157,1361927292413,2348670477,2348670733,256
1361927569,2348947960,3,189,63,1361927565371,1361927568379,2348944331,2348947339,3008
1361927585,2348963896,2,126,63,1361927582905,1361927583929,2348961801,2348962825,1024
1361927585,2348963908,2,126,63,1361927572461,1361927580461,2348951369,2348959369,8000
1361927593,2348971956,3,189,63,1361927588093,1361927591101,2348967049,2348970057,3008
1361927593,2348971964,2,126,63,1361927585910,1361927589878,2348964874,2348968842,3968
1361927609,2348987876,2,126,63,1361927595215,1361927603279,2348974091,2348982155,8064
1361927624,2349002264,1,63,63,1361927598640,1361927598640,2348976904,2348976904,0
1361927665,2349043952,3,189,63,1361927658239,1361927661247,2349037191,2349040199,3008
1361927681,2349059896,2,126,63,1361927665335,1361927673399,2349044231,2349052295,8064
1361928555,2349933120,1,48,48,1361928527986,1361928527986,2349906106,2349906106,0
1361928586,2349964440,1,46,46,1361928559857,1361928559857,2349938297,2349938297,0
1361928614,2349992548,2,122,61,1361928587332,1361928589444,2349965880,2349967992,2112
1361929227,2350605704,1,48,48,1361929201631,1361929201631,2350580335,2350580335,0
1361929494,2350872820,1,48,48,1361929463975,1361929463975,2350842795,2350842795,0
1361929609,2350988088,1,46,46,1361929583067,1361929583067,2350962155,2350962155,0
1361930286,2351664748,3,152,50.66666667,1361930260643,1361930269667,2351639391,2351648415,9024
1361930286,2351664788,3,152,50.66666667,1361930259516,1361930268540,2351638304,2351647328,9024
1361930290,2351668612,3,152,50.66666667,1361930261931,1361930270891,2351640543,2351649503,8960
1361930290,2351668704,3,152,50.66666667,1361930261775,1361930270799,2351640479,2351649503,9024
1361930836,2352214448,9,861,95.66666667,1361930811594,1361930811786,2352190042,2352190234,192
1361930836,2352214560,13,6234,479.5384615,1361930811031,1361930811351,2352189591,2352189911,320
1361930840,2352218404,8,815,101.875,1361930812211,1361930812339,2352190615,2352190743,128
1361930840,2352218512,9,861,95.66666667,1361930811783,1361930811975,2352190295,2352190487,192
1361931069,2352447160,3,172,57.33333333,1361931066725,1361931067749,2352444885,2352445909,1024
1361931069,2352447160,3,172,57.33333333,1361931066725,1361931067749,2352444885,2352445909,1024
1361931069,2352447232,3,138,46,1361931066652,1361931067676,2352444884,2352445908,1024
1361931125,2352503192,4,252,63,1361931116803,1361931123907,2352494995,2352502099,7104
1361931156,2352534780,1,63,63,1361931131320,1361931131320,2352510100,2352510100,0
1361933465,2354843272,44,56779,1290.431818,1361933457551,1361933460303,2354835823,2354838575,2752
1361933473,2354851344,4,379,94.75,1361933464905,1361933464969,2354843249,2354843313,64
1361933473,2354851344,4,378,94.5,1361933464904,1361933464968,2354843248,2354843312,64
1361933473,2354851360,28,36763,1312.964286,1361933459832,1361933471800,2354838192,2354850160,11968
1361933473,2354851384,7,2448,349.7142857,1361933465825,1361933466657,2354844209,2354845041,832
1361933473,2354851424,7,4279,611.2857143,1361933462009,1361933471993,2354840433,2354850417,9984
1361933476,993168884,18,21925,1218.055556,1361933459644,1361933470588,993152528,993163472,10944
1361933481,2354859284,19,22710,1195.263158,1361933462725,1361933474693,2354841009,2354852977,11968
1361933481,2354859292,10,907,90.7,1361933463102,1361933473214,2354841394,2354851506,10112
1361933481,2354859328,4,431,107.75,1361933466264,1361933474648,2354844592,2354852976,8384
1361933481,2354859404,12,999,83.25,1361933464206,1361933473102,2354842610,2354851506,8896
1361933481,2354859412,10,907,90.7,1361933464581,1361933473093,2354842993,2354851505,8512
1361933481,2354859420,25,14916,596.64,1361933462269,1361933476797,2354840689,2354855217,14528
1361933483,2354861324,16,6372,398.25,1361933462364,1361933473180,2354840688,2354851504,10816
1361933487,2354865480,1,46,46,1361933462271,1361933462271,2354840751,2354840751,0
1361934289,2355667980,7,2448,349.7142857,1361934281729,1361934282113,2355660709,2355661093,384
1361934337,2355715884,7,2447,349.5714286,1361934331424,1361934331616,2355710308,2355710500,192
1361934345,2355723872,23,14808,643.826087,1361934330733,1361934342573,2355709605,2355721445,11840
1361934521,2355899592,1,46,46,1361934493186,1361934493186,2355871778,2355871778,0
1361934593,2355972064,13,3408,262.1538462,1361934583849,1361934588521,2355962913,2355967585,4672
1361935487,2356866036,2,120,60,1361935459830,1361935462838,2356838866,2356841874,3008
1361935544,2356922172,1,46,46,1361935518358,1361935518358,2356896530,2356896530,0
1361935957,2357335320,12,999,83.25,1361935943419,1361935954363,2357321739,2357332683,10944
1361936350,2357728264,3,162,54,1361936323245,1361936329261,2357701509,2357707525,6016
1361936397,2357775584,12,999,83.25,1361936383531,1361936393835,2357762115,2357772419,10304
1361936397,2357775588,12,999,83.25,1361936383913,1361936393833,2357762501,2357772421,9920
1361936397,2357775588,11,953,86.63636364,1361936384168,1361936393832,2357762756,2357772420,9664
1361936410,2357788240,1,46,46,1361936384707,1361936384707,2357762947,2357762947,0
1361937197,2358576052,18,9318,517.6666667,1361937192651,1361937193099,2358571703,2358572151,448
1361937197,2358576060,16,3733,233.3125,1361937193030,1361937194758,2358572090,2358573818,1728
1361937206,2358584176,11,953,86.63636364,1361937190905,1361937200505,2358569081,2358578681,9600
1361937214,2358592140,16,6372,398.25,1361937195357,1361937206685,2358573497,2358584825,11328
1361937214,2358592216,12,999,83.25,1361937191503,1361937206543,2358569719,2358584759,15040
1361937221,2358599188,1,52,52,1361937194091,1361937194091,2358572279,2358572279,0
1361937225,2358603188,1,46,46,1361937197934,1361937197934,2358576122,2358576122,0
1361937241,2358619276,2,120,60,1361937213397,1361937216405,2358591673,2358594681,3008
1361937349,2358727616,3,162,54,1361937324095,1361937330111,2358702711,2358708727,6016
1361937642,2359020260,11,3267,297,1361937616479,1361937617247,2358994739,2358995507,768
1361937662,2359040592,3,193,64.33333333,1361937658834,1361937658834,2359037426,2359037426,0
1361937986,2359364500,11,3267,297,1361937958759,1361937959527,2359337259,2359338027,768
1361937999,2359377116,3,193,64.33333333,1361937991146,1361937991146,2359369262,2359369262,0
1361938055,2359433176,3,162,54,1361938030251,1361938036267,2359408427,2359414443,6016
1361938263,2359641400,4,190,47.5,1361938236039,1361938257031,2359614439,2359635431,20992
1361938659,2360038028,11,3267,297,1361938633999,1361938634575,2360013027,2360013603,576
1361938700,2360078092,3,162,54,1361938675575,1361938681591,2360053667,2360059683,6016
1361939017,2360395276,12,999,83.25,1361939001463,1361939012727,2360379739,2360391003,11264
1361939017,2360395284,11,953,86.63636364,1361939002095,1361939012591,2360380379,2360390875,10496
1361939017,2360395324,15,6326,421.7333333,1361939000586,1361939012682,2360378910,2360391006,12096
1361939017,2360395360,11,953,86.63636364,1361939002662,1361939012518,2360381022,2360390878,9856
1361939037,2360415144,1,89,89,1361939012410,1361939012410,2360390554,2360390554,0
1361939265,2360643752,2,141,70.5,1361939260249,1361939260249,2360639001,2360639001,0
1361939285,2360663500,11,3267,297,1361939259924,1361939260692,2360638424,2360639192,768
1361939570,2360948188,2,141,70.5,1361939563976,1361939563976,2360942164,2360942164,0
1361939589,2360967964,11,3267,297,1361939562687,1361939563775,2360941651,2360942739,1088
1361939882,2361261028,2,141,70.5,1361939879292,1361939879292,2361258320,2361258320,0
1361940211,2361589992,1,46,46,1361940186138,1361940186138,2361565130,2361565130,0
1361940732,2362110784,1,64,64,1361940705508,1361940705508,2362084292,2362084292,0
1361941590,1001282852,1,46,46,1361941563281,1361941563281,1001256133,1001256133,0
1361942784,2364162640,11,953,86.63636364,1361942767122,1361942777490,2364145762,2364156130,10368
1361942784,2364162652,12,999,83.25,1361942765384,1361942777480,2364144036,2364156132,12096
1361942784,2364162684,11,953,86.63636364,1361942766441,1361942777449,2364145125,2364156133,11008
1361942784,2364162688,11,953,86.63636364,1361942766757,1361942777445,2364145445,2364156133,10688
1361943161,2364539500,1,48,48,1361943134425,1361943134425,2364512925,2364512925,0
1361943161,2364539500,1,48,48,1361943134425,1361943134425,2364512925,2364512925,0
1361943374,2364752184,3,144,48,1361943346963,1361943355987,2364725147,2364734171,9024
1361945029,2366407604,3,405,135,1361945003542,1361945009494,2366382146,2366388098,5952
1361945912,2367290180,1,46,46,1361945885426,1361945885426,2367263606,2367263606,0
1361948486,2369864420,1,46,46,1361948461274,1361948461274,2369839694,2369839694,0
1361948582,2369960504,1,46,46,1361948553989,1361948553989,2369932493,2369932493,0
1361949476,2370854580,1,46,46,1361949450347,1361949450347,2370828927,2370828927,0
1361949774,2371152400,1,46,46,1361949747291,1361949747291,2371125691,2371125691,0
1361949775,2371153844,1,46,46,1361949746845,1361949746845,2371125689,2371125689,0
1361949937,2371315168,5,250,50,1361949911553,1361949933377,2371289721,2371311545,21824
1361949985,2371363328,1,48,48,1361949957218,1361949957218,2371335546,2371335546,0
1361950013,2371391416,1,48,48,1361949986569,1361949986569,2371364985,2371364985,0
1361950169,2371547900,1,46,46,1361950141344,1361950141344,2371520244,2371520244,0
1361950169,2371547948,1,46,46,1361950143667,1361950143667,2371522615,2371522615,0
1361950686,2372064888,6,384,64,1361950661029,1361950666469,2372039917,2372045357,5440
1361950690,2372068776,4,256,64,1361950663382,1361950666582,2372042158,2372045358,3200
1361950690,2372068780,5,320,64,1361950662224,1361950666576,2372041004,2372045356,4352
1361950690,2372068804,4,256,64,1361950663352,1361950666552,2372042156,2372045356,3200
1361951283,2372661728,1,78,78,1361951255163,1361951255163,2372633891,2372633891,0
1361951416,2372794136,1,78,78,1361951389706,1361951389706,2372767842,2372767842,0
1361951449,2372827420,1,46,46,1361951422064,1361951422064,2372800484,2372800484,0
1361951449,2372827468,1,46,46,1361951422142,1361951422142,2372800610,2372800610,0
1361951804,2373182320,1,46,46,1361951778123,1361951778123,2373156443,2373156443,0
1361952690,2374068692,1,125,125,1361952664394,1361952664394,2374043086,2374043086,0
1361952763,2374141052,1,46,46,1361952738504,1361952738504,2374116556,2374116556,0
1361953311,1013003620,3,919,306.3333333,1361953310659,1361953310723,1013003279,1013003343,64
1361953314,1013006532,5,538,107.6,1361953311772,1361953311772,1013004304,1013004304,0
1361953314,2374692668,1,64,64,1361953310938,1361953310938,2374689606,2374689606,0
1361953314,2374692712,8,3293,411.625,1361953310957,1361953312109,2374689669,2374690821,1152
1361953322,1013014548,4,971,242.75,1361953316684,1361953317132,1013009232,1013009680,448
1361953322,2374700664,8,1424,178,1361953315101,1361953315485,2374693765,2374694149,384
1361953322,2374700672,7,2326,332.2857143,1361953317142,1361953317462,2374695814,2374696134,320
1361953322,2374700708,7,1838,262.5714286,1361953316786,1361953317106,2374695494,2374695814,320
1361953322,2374700712,7,2582,368.8571429,1361953317739,1361953318059,2374696451,2374696771,320
1361953322,2374700712,7,2878,411.1428571,1361953317423,1361953317743,2374696135,2374696455,320
1361953330,1013022544,4,478,119.5,1361953326609,1361953326609,1013019153,1013019153,0
1361953330,2374708660,7,1838,262.5714286,1361953327907,1361953328227,2374706567,2374706887,320
1361953330,2374708660,7,1838,262.5714286,1361953328226,1361953328610,2374706886,2374707270,384
1361953330,2374708664,8,1890,236.25,1361953326110,1361953326494,2374704774,2374705158,384
1361953330,2374708664,7,1838,262.5714286,1361953329246,1361953329566,2374707910,2374708230,320
1361953330,2374708664,8,2021,252.625,1361953326301,1361953326621,2374704965,2374705285,320
1361953330,2374708664,11,3405,309.5454545,1361953313756,1361953328092,2374692420,2374706756,14336
1361953330,2374708664,8,2714,339.25,1361953326812,1361953327196,2374705476,2374705860,384
1361953330,2374708668,7,2334,333.4285714,1361953327193,1361953327513,2374705861,2374706181,320
1361953330,2374708692,10,2482,248.2,1361953327491,1361953327875,2374706183,2374706567,384
1361953330,2374708696,8,1890,236.25,1361953328572,1361953328892,2374707268,2374707588,320
1361953330,2374708700,7,1838,262.5714286,1361953328891,1361953329211,2374707591,2374707911,320
1361953330,2374708700,7,2646,378,1361953326457,1361953326777,2374705157,2374705477,320
1361953330,2374708704,7,1838,262.5714286,1361953329527,1361953329911,2374708231,2374708615,384
1361953338,2374716648,8,2386,298.25,1361953329967,1361953330287,2374708615,2374708935,320
1361953338,2374716648,9,2798,310.8888889,1361953330990,1361953331374,2374709638,2374710022,384
1361953338,2374716648,9,2558,284.2222222,1361953330284,1361953330604,2374708932,2374709252,320
1361953338,2374716652,9,1942,215.7777778,1361953330601,1361953330985,2374709253,2374709637,384
1361953338,2374716656,10,4818,481.8,1361953332455,1361953332903,2374711111,2374711559,448
1361953338,2374716656,8,2394,299.25,1361953332774,1361953333158,2374711430,2374711814,384
1361953338,2374716656,8,1977,247.125,1361953328229,1361953335717,2374706885,2374714373,7488
1361953338,2374716656,8,2930,366.25,1361953333156,1361953333476,2374711812,2374712132,320
1361953338,2374716660,7,1838,262.5714286,1361953333794,1361953334114,2374712454,2374712774,320
1361953338,2374716664,9,1942,215.7777778,1361953334815,1361953335199,2374713479,2374713863,384
1361953338,2374716664,10,1994,199.4,1361953335197,1361953335517,2374713861,2374714181,320
1361953338,2374716664,10,2482,248.2,1361953331356,1361953331740,2374710020,2374710404,384
1361953338,2374716668,10,1994,199.4,1361953331735,1361953332055,2374710403,2374710723,320
1361953338,2374716688,10,1994,199.4,1361953332038,1361953332422,2374710726,2374711110,384
1361953338,2374716692,8,3194,399.25,1361953333440,1361953333760,2374712132,2374712452,320
1361953338,2374716696,7,1838,262.5714286,1361953334078,1361953334462,2374712774,2374713158,384
1361953338,2374716700,8,3442,430.25,1361953334458,1361953334778,2374713158,2374713478,320
1361953346,1013038544,5,527,105.4,1361953339666,1361953339666,1013032210,1013032210,0
1361953346,2374724656,7,1401,200.1428571,1361953337574,1361953338150,2374716230,2374716806,576
1361953347,2374725636,1,108,108,1361953320057,1361953320057,2374698693,2374698693,0
1361953347,2374725640,1,108,108,1361953320182,1361953320182,2374698822,2374698822,0
1361953347,2374725680,1,108,108,1361953320076,1361953320076,2374698756,2374698756,0
1361953351,1013043720,1,52,52,1361953325601,1361953325601,1013018321,1013018321,0
1361953354,2374732652,5,1275,255,1361953335851,1361953352427,2374714503,2374731079,16576
1361953354,2374732688,11,3576,325.0909091,1361953336004,1361953351364,2374714692,2374730052,15360
1361953507,2374885840,2,122,61,1361953479532,1361953479724,2374858372,2374858564,192
1361954066,1013758632,5,527,105.4,1361954061243,1361954061307,1013753875,1013753939,64
1361954067,2375445164,444746,666808402,1499.301628,1361953339781,1361954060485,2374717945,2375438649,720704
1361954170,1013862636,4,478,119.5,1361954165752,1361954165752,1013858388,1013858388,0
1361954170,1013862644,4,478,119.5,1361954169587,1361954169651,1013862231,1013862295,64
1361954171,2375549300,2,92,46,1361954168318,1361954168382,2375546618,2375546682,64
1361954192,2375570892,1,46,46,1361954167789,1361954167789,2375546681,2375546681,0
1361954196,1013888740,1,46,46,1361954168210,1361954168210,1013860950,1013860950,0
1361954773,2376151416,1,46,46,1361954743041,1361954743041,2376121457,2376121457,0
1361954773,2376151452,1,46,46,1361954743069,1361954743069,2376121521,2376121521,0
1361954806,2376184592,1,46,46,1361954779535,1361954779535,2376158127,2376158127,0
1361954806,2376184632,1,46,46,1361954779113,1361954779113,2376157745,2376157745,0
1361956124,2377502976,2,92,46,1361956099901,1361956099901,2377478877,2377478877,0
1361956194,2377572984,1,46,46,1361956181617,1361956181617,2377560601,2377560601,0
1361956196,2377574680,1,46,46,1361956182180,1361956182180,2377560860,2377560860,0
1361956750,2378128876,1,447,447,1361956724375,1361956724375,2378103251,2378103251,0
1361956758,2378136900,1,447,447,1361956732284,1361956732284,2378111184,2378111184,0
1361956939,2378317840,1,46,46,1361956912697,1361956912697,2378291537,2378291537,0
1361957399,2378777980,3,162,54,1361957371747,1361957377699,2378750727,2378756679,5952
1361957529,2378907220,1,46,46,1361957500569,1361957500569,2378878789,2378878789,0
1361957720,2379098488,1,64,64,1361957695050,1361957695050,2379073538,2379073538,0
1361957720,2379098520,1,64,64,1361957695405,1361957695405,2379073925,2379073925,0
1361958106,2379484680,1,46,46,1361958080389,1361958080389,2379459069,2379459069,0
1361958107,2379485416,1,46,46,1361958080655,1361958080655,2379459071,2379459071,0
1361958695,2380073488,1,46,46,1361958667647,1361958667647,2380046135,2380046135,0
1361958695,2380073768,1,46,46,1361958667238,1361958667238,2380046006,2380046006,0
1361959040,2380418124,1,56,56,1361959012261,1361959012261,2380390385,2380390385,0
1361959072,2380450124,1,46,46,1361959047075,1361959047075,2380425199,2380425199,0
1361960118,2381496316,1,46,46,1361960091156,1361960091156,2381469472,2381469472,0
1361961465,2382843652,1,64,64,1361961439726,1361961439726,2382818378,2382818378,0
1361961465,2382843684,1,64,64,1361961437520,1361961437520,2382816204,2382816204,0
1361961469,2382847624,1,64,64,1361961441481,1361961441481,2382820105,2382820105,0
1361962517,2383895808,1,46,46,1361962489347,1361962489347,2383868155,2383868155,0
1361962519,2383897056,1,46,46,1361962490034,1361962490034,2383868090,2383868090,0
1361962519,2383897092,1,46,46,1361962490064,1361962490064,2383868156,2383868156,0
1361962716,2384094652,1,439,439,1361962688795,1361962688795,2384067447,2384067447,0
1361963105,2384483624,1,46,46,1361963079600,1361963079600,2384458224,2384458224,0
1361963349,2384727976,3,152,50.66666667,1361963324238,1361963333262,2384703214,2384712238,9024
1361964268,2385646860,1,46,46,1361964242550,1361964242550,2385621410,2385621410,0
1361964268,2385646900,1,46,46,1361964242571,1361964242571,2385621471,2385621471,0
1361964269,2385647436,1,46,46,1361964242971,1361964242971,2385621407,2385621407,0
1361964376,2385754416,2,104,52,1361964351537,1361964354545,2385729953,2385732961,3008
1361964380,2385758380,2,104,52,1361964352660,1361964355668,2385731040,2385734048,3008
1361964380,2385758416,2,104,52,1361964353774,1361964356782,2385732190,2385735198,3008
1361964380,2385758420,2,104,52,1361964353769,1361964356777,2385732189,2385735197,3008
1361964528,2385906840,3,162,54,1361964503430,1361964509446,2385882270,2385888286,6016
1361965019,2386397592,7,1460,208.5714286,1361965018037,1361965018677,2386396629,2386397269,640
1361965019,2386397592,6,798,133,1361965018356,1361965018676,2386396948,2386397268,320
1361965019,2386397596,32,41637,1301.15625,1361965014642,1361965015154,2386393238,2386393750,512
1361965019,2386397600,8,3492,436.5,1361965015790,1361965016878,2386394390,2386395478,1088
1361965019,2386397600,8,2004,250.5,1361965016365,1361965016557,2386394965,2386395157,192
1361965019,2386397600,10,3248,324.8,1361965017197,1361965017901,2386395797,2386396501,704
1361965019,2386397604,6,983,163.8333333,1361965017898,1361965018346,2386396502,2386396950,448
1361965019,2386397604,10,9936,993.6,1361965018600,1361965018728,2386397204,2386397332,128
1361965019,2386397604,8,2018,252.25,1361965018600,1361965018856,2386397204,2386397460,256
1361965019,2386397608,9,1913,212.5555556,1361965015204,1361965015460,2386393812,2386394068,256
1361965019,2386397632,5,1257,251.4,1361965016014,1361965016078,2386394646,2386394710,64
1361965021,1024713404,5,451,90.2,1361965015273,1361965015401,1024707677,1024707805,128
1361965021,1024713408,4,1448,362,1361965015206,1361965015270,1024707614,1024707678,64
1361965021,1024713408,5,451,90.2,1361965019301,1361965020005,1024711709,1024712413,704
1361965027,2386405592,9,1913,212.5555556,1361965019510,1361965019702,2386398102,2386398294,192
1361965027,2386405592,11,3139,285.3636364,1361965018101,1361965022069,2386396693,2386400661,3968
1361965027,2386405592,12,4967,413.9166667,1361965022643,1361965022835,2386401235,2386401427,192
1361965027,2386405596,5,609,121.8,1361965020082,1361965020466,2386398678,2386399062,384
1361965027,2386405596,5,609,121.8,1361965023154,1361965023538,2386401750,2386402134,384
1361965027,2386405600,9,1913,212.5555556,1361965024110,1361965024238,2386402710,2386402838,128
1361965027,2386405604,9,1913,212.5555556,1361965021611,1361965021739,2386400215,2386400343,128
1361965027,2386405604,5,609,121.8,1361965022122,1361965022378,2386400726,2386400982,256
1361965027,2386405632,5,609,121.8,1361965024588,1361965025036,2386403220,2386403668,448
1361965029,1024721400,5,451,90.2,1361965021228,1361965022188,1024713628,1024714588,960
1361965029,1024721404,242,358257,1480.400826,1361965025706,1361965026218,1024718110,1024718622,512
1361965029,1024721404,5,452,90.4,1361965023018,1361965023146,1024715422,1024715550,128
1361965029,1024721404,5,2109,421.8,1361965022890,1361965022954,1024715294,1024715358,64
1361965029,1024721404,4,1448,362,1361965023785,1361965023785,1024716189,1024716189,0
1361965029,1024721404,5,451,90.2,1361965024168,1361965024616,1024716572,1024717020,448
1361965037,1024729416,4,445,111.25,1361965031002,1361965031130,1024723418,1024723546,128
1361965037,1024729420,4,445,111.25,1361965031194,1361965031322,1024723614,1024723742,128
1361965041,2386419780,1,108,108,1361965014647,1361965014647,2386393427,2386393427,0
1361965041,2386419784,1,108,108,1361965014711,1361965014711,2386393495,2386393495,0
1361965041,2386419784,1,108,108,1361965014775,1361965014775,2386393559,2386393559,0
1361965165,2386543972,3,162,54,1361965140471,1361965146487,2386519443,2386525459,6016
1361965590,2386968428,3,399,133,1361965564049,1361965570065,2386942477,2386948493,6016
1361966372,2387750576,1,46,46,1361966347826,1361966347826,2387726402,2387726402,0
1361966404,2387782908,3,162,54,1361966378275,1361966384291,2387757183,2387763199,6016
1361966472,2387850856,1,46,46,1361966444633,1361966444633,2387823489,2387823489,0
1361966508,2387886936,1,64,64,1361966480904,1361966480904,2387859840,2387859840,0
1361966508,2387886936,1,64,64,1361966481414,1361966481414,2387860350,2387860350,0
1361966684,2388062552,16,6372,398.25,1361966670085,1361966682181,2388048637,2388060733,12096
1361966684,2388062556,11,953,86.63636364,1361966671230,1361966682174,2388049786,2388060730,10944
1361966684,2388062560,11,953,86.63636364,1361966670523,1361966682171,2388049083,2388060731,11648
1361966684,2388062560,12,999,83.25,1361966670779,1361966682171,2388049339,2388060731,11392
1361967086,2388464632,1,46,46,1361967061869,1361967061869,2388440501,2388440501,0
1361968879,2390257844,1,46,46,1361968853441,1361968853441,2390232285,2390232285,0
1361968895,2390273884,1,46,46,1361968869272,1361968869272,2390248156,2390248156,0
1361969004,2390382212,1,46,46,1361968979763,1361968979763,2390357975,2390357975,0
1361969080,2390458548,1,46,46,1361969054756,1361969054756,2390433304,2390433304,0
1361969422,2390800628,15,6289,419.2666667,1361969402446,1361969414542,2390781074,2390793170,12096
1361969422,2390800632,11,953,86.63636364,1361969402891,1361969414539,2390781523,2390793171,11648
1361969422,2390800668,12,999,83.25,1361969403110,1361969414502,2390781778,2390793170,11392
1361969422,2390800672,12,999,83.25,1361969403492,1361969414436,2390782164,2390793108,10944
1361969869,2391247872,1,46,46,1361969844755,1361969844755,2391223627,2391223627,0
1361969934,2391312220,1,46,46,1361969906784,1361969906784,2391285004,2391285004,0
1361969954,2391332248,1,46,46,1361969927109,1361969927109,2391305357,2391305357,0
1361971277,2392655812,2,122,61,1361971251837,1361971254269,2392630649,2392633081,2432
1361971297,2392675812,3,522,174,1361971268922,1361971274938,2392647734,2392653750,6016
1361971333,2392711912,2,122,61,1361971307926,1361971308054,2392686838,2392686966,128
1361971462,2392840088,5,320,64,1361971436235,1361971440459,2392814323,2392818547,4224
1361971462,2392840088,5,320,64,1361971436299,1361971441675,2392814387,2392819763,5376
1361971462,2392840092,5,320,64,1361971437383,1361971441735,2392815475,2392819827,4352
1361971462,2392840160,5,320,64,1361971437317,1361971441669,2392815477,2392819829,4352
1361971522,2392900956,1,46,46,1361971495144,1361971495144,2392874100,2392874100,0
1361971523,2392900992,1,46,46,1361971496172,1361971496172,2392874164,2392874164,0
1361971606,2392984392,2,122,61,1361971578585,1361971580697,2392956977,2392959089,2112
1361971778,2393156840,3,152,50.66666667,1361971752281,1361971761305,2393131121,2393140145,9024
1361972159,2393537712,2,96,48,1361972132434,1361972135442,2393511146,2393514154,3008
1361972159,2393537720,2,96,48,1361972133515,1361972136523,2393512235,2393515243,3008
1361972159,2393537752,2,96,48,1361972131243,1361972134251,2393509995,2393513003,3008
1361972159,2393537788,2,96,48,1361972133444,1361972136452,2393512232,2393515240,3008
1361972456,2393834328,3,152,50.66666667,1361972429325,1361972438285,2393807653,2393816613,8960
1361972724,2394102828,1,86,86,1361972697043,1361972697043,2394075871,2394075871,0
1361972784,2394162908,1,46,46,1361972756484,1361972756484,2394135392,2394135392,0
1361973214,2394592348,1,46,46,1361973187629,1361973187629,2394565977,2394565977,0
1361973215,2394593352,1,46,46,1361973187691,1361973187691,2394566043,2394566043,0
1361973215,2394593360,1,46,46,1361973187747,1361973187747,2394566107,2394566107,0
1361973337,2394715924,12,999,83.25,1361973323116,1361973334444,2394702040,2394713368,11328
1361973338,2394715952,15,6289,419.2666667,1361973323321,1361973335417,2394701273,2394713369,12096
1361973338,2394715952,12,999,83.25,1361973323831,1361973335415,2394701783,2394713367,11584
1361973338,2394715956,11,953,86.63636364,1361973324468,1361973335412,2394702424,2394713368,10944
1361973442,2394820588,1,46,46,1361973414652,1361973414652,2394793240,2394793240,0
1361973442,2394820660,1,46,46,1361973414705,1361973414705,2394793365,2394793365,0
1361973498,2394876408,11,953,86.63636364,1361973480429,1361973492013,2394858837,2394870421,11584
1361973498,2394876448,15,6104,406.9333333,1361973483847,1361973495943,2394862295,2394874391,12096
1361973498,2394876448,12,999,83.25,1361973480004,1361973491972,2394858452,2394870420,11968
1361973498,2394876452,11,953,86.63636364,1361973480643,1361973491971,2394859095,2394870423,11328
1361973503,1033195656,9,7809,867.6666667,1361973484005,1361973496037,1033176661,1033188693,12032
1361973503,1033195656,8,7207,900.875,1361973484005,1361973496037,1033176661,1033188693,12032
1361973630,2395008200,11,3267,297,1361973603581,1361973604349,2394981781,2394982549,768
1361974075,2395453036,3,205,68.33333333,1361974073111,1361974073623,2395451147,2395451659,512
1361975151,2396529056,1,46,46,1361975126966,1361975126966,2396505022,2396505022,0
1361975152,2396530904,1,46,46,1361975137574,1361975137574,2396516478,2396516478,0
1361975154,2396532380,1,46,46,1361975126768,1361975126768,2396505148,2396505148,0
1361975155,2396533496,1,46,46,1361975137979,1361975137979,2396516475,2396516475,0
1361975318,2396696404,12,6151,512.5833333,1361975291479,1361975291799,2396669883,2396670203,320
1361975318,2396696408,14,6758,482.7142857,1361975291091,1361975291347,2396669499,2396669755,256
1361975318,2396696412,9,861,95.66666667,1361975291855,1361975292047,2396670267,2396670459,192
1361975318,2396696412,13,2393,184.0769231,1361975292111,1361975307919,2396670523,2396686331,15808
1361975350,2396728364,1,383,383,1361975324028,1361975324028,2396702392,2396702392,0
1361975382,2396760400,1,383,383,1361975356120,1361975356120,2396734520,2396734520,0
1361975418,2396796476,1,46,46,1361975392462,1361975392462,2396770938,2396770938,0
1361975446,2396824520,1,383,383,1361975420321,1361975420321,2396798841,2396798841,0
1361975553,2396931728,2,126,63,1361975549454,1361975550414,2396928182,2396929142,960
1361975563,2396941784,2,126,63,1361975552405,1361975556437,2396931189,2396935221,4032
1361975590,2396968908,1,63,63,1361975564376,1361975564376,2396943284,2396943284,0
1361975611,2396989892,3,189,63,1361975606760,1361975609768,2396985652,2396988660,3008
1361975611,2396989936,2,126,63,1361975609087,1361975610111,2396988023,2396989047,1024
1361975619,2396997876,2,126,63,1361975612219,1361975616251,2396991095,2396995127,4032
1361975627,2397005872,2,126,63,1361975613821,1361975621885,2396992693,2397000757,8064
1361975651,2397028960,1,63,63,1361975625163,1361975625163,2397003123,2397003123,0
1361975764,2397142112,11,953,86.63636364,1361975746483,1361975758195,2397124595,2397136307,11712
1361975764,2397142112,12,999,83.25,1361975746739,1361975758195,2397124851,2397136307,11456
1361975764,2397142156,12,999,83.25,1361975746120,1361975758152,2397124276,2397136308,12032
1361975767,2397145396,12,999,83.25,1361975746710,1361975758294,2397125106,2397136690,11584
1361975843,2397221824,1,46,46,1361975817705,1361975817705,2397196529,2397196529,0
1361976257,2397634976,2,128,64,1361976230260,1361976231348,2397608236,2397609324,1088
1361976257,2397635004,2,128,64,1361976231383,1361976232407,2397609387,2397610411,1024
1361976257,2397635016,2,128,64,1361976232524,1361976233612,2397610540,2397611628,1088
1361976257,2397635084,5,320,64,1361976232521,1361976236617,2397610605,2397614701,4096
1361976309,2397687184,16,6372,398.25,1361976293989,1361976306085,2397672173,2397684269,12096
1361976309,2397687184,11,953,86.63636364,1361976294433,1361976306081,2397672617,2397684265,11648
1361976309,2397687188,12,999,83.25,1361976294751,1361976306079,2397672939,2397684267,11328
1361976309,2397687260,12,999,83.25,1361976295000,1361976306008,2397673260,2397684268,11008
1361976397,2397775396,2,128,64,1361976370573,1361976371597,2397748969,2397749993,1024
1361976397,2397775472,2,128,64,1361976371584,1361976372672,2397750056,2397751144,1088
1361976401,2397779400,2,128,64,1361976372872,1361976373960,2397751272,2397752360,1088
1361976401,2397779404,5,320,64,1361976372936,1361976376968,2397751340,2397755372,4032
1361976517,2397895684,1,46,46,1361976491500,1361976491500,2397870184,2397870184,0
1361976818,2398196308,2,122,61,1361976791968,1361976794272,2398170276,2398172580,2304
1361977181,2398559740,44,56779,1290.431818,1361977177771,1361977178027,2398556511,2398556767,256
1361977206,2398584888,9,861,95.66666667,1361977179030,1361977179350,2398557918,2398558238,320
1361977206,2398584904,9,861,95.66666667,1361977179396,1361977179652,2398558300,2398558556,256
1361977206,2398584908,9,861,95.66666667,1361977179777,1361977180033,2398558685,2398558941,256
1361977206,2398584952,14,6617,472.6428571,1361977178581,1361977178901,2398557533,2398557853,320
1361977207,2398584956,1,46,46,1361977179640,1361977179640,2398557596,2398557596,0
1361977207,2398584964,1,46,46,1361977180531,1361977180531,2398558495,2398558495,0
1361977251,2398628964,5,250,50,1361977224624,1361977246448,2398602588,2398624412,21824
1361977279,2398657196,1,46,46,1361977251016,1361977251016,2398629212,2398629212,0
1361977295,2398673228,1,48,48,1361977270505,1361977270505,2398648733,2398648733,0
1361977327,2398705472,1,48,48,1361977299636,1361977299636,2398678108,2398678108,0
1361977362,1037055328,1,46,46,1361977332831,1361977332831,1037026159,1037026159,0
1361977363,1037055348,1,46,46,1361977333874,1361977333874,1037026222,1037026222,0
1361977382,2398760000,3,189,63,1361977377994,1361977381002,2398755994,2398759002,3008
1361977390,2398767992,2,126,63,1361977388051,1361977389075,2398766043,2398767067,1024
1361977397,2398775892,2,126,63,1361977384141,1361977392205,2398763033,2398771097,8064
1361977397,2398775936,2,126,63,1361977390114,1361977394146,2398769050,2398773082,4032
1361977398,2398775956,3,189,63,1361977393655,1361977396727,2398771611,2398774683,3072
1361977414,2398791948,2,126,63,1361977400704,1361977408768,2398778652,2398786716,8064
1361977427,2398805768,1,63,63,1361977402377,1361977402377,2398781145,2398781145,0
1361977502,2398879960,3,189,63,1361977497904,1361977500976,2398875864,2398878936,3072
1361977518,2398896152,2,126,63,1361977504818,1361977512818,2398882970,2398890970,8000
1361978064,2399442544,1,46,46,1361978039202,1361978039202,2399417746,2399417746,0
1361978340,2399718920,1,46,46,1361978313636,1361978313636,2399692556,2399692556,0
1361978994,2400372724,9,861,95.66666667,1361978967709,1361978967837,2400346433,2400346561,128
1361978994,2400372800,9,861,95.66666667,1361978967316,1361978967508,2400346116,2400346308,192
1361978994,2400372808,14,6617,472.6428571,1361978966860,1361978967244,2400345668,2400346052,384
1361978994,2400372808,9,861,95.66666667,1361978967882,1361978968074,2400346690,2400346882,192
1361979183,2400561868,3,189,63,1361979179083,1361979182091,2400557951,2400560959,3008
1361979199,2400577904,2,126,63,1361979186087,1361979194151,2400564991,2400573055,8064
1361979207,2400585896,3,189,63,1361979203182,1361979206190,2400582078,2400585086,3008
1361979224,2400601952,2,126,63,1361979211168,1361979219232,2400589120,2400597184,8064
1361979234,2400612108,1,46,46,1361979205059,1361979205059,2400583167,2400583167,0
1361979248,2400626736,4,252,63,1361979240272,1361979247312,2400619008,2400626048,7040
1361979283,2400661692,1,63,63,1361979255420,1361979255420,2400634112,2400634112,0
1361979288,2400666700,4,252,63,1361979280433,1361979287473,2400659133,2400666173,7040
1361979307,2400685732,1,46,46,1361979282449,1361979282449,2400661181,2400661181,0
1361979323,2400701728,1,63,63,1361979295509,1361979295509,2400674237,2400674237,0
1361979484,2400862168,1,46,46,1361979458628,1361979458628,2400836796,2400836796,0
1361979513,2400891544,1,46,46,1361979484170,1361979484170,2400862714,2400862714,0
1361979514,2400892828,1,46,46,1361979483887,1361979483887,2400862715,2400862715,0
1361979905,2401283760,12,999,83.25,1361979893997,1361979904237,2401272757,2401282997,10240
1361979905,2401283804,16,6372,398.25,1361979893505,1361979904193,2401272309,2401282997,10688
1361979905,2401283828,11,953,86.63636364,1361979894186,1361979904170,2401273014,2401282998,9984
1361979905,2401283828,12,999,83.25,1361979894440,1361979904168,2401273268,2401282996,9728
1361981715,2403093604,16,6372,398.25,1361981699372,1361981709164,2403077976,2403087768,9792
1361981715,2403093608,12,999,83.25,1361981699754,1361981709162,2403078362,2403087770,9408
1361981715,2403093612,12,999,83.25,1361981700071,1361981709159,2403078683,2403087771,9088
1361981715,2403093612,12,999,83.25,1361981700325,1361981709093,2403078937,2403087705,8768
1361981912,2403289984,2,96,48,1361981884311,1361981887255,2403262295,2403265239,2944
1361982084,2403462776,2,128,64,1361982059005,1361982060093,2403437781,2403438869,1088
1361982604,2403982704,12,999,83.25,1361982591677,1361982603773,2403970381,2403982477,12096
1361982604,2403982704,11,953,86.63636364,1361982591932,1361982603772,2403970636,2403982476,11840
1361982604,2403982708,12,999,83.25,1361982592182,1361982603766,2403970890,2403982474,11584
1361982604,2403982708,11,953,86.63636364,1361982592441,1361982603769,2403971149,2403982477,11328
1361982899,2404277652,1,46,46,1361982871660,1361982871660,2404250312,2404250312,0
1361983461,2404839368,15,6289,419.2666667,1361983441279,1361983453375,2404819647,2404831743,12096
1361983461,2404839372,12,999,83.25,1361983442043,1361983453371,2404820415,2404831743,11328
1361983461,2404839372,11,953,86.63636364,1361983442297,1361983453369,2404820669,2404831741,11072
1361983461,2404839428,12,999,83.25,1361983441669,1361983453317,2404820097,2404831745,11648
1361983501,2404878920,1,48,48,1361983475645,1361983475645,2404853565,2404853565,0
1361983597,2404975436,5,2409,481.8,1361983582778,1361983594170,2404961214,2404972606,11392
1361983597,2404975508,5,2408,481.6,1361983582705,1361983594161,2404961213,2404972669,11456
1361983605,2404983428,13,1045,80.38461538,1361983587071,1361983598975,2404965499,2404977403,11904
1361983605,2404983472,15,6289,419.2666667,1361983585942,1361983598038,2404964414,2404976510,12096
1361983605,2404983476,11,953,86.63636364,1361983586385,1361983598033,2404964861,2404976509,11648
1361983605,2404983476,12,999,83.25,1361983586640,1361983598032,2404965116,2404976508,11392
1361983608,2404986088,1,60,60,1361983583060,1361983583060,2404961148,2404961148,0
1361983608,2404986168,1,60,60,1361983582980,1361983582980,2404961148,2404961148,0
1361983609,1043301424,19,21978,1156.736842,1361983593614,1361983605646,1043286038,1043298070,12032
1361983609,1043301448,18,21926,1218.111111,1361983593718,1361983605558,1043286166,1043298006,11840
1361983613,2404991456,22,17383,790.1363636,1361983594277,1361983605285,2404972733,2404983741,11008
1361983661,2405039456,2,92,46,1361983660197,1361983660261,2405038653,2405038717,64
1361983677,2405055416,11,953,86.63636364,1361983660298,1361983671498,2405038714,2405049914,11200
1361983677,2405055464,11,953,86.63636364,1361983659357,1361983671453,2405037821,2405049917,12096
1361983677,2405055464,12,999,83.25,1361983659677,1361983671453,2405038141,2405049917,11776
1361983677,2405055468,11,953,86.63636364,1361983659929,1361983671449,2405038397,2405049917,11520
1361984614,2405992512,11,953,86.63636364,1361984600287,1361984609055,2405978799,2405987567,8768
1361985280,2406658044,1,60,60,1361985251943,1361985251943,2406629987,2406629987,0
1361985935,2407313368,12,999,83.25,1361985920027,1361985928923,2407298395,2407307291,8896
1361985935,2407313420,16,6372,398.25,1361985919270,1361985928870,2407297690,2407307290,9600
1361985935,2407313424,12,999,83.25,1361985919712,1361985928864,2407298136,2407307288,9152
1361985935,2407313452,11,953,86.63636364,1361985920261,1361985928773,2407298713,2407307225,8512
1361986021,2407399536,1,48,48,1361985995954,1361985995954,2407374490,2407374490,0
1361986514,2407892268,1,46,46,1361986488243,1361986488243,2407866511,2407866511,0
1361987035,2408413400,1,46,46,1361987007594,1361987007594,2408385994,2408385994,0
1361987729,2409107156,12,999,83.25,1361987714065,1361987724433,2409092221,2409102589,10368
1361987729,2409107160,12,999,83.25,1361987714320,1361987724432,2409092480,2409102592,10112
1361988145,2409523680,10,3717,371.7,1361988130111,1361988142079,2409508791,2409520759,11968
1361988145,2409523684,15,6289,419.2666667,1361988130428,1361988143292,2409509112,2409521976,12864
1361988145,2409523712,12,999,83.25,1361988131231,1361988143263,2409509943,2409521975,12032
1361988145,2409523716,12,999,83.25,1361988131613,1361988143261,2409510329,2409521977,11648
1361988145,2409523788,16,6335,395.9375,1361988126866,1361988137170,2409505654,2409515958,10304
1361988145,2409523800,6,4775,795.8333333,1361988127814,1361988137862,2409506614,2409516662,10048
1361988145,1047838288,18,21926,1218.111111,1361988130185,1361988141897,1047823473,1047835185,11712
1361988154,2409532028,5,712,142.4,1361988127563,1361988148171,2409505591,2409526199,20608
1361988154,2409532032,6,3541,590.1666667,1361988127753,1361988148169,2409505785,2409526201,20416
1361988154,2409532036,12,5140,428.3333333,1361988128580,1361988148164,2409506616,2409526200,19584
1361988154,2409532200,13,3309,254.5384615,1361988128480,1361988148000,2409506680,2409526200,19520
1361988154,2409532200,3,397,132.3333333,1361988128479,1361988147999,2409506679,2409526199,19520
1361988154,2409532200,15,4911,327.4,1361988128479,1361988147999,2409506679,2409526199,19520
1361988154,2409532200,5,2060,412,1361988128671,1361988147999,2409506871,2409526199,19328
1361989240,2410618260,1,56,56,1361989214996,1361989214996,2410593256,2410593256,0
1361989949,2411327168,9,861,95.66666667,1361989923811,1361989924003,2411301979,2411302171,192
1361989949,2411327216,14,6757,482.6428571,1361989922806,1361989923062,2411301022,2411301278,256
1361989949,2411327224,14,6617,472.6428571,1361989923117,1361989923437,2411301341,2411301661,320
1361989949,2411327240,9,861,95.66666667,1361989923484,1361989923676,2411301724,2411301916,192
1361989949,2411327252,8,815,101.875,1361989923983,1361989924175,2411302235,2411302427,192
1361990155,2411533284,3,189,63,1361990148654,1361990151662,2411526938,2411529946,3008
1361990171,2411549148,2,126,63,1361990155764,1361990163828,2411533912,2411541976,8064
1361990187,2411565216,3,189,63,1361990183410,1361990186418,2411561626,2411564634,3008
1361990203,2411581160,2,126,63,1361990190503,1361990198567,2411568663,2411576727,8064
1361990227,2411605352,4,252,63,1361990218791,1361990225831,2411597143,2411604183,7040
1361990227,2411605352,4,252,63,1361990218791,1361990225831,2411597143,2411604183,7040
1361990261,2411639780,1,63,63,1361990233469,1361990233469,2411612249,2411612249,0
1361990261,2411639780,1,63,63,1361990233469,1361990233469,2411612249,2411612249,0
1361990267,2411645408,4,252,63,1361990258030,1361990265070,2411636438,2411643478,7040
1361990297,2411675784,1,63,63,1361990272761,1361990272761,2411651545,2411651545,0
1361991516,2412894728,1,48,48,1361991489949,1361991489949,2412868677,2412868677,0
1361991569,2412947208,1,46,46,1361991541349,1361991541349,2412919557,2412919557,0
1361991716,2413094556,1,46,46,1361991688774,1361991688774,2413067330,2413067330,0
1361991724,2413102812,17,6755,397.3529412,1361991713540,1361991723844,2413092352,2413102656,10304
1361991724,2413102832,12,999,83.25,1361991713968,1361991723824,2413092800,2413102656,9856
1361991725,2413102916,12,999,83.25,1361991715207,1361991724743,2413093123,2413102659,9536
1361991725,2413102924,11,953,86.63636364,1361991715453,1361991724669,2413093377,2413102593,9216
1361992406,2413784332,2,96,48,1361992380253,1361992389341,2413758585,2413767673,9088
1361992498,2413876888,1,52,52,1361992472238,1361992472238,2413851126,2413851126,0
1361992767,2414145588,3,144,48,1361992741847,1361992753559,2414120435,2414132147,11712
1361993425,2414803536,9,861,95.66666667,1361993398526,1361993398718,2414777062,2414777254,192
1361993425,2414803536,9,861,95.66666667,1361993398783,1361993398975,2414777319,2414777511,192
1361993425,2414803540,8,815,101.875,1361993399036,1361993399228,2414777576,2414777768,192
1361993614,2414992520,3,138,46,1361993613196,1361993613260,2414991716,2414991780,64
1361993614,2414992524,3,138,46,1361993613192,1361993613320,2414991716,2414991844,128
1361993637,2415015872,2,109,54.5,1361993612525,1361993612845,2414991397,2414991717,320
1361993641,2415019740,9,861,95.66666667,1361993614063,1361993614255,2414992803,2414992995,192
1361993641,2415019748,9,861,95.66666667,1361993614311,1361993614503,2414993059,2414993251,192
1361993641,2415019772,8,815,101.875,1361993614610,1361993614802,2414993382,2414993574,192
1361993641,2415019820,14,6617,472.6428571,1361993613602,1361993613922,2414992422,2414992742,320
1361993935,2415312924,4,252,63,1361993926750,1361993933854,2415304674,2415311778,7104
1361993935,2415312924,3,189,63,1361993930973,1361993933981,2415308897,2415311905,3008
1361993935,2415313000,3,189,63,1361993930896,1361993933968,2415308896,2415311968,3072
1361993951,2415329044,2,126,63,1361993937891,1361993945955,2415315935,2415323999,8064
1361993951,2415329044,2,126,63,1361993937955,1361993945955,2415315999,2415323999,8000
1361993966,2415344824,1,63,63,1361993940953,1361993940953,2415319777,2415319777,0
1361994039,2415417444,3,189,63,1361994033043,1361994036115,2415411487,2415414559,3072
1361994055,2415433548,2,126,63,1361994040040,1361994048040,2415418588,2415426588,8000
1361994261,1053953568,1,77,77,1361994235908,1361994235908,1053928476,1053928476,0
1361994265,1053957572,1,58,58,1361994236926,1361994236926,1053929498,1053929498,0
1361994977,2416355404,1,71,71,1361994950701,1361994950701,2416329105,2416329105,0
1361995200,2416578728,12,999,83.25,1361995189412,1361995198884,2416568140,2416577612,9472
1361995200,2416578736,12,999,83.25,1361995189727,1361995198879,2416568463,2416577615,9152
1361995200,2416578740,12,999,83.25,1361995190041,1361995198809,2416568781,2416577549,8768
1361995200,2416578804,14,4789,342.0714286,1361995188826,1361995198810,2416567630,2416577614,9984
1361995394,2416772028,9,861,95.66666667,1361995369182,1361995369374,2416747210,2416747402,192
1361995394,2416772064,8,815,101.875,1361995369659,1361995369979,2416747723,2416748043,320
1361995394,2416772108,9,861,95.66666667,1361995368845,1361995369037,2416746953,2416747145,192
1361995394,2416772144,9,861,95.66666667,1361995369323,1361995369515,2416747467,2416747659,192
1361995569,2416947192,4,252,63,1361995560632,1361995567736,2416938824,2416945928,7104
1361995593,2416971376,4,252,63,1361995584063,1361995591167,2416962439,2416969543,7104
1361995603,2416980996,1,63,63,1361995575933,1361995575933,2416953929,2416953929,0
1361995627,2417004984,1,63,63,1361995599559,1361995599559,2416977543,2416977543,0
1361995745,2417123664,4,252,63,1361995736220,1361995743260,2417114884,2417121924,7040
1361995745,2417123664,4,252,63,1361995736220,1361995743260,2417114884,2417121924,7040
1361995779,2417157428,1,63,63,1361995751559,1361995751559,2417129987,2417129987,0
1361995779,2417157520,1,63,63,1361995751469,1361995751469,2417129989,2417129989,0
1361996016,2417393932,1,46,46,1361995988468,1361995988468,2417366400,2417366400,0
1361996260,2417638552,1,46,46,1361996234565,1361996234565,2417613117,2417613117,0
1361996280,2417658404,14,6617,472.6428571,1361996253850,1361996254170,2417632254,2417632574,320
1361996280,2417658412,9,861,95.66666667,1361996254227,1361996254483,2417632639,2417632895,256
1361996280,2417658520,8,815,101.875,1361996254438,1361996254822,2417632958,2417633342,384
1361996548,2417926860,9,861,95.66666667,1361996523406,1361996523534,2417902266,2417902394,128
1361996549,2417926976,8,815,101.875,1361996524546,1361996524738,2417902522,2417902714,192
1361996552,2417930728,9,861,95.66666667,1361996524369,1361996524561,2417903097,2417903289,192
1361996552,2417930812,9,861,95.66666667,1361996523965,1361996524157,2417902777,2417902969,192
1361996586,2417964428,3,189,63,1361996580733,1361996583741,2417959161,2417962169,3008
1361996586,2417964508,3,189,63,1361996580716,1361996583724,2417959224,2417962232,3008
1361996586,2417964592,2,126,63,1361996584280,1361996585304,2417962872,2417963896,1024
1361996594,2417972456,2,126,63,1361996587425,1361996591457,2417965881,2417969913,4032
1361996602,2417980624,2,126,63,1361996587576,1361996595640,2417966200,2417974264,8064
1361996602,2417980624,2,126,63,1361996587639,1361996595703,2417966263,2417974327,8064
1361996625,2418003364,1,63,63,1361996599611,1361996599611,2417977975,2417977975,0
1361996754,2418132628,2,126,63,1361996751474,1361996752498,2418130102,2418131126,1024
1361996762,2418140488,2,126,63,1361996754686,1361996758718,2418133174,2418137206,4032
1361996786,2418164620,3,189,63,1361996782395,1361996785467,2418161015,2418164087,3072
1361996793,2418171608,1,63,63,1361996766663,1361996766663,2418145271,2418145271,0
1361996802,2418180508,2,126,63,1361996789611,1361996797611,2418168119,2418176119,8000
1361996842,2418220812,3,189,63,1361996835897,1361996838969,2418214709,2418217781,3072
1361996858,2418236728,2,126,63,1361996843082,1361996851146,2418221810,2418229874,8064
1361996930,2418308836,3,189,63,1361996923809,1361996926881,2418302645,2418305717,3072
1361996946,2418324808,2,126,63,1361996930939,1361996938939,2418309747,2418317747,8000
1361997683,2419060948,1,48,48,1361997654346,1361997654346,2419032294,2419032294,0
1361997852,2419230856,2,94,47,1361997851132,1361997851324,2419229988,2419230180,192
1361997880,2419258488,1,48,48,1361997852141,1361997852141,2419230629,2419230629,0
1361998072,2419450716,14,6617,472.6428571,1361998043976,1361998044296,2419422692,2419423012,320
1361998072,2419450724,9,861,95.66666667,1361998044349,1361998044541,2419423073,2419423265,192
1361998072,2419450724,8,815,101.875,1361998044861,1361998045053,2419423585,2419423777,192
1361998072,2419450836,8,815,101.875,1361998044494,1361998044686,2419423330,2419423522,192
1361998269,2419647728,3,189,63,1361998262262,1361998265270,2419640990,2419643998,3008
1361998269,2419647728,3,189,63,1361998262390,1361998265398,2419641118,2419644126,3008
1361998285,2419663592,2,126,63,1361998269565,1361998277629,2419648157,2419656221,8064
1361998285,2419663672,2,126,63,1361998269358,1361998277422,2419648030,2419656094,8064
1361998366,2419743900,3,189,63,1361998361394,1361998364466,2419739294,2419742366,3072
1361998366,2419743900,3,189,63,1361998361458,1361998364466,2419739358,2419742366,3008
1361998381,2419759824,2,126,63,1361998367509,1361998375573,2419746333,2419754397,8064
1361998382,2419759904,2,126,63,1361998368494,1361998376558,2419746398,2419754462,8064
1361998477,2419855588,1,46,46,1361998451584,1361998451584,2419830172,2419830172,0
1361998553,2419931820,1,46,46,1361998527446,1361998527446,2419906266,2419906266,0
1361998602,2419979900,1,48,48,1361998577071,1361998577071,2419954971,2419954971,0
1361999847,2421225780,11,953,86.63636364,1361999833325,1361999844525,2421212105,2421223305,11200
1361999847,2421225848,12,999,83.25,1361999832741,1361999844453,2421211589,2421223301,11712
1361999847,2421225852,11,953,86.63636364,1361999832993,1361999844449,2421211845,2421223301,11456
1361999848,2421225888,17,6755,397.3529412,1361999833320,1361999845416,2421211208,2421223304,12096
1362000168,2421546268,3,156,52,1362000166182,1362000166886,2421544450,2421545154,704
1362000176,2421554256,3,156,52,1362000167857,1362000173553,2421546113,2421551809,5696
1362000192,2421570244,2,104,52,1362000181117,1362000191101,2421559361,2421569345,9984
1362000226,2421604288,1,52,52,1362000201041,1362000201041,2421579329,2421579329,0
1362000440,2421818348,3,156,52,1362000438737,1362000439441,2421817085,2421817789,704
1362000440,2421818356,2,104,52,1362000439052,1362000439372,2421817408,2421817728,320
1362000448,2421826424,3,156,52,1362000440008,1362000444040,2421818432,2421822464,4032
1362000448,2421826428,3,156,52,1362000440386,1362000446210,2421818814,2421824638,5824
1362000464,2421842440,5,260,52,1362000458358,1362000461942,2421836798,2421840382,3584
1362000464,2421842488,2,104,52,1362000449415,1362000459463,2421827903,2421837951,10048
1362000472,2421850340,5,260,52,1362000466329,1362000469913,2421844669,2421848253,3584
1362000472,2421850344,5,260,52,1362000466456,1362000469976,2421844800,2421848320,3520
1362000472,2421850352,5,260,52,1362000466896,1362000470480,2421845248,2421848832,3584
1362000472,2421850416,5,260,52,1362000466189,1362000469837,2421844605,2421848253,3648
1362000472,2421850496,2,104,52,1362000453887,1362000463871,2421832383,2421842367,9984
1362000480,2421858396,2,104,52,1362000465760,1362000473312,2421844156,2421851708,7552
1362000480,2421858432,2,104,52,1362000469504,1362000479488,2421847936,2421857920,9984
1362000488,2421866380,2,104,52,1362000474225,1362000481777,2421852605,2421860157,7552
1362000488,2421866428,2,104,52,1362000473601,1362000481153,2421852029,2421859581,7552
1362000488,2421866428,2,104,52,1362000473665,1362000481345,2421852093,2421859773,7680
1362000488,2421866520,2,104,52,1362000473509,1362000481125,2421852029,2421859645,7616
1362000496,2421874500,2,104,52,1362000483195,1362000493179,2421861695,2421871679,9984
1362000498,2421876800,1,52,52,1362000473612,1362000473612,2421852412,2421852412,0
1362000504,2421882396,2,104,52,1362000491168,1362000501152,2421869564,2421879548,9984
1362000504,2421882500,2,104,52,1362000491130,1362000501114,2421869630,2421879614,9984
1362000504,2421882500,2,104,52,1362000491256,1362000501240,2421869756,2421879740,9984
1362000504,2421882508,2,104,52,1362000491633,1362000501617,2421870141,2421880125,9984
1362000546,2421924860,5,430,86,1362000518096,1362000533136,2421896956,2421911996,15040
1362000546,2421924864,5,430,86,1362000518027,1362000533067,2421896891,2421911931,15040
1362000547,2421924888,5,430,86,1362000519326,1362000534366,2421897214,2421912254,15040
1362000547,2421924896,5,430,86,1362000519447,1362000534487,2421897343,2421912383,15040
1362000567,2421944952,1,48,48,1362000542620,1362000542620,2421920572,2421920572,0
1362000575,2421952888,1,86,86,1362000550044,1362000550044,2421927932,2421927932,0
1362000575,2421952896,1,86,86,1362000550420,1362000550420,2421928316,2421928316,0
1362000575,2421953008,1,86,86,1362000549989,1362000549989,2421927997,2421927997,0
1362000575,2421953008,1,86,86,1362000550372,1362000550372,2421928380,2421928380,0
1362000607,2421985188,1,86,86,1362000581806,1362000581806,2421959994,2421959994,0
1362000607,2421985192,1,86,86,1362000581803,1362000581803,2421959995,2421959995,0
1362000607,2421985196,1,86,86,1362000582183,1362000582183,2421960379,2421960379,0
1362000607,2421985348,1,86,86,1362000581966,1362000581966,2421960314,2421960314,0
1362000671,2422049196,1,86,86,1362000645800,1362000645800,2422023996,2422023996,0
1362000671,2422049200,1,86,86,1362000646113,1362000646113,2422024313,2422024313,0
1362000671,2422049284,1,86,86,1362000645710,1362000645710,2422023994,2422023994,0
1362000671,2422049292,1,86,86,1362000646089,1362000646089,2422024381,2422024381,0
1362000747,2422125632,13,6234,479.5384615,1362000722611,1362000722931,2422101243,2422101563,320
1362000751,2422129544,8,815,101.875,1362000723337,1362000723529,2422101881,2422102073,192
1362000751,2422129664,9,861,95.66666667,1362000722963,1362000723155,2422101627,2422101819,192
1362000751,2422129668,9,861,95.66666667,1362000723532,1362000723788,2422102200,2422102456,256
1362000987,2422365724,10,1000,100,1362000982931,1362000983699,2422361655,2422362423,768
1362001012,2422389904,5,1224,244.8,1362000987332,1362000987460,2422365236,2422365364,128
1362001012,2422389952,7,825,117.8571429,1362000984533,1362000984661,2422362485,2422362613,128
1362001012,2422390020,4,821,205.25,1362000987028,1362000987220,2422365048,2422365240,192
1362001016,2422393880,20,4747,237.35,1362000990622,1362000991454,2422368502,2422369334,832
1362001016,2422393956,8,906,113.25,1362000989138,1362000989266,2422367094,2422367222,128
1362001016,2422393996,8,3362,420.25,1362000990953,1362000992489,2422368949,2422370485,1536
1362001020,2422398024,4,942,235.5,1362000995278,1362000995342,2422373302,2422373366,64
1362001024,2422402000,4,1185,296.25,1362000996645,1362000996709,2422374645,2422374709,64
1362001032,2422410764,4,252,63,1362001022955,1362001030059,2422401719,2422408823,7104
1362001032,2422410764,4,252,63,1362001023019,1362001030059,2422401783,2422408823,7040
1362001049,2422426900,3,138,46,1362001047371,1362001048779,2422425271,2422426679,1408
1362001057,2422434976,2,92,46,1362001050623,1362001054463,2422428599,2422432439,3840
1362001064,2422441956,1,63,63,1362001038929,1362001038929,2422416885,2422416885,0
1362001064,2422442072,1,63,63,1362001038812,1362001038812,2422416884,2422416884,0
1362001073,2422450880,4,252,63,1362001064669,1362001071709,2422442549,2422449589,7040
1362001080,2422457980,7,539,77,1362001055033,1362001070329,2422433013,2422448309,15296
1362001081,2422458920,2,92,46,1362001062259,1362001077683,2422440179,2422455603,15424
1362001104,2422481972,1,63,63,1362001079681,1362001079681,2422457653,2422457653,0
1362001113,2422491020,4,184,46,1362001107279,1362001109967,2422485299,2422487987,2688
1362001121,2422498992,2,92,46,1362001113070,1362001119214,2422491062,2422497206,6144
1362001136,2422514052,1,46,46,1362001108398,1362001108398,2422486450,2422486450,0
1362001145,2422523076,4,252,63,1362001137110,1362001144214,2422515186,2422522290,7104
1362001156,2422534152,1,46,46,1362001131337,1362001131337,2422509489,2422509489,0
1362001180,2422557976,1,63,63,1362001152316,1362001152316,2422530292,2422530292,0
1362001184,2422562072,1,46,46,1362001155995,1362001155995,2422534067,2422534067,0
1362001225,2422603144,4,329,82.25,1362001224468,1362001224724,2422602612,2422602868,256
1362001232,2422610160,1,46,46,1362001204996,1362001204996,2422583156,2422583156,0
1362001233,2422611076,6,531,88.5,1362001229140,1362001231316,2422607216,2422609392,2176
1362001252,2422630496,6,606,101,1362001224884,1362001249844,2422603380,2422628340,24960
1362001260,2422638412,1,101,101,1362001233477,1362001233477,2422611889,2422611889,0
1362001288,2422666380,1,101,101,1362001259940,1362001259940,2422638320,2422638320,0
1362001303,1060995776,10950,16380980,1495.979909,1362000992417,1362001003041,1060685193,1060695817,10624
1362001425,2422803716,249,283672,1139.24498,1362000987413,1362001124757,2422366129,2422503473,137344
1362001508,1061201220,4,184,46,1362001502568,1362001504168,1061195788,1061197388,1600
1362001517,2422895328,7,508,72.57142857,1362001491924,1362001506260,2422870252,2422884588,14336
1362001549,2422927344,1,77,77,1362001521092,1362001521092,2422899436,2422899436,0
1362001577,2422955292,1,77,77,1362001550778,1362001550778,2422929070,2422929070,0
1362001806,2423183916,1,56,56,1362001779312,1362001779312,2423157228,2423157228,0
1362001962,2423340716,6,497,82.83333333,1362001954698,1362001958410,2423333414,2423337126,3712
1362001990,2423368440,3,267,89,1362001962657,1362001986465,2423341097,2423364905,23808
1362002046,2423424364,1,89,89,1362002018281,1362002018281,2423396645,2423396645,0
1362002118,2423496568,1,46,46,1362002090590,1362002090590,2423469158,2423469158,0
1362002287,2423664860,1,48,48,1362002261279,1362002261279,2423639139,2423639139,0
1362002539,2423917508,8,815,101.875,1362002512595,1362002512787,2423891103,2423891295,192
1362002539,2423917512,9,861,95.66666667,1362002513165,1362002513293,2423891677,2423891805,128
1362002539,2423917596,13,6234,479.5384615,1362002512057,1362002512441,2423890653,2423891037,384
1362002539,2423917628,9,861,95.66666667,1362002512730,1362002512922,2423891358,2423891550,192
1362002756,2424134828,4,252,63,1362002748559,1362002755599,2424127387,2424134427,7040
1362002757,2424134912,4,252,63,1362002749476,1362002756516,2424127388,2424134428,7040
1362002783,2424160940,1,46,46,1362002754569,1362002754569,2424132509,2424132509,0
1362002783,2424160976,1,46,46,1362002754594,1362002754594,2424132570,2424132570,0
1362002783,2424161812,4,252,63,1362002771806,1362002778846,2424150618,2424157658,7040
1362002792,2424170072,1,63,63,1362002764419,1362002764419,2424142491,2424142491,0
1362002792,2424170076,1,63,63,1362002764416,1362002764416,2424142492,2424142492,0
1362002812,2424190140,1,63,63,1362002787583,1362002787583,2424165723,2424165723,0
1362002845,2424223264,4,252,63,1362002836482,1362002843522,2424214746,2424221786,7040
1362002876,2424254168,1,63,63,1362002851680,1362002851680,2424229848,2424229848,0
1362002965,2424343272,6,497,82.83333333,1362002957753,1362002961465,2424336025,2424339737,3712
1362002981,2424359268,2,178,89,1362002965435,1362002973371,2424343703,2424351639,7936
1362003016,2424394280,1,89,89,1362002989230,1362002989230,2424367510,2424367510,0
1362003048,2424426444,1,89,89,1362003020812,1362003020812,2424399256,2424399256,0
1362003537,2424915772,1,46,46,1362003511994,1362003511994,2424890766,2424890766,0
1362003590,2424967944,2,96,48,1362003563445,1362003566389,2424941389,2424944333,2944
1362003726,2425104724,5,861,172.2,1362003721769,1362003722153,2425100493,2425100877,384
1362003742,2425120620,6,3112,518.6666667,1362003730513,1362003735569,2425109133,2425114189,5056
1362003749,1063441920,43,44082,1025.162791,1362003730847,1362003747871,1063423767,1063440791,17024
1362003758,2425136708,4,1145,286.25,1362003751863,1362003756919,2425130571,2425135627,5056
1362003774,2425152444,1,52,52,1362003749632,1362003749632,2425128076,2425128076,0
1362003774,1063467072,1,52,52,1362003749448,1362003749448,1063442520,1063442520,0
1362003782,2425160648,5,478,95.6,1362003778228,1362003778356,2425156876,2425157004,128
1362003782,2425160652,5,478,95.6,1362003778352,1362003778544,2425157004,2425157196,192
1362003782,2425160652,9,2198,244.2222222,1362003778352,1362003778992,2425157004,2425157644,640
1362003782,2425160696,5,715,143,1362003780549,1362003781637,2425159245,2425160333,1088
1362003782,2425160812,9,5031,559,1362003773906,1362003778962,2425152718,2425157774,5056
1362003782,2425160816,5,478,95.6,1362003778061,1362003778189,2425156877,2425157005,128
1362003782,2425160816,5,478,95.6,1362003778061,1362003778253,2425156877,2425157069,192
1362003782,2425160816,5,478,95.6,1362003778061,1362003778189,2425156877,2425157005,128
1362003782,2425160816,5,478,95.6,1362003778061,1362003778253,2425156877,2425157069,192
1362003782,2425160816,5,478,95.6,1362003778061,1362003778253,2425156877,2425157069,192
1362003782,2425160816,5,478,95.6,1362003778187,1362003778379,2425157003,2425157195,192
1362003782,2425160848,5,594,118.8,1362003778861,1362003778925,2425157709,2425157773,64
1362003782,2425160860,15,16542,1102.8,1362003772192,1362003777248,2425151052,2425156108,5056
1362003783,2425160864,2,112,56,1362003773314,1362003778114,2425151178,2425155978,4800
1362003789,1063481976,16029,24032063,1499.286481,1362003732968,1362003788840,1063425944,1063481816,55872
1362003790,2425168640,4,917,229.25,1362003773691,1362003782523,2425152331,2425161163,8832
1362003790,2425168644,62,82867,1336.564516,1362003778040,1362003782904,2425156684,2425161548,4864
1362003790,2425168648,39,51123,1310.846154,1362003778165,1362003782517,2425156813,2425161165,4352
1362003790,2425168692,5,788,157.6,1362003780488,1362003785544,2425159180,2425164236,5056
1362003790,2425168696,4,916,229,1362003773634,1362003784706,2425152330,2425163402,11072
1362003790,2425168724,104,139835,1344.567308,1362003778089,1362003782697,2425156813,2425161421,4608
1362003790,2425168724,12,10282,856.8333333,1362003778089,1362003782249,2425156813,2425160973,4160
1362003790,2425168724,34,43456,1278.117647,1362003778089,1362003782313,2425156813,2425161037,4224
1362003790,2425168724,23,26376,1146.782609,1362003778089,1362003782313,2425156813,2425161037,4224
1362003790,2425168760,2,112,56,1362003779267,1362003784323,2425158027,2425163083,5056
1362003790,2425168772,6,1099,183.1666667,1362003780536,1362003785656,2425159308,2425164428,5120
1362003798,2425176392,3,1047,349,1362003772786,1362003772850,2425151178,2425151242,64
1362003798,2425176392,42,57421,1367.166667,1362003772786,1362003774514,2425151178,2425152906,1728
1362003798,2425176392,3,687,229,1362003772786,1362003772850,2425151178,2425151242,64
1362003798,2425176416,47,44906,955.4468085,1362003772762,1362003794458,2425151178,2425172874,21696
1362003798,2425176416,24,30160,1256.666667,1362003772762,1362003775002,2425151178,2425153418,2240
1362003798,2425176424,20,26837,1341.85,1362003773651,1362003773779,2425152075,2425152203,128
1362003798,2425176424,6,3045,507.5,1362003773778,1362003773906,2425152202,2425152330,128
1362003798,2425176496,31,36173,1166.870968,1362003772427,1362003789195,2425150923,2425167691,16768
1362003798,2425176500,3,527,175.6666667,1362003772681,1362003772681,2425151181,2425151181,0
1362003798,2425176500,23,29033,1262.304348,1362003772681,1362003774089,2425151181,2425152589,1408
1362003798,2425176500,3,278,92.66666667,1362003772743,1362003772807,2425151243,2425151307,64
1362003798,2425176500,4,458,114.5,1362003772743,1362003773447,2425151243,2425151947,704
1362003798,2425176504,12,12587,1048.916667,1362003772932,1362003779012,2425151436,2425157516,6080
1362003798,2425176532,16,19914,1244.625,1362003773543,1362003773671,2425152075,2425152203,128
1362003798,1063491076,18,17822,990.1111111,1362003772615,1362003773319,1063465691,1063466395,704
1362003798,1063491076,17,16091,946.5294118,1362003772615,1362003773319,1063465691,1063466395,704
1362003798,1063491076,82,110682,1349.780488,1362003772614,1362003773510,1063465690,1063466586,896
1362003798,1063491116,39,44770,1147.948718,1362003772317,1362003773277,1063465433,1063466393,960
1362003798,1063491116,22,25074,1139.727273,1362003772572,1362003773276,1063465688,1063466392,704
1362003798,2425176800,3,1103,367.6666667,1362003780443,1362003795291,2425159243,2425174091,14848
1362003802,2425180600,11,13244,1204,1362003777826,1362003777890,2425156426,2425156490,64
1362003802,2425180600,19,23968,1261.473684,1362003773924,1362003774820,2425152524,2425153420,896
1362003802,2425180600,4,1852,463,1362003773924,1362003773924,2425152524,2425152524,0
1362003802,2425180600,20,24416,1220.8,1362003773924,1362003774948,2425152524,2425153548,1024
1362003802,2425180600,18,23315,1295.277778,1362003773924,1362003774884,2425152524,2425153484,960
1362003802,2425180600,4,2904,726,1362003773924,1362003773924,2425152524,2425152524,0
1362003802,2425180600,30,39537,1317.9,1362003773924,1362003774884,2425152524,2425153484,960
1362003802,2425180600,4,3004,751,1362003773923,1362003773923,2425152523,2425152523,0
1362003802,2425180604,3,634,211.3333333,1362003774432,1362003774496,2425153036,2425153100,64
1362003802,2425180604,3,304,101.3333333,1362003774496,1362003774560,2425153100,2425153164,64
1362003802,2425180640,4,1141,285.25,1362003775611,1362003779323,2425154251,2425157963,3712
1362003802,2425180712,3,948,316,1362003777715,1362003777779,2425156427,2425156491,64
1362003802,2425180716,34,46042,1354.176471,1362003773808,1362003774704,2425152524,2425153420,896
1362003802,2425180716,23,30010,1304.782609,1362003773808,1362003774896,2425152524,2425153612,1088
1362003802,2425180716,5,3559,711.8,1362003773808,1362003773808,2425152524,2425152524,0
1362003802,2425180716,13,15746,1211.230769,1362003773808,1362003774896,2425152524,2425153612,1088
1362003802,2425180716,9,9229,1025.444444,1362003773807,1362003774639,2425152523,2425153355,832
1362003802,2425180752,5,1504,300.8,1362003775565,1362003795533,2425154317,2425174285,19968
1362003802,2425180752,3,379,126.3333333,1362003775565,1362003775629,2425154317,2425154381,64
1362003806,2425184612,54,71855,1330.648148,1362003778008,1362003780952,2425156620,2425159564,2944
1362003806,2425184620,17,21147,1243.941176,1362003778574,1362003778574,2425157194,2425157194,0
1362003806,2425184624,88,124125,1410.511364,1362003778891,1362003803083,2425157515,2425181707,24192
1362003806,2425184624,3,878,292.6666667,1362003778891,1362003779403,2425157515,2425158027,512
1362003806,2425184624,5,2653,530.6,1362003778891,1362003802699,2425157515,2425181323,23808
1362003806,2425184624,5,4270,854,1362003778890,1362003779338,2425157514,2425157962,448
1362003806,2425184624,27,36675,1358.333333,1362003778890,1362003778954,2425157514,2425157578,64
1362003806,2425184648,6,5848,974.6666667,1362003778868,1362003779380,2425157516,2425158028,512
1362003806,2425184728,5,3150,630,1362003779170,1362003779234,2425157898,2425157962,64
1362003806,2425184728,4,1610,402.5,1362003779170,1362003779298,2425157898,2425158026,128
1362003806,2425184728,7,3035,433.5714286,1362003779301,1362003779429,2425158029,2425158157,128
1362003806,2425184728,1,48,48,1362003779363,1362003779363,2425158091,2425158091,0
1362003806,2425184728,13,14996,1153.538462,1362003779363,1362003780195,2425158091,2425158923,832
1362003806,2425184728,4,1518,379.5,1362003779299,1362003779427,2425158027,2425158155,128
1362003806,2425184732,7,3658,522.5714286,1362003779425,1362003779553,2425158157,2425158285,128
1362003806,2425184776,4,1733,433.25,1362003779123,1362003779251,2425157899,2425158027,128
1362003806,2425184812,14,17042,1217.285714,1362003778257,1362003778321,2425157069,2425157133,64
1362003806,2425184812,25,31103,1244.12,1362003779086,1362003779278,2425157898,2425158090,192
1362003806,2425184816,16,20045,1252.8125,1362003778701,1362003778701,2425157517,2425157517,0
1362003806,2425184816,4,2248,562,1362003778701,1362003779021,2425157517,2425157837,320
1362003806,2425184816,27,24323,900.8518519,1362003778700,1362003801100,2425157516,2425179916,22400
1362003806,2425184816,3,643,214.3333333,1362003778700,1362003779212,2425157516,2425158028,512
1362003806,2425184816,73,101305,1387.739726,1362003778699,1362003802379,2425157515,2425181195,23680
1362003806,2425184816,5,4311,862.2,1362003778699,1362003779339,2425157515,2425158155,640
1362003806,2425184840,12,12610,1050.833333,1362003779061,1362003779253,2425157901,2425158093,192
1362003806,2425184844,6,3551,591.8333333,1362003779054,1362003779182,2425157898,2425158026,128
1362003806,2425184844,68,96220,1415,1362003779184,1362003780656,2425158028,2425159500,1472
1362003806,2425184844,5,2883,576.6,1362003779182,1362003780078,2425158026,2425158922,896
1362003807,1063499308,26,35918,1381.461538,1362003779910,1362003779910,1063472218,1063472218,0
1362003806,2425184860,3,215,71.66666667,1362003780129,1362003780129,2425158989,2425158989,0
1362003806,2425184860,4,1088,272,1362003780383,1362003780511,2425159243,2425159371,128
1362003806,2425184860,9,4038,448.6666667,1362003780255,1362003802591,2425159115,2425181451,22336
1362003807,2425184940,44,38217,868.5681818,1362003798968,1362003803512,2425176908,2425181452,4544
1362003807,2425184940,4,2345,586.25,1362003803319,1362003803383,2425181259,2425181323,64
1362003807,2425184940,7,1600,228.5714286,1362003803447,1362003805495,2425181387,2425183435,2048
1362003807,2425184940,3,474,158,1362003803511,1362003803511,2425181451,2425181451,0
1362003807,2425184944,3,938,312.6666667,1362003803570,1362003803570,2425181514,2425181514,0
1362003807,2425184944,3,896,298.6666667,1362003803569,1362003803633,2425181513,2425181577,64
1362003807,2425184944,4,1293,323.25,1362003803509,1362003803637,2425181453,2425181581,128
1362003807,2425184944,5,684,136.8,1362003803509,1362003803637,2425181453,2425181581,128
1362003807,2425184944,3,513,171,1362003803509,1362003803573,2425181453,2425181517,64
1362003807,2425184944,3,941,313.6666667,1362003803572,1362003803572,2425181516,2425181516,0
1362003807,2425184944,3,916,305.3333333,1362003803572,1362003803636,2425181516,2425181580,64
1362003807,2425184984,2,112,56,1362003801293,1362003806477,2425179277,2425184461,5184
1362003807,2425185020,3,279,93,1362003803239,1362003803303,2425181259,2425181323,64
1362003807,2425185020,5,1127,225.4,1362003803111,1362003803239,2425181131,2425181259,128
1362003807,2425185024,5,873,174.6,1362003803427,1362003803491,2425181451,2425181515,64
1362003807,2425185024,3,937,312.3333333,1362003803491,1362003803555,2425181515,2425181579,64
1362003807,2425185028,11,6172,561.0909091,1362003803744,1362003804064,2425181772,2425182092,320
1362003807,2425185048,5,1841,368.2,1362003803851,1362003804043,2425181899,2425182091,192
1362003814,2425192832,1,52,52,1362003788474,1362003788474,2425167306,2425167306,0
1362003815,2425193024,8,5958,744.75,1362003802661,1362003812709,2425180685,2425190733,10048
1362003815,2425193028,2,112,56,1362003803358,1362003808478,2425181386,2425186506,5120
1362003815,2425193032,5,938,187.6,1362003803421,1362003813533,2425181453,2425191565,10112
1362003815,2425193032,5,780,156,1362003803420,1362003808476,2425181452,2425186508,5056
1362003815,2425193104,19,21455,1129.210526,1362003802581,1362003812693,2425180685,2425190797,10112
1362003815,2425193104,6,2377,396.1666667,1362003802835,1362003808787,2425180939,2425186891,5952
1362003815,2425193176,20,23442,1172.1,1362003802057,1362003812169,2425180233,2425190345,10112
1362003822,2425200656,3,576,192,1362003795627,1362003795691,2425174283,2425174347,64
1362003826,2425204692,81,109245,1348.703704,1362003800454,1362003803270,2425179146,2425181962,2816
1362003826,2425204692,4,1050,262.5,1362003800453,1362003800645,2425179145,2425179337,192
1362003826,2425204696,3,539,179.6666667,1362003800580,1362003800644,2425179276,2425179340,64
1362003826,2425204696,17,18164,1068.470588,1362003800707,1362003803075,2425179403,2425181771,2368
1362003826,2425204700,8,4358,544.75,1362003800960,1362003801024,2425179660,2425179724,64
1362003826,2425204700,6,3636,606,1362003800959,1362003801087,2425179659,2425179787,128
1362003826,2425204704,12,12358,1029.833333,1362003801275,1362003801595,2425179979,2425180299,320
1362003826,2425204788,24,28693,1195.541667,1362003800359,1362003800871,2425179147,2425179659,512
1362003826,2425204804,55,72951,1326.381818,1362003800279,1362003802839,2425179083,2425181643,2560
1362003826,2425204812,8,6611,826.375,1362003800848,1362003801424,2425179660,2425180236,576
1362003826,2425204812,10,6604,660.4,1362003800847,1362003801039,2425179659,2425179851,192
1362003826,2425204812,8,4571,571.375,1362003800847,1362003800975,2425179659,2425179787,128
1362003826,2425204812,8,4327,540.875,1362003800846,1362003800974,2425179658,2425179786,128
1362003827,1063519332,9,10302,1144.666667,1362003802093,1362003802093,1063494425,1063494425,0
1362003830,2425208640,22,28207,1282.136364,1362003802044,1362003803004,2425180684,2425181644,960
1362003830,2425208640,10,4006,400.6,1362003802044,1362003802684,2425180684,2425181324,640
1362003830,2425208640,10,6447,644.7,1362003802043,1362003802107,2425180683,2425180747,64
1362003830,2425208640,11,6520,592.7272727,1362003802043,1362003802171,2425180683,2425180811,128
1362003830,2425208644,8,8184,1023,1362003802295,1362003802295,2425180939,2425180939,0
1362003830,2425208644,7,6303,900.4285714,1362003802423,1362003802487,2425181067,2425181131,64
1362003830,2425208644,5,3855,771,1362003802423,1362003802487,2425181067,2425181131,64
1362003830,2425208644,5,3208,641.6,1362003802421,1362003802421,2425181065,2425181065,0
1362003830,2425208644,4,3066,766.5,1362003802421,1362003802485,2425181065,2425181129,64
1362003830,2425208648,3,569,189.6666667,1362003802738,1362003802866,2425181386,2425181514,128
1362003830,2425208652,4,1026,256.5,1362003802801,1362003803057,2425181453,2425181709,256
1362003830,2425208652,2,405,202.5,1362003802800,1362003802928,2425181452,2425181580,128
1362003830,2425208652,4,1535,383.75,1362003802800,1362003802864,2425181452,2425181516,64
1362003830,2425208652,3,1440,480,1362003802799,1362003802863,2425181451,2425181515,64
1362003830,2425208656,20,23740,1187,1362003803052,1362003804396,2425181708,2425183052,1344
1362003830,1063523240,3,1107,369,1362003802209,1362003802273,1063495449,1063495513,64
1362003830,1063523240,28,38891,1388.964286,1362003802209,1362003802273,1063495449,1063495513,64
1362003830,1063523240,28,38891,1388.964286,1362003802209,1362003802273,1063495449,1063495513,64
1362003830,2425208812,21,27576,1313.142857,1362003801807,1362003802383,2425180619,2425181195,576
1362003830,2425208812,12,7898,658.1666667,1362003801870,1362003801998,2425180682,2425180810,128
1362003830,2425208816,12,12312,1026,1362003802123,1362003802699,2425180939,2425181515,576
1362003830,2425208816,8,6833,854.125,1362003802250,1362003802314,2425181066,2425181130,64
1362003830,2425208816,11,4846,440.5454545,1362003802186,1362003802826,2425181002,2425181642,640
1362003830,2425208816,7,6124,874.8571429,1362003802249,1362003802313,2425181065,2425181129,64
1362003830,2425208844,44,52274,1188.045455,1362003802351,1362003804975,2425181195,2425183819,2624
1362003830,2425208848,10,7318,731.8,1362003802668,1362003802860,2425181516,2425181708,192
1362003830,2425208848,22,25241,1147.318182,1362003802603,1362003803947,2425181451,2425182795,1344
1362003830,2425208852,3,658,219.3333333,1362003802856,1362003803176,2425181708,2425182028,320
1362003831,2425208964,2,112,56,1362003822624,1362003827680,2425200588,2425205644,5056
1362003831,2425208972,28,36361,1298.607143,1362003823768,1362003824152,2425201740,2425202124,384
1362003847,2425224888,3,557,185.6666667,1362003820396,1362003820460,2425198284,2425198348,64
1362003847,2425224888,34,44672,1313.882353,1362003820522,1362003822890,2425198410,2425200778,2368
1362003850,2425228640,7,7247,1035.285714,1362003821946,1362003822138,2425200586,2425200778,192
1362003850,2425228644,40,56328,1408.2,1362003821941,1362003822325,2425200585,2425200969,384
1362003850,2425228688,2,104,52,1362003823756,1362003823820,2425202444,2425202508,64
1362003850,2425228732,2,104,52,1362003825309,1362003825373,2425204041,2425204105,64
1362003850,2425228740,6,2036,339.3333333,1362003822039,1362003822103,2425200779,2425200843,64
1362003850,2425228740,40,54621,1365.525,1362003821847,1362003822359,2425200587,2425201099,512
1362003850,2425228768,40,53958,1348.95,1362003822460,1362003822972,2425201228,2425201740,512
1362003850,2425228840,2,104,52,1362003825205,1362003825269,2425204045,2425204109,64
1362003855,2425233044,166,239074,1440.204819,1362003779471,1362003847631,2425157515,2425225675,68160
1362003858,2425236720,2,92,46,1362003832555,1362003832619,2425211275,2425211339,64
1362003858,2425236844,2,92,46,1362003832432,1362003832496,2425211276,2425211340,64
1362003863,2425241052,102,142928,1401.254902,1362003773127,1362003861639,2425151179,2425239691,88512
1362003863,2425241056,2,104,52,1362003861636,1362003861636,2425239692,2425239692,0
1362003863,2425241056,3,156,52,1362003861635,1362003861635,2425239691,2425239691,0
1362003863,2425241056,2,92,46,1362003861635,1362003861635,2425239691,2425239691,0
1362003863,2425241056,2,104,52,1362003861635,1362003861635,2425239691,2425239691,0
1362003863,2425241056,4,235,58.75,1362003861635,1362003861635,2425239691,2425239691,0
1362003863,2425241136,186,266240,1431.397849,1362003773042,1362003861554,2425151178,2425239690,88512
1362003863,2425241140,3,183,61,1362003861488,1362003861488,2425239628,2425239628,0
1362003863,2425241140,3,193,64.33333333,1362003861551,1362003861551,2425239691,2425239691,0
1362003863,2425241140,3,193,64.33333333,1362003861551,1362003861551,2425239691,2425239691,0
1362003863,2425241140,2,104,52,1362003861551,1362003861551,2425239691,2425239691,0
1362003866,2425244728,2,104,52,1362003839970,1362003839970,2425218698,2425218698,0
1362003869,1063561980,397,579426,1459.511335,1362003772711,1362003861095,1063465691,1063554075,88384
1362003870,2425248688,1,46,46,1362003843594,1362003843594,2425222282,2425222282,0
1362003870,2425248740,2,92,46,1362003844311,1362003844375,2425223051,2425223115,64
1362003874,2425252708,2,104,52,1362003846968,1362003846968,2425225676,2425225676,0
1362003874,2425252708,2,104,52,1362003847093,1362003847093,2425225801,2425225801,0
1362003874,2425252708,2,104,52,1362003847093,1362003847093,2425225801,2425225801,0
1362003874,2425252712,2,104,52,1362003847220,1362003847220,2425225932,2425225932,0
1362003874,2425252840,2,104,52,1362003848819,1362003848819,2425227659,2425227659,0
1362003875,2425252896,2,104,52,1362003847394,1362003847458,2425225290,2425225354,64
1362003875,2425252900,2,104,52,1362003847775,1362003847775,2425225675,2425225675,0
1362003875,2425252900,2,104,52,1362003847774,1362003847838,2425225674,2425225738,64
1362003875,2425252904,2,104,52,1362003847900,1362003847900,2425225804,2425225804,0
1362003875,2425252904,2,104,52,1362003847900,1362003847900,2425225804,2425225804,0
1362003875,2425252904,2,104,52,1362003847834,1362003847898,2425225738,2425225802,64
1362003875,2425252908,2,104,52,1362003848278,1362003848342,2425226186,2425226250,64
1362003875,2425252960,2,104,52,1362003849380,1362003849444,2425227340,2425227404,64
1362003875,2425252984,2,104,52,1362003849864,1362003849928,2425227848,2425227912,64
1362003875,2425252984,2,104,52,1362003849800,1362003849864,2425227784,2425227848,64
1362003886,2425264712,1,52,52,1362003860913,1362003860913,2425239625,2425239625,0
1362003886,2425264712,2,104,52,1362003860913,1362003860913,2425239625,2425239625,0
1362003886,2425264712,2,104,52,1362003860913,1362003860913,2425239625,2425239625,0
1362003886,2425264712,1,52,52,1362003860913,1362003860913,2425239625,2425239625,0
1362003886,2425264712,1,52,52,1362003860913,1362003860913,2425239625,2425239625,0
1362003886,2425264712,1,52,52,1362003860913,1362003860913,2425239625,2425239625,0
1362003886,2425264712,1,52,52,1362003860912,1362003860912,2425239624,2425239624,0
1362003886,2425264712,1,52,52,1362003860976,1362003860976,2425239688,2425239688,0
1362003886,2425264712,1,52,52,1362003860976,1362003860976,2425239688,2425239688,0
1362003886,2425264716,1,52,52,1362003860976,1362003860976,2425239692,2425239692,0
1362003886,2425264716,1,52,52,1362003860976,1362003860976,2425239692,2425239692,0
1362003886,2425264716,1,52,52,1362003860976,1362003860976,2425239692,2425239692,0
1362003886,2425264716,1,52,52,1362003860976,1362003860976,2425239692,2425239692,0
1362003886,2425264716,1,52,52,1362003860976,1362003860976,2425239692,2425239692,0
1362003886,2425264716,1,52,52,1362003860976,1362003860976,2425239692,2425239692,0
1362003886,2425264716,1,52,52,1362003860976,1362003860976,2425239692,2425239692,0
1362003886,2425264716,1,46,46,1362003860975,1362003860975,2425239691,2425239691,0
1362003886,2425264716,1,46,46,1362003860975,1362003860975,2425239691,2425239691,0
1362003886,2425264716,1,52,52,1362003860975,1362003860975,2425239691,2425239691,0
1362003886,2425264716,1,46,46,1362003860975,1362003860975,2425239691,2425239691,0
1362003886,2425264716,1,52,52,1362003860908,1362003860908,2425239624,2425239624,0
1362003886,2425264716,1,52,52,1362003860908,1362003860908,2425239624,2425239624,0
1362003886,2425264716,1,52,52,1362003860908,1362003860908,2425239624,2425239624,0
1362003886,2425264716,1,52,52,1362003860908,1362003860908,2425239624,2425239624,0
1362003886,2425264716,1,52,52,1362003860972,1362003860972,2425239688,2425239688,0
1362003886,2425264720,1,52,52,1362003860972,1362003860972,2425239692,2425239692,0
1362003886,2425264720,1,52,52,1362003860972,1362003860972,2425239692,2425239692,0
1362003886,2425264720,1,52,52,1362003860972,1362003860972,2425239692,2425239692,0
1362003886,2425264720,1,52,52,1362003860972,1362003860972,2425239692,2425239692,0
1362003886,2425264720,1,52,52,1362003860972,1362003860972,2425239692,2425239692,0
1362003886,2425264720,1,52,52,1362003860972,1362003860972,2425239692,2425239692,0
1362003886,2425264720,1,52,52,1362003860972,1362003860972,2425239692,2425239692,0
1362003886,2425264720,1,52,52,1362003860972,1362003860972,2425239692,2425239692,0
1362003886,2425264720,1,52,52,1362003860971,1362003860971,2425239691,2425239691,0
1362003886,2425264720,1,46,46,1362003860971,1362003860971,2425239691,2425239691,0
1362003886,2425264720,1,52,52,1362003860971,1362003860971,2425239691,2425239691,0
1362003886,2425264720,2,104,52,1362003860971,1362003860971,2425239691,2425239691,0
1362003886,1063579228,1,52,52,1362003860846,1362003860846,1063554074,1063554074,0
1362003886,1063579228,1,52,52,1362003860844,1362003860844,1063554072,1063554072,0
1362003886,1063579228,1,52,52,1362003860844,1362003860844,1063554072,1063554072,0
1362003886,1063579228,1,52,52,1362003860844,1362003860844,1063554072,1063554072,0
1362003886,1063579228,1,52,52,1362003860844,1362003860844,1063554072,1063554072,0
1362003886,1063579232,1,52,52,1362003860843,1362003860843,1063554075,1063554075,0
1362003886,1063579272,1,52,52,1362003860800,1362003860800,1063554072,1063554072,0
1362003886,1063579276,1,52,52,1362003860799,1362003860799,1063554075,1063554075,0
1362003886,1063579276,1,52,52,1362003860798,1362003860798,1063554074,1063554074,0
1362003886,1063579276,1,52,52,1362003860862,1362003860862,1063554138,1063554138,0
1362003886,2425264828,1,52,52,1362003860798,1362003860798,2425239626,2425239626,0
1362003886,2425264828,1,52,52,1362003860798,1362003860798,2425239626,2425239626,0
1362003886,2425264828,2,104,52,1362003860798,1362003860798,2425239626,2425239626,0
1362003886,2425264828,1,52,52,1362003860798,1362003860798,2425239626,2425239626,0
1362003886,2425264828,1,52,52,1362003860798,1362003860798,2425239626,2425239626,0
1362003886,2425264828,1,52,52,1362003860798,1362003860798,2425239626,2425239626,0
1362003886,2425264828,1,52,52,1362003860862,1362003860862,2425239690,2425239690,0
1362003886,2425264828,1,52,52,1362003860862,1362003860862,2425239690,2425239690,0
1362003886,2425264828,1,52,52,1362003860862,1362003860862,2425239690,2425239690,0
1362003886,2425264828,1,52,52,1362003860861,1362003860861,2425239689,2425239689,0
1362003886,2425264828,1,52,52,1362003860797,1362003860797,2425239625,2425239625,0
1362003886,2425264828,1,52,52,1362003860797,1362003860797,2425239625,2425239625,0
1362003886,2425264828,1,52,52,1362003860797,1362003860797,2425239625,2425239625,0
1362003886,2425264828,1,52,52,1362003860797,1362003860797,2425239625,2425239625,0
1362003886,2425264828,1,52,52,1362003860797,1362003860797,2425239625,2425239625,0
1362003886,2425264828,1,52,52,1362003860797,1362003860797,2425239625,2425239625,0
1362003886,2425264828,1,52,52,1362003860861,1362003860861,2425239689,2425239689,0
1362003886,2425264828,1,52,52,1362003860861,1362003860861,2425239689,2425239689,0
1362003886,2425264828,1,52,52,1362003860861,1362003860861,2425239689,2425239689,0
1362003886,2425264828,2,104,52,1362003860861,1362003860861,2425239689,2425239689,0
1362003886,2425264828,1,52,52,1362003860861,1362003860861,2425239689,2425239689,0
1362003886,2425264828,1,52,52,1362003860861,1362003860861,2425239689,2425239689,0
1362003886,2425264828,1,52,52,1362003860861,1362003860861,2425239689,2425239689,0
1362003886,2425264828,1,52,52,1362003860861,1362003860861,2425239689,2425239689,0
1362003886,2425264828,1,52,52,1362003860861,1362003860861,2425239689,2425239689,0
1362003886,2425264828,1,52,52,1362003860861,1362003860861,2425239689,2425239689,0
1362003886,2425264828,1,52,52,1362003860861,1362003860861,2425239689,2425239689,0
1362003886,2425264828,1,52,52,1362003860861,1362003860861,2425239689,2425239689,0
1362003886,2425264828,1,52,52,1362003860861,1362003860861,2425239689,2425239689,0
1362003886,2425264828,1,52,52,1362003860861,1362003860861,2425239689,2425239689,0
1362003886,2425264828,1,52,52,1362003860861,1362003860861,2425239689,2425239689,0
1362003886,2425264828,1,52,52,1362003860861,1362003860861,2425239689,2425239689,0
1362003886,2425264828,1,52,52,1362003860861,1362003860861,2425239689,2425239689,0
1362003886,2425264828,1,52,52,1362003860861,1362003860861,2425239689,2425239689,0
1362003886,2425264832,1,52,52,1362003860856,1362003860856,2425239688,2425239688,0
1362003886,2425264832,1,52,52,1362003860856,1362003860856,2425239688,2425239688,0
1362004027,2425405476,1,46,46,1362004002140,1362004002140,2425380616,2425380616,0
1362004039,2425417164,6,2035,339.1666667,1362004032019,1362004038163,2425410183,2425416327,6144
1362004045,1063738004,3929,5885645,1498.000764,1362004020496,1362004037840,1063713500,1063730844,17344
1362004103,2425481204,3157,4729154,1497.989864,1362003773033,1362003798889,2425151237,2425177093,25856
1362004223,2425601680,14,6617,472.6428571,1362004198541,1362004198861,2425577221,2425577541,320
1362004227,2425605700,9,861,95.66666667,1362004198904,1362004199096,2425577604,2425577796,192
1362004227,2425605708,8,815,101.875,1362004199408,1362004199600,2425578116,2425578308,192
1362004227,2425605800,9,861,95.66666667,1362004199062,1362004199254,2425577862,2425578054,192
1362004247,2425625736,1,46,46,1362004219413,1362004219413,2425598149,2425598149,0
1362004452,2425830260,1,46,46,1362004425263,1362004425263,2425803523,2425803523,0
1362004471,2425849496,3,189,63,1362004464129,1362004467137,2425842625,2425845633,3008
1362004487,2425865392,2,126,63,1362004471271,1362004479335,2425849663,2425857727,8064
1362004519,2425897444,3,189,63,1362004513459,1362004516467,2425891903,2425894911,3008
1362004519,2425897532,3,189,63,1362004513247,1362004516319,2425891779,2425894851,3072
1362004535,2425913460,2,126,63,1362004520421,1362004528421,2425898881,2425906881,8000
1362004535,2425913460,2,126,63,1362004520483,1362004528547,2425898943,2425907007,8064
1362004535,2425913500,4,252,63,1362004526141,1362004533245,2425904641,2425911745,7104
1362004568,2425946532,1,63,63,1362004541213,1362004541213,2425919745,2425919745,0
1362004917,2426295064,1,46,46,1362004892011,1362004892011,2426270075,2426270075,0
1362005210,2426588040,1,46,46,1362005183551,1362005183551,2426561591,2426561591,0
1362005904,2427282132,1,46,46,1362005877846,1362005877846,2427255978,2427255978,0
1362005920,2427298796,1,60,60,1362005894145,1362005894145,2427272941,2427272941,0
1362005921,2427299432,1,60,60,1362005894764,1362005894764,2427273196,2427273196,0
1362005921,2427299556,5,775,155,1362005911791,1362005911983,2427290347,2427290539,192
1362006016,2427394136,9,861,95.66666667,1362005990096,1362005990224,2427368232,2427368360,128
1362006016,2427394204,16,7743,483.9375,1362005988623,1362005988879,2427366827,2427367083,256
1362006016,2427394212,13,6234,479.5384615,1362005989383,1362005989639,2427367595,2427367851,256
1362006016,2427394216,9,861,95.66666667,1362005989762,1362005989890,2427367978,2427368106,128
1362006016,2427394244,8,815,101.875,1362005990245,1362005990373,2427368489,2427368617,128
1362006164,2427542416,1,46,46,1362006139513,1362006139513,2427517929,2427517929,0
1362006256,2427634780,3,189,63,1362006251659,1362006254667,2427630439,2427633447,3008
1362006272,2427650836,2,126,63,1362006258642,1362006266642,2427637478,2427645478,8000
1362006273,2427650844,3,189,63,1362006267952,1362006271024,2427645796,2427648868,3072
1362006280,2427658800,3,189,63,1362006276661,1362006279669,2427655461,2427658469,3008
1362006288,2427666804,2,126,63,1362006274032,1362006282096,2427652836,2427660900,8064
1362006297,2427674852,2,126,63,1362006284648,1362006292712,2427662500,2427670564,8064
1362006304,2427682832,3,189,63,1362006298837,1362006301845,2427677669,2427680677,3008
1362006305,2427682884,3,189,63,1362006299720,1362006302792,2427677604,2427680676,3072
1362006321,2427698912,2,126,63,1362006306799,1362006314799,2427684711,2427692711,8000
1362006321,2427698912,2,126,63,1362006306799,1362006314863,2427684711,2427692775,8064
1362006353,2427731760,1,46,46,1362006325595,1362006325595,2427704355,2427704355,0
1362006353,2427731804,1,46,46,1362006325747,1362006325747,2427704551,2427704551,0
1362006457,2427835516,5,775,155,1362006453327,1362006453519,2427831843,2427832035,192
1362007571,2428949404,5,775,155,1362007568176,1362007568368,2428946580,2428946772,192
1362007691,2429069616,12,999,83.25,1362007673752,1362007684952,2429052368,2429063568,11200
1362007691,2429069664,17,6755,397.3529412,1362007672808,1362007684904,2429051472,2429063568,12096
1362007691,2429069668,12,999,83.25,1362007673189,1362007684901,2429051857,2429063569,11712
1362007691,2429069668,12,999,83.25,1362007673445,1362007684901,2429052113,2429063569,11456
1362008160,2429538560,1,46,46,1362008135435,1362008135435,2429513995,2429513995,0
1362008161,2429539032,1,46,46,1362008135897,1362008135897,2429513929,2429513929,0
1362008437,2429815080,16,6372,398.25,1362008417382,1362008429478,2429795462,2429807558,12096
1362008437,2429815084,12,999,83.25,1362008417763,1362008429475,2429795847,2429807559,11712
1362008437,2429815156,12,999,83.25,1362008418008,1362008429400,2429796164,2429807556,11392
1362008437,2429815160,12,999,83.25,1362008418260,1362008429396,2429796420,2429807556,11136
1362008445,2429822932,11,3267,297,1362008417147,1362008417787,2429795079,2429795719,640
1362008525,2429903444,3,193,64.33333333,1362008517625,1362008517625,2429896069,2429896069,0
1362008581,2429959412,5,774,154.8,1362008577176,1362008577368,2429955588,2429955780,192
1362008753,2430131316,14,6617,472.6428571,1362008728180,1362008728500,2430106496,2430106816,320
1362008753,2430131336,9,861,95.66666667,1362008728545,1362008728737,2430106881,2430107073,192
1362008753,2430131428,8,815,101.875,1362008728709,1362008728901,2430107137,2430107329,192
1362008757,2430135336,9,861,95.66666667,1362008729055,1362008729247,2430107391,2430107583,192
1362008881,2430259756,1,48,48,1362008856250,1362008856250,2430235006,2430235006,0
1362008894,2430271964,14,6021,430.0714286,1362008875476,1362008887508,2430253440,2430265472,12032
1362008895,1068587308,8,7207,900.875,1362008875558,1362008887526,1068567866,1068579834,11968
1362008895,1068587316,7,4808,686.8571429,1362008875550,1362008887518,1068567866,1068579834,11968
1362008945,2430323636,1,46,46,1362008918004,1362008918004,2430296640,2430296640,0
1362008950,2430327948,3,189,63,1362008945699,1362008948707,2430323647,2430326655,3008
1362008966,2430343948,2,126,63,1362008952737,1362008960801,2430330685,2430338749,8064
1362008982,2430359952,3,189,63,1362008976284,1362008979292,2430354236,2430357244,3008
1362008982,2430359956,3,189,63,1362008976472,1362008979480,2430354428,2430357436,3008
1362008998,2430376248,2,126,63,1362008983222,1362008991286,2430361470,2430369534,8064
1362008998,2430376328,2,126,63,1362008982949,1362008991013,2430361277,2430369341,8064
1362009062,2430440128,3,189,63,1362009054765,1362009057837,2430432893,2430435965,3072
1362009078,2430455964,2,126,63,1362009062031,1362009070031,2430439995,2430447995,8000
1362009230,2430608160,5,774,154.8,1362009228361,1362009228553,2430606521,2430606713,192
1362009331,2430708956,14,6617,472.6428571,1362009304596,1362009304916,2430682552,2430682872,320
1362009331,2430708960,9,861,95.66666667,1362009304975,1362009305231,2430682935,2430683191,256
1362009331,2430708964,8,815,101.875,1362009305293,1362009305485,2430683257,2430683449,192
1362009558,2430936268,3,189,63,1362009553047,1362009556055,2430931315,2430934323,3008
1362009558,2430936316,3,189,63,1362009553001,1362009556009,2430931317,2430934325,3008
1362009566,2430944236,5,264,52.8,1362009560120,1362009562424,2430938356,2430940660,2304
1362009566,2430944288,5,264,52.8,1362009560069,1362009562309,2430938357,2430940597,2240
1362009566,2430944316,3,138,46,1362009562215,1362009562279,2430940531,2430940595,64
1362009591,2430969168,8,815,101.875,1362009563707,1362009563899,2430941875,2430942067,192
1362009591,2430969168,9,861,95.66666667,1362009563964,1362009564156,2430942132,2430942324,192
1362009591,2430969212,9,861,95.66666667,1362009563087,1362009563343,2430941299,2430941555,256
1362009591,2430969216,8,815,101.875,1362009563403,1362009563595,2430941619,2430941811,192
1362009798,2431176516,4,252,63,1362009790683,1362009797723,2431169199,2431176239,7040
1362009822,2431200576,4,252,63,1362009814496,1362009821536,2431193072,2431200112,7040
1362009831,2431209656,1,63,63,1362009805647,1362009805647,2431184303,2431184303,0
1362009855,2431233800,1,63,63,1362009829378,1362009829378,2431208178,2431208178,0
1362009886,2431264516,2,126,63,1362009883101,1362009884125,2431261617,2431262641,1024
1362009894,2431272576,2,126,63,1362009886049,1362009890081,2431264625,2431268657,4032
1362009924,2431301916,1,63,63,1362009898805,1362009898805,2431276721,2431276721,0
1362009983,2431360864,4,252,63,1362009973926,1362009980966,2431351790,2431358830,7040
1362010016,2431394236,1,63,63,1362009988657,1362009988657,2431366893,2431366893,0
1362010269,2431646996,1,48,48,1362010241308,1362010241308,2431619304,2431619304,0
1362010269,2431647440,1,48,48,1362010240419,1362010240419,2431618859,2431618859,0
1362010566,2431944172,1,46,46,1362010540970,1362010540970,2431919142,2431919142,0
1362010566,2431944196,1,46,46,1362010541136,1362010541136,2431919332,2431919332,0
1362011111,2432489548,17,6755,397.3529412,1362011094441,1362011104041,2432472989,2432482589,9600
1362011111,2432489552,12,999,83.25,1362011094820,1362011104036,2432473372,2432482588,9216
1362011111,2432489556,12,999,83.25,1362011095071,1362011104031,2432473627,2432482587,8960
1362011111,2432489556,11,953,86.63636364,1362011095329,1362011104033,2432473885,2432482589,8704
1362011424,2432802444,5,775,155,1362011420492,1362011420620,2432798936,2432799064,128
1362012803,2434181380,14,6617,472.6428571,1362012778617,1362012778937,2434156997,2434157317,320
1362012807,2434185224,9,861,95.66666667,1362012779155,1362012779411,2434157379,2434157635,256
1362012807,2434185324,9,861,95.66666667,1362012779439,1362012779567,2434157763,2434157891,128
1362013044,2434422212,8,815,101.875,1362013018395,1362013018651,2434396607,2434396863,256
1362013044,2434422268,9,861,95.66666667,1362013017765,1362013017957,2434396033,2434396225,192
1362013044,2434422292,8,815,101.875,1362013018059,1362013018187,2434396351,2434396479,128
1362013044,2434422328,8,815,101.875,1362013018600,1362013018792,2434396928,2434397120,192
1362013058,2434436060,3,189,63,1362013052211,1362013055219,2434430271,2434433279,3008
1362013074,2434452160,2,126,63,1362013059152,1362013067216,2434437312,2434445376,8064
1362013106,2434484040,2,126,63,1362013104264,1362013105288,2434482304,2434483328,1024
1362013114,2434492068,3,189,63,1362013108522,1362013111594,2434486590,2434489662,3072
1362013114,2434492180,2,126,63,1362013107130,1362013111162,2434485310,2434489342,4032
1362013130,2434508192,2,126,63,1362013115504,1362013123504,2434493696,2434501696,8000
1362013144,2434522536,1,63,63,1362013118869,1362013118869,2434497405,2434497405,0
1362013258,2434636172,4,252,63,1362013250370,1362013257474,2434628542,2434635646,7104
1362013293,2434671056,1,63,63,1362013265589,1362013265589,2434643645,2434643645,0
1362013330,2434708232,2,126,63,1362013326978,1362013327938,2434705210,2434706170,960
1362013330,2434708304,2,126,63,1362013326843,1362013327803,2434705147,2434706107,960
1362013330,2434708304,2,126,63,1362013326842,1362013327866,2434705146,2434706170,1024
1362013338,2434716192,2,126,63,1362013329963,1362013333995,2434708155,2434712187,4032
1362013338,2434716192,2,126,63,1362013330027,1362013334059,2434708219,2434712251,4032
1362013338,2434716244,2,126,63,1362013329975,1362013334007,2434708219,2434712251,4032
1362013369,2434747080,1,63,63,1362013342235,1362013342235,2434720315,2434720315,0
1362013369,2434747192,1,63,63,1362013342125,1362013342125,2434720317,2434720317,0
1362013369,2434747192,1,63,63,1362013342060,1362013342060,2434720252,2434720252,0
1362013514,2434892388,5,775,155,1362013506278,1362013507046,2434884666,2434885434,768
1362014596,2435974140,13,6234,479.5384615,1362014569228,1362014569548,2435947368,2435947688,320
1362014596,2435974144,9,861,95.66666667,1362014569610,1362014569866,2435947754,2435948010,256
1362014596,2435974316,8,815,101.875,1362014569820,1362014569948,2435948136,2435948264,128
1362014596,2435974348,9,861,95.66666667,1362014570044,1362014570172,2435948392,2435948520,128
1362014756,2436134732,3,189,63,1362014751482,1362014754490,2436130214,2436133222,3008
1362014756,2436134804,3,189,63,1362014750897,1362014753969,2436129701,2436132773,3072
1362014772,2436150736,2,126,63,1362014758517,1362014766581,2436137253,2436145317,8064
1362014773,2436150912,2,126,63,1362014758895,1362014766959,2436136807,2436144871,8064
1362014801,2436178880,1,46,46,1362014773068,1362014773068,2436150948,2436150948,0
1362014801,2436179420,1,46,46,1362014772336,1362014772336,2436150756,2436150756,0
1362014829,2436207020,3,189,63,1362014824001,1362014827009,2436202021,2436205029,3008
1362014845,2436222864,2,126,63,1362014831196,1362014839260,2436209060,2436217124,8064
1362014901,2436278876,3,189,63,1362014897297,1362014900305,2436275173,2436278181,3008
1362014917,2436294988,2,126,63,1362014904224,1362014912288,2436282212,2436290276,8064
1362015454,2436832072,5,775,155,1362015451843,1362015451971,2436829915,2436830043,128
1362015692,2437069936,1,48,48,1362015666438,1362015666438,2437044374,2437044374,0
1362015695,2437073444,1,48,48,1362015666059,1362015666059,2437044503,2437044503,0
1362016043,2437421712,1,46,46,1362016015226,1362016015226,2437393938,2437393938,0
1362016280,2437658212,13,6234,479.5384615,1362016254314,1362016255018,2437632526,2437633230,704
1362016280,2437658296,9,861,95.66666667,1362016255382,1362016255574,2437633678,2437633870,192
1362016280,2437658308,10,907,90.7,1362016255629,1362016256909,2437633937,2437635217,1280
1362016470,2437848784,4,252,63,1362016462059,1362016469099,2437840843,2437847883,7040
1362016478,2437856708,3,138,46,1362016475638,1362016475766,2437854346,2437854474,128
1362016478,2437856708,3,138,46,1362016475642,1362016475770,2437854350,2437854478,128
1362016478,2437856756,4,201,50.25,1362016475590,1362016475654,2437854346,2437854410,64
1362016504,2437882452,8,815,101.875,1362016477431,1362016478007,2437855883,2437856459,576
1362016504,2437882492,9,861,95.66666667,1362016479822,1362016480014,2437858314,2437858506,192
1362016504,2437882496,8,815,101.875,1362016478219,1362016479691,2437856715,2437858187,1472
1362016508,2437886472,9,861,95.66666667,1362016480100,1362016481508,2437858572,2437859980,1408
1362016608,2437986752,1,46,46,1362016580233,1362016580233,2437958985,2437958985,0
1362016767,2438144924,3,189,63,1362016758085,1362016762437,2438136009,2438140361,4352
1362016767,2438144992,4,252,63,1362016758079,1362016765887,2438136071,2438143879,7808
1362016783,2438160960,2,126,63,1362016768287,1362016779935,2438146247,2438157895,11648
1362016799,2438176984,2,126,63,1362016793352,1362016794376,2438171336,2438172360,1024
1362016801,2438179012,1,63,63,1362016774826,1362016774826,2438152838,2438152838,0
1362016815,2438193044,2,126,63,1362016800332,1362016808396,2438178376,2438186440,8064
1362016847,2438225120,2,126,63,1362016844287,1362016845311,2438222407,2438223431,1024
1362016855,2438233092,2,126,63,1362016847386,1362016851418,2438225478,2438229510,4032
1362016885,2438263180,1,63,63,1362016859329,1362016859329,2438237509,2438237509,0
1362017366,2438743860,1,46,46,1362017339194,1362017339194,2438717054,2438717054,0
1362017482,2438859912,1,46,46,1362017455749,1362017455749,2438833661,2438833661,0
1362017712,2439089940,17,6755,397.3529412,1362017695078,1362017704806,2439073018,2439082746,9728
1362017712,2439089944,12,999,83.25,1362017695456,1362017704800,2439073400,2439082744,9344
1362017712,2439089988,11,953,86.63636364,1362017695926,1362017704758,2439073914,2439082746,8832
1362017712,2439090020,12,999,83.25,1362017695639,1362017704727,2439073659,2439082747,9088
1362017752,2439130088,5,773,154.6,1362017749200,1362017749456,2439127288,2439127544,256
1362017875,2439253500,1,46,46,1362017849970,1362017849970,2439228470,2439228470,0
1362017876,2439254052,1,46,46,1362017850355,1362017850355,2439228407,2439228407,0
1362018328,2439705816,2,96,48,1362018300888,1362018303256,2439678704,2439681072,2368
1362018609,2439987208,12,999,83.25,1362018593995,1362018604619,2439972203,2439982827,10624
1362018609,2439987212,12,999,83.25,1362018594631,1362018604615,2439972843,2439982827,9984
1362018609,2439987212,12,999,83.25,1362018594375,1362018604615,2439972587,2439982827,10240
1362018609,2439987280,16,6372,398.25,1362018593478,1362018604550,2439971758,2439982830,11072
1362018893,2440271356,1,46,46,1362018866741,1362018866741,2440245097,2440245097,0
1362019170,2440548228,1,46,46,1362019141935,1362019141935,2440520163,2440520163,0
1362019439,2440817068,1,46,46,1362019413389,1362019413389,2440791457,2440791457,0
1362019507,2440885316,12,999,83.25,1362019494739,1362019504851,2440873055,2440883167,10112
1362019507,2440885320,12,999,83.25,1362019495246,1362019504846,2440873566,2440883166,9600
1362019507,2440885360,12,999,83.25,1362019494949,1362019504805,2440873309,2440883165,9856
1362019507,2440885400,16,6372,398.25,1362019494205,1362019504765,2440872605,2440883165,10560
1362020197,2441575144,1,48,48,1362020170163,1362020170163,2441548307,2441548307,0
1362020245,2441623620,1,46,46,1362020219097,1362020219097,2441597717,2441597717,0
1362020321,2441699488,1,46,46,1362020293723,1362020293723,2441672211,2441672211,0
1362021301,2442679592,44,56779,1290.431818,1362021298850,1362021299106,2442677442,2442677698,256
1362021317,2442695644,11,953,86.63636364,1362021299246,1362021309038,2442677890,2442687682,9792
1362021317,2442695648,12,999,83.25,1362021299499,1362021309035,2442678147,2442687683,9536
1362021317,2442695668,12,999,83.25,1362021299735,1362021309015,2442678403,2442687683,9280
1362021328,2442705976,1,46,46,1362021299915,1362021299915,2442677891,2442677891,0
1362021394,1081086976,13,5341,410.8461538,1362021391070,1362021391326,1081084046,1081084302,256
1362021405,2442783644,10,9492,949.2,1362021403630,1362021403758,2442782274,2442782402,128
1362021405,2442783644,7,2448,349.7142857,1362021399980,1362021400364,2442778624,2442779008,384
1362021405,2442783680,19,21471,1130.052632,1362021403272,1362021403464,2442781952,2442782144,192
1362021405,2442783684,7,3831,547.2857143,1362021403399,1362021403527,2442782083,2442782211,128
1362021405,2442783684,9,8162,906.8888889,1362021403463,1362021403591,2442782147,2442782275,128
1362021405,2442783684,7,4907,701,1362021403653,1362021403781,2442782337,2442782465,128
1362021405,2442783756,15,12521,834.7333333,1362021390846,1362021402750,2442769602,2442781506,11904
1362021413,2442791700,4,356,89,1362021401526,1362021410486,2442780226,2442789186,8960
1362021413,2442791784,9,3149,349.8888889,1362021394658,1362021408738,2442773442,2442787522,14080
1362021422,2442799952,33,41799,1266.636364,1362021410465,1362021418721,2442788417,2442796673,8256
1362021422,2442799952,15,14594,972.9333333,1362021410592,1362021417504,2442788544,2442795456,6912
1362021422,2442799952,15,15696,1046.4,1362021410592,1362021417440,2442788544,2442795392,6848
1362021422,2442799952,8,6094,761.75,1362021410592,1362021417504,2442788544,2442795456,6912
1362021422,2442799952,37,49356,1333.945946,1362021410592,1362021417504,2442788544,2442795456,6912
1362021422,2442799960,4,1489,372.25,1362021413723,1362021418907,2442791683,2442796867,5184
1362021422,2442799992,25,29913,1196.52,1362021409144,1362021417272,2442787136,2442795264,8128
1362021422,2442800000,171,238151,1392.695906,1362021399216,1362021417264,2442777216,2442795264,18048
1362021422,2442800004,51,69596,1364.627451,1362021410414,1362021418670,2442788418,2442796674,8256
1362021422,2442800004,41,52170,1272.439024,1362021410541,1362021417453,2442788545,2442795457,6912
1362021422,2442800004,5,1703,340.6,1362021410412,1362021418796,2442788416,2442796800,8384
1362021422,2442800008,17,18653,1097.235294,1362021410539,1362021417259,2442788547,2442795267,6720
1362021446,2442823920,5,1629,325.8,1362021436929,1362021442881,2442814849,2442820801,5952
1362021448,2442825852,1,46,46,1362021423428,1362021423428,2442801280,2442801280,0
1362021448,2442825852,1,46,46,1362021423363,1362021423363,2442801215,2442801215,0
1362021448,2442825852,1,46,46,1362021423427,1362021423427,2442801279,2442801279,0
1362021448,2442825856,1,46,46,1362021423423,1362021423423,2442801279,2442801279,0
1362021448,2442825856,1,46,46,1362021423427,1362021423427,2442801283,2442801283,0
1362021448,2442825856,1,46,46,1362021423427,1362021423427,2442801283,2442801283,0
1362021448,2442825944,1,46,46,1362021423338,1362021423338,2442801282,2442801282,0
1362021448,2442825944,1,46,46,1362021423338,1362021423338,2442801282,2442801282,0
1362021448,2442825944,1,46,46,1362021423338,1362021423338,2442801282,2442801282,0
1362021664,2443042180,1,52,52,1362021636345,1362021636345,2443014525,2443014525,0
1362022551,2443929560,1,48,48,1362022523058,1362022523058,2443901618,2443901618,0
1362022746,2444124444,1,168,168,1362022721504,1362022721504,2444099948,2444099948,0
1362023120,2444498088,15,6289,419.2666667,1362023104191,1362023116287,2444482279,2444494375,12096
1362023120,2444498096,11,953,86.63636364,1362023104697,1362023116281,2444482793,2444494377,11584
1362023120,2444498172,12,999,83.25,1362023104876,1362023116140,2444483048,2444494312,11264
1362023120,2444498172,12,999,83.25,1362023105130,1362023116138,2444483302,2444494310,11008
1362024922,2446300036,12,999,83.25,1362024910104,1362024921368,2446288140,2446299404,11264
1362024922,2446300080,15,6289,419.2666667,1362024909292,1362024921388,2446287372,2446299468,12096
1362024922,2446300088,12,999,83.25,1362024909796,1362024921380,2446287884,2446299468,11584
1362024922,2446300092,12,999,83.25,1362024910304,1362024921312,2446288396,2446299404,11008
1362024990,2446368132,1,46,46,1362024963897,1362024963897,2446342029,2446342029,0
1362025002,2446380328,5,2228,445.6,1362024994804,1362024995124,2446373132,2446373452,320
1362025002,2446380328,5,2228,445.6,1362024994802,1362024994994,2446373130,2446373322,192
1362025002,2446380328,5,2228,445.6,1362024994802,1362024995058,2446373130,2446373386,256
1362025002,2446380336,5,2831,566.2,1362024995629,1362024995821,2446373965,2446374157,192
1362025002,2446380400,5,2228,445.6,1362024994730,1362024995050,2446373130,2446373450,320
1362025002,2446380400,5,2161,432.2,1362024994730,1362024995050,2446373130,2446373450,320
1362025002,2446380404,5,2831,566.2,1362024995558,1362024995686,2446373962,2446374090,128
1362025002,2446380404,5,2831,566.2,1362024995558,1362024995750,2446373962,2446374154,192
1362025010,2446388344,11,6228,566.1818182,1362024995045,1362025006821,2446373389,2446385165,11776
1362025010,2446388344,9,3692,410.2222222,1362024995108,1362025006820,2446373452,2446385164,11712
1362025010,2446388344,10,4961,496.1,1362024995044,1362025006820,2446373388,2446385164,11776
1362025010,2446388344,11,3855,350.4545455,1362024995235,1362025006755,2446373579,2446385099,11520
1362025010,2446388344,7,1730,247.1428571,1362024995426,1362025006818,2446373770,2446385162,11392
1362025010,2446388348,23,7552,328.3478261,1362024995808,1362025006816,2446374156,2446385164,11008
1362025010,2446388348,11,953,86.63636364,1362024996063,1362025007071,2446374411,2446385419,11008
1362025010,2446388372,11,953,86.63636364,1362024996294,1362025007046,2446374666,2446385418,10752
1362025010,2446388376,16,6372,398.25,1362024996866,1362025007042,2446375242,2446385418,10176
1362025010,2446388380,5,2831,566.2,1362025008577,1362025008833,2446386957,2446387213,256
1362025010,2446388424,12,999,83.25,1362024995282,1362025007058,2446373706,2446385482,11776
1362025010,2446388424,7,1724,246.2857143,1362024995154,1362025006738,2446373578,2446385162,11584
1362025010,2446388428,22,7475,339.7727273,1362024995727,1362025006735,2446374155,2446385163,11008
1362025010,2446388428,19,9919,522.0526316,1362024995726,1362025006734,2446374154,2446385162,11008
1362025018,2446396404,5,2831,566.2,1362025014631,1362025014823,2446393035,2446393227,192
1362025018,2446396480,5,2151,430.2,1362025014621,1362025014749,2446393101,2446393229,128
1362025034,2446412320,19,8450,444.7368421,1362025008893,1362025026685,2446387213,2446405005,17792
1362025034,2446412400,12,3732,311,1362025014889,1362025026601,2446393289,2446405001,11712
1362025034,2446412476,60,34041,567.35,1362025014749,1362025033053,2446393225,2446411529,18304
1362025042,2446420456,13,2659,204.5384615,1362025028595,1362025038515,2446407051,2446416971,9920
1362025050,2446428228,63,16438,260.9206349,1362025021973,1362025045781,2446400201,2446424009,23808
1362025058,2446436208,49,11671,238.1836735,1362025033196,1362025054060,2446411404,2446432268,20864
1362025058,2446436208,19,6289,331,1362025033260,1362025050796,2446411468,2446429004,17536
1362025058,2446436432,6,456,76,1362025050955,1362025051083,2446429387,2446429515,128
1362025058,2446436432,13,3813,293.3076923,1362025051083,1362025051787,2446429515,2446430219,704
1362025066,2446444460,6,456,76,1362025060847,1362025060975,2446439307,2446439435,128
1362025066,2446444516,57,13637,239.245614,1362025049398,1362025062454,2446427914,2446440970,13056
1362025078,2446456224,30,4722,157.4,1362025053464,1362025072152,2446431688,2446450376,18688
1362025078,2446456332,42,10950,260.7142857,1362025053231,1362025072559,2446431563,2446450891,19328
1362025082,2446460468,12,3886,323.8333333,1362025062694,1362025080806,2446441162,2446459274,18112
1362025082,2446460556,4,220,55,1362025080399,1362025080463,2446458955,2446459019,64
1362025090,2446468576,43,10144,235.9069767,1362025073020,1362025086396,2446451596,2446464972,13376
1362025122,2446500628,8,882,110.25,1362025106887,1362025116359,2446485515,2446494987,9472
1362025126,2446504356,33,7719,233.9090909,1362025099093,1362025125781,2446477449,2446504137,26688
1362025134,2446512396,23,5822,253.1304348,1362025106924,1362025130860,2446485320,2446509256,23936
1362025138,2446516560,29,6651,229.3448276,1362025126792,1362025134408,2446505352,2446512968,7616
1362025138,2446516600,16,3246,202.875,1362025125599,1362025135967,2446504199,2446514567,10368
1362025146,2446524612,19,5213,274.3684211,1362025119828,1362025145620,2446498440,2446524232,25792
1362025155,2446532828,2,112,56,1362025151398,1362025151398,2446529226,2446529226,0
1362025155,2446532860,31,6056,195.3548387,1362025136454,1362025153094,2446514314,2446530954,16640
1362025163,2446540796,27,6164,228.2962963,1362025151430,1362025159174,2446529226,2446536970,7744
1362025164,2446542696,17,4365,256.7647059,1362025145666,1362025154370,2446524362,2446533066,8704
1362025171,2446548968,5,2831,566.2,1362025165403,1362025165531,2446543371,2446543499,128
1362025171,2446549056,5,2228,445.6,1362025165312,1362025165440,2446543368,2446543496,128
1362025174,2446552612,33,6090,184.5454545,1362025145941,1362025166549,2446524553,2446545161,20608
1362025179,2446556880,9,3692,410.2222222,1362025165617,1362025177073,2446543497,2446554953,11456
1362025179,2446556880,15,6608,440.5333333,1362025165617,1362025177137,2446543497,2446555017,11520
1362025182,2446560584,20,5875,293.75,1362025157746,1362025178866,2446536330,2446557450,21120
1362025187,2446564880,27,6152,227.8518519,1362025172847,1362025183087,2446550727,2446560967,10240
1362025202,2446580544,27,5996,222.0740741,1362025174296,1362025197144,2446552840,2446575688,22848
1362025203,2446580952,8,886,110.75,1362025189737,1362025201321,2446567689,2446579273,11584
1362025211,2446588904,14,2211,157.9285714,1362025189591,1362025207063,2446567495,2446584967,17472
1362025211,2446588916,27,6152,227.8518519,1362025194764,1362025207052,2446572680,2446584968,12288
1362025214,2446592596,18,3919,217.7222222,1362025188902,1362025197606,2446567498,2446576202,8704
1362025214,2446592684,2,104,52,1362025188301,1362025188301,2446566985,2446566985,0
1362025227,2446604912,9,1661,184.5555556,1362025217617,1362025225041,2446595529,2446602953,7424
1362025227,2446604912,8,874,109.25,1362025218254,1362025225038,2446596166,2446602950,6784
1362025235,2446612936,14,2170,155,1362025218105,1362025231353,2446596041,2446609289,13248
1362025242,2446620676,24,4953,206.375,1362025217493,1362025231253,2446596169,2446609929,13760
1362025243,2446620800,1,60,60,1362025218431,1362025218431,2446596231,2446596231,0
1362025251,2446629020,25,5653,226.12,1362025238051,1362025248931,2446616071,2446626951,10880
1362025251,2446629064,8,874,109.25,1362025231478,1362025242870,2446609542,2446620934,11392
1362025275,2446653080,8,895,111.875,1362025257384,1362025266920,2446635464,2446645000,9536
1362025275,2446653080,8,874,109.25,1362025257512,1362025266920,2446635592,2446645000,9408
1362025282,2446660876,20,5001,250.05,1362025256714,1362025276362,2446635590,2446655238,19648
1362025290,2446668996,8,874,109.25,1362025275411,1362025283987,2446654407,2446662983,8576
1362025291,2446669024,15,3158,210.5333333,1362025277470,1362025284958,2446655494,2446662982,7488
1362025291,2446669072,8,895,111.875,1362025276207,1362025284911,2446654279,2446662983,8704
1362025314,2446692964,6,878,146.3333333,1362025288690,1362025304562,2446667654,2446683526,15872
1362025315,2446693104,6,770,128.3333333,1362025289423,1362025289551,2446667527,2446667655,128
1362025323,2446701228,21,4655,221.6666667,1362025309266,1362025320722,2446687494,2446698950,11456
1362025323,2446701272,8,882,110.25,1362025307109,1362025314789,2446685381,2446693061,7680
1362025323,2446701272,8,903,112.875,1362025307048,1362025314856,2446685320,2446693128,7808
1362025323,2446701312,27,7480,277.037037,1362025304958,1362025318654,2446683270,2446696966,13696
1362025323,2446701312,21,5476,260.7619048,1362025304957,1362025314813,2446683269,2446693125,9856
1362025339,2446717368,8,903,112.875,1362025325256,1362025332616,2446703624,2446710984,7360
1362025339,2446717368,8,882,110.25,1362025325256,1362025332616,2446703624,2446710984,7360
1362025339,2446717368,8,903,112.875,1362025325254,1362025332614,2446703622,2446710982,7360
1362025343,2446721092,24,6732,280.5,1362025317658,1362025334682,2446695750,2446712774,17024
1362025347,2446725252,8,903,112.875,1362025333817,1362025344697,2446712069,2446722949,10880
1362025347,2446725252,8,894,111.75,1362025333817,1362025345017,2446712069,2446723269,11200
1362025347,2446725300,8,903,112.875,1362025333772,1362025344652,2446712072,2446722952,10880
1362025347,2446725304,23,5154,224.0869565,1362025337479,1362025344711,2446715783,2446723015,7232
1362025379,2446757324,5,2228,445.6,1362025378163,1362025378355,2446756487,2446756679,192
1362025379,2446757324,8,882,110.25,1362025362736,1362025377648,2446741060,2446755972,14912
1362025379,2446757360,6,3996,666,1362025376525,1362025376781,2446754885,2446755141,256
1362025379,2446757428,5,2831,566.2,1362025378121,1362025378249,2446756549,2446756677,128
1362025387,2446765036,15,1922,128.1333333,1362025362514,1362025379602,2446740550,2446757638,17088
1362025387,2446765320,6,3996,666,1362025379766,1362025380086,2446758086,2446758406,320
1362025387,2446765344,6,3996,666,1362025379742,1362025380062,2446758086,2446758406,320
1362025395,2446773332,10,4955,495.5,1362025378344,1362025392680,2446756676,2446771012,14336
1362025395,2446773336,18,2358,131,1362025378917,1362025387045,2446757253,2446765381,8128
1362025395,2446773340,15,3158,210.5333333,1362025382818,1362025392610,2446761158,2446770950,9792
1362025395,2446773340,7,2448,349.7142857,1362025387297,1362025387361,2446765637,2446765701,64
1362025395,2446773384,6,2481,413.5,1362025381814,1362025393846,2446760198,2446772230,12032
1362025403,2446781000,14,5387,384.7857143,1362025377142,1362025380662,2446755142,2446758662,3520
1362025403,2446781036,30,12221,407.3666667,1362025378706,1362025398930,2446756742,2446776966,20224
1362025403,2446781108,1,60,60,1362025376841,1362025376841,2446754949,2446754949,0
1362025403,2446781296,5,2831,566.2,1362025399629,1362025399757,2446777925,2446778053,128
1362025403,2446781380,16,4726,295.375,1362025382330,1362025398586,2446760710,2446776966,16256
1362025403,2446781428,23,14766,642,1362025386183,1362025395591,2446764611,2446774019,9408
1362025403,1085096080,18,21928,1218.222222,1362025384334,1362025395278,1085077414,1085088358,10944
1362025407,2446784992,1,60,60,1362025380157,1362025380157,2446758149,2446758149,0
1362025407,2446785024,5,3944,788.8,1362025380316,1362025380444,2446758340,2446758468,128
1362025407,2446785028,5,3942,788.4,1362025380377,1362025380505,2446758405,2446758533,128
1362025407,2446785124,5,3942,788.4,1362025380282,1362025380794,2446758406,2446758918,512
1362025411,2446789364,5,2580,516,1362025408201,1362025408329,2446786565,2446786693,128
1362025419,2446797380,12,2579,214.9166667,1362025407289,1362025417529,2446785669,2446795909,10240
1362025419,2446797460,7,1162,166,1362025403880,1362025411432,2446782340,2446789892,7552
1362025419,2446797464,39,13406,343.7435897,1362025399590,1362025417446,2446778054,2446795910,17856
1362025435,2446813328,5,663,132.6,1362025427436,1362025432812,2446805764,2446811140,5376
1362025435,2446813404,2634,3859398,1465.223235,1362025408289,1362025429793,2446786693,2446808197,21504
1362025459,2446837708,1,52,52,1362025432497,1362025432497,2446811205,2446811205,0
1362025459,2446837708,1,52,52,1362025432496,1362025432496,2446811204,2446811204,0
1362025459,2446837708,1,52,52,1362025432496,1362025432496,2446811204,2446811204,0
1362025460,2446837828,1,52,52,1362025433377,1362025433377,2446811205,2446811205,0
1362025534,2446912564,4,208,52,1362025529086,1362025530814,2446907650,2446909378,1728
1362025559,2446937612,1,52,52,1362025532750,1362025532750,2446911362,2446911362,0
1362026822,2448199884,15,6289,419.2666667,1362026801110,1362026821718,2448178994,2448199602,20608
1362026827,2448205176,10,907,90.7,1362026801265,1362026820465,2448179441,2448198641,19200
1362026827,2448205176,8,815,101.875,1362026801582,1362026801838,2448179758,2448180014,256
1362026827,2448205316,9,861,95.66666667,1362026801828,1362026802148,2448180144,2448180464,320
1362026837,2448215720,11,953,86.63636364,1362026824079,1362026835599,2448202799,2448214319,11520
1362026837,2448215744,11,953,86.63636364,1362026824312,1362026835576,2448203056,2448214320,11264
1362026838,2448215788,11,953,86.63636364,1362026824437,1362026836533,2448202225,2448214321,12096
1362026838,2448215792,12,999,83.25,1362026824753,1362026836529,2448202545,2448214321,11776
1362027014,2448391980,3,189,63,1362027010416,1362027013424,2448388396,2448391404,3008
1362027030,2448408004,2,126,63,1362027017498,1362027025498,2448395502,2448403502,8000
1362027070,2448447968,3,189,63,1362027063932,1362027066940,2448441900,2448444908,3008
1362027086,2448464320,2,126,63,1362027070619,1362027078683,2448448939,2448457003,8064
1362027102,2448480108,2,126,63,1362027099313,1362027100337,2448477421,2448478445,1024
1362027110,2448487988,2,126,63,1362027102438,1362027106470,2448480426,2448484458,4032
1362027140,2448517940,1,63,63,1362027114582,1362027114582,2448492522,2448492522,0
1362027462,2448840252,12,999,83.25,1362027444314,1362027454106,2448822566,2448832358,9792
1362027462,2448840256,11,953,86.63636364,1362027444568,1362027454104,2448822824,2448832360,9536
1362027462,2448840324,17,6755,397.3529412,1362027443923,1362027454035,2448822247,2448832359,10112
1362027542,2448920304,12,999,83.25,1362027528486,1362027540198,2448906790,2448918502,11712
1362027542,2448920348,12,999,83.25,1362027528057,1362027540153,2448906405,2448918501,12096
1362027542,2448920356,11,953,86.63636364,1362027528690,1362027540146,2448907046,2448918502,11456
1362027542,2448920376,12,999,83.25,1362027528923,1362027540123,2448907299,2448918499,11200
1362027590,2448968424,12,999,83.25,1362027570862,1362027582446,2448949286,2448960870,11584
1362027590,2448968472,11,953,86.63636364,1362027570300,1362027582396,2448948772,2448960868,12096
1362027590,2448968476,12,999,83.25,1362027570553,1362027582393,2448949029,2448960869,11840
1362027590,2448968508,12,999,83.25,1362027571034,1362027582362,2448949542,2448960870,11328
1362027622,2449000448,11,953,86.63636364,1362027605907,1362027618003,2448984355,2448996451,12096
1362027622,2449000452,12,999,83.25,1362027606160,1362027618000,2448984612,2448996452,11840
1362027622,2449000480,11,953,86.63636364,1362027606387,1362027617907,2448984867,2448996387,11520
1362027622,2449000488,11,953,86.63636364,1362027606699,1362027617899,2448985187,2448996387,11200
1362027697,2449075248,8,815,101.875,1362027672603,1362027672795,2449050851,2449051043,192
1362027701,2449079104,9,861,95.66666667,1362027673002,1362027673258,2449051106,2449051362,256
1362027701,2449079108,8,815,101.875,1362027673318,1362027673574,2449051426,2449051682,256
1362027701,2449079116,8,815,101.875,1362027673629,1362027673821,2449051745,2449051937,192
1362027782,2449160484,12,999,83.25,1362027768751,1362027778735,2449147235,2449157219,9984
1362027782,2449160536,12,999,83.25,1362027769018,1362027778682,2449147554,2449157218,9664
1362027934,2449312640,2,126,63,1362027931344,1362027932368,2449309984,2449311008,1024
1362027942,2449320584,2,126,63,1362027934409,1362027938441,2449312993,2449317025,4032
1362027950,2449328568,4,252,63,1362027941208,1362027948248,2449319776,2449326816,7040
1362027950,2449328568,4,252,63,1362027941208,1362027948248,2449319776,2449326816,7040
1362027974,2449352040,1,63,63,1362027947046,1362027947046,2449325086,2449325086,0
1362027982,2449359984,1,63,63,1362027956893,1362027956893,2449334877,2449334877,0
1362027982,2449360088,1,63,63,1362027956791,1362027956791,2449334879,2449334879,0
1362027998,2449376636,4,252,63,1362027989393,1362027996433,2449368029,2449375069,7040
1362028030,2449408296,1,63,63,1362028004839,1362028004839,2449383135,2449383135,0
1362028170,2449548676,1,46,46,1362028144552,1362028144552,2449523228,2449523228,0
1362028175,2449552876,17,6755,397.3529412,1362028160712,1362028172808,2449538588,2449550684,12096
1362028175,2449552880,12,999,83.25,1362028161413,1362028172805,2449539293,2449550685,11392
1362028175,2449552944,11,953,86.63636364,1362028161027,1362028172739,2449538971,2449550683,11712
1362028175,2449552948,12,999,83.25,1362028161663,1362028172671,2449539611,2449550619,11008
1362028191,2449568896,11,3267,297,1362028165300,1362028167604,2449543196,2449545500,2304
1362028472,2449849852,2,141,70.5,1362028464988,1362028464988,2449842840,2449842840,0
1362028491,2449869604,11,3267,297,1362028463595,1362028464299,2449842199,2449842903,704
1362028673,2450051576,1,48,48,1362028645443,1362028645443,2450024019,2450024019,0
1362028676,2450054288,1,446,446,1362028649445,1362028649445,2450027733,2450027733,0
1362028720,2450098220,1,60,60,1362028694630,1362028694630,2450072850,2450072850,0
1362028785,2450163180,2,141,70.5,1362028777232,1362028777232,2450155412,2450155412,0
1362028800,2450178604,9,3163,351.4444444,1362028774308,1362028776932,2450152912,2450155536,2624
1362029161,2450539628,11,3267,297,1362029135818,1362029136778,2450514446,2450515406,960
1362029161,2450539744,2,141,70.5,1362029136339,1362029136339,2450515083,2450515083,0
1362029410,2450788396,2,141,70.5,1362029403372,1362029403372,2450781768,2450781768,0
1362029995,2451372792,12,6151,512.5833333,1362029966978,1362029967362,2451344770,2451345154,384
1362029995,2451372796,9,861,95.66666667,1362029967482,1362029967802,2451345278,2451345598,320
1362029995,2451372888,9,861,95.66666667,1362029967777,1362029967969,2451345665,2451345857,192
1362029995,2451372920,8,815,101.875,1362029968001,1362029968193,2451345921,2451346113,192
1362030155,2451533340,3,189,63,1362030148952,1362030152024,2451527292,2451530364,3072
1362030171,2451549380,2,126,63,1362030156017,1362030164017,2451534397,2451542397,8000
1362030235,2451613540,3,189,63,1362030229391,1362030232399,2451607931,2451610939,3008
1362030251,2451629616,2,126,63,1362030236356,1362030244420,2451614972,2451623036,8064
1362030267,2451645696,2,126,63,1362030264307,1362030265331,2451643003,2451644027,1024
1362030275,2451653732,2,126,63,1362030267280,1362030271312,2451646012,2451650044,4032
1362030307,2451685528,1,63,63,1362030279580,1362030279580,2451658108,2451658108,0
1362030307,2451685720,3,189,63,1362030302426,1362030305434,2451681146,2451684154,3008
1362030315,2451693692,1,84,84,1362030289206,1362030289206,2451667898,2451667898,0
1362030323,2451701720,2,126,63,1362030309467,1362030317531,2451688187,2451696251,8064
1362030793,2452170948,3,138,46,1362030765017,1362030768985,2452142965,2452146933,3968
1362030861,2452239028,9,861,95.66666667,1362030834633,1362030834761,2452212661,2452212789,128
1362030861,2452239108,14,6617,472.6428571,1362030834168,1362030834488,2452212276,2452212596,320
1362030861,2452239136,9,861,95.66666667,1362030834779,1362030834971,2452212915,2452213107,192
1362031076,2452454276,3,189,63,1362031070094,1362031073166,2452448370,2452451442,3072
1362031084,2452462308,4,252,63,1362031076138,1362031083242,2452454446,2452461550,7104
1362031092,2452470272,4,201,50.25,1362031084624,1362031084688,2452462896,2452462960,64
1362031092,2452470276,5,264,52.8,1362031077133,1362031084685,2452455409,2452462961,7552
1362031092,2452470312,3,138,46,1362031084583,1362031084647,2452462895,2452462959,64
1362031113,2452491736,9,861,95.66666667,1362031085887,1362031086143,2452464623,2452464879,256
1362031113,2452491740,9,861,95.66666667,1362031086203,1362031086395,2452464943,2452465135,192
1362031113,2452491768,8,815,101.875,1362031086688,1362031086880,2452465456,2452465648,192
1362031114,2452491844,1,46,46,1362031086908,1362031086908,2452464752,2452464752,0
1362031114,2452491852,9,861,95.66666667,1362031087349,1362031087541,2452465201,2452465393,192
1362031372,2452750432,3,189,63,1362031367531,1362031370539,2452745963,2452748971,3008
1362031388,2452766380,2,126,63,1362031374622,1362031382686,2452753002,2452761066,8064
1362031396,2452774420,3,189,63,1362031390198,1362031393270,2452768618,2452771690,3072
1362031412,2452790572,2,126,63,1362031397149,1362031405149,2452775721,2452783721,8000
1362031420,2452798456,4,252,63,1362031412691,1362031419731,2452791147,2452798187,7040
1362031420,2452798456,4,252,63,1362031412754,1362031419794,2452791210,2452798250,7040
1362031454,2452832464,1,63,63,1362031427850,1362031427850,2452806314,2452806314,0
1362031454,2452832544,1,63,63,1362031427707,1362031427707,2452806251,2452806251,0
1362031861,2453238776,12,999,83.25,1362031850742,1362031860470,2453228518,2453238246,9728
1362031861,2453238776,12,999,83.25,1362031851061,1362031860469,2453228837,2453238245,9408
1362031861,2453238780,11,953,86.63636364,1362031851440,1362031860464,2453229220,2453238244,9024
1362032069,2453446820,12,999,83.25,1362032055363,1362032066883,2453433183,2453444703,11520
1362032069,2453446864,15,6289,419.2666667,1362032054809,1362032066841,2453432673,2453444705,12032
1362032069,2453446872,12,999,83.25,1362032055569,1362032066833,2453433441,2453444705,11264
1362032069,2453446876,11,953,86.63636364,1362032055823,1362032066831,2453433699,2453444707,11008
1362032079,2453457264,1,46,46,1362032054345,1362032054345,2453432609,2453432609,0
1362032197,2453575048,12,999,83.25,1362032180447,1362032192287,2453558495,2453570335,11840
1362032197,2453575048,12,999,83.25,1362032180765,1362032192221,2453558813,2453570269,11456
1362032197,2453575080,11,953,86.63636364,1362032180991,1362032192191,2453559071,2453570271,11200
1362032197,2453575088,12,999,83.25,1362032180150,1362032192246,2453558238,2453570334,12096
1362032629,2454007676,11,953,86.63636364,1362032619362,1362032628322,2453998038,2454006998,8960
1362032629,2454007680,17,6755,397.3529412,1362032618978,1362032628322,2453997658,2454007002,9344
1362032629,2454007684,12,999,83.25,1362032619803,1362032628315,2453998487,2454006999,8512
1362032724,2454102376,1,46,46,1362032697294,1362032697294,2454075670,2454075670,0
1362033606,2454984120,9,861,95.66666667,1362033579969,1362033580161,2454958089,2454958281,192
1362033606,2454984120,9,861,95.66666667,1362033580288,1362033580480,2454958408,2454958600,192
1362033606,2454984168,9,861,95.66666667,1362033579536,1362033579792,2454957704,2454957960,256
1362033754,2455132532,1,46,46,1362033726435,1362033726435,2455104967,2455104967,0
1362033826,2455204556,9,861,95.66666667,1362033800587,1362033800843,2455179143,2455179399,256
1362033826,2455204636,8,815,101.875,1362033799867,1362033800123,2455178503,2455178759,256
1362033826,2455204636,9,861,95.66666667,1362033800185,1362033800441,2455178821,2455179077,256
1362033826,2455204644,8,815,101.875,1362033800817,1362033801009,2455179461,2455179653,192
1362033855,2455232888,4,252,63,1362033847333,1362033854437,2455225221,2455232325,7104
1362033855,2455232940,3,189,63,1362033849072,1362033852080,2455227012,2455230020,3008
1362033871,2455248924,2,126,63,1362033856129,1362033864193,2455234053,2455242117,8064
1362033886,2455264696,1,63,63,1362033861627,1362033861627,2455240323,2455240323,0
1362033887,2455264916,2,126,63,1362033885002,1362033886026,2455262918,2455263942,1024
1362033895,2455272920,2,126,63,1362033888070,1362033892102,2455265990,2455270022,4032
1362033926,2455304700,1,63,63,1362033899321,1362033899321,2455278021,2455278021,0
1362034039,2455417056,2,126,63,1362034037498,1362034038522,2455415554,2455416578,1024
1362034047,2455425124,2,126,63,1362034040438,1362034044470,2455418562,2455422594,4032
1362034078,2455456740,1,63,63,1362034051918,1362034051918,2455430658,2455430658,0
1362034079,2455457088,3,189,63,1362034073242,1362034076250,2455451330,2455454338,3008
1362034095,2455473096,2,126,63,1362034080273,1362034088337,2455458369,2455466433,8064
1362034103,2455481076,4,252,63,1362034095461,1362034102501,2455473537,2455480577,7040
1362034103,2455481120,4,252,63,1362034095354,1362034102394,2455473474,2455480514,7040
1362034135,2455512920,1,63,63,1362034110657,1362034110657,2455488577,2455488577,0
1362034135,2455512920,1,63,63,1362034110720,1362034110720,2455488640,2455488640,0
1362034528,2455906324,1,46,46,1362034500712,1362034500712,2455879036,2455879036,0
1362035393,2456771220,14,6617,472.6428571,1362035368643,1362035369027,2456746863,2456747247,384
1362035397,2456775144,9,861,95.66666667,1362035369230,1362035369358,2456747374,2456747502,128
1362035397,2456775224,9,861,95.66666667,1362035369408,1362035369600,2456747632,2456747824,192
1362035397,2456775224,8,815,101.875,1362035369726,1362035369982,2456747950,2456748206,256
1362035525,2456903512,6,384,64,1362035496988,1362035501916,2456875500,2456880428,4928
1362035525,2456903596,6,384,64,1362035498056,1362035502920,2456876652,2456881516,4864
1362035525,2456903604,9,544,60.44444444,1362035499136,1362035518144,2456877740,2456896748,19008
1362035525,2456903608,5,320,64,1362035499134,1362035503166,2456877742,2456881774,4032
1362035561,2456939580,1,48,48,1362035534425,1362035534425,2456913005,2456913005,0
1362035593,2456970988,3,189,63,1362035586409,1362035589417,2456964397,2456967405,3008
1362035593,2456971024,3,189,63,1362035586114,1362035589186,2456964138,2456967210,3072
1362035609,2456987160,2,126,63,1362035593082,1362035601146,2456971242,2456979306,8064
1362035609,2456987164,2,126,63,1362035593273,1362035601337,2456971437,2456979501,8064
1362035665,2457043044,3,189,63,1362035660591,1362035663599,2457038635,2457041643,3008
1362035673,2457051120,3,189,63,1362035668004,1362035671012,2457046124,2457049132,3008
1362035681,2457059088,2,126,63,1362035667588,1362035675652,2457045676,2457053740,8064
1362035689,2457067080,2,126,63,1362035675083,1362035683147,2457053163,2457061227,8064
1362037170,2458547928,17,6895,405.5882353,1362037159245,1362037169805,2458537173,2458547733,10560
1362037170,2458547928,12,999,83.25,1362037160011,1362037169867,2458537939,2458547795,9856
1362037170,2458547932,12,999,83.25,1362037160582,1362037169862,2458538514,2458547794,9280
1362037170,2458547964,17,6755,397.3529412,1362037159592,1362037169832,2458537556,2458547796,10240
1362037170,2458547964,12,999,83.25,1362037160231,1362037169831,2458538195,2458547795,9600
1362037185,2458562924,1,46,46,1362037158289,1362037158289,2458536213,2458536213,0
1362037205,2458583056,2,152,76,1362037179722,1362037194826,2458557778,2458572882,15104
1362037237,2458615120,2,152,76,1362037209802,1362037224778,2458587922,2458602898,14976
1362037265,2458643320,1,76,76,1362037239681,1362037239681,2458618001,2458618001,0
1362037317,2458695448,1,46,46,1362037292354,1362037292354,2458670802,2458670802,0
1362037462,2458839956,1,60,60,1362037435242,1362037435242,2458813198,2458813198,0
1362038671,2460049104,1,58,58,1362038646214,1362038646214,2460024318,2460024318,0
1362038739,2460117444,16,6709,419.3125,1362038722864,1362038734384,2460101308,2460112828,11520
1362038739,2460117448,12,999,83.25,1362038723310,1362038734446,2460101758,2460112894,11136
1362038739,2460117464,13,1045,80.38461538,1362038723548,1362038734428,2460102012,2460112892,10880
1362038739,2460117484,14,1091,77.92857143,1362038725958,1362038734406,2460104442,2460112890,8448
1362038743,1098436008,5,574,114.8,1362038738605,1362038738925,1098431613,1098431933,320
1362038751,2460129296,2,152,76,1362038725507,1362038740547,2460103803,2460118843,15040
1362038795,2460173564,2,152,76,1362038770424,1362038785464,2460148988,2460164028,15040
1362039035,2460413648,3,144,48,1362039009247,1362039018591,2460387895,2460397239,9344
1362039095,2460473688,1,46,46,1362039068215,1362039068215,2460446903,2460446903,0
1362039680,2461058528,1,46,46,1362039651983,1362039651983,2461030511,2461030511,0
1362040549,2461927668,12,999,83.25,1362040538355,1362040545267,2461917023,2461923935,6912
1362040549,2461927704,12,999,83.25,1362040538767,1362040545231,2461917471,2461923935,6464
1362040557,2461935696,11,953,86.63636364,1362040539096,1362040551256,2461917792,2461929952,12160
1362040558,2461936208,2,152,76,1362040532033,1362040547073,2461910241,2461925281,15040
1362040566,2461944240,1,46,46,1362040538977,1362040538977,2461917217,2461917217,0
1362040586,2461964576,2,152,76,1362040561746,1362040576786,2461940322,2461955362,15040
1362040618,2461996584,1,76,76,1362040591817,1362040591817,2461970401,2461970401,0
1362040782,2462159900,12,999,83.25,1362040767986,1362040780146,2462145886,2462158046,12160
1362040782,2462159900,12,999,83.25,1362040768305,1362040780081,2462146205,2462157981,11776
1362040782,2462159936,12,999,83.25,1362040768589,1362040780045,2462146525,2462157981,11456
1362040782,2462159940,12,999,83.25,1362040768907,1362040780043,2462146847,2462157983,11136
1362040799,2462177052,2,152,76,1362040772185,1362040787225,2462150237,2462165277,15040
1362040827,2462205248,2,152,76,1362040802067,1362040817107,2462180315,2462195355,15040
1362040859,2462237160,1,76,76,1362040832235,1362040832235,2462210395,2462210395,0
1362041764,2463142576,1,46,46,1362041736638,1362041736638,2463115214,2463115214,0
1362042302,2463679940,1,46,46,1362042275059,1362042275059,2463652999,2463652999,0
1362042426,2463804320,1,46,46,1362042399285,1362042399285,2463777605,2463777605,0
1362042575,2463953076,16,6372,398.25,1362042562792,1362042574888,2463940868,2463952964,12096
1362042575,2463953088,12,999,83.25,1362042563355,1362042574875,2463941443,2463952963,11520
1362042575,2463953088,11,953,86.63636364,1362042563610,1362042574874,2463941698,2463952962,11264
1362042575,2463953088,12,999,83.25,1362042563929,1362042574873,2463942017,2463952961,10944
1362042590,2463968512,2,152,76,1362042565296,1362042580336,2463943808,2463958848,15040
1362042622,2464000456,2,152,76,1362042595369,1362042610473,2463973825,2463988929,15104
1362042650,2464028520,1,76,76,1362042625448,1362042625448,2464003968,2464003968,0
1362042862,2464240648,1,46,46,1362042836580,1362042836580,2464215228,2464215228,0
1362043464,2464841808,12,999,83.25,1362043449828,1362043460388,2464827636,2464838196,10560
1362043464,2464841808,12,999,83.25,1362043450211,1362043460387,2464828019,2464838195,10176
1362043464,2464841812,11,953,86.63636364,1362043450531,1362043460387,2464828343,2464838199,9856
1362043475,2464853316,2,152,76,1362043450535,1362043465575,2464828851,2464843891,15040
1362043507,2464885256,2,152,76,1362043480677,1362043495717,2464858933,2464873973,15040
1362043535,2464913336,1,76,76,1362043510677,1362043510677,2464889013,2464889013,0
1362044261,2465638852,3,144,48,1362044233774,1362044242990,2465611626,2465620842,9216
1362045265,2466642928,12,1036,86.33333333,1362045264147,1362045264531,2466642075,2466642459,384
1362045273,2466650920,16,6372,398.25,1362045263513,1362045271385,2466641433,2466649305,7872
1362045303,2466680944,9,861,95.66666667,1362045278146,1362045278402,2466656090,2466656346,256
1362045303,2466680980,9,861,95.66666667,1362045276892,1362045277276,2466654872,2466655256,384
1362045303,2466680984,8,815,101.875,1362045277400,1362045277592,2466655384,2466655576,192
1362045303,2466680984,8,815,101.875,1362045277720,1362045277976,2466655704,2466655960,256
1362045505,2466883004,3,189,63,1362045500737,1362045503745,2466878741,2466881749,3008
1362045505,2466883004,3,189,63,1362045500800,1362045503808,2466878804,2466881812,3008
1362045521,2466899004,2,126,63,1362045507779,1362045515843,2466885783,2466893847,8064
1362045521,2466899004,2,126,63,1362045507843,1362045515843,2466885847,2466893847,8000
1362045529,2466907012,3,189,63,1362045521979,1362045524987,2466899991,2466902999,3008
1362045545,2466923000,2,126,63,1362045529031,1362045537031,2466907031,2466915031,8000
1362045577,2466955040,3,189,63,1362045572252,1362045575324,2466950292,2466953364,3072
1362045593,2466971052,2,126,63,1362045579346,1362045587346,2466957398,2466965398,8000
1362046128,2467506132,1,46,46,1362046103289,1362046103289,2467481421,2467481421,0
1362046765,2468143564,1,46,46,1362046740479,1362046740479,2468119043,2468119043,0
1362047094,2468472200,9,861,95.66666667,1362047068199,1362047068455,2468446399,2468446655,256
1362047094,2468472244,8,815,101.875,1362047068538,1362047068730,2468446782,2468446974,192
1362047094,2468472244,8,815,101.875,1362047068794,1362047069050,2468447038,2468447294,256
1362047379,2468756840,3,189,63,1362047375881,1362047378889,2468753721,2468756729,3008
1362047379,2468756840,2,126,63,1362047375881,1362047376905,2468753721,2468754745,1024
1362047379,2468756840,3,189,63,1362047372617,1362047375625,2468750457,2468753465,3008
1362047406,2468784680,1,63,63,1362047378112,1362047378112,2468756792,2468756792,0
1362047406,2468784692,8,815,101.875,1362047379382,1362047379574,2468758074,2468758266,192
1362047406,2468784696,8,815,101.875,1362047379954,1362047380210,2468758650,2468758906,256
1362047406,2468784728,1,63,63,1362047378771,1362047378771,2468757499,2468757499,0
1362047406,2468784728,9,861,95.66666667,1362047379026,1362047379218,2468757754,2468757946,192
1362047407,2468784732,8,815,101.875,1362047380595,1362047380851,2468758327,2468758583,256
1362047410,2468788672,1,63,63,1362047382088,1362047382088,2468760760,2468760760,0
1362047611,2468989180,3,189,63,1362047606320,1362047609328,2468984500,2468987508,3008
1362047611,2468989180,3,189,63,1362047606643,1362047609715,2468984823,2468987895,3072
1362047627,2469005208,2,126,63,1362047613718,1362047621718,2468991926,2468999926,8000
1362047627,2469005244,2,126,63,1362047613299,1362047621363,2468991543,2468999607,8064
1362047675,2469053220,4,252,63,1362047666763,1362047673803,2469044983,2469052023,7040
1362047675,2469053228,4,252,63,1362047666627,1362047673731,2469044855,2469051959,7104
1362047707,2469085616,1,63,63,1362047681470,1362047681470,2469060086,2469060086,0
1362047707,2469085652,1,63,63,1362047681370,1362047681370,2469060022,2469060022,0
1362048886,2470264144,9,861,95.66666667,1362048858372,1362048858564,2470236516,2470236708,192
1362048886,2470264148,8,815,101.875,1362048859069,1362048859325,2470237217,2470237473,256
1362048886,2470264184,9,861,95.66666667,1362048858587,1362048858843,2470236771,2470237027,256
1362049056,2470433840,1,46,46,1362049031024,1362049031024,2470408864,2470408864,0
1362049056,2470433868,1,46,46,1362049031059,1362049031059,2470408927,2470408927,0
1362049116,2470494144,2,126,63,1362049113664,1362049114688,2470491808,2470492832,1024
1362049116,2470494180,2,126,63,1362049113692,1362049114716,2470491872,2470492896,1024
1362049124,2470502144,2,126,63,1362049116733,1362049120765,2470494877,2470498909,4032
1362049124,2470502156,2,126,63,1362049116787,1362049120819,2470494943,2470498975,4032
1362049131,2470509044,1,46,46,1362049106213,1362049106213,2470484257,2470484257,0
1362049155,2470532940,1,63,63,1362049128970,1362049128970,2470506910,2470506910,0
1362049155,2470532944,1,63,63,1362049129032,1362049129032,2470506976,2470506976,0
1362049164,2470542216,2,126,63,1362049161400,1362049162424,2470539616,2470540640,1024
1362049172,2470550160,2,126,63,1362049164461,1362049168493,2470542621,2470546653,4032
1362049203,2470581032,1,63,63,1362049176686,1362049176686,2470554718,2470554718,0
1362049235,2470613296,7,896,128,1362049208421,1362049223653,2470586717,2470601949,15232
1362049267,2470645352,1,162,162,1362049239663,1362049239663,2470618015,2470618015,0
1362049299,2470677392,1,162,162,1362049271748,1362049271748,2470650140,2470650140,0
1362049347,2470725544,3,138,46,1362049322156,1362049331308,2470700700,2470709852,9152
1362049363,2470741472,1,162,162,1362049335923,1362049335923,2470714395,2470714395,0
1362049420,2470797828,1,46,46,1362049393527,1362049393527,2470771355,2470771355,0
1362049420,2470797828,9,861,95.66666667,1362049393718,1362049393974,2470771546,2470771802,256
1362049420,2470797832,9,861,95.66666667,1362049394033,1362049394289,2470771865,2470772121,256
1362049420,2470797832,8,815,101.875,1362049394356,1362049394548,2470772188,2470772380,192
1362049420,2470797876,8,815,101.875,1362049393223,1362049393607,2470771099,2470771483,384
1362049513,2470891308,1,60,60,1362049484566,1362049484566,2470862874,2470862874,0
1362049513,2470891312,1,60,60,1362049484562,1362049484562,2470862874,2470862874,0
1362049652,2471030596,3,189,63,1362049647925,1362049650933,2471026521,2471029529,3008
1362049652,2471030596,3,189,63,1362049648052,1362049651060,2471026648,2471029656,3008
1362049660,2471038608,4,252,63,1362049652839,1362049659879,2471031447,2471038487,7040
1362049668,2471046620,2,126,63,1362049654938,1362049663002,2471033558,2471041622,8064
1362049668,2471046624,2,126,63,1362049655061,1362049663125,2471033685,2471041749,8064
1362049693,2471070808,1,63,63,1362049668742,1362049668742,2471046550,2471046550,0
1362049724,2471102676,2,126,63,1362049721891,1362049722915,2471100567,2471101591,1024
1362049732,2471110624,2,126,63,1362049724948,1362049728980,2471103572,2471107604,4032
1362049765,2471142848,1,63,63,1362049737820,1362049737820,2471115668,2471115668,0
1362049949,2471327360,1,46,46,1362049924185,1362049924185,2471302545,2471302545,0
1362050454,2471832068,2,122,61,1362050428217,1362050430393,2471806285,2471808461,2176
1362050750,2472128600,1,46,46,1362050722143,1362050722143,2472100743,2472100743,0
1362051019,2472397056,9,861,95.66666667,1362050993466,1362050993658,2472371522,2472371714,192
1362051019,2472397056,8,815,101.875,1362050993721,1362050993913,2472371777,2472371969,192
1362051019,2472397080,8,815,101.875,1362050994019,1362050994211,2472372099,2472372291,192
1362051047,2472425028,2,122,61,1362051019221,1362051021461,2472397249,2472399489,2240
1362051123,2472501272,1,46,46,1362051097379,1362051097379,2472475651,2472475651,0
1362051237,2472615424,2,126,63,1362051234246,1362051235270,2472612670,2472613694,1024
1362051237,2472615428,2,126,63,1362051234373,1362051235397,2472612801,2472613825,1024
1362051245,2472623424,2,126,63,1362051237321,1362051241353,2472615745,2472619777,4032
1362051245,2472623432,2,126,63,1362051237374,1362051241406,2472615806,2472619838,4032
1362051275,2472653664,1,63,63,1362051249175,1362051249175,2472627839,2472627839,0
1362051275,2472653664,1,63,63,1362051249239,1362051249239,2472627903,2472627903,0
1362051293,2472671444,3,189,63,1362051288243,1362051291315,2472666687,2472669759,3072
1362051301,2472679444,2,92,46,1362051295282,1362051295282,2472673726,2472673726,0
1362051301,2472679444,2,92,46,1362051295282,1362051295282,2472673726,2472673726,0
1362051301,2472679456,2,109,54.5,1362051295269,1362051295333,2472673725,2472673789,64
1362051324,2472701936,9,861,95.66666667,1362051297135,1362051297391,2472675071,2472675327,256
1362051324,2472701936,9,861,95.66666667,1362051297452,1362051297708,2472675388,2472675644,256
1362051324,2472701940,8,815,101.875,1362051297771,1362051297963,2472675711,2472675903,192
1362051324,2472701976,8,815,101.875,1362051296773,1362051297029,2472674749,2472675005,256
1362051413,2472791476,7,2210,315.7142857,1362051409360,1362051410064,2472787836,2472788540,704
1362051413,2472791476,8,3137,392.125,1362051409424,1362051410896,2472787900,2472789372,1472
1362051419,1111111308,5,452,90.4,1362051412285,1362051413373,1111104593,1111105681,1088
1362051419,1111111308,4,1448,362,1362051412476,1362051412540,1111104784,1111104848,64
1362051421,2472799512,5,1257,251.4,1362051412907,1362051413163,2472791419,2472791675,256
1362051429,2472807504,12,3783,315.25,1362051411956,1362051423220,2472790460,2472801724,11264
1362051436,2472814088,1,108,108,1362051409940,1362051409940,2472788028,2472788028,0
1362051436,2472814132,1,108,108,1362051409705,1362051409705,2472787837,2472787837,0
1362051436,2472814132,1,108,108,1362051409832,1362051409832,2472787964,2472787964,0
1362051448,2472826092,12,3340,278.3333333,1362051423888,1362051445712,2472801980,2472823804,21824
1362051453,2472831500,9,1121,124.5555556,1362051445366,1362051447542,2472823866,2472826042,2176
1362051453,2472831512,6,798,133,1362051445674,1362051448042,2472824186,2472826554,2368
1362051459,1111151320,5,2109,421.8,1362051454000,1362051454064,1111146320,1111146384,64
1362051461,2472839536,7,1877,268.1428571,1362051455636,1362051459604,2472834172,2472838140,3968
1362051461,2472839544,4,724,181,1362051454285,1362051455501,2472832829,2472834045,1216
1362051461,2472839552,9,4483,498.1111111,1362051445379,1362051453251,2472823931,2472831803,7872
1362051467,1111159388,5,451,90.2,1362051465517,1362051466221,1111157905,1111158609,704
1362051467,1111159388,5,451,90.2,1362051463276,1362051463724,1111155664,1111156112,448
1362051469,2472847544,5,609,121.8,1362051464267,1362051464715,2472842811,2472843259,448
1362051469,2472847548,9,1913,212.5555556,1362051460553,1362051461129,2472839101,2472839677,576
1362051469,2472847548,9,1576,175.1111111,1362051445384,1362051462536,2472823932,2472841084,17152
1362051469,2472847548,10,1965,196.5,1362051461575,1362051462215,2472840123,2472840763,640
1362051469,2472847552,9,1913,212.5555556,1362051462660,1362051463172,2472841212,2472841724,512
1362051469,2472847556,12,4967,413.9166667,1362051465086,1362051465726,2472843642,2472844282,640
1362051469,2472847564,9,1913,212.5555556,1362051463161,1362051463865,2472841725,2472842429,704
1362051469,2472847596,11,5273,479.3636364,1362051463641,1362051464537,2472842237,2472843133,896
1362051477,2472855540,9,2617,290.7777778,1362051475921,1362051476625,2472854461,2472855165,704
1362051477,2472855544,10,1877,187.7,1362051473101,1362051474445,2472851645,2472852989,1344
1362051477,2472855544,11,4509,409.9090909,1362051469901,1362051471501,2472848445,2472850045,1600
1362051477,2472855544,10,2016,201.6,1362051465612,1362051473868,2472844156,2472852412,8256
1362051477,2472855544,11,2062,187.4545455,1362051466124,1362051469260,2472844668,2472847804,3136
1362051477,2472855548,10,1959,195.9,1362051474633,1362051475145,2472853181,2472853693,512
1362051477,2472855548,12,4735,394.5833333,1362051471943,1362051472711,2472850491,2472851259,768
1362051477,2472855556,5,609,121.8,1362051474240,1362051474624,2472852796,2472853180,384
1362051477,2472855556,9,1913,212.5555556,1362051474815,1362051475583,2472853371,2472854139,768
1362051480,2472858360,1,46,46,1362051454658,1362051454658,2472833018,2472833018,0
1362051483,1111175384,5,452,90.4,1362051475315,1362051475443,1111167699,1111167827,128
1362051485,2472863576,4,557,139.25,1362051475883,1362051477163,2472854459,2472855739,1280
1362051485,2472863580,13,5070,390,1362051477478,1362051479654,2472856058,2472858234,2176
1362051485,2472863584,9,2849,316.5555556,1362051481956,1362051482532,2472860540,2472861116,576
1362051491,1111183388,5,2732,546.4,1362051485423,1362051486383,1111177811,1111178771,960
1362051493,2472871580,5,609,121.8,1362051481384,1362051490920,2472859964,2472869500,9536
1362051499,1111191384,6,520,86.66666667,1362051491635,1362051492531,1111184019,1111184915,896
1362051501,2472879584,13,2235,171.9230769,1362051492066,1362051495458,2472870650,2472874042,3392
1362051501,2472879600,9,3310,367.7777778,1362051484819,1362051498003,2472863419,2472876603,13184
1362051501,2472879600,9,3345,371.6666667,1362051498130,1362051499474,2472876730,2472878074,1344
1362051502,1111194988,4,399,99.75,1362051477271,1362051477335,1111170259,1111170323,64
1362051509,2472887604,5,1266,253.2,1362051502352,1362051503184,2472880956,2472881788,832
1362051524,2472902396,1,64,64,1362051498334,1362051498334,2472876730,2472876730,0
1362051525,2472903652,2,126,63,1362051522717,1362051523741,2472901369,2472902393,1024
1362051525,2472903684,2,126,63,1362051522942,1362051523902,2472901626,2472902586,960
1362051532,2472910388,6,2384,397.3333333,1362051504040,1362051505832,2472882428,2472884220,1792
1362051533,2472911644,2,126,63,1362051525990,1362051530022,2472904634,2472908666,4032
1362051533,2472911656,2,126,63,1362051525723,1362051529755,2472904379,2472908411,4032
1362051552,2472930420,2,116,58,1362051526789,1362051527109,2472905209,2472905529,320
1362051557,2472935636,3,189,63,1362051549869,1362051552941,2472928505,2472931577,3072
1362051564,2472942444,1,63,63,1362051538288,1362051538288,2472916732,2472916732,0
1362051564,2472942480,1,63,63,1362051537993,1362051537993,2472916473,2472916473,0
1362051573,2472951652,2,126,63,1362051556957,1362051565021,2472935609,2472943673,8064
1362051597,2472975640,5,597,119.4,1362051594155,1362051595883,2472972795,2472974523,1728
1362051605,2472983652,4,252,63,1362051596831,1362051603871,2472975483,2472982523,7040
1362051611,1111303380,269,397525,1477.788104,1362051597685,1362051608565,1111290065,1111300945,10880
1362051629,2473007648,4,1045,261.25,1362051625506,1362051627234,2473004154,2473005882,1728
1362051635,1111327376,4,1044,261,1362051612922,1362051634170,1111305298,1111326546,21248
1362051637,2473014796,1,63,63,1362051612791,1362051612791,2472990587,2472990587,0
1362051643,1111335384,5,650,130,1362051635572,1362051635892,1111327956,1111328276,320
1362051643,1111335384,4,445,111.25,1362051636083,1362051636275,1111328467,1111328659,192
1362051761,2473138992,5,292,58.4,1362051736625,1362051757681,2473114617,2473135673,21056
1362051793,2473171280,1,52,52,1362051766350,1362051766350,2473144630,2473144630,0
1362051793,2473171312,2,112,56,1362051767725,1362051767725,2473146037,2473146037,0
1362051846,2473223884,2,92,46,1362051841754,1362051841882,2473219638,2473219766,128
1362051869,2473247348,1,46,46,1362051842697,1362051842697,2473221045,2473221045,0
1362051941,2473319684,1,46,46,1362051915959,1362051915959,2473294643,2473294643,0
1362051945,2473323660,1,46,46,1362051917391,1362051917391,2473296051,2473296051,0
1362052018,2473395832,1,46,46,1362051993226,1362051993226,2473371058,2473371058,0
1362052018,2473395844,1,46,46,1362051991807,1362051991807,2473369651,2473369651,0
1362052094,2473472108,1,46,46,1362052066549,1362052066549,2473444657,2473444657,0
1362052094,2473472120,1,46,46,1362052067948,1362052067948,2473446068,2473446068,0
1362052166,2473544240,1,46,46,1362052141360,1362052141360,2473519600,2473519600,0
1362052170,2473548180,1,46,46,1362052142893,1362052142893,2473521073,2473521073,0
1362052242,2473620264,1,46,46,1362052216344,1362052216344,2473594608,2473594608,0
1362052242,2473620296,1,46,46,1362052217784,1362052217784,2473596080,2473596080,0
1362052311,2473688712,1,46,46,1362052286525,1362052286525,2473664237,2473664237,0
1362052319,2473696728,1,46,46,1362052291888,1362052291888,2473669616,2473669616,0
1362052319,2473696736,1,46,46,1362052293352,1362052293352,2473671088,2473671088,0
1362052391,2473768860,1,46,46,1362052366760,1362052366760,2473744620,2473744620,0
1362052395,2473772888,1,46,46,1362052368206,1362052368206,2473746094,2473746094,0
1362052467,2473845116,1,52,52,1362052441512,1362052441512,2473819628,2473819628,0
1362052471,2473849144,1,46,46,1362052442956,1362052442956,2473821100,2473821100,0
1362052542,2473920652,11099,16478456,1484.67934,1362051481232,1362052538832,2472859884,2473917484,1057600
1362052543,2473921228,1,52,52,1362052517878,1362052517878,2473896106,2473896106,0
1362052807,2474185684,14,6617,472.6428571,1362052782124,1362052782444,2474160808,2474161128,320
1362052807,2474185688,9,861,95.66666667,1362052782504,1362052782696,2474161192,2474161384,192
1362052807,2474185692,8,815,101.875,1362052782819,1362052782947,2474161511,2474161639,128
1362052808,2474185728,15,6834,455.6,1362052782760,1362052783016,2474160488,2474160744,256
1362052811,2474189636,9,861,95.66666667,1362052783131,1362052783259,2474161767,2474161895,128
1362052991,2474369088,3,189,63,1362052987067,1362052990139,2474365155,2474368227,3072
1362052996,2474373864,1,46,46,1362052968924,1362052968924,2474346788,2474346788,0
1362053007,2474385072,2,126,63,1362052994187,1362053002251,2474372259,2474380323,8064
1362053044,2474422056,1,46,46,1362053016798,1362053016798,2474394854,2474394854,0
1362053047,2474425260,2,126,63,1362053044816,1362053045840,2474423076,2474424100,1024
1362053047,2474425260,2,126,63,1362053044815,1362053045839,2474423075,2474424099,1024
1362053047,2474425272,2,126,63,1362053044486,1362053045510,2474422758,2474423782,1024
1362053055,2474433292,2,126,63,1362053047855,1362053051887,2474426147,2474430179,4032
1362053055,2474433296,2,126,63,1362053047467,1362053051499,2474425763,2474429795,4032
1362053055,2474433304,2,126,63,1362053047843,1362053051875,2474426147,2474430179,4032
1362053084,2474462236,1,63,63,1362053059625,1362053059625,2474437861,2474437861,0
1362053088,2474466176,1,63,63,1362053060067,1362053060067,2474438243,2474438243,0
1362053088,2474466212,1,63,63,1362053060030,1362053060030,2474438242,2474438242,0
1362053103,2474481356,2,126,63,1362053101101,1362053102125,2474479457,2474480481,1024
1362053104,2474482248,1,46,46,1362053079514,1362053079514,2474457762,2474457762,0
1362053111,2474489340,2,126,63,1362053104191,1362053108223,2474482531,2474486563,4032
1362053144,2474522340,1,63,63,1362053116287,1362053116287,2474494627,2474494627,0
1362053157,2474535024,1,48,48,1362053132346,1362053132346,2474510370,2474510370,0
1362053157,2474535448,1,48,48,1362053131857,1362053131857,2474510305,2474510305,0
1362053357,2474734808,1,46,46,1362053331855,1362053331855,2474709663,2474709663,0
1362053621,2474999656,1,46,46,1362053596093,1362053596093,2474974749,2474974749,0
1362053641,2475019616,1,46,46,1362053614756,1362053614756,2474993372,2474993372,0
1362053842,2475220040,1,46,46,1362053815137,1362053815137,2475193177,2475193177,0
1362054006,2475384216,1,46,46,1362053978030,1362053978030,2475356246,2475356246,0
1362054079,2475457628,1,48,48,1362054049745,1362054049745,2475428373,2475428373,0
1362054081,2475458784,1,48,48,1362054050590,1362054050590,2475428374,2475428374,0
1362054174,2475552440,1,46,46,1362054148426,1362054148426,2475526866,2475526866,0
1362054211,2475588736,1,46,46,1362054185419,1362054185419,2475563155,2475563155,0
1362054267,2475644864,14,6617,472.6428571,1362054240904,1362054241224,2475618768,2475619088,320
1362054267,2475644868,9,861,95.66666667,1362054241284,1362054241604,2475619152,2475619472,320
1362054267,2475644912,9,861,95.66666667,1362054241626,1362054241818,2475619538,2475619730,192
1362054267,2475644928,8,815,101.875,1362054241929,1362054242249,2475619857,2475620177,320
1362054472,2475850132,3,189,63,1362054466618,1362054469690,2475844750,2475847822,3072
1362054472,2475850140,3,189,63,1362054466097,1362054469169,2475844237,2475847309,3072
1362054488,2475866160,2,126,63,1362054473180,1362054481180,2475851340,2475859340,8000
1362054488,2475866160,2,126,63,1362054473694,1362054481758,2475851854,2475859918,8064
1362054552,2475930176,3,189,63,1362054548686,1362054551758,2475926862,2475929934,3072
1362054568,2475946184,2,126,63,1362054555780,1362054563780,2475933964,2475941964,8000
1362054584,2475962200,4,252,63,1362054574966,1362054582006,2475953166,2475960206,7040
1362054616,2475993884,1,63,63,1362054590382,1362054590382,2475968266,2475968266,0
1362054664,2476042140,1,48,48,1362054636208,1362054636208,2476014348,2476014348,0
1362055666,2477044156,1,60,60,1362055641232,1362055641232,2477019388,2477019388,0
1362055678,2477056184,1,60,60,1362055653683,1362055653683,2477031867,2477031867,0
1362056059,2477437056,14,6617,472.6428571,1362056031663,1362056031983,2477409719,2477410039,320
1362056059,2477437064,8,815,101.875,1362056032359,1362056032551,2477410423,2477410615,192
1362056059,2477437128,9,861,95.66666667,1362056031976,1362056032232,2477410104,2477410360,256
1362056059,2477437132,9,861,95.66666667,1362056032545,1362056032737,2477410677,2477410869,192
1362056289,2477667680,4,252,63,1362056281596,1362056288636,2477660276,2477667316,7040
1362056290,2477667692,4,252,63,1362056282584,1362056289624,2477660276,2477667316,7040
1362056290,2477667716,2,126,63,1362056287359,1362056288319,2477665075,2477666035,960
1362056298,2477675684,2,126,63,1362056290400,1362056294432,2477668084,2477672116,4032
1362056323,2477701260,1,63,63,1362056297118,1362056297118,2477675378,2477675378,0
1362056323,2477701328,1,63,63,1362056297051,1362056297051,2477675379,2477675379,0
1362056327,2477705308,1,63,63,1362056301872,1362056301872,2477680180,2477680180,0
1362056362,2477739784,3,189,63,1362056358395,1362056361403,2477736179,2477739187,3008
1362056378,2477755780,2,126,63,1362056365439,1362056373503,2477743219,2477751283,8064
1362056945,2478322984,14,6617,472.6428571,1362056918250,1362056918570,2478296234,2478296554,320
1362056945,2478322988,9,861,95.66666667,1362056918885,1362056919077,2478296873,2478297065,192
1362056945,2478323028,8,815,101.875,1362056918588,1362056918780,2478296616,2478296808,192
1362056945,2478323032,9,861,95.66666667,1362056919161,1362056919289,2478297193,2478297321,128
1362057146,2478524360,2,126,63,1362057144301,1362057145261,2478522661,2478523621,960
1362057146,2478524388,2,126,63,1362057144210,1362057145234,2478522598,2478523622,1024
1362057154,2478532356,2,126,63,1362057147312,1362057151344,2478525668,2478529700,4032
1362057154,2478532392,2,126,63,1362057147279,1362057151311,2478525671,2478529703,4032
1362057185,2478563440,1,63,63,1362057159323,1362057159323,2478537763,2478537763,0
1362057185,2478563492,1,63,63,1362057159273,1362057159273,2478537765,2478537765,0
1362057210,2478588448,3,189,63,1362057204119,1362057207127,2478582567,2478585575,3008
1362057226,2478604436,2,126,63,1362057211167,1362057219231,2478589603,2478597667,8064
1362057234,2478612416,3,189,63,1362057229686,1362057232694,2478608102,2478611110,3008
1362057250,2478628424,2,126,63,1362057236718,1362057244782,2478615142,2478623206,8064
1362058736,2480113992,9,861,95.66666667,1362058708037,1362058708229,2480086029,2480086221,192
1362058736,2480114048,9,861,95.66666667,1362058708239,1362058708431,2480086287,2480086479,192
1362058736,2480114052,8,815,101.875,1362058708556,1362058708684,2480086608,2480086736,128
1362058939,2480317576,4,252,63,1362058931515,1362058938555,2480310091,2480317131,7040
1362058963,2480341584,3,189,63,1362058958514,1362058961586,2480337098,2480340170,3072
1362058972,2480350624,1,63,63,1362058946570,1362058946570,2480325194,2480325194,0
1362058979,2480357580,2,126,63,1362058965623,1362058973687,2480344203,2480352267,8064
1362059044,2480421696,3,189,63,1362059040744,1362059043816,2480418440,2480421512,3072
1362059060,2480437728,2,126,63,1362059047818,1362059055882,2480425546,2480433610,8064
1362059068,2480445756,12,999,83.25,1362059052141,1362059060653,2480429897,2480438409,8512
1362059068,2480445760,12,999,83.25,1362059052394,1362059060650,2480430154,2480438410,8256
1362059068,2480445764,5,2352,470.4,1362059052901,1362059064869,2480430665,2480442633,11968
1362059068,2480446112,5,2345,469,1362059052682,1362059064522,2480430794,2480442634,11840
1362059089,2480466928,11,3267,297,1362059064130,1362059064770,2480442058,2480442698,640
1362059138,2480516560,1,46,46,1362059110278,1362059110278,2480488838,2480488838,0
1362059138,2480516576,1,46,46,1362059110390,1362059110390,2480488966,2480488966,0
1362059236,2480613840,3,230,76.66666667,1362059235413,1362059235797,2480613253,2480613637,384
1362059244,2480621844,3,267,89,1362059236691,1362059241811,2480614535,2480619655,5120
1362059268,2480645884,2,178,89,1362059248555,1362059262251,2480626439,2480640135,13696
1362059317,2480695184,1,89,89,1362059289275,1362059289275,2480667459,2480667459,0
1362059357,2480735332,1,46,46,1362059331306,1362059331306,2480709638,2480709638,0
1362059369,2480747280,1,89,89,1362059343836,1362059343836,2480722116,2480722116,0
1362059413,2480791404,1,48,48,1362059388446,1362059388446,2480766850,2480766850,0
1362059417,2480795456,1,48,48,1362059389997,1362059389997,2480768453,2480768453,0
1362059746,2481124208,1,46,46,1362059719200,1362059719200,2481097408,2481097408,0
1362060728,2482105952,1,46,46,1362060701327,1362060701327,2482079279,2482079279,0
1362060760,2482138172,1,46,46,1362060732084,1362060732084,2482110256,2482110256,0
1362060944,2482322260,5,250,50,1362060918743,1362060940631,2482297003,2482318891,21888
1362060992,2482370320,1,48,48,1362060964763,1362060964763,2482343083,2482343083,0
1362061020,2482398452,1,48,48,1362060993880,1362060993880,2482372332,2482372332,0
1362061072,2482450488,8,815,101.875,1362061045876,1362061046068,2482424364,2482424556,192
1362061072,2482450528,12,6151,512.5833333,1362061045387,1362061045771,2482423915,2482424299,384
1362061072,2482450560,9,861,95.66666667,1362061046058,1362061046250,2482424618,2482424810,192
1362061072,2482450564,9,861,95.66666667,1362061046309,1362061046501,2482424873,2482425065,192
1362061318,2482695732,4,252,63,1362061309092,1362061316196,2482686824,2482693928,7104
1362061342,2482719728,4,252,63,1362061333414,1362061340454,2482711142,2482718182,7040
1362061349,2482727432,1,63,63,1362061323496,1362061323496,2482701928,2482701928,0
1362061373,2482751488,1,63,63,1362061347759,1362061347759,2482726247,2482726247,0
1362061382,2482759752,3,189,63,1362061377999,1362061381007,2482755751,2482758759,3008
1362061382,2482759752,3,189,63,1362061378063,1362061381071,2482755815,2482758823,3008
1362061398,2482775724,2,126,63,1362061385068,1362061393132,2482762792,2482770856,8064
1362061398,2482775724,2,126,63,1362061385131,1362061393131,2482762855,2482770855,8000
1362061806,2483184040,17,6755,397.3529412,1362061793448,1362061803944,2483171488,2483181984,10496
1362061806,2483184040,12,999,83.25,1362061793830,1362061803942,2483171870,2483181982,10112
1362061806,2483184044,11,953,86.63636364,1362061794213,1362061803941,2483172257,2483181985,9728
1362061911,2483288980,1,46,46,1362061884256,1362061884256,2483262236,2483262236,0
1362061943,2483320904,1,46,46,1362061916015,1362061916015,2483293919,2483293919,0
1362062107,2483485392,1,46,46,1362062081026,1362062081026,2483459418,2483459418,0
1362062116,2483494056,1,46,46,1362062091285,1362062091285,2483469341,2483469341,0
1362062396,2483773796,1,46,46,1362062370899,1362062370899,2483748695,2483748695,0
1362062436,2483813692,1,46,46,1362062407995,1362062407995,2483785687,2483785687,0
1362062796,2484174476,3,144,48,1362062770019,1362062779107,2484148495,2484157583,9088
1362063614,2484992388,9,861,95.66666667,1362063589423,1362063589615,2484967811,2484968003,192
1362063614,2484992452,8,815,101.875,1362063589042,1362063589298,2484967494,2484967750,256
1362063887,2485265432,3,189,63,1362063883392,1362063886464,2485261824,2485264896,3072
1362063899,2485277304,8,815,101.875,1362063873792,1362063873984,2485252096,2485252288,192
1362063899,2485277308,8,815,101.875,1362063874044,1362063874236,2485252352,2485252544,192
1362063899,2485277348,9,861,95.66666667,1362063873427,1362063873619,2485251775,2485251967,192
1362063899,2485277380,9,861,95.66666667,1362063874227,1362063874419,2485252607,2485252799,192
1362063903,2485281252,1,56,56,1362063875637,1362063875637,2485253889,2485253889,0
1362063903,2485281484,2,126,63,1362063890446,1362063898446,2485268930,2485276930,8000
1362064024,2485401696,4,252,63,1362064015903,1362064022943,2485393599,2485400639,7040
1362064056,2485433848,1,63,63,1362064030854,1362064030854,2485408702,2485408702,0
1362064128,2485506152,3,189,63,1362064121685,1362064124757,2485499837,2485502909,3072
1362064136,2485514080,4,252,63,1362064127707,1362064134747,2485505787,2485512827,7040
1362064144,2485522152,2,126,63,1362064128790,1362064136790,2485506942,2485514942,8000
1362064168,2485545928,1,63,63,1362064142964,1362064142964,2485520892,2485520892,0
1362064216,2485594312,4,252,63,1362064207924,1362064214964,2485586236,2485593276,7040
1362064216,2485594360,4,252,63,1362064207811,1362064214915,2485586171,2485593275,7104
1362064244,2485622172,1,52,52,1362064219328,1362064219328,2485597500,2485597500,0
1362064248,2485626184,1,63,63,1362064223155,1362064223155,2485601339,2485601339,0
1362064248,2485626308,1,63,63,1362064222967,1362064222967,2485601275,2485601275,0
1362064272,2485650272,1,46,46,1362064245723,1362064245723,2485623995,2485623995,0
1362064505,2485882720,17,6755,397.3529412,1362064493887,1362064504575,2485871607,2485882295,10688
1362064505,2485882724,44,56779,1290.431818,1362064498940,1362064499196,2485876664,2485876920,256
1362064505,2485882744,11,953,86.63636364,1362064494502,1362064504486,2485872246,2485882230,9984
1362064505,2485882748,11,953,86.63636364,1362064494946,1362064504482,2485872694,2485882230,9536
1362064505,2485882792,12,999,83.25,1362064494199,1362064504503,2485871991,2485882295,10304
1362064520,2485898572,1,46,46,1362064493868,1362064493868,2485872440,2485872440,0
1362064524,2485902548,1,46,46,1362064497284,1362064497284,2485875832,2485875832,0
1362064592,2485970608,1,46,46,1362064565764,1362064565764,2485944372,2485944372,0
1362064620,2485998600,1,46,46,1362064594124,1362064594124,2485972724,2485972724,0
1362064793,2486171200,1,46,46,1362064768475,1362064768475,2486146675,2486146675,0
1362064921,2486299392,1,46,46,1362064894103,1362064894103,2486272495,2486272495,0
1362065085,2486463500,1,46,46,1362065057899,1362065057899,2486436399,2486436399,0
1362065306,2486684260,1,46,46,1362065280790,1362065280790,2486659050,2486659050,0
1362065382,2486760176,1,46,46,1362065357737,1362065357737,2486735913,2486735913,0
1362065566,2486944648,1,46,46,1362065539279,1362065539279,2486917927,2486917927,0
1362065603,2486980976,1,46,46,1362065578285,1362065578285,2486956261,2486956261,0
1362065951,2487329152,1,46,46,1362065922938,1362065922938,2487301090,2487301090,0
1362065963,2487341280,13,6234,479.5384615,1362065937336,1362065937656,2487315616,2487315936,320
1362065963,2487341280,9,861,95.66666667,1362065937719,1362065937911,2487315999,2487316191,192
1362065963,2487341284,9,861,95.66666667,1362065938291,1362065938483,2487316575,2487316767,192
1362065963,2487341288,9,861,95.66666667,1362065938034,1362065938226,2487316322,2487316514,192
1362066131,2487509336,1,46,46,1362066105661,1362066105661,2487483997,2487483997,0
1362066155,2487532848,3,189,63,1362066148260,1362066151268,2487526108,2487529116,3008
1362066171,2487548800,2,126,63,1362066155351,1362066163415,2487533151,2487541215,8064
1362066187,2487564824,12,999,83.25,1362066168190,1362066180286,2487546014,2487558110,12096
1362066187,2487564828,12,999,83.25,1362066168571,1362066180283,2487546399,2487558111,11712
1362066187,2487564832,12,999,83.25,1362066169270,1362066180150,2487547102,2487557982,10880
1362066187,2487564900,11,953,86.63636364,1362066168944,1362066180144,2487546844,2487558044,11200
1362066200,2487577804,1,63,63,1362066174866,1362066174866,2487552670,2487552670,0
1362066276,2487653760,1,63,63,1362066248251,1362066248251,2487626011,2487626011,0
1362066284,2487661740,1,63,63,1362066257744,1362066257744,2487635484,2487635484,0
1362066965,2488343148,1,46,46,1362066937901,1362066937901,2488316049,2488316049,0
1362067065,2488443420,1,46,46,1362067038876,1362067038876,2488417296,2488417296,0
1362067178,2488555900,1,46,46,1362067151843,1362067151843,2488529743,2488529743,0
1362067222,2488599820,1,46,46,1362067196659,1362067196659,2488574479,2488574479,0
1362067988,2489366476,15,6289,419.2666667,1362067972759,1362067984407,2489351235,2489362883,11648
1362067988,2489366476,11,953,86.63636364,1362067973140,1362067984404,2489351616,2489362880,11264
1362067988,2489366500,12,999,83.25,1362067973437,1362067984381,2489351937,2489362881,10944
1362067988,2489366548,17,6896,405.6470588,1362067972237,1362067984269,2489350785,2489362817,12032
1362067988,2489366580,17,6755,397.3529412,1362067973677,1362067984301,2489352257,2489362881,10624
1362068052,2489430464,12,999,83.25,1362068035745,1362068047841,2489414209,2489426305,12096
1362068052,2489430536,12,999,83.25,1362068035929,1362068047769,2489414465,2489426305,11840
1362068052,2489430604,11,953,86.63636364,1362068036181,1362068047701,2489414785,2489426305,11520
1362068052,2489430608,12,999,83.25,1362068036433,1362068047697,2489415041,2489426305,11264
1362068421,2489798940,12,999,83.25,1362068405031,1362068416679,2489782971,2489794619,11648
1362068421,2489798944,11,953,86.63636364,1362068405283,1362068416611,2489783227,2489794555,11328
1362068421,2489798944,12,999,83.25,1362068405602,1362068416610,2489783546,2489794554,11008
1362068421,2489799064,15,6289,419.2666667,1362068404461,1362068416557,2489782525,2489794621,12096
1362068433,2489811060,1,46,46,1362068408431,1362068408431,2489786491,2489786491,0
1362068537,2489915368,1,46,46,1362068509242,1362068509242,2489887610,2489887610,0
1362068842,2490220108,1,46,46,1362068814777,1362068814777,2490192885,2490192885,0
1362068942,2490320488,1,46,46,1362068916219,1362068916219,2490294707,2490294707,0
1362069014,2490392584,3,152,50.66666667,1362068988825,1362068990745,2490367409,2490369329,1920
1362069018,2490396540,3,152,50.66666667,1362068989956,1362068991812,2490368496,2490370352,1856
1362069018,2490396552,3,152,50.66666667,1362068991097,1362068992633,2490369649,2490371185,1536
1362069019,2490396716,2,104,52,1362068991933,1362068994941,2490369649,2490372657,3008
1362069417,2490794768,1,48,48,1362069389638,1362069389638,2490767406,2490767406,0
1362069820,2491198228,1,46,46,1362069795314,1362069795314,2491173542,2491173542,0
1362070231,2491609364,15,6289,419.2666667,1362070217187,1362070229283,2491595551,2491607647,12096
1362070231,2491609444,12,999,83.25,1362070217490,1362070229202,2491595934,2491607646,11712
1362070231,2491609448,11,953,86.63636364,1362070217742,1362070229198,2491596190,2491607646,11456
1362070231,2491609452,11,953,86.63636364,1362070218123,1362070229195,2491596575,2491607647,11072
1362070366,2491743880,1,46,46,1362070338823,1362070338823,2491716703,2491716703,0
1362070466,2491843972,1,46,46,1362070439975,1362070439975,2491817947,2491817947,0
1362070594,2491972504,1,48,48,1362070569107,1362070569107,2491947611,2491947611,0
1362070655,2492032932,1,46,46,1362070627215,1362070627215,2492005147,2492005147,0
1362070671,2492048960,1,46,46,1362070643695,1362070643695,2492021655,2492021655,0
1362071480,2492858320,1,46,46,1362071454843,1362071454843,2492833163,2492833163,0
1362071497,2492875040,1,52,52,1362071470548,1362071470548,2492848588,2492848588,0
1362071520,2492898280,1,48,48,1362071492580,1362071492580,2492870860,2492870860,0
1362071545,2492922744,1,52,52,1362071517822,1362071517822,2492895566,2492895566,0
1362071584,2492962396,1,46,46,1362071556206,1362071556206,2492934602,2492934602,0
1362071652,2493030580,2,92,46,1362071626999,1362071629559,2493005579,2493008139,2560
1362071684,2493062636,1,46,46,1362071657023,1362071657023,2493035659,2493035659,0
1362071784,2493162636,1,46,46,1362071758267,1362071758267,2493136903,2493136903,0
1362071885,2493263060,1,46,46,1362071860029,1362071860029,2493238089,2493238089,0
1362071965,2493343356,1,46,46,1362071940625,1362071940625,2493318981,2493318981,0
1362071989,2493367216,1,46,46,1362071961054,1362071961054,2493339270,2493339270,0
1362072042,2493419708,15,6289,419.2666667,1362072022553,1362072034649,2493400261,2493412357,12096
1362072042,2493419716,12,999,83.25,1362072023248,1362072034640,2493400964,2493412356,11392
1362072042,2493419740,11,953,86.63636364,1362072023481,1362072034617,2493401221,2493412357,11136
1362072042,2493419792,11,953,86.63636364,1362072022917,1362072034501,2493400709,2493412293,11584
1362072057,2493435568,2,92,46,1362072032317,1362072034813,2493410885,2493413381,2496
1362072089,2493467436,1,46,46,1362072062017,1362072062017,2493440453,2493440453,0
1362072090,2493467824,2,92,46,1362072085860,1362072085988,2493463684,2493463812,128
1362072390,2493768552,1,46,46,1362072365638,1362072365638,2493744190,2493744190,0
1362072810,2494188124,6,2592,432,1362072805036,1362072805164,2494183160,2494183288,128
1362072817,1132509536,33,43688,1323.878788,1362072802980,1362072814948,1132495516,1132507484,11968
1362072818,2494196100,26,21856,840.6153846,1362072803588,1362072814980,2494181688,2494193080,11392
1362072826,2494204184,8,4595,574.375,1362072802610,1362072820594,2494180794,2494198778,17984
1362073922,2495300260,12,6151,512.5833333,1362073895893,1362073896341,2495274153,2495274601,448
1362073922,2495300268,9,861,95.66666667,1362073896396,1362073896588,2495274664,2495274856,192
1362073922,2495300268,9,861,95.66666667,1362073896651,1362073896907,2495274919,2495275175,256
1362073922,2495300384,9,861,95.66666667,1362073896854,1362073897046,2495275238,2495275430,192
1362073962,2495340464,5,250,50,1362073936518,1362073958662,2495314982,2495337126,22144
1362074010,2495388452,1,48,48,1362073983121,1362073983121,2495361573,2495361573,0
1362074039,2495416652,1,48,48,1362074013170,1362074013170,2495390822,2495390822,0
1362074139,2495517400,2,126,63,1362074137349,1362074138309,2495515749,2495516709,960
1362074147,2495525468,2,126,63,1362074140290,1362074144322,2495518758,2495522790,4032
1362074179,2495556836,1,63,63,1362074152951,1362074152951,2495530787,2495530787,0
1362074219,2495597408,4,252,63,1362074211003,1362074218107,2495589411,2495596515,7104
1362074227,2495605496,4,252,63,1362074219684,1362074226788,2495598180,2495605284,7104
1362074251,2495628920,1,63,63,1362074226597,1362074226597,2495604517,2495604517,0
1362074263,2495640740,1,63,63,1362074235544,1362074235544,2495613284,2495613284,0
1362074267,2495645408,3,189,63,1362074260346,1362074263354,2495638754,2495641762,3008
1362074283,2495661508,2,126,63,1362074267287,1362074275351,2495645795,2495653859,8064
1362075490,2496868444,1,60,60,1362075465092,1362075465092,2496843536,2496843536,0
1362075700,2497078564,12,999,83.25,1362075684298,1362075694474,2497062862,2497073038,10176
1362075700,2497078568,12,999,83.25,1362075684549,1362075694469,2497063117,2497073037,9920
1362075701,2497078632,17,6755,397.3529412,1362075684847,1362075695407,2497062479,2497073039,10560
1362075701,2497078676,12,999,83.25,1362075685762,1362075695298,2497063438,2497072974,9536
1362076585,2497962712,1,46,46,1362076560017,1362076560017,2497937729,2497937729,0
1362076589,2497966680,1,435,435,1362076563119,1362076563119,2497940799,2497940799,0
1362077503,2498880748,12,999,83.25,1362077484959,1362077494943,2498862707,2498872691,9984
1362077503,2498880816,12,999,83.25,1362077484314,1362077494874,2498862130,2498872690,10560
1362077503,2498880820,11,953,86.63636364,1362077484631,1362077494871,2498862451,2498872691,10240
1362077527,2498905296,9,861,95.66666667,1362077502714,1362077502842,2498881010,2498881138,128
1362077527,2498905376,13,6234,479.5384615,1362077502120,1362077502504,2498880496,2498880880,384
1362077531,2498909248,9,861,95.66666667,1362077503018,1362077503210,2498881266,2498881458,192
1362077531,2498909276,9,861,95.66666667,1362077503244,1362077503500,2498881520,2498881776,256
1362077727,2499104908,3,189,63,1362077722043,1362077725115,2499099951,2499103023,3072
1362077743,2499121036,2,126,63,1362077729018,1362077737018,2499107054,2499115054,8000
1362077759,2499137116,4,252,63,1362077751656,1362077758760,2499129772,2499136876,7104
1362077783,2499161124,4,252,63,1362077775520,1362077782560,2499153644,2499160684,7040
1362077788,2499165924,1,46,46,1362077761770,1362077761770,2499139694,2499139694,0
1362077792,2499169964,1,63,63,1362077766912,1362077766912,2499144876,2499144876,0
1362077799,2499177056,2,126,63,1362077796324,1362077797348,2499174380,2499175404,1024
1362077807,2499185144,2,126,63,1362077799310,1362077803278,2499177454,2499181422,3968
1362077816,2499193976,1,63,63,1362077790772,1362077790772,2499168748,2499168748,0
1362077836,2499214080,1,63,63,1362077811405,1362077811405,2499189485,2499189485,0
1362078240,2499617712,11,953,86.63636364,1362078221817,1362078233145,2499599529,2499610857,11328
1362078240,2499617784,12,999,83.25,1362078221357,1362078233069,2499599141,2499610853,11712
1362078240,2499617796,12,999,83.25,1362078222051,1362078232995,2499599847,2499610791,10944
1362078241,2499618904,17,6755,397.3529412,1362078220856,1362078232952,2499598760,2499610856,12096
1362078253,2499631056,11,3267,297,1362078226144,1362078227104,2499604200,2499605160,960
1362078592,2499970208,2,141,70.5,1362078588033,1362078588033,2499966241,2499966241,0
1362078614,2499992172,11,3267,297,1362078587555,1362078588195,2499965727,2499966367,640
1362078640,2500018360,3,193,64.33333333,1362078637609,1362078637609,2500015969,2500015969,0
1362078666,2500044488,11,3267,297,1362078638826,1362078639402,2500017314,2500017890,576
1362078840,2500218320,2,141,70.5,1362078839373,1362078839373,2500217693,2500217693,0
1362078867,2500245008,11,3267,297,1362078839174,1362078839750,2500217182,2500217758,576
1362079153,2500530720,2,141,70.5,1362079151778,1362079151778,2500529498,2500529498,0
1362079176,2500553888,11,3267,297,1362079150903,1362079151671,2500528791,2500529559,768
1362079537,2500915164,2,141,70.5,1362079529377,1362079529377,2500907541,2500907541,0
1362079557,2500934932,11,3267,297,1362079528966,1362079529734,2500906898,2500907666,768
1362079733,2501111536,1,46,46,1362079706728,1362079706728,2501085264,2501085264,0
1362079786,2501163912,2,141,70.5,1362079778137,1362079778137,2501156049,2501156049,0
1362080050,2501428248,12,6151,512.5833333,1362080025474,1362080026178,2501403722,2501404426,704
1362080054,2501432204,8,815,101.875,1362080026352,1362080026544,2501404556,2501404748,192
1362080054,2501432404,9,861,95.66666667,1362080026409,1362080026665,2501404813,2501405069,256
1362080054,2501432408,9,861,95.66666667,1362080026721,1362080026913,2501405129,2501405321,192
1362080267,2501644944,3,189,63,1362080261167,1362080264175,2501639111,2501642119,3008
1362080283,2501660928,2,126,63,1362080268226,1362080276290,2501646154,2501654218,8064
1362080339,2501716924,3,189,63,1362080333637,1362080336709,2501711561,2501714633,3072
1362080339,2501717004,3,189,63,1362080333618,1362080336690,2501711622,2501714694,3072
1362080339,2501717008,3,189,63,1362080333744,1362080338608,2501711752,2501716616,4864
1362080355,2501732912,2,126,63,1362080340687,1362080348751,2501718599,2501726663,8064
1362080355,2501732912,2,126,63,1362080340814,1362080348878,2501718726,2501726790,8064
1362080363,2501740996,2,126,63,1362080345083,1362080358011,2501723079,2501736007,12928
1362080688,2502066072,14,6617,472.6428571,1362080663274,1362080663658,2502041346,2502041730,384
1362080688,2502066076,8,815,101.875,1362080663718,1362080663910,2502041794,2502041986,192
1362080692,2502070376,9,861,95.66666667,1362080663996,1362080664188,2502042372,2502042564,192
1362080692,2502070488,8,815,101.875,1362080663564,1362080663820,2502042052,2502042308,256
1362080915,2502293328,2,126,63,1362080912936,1362080913960,2502291264,2502292288,1024
1362080923,2502301408,2,126,63,1362080915863,1362080919895,2502294271,2502298303,4032
1362080952,2502330552,1,63,63,1362080927814,1362080927814,2502306366,2502306366,0
1362081003,2502381396,4,252,63,1362080994657,1362081001697,2502373053,2502380093,7040
1362081003,2502381480,4,252,63,1362080994572,1362081001676,2502373052,2502380156,7104
1362081003,2502381484,4,252,63,1362080994635,1362081001675,2502373119,2502380159,7040
1362081037,2502414752,1,63,63,1362081010467,1362081010467,2502388219,2502388219,0
1362081037,2502414752,1,63,63,1362081010406,1362081010406,2502388158,2502388158,0
1362081037,2502414872,1,63,63,1362081010347,1362081010347,2502388219,2502388219,0
1362081932,2503310020,12,999,83.25,1362081919244,1362081929740,2503297264,2503307760,10496
1362081932,2503310092,13,1045,80.38461538,1362081918916,1362081929668,2503297008,2503307760,10752
1362081932,2503310148,17,6755,397.3529412,1362081918092,1362081929292,2503296240,2503307440,11200
1362081932,2503310168,12,999,83.25,1362081918453,1362081929269,2503296621,2503307437,10816
1362081940,1141632632,5,574,114.8,1362081933314,1362081933378,1141625946,1141626010,64
1362081943,2503321160,1,46,46,1362081918654,1362081918654,2503296814,2503296814,0
1362082189,2503567492,1,46,46,1362082161646,1362082161646,2503540138,2503540138,0
1362082369,2503746616,1,78,78,1362082341911,1362082341911,2503719527,2503719527,0
1362083026,2504404500,1,46,46,1362083000730,1362083000730,2504379230,2504379230,0
1362083159,2504537480,10,907,90.7,1362083149356,1362083158636,2504527836,2504537116,9280
1362083167,2504545264,12,999,83.25,1362083149316,1362083158980,2504527580,2504537244,9664
1362083167,2504545288,12,999,83.25,1362083149868,1362083158892,2504528156,2504537180,9024
1362083167,2504545340,17,6755,397.3529412,1362083148855,1362083158903,2504527195,2504537243,10048
1362083187,2504564828,1,46,46,1362083159353,1362083159353,2504537181,2504537181,0
1362084720,2506097640,1,46,46,1362084694494,1362084694494,2506072134,2506072134,0
1362085277,2506654696,12,999,83.25,1362085262491,1362085274587,2506640187,2506652283,12096
1362085277,2506654700,11,953,86.63636364,1362085263321,1362085274585,2506641021,2506652285,11264
1362085277,2506654700,12,999,83.25,1362085263065,1362085274585,2506640765,2506652285,11520
1362085277,2506654784,11,953,86.63636364,1362085262659,1362085274499,2506640443,2506652283,11840
1362085791,2507168968,1,48,48,1362085764355,1362085764355,2507142323,2507142323,0
1362086457,2507834600,1,46,46,1362086428585,1362086428585,2507806185,2507806185,0
1362086988,2508366392,3,144,48,1362086960331,1362086969419,2508338723,2508347811,9088
1362087598,2508976044,9,861,95.66666667,1362087571164,1362087571420,2508949208,2508949464,256
1362087598,2508976052,9,861,95.66666667,1362087571540,1362087571732,2508949592,2508949784,192
1362087598,2508976076,9,861,95.66666667,1362087571839,1362087571967,2508949915,2508950043,128
1362087598,2508976156,9,861,95.66666667,1362087570223,1362087570607,2508948379,2508948763,384
1362087602,2508980188,1,46,46,1362087577103,1362087577103,2508955291,2508955291,0
1362087816,2509193628,4,252,63,1362087807162,1362087814202,2509184790,2509191830,7040
1362087847,2509224692,1,63,63,1362087822202,1362087822202,2509199894,2509199894,0
1362087887,2509265568,2,126,63,1362087883982,1362087885006,2509262550,2509263574,1024
1362087895,2509273532,2,126,63,1362087887027,1362087891059,2509265559,2509269591,4032
1362087904,2509281680,2,126,63,1362087902084,1362087903044,2509279764,2509280724,960
1362087911,2509289552,2,92,46,1362087910430,1362087910430,2509288982,2509288982,0
1362087911,2509289556,5,264,52.8,1362087899096,1362087910680,2509277652,2509289236,11584
1362087912,2509289588,6,327,54.5,1362087905186,1362087911522,2509282774,2509289110,6336
1362087912,2509289640,5,281,56.2,1362087908011,1362087911467,2509285651,2509289107,3456
1362087927,2509305564,12,999,83.25,1362087912337,1362087923985,2509290901,2509302549,11648
1362087928,2509305588,12,999,83.25,1362087913889,1362087924961,2509291477,2509302549,11072
1362087928,2509305640,15,6289,419.2666667,1362087912876,1362087924972,2509290516,2509302612,12096
1362087928,2509305664,11,953,86.63636364,1362087913494,1362087924886,2509291158,2509302550,11392
1362087943,2509320888,11,3267,297,1362087916405,1362087917173,2509294293,2509295061,768
1362087952,2509329700,3,193,64.33333333,1362087947887,1362087947951,2509325587,2509325651,64
1362088176,2509554500,1,46,46,1362088147341,1362088147341,2509525841,2509525841,0
1362088263,2509641536,9,861,95.66666667,1362088237288,1362088237480,2509615824,2509616016,192
1362088264,2509641588,8,815,101.875,1362088237084,1362088237404,2509614672,2509614992,320
1362088264,2509641628,8,815,101.875,1362088237429,1362088237621,2509615057,2509615249,192
1362088264,2509641632,8,815,101.875,1362088237809,1362088238129,2509615441,2509615761,320
1362088488,2509866572,4,252,63,1362088478912,1362088486016,2509857484,2509864588,7104
1362088512,2509890496,4,252,63,1362088504397,1362088511437,2509882893,2509889933,7040
1362088520,2509898092,1,63,63,1362088494561,1362088494561,2509872653,2509872653,0
1362088548,2509926044,1,63,63,1362088519951,1362088519951,2509897995,2509897995,0
1362088553,2509930620,3,189,63,1362088549111,1362088552119,2509926731,2509929739,3008
1362088553,2509930644,3,189,63,1362088549086,1362088552094,2509926730,2509929738,3008
1362088568,2509946572,2,126,63,1362088555197,1362088563261,2509933769,2509941833,8064
1362088569,2509946680,2,126,63,1362088556092,1362088564156,2509933772,2509941836,8064
1362088824,2510202360,14,6617,472.6428571,1362088799119,1362088799439,2510177479,2510177799,320
1362088824,2510202380,9,861,95.66666667,1362088799483,1362088799675,2510177863,2510178055,192
1362088824,2510202384,9,861,95.66666667,1362088799736,1362088799928,2510178120,2510178312,192
1362088950,2510328140,1,46,46,1362088924459,1362088924459,2510302599,2510302599,0
1362089010,2510387616,2,126,63,1362089007477,1362089008437,2510385093,2510386053,960
1362089018,2510395596,2,126,63,1362089010502,1362089014534,2510388098,2510392130,4032
1362089049,2510426944,1,63,63,1362089022251,1362089022251,2510400195,2510400195,0
1362089066,2510443716,3,189,63,1362089059405,1362089062477,2510437121,2510440193,3072
1362089082,2510459684,2,126,63,1362089066478,1362089074542,2510444162,2510452226,8064
1362089114,2510491760,3,189,63,1362089107747,1362089110755,2510485507,2510488515,3008
1362089130,2510507748,2,126,63,1362089114800,1362089122864,2510492548,2510500612,8064
1362089382,2510759888,8,815,101.875,1362089355743,1362089355935,2510733631,2510733823,192
1362089382,2510760004,8,815,101.875,1362089355369,1362089355561,2510733373,2510733565,192
1362089382,2510760012,9,861,95.66666667,1362089355874,1362089356066,2510733886,2510734078,192
1362089382,2510760016,8,815,101.875,1362089356189,1362089356317,2510734205,2510734333,128
1362089634,2511012436,2,126,63,1362089632566,1362089633590,2511011002,2511012026,1024
1362089634,2511012440,2,126,63,1362089632564,1362089633588,2511011004,2511012028,1024
1362089642,2511020568,2,126,63,1362089635443,1362089639475,2511014011,2511018043,4032
1362089643,2511020748,2,126,63,1362089636261,1362089640293,2511014009,2511018041,4032
1362089675,2511052788,1,63,63,1362089648318,1362089648318,2511026106,2511026106,0
1362089675,2511052908,1,63,63,1362089648197,1362089648197,2511026105,2511026105,0
1362089762,2511140504,4,252,63,1362089753521,1362089760561,2511132025,2511139065,7040
1362089762,2511140508,4,252,63,1362089753518,1362089760558,2511132026,2511139066,7040
1362089795,2511172932,1,63,63,1362089769197,1362089769197,2511147129,2511147129,0
1362089795,2511172932,1,63,63,1362089769196,1362089769196,2511147128,2511147128,0
1362091174,2512551916,8,815,101.875,1362091149159,1362091149351,2512527075,2512527267,192
1362091174,2512551948,9,861,95.66666667,1362091149385,1362091149577,2512527333,2512527525,192
1362091174,2512551948,8,815,101.875,1362091149702,1362091150022,2512527650,2512527970,320
1362091403,2512781352,3,189,63,1362091399534,1362091402606,2512777886,2512780958,3072
1362091403,2512781412,3,189,63,1362091399732,1362091402740,2512778144,2512781152,3008
1362091411,2512789496,3,138,46,1362091405281,1362091405345,2512783777,2512783841,64
1362091411,2512789496,4,201,50.25,1362091405281,1362091405345,2512783777,2512783841,64
1362091412,2512789632,4,201,50.25,1362091406145,1362091406209,2512783777,2512783841,64
1362091435,2512812872,9,861,95.66666667,1362091408015,1362091408271,2512785887,2512786143,256
1362091435,2512812880,9,861,95.66666667,1362091408328,1362091408584,2512786208,2512786464,256
1362091435,2512812912,8,815,101.875,1362091408999,1362091409191,2512786911,2512787103,192
1362091435,2512813004,14,6617,472.6428571,1362091408521,1362091408841,2512786525,2512786845,320
1362091628,2513005592,3,189,63,1362091621410,1362091624418,2512999002,2513002010,3008
1362091635,2513013560,3,189,63,1362091629342,1362091632350,2513007902,2513010910,3008
1362091635,2513013564,3,189,63,1362091629718,1362091632726,2513008282,2513011290,3008
1362091636,2513013612,2,126,63,1362091633745,1362091634769,2513011357,2513012381,1024
1362091643,2513021544,2,126,63,1362091627499,1362091635563,2513006043,2513014107,8064
1362091643,2513021552,2,126,63,1362091635814,1362091639846,2513014366,2513018398,4032
1362091652,2513029620,2,126,63,1362091637319,1362091645319,2513014939,2513022939,8000
1362091652,2513029648,2,126,63,1362091637677,1362091645741,2513015325,2513023389,8064
1362091675,2513053396,1,63,63,1362091648064,1362091648064,2513026460,2513026460,0
1362092758,2514136008,2,122,61,1362092732531,1362092734835,2514110539,2514112843,2304
1362092962,2514340228,14,6617,472.6428571,1362092936854,1362092937174,2514315082,2514315402,320
1362092962,2514340324,9,861,95.66666667,1362092937139,1362092937331,2514315463,2514315655,192
1362092962,2514340352,9,861,95.66666667,1362092937370,1362092937562,2514315722,2514315914,192
1362092962,2514340352,9,861,95.66666667,1362092937624,1362092937816,2514315976,2514316168,192
1362093135,2514513460,1,46,46,1362093110122,1362093110122,2514488582,2514488582,0
1362093167,2514544664,5,230,46,1362093139716,1362093140164,2514517380,2514517828,448
1362093174,2514551688,3,138,46,1362093171180,1362093171244,2514548868,2514548932,64
1362093174,2514551688,3,138,46,1362093171180,1362093171244,2514548868,2514548932,64
1362093174,2514551768,3,138,46,1362093171036,1362093171100,2514548804,2514548868,64
1362093174,2514551768,3,138,46,1362093171099,1362093171163,2514548867,2514548931,64
1362093207,2514584712,11,3267,297,1362093181526,1362093182294,2514559238,2514560006,768
1362093406,2514783976,2,141,70.5,1362093400136,1362093400136,2514778112,2514778112,0
1362093423,2514800896,1,46,46,1362093397146,1362093397146,2514775042,2514775042,0
1362093439,2514816916,11,3267,297,1362093411141,1362093411973,2514789057,2514789889,832
1362093486,2514863980,2,141,70.5,1362093484806,1362093484806,2514862786,2514862786,0
1362093511,2514888928,9,3163,351.4444444,1362093484023,1362093484983,2514861951,2514862911,960
1362093904,2515282112,1,46,46,1362093876026,1362093876026,2515254138,2515254138,0
1362093928,2515306244,1,46,46,1362093900726,1362093900726,2515278970,2515278970,0
1362094405,2515783016,1,89,89,1362094379089,1362094379089,2515757105,2515757105,0
1362094641,2516019468,3,193,64.33333333,1362094636873,1362094636873,2516015341,2516015341,0
1362094774,2516151944,12,6151,512.5833333,1362094749461,1362094749909,2516127405,2516127853,448
1362094778,2516155884,9,861,95.66666667,1362094750034,1362094750290,2516127918,2516128174,256
1362094778,2516155888,9,861,95.66666667,1362094750412,1362094750604,2516128300,2516128492,192
1362094778,2516155916,9,861,95.66666667,1362094750641,1362094750897,2516128557,2516128813,256
1362094902,2516280480,1,46,46,1362094877437,1362094877437,2516255917,2516255917,0
1362094936,2516314000,2,126,63,1362094933785,1362094934809,2516311785,2516312809,1024
1362094944,2516321944,2,126,63,1362094936852,1362094940884,2516314796,2516318828,4032
1362094960,2516338000,2,126,63,1362094958108,1362094959132,2516336108,2516337132,1024
1362094968,2516346036,2,126,63,1362094961143,1362094965175,2516339179,2516343211,4032
1362094975,2516352632,1,63,63,1362094949257,1362094949257,2516326889,2516326889,0
1362094999,2516376652,1,63,63,1362094973558,1362094973558,2516351210,2516351210,0
1362095000,2516377968,3,189,63,1362094994937,1362094998009,2516372905,2516375977,3072
1362095016,2516394068,2,126,63,1362095001875,1362095009939,2516379943,2516388007,8064
1362095024,2516401988,4,252,63,1362095015011,1362095022115,2516392999,2516400103,7104
1362095055,2516432800,1,63,63,1362095030304,1362095030304,2516408104,2516408104,0
1362095331,2516709516,14,6617,472.6428571,1362095303886,1362095304206,2516682402,2516682722,320
1362095332,2516709632,9,861,95.66666667,1362095305157,1362095305349,2516682789,2516682981,192
1362095332,2516709640,9,861,95.66666667,1362095305468,1362095305596,2516683108,2516683236,128
1362095537,2516915084,2,126,63,1362095535806,1362095536830,2516913890,2516914914,1024
1362095545,2516923084,2,126,63,1362095538876,1362095542908,2516916960,2516920992,4032
1362095576,2516954196,1,63,63,1362095550862,1362095550862,2516929058,2516929058,0
1362095625,2517003064,3,189,63,1362095618833,1362095621841,2516996897,2516999905,3008
1362095641,2517019068,2,126,63,1362095625866,1362095633930,2517003934,2517011998,8064
1362095649,2517027124,3,189,63,1362095642132,1362095645204,2517020256,2517023328,3072
1362095665,2517043160,2,126,63,1362095649201,1362095657201,2517027361,2517035361,8000
1362095701,1155393148,1,46,46,1362095675712,1362095675712,1155367860,1155367860,0
1362096010,2517387644,9,861,95.66666667,1362095985583,1362095985775,2517363227,2517363419,192
1362096010,2517387728,9,861,95.66666667,1362095985243,1362095985371,2517362971,2517363099,128
1362096013,2517391504,8,815,101.875,1362095984978,1362095985234,2517363482,2517363738,256
1362096013,2517391508,8,815,101.875,1362095985357,1362095985485,2517363865,2517363993,128
1362096227,2517604688,3,189,63,1362096222080,1362096225152,2517599768,2517602840,3072
1362096242,2517620548,2,126,63,1362096228321,1362096236321,2517606869,2517614869,8000
1362096258,2517636508,3,189,63,1362096254220,1362096257292,2517632728,2517635800,3072
1362096275,2517652604,2,126,63,1362096262162,1362096270226,2517639766,2517647830,8064
1362096299,2517676628,3,189,63,1362096294777,1362096297785,2517672405,2517675413,3008
1362096299,2517676628,3,189,63,1362096294840,1362096297848,2517672468,2517675476,3008
1362096310,2517688476,3,144,48,1362096283115,1362096292075,2517661591,2517670551,8960
1362096315,2517692676,2,126,63,1362096301835,1362096309899,2517679511,2517687575,8064
1362096315,2517692720,2,126,63,1362096301724,1362096309788,2517679444,2517687508,8064
1362097205,2518582604,1,46,46,1362097180420,1362097180420,2518558024,2518558024,0
1362097218,2518596072,1,46,46,1362097190448,1362097190448,2518568520,2518568520,0
1362097529,2518907500,9,861,95.66666667,1362097503358,1362097503550,2518881858,2518882050,192
1362097529,2518907508,9,861,95.66666667,1362097503606,1362097503798,2518882114,2518882306,192
1362097529,2518907508,9,861,95.66666667,1362097503927,1362097504055,2518882435,2518882563,128
1362097676,2519053892,3,138,46,1362097668959,1362097669023,2519046851,2519046915,64
1362097676,2519053892,3,138,46,1362097668957,1362097669021,2519046849,2519046913,64
1362097676,2519053964,3,138,46,1362097668885,1362097668949,2519046849,2519046913,64
1362097692,2519069904,16,6372,398.25,1362097672530,1362097684562,2519050434,2519062466,12032
1362097692,2519069928,12,999,83.25,1362097672889,1362097684409,2519050817,2519062337,11520
1362097692,2519069968,18,6973,387.3888889,1362097671951,1362097684111,2519049919,2519062079,12160
1362097692,2519069976,11,953,86.63636364,1362097673095,1362097684423,2519051071,2519062399,11328
1362097692,2519069980,12,999,83.25,1362097673414,1362097684358,2519051394,2519062338,10944
1362097710,2519087660,12,3356,279.6666667,1362097683011,1362097684163,2519060671,2519061823,1152
1362097710,2519087752,1,125,125,1362097684777,1362097684777,2519062529,2519062529,0
1362097836,2519213976,3,193,64.33333333,1362097834566,1362097834566,2519212542,2519212542,0
1362097959,2519337524,1,46,46,1362097930976,1362097930976,2519309500,2519309500,0
1362098667,2520045280,6,298,49.66666667,1362098639752,1362098661512,2520018032,2520039792,21760
1362098711,2520089292,1,48,48,1362098685630,1362098685630,2520063922,2520063922,0
1362098743,2520121352,1,48,48,1362098715010,1362098715010,2520093362,2520093362,0
1362100295,2521672620,16,6372,398.25,1362100278983,1362100291079,2521656603,2521668699,12096
1362100295,2521672624,11,953,86.63636364,1362100279936,1362100291072,2521657560,2521668696,11136
1362100295,2521672672,12,999,83.25,1362100279376,1362100291024,2521657048,2521668696,11648
1362100295,2521672696,11,953,86.63636364,1362100279609,1362100291001,2521657305,2521668697,11392
1362101188,2522566324,8,815,101.875,1362101162870,1362101163126,2522541194,2522541450,256
1362101436,2522814484,9,861,95.66666667,1362101410834,1362101411026,2522789318,2522789510,192
1362101436,2522814508,8,815,101.875,1362101411133,1362101411325,2522789641,2522789833,192
1362101436,2522814508,8,815,101.875,1362101411389,1362101411581,2522789897,2522790089,192
1362101436,2522814604,8,815,101.875,1362101411550,1362101411742,2522790154,2522790346,192
1362101480,2522858084,3,189,63,1362101474914,1362101477922,2522852998,2522856006,3008
1362101496,2522874068,2,126,63,1362101481972,1362101490036,2522860040,2522868104,8064
1362101561,2522938644,1,48,48,1362101535002,1362101535002,2522912646,2522912646,0
1362101656,2523034276,4,252,63,1362101647391,1362101654431,2523025667,2523032707,7040
1362101685,2523063076,1,46,46,1362101657703,1362101657703,2523035779,2523035779,0
1362101689,2523067116,1,63,63,1362101662655,1362101662655,2523040771,2523040771,0
1362101720,2523098276,3,189,63,1362101715936,1362101718944,2523094212,2523097220,3008
1362101720,2523098320,3,189,63,1362101715891,1362101718899,2523094211,2523097219,3008
1362101720,2523098324,3,189,63,1362101715889,1362101718961,2523094213,2523097285,3072
1362101736,2523114336,2,126,63,1362101722916,1362101730980,2523101252,2523109316,8064
1362101736,2523114336,2,126,63,1362101722916,1362101730980,2523101252,2523109316,8064
1362101736,2523114336,2,126,63,1362101722980,1362101730980,2523101316,2523109316,8000
1362102936,2524314100,2,122,61,1362102911038,1362102913086,2524289138,2524291186,2048
1362102980,2524358184,8,815,101.875,1362102954794,1362102954986,2524332978,2524333170,192
1362102980,2524358188,8,815,101.875,1362102955045,1362102955237,2524333233,2524333425,192
1362102980,2524358256,13,6234,479.5384615,1362102953953,1362102954273,2524332209,2524332529,320
1362102980,2524358268,9,861,95.66666667,1362102954391,1362102954583,2524332659,2524332851,192
1362103106,2524483744,3,138,46,1362103102878,1362103103006,2524480622,2524480750,128
1362103106,2524483744,3,138,46,1362103102878,1362103103006,2524480622,2524480750,128
1362103106,2524483800,4,184,46,1362103102823,1362103103463,2524480623,2524481263,640
1362103106,2524483804,3,138,46,1362103102820,1362103102884,2524480624,2524480688,64
1362103122,2524499732,11,953,86.63636364,1362103105387,1362103117163,2524483119,2524494895,11776
1362103122,2524499736,11,953,86.63636364,1362103105638,1362103117158,2524483374,2524494894,11520
1362103122,2524499772,11,953,86.63636364,1362103105859,1362103117123,2524483631,2524494895,11264
1362103122,2524499776,12,999,83.25,1362103105022,1362103117182,2524482798,2524494958,12160
1362103132,2524510504,11,3267,297,1362103103911,1362103104679,2524482415,2524483183,768
1362103266,2524644032,3,205,68.33333333,1362103259451,1362103259771,2524637483,2524637803,320
1362103369,2524746856,1,46,46,1362103344426,1362103344426,2524722282,2524722282,0
1362103405,2524782792,5,250,50,1362103379499,1362103401707,2524757291,2524779499,22208
1362103453,2524831108,1,48,48,1362103425712,1362103425712,2524803820,2524803820,0
1362103481,2524859120,1,48,48,1362103454947,1362103454947,2524833067,2524833067,0
1362104936,2526313960,12,6151,512.5833333,1362104911341,1362104912493,2526289301,2526290453,1152
1362104940,2526317860,9,861,95.66666667,1362104912655,1362104912847,2526290515,2526290707,192
1362104940,2526317864,9,861,95.66666667,1362104912970,1362104913226,2526290834,2526291090,256
1362104940,2526317868,1,46,46,1362104913288,1362104913288,2526291156,2526291156,0
1362105181,2526558744,3,189,63,1362105177217,1362105180225,2526554961,2526557969,3008
1362105197,2526575136,2,126,63,1362105183863,1362105191927,2526561999,2526570063,8064
1362105221,2526598824,3,189,63,1362105213872,1362105216944,2526591696,2526594768,3072
1362105221,2526598832,2,126,63,1362105218662,1362105219686,2526596494,2526597518,1024
1362105229,2526606664,2,126,63,1362105221839,1362105225871,2526599503,2526603535,4032
1362105261,2526639012,1,63,63,1362105233586,1362105233586,2526611598,2526611598,0
1362105594,2526971852,4,202,50.5,1362105569612,1362105591500,2526947464,2526969352,21888
1362106099,2527477136,5,522,104.4,1362106072489,1362106093865,2527450625,2527472001,21376
1362106143,2527521024,1,116,116,1362106117977,1362106117977,2527496001,2527496001,0
1362106175,2527553140,1,48,48,1362106146916,1362106146916,2527525056,2527525056,0
1362106218,2527596052,1,48,48,1362106189182,1362106189182,2527567234,2527567234,0
1362106508,2527885776,12,6151,512.5833333,1362106483533,1362106483917,2527861309,2527861693,384
1362106512,2527889632,9,861,95.66666667,1362106484124,1362106484316,2527861756,2527861948,192
1362106512,2527889636,9,861,95.66666667,1362106484439,1362106484631,2527862075,2527862267,192
1362106512,2527889660,8,815,101.875,1362106484671,1362106484863,2527862331,2527862523,192
1362106718,2528095784,4,252,63,1362106709184,1362106716224,2528086968,2528094008,7040
1362106752,2528129852,1,63,63,1362106724221,1362106724221,2528102073,2528102073,0
1362106758,2528135748,4,252,63,1362106749155,1362106756195,2528126903,2528133943,7040
1362106758,2528135800,4,252,63,1362106749040,1362106756080,2528126840,2528133880,7040
1362106792,2528169884,1,63,63,1362106764059,1362106764059,2528141943,2528141943,0
1362106792,2528169972,1,63,63,1362106764034,1362106764034,2528142006,2528142006,0
1362106798,2528175844,3,189,63,1362106790915,1362106793923,2528168759,2528171767,3008
1362106814,2528191812,2,126,63,1362106797989,1362106806053,2528175801,2528183865,8064
1362107566,2528944052,1,46,46,1362107540072,1362107540072,2528918124,2528918124,0
1362107598,2528976108,1,426,426,1362107572208,1362107572208,2528950316,2528950316,0
1362108120,2529497760,1,46,46,1362108094597,1362108094597,2529472357,2529472357,0
1362108140,2529517756,1,60,60,1362108113607,1362108113607,2529491363,2529491363,0
1362108279,2529657436,43,56503,1314.023256,1362108276765,1362108277149,2529655201,2529655585,384
1362108308,2529686252,9,861,95.66666667,1362108282966,1362108283286,2529661218,2529661538,320
1362108308,2529686376,14,6617,472.6428571,1362108282393,1362108282777,2529660769,2529661153,384
1362108308,2529686404,9,861,95.66666667,1362108283198,1362108283518,2529661602,2529661922,320
1362108504,2529881604,2,126,63,1362108502488,1362108503512,2529880092,2529881116,1024
1362108511,2529889480,2,126,63,1362108504622,1362108508654,2529883102,2529887134,4032
1362108528,2529905652,3,189,63,1362108524713,1362108527721,2529902365,2529905373,3008
1362108544,2529921648,2,126,63,1362108531756,1362108539756,2529909404,2529917404,8000
1362108545,2529923128,1,63,63,1362108517069,1362108517069,2529895197,2529895197,0
1362108600,2529977856,2,126,63,1362108598366,1362108599390,2529976222,2529977246,1024
1362108608,2529985844,2,126,63,1362108601385,1362108605417,2529979229,2529983261,4032
1362108637,2530015164,8,815,101.875,1362108612071,1362108612263,2529990235,2529990427,192
1362108637,2530015256,8,815,101.875,1362108611723,1362108611915,2529989979,2529990171,192
1362108637,2530015264,8,815,101.875,1362108612355,1362108612547,2529990619,2529990811,192
1362108637,2530015264,9,861,95.66666667,1362108612674,1362108612802,2529990938,2529991066,128
1362108641,2530019108,1,63,63,1362108613217,1362108613217,2529991325,2529991325,0
1362108872,2530250016,2,126,63,1362108868856,1362108869880,2530246872,2530247896,1024
1362108872,2530250088,3,189,63,1362108868718,1362108871726,2530246806,2530249814,3008
1362108880,2530257968,2,126,63,1362108871912,1362108875944,2530249880,2530253912,4032
1362108888,2530265988,2,126,63,1362108886355,1362108887379,2530264343,2530265367,1024
1362108888,2530266016,2,126,63,1362108875830,1362108883894,2530253846,2530261910,8064
1362108896,2530274020,2,126,63,1362108889331,1362108893363,2530267351,2530271383,4032
1362108896,2530274028,3,189,63,1362108892650,1362108895722,2530270678,2530273750,3072
1362108910,2530287616,1,63,63,1362108884358,1362108884358,2530261974,2530261974,0
1362108912,2530290056,2,126,63,1362108899661,1362108907725,2530277717,2530285781,8064
1362108930,2530307572,1,63,63,1362108901877,1362108901877,2530279449,2530279449,0
1362109543,2530921400,1,46,46,1362109517102,1362109517102,2530895502,2530895502,0
1362109543,2530921404,1,46,46,1362109517419,1362109517419,2530895823,2530895823,0
1362109787,2531165476,1,46,46,1362109760607,1362109760607,2531139083,2531139083,0
1362110429,2531807072,9,861,95.66666667,1362110402663,1362110402983,2531780735,2531781055,320
1362110429,2531807152,13,6234,479.5384615,1362110402135,1362110402455,2531780287,2531780607,320
1362110429,2531807184,9,861,95.66666667,1362110403001,1362110403193,2531781185,2531781377,192
1362110429,2531807188,8,815,101.875,1362110403316,1362110403572,2531781504,2531781760,256
1362110650,2532028220,3,189,63,1362110645200,1362110648272,2532023420,2532026492,3072
1362110666,2532044180,2,126,63,1362110652347,1362110660347,2532030527,2532038527,8000
1362110682,2532060252,3,189,63,1362110678127,1362110681135,2532056379,2532059387,3008
1362110698,2532076216,2,126,63,1362110685204,1362110693204,2532063420,2532071420,8000
1362110738,2532116248,3,189,63,1362110732276,1362110735348,2532110524,2532113596,3072
1362110738,2532116328,3,189,63,1362110732132,1362110735204,2532110460,2532113532,3072
1362110754,2532132276,2,126,63,1362110739288,1362110747352,2532117564,2532125628,8064
1362110754,2532132364,2,126,63,1362110739201,1362110747201,2532117565,2532125565,8000
1362112221,2533598796,14,6617,472.6428571,1362112193634,1362112193954,2533571430,2533571750,320
1362112221,2533598800,8,815,101.875,1362112194014,1362112194206,2533571814,2533572006,192
1362112221,2533598916,9,861,95.66666667,1362112194218,1362112194346,2533572134,2533572262,128
1362112221,2533598916,8,815,101.875,1362112194472,1362112194600,2533572388,2533572516,128
1362112446,2533823600,2,126,63,1362112443556,1362112444580,2533821156,2533822180,1024
1362112454,2533831536,2,126,63,1362112446691,1362112450723,2533824227,2533828259,4032
1362112485,2533863172,3,155,51.66666667,1362112458149,1362112479781,2533836321,2533857953,21632
1362112485,2533863512,3,138,46,1362112479441,1362112479505,2533857953,2533858017,64
1362112486,2533863564,3,138,46,1362112480390,1362112480454,2533857954,2533858018,64
1362112505,2533883308,2,109,54.5,1362112479707,1362112479707,2533858015,2533858015,0
1362112509,2533887200,9,861,95.66666667,1362112481672,1362112481864,2533859872,2533860064,192
1362112509,2533887312,9,861,95.66666667,1362112481818,1362112482074,2533860130,2533860386,256
1362112509,2533887316,8,815,101.875,1362112482135,1362112482327,2533860451,2533860643,192
1362112509,2533887316,8,815,101.875,1362112482452,1362112482580,2533860768,2533860896,128
1362112694,2534071896,2,126,63,1362112692533,1362112693557,2534070429,2534071453,1024
1362112702,2534079956,4,252,63,1362112692920,1362112700024,2534070876,2534077980,7104
1362112702,2534079992,2,126,63,1362112695509,1362112699541,2534073501,2534077533,4032
1362112734,2534111816,1,63,63,1362112707718,1362112707718,2534085534,2534085534,0
1362112734,2534111820,1,63,63,1362112708161,1362112708161,2534085981,2534085981,0
1362112790,2534168208,3,189,63,1362112786621,1362112789693,2534164829,2534167901,3072
1362112790,2534168208,3,189,63,1362112786685,1362112789693,2534164893,2534167901,3008
1362112806,2534184244,2,126,63,1362112793688,1362112801688,2534171932,2534179932,8000
1362112806,2534184320,2,126,63,1362112793614,1362112801678,2534171934,2534179998,8064
1362114009,2535386856,8,815,101.875,1362113984587,1362113984779,2535362443,2535362635,192
1362114009,2535386908,9,861,95.66666667,1362113983896,1362113984152,2535361804,2535362060,256
1362114009,2535386928,9,861,95.66666667,1362113984258,1362113984386,2535362186,2535362314,128
1362114272,2535649660,3,138,46,1362114270666,1362114270730,2535648326,2535648390,64
1362114272,2535649668,7,390,55.71428571,1362114264770,1362114270722,2535642438,2535648390,5952
1362114278,2535655916,1,433,433,1362114250572,1362114250572,2535628488,2535628488,0
1362114298,2535675824,2,109,54.5,1362114270501,1362114270501,2535648325,2535648325,0
1362114298,2535675828,9,861,95.66666667,1362114272227,1362114272547,2535650055,2535650375,320
1362114298,2535675864,8,815,101.875,1362114272576,1362114272768,2535650440,2535650632,192
1362114298,2535675884,9,861,95.66666667,1362114272810,1362114273066,2535650694,2535650950,256
1362114298,2535675948,1,46,46,1362114272298,1362114272298,2535650246,2535650246,0
1362114298,2535676012,8,815,101.875,1362114273066,1362114273258,2535651078,2535651270,192
1362114592,2535970052,2,126,63,1362114590461,1362114591485,2535968513,2535969537,1024
1362114592,2535970104,2,126,63,1362114590410,1362114591370,2535968514,2535969474,960
1362114600,2535978148,2,126,63,1362114593374,1362114597406,2535971522,2535975554,4032
1362114600,2535978148,2,126,63,1362114593437,1362114597469,2535971585,2535975617,4032
1362114631,2536008648,1,63,63,1362114605968,1362114605968,2535983616,2535983616,0
1362114631,2536008652,1,63,63,1362114605963,1362114605963,2535983615,2535983615,0
1362114632,2536010148,2,126,63,1362114630238,1362114631262,2536008386,2536009410,1024
1362114640,2536018120,2,126,63,1362114633274,1362114637306,2536011394,2536015426,4032
1362114671,2536048556,1,63,63,1362114645932,1362114645932,2536023488,2536023488,0
1362114688,2536066168,3,189,63,1362114681224,1362114684232,2536059392,2536062400,3008
1362114704,2536082100,2,126,63,1362114688333,1362114696333,2536066433,2536074433,8000
1362115292,2536670232,1,46,46,1362115264062,1362115264062,2536642294,2536642294,0
1362115316,2536694356,1,46,46,1362115287556,1362115287556,2536665912,2536665912,0
1362115493,2536870860,1,46,46,1362115465839,1362115465839,2536843699,2536843699,0
1362115537,2536915088,12,999,83.25,1362115522316,1362115533900,2536900404,2536911988,11584
1362115537,2536915088,12,999,83.25,1362115522826,1362115533898,2536900914,2536911986,11072
1362115537,2536915160,12,999,83.25,1362115523013,1362115533829,2536901173,2536911989,10816
1362116499,2537876964,1,46,46,1362116471736,1362116471736,2537849700,2537849700,0
1362116742,2538119780,1,46,46,1362116712943,1362116712943,2538090723,2538090723,0
