unix_secs,sysuptime,dpkts,doctets,doctets/dpkts,Real First Packet,Real End Packet,first,last,Duration
1359738460,159845440,1,46,46,1359738433994,1359738433994,159819434,159819434,0
1359739002,160387560,1,46,46,1359738974857,1359738974857,160360417,160360417,0
1359739066,160451252,1,60,60,1359739040443,1359739040443,160425695,160425695,0
1359739198,160583536,1,60,60,1359739170720,1359739170720,160556256,160556256,0
1359739262,160647696,1,56,56,1359739236735,1359739236735,160622431,160622431,0
1359739514,160900028,1,48,48,1359739485869,1359739485869,160871897,160871897,0
1359739912,161297556,1,46,46,1359739887616,1359739887616,161273172,161273172,0
1359741307,162692572,1,46,46,1359741280539,1359741280539,162666111,162666111,0
1359741744,163129900,5,1659,331.8,1359741739340,1359741739596,163125240,163125496,256
1359741744,163129912,2,98,49,1359741737537,1359741743489,163123449,163129401,5952
1359741744,163129912,2,98,49,1359741737537,1359741743489,163123449,163129401,5952
1359741744,163129912,2,98,49,1359741737664,1359741743488,163123576,163129400,5824
1359741744,163129984,2,98,49,1359741737462,1359741743414,163123446,163129398,5952
1359741744,163129984,2,98,49,1359741737462,1359741743414,163123446,163129398,5952
1359741744,163129988,2,98,49,1359741737462,1359741743414,163123450,163129402,5952
1359741744,163129988,4,190,47.5,1359741737844,1359741743476,163123832,163129464,5632
1359741746,3096410088,3,144,48,1359741738020,1359741743972,3096402108,3096408060,5952
1359741746,3096410092,3,144,48,1359741736480,1359741742048,3096400572,3096406140,5568
1359741746,3096410092,3,144,48,1359741736480,1359741742176,3096400572,3096406268,5696
1359741746,3096410092,4,190,47.5,1359741736480,1359741742176,3096400572,3096406268,5696
1359741746,3096410096,2,98,49,1359741738011,1359741743963,3096402107,3096408059,5952
1359741746,3096410096,3,144,48,1359741738011,1359741743963,3096402107,3096408059,5952
1359741746,3096410100,3,144,48,1359741736471,1359741742167,3096400571,3096406267,5696
1359741746,3096410100,3,144,48,1359741736471,1359741742167,3096400571,3096406267,5696
1359741746,3096410100,3,144,48,1359741736471,1359741742167,3096400571,3096406267,5696
1359741754,163139620,1,46,46,1359741727394,1359741727394,163113014,163113014,0
1359741754,163139732,2,92,46,1359741739954,1359741745714,163125686,163131446,5760
1359741754,163139788,4,190,47.5,1359741739706,1359741745722,163125494,163131510,6016
1359741754,163139792,3,144,48,1359741739766,1359741745654,163125558,163131446,5888
1359741754,163139792,9,875,97.22222222,1359741739833,1359741744953,163125625,163130745,5120
1359741760,163146064,6,450,75,1359741750698,1359741754026,163136762,163140090,3328
1359741761,163146112,12,2876,239.6666667,1359741754210,1359741754914,163139322,163140026,704
1359741762,3096426088,3,144,48,1359741755683,1359741761699,3096419771,3096425787,6016
1359741762,3096426100,3,144,48,1359741755672,1359741761688,3096419772,3096425788,6016
1359741763,3096427524,9,8496,944,1359741737965,1359741738221,3096402489,3096402745,256
1359741763,3096427548,22,22013,1000.590909,1359741737046,1359741738006,3096401594,3096402554,960
1359741763,3096427556,6,4551,758.5,1359741737551,1359741737871,3096402107,3096402427,320
1359741763,3096427560,5,3533,706.6,1359741737930,1359741737994,3096402490,3096402554,64
1359741763,3096427584,4,2213,553.25,1359741737012,1359741737972,3096401596,3096402556,960
1359741764,163149196,23,18751,815.2608696,1359741736842,1359741741578,163122038,163126774,4736
1359741764,163149200,4,658,164.5,1359741736266,1359741736394,163121466,163121594,128
1359741764,163149204,10,2725,272.5,1359741737029,1359741737413,163122233,163122617,384
1359741764,163149224,16,17267,1079.1875,1359741737711,1359741737839,163122935,163123063,128
1359741764,163149224,5,3212,642.4,1359741737711,1359741738671,163122935,163123895,960
1359741764,163149228,5,3172,634.4,1359741737709,1359741738669,163122937,163123897,960
1359741764,163149228,3,903,301,1359741737709,1359741738669,163122937,163123897,960
1359741764,163149228,8,6358,794.75,1359741737709,1359741741549,163122937,163126777,3840
1359741764,163149228,1,137,137,1359741737836,1359741737836,163123064,163123064,0
1359741764,163149272,8,2954,369.25,1359741736704,1359741736832,163121976,163122104,128
1359741764,163149312,8,1522,190.25,1359741737624,1359741740696,163122936,163126008,3072
1359741764,163149312,5,3085,617,1359741737624,1359741738584,163122936,163123896,960
1359741764,163149312,1,137,137,1359741737815,1359741737815,163123127,163123127,0
1359741764,163149316,3,733,244.3333333,1359741738132,1359741738516,163123448,163123832,384
1359741764,163149320,21,23894,1137.809524,1359741738511,1359741738831,163123831,163124151,320
1359741768,163153208,6,635,105.8333333,1359741740032,1359741740352,163125240,163125560,320
1359741768,163153208,6,1109,184.8333333,1359741740031,1359741740543,163125239,163125751,512
1359741768,163153208,6,585,97.5,1359741740031,1359741740351,163125239,163125559,320
1359741768,163153212,4,1247,311.75,1359741740284,1359741740796,163125496,163126008,512
1359741768,163153212,26,19880,764.6153846,1359741740283,1359741755963,163125495,163141175,15680
1359741768,163153212,65,29689,456.7538462,1359741740283,1359741755323,163125495,163140535,15040
1359741768,163153304,6,522,87,1359741739938,1359741740130,163125242,163125434,192
1359741768,163153304,8,4269,533.625,1359741740127,1359741740831,163125431,163126135,704
1359741768,163153304,10,5371,537.1,1359741740191,1359741741151,163125495,163126455,960
1359741768,163153304,18,4038,224.3333333,1359741740254,1359741755294,163125558,163140598,15040
1359741772,163157260,2,98,49,1359741744204,1359741744204,163129464,163129464,0
1359741775,3096439576,8,1036,129.5,1359741750778,1359741751034,3096415354,3096415610,256
1359741776,163161264,2,474,237,1359741751751,1359741751879,163137015,163137143,128
1359741776,163161320,25,18537,741.48,1359741750734,1359741755854,163136054,163141174,5120
1359741781,163166448,1,46,46,1359741753678,1359741753678,163139126,163139126,0
1359741781,163166484,1,46,46,1359741753645,1359741753645,163139129,163139129,0
1359741781,163166568,26,16128,620.3076923,1359741753816,1359741755608,163139384,163141176,1792
1359741781,163166568,23,15728,683.826087,1359741753751,1359741755607,163139319,163141175,1856
1359741781,163166572,12,3534,294.5,1359741754451,1359741754579,163140023,163140151,128
1359741782,163167120,1,46,46,1359741754008,1359741754008,163139128,163139128,0
1359741808,163193300,7,2291,327.2857143,1359741781669,1359741782373,163166969,163167673,704
1359741808,163193312,1,137,137,1359741782617,1359741782617,163167929,163167929,0
1359741808,163193380,2,123,61.5,1359741781652,1359741781716,163167032,163167096,64
1359741808,163193380,3,169,56.33333333,1359741781651,1359741781715,163167031,163167095,64
1359741816,163201224,5,2762,552.4,1359741788463,1359741788719,163173687,163173943,256
1359741816,163201228,34,31815,935.7352941,1359741788778,1359741789738,163174006,163174966,960
1359741824,163209296,2,123,61.5,1359741799784,1359741799784,163185080,163185080,0
1359741824,163209296,1,77,77,1359741799784,1359741799784,163185080,163185080,0
1359741824,163209296,3,138,46,1359741799655,1359741799655,163184951,163184951,0
1359741824,163209384,1,77,77,1359741799696,1359741799696,163185080,163185080,0
1359741828,163213248,1,77,77,1359741800792,1359741800792,163186040,163186040,0
1359741828,163213248,1,77,77,1359741800792,1359741800792,163186040,163186040,0
1359741828,163213336,2,123,61.5,1359741800702,1359741800766,163186038,163186102,64
1359741828,163213336,2,123,61.5,1359741800765,1359741800765,163186101,163186101,0
1359741840,163225388,1,137,137,1359741814028,1359741814028,163199416,163199416,0
1359741848,163233404,6,1079,179.8333333,1359741822396,1359741828668,163207800,163214072,6272
1359741852,163237480,2,123,61.5,1359741825646,1359741825646,163211126,163211126,0
1359741852,163237572,1,77,77,1359741825555,1359741825555,163211127,163211127,0
1359741856,163242072,2,92,46,1359741855709,1359741855709,163241781,163241781,0
1359741856,163242072,2,92,46,1359741855709,1359741855709,163241781,163241781,0
1359741856,163242080,3,138,46,1359741852632,1359741852696,163238712,163238776,64
1359741856,163242088,2,92,46,1359741853647,1359741853647,163239735,163239735,0
1359741856,163242088,3,138,46,1359741853647,1359741854223,163239735,163240311,576
1359741857,163242124,3,138,46,1359741856658,1359741856722,163241782,163241846,64
1359741857,163242124,3,138,46,1359741856658,1359741856786,163241782,163241910,128
1359741857,163242124,3,138,46,1359741856658,1359741856722,163241782,163241846,64
1359741868,163253512,2,123,61.5,1359741843599,1359741843663,163229111,163229175,64
1359741868,163253512,1,77,77,1359741843599,1359741843599,163229111,163229111,0
1359741868,163253612,2,123,61.5,1359741843498,1359741843626,163229110,163229238,128
1359741872,163257468,2,123,61.5,1359741844665,1359741844793,163230133,163230261,128
1359741872,163257500,2,123,61.5,1359741845593,1359741845657,163231093,163231157,64
1359741872,163257576,2,123,61.5,1359741844559,1359741844623,163230135,163230199,64
1359741872,163257576,1,77,77,1359741844559,1359741844559,163230135,163230135,0
1359741872,163257592,1,137,137,1359741845888,1359741845888,163231480,163231480,0
1359741873,163258172,7,412,58.85714286,1359741869988,1359741870052,163255160,163255224,64
1359741873,163258172,7,412,58.85714286,1359741869923,1359741869987,163255095,163255159,64
1359741876,163261616,2,92,46,1359741851112,1359741851176,163236728,163236792,64
1359741880,3096543768,2,92,46,1359741854629,1359741854629,3096518397,3096518397,0
1359741880,3096543768,1,46,46,1359741854629,1359741854629,3096518397,3096518397,0
1359741880,3096543768,1,46,46,1359741854629,1359741854629,3096518397,3096518397,0
1359741880,3096543800,1,46,46,1359741854597,1359741854597,3096518397,3096518397,0
1359741880,3096543800,1,46,46,1359741854597,1359741854597,3096518397,3096518397,0
1359741880,163265476,1,46,46,1359741854259,1359741854259,163239735,163239735,0
1359741880,163265476,2,92,46,1359741854576,1359741854640,163240052,163240116,64
1359741880,163265484,2,92,46,1359741855209,1359741855273,163240693,163240757,64
1359741880,163265552,1,46,46,1359741854181,1359741854181,163239733,163239733,0
1359741880,163265556,1,46,46,1359741854178,1359741854178,163239734,163239734,0
1359741880,163265560,1,46,46,1359741855133,1359741855133,163240693,163240693,0
1359741882,3096546120,5,871,174.2,1359741877444,1359741877636,3096541564,3096541756,192
1359741884,163269476,2,92,46,1359741857265,1359741857265,163242741,163242741,0
1359741884,163269568,1,46,46,1359741857172,1359741857172,163242740,163242740,0
1359741888,163273528,1,46,46,1359741863740,1359741863740,163249268,163249268,0
1359741888,163273532,1,46,46,1359741859899,1359741859899,163245431,163245431,0
1359741896,163281444,3,491,163.6666667,1359741868240,1359741868368,163253684,163253812,128
1359741896,163282108,9,516,57.33333333,1359741889082,1359741892602,163275190,163278710,3520
1359741896,163282108,6,421,70.16666667,1359741889082,1359741890042,163275190,163276150,960
1359741896,163282108,6,378,63,1359741889273,1359741889657,163275381,163275765,384
1359741897,163282176,6,378,63,1359741890205,1359741890589,163275381,163275765,384
1359741897,163282180,8,458,57.25,1359741890904,1359741890968,163276084,163276148,64
1359741900,163285488,18,8221,456.7222222,1359741872805,1359741873125,163258293,163258613,320
1359741900,163285568,6,483,80.5,1359741872661,1359741872981,163258229,163258549,320
1359741900,163285576,5,336,67.2,1359741872847,1359741873039,163258423,163258615,192
1359741904,3096567772,10,9832,983.2,1359741878303,1359741878623,3096542075,3096542395,320
1359741904,3096567772,10,7415,741.5,1359741878303,1359741878687,3096542075,3096542459,384
1359741904,3096567772,6,4224,704,1359741878303,1359741879327,3096542075,3096543099,1024
1359741904,3096567780,2,112,56,1359741879001,1359741879705,3096542781,3096543485,704
1359741904,3096567808,27,27108,1004,1359741877948,1359741879804,3096541756,3096543612,1856
1359741904,3096567808,5,2656,531.2,1359741878203,1359741878843,3096542011,3096542651,640
1359741904,3096567820,6,2216,369.3333333,1359741878321,1359741879345,3096542141,3096543165,1024
1359741904,163289456,4,798,199.5,1359741877190,1359741877318,163262646,163262774,128
1359741904,163289456,3,168,56,1359741877381,1359741879045,163262837,163264501,1664
1359741904,163289540,4,384,96,1359741877104,1359741880368,163262644,163265908,3264
1359741904,163289540,3,168,56,1359741877360,1359741879152,163262900,163264692,1792
1359741904,163289540,3,168,56,1359741877424,1359741879664,163262964,163265204,2240
1359741908,163293540,1,137,137,1359741880434,1359741880434,163265974,163265974,0
1359741921,163306152,3,144,48,1359741913203,1359741918259,163298355,163303411,5056
1359741929,163314200,3,144,48,1359741915845,1359741921221,163301045,163306421,5376
1359741932,163317516,2,92,46,1359741904391,1359741904455,163289907,163289971,64
1359741932,163317620,2,92,46,1359741905314,1359741905314,163290934,163290934,0
1359741936,163321588,6,1096,182.6666667,1359741908098,1359741910338,163293686,163295926,2240
1359741940,163325588,1,137,137,1359741912767,1359741912767,163298355,163298355,0
1359741944,163329564,5,340,68,1359741917531,1359741934235,163303095,163319799,16704
1359741944,163329588,3,169,56.33333333,1359741917568,1359741917632,163303156,163303220,64
1359741944,163329672,23,8445,367.173913,1359741917419,1359741934059,163303091,163319731,16640
1359741945,163330264,3,144,48,1359741943622,1359741943814,163328886,163329078,192
1359741953,163338208,3,144,48,1359741943611,1359741948859,163328819,163334067,5248
1359741953,163338288,2,98,49,1359741943534,1359741948718,163328822,163334006,5184
1359741960,3096623804,5,280,56,1359741934272,1359741959424,3096598076,3096623228,25152
1359741960,163345580,6,483,80.5,1359741932999,1359741933127,163318579,163318707,128
1359741960,163345584,5,280,56,1359741933190,1359741958278,163318774,163343862,25088
1359741960,163345612,7,529,75.57142857,1359741933803,1359741933931,163319415,163319543,128
1359741960,163345692,5,280,56,1359741933209,1359741958361,163318901,163344053,25152
1359741960,163345692,10,560,56,1359741933337,1359741959193,163319029,163344885,25856
1359741960,163345696,10,960,96,1359741933653,1359741959381,163319349,163345077,25728
1359741968,163353656,94,79487,845.606383,1359741943358,1359741962046,163329014,163347702,18688
1359741969,163354340,2,98,49,1359741962298,1359741962362,163347638,163347702,64
1359741969,163354404,2,98,49,1359741961592,1359741961848,163346996,163347252,256
1359741969,163354408,3,144,48,1359741961590,1359741961910,163346998,163347318,320
1359741970,3096634112,12,3287,273.9166667,1359741946957,1359741962317,3096611069,3096626429,15360
1359741972,163357572,12,783,65.25,1359741944593,1359741963217,163330165,163348789,18624
1359741972,163357612,2,681,340.5,1359741946023,1359741946215,163331635,163331827,192
1359741972,163357656,56,24491,437.3392857,1359741944124,1359741962876,163329780,163348532,18752
1359741976,163361588,1,137,137,1359741948737,1359741948737,163334325,163334325,0
1359741976,163361620,3,491,163.6666667,1359741950048,1359741950176,163335668,163335796,128
1359741986,3096650104,11,10328,938.9090909,1359741984213,1359741985045,3096648317,3096649149,832
1359741988,3096651756,3,168,56,1359741961906,1359741985458,3096625662,3096649214,23552
1359741988,163373584,7,392,56,1359741960964,1359741987652,163346548,163373236,26688
1359741988,163373592,5,480,96,1359741961277,1359741984829,163346869,163370421,23552
1359741988,163373596,94,103238,1098.276596,1359741961466,1359741984698,163347062,163370294,23232
1359741988,163373616,1,77,77,1359741961764,1359741961764,163347380,163347380,0
1359741988,163373672,4,224,56,1359741961005,1359741986221,163346677,163371893,25216
1359741988,163373700,70,69484,992.6285714,1359741961552,1359741984400,163347252,163370100,22848
1359741988,163373708,3,168,56,1359741961930,1359741985930,163347638,163371638,24000
1359741988,163373708,10,812,81.2,1359741961993,1359741962185,163347701,163347893,192
1359741994,3096658092,12,9444,787,1359741986273,1359741986465,3096650365,3096650557,192
1359741994,3096658096,10,8985,898.5,1359741993310,1359741993566,3096657406,3096657662,256
1359741994,3096658096,7,1853,264.7142857,1359741993502,1359741993630,3096657598,3096657726,128
1359741994,3096658096,12,10242,853.5,1359741993310,1359741993630,3096657406,3096657726,320
1359741994,3096658096,6,1807,301.1666667,1359741993309,1359741993501,3096657405,3096657597,192
1359741994,3096658116,7,2338,334,1359741993161,1359741993289,3096657277,3096657405,128
1359741994,3096658116,7,2001,285.8571429,1359741993289,1359741993481,3096657405,3096657597,192
1359741994,3096658116,8,4530,566.25,1359741993289,1359741993481,3096657405,3096657597,192
1359741994,3096658116,11,10495,954.0909091,1359741993289,1359741993609,3096657405,3096657725,320
1359741994,3096658116,5,1127,225.4,1359741993481,1359741993609,3096657597,3096657725,128
1359741994,3096658116,7,2007,286.7142857,1359741993736,1359741993864,3096657852,3096657980,128
1359742002,3096666088,3,138,46,1359741994276,1359741994340,3096658364,3096658428,64
1359742002,3096666088,2,92,46,1359741994275,1359741994275,3096658363,3096658363,0
1359742002,3096666100,2,92,46,1359741994267,1359741994267,3096658367,3096658367,0
1359742002,3096666100,2,92,46,1359741994267,1359741994267,3096658367,3096658367,0
1359742002,3096666100,2,92,46,1359741994266,1359741994266,3096658366,3096658366,0
1359742002,3096666116,4,196,49,1359741993737,1359741999305,3096657853,3096663421,5568
1359742002,3096666116,3,138,46,1359741995208,1359741995336,3096659324,3096659452,128
1359742004,163389708,3,169,56.33333333,1359741977670,1359741977670,163363378,163363378,0
1359742009,163394652,8,458,57.25,1359742006720,1359742006720,163392372,163392372,0
1359742012,163397688,8,6481,810.125,1359741984027,1359741984539,163369715,163370227,512
1359742012,163397856,1,137,137,1359741987380,1359741987380,163373236,163373236,0
1359742016,3096680012,2,112,56,1359741989873,1359741995249,3096653885,3096659261,5376
1359742016,163401708,4,384,96,1359741989318,1359741996166,163375026,163381874,6848
1359742016,163401740,8,521,65.125,1359741989671,1359742009191,163375411,163394931,19520
1359742016,163401840,40,16505,412.625,1359741989381,1359742009093,163375221,163394933,19712
1359742016,163401840,6,1099,183.1666667,1359741989893,1359741995845,163375733,163381685,5952
1359742016,163401840,4,224,56,1359741989572,1359741998852,163375412,163384692,9280
1359742018,3096682092,13,5196,399.6923077,1359742016992,1359742017632,3096681084,3096681724,640
1359742018,3096682104,6,867,144.5,1359742016983,1359742016983,3096681087,3096681087,0
1359742018,3096682104,11,8528,775.2727273,1359742017622,1359742017814,3096681726,3096681918,192
1359742020,163405692,2,691,345.5,1359741992793,1359741992857,163378485,163378549,64
1359742020,163405768,3,168,56,1359741993418,1359742019338,163379186,163405106,25920
1359742020,163405792,3,168,56,1359741993524,1359742019700,163379316,163405492,26176
1359742025,163410664,6,1131,188.5,1359742016949,1359742017205,163402613,163402869,256
1359742025,163410664,6,1130,188.3333333,1359742017203,1359742017459,163402867,163403123,256
1359742024,3096688088,10,6372,637.2,1359742019877,1359742020389,3096683965,3096684477,512
1359742024,3096688088,9,1442,160.2222222,1359742019941,1359742020645,3096684029,3096684733,704
1359742024,3096688088,10,2394,239.4,1359742019941,1359742020517,3096684029,3096684605,576
1359742026,3096690088,34,40616,1194.588235,1359742018084,1359742018404,3096682172,3096682492,320
1359742026,3096690088,8,2120,265,1359742018084,1359742018276,3096682172,3096682364,192
1359742026,3096690088,9,2326,258.4444444,1359742018084,1359742018212,3096682172,3096682300,128
1359742026,3096690088,10,2532,253.2,1359742018148,1359742018660,3096682236,3096682748,512
1359742026,3096690088,26,30455,1171.346154,1359742018211,1359742018915,3096682299,3096683003,704
1359742026,3096690088,16,15955,997.1875,1359742018275,1359742018851,3096682363,3096682939,576
1359742026,3096690092,10,1696,169.6,1359742018274,1359742018786,3096682366,3096682878,512
1359742026,3096690096,9,1612,179.1111111,1359742018782,1359742019294,3096682878,3096683390,512
1359742026,3096690096,10,2212,221.2,1359742018974,1359742019486,3096683070,3096683582,512
1359742026,3096690096,37,42236,1141.513514,1359742019037,1359742020253,3096683133,3096684349,1216
1359742026,3096690096,19,15623,822.2631579,1359742019101,1359742020189,3096683197,3096684285,1088
1359742026,3096690096,9,1730,192.2222222,1359742019293,1359742019869,3096683389,3096683965,576
1359742026,3096690096,9,1448,160.8888889,1359742019741,1359742020253,3096683837,3096684349,512
1359742026,3096690096,11,6876,625.0909091,1359742019676,1359742020316,3096683772,3096684412,640
1359742026,3096690096,9,2166,240.6666667,1359742018075,1359742018267,3096682171,3096682363,192
1359742026,3096690100,8,1950,243.75,1359742018075,1359742018139,3096682175,3096682239,64
1359742026,3096690100,10,1146,114.6,1359742018074,1359742018138,3096682174,3096682238,64
1359742026,3096690100,10,2360,236,1359742018265,1359742018969,3096682365,3096683069,704
1359742026,3096690100,10,2596,259.6,1359742018647,1359742019095,3096682747,3096683195,448
1359742026,3096690116,10,1930,193,1359742018698,1359742019146,3096682814,3096683262,448
1359742026,3096690116,8,3332,416.5,1359742019144,1359742019592,3096683260,3096683708,448
1359742026,3096690116,14,10069,719.2142857,1359742019208,1359742019720,3096683324,3096683836,512
1359742026,3096690116,10,1804,180.4,1359742019272,1359742019848,3096683388,3096683964,576
1359742032,163417852,1,77,77,1359742006519,1359742006519,163392371,163392371,0
1359742034,3096698088,9,1484,164.8888889,1359742032038,1359742033510,3096696126,3096697598,1472
1359742034,3096698088,9,590,65.55555556,1359742020197,1359742026021,3096684285,3096690109,5824
1359742034,3096698092,10,5230,523,1359742033824,1359742033952,3096697916,3096698044,128
1359742034,3096698100,11,7046,640.5454545,1359742033560,1359742033752,3096697660,3096697852,192
1359742034,3096698100,10,1514,151.4,1359742033496,1359742033560,3096697596,3096697660,64
1359742036,163421788,7,529,75.57142857,1359742008825,1359742009017,163394613,163394805,192
1359742042,3096706092,9,1554,172.6666667,1359742036065,1359742036385,3096700157,3096700477,320
1359742042,3096706092,14,12755,911.0714286,1359742036129,1359742036449,3096700221,3096700541,320
1359742042,3096706092,26,26399,1015.346154,1359742036257,1359742036577,3096700349,3096700669,320
1359742042,3096706092,9,1484,164.8888889,1359742036640,1359742037024,3096700732,3096701116,384
1359742042,3096706092,8,2296,287,1359742036640,1359742036960,3096700732,3096701052,320
1359742042,3096706092,8,1358,169.75,1359742036639,1359742037023,3096700731,3096701115,384
1359742042,3096706092,9,1692,188,1359742036895,1359742037087,3096700987,3096701179,192
1359742042,3096706092,8,2168,271,1359742037023,1359742037215,3096701115,3096701307,192
1359742042,3096706096,9,1362,151.3333333,1359742037023,1359742037151,3096701119,3096701247,128
1359742042,3096706096,10,7752,775.2,1359742034399,1359742034655,3096698495,3096698751,256
1359742042,3096706096,10,1264,126.4,1359742037214,1359742037278,3096701310,3096701374,64
1359742042,3096706096,11,1214,110.3636364,1359742034397,1359742034717,3096698493,3096698813,320
1359742042,3096706096,8,1316,164.5,1359742034716,1359742034780,3096698812,3096698876,64
1359742042,3096706096,10,1488,148.8,1359742034716,1359742035228,3096698812,3096699324,512
1359742042,3096706096,9,1122,124.6666667,1359742034716,1359742035164,3096698812,3096699260,448
1359742042,3096706100,10,8082,808.2,1359742033818,1359742033946,3096697918,3096698046,128
1359742042,3096706100,8,3656,457,1359742033818,1359742034074,3096697918,3096698174,256
1359742042,3096706100,9,5584,620.4444444,1359742033818,1359742034202,3096697918,3096698302,384
1359742042,3096706100,9,4518,502,1359742033818,1359742034138,3096697918,3096698238,320
1359742042,3096706100,12,9965,830.4166667,1359742035226,1359742035482,3096699326,3096699582,256
1359742042,3096706100,12,9805,817.0833333,1359742035353,1359742035545,3096699453,3096699645,192
1359742042,3096706100,13,10747,826.6923077,1359742035353,1359742035673,3096699453,3096699773,320
1359742042,3096706100,13,7099,546.0769231,1359742035417,1359742036121,3096699517,3096700221,704
1359742042,3096706100,24,24695,1028.958333,1359742035417,1359742036185,3096699517,3096700285,768
1359742042,3096706100,11,1658,150.7272727,1359742035609,1359742036313,3096699709,3096700413,704
1359742042,3096706104,9,4102,455.7777778,1359742034070,1359742034326,3096698174,3096698430,256
1359742042,3096706104,7,4768,681.1428571,1359742036182,1359742036374,3096700286,3096700478,192
1359742042,3096706104,8,1044,130.5,1359742036246,1359742036502,3096700350,3096700606,256
1359742042,3096706104,9,1442,160.2222222,1359742036437,1359742036565,3096700541,3096700669,128
1359742042,3096706104,8,1636,204.5,1359742036373,1359742036501,3096700477,3096700605,128
1359742042,3096706104,8,1668,208.5,1359742036501,1359742036629,3096700605,3096700733,128
1359742042,3096706104,9,2204,244.8888889,1359742036437,1359742036629,3096700541,3096700733,192
1359742042,3096706104,9,6320,702.2222222,1359742034133,1359742034325,3096698237,3096698429,192
1359742042,3096706104,8,2424,303,1359742036629,1359742036885,3096700733,3096700989,256
1359742042,3096706104,8,1422,177.75,1359742036629,1359742036885,3096700733,3096700989,256
1359742042,3096706104,10,1466,146.6,1359742036629,1359742037077,3096700733,3096701181,448
1359742042,3096706104,9,2246,249.5555556,1359742036949,1359742037205,3096701053,3096701309,256
1359742042,3096706104,10,1498,149.8,1359742036949,1359742037205,3096701053,3096701309,256
1359742042,3096706104,9,1650,183.3333333,1359742037204,1359742037268,3096701308,3096701372,64
1359742042,3096706104,12,9390,782.5,1359742034388,1359742034644,3096698492,3096698748,256
1359742042,3096706116,8,1284,160.5,1359742034697,1359742035145,3096698813,3096699261,448
1359742042,3096706116,10,2292,229.2,1359742034697,1359742035401,3096698813,3096699517,704
1359742042,3096706116,9,1346,149.5555556,1359742034696,1359742035144,3096698812,3096699260,448
1359742042,3096706120,14,12557,896.9285714,1359742033799,1359742034119,3096697919,3096698239,320
1359742042,3096706120,8,4696,587,1359742035142,1359742035462,3096699262,3096699582,320
1359742042,3096706120,10,2010,201,1359742035142,1359742035334,3096699262,3096699454,192
1359742042,3096706120,9,2886,320.6666667,1359742035206,1359742035398,3096699326,3096699518,192
1359742042,3096706120,10,4112,411.2,1359742035461,1359742036101,3096699581,3096700221,640
1359742042,3096706120,10,1500,150,1359742035525,1359742036101,3096699645,3096700221,576
1359742044,3096708060,6,336,56,1359742018753,1359742036929,3096682813,3096700989,18176
1359742044,163429752,13,1248,96,1359742018333,1359742043677,163404085,163429429,25344
1359742044,163429756,12,672,56,1359742018905,1359742043353,163404661,163429109,24448
1359742048,163433704,5,280,56,1359742021322,1359742037578,163407026,163423282,16256
1359742048,163433740,2,123,61.5,1359742022629,1359742022629,163408369,163408369,0
1359742048,163433792,1,137,137,1359742021237,1359742021237,163407029,163407029,0
1359742048,163433816,5,280,56,1359742021850,1359742042842,163407666,163428658,20992
1359742049,163434644,2,92,46,1359742037192,1359742043144,163422836,163428788,5952
1359742050,3096714096,8,544,68,1359742037278,1359742043294,3096701374,3096707390,6016
1359742050,3096714096,11,1624,147.6363636,1359742048990,1359742049758,3096713086,3096713854,768
1359742050,3096714096,9,2204,244.8888889,1359742048990,1359742049822,3096713086,3096713918,832
1359742050,3096714104,11,6982,634.7272727,1359742048660,1359742048916,3096712764,3096713020,256
1359742050,3096714104,12,7844,653.6666667,1359742048979,1359742049427,3096713083,3096713531,448
1359742050,3096714104,10,1590,159,1359742048979,1359742049939,3096713083,3096714043,960
1359742050,3096714104,8,1470,183.75,1359742048979,1359742049235,3096713083,3096713339,256
1359742056,163441704,3,169,56.33333333,1359742028621,1359742028685,163414325,163414389,64
1359742056,163441732,3,169,56.33333333,1359742029614,1359742029678,163415346,163415410,64
1359742056,163441816,2,123,61.5,1359742029532,1359742029532,163415348,163415348,0
1359742057,163442684,3,144,48,1359742043872,1359742049056,163429556,163434740,5184
1359742057,163442700,27,30921,1145.222222,1359742036880,1359742052560,163422580,163438260,15680
1359742056,3096720084,14,11561,825.7857143,1359742051880,1359742052392,3096715964,3096716476,512
1359742058,3096722088,10,1168,116.8,1359742052007,1359742052647,3096716095,3096716735,640
1359742058,3096722092,8,1092,136.5,1359742052513,1359742052897,3096716605,3096716989,384
1359742058,3096722092,9,1122,124.6666667,1359742052705,1359742052961,3096716797,3096717053,256
1359742058,3096722092,17,14385,846.1764706,1359742048993,1359742050273,3096713085,3096714365,1280
1359742058,3096722092,10,1322,132.2,1359742052833,1359742053025,3096716925,3096717117,192
1359742058,3096722092,20,18052,902.6,1359742050400,1359742050912,3096714492,3096715004,512
1359742058,3096722092,9,1122,124.6666667,1359742052896,1359742053152,3096716988,3096717244,256
1359742058,3096722092,10,2436,243.6,1359742050400,1359742050720,3096714492,3096714812,320
1359742058,3096722092,9,1090,121.1111111,1359742052960,1359742053216,3096717052,3096717308,256
1359742058,3096722092,8,1508,188.5,1359742053216,1359742053472,3096717308,3096717564,256
1359742058,3096722092,8,1252,156.5,1359742053152,1359742053408,3096717244,3096717500,256
1359742058,3096722092,8,1374,171.75,1359742053535,1359742053727,3096717627,3096717819,192
1359742058,3096722092,12,8190,682.5,1359742053535,1359742053855,3096717627,3096717947,320
1359742058,3096722092,9,1554,172.6666667,1359742053279,1359742053471,3096717371,3096717563,192
1359742058,3096722096,8,1230,153.75,1359742053535,1359742053919,3096717631,3096718015,384
1359742058,3096722096,16,14067,879.1875,1359742050654,1359742051038,3096714750,3096715134,384
1359742058,3096722096,15,13659,910.6,1359742050654,1359742051166,3096714750,3096715262,512
1359742058,3096722096,11,1656,150.5454545,1359742050717,1359742051229,3096714813,3096715325,512
1359742058,3096722096,9,2550,283.3333333,1359742051228,1359742051548,3096715324,3096715644,320
1359742058,3096722096,10,3476,347.6,1359742051419,1359742051803,3096715515,3096715899,384
1359742058,3096722100,9,1426,158.4444444,1359742051803,1359742052315,3096715903,3096716415,512
1359742058,3096722100,10,7032,703.2,1359742051611,1359742051931,3096715711,3096716031,320
1359742058,3096722100,10,1322,132.2,1359742055194,1359742057882,3096719294,3096721982,2688
1359742058,3096722100,11,1336,121.4545455,1359742051929,1359742052825,3096716029,3096716925,896
1359742058,3096722100,9,1128,125.3333333,1359742052121,1359742052697,3096716221,3096716797,576
1359742058,3096722100,9,1128,125.3333333,1359742052311,1359742052823,3096716411,3096716923,512
1359742058,3096722100,8,2008,251,1359742050391,1359742050455,3096714491,3096714555,64
1359742058,3096722104,10,1306,130.6,1359742050391,1359742050583,3096714495,3096714687,192
1359742058,3096722104,9,1122,124.6666667,1359742052631,1359742052887,3096716735,3096716991,256
1359742058,3096722104,15,12369,824.6,1359742050391,1359742050711,3096714495,3096714815,320
1359742058,3096722104,8,4568,571,1359742050391,1359742050647,3096714495,3096714751,256
1359742058,3096722104,9,1324,147.1111111,1359742052822,1359742053014,3096716926,3096717118,192
1359742058,3096722104,10,3402,340.2,1359742052822,1359742053078,3096716926,3096717182,256
1359742058,3096722104,8,2670,333.75,1359742052886,1359742053206,3096716990,3096717310,320
1359742058,3096722104,8,1124,140.5,1359742053014,1359742053270,3096717118,3096717374,256
1359742058,3096722104,8,1236,154.5,1359742053014,1359742053334,3096717118,3096717438,320
1359742058,3096722104,9,4732,525.7777778,1359742053078,1359742053334,3096717182,3096717438,256
1359742058,3096722104,9,1554,172.6666667,1359742053205,1359742053397,3096717309,3096717501,192
1359742058,3096722104,8,1508,188.5,1359742053333,1359742053525,3096717437,3096717629,192
1359742058,3096722104,9,1484,164.8888889,1359742053527,1359742053719,3096717631,3096717823,192
1359742058,3096722104,8,1390,173.75,1359742053527,1359742053783,3096717631,3096717887,256
1359742058,3096722116,11,1800,163.6363636,1359742053515,1359742053963,3096717631,3096718079,448
1359742058,3096722116,9,5168,574.2222222,1359742050635,1359742051083,3096714751,3096715199,448
1359742058,3096722116,9,1666,185.1111111,1359742053898,1359742054026,3096718014,3096718142,128
1359742058,3096722116,8,2264,283,1359742051080,1359742051336,3096715196,3096715452,256
1359742058,3096722116,21,22214,1057.809524,1359742050760,1359742051464,3096714876,3096715580,704
1359742058,3096722116,9,3862,429.1111111,1359742051080,1359742051400,3096715196,3096715516,320
1359742058,3096722116,9,3862,429.1111111,1359742051208,1359742051464,3096715324,3096715580,256
1359742058,3096722116,10,2756,275.6,1359742051143,1359742051463,3096715259,3096715579,320
1359742058,3096722116,10,1434,143.4,1359742051463,1359742051783,3096715579,3096715899,320
1359742058,3096722116,8,2680,335,1359742051467,1359742051787,3096715583,3096715903,320
1359742058,3096722116,9,1276,141.7777778,1359742051531,1359742051915,3096715647,3096716031,384
1359742058,3096722120,8,1358,169.75,1359742051783,1359742052423,3096715903,3096716543,640
1359742058,3096722120,13,9867,759,1359742051654,1359742052038,3096715774,3096716158,384
1359742060,3096724004,1,46,46,1359742034106,1359742034106,3096698110,3096698110,0
1359742064,163449800,2,445,222.5,1359742035884,1359742036076,163421684,163421876,192
1359742064,163449812,7,2082,297.4285714,1359742037023,1359742037151,163422835,163422963,128
1359742066,3096730096,9,590,65.55555556,1359742055260,1359742060572,3096719356,3096724668,5312
1359742072,3096736048,4,224,56,1359742044173,1359742060237,3096708221,3096724285,16064
1359742073,163458700,8,458,57.25,1359742066960,1359742066960,163452660,163452660,0
1359742076,163461716,3,168,56,1359742049087,1359742054975,163434803,163440691,5888
1359742076,163461724,6,336,56,1359742048503,1359742055351,163434227,163441075,6848
1359742076,163461728,6,576,96,1359742048692,1359742057524,163434420,163443252,8832
1359742076,163461760,2,123,61.5,1359742050898,1359742050962,163436658,163436722,64
1359742076,163461796,3,168,56,1359742048816,1359742054832,163434612,163440628,6016
1359742080,163465760,2,123,61.5,1359742053907,1359742053907,163439667,163439667,0
1359742080,163465848,3,169,56.33333333,1359742053819,1359742053819,163439667,163439667,0
1359742080,163465848,1,77,77,1359742053818,1359742053818,163439666,163439666,0
1359742088,163473800,1,137,137,1359742059881,1359742059881,163445681,163445681,0
1359742097,163482692,7,412,58.85714286,1359742095958,1359742096022,163481650,163481714,64
1359742098,3096762160,9,1276,141.7777778,1359742092316,1359742092444,3096756476,3096756604,128
1359742098,3096762164,11,1368,124.3636364,1359742096923,1359742097563,3096761087,3096761727,640
1359742098,3096762164,9,1324,147.1111111,1359742096923,1359742097563,3096761087,3096761727,640
1359742098,3096762164,8,1374,171.75,1359742097626,1359742097754,3096761790,3096761918,128
1359742098,3096762164,13,8300,638.4615385,1359742097626,1359742097818,3096761790,3096761982,192
1359742098,3096762168,10,2250,225,1359742094933,1359742095701,3096759101,3096759869,768
1359742098,3096762168,9,1516,168.4444444,1359742094933,1359742095189,3096759101,3096759357,256
1359742098,3096762172,9,1554,172.6666667,1359742096914,1359742097554,3096761086,3096761726,640
1359742098,3096762172,11,1310,119.0909091,1359742096914,1359742097490,3096761086,3096761662,576
1359742098,3096762172,10,1600,160,1359742096914,1359742097554,3096761086,3096761726,640
1359742098,3096762172,9,1554,172.6666667,1359742096914,1359742097554,3096761086,3096761726,640
1359742098,3096762172,7,1462,208.8571429,1359742097488,1359742097552,3096761660,3096761724,64
1359742098,3096762172,9,1484,164.8888889,1359742097616,1359742097808,3096761788,3096761980,192
1359742098,3096762172,8,1390,173.75,1359742097616,1359742097808,3096761788,3096761980,192
1359742098,3096762172,9,1276,141.7777778,1359742097616,1359742097872,3096761788,3096762044,256
1359742098,3096762188,9,1276,141.7777778,1359742094529,1359742094593,3096758717,3096758781,64
1359742098,3096762188,11,6982,634.7272727,1359742094657,1359742094785,3096758845,3096758973,128
1359742098,3096762188,12,7844,653.6666667,1359742094912,1359742095296,3096759100,3096759484,384
1359742098,3096762188,17,14411,847.7058824,1359742094912,1359742096832,3096759100,3096761020,1920
1359742098,3096762188,10,1578,157.8,1359742094912,1359742095616,3096759100,3096759804,704
1359742098,3096762188,11,1624,147.6363636,1359742094912,1359742095744,3096759100,3096759932,832
1359742100,163485776,2,123,61.5,1359742073859,1359742073923,163459635,163459699,64
1359742100,163485824,2,123,61.5,1359742072851,1359742072851,163458675,163458675,0
1359742100,163485868,1,77,77,1359742073768,1359742073768,163459636,163459636,0
1359742104,163489740,3,491,163.6666667,1359742076006,1359742076134,163461746,163461874,128
1359742106,3096770164,12,1846,153.8333333,1359742097626,1359742098010,3096761790,3096762174,384
1359742114,3096778168,9,1276,141.7777778,1359742112598,1359742112726,3096776766,3096776894,128
1359742121,163506748,7,412,58.85714286,1359742118301,1359742118301,163504049,163504049,0
1359742121,163506784,132,119611,906.1439394,1359741961466,1359742118266,163347250,163504050,156800
1359742121,163506788,8,458,57.25,1359742117239,1359742117303,163503027,163503091,64
1359742121,163506796,8,458,57.25,1359742118254,1359742118254,163504050,163504050,0
1359742122,3096786164,8,544,68,1359742115931,1359742121691,3096780095,3096785855,5760
1359742122,3096786164,8,544,68,1359742115931,1359742121691,3096780095,3096785855,5760
1359742122,3096786168,11,7046,640.5454545,1359742114581,1359742114709,3096778749,3096778877,128
1359742122,3096786168,10,1594,159.4,1359742114709,1359742115221,3096778877,3096779389,512
1359742122,3096786168,11,1736,157.8181818,1359742114708,1359742115092,3096778876,3096779260,384
1359742122,3096786168,14,10473,748.0714286,1359742114772,1359742115604,3096778940,3096779772,832
1359742122,3096786172,9,1218,135.3333333,1359742115666,1359742115986,3096779838,3096780158,320
1359742122,3096786188,9,1356,150.6666667,1359742114433,1359742114561,3096778621,3096778749,128
1359742122,3096786188,13,10667,820.5384615,1359742114753,1359742115649,3096778941,3096779837,896
1359742122,3096786188,13,7890,606.9230769,1359742114691,1359742115267,3096778879,3096779455,576
1359742122,3096786188,10,2262,226.2,1359742114755,1359742115587,3096778943,3096779775,832
1359742122,3096786192,11,2808,255.2727273,1359742115646,1359742115966,3096779838,3096780158,320
1359742122,3096786192,9,1276,141.7777778,1359742115710,1359742116030,3096779902,3096780222,320
1359742124,163509864,1,77,77,1359742098152,1359742098152,163484016,163484016,0
1359742124,163509948,1,77,77,1359742098071,1359742098071,163484019,163484019,0
1359742124,163509948,2,123,61.5,1359742098071,1359742098071,163484019,163484019,0
1359742128,163513888,1,137,137,1359742101969,1359742101969,163487857,163487857,0
1359742130,3096794168,12,10509,875.75,1359742123158,1359742123478,3096787326,3096787646,320
1359742130,3096794168,9,1218,135.3333333,1359742123478,1359742123926,3096787646,3096788094,448
1359742130,3096794168,10,1546,154.6,1359742123478,1359742128406,3096787646,3096792574,4928
1359742130,3096794168,10,1322,132.2,1359742123478,1359742123926,3096787646,3096788094,448
1359742130,3096794184,10,1152,115.2,1359742123461,1359742123845,3096787645,3096788029,384
1359742130,3096794184,10,1147,114.7,1359742123461,1359742128453,3096787645,3096792637,4992
1359742136,163521856,2,92,46,1359742108146,1359742108210,163494002,163494066,64
1359742144,163529880,3,491,163.6666667,1359742115930,1359742115994,163501810,163501874,64
1359742145,163530728,665,696765,1047.766917,1359741735856,1359742142320,163121584,163528048,406464
1359742145,163530764,7,1878,268.2857143,1359742139406,1359742139534,163525170,163525298,128
1359742145,163530764,7,412,58.85714286,1359742143245,1359742143245,163529009,163529009,0
1359742145,163530776,13,3921,301.6153846,1359742140866,1359742141506,163526642,163527282,640
1359742145,163530800,9,2477,275.2222222,1359742141291,1359742141419,163527091,163527219,128
1359742145,163530812,7,412,58.85714286,1359742143197,1359742143197,163529009,163529009,0
1359742145,163530812,6,366,61,1359742143197,1359742143197,163529009,163529009,0
1359742145,163530836,7,1825,260.7142857,1359742139781,1359742139909,163525617,163525745,128
1359742148,3096812192,34,39513,1162.147059,1359742123452,1359742128572,3096787644,3096792764,5120
1359742153,163538688,11,1446,131.4545455,1359742140186,1359742151834,163525874,163537522,11648
1359742153,163538692,9,563,62.55555556,1359742144406,1359742150486,163530098,163536178,6080
1359742153,163538700,3,144,48,1359742141389,1359742147213,163527089,163532913,5824
1359742153,163538704,19,17443,918.0526316,1359742149962,1359742150730,163535666,163536434,768
1359742153,163538740,11,964,87.63636364,1359742140135,1359742151783,163525875,163537523,11648
1359742153,163538744,31,31181,1005.83871,1359742144355,1359742152227,163530099,163537971,7872
1359742160,163545924,1,137,137,1359742133484,1359742133484,163519408,163519408,0
1359742161,163546688,8,544,68,1359742152921,1359742158169,163538609,163543857,5248
1359742161,163546688,18,3868,214.8888889,1359742140184,1359742156696,163525872,163542384,16512
1359742161,163546696,160,117845,736.53125,1359741735698,1359742159314,163121394,163545010,423616
1359742161,163546700,3,144,48,1359742153615,1359742159183,163539315,163544883,5568
1359742161,163546732,62,68155,1099.274194,1359742143853,1359742153197,163529585,163538929,9344
1359742161,163546736,27,13264,491.2592593,1359742140139,1359742155691,163525875,163541427,15552
1359742161,163546736,12,1383,115.25,1359742140139,1359742153643,163525875,163539379,13504
1359742161,163546740,4,190,47.5,1359742153572,1359742159140,163539312,163544880,5568
1359742161,163546768,87,80205,921.8965517,1359742138122,1359742157642,163523890,163543410,19520
1359742161,163546772,3,144,48,1359742150471,1359742156103,163536243,163541875,5632
1359742168,3096832088,12,672,56,1359742142052,1359742163620,3096806140,3096827708,21568
1359742168,163553804,25,1400,56,1359742140389,1359742164581,163526193,163550385,24192
1359742168,163553804,9,2697,299.6666667,1359742140452,1359742140644,163526256,163526448,192
1359742168,163553808,13,3233,248.6923077,1359742140706,1359742141282,163526514,163527090,576
1359742168,163553808,25,2400,96,1359742140705,1359742164705,163526513,163550513,24000
1359742168,163553812,13,728,56,1359742141084,1359742165148,163526896,163550960,24064
1359742168,163553888,11,3000,272.7272727,1359742140817,1359742141073,163526705,163526961,256
1359742168,163553892,13,728,56,1359742141197,1359742167693,163527089,163553585,26496
1359742169,163554724,7,560,80,1359742149236,1359742164852,163534960,163550576,15616
1359742169,163554800,3,1347,449,1359742153899,1359742167787,163539699,163553587,13888
1359742169,163554836,16,14053,878.3125,1359742159302,1359742164550,163545138,163550386,5248
1359742176,3096840080,20,16166,808.3,1359742150636,1359742152812,3096814716,3096816892,2176
1359742176,3096840080,91,105872,1163.428571,1359742150700,1359742160108,3096814780,3096824188,9408
1359742176,3096840128,64,72627,1134.796875,1359742150591,1359742160383,3096814719,3096824511,9792
1359742176,3096840128,62,74310,1198.548387,1359742150591,1359742160447,3096814719,3096824575,9856
1359742176,3096840128,79,91695,1160.696203,1359742150655,1359742160063,3096814783,3096824191,9408
1359742176,3096840128,61,63719,1044.57377,1359742150655,1359742160191,3096814783,3096824319,9536
1359742176,163561896,3,773,257.6666667,1359742150218,1359742150410,163536114,163536306,192
1359742177,163562716,7,3136,448,1359742153981,1359742171197,163539697,163556913,17216
1359742177,163562748,8,2550,318.75,1359742174813,1359742175069,163560561,163560817,256
1359742177,163562784,7,1719,245.5714286,1359742153914,1359742171130,163539698,163556914,17216
1359742180,163565876,6,1096,182.6666667,1359742155804,1359742169180,163541680,163555056,13376
1359742180,163565892,12,3254,271.1666667,1359742152462,1359742160078,163538354,163545970,7616
1359742180,163565896,23,26235,1140.652174,1359742153417,1359742153609,163539313,163539505,192
1359742180,163565896,15,18604,1240.266667,1359742153416,1359742153544,163539312,163539440,128
1359742180,163565972,1,46,46,1359742152958,1359742152958,163538930,163538930,0
1359742185,163570716,8,2550,318.75,1359742180286,1359742180606,163566002,163566322,320
1359742192,163577976,1,137,137,1359742164984,1359742164984,163550960,163550960,0
1359742193,163578788,15,8544,569.6,1359742180853,1359742186101,163566641,163571889,5248
1359742196,3096860128,5,280,56,1359742171453,1359742189181,3096835581,3096853309,17728
1359742196,163581952,9,864,96,1359742169362,1359742189202,163555314,163575154,19840
1359742196,163582020,11,616,56,1359742168973,1359742194189,163554993,163580209,25216
1359742200,163585972,8,448,56,1359742174847,1359742199231,163560819,163585203,24384
1359742200,163586060,15,840,56,1359742174372,1359742199652,163560432,163585712,25280
1359742201,163586800,3,144,48,1359742195753,1359742195881,163581553,163581681,128
1359742201,163586812,3,144,48,1359742196637,1359742196701,163582449,163582513,64
1359742201,163586840,6,2033,338.8333333,1359742181375,1359742193343,163567215,163579183,11968
1359742208,3096872056,4,410,102.5,1359742181766,1359742181830,3096845822,3096845886,64
1359742208,163594040,18,18742,1041.222222,1359742180921,1359742181113,163566961,163567153,192
1359742209,163594768,7,346,49.42857143,1359742200905,1359742207625,163586673,163593393,6720
1359742209,163594808,4,196,49,1359742199843,1359742202147,163585651,163587955,2304
1359742209,163594808,5,248,49.6,1359742199907,1359742208099,163585715,163593907,8192
1359742209,163594840,7,358,51.14285714,1359742201857,1359742207489,163587697,163593329,5632
1359742209,163594840,7,358,51.14285714,1359742201921,1359742207489,163587761,163593329,5568
1359742212,3096876092,13,13126,1009.692308,1359742187300,1359742187364,3096851392,3096851456,64
1359742212,163597992,2,123,61.5,1359742185833,1359742185897,163571825,163571889,64
1359742212,163598072,2,123,61.5,1359742185753,1359742185817,163571825,163571889,64
1359742216,3096880072,4,1010,252.5,1359742188727,1359742189879,3096852799,3096853951,1152
1359742216,163602088,7,2662,380.2857143,1359742191432,1359742196104,163577520,163582192,4672
1359742217,163602748,4,202,50.5,1359742212764,1359742213788,163598512,163599536,1024
1359742217,163602824,8,404,50.5,1359742202257,1359742210129,163588081,163595953,7872
1359742217,163602828,5,248,49.6,1359742210764,1359742213452,163596592,163599280,2688
1359742217,163602836,36,25243,701.1944444,1359742207491,1359742213763,163593327,163599599,6272
1359742221,163606108,9,3000,333.3333333,1359742196382,1359742196958,163581490,163582066,576
1359742221,163606112,27,1512,56,1359742196762,1359742220314,163581874,163605426,23552
1359742221,163606156,9,3087,343,1359742195244,1359742195628,163580400,163580784,384
1359742221,163606192,6,483,80.5,1359742196299,1359742196875,163581491,163582067,576
1359742224,3096888092,14,784,56,1359742196834,1359742223522,3096860926,3096887614,26688
1359742224,163610024,33,3168,96,1359742195977,1359742223497,163582001,163609521,27520
1359742224,163610024,5,1164,232.8,1359742196103,1359742209479,163582127,163595503,13376
1359742224,163610028,26,12111,465.8076923,1359742196484,1359742196804,163582512,163582832,320
1359742224,163610028,12,3610,300.8333333,1359742196547,1359742196739,163582575,163582767,192
1359742225,163610768,2,98,49,1359742220488,1359742222600,163606256,163608368,2112
1359742225,163610776,19,8251,434.2631579,1359742217601,1359742218049,163603377,163603825,448
1359742225,163610780,26,16224,624,1359742218493,1359742218941,163604273,163604721,448
1359742225,163610812,34,10821,318.2647059,1359742219739,1359742223771,163605551,163609583,4032
1359742225,163610824,20,8470,423.5,1359742212497,1359742217553,163598321,163603377,5056
1359742225,163610856,3,144,48,1359742217778,1359742218034,163603634,163603890,256
1359742225,163610856,22,10217,464.4090909,1359742218032,1359742218544,163603888,163604400,512
1359742225,163610864,25,14083,563.32,1359742218857,1359742219241,163604721,163605105,384
1359742225,163610884,24,16052,668.8333333,1359742219220,1359742219668,163605104,163605552,448
1359742228,163614048,34,1904,56,1359742200177,1359742227441,163586225,163613489,27264
1359742228,163614048,16,896,56,1359742200113,1359742227313,163586161,163613361,27200
1359742233,163618120,10,904,90.4,1359742205327,1359742232207,163590447,163617327,26880
1359742233,163618788,20,12133,606.65,1359742226292,1359742232244,163612080,163618032,5952
1359742233,163618788,12,594,49.5,1359742226547,1359742231539,163612335,163617327,4992
1359742233,163618792,6,300,50,1359742221746,1359742231602,163607538,163617394,9856
1359742233,163618792,4,190,47.5,1359742221810,1359742231794,163607602,163617586,9984
1359742233,163618828,5,236,47.2,1359742220108,1359742232716,163605936,163618544,12608
1359742233,163618828,19,3891,204.7894737,1359742220172,1359742231692,163606000,163617520,11520
1359742233,163618832,3,144,48,1359742232329,1359742232713,163618161,163618545,384
1359742233,163618860,10,518,51.8,1359742221166,1359742225134,163607026,163610994,3968
1359742233,163618864,10,496,49.6,1359742226215,1359742231207,163612079,163617071,4992
1359742233,163618864,2,98,49,1359742221737,1359742230057,163607601,163615921,8320
1359742233,163618864,6,294,49,1359742226473,1359742231849,163612337,163617713,5376
1359742233,163618900,9,432,48,1359742219846,1359742231430,163605746,163617330,11584
1359742233,163618900,80,108782,1359.775,1359742219910,1359742231174,163605810,163617074,11264
1359742233,163618900,9,438,48.66666667,1359742219844,1359742231044,163605744,163616944,11200
1359742236,163622044,10,824,82.4,1359742208949,1359742211445,163594993,163597489,2496
1359742236,163622048,11,3414,310.3636364,1359742209201,1359742213809,163595249,163599857,4608
1359742236,163622072,1,46,46,1359742209559,1359742209559,163595631,163595631,0
1359742236,163622076,1,137,137,1359742209622,1359742209622,163595698,163595698,0
1359742236,163622084,10,2706,270.6,1359742210508,1359742215756,163596592,163601840,5248
1359742237,163622156,1,46,46,1359742210411,1359742210411,163595567,163595567,0
1359742237,163622156,1,46,46,1359742210542,1359742210542,163595698,163595698,0
1359742241,163626772,3,144,48,1359742233348,1359742234116,163619120,163619888,768
1359742241,163626816,18,6280,348.8888889,1359742232152,1359742233240,163617968,163619056,1088
1359742245,163630124,75,96524,1286.986667,1359742220556,1359742243340,163605680,163628464,22784
1359742248,163634040,38,2128,56,1359742220022,1359742245110,163606062,163631150,25088
1359742249,163634772,35,16059,458.8285714,1359742233093,1359742248261,163618865,163634033,15168
1359742249,163634780,2,98,49,1359742245116,1359742246844,163630896,163632624,1728
1359742249,163634856,2,98,49,1359742245298,1359742247858,163631154,163633714,2560
1359742252,3096916300,17,952,56,1359742223955,1359742245715,3096888255,3096910015,21760
1359742252,163638044,28,2688,96,1359742223925,1359742245237,163609969,163631281,21312
1359742252,163638048,10,3931,393.1,1359742223986,1359742231986,163610034,163618034,8000
1359742253,163638128,1,46,46,1359742225930,1359742225930,163611058,163611058,0
1359742256,163642032,24,1344,56,1359742228033,1359742245441,163614065,163631473,17408
1359742256,163642040,11,616,56,1359742228726,1359742244790,163614766,163630830,16064
1359742256,163642064,7,439,62.71428571,1359742229855,1359742230751,163615919,163616815,896
1359742256,163642068,7,439,62.71428571,1359742229850,1359742230746,163615918,163616814,896
1359742257,163642832,3,144,48,1359742247047,1359742249927,163632879,163635759,2880
1359742257,163642836,7,427,61,1359742256004,1359742256708,163641840,163642544,704
1359742257,163642836,3,138,46,1359742248963,1359742255427,163634799,163641263,6464
1359742260,163646032,1,46,46,1359742232895,1359742232895,163618927,163618927,0
1359742261,163646104,9,1120,124.4444444,1359742236640,1359742248608,163621744,163633712,11968
1359742264,163650072,15,924,61.6,1359742238870,1359742243926,163624942,163629998,5056
1359742265,163650796,12,2882,240.1666667,1359742260907,1359742263979,163646703,163649775,3072
1359742265,163650832,29,11796,406.7586207,1359742246792,1359742263112,163632624,163648944,16320
1359742265,163650868,5,396,79.2,1359742257571,1359742262371,163643439,163648239,4800
1359742269,163654108,13,801,61.61538462,1359742241819,1359742246491,163626927,163631599,4672
1359742269,163654108,10,633,63.3,1359742241818,1359742246746,163626926,163631854,4928
1359742269,163654108,10,639,63.9,1359742241818,1359742246554,163626926,163631662,4736
1359742269,163654212,13,801,61.61538462,1359742241716,1359742246388,163626928,163631600,4672
1359742269,163654268,1,46,46,1359742242877,1359742242877,163628145,163628145,0
1359742272,163658064,51,66322,1300.431373,1359742245538,1359742263522,163631602,163649586,17984
1359742273,163658184,2,274,137,1359742248334,1359742250318,163633518,163635502,1984
1359742276,163662084,1,46,46,1359742249612,1359742249612,163635696,163635696,0
1359742277,163662188,1,52,52,1359742251085,1359742251085,163636273,163636273,0
1359742281,163666108,1,46,46,1359742256154,1359742256154,163641262,163641262,0
1359742281,163666792,3,144,48,1359742272303,1359742277999,163658095,163663791,5696
1359742281,163666832,9,504,56,1359742276038,1359742276166,163661870,163661998,128
1359742281,163666836,9,504,56,1359742276038,1359742276294,163661874,163662130,256
1359742281,163666836,8,649,81.125,1359742270917,1359742278917,163656753,163664753,8000
1359742281,163666908,17,15785,928.5294118,1359742270970,1359742276346,163656878,163662254,5376
1359742281,163666912,3,144,48,1359742271799,1359742276919,163657711,163662831,5120
1359742281,163666912,3,144,48,1359742271799,1359742277943,163657711,163663855,6144
1359742282,3096946160,730,1048921,1436.878082,1359742160544,1359742278304,3096824704,3096942464,117760
1359742284,163670080,4,252,63,1359742256848,1359742258896,163642928,163644976,2048
1359742285,163670116,5,310,62,1359742258709,1359742263125,163643825,163648241,4416
1359742285,163670132,7,392,56,1359742260037,1359742271621,163645169,163656753,11584
1359742285,163670164,4,233,58.25,1359742257635,1359742259043,163642799,163644207,1408
1359742285,163670236,8,448,56,1359742259486,1359742271710,163644722,163656946,12224
1359742285,163670236,8,768,96,1359742259675,1359742271835,163644911,163657071,12160
1359742285,163670236,3,175,58.33333333,1359742259675,1359742260571,163644911,163645807,896
1359742285,163670240,4,224,56,1359742259801,1359742271385,163645041,163656625,11584
1359742288,3096952276,3,168,56,1359742259946,1359742271594,3096924222,3096935870,11648
1359742289,163674816,2,92,46,1359742282199,1359742288663,163668015,163674479,6464
1359742289,163674844,4,886,221.5,1359742270650,1359742282938,163656494,163668782,12288
1359742293,163678120,7,1719,245.5714286,1359742272785,1359742283665,163657905,163668785,10880
1359742293,163678220,2,92,46,1359742266602,1359742266602,163651822,163651822,0
1359742296,3096960240,2,92,46,1359742268239,1359742268239,3096932479,3096932479,0
1359742296,3096960292,3,1432,477.3333333,1359742271770,1359742272218,3096936062,3096936510,448
1359742296,3096960320,4,410,102.5,1359742270974,1359742271294,3096935294,3096935614,320
1359742296,3096960324,19,13818,727.2631579,1359742271548,1359742273404,3096935872,3096937728,1856
1359742296,3096960324,4,3245,811.25,1359742271675,1359742272123,3096935999,3096936447,448
1359742296,163682076,2,92,46,1359742268690,1359742268754,163654766,163654830,64
1359742297,163682160,1,46,46,1359742269609,1359742269609,163654769,163654769,0
1359742300,3096964300,2,92,46,1359742275153,1359742275153,3096939453,3096939453,0
1359742300,3096964336,1,46,46,1359742275119,1359742275119,3096939455,3096939455,0
1359742301,163686176,2,523,261.5,1359742272855,1359742272855,163658031,163658031,0
1359742313,163698220,3,491,163.6666667,1359742285547,1359742285611,163670767,163670831,64
1359742317,163702160,3,169,56.33333333,1359742290727,1359742290727,163675887,163675887,0
1359742317,163702160,2,123,61.5,1359742290727,1359742290727,163675887,163675887,0
1359742317,163702172,3,169,56.33333333,1359742291675,1359742291739,163676847,163676911,64
1359742317,163702240,2,123,61.5,1359742290647,1359742290647,163675887,163675887,0
1359742317,163702240,3,169,56.33333333,1359742290647,1359742290711,163675887,163675951,64
1359742321,163706244,1,137,137,1359742296084,1359742296084,163681328,163681328,0
1359742322,163707164,4,190,47.5,1359742314402,1359742320610,163699566,163705774,6208
1359742322,163707164,2,98,49,1359742314402,1359742320482,163699566,163705646,6080
1359742322,163707164,2,98,49,1359742314402,1359742320482,163699566,163705646,6080
1359742322,163707164,3,144,48,1359742314465,1359742321121,163699629,163706285,6656
1359742322,163707240,2,98,49,1359742314329,1359742320409,163699569,163705649,6080
1359742322,163707240,2,98,49,1359742314329,1359742320409,163699569,163705649,6080
1359742322,163707240,2,98,49,1359742314328,1359742320408,163699568,163705648,6080
1359742322,163707240,3,144,48,1359742314774,1359742321302,163700014,163706542,6528
1359742323,3096986776,1,46,46,1359742296288,1359742296288,3096960064,3096960064,0
1359742329,163714208,2,92,46,1359742302265,1359742328185,163687473,163713393,25920
1359742329,163714272,2,123,61.5,1359742304630,1359742304630,163689902,163689902,0
1359742330,163715196,8,404,50.5,1359742317314,1359742329410,163702510,163714606,12096
1359742330,163715200,4,202,50.5,1359742317441,1359742328449,163702641,163713649,11008
1359742330,163715200,4,202,50.5,1359742317440,1359742328448,163702640,163713648,11008
1359742330,163715212,8,404,50.5,1359742315509,1359742325429,163700721,163710641,9920
1359742330,163715240,6,300,50,1359742320342,1359742329046,163705582,163714286,8704
1359742330,163715268,7,358,51.14285714,1359742317180,1359742328508,163702448,163713776,11328
1359742330,163715272,4,202,50.5,1359742317365,1359742328373,163702637,163713645,11008
1359742330,163715272,3,138,46,1359742322361,1359742323321,163707633,163708593,960
1359742330,163715272,5,248,49.6,1359742317368,1359742329080,163702640,163714352,11712
1359742330,163715276,6,306,51,1359742317939,1359742328371,163703215,163713647,10432
1359742330,163715280,5,254,50.8,1359742315376,1359742323504,163700656,163708784,8128
1359742333,163718180,3,169,56.33333333,1359742306708,1359742306708,163691888,163691888,0
1359742333,163718224,8,560,70,1359742308648,1359742321128,163693872,163706352,12480
1359742338,163723200,8,458,57.25,1359742334720,1359742334720,163719920,163719920,0
1359742338,163723232,8,458,57.25,1359742335648,1359742335712,163720880,163720944,64
1359742338,163723280,8,458,57.25,1359742335600,1359742335664,163720880,163720944,64
1359742338,163723280,7,412,58.85714286,1359742335664,1359742335664,163720944,163720944,0
1359742338,163723308,8,458,57.25,1359742336595,1359742336595,163721903,163721903,0
1359742341,163726160,6,3336,556,1359742314409,1359742314729,163699569,163699889,320
1359742341,163726160,8,2954,369.25,1359742314409,1359742314793,163699569,163699953,384
1359742341,163726188,16,10424,651.5,1359742315340,1359742320908,163700528,163706096,5568
1359742341,163726188,35,32051,915.7428571,1359742315276,1359742323788,163700464,163708976,8512
1359742341,163726188,28,25206,900.2142857,1359742315275,1359742322059,163700463,163707247,6784
1359742341,163726188,19,12530,659.4736842,1359742315339,1359742320395,163700527,163705583,5056
1359742341,163726188,44,40274,915.3181818,1359742315339,1359742324107,163700527,163709295,8768
1359742341,163726188,44,38105,866.0227273,1359742315339,1359742324235,163700527,163709423,8896
1359742341,163726188,23,18032,784,1359742315339,1359742320459,163700527,163705647,5120
1359742341,163726188,21,22308,1062.285714,1359742315339,1359742321355,163700527,163706543,6016
1359742341,163726188,18,11636,646.4444444,1359742315339,1359742321675,163700527,163706863,6336
1359742341,163726188,10,6712,671.2,1359742315339,1359742318283,163700527,163703471,2944
1359742341,163726188,20,19904,995.2,1359742315339,1359742320971,163700527,163706159,5632
1359742341,163726188,17,11650,685.2941176,1359742315339,1359742321675,163700527,163706863,6336
1359742341,163726188,8,816,102,1359742315403,1359742319499,163700591,163704687,4096
1359742341,163726192,29,1624,56,1359742315783,1359742339015,163700975,163724207,23232
1359742341,163726192,14,784,56,1359742316165,1359742336709,163701357,163721901,20544
1359742341,163726240,30,33011,1100.366667,1359742313303,1359742315223,163698543,163700463,1920
1359742341,163726264,6,5468,911.3333333,1359742314302,1359742314622,163699566,163699886,320
1359742341,163726276,26,17648,678.7692308,1359742315188,1359742321716,163700464,163706992,6528
1359742341,163726276,26,20507,788.7307692,1359742315252,1359742322484,163700528,163707760,7232
1359742341,163726276,21,21495,1023.571429,1359742315252,1359742318964,163700528,163704240,3712
1359742341,163726276,19,21054,1108.105263,1359742315252,1359742319156,163700528,163704432,3904
1359742341,163726276,9,6464,718.2222222,1359742315252,1359742318068,163700528,163703344,2816
1359742341,163726276,17,12648,744,1359742315252,1359742322868,163700528,163708144,7616
1359742341,163726276,22,23878,1085.363636,1359742315252,1359742321588,163700528,163706864,6336
1359742341,163726276,22,17436,792.5454545,1359742315251,1359742321715,163700527,163706991,6464
1359742341,163726276,9,5520,613.3333333,1359742315251,1359742318067,163700527,163703343,2816
1359742341,163726276,9,5414,601.5555556,1359742315251,1359742318195,163700527,163703471,2944
1359742341,163726276,9,7018,779.7777778,1359742315251,1359742318259,163700527,163703535,3008
1359742341,163726276,16,11638,727.375,1359742315251,1359742320115,163700527,163705391,4864
1359742341,163726280,28,1568,56,1359742315821,1359742339181,163701101,163724461,23360
1359742341,163726284,27,2592,96,1359742315884,1359742339244,163701168,163724528,23360
1359742344,3097008280,15,840,56,1359742316006,1359742340134,3096980286,3097004414,24128
1359742345,163730196,8,527,65.875,1359742319620,1359742324996,163704816,163710192,5376
1359742346,163731212,5,1266,253.2,1359742339061,1359742339317,163724273,163724529,256
1359742349,163734248,1,46,46,1359742323152,1359742323152,163708400,163708400,0
1359742353,163738460,3,626,208.6666667,1359742324793,1359742324857,163710253,163710317,64
1359742353,163738464,6,1891,315.1666667,1359742325240,1359742331384,163710704,163716848,6144
1359742354,163739172,3,144,48,1359742345114,1359742350234,163730286,163735406,5120
1359742354,163739220,2,98,49,1359742345066,1359742350122,163730286,163735342,5056
1359742354,163739248,8,458,57.25,1359742349647,1359742349967,163734895,163735215,320
1359742354,163739264,8,458,57.25,1359742351615,1359742351679,163736879,163736943,64
1359742357,163742200,17,2766,162.7058824,1359742331645,1359742344765,163716845,163729965,13120
1359742357,163742232,1,137,137,1359742332509,1359742332509,163717741,163717741,0
1359742361,163746208,6,1246,207.6666667,1359742335029,1359742345077,163720237,163730285,10048
1359742365,163750324,1,56,56,1359742340739,1359742340739,163726063,163726063,0
1359742369,163754400,1,46,46,1359742344308,1359742344308,163729708,163729708,0
1359742385,163770320,3,169,56.33333333,1359742358597,1359742358597,163743917,163743917,0
1359742389,163774240,6,380,63.33333333,1359742361684,1359742385684,163746924,163770924,24000
1359742394,163779184,4,190,47.5,1359742384909,1359742390349,163770093,163775533,5440
1359742394,163779184,5,236,47.2,1359742384909,1359742392077,163770093,163777261,7168
1359742394,163779200,3,144,48,1359742387071,1359742392255,163772271,163777455,5184
1359742394,163779236,251,267389,1065.294821,1359742208089,1359742392985,163593325,163778221,184896
1359742394,163779276,3,169,56.33333333,1359742388082,1359742388082,163773358,163773358,0
1359742394,163779304,2,98,49,1359742383893,1359742390037,163769197,163775341,6144
1359742394,163779304,4,190,47.5,1359742383957,1359742390101,163769261,163775405,6144
1359742394,163779308,2,98,49,1359742383890,1359742390034,163769198,163775342,6144
1359742394,163779308,3,144,48,1359742384785,1359742390161,163770093,163775469,5376
1359742394,163779308,2,98,49,1359742384785,1359742390033,163770093,163775341,5248
1359742397,163782288,7,1147,163.8571429,1359742371428,1359742388004,163756716,163773292,16576
1359742397,163782292,1,137,137,1359742372000,1359742372000,163757292,163757292,0
1359742401,163786272,7,2268,324,1359742374965,1359742384693,163760237,163769965,9728
1359742402,163787212,233,235391,1010.261803,1359742197233,1359742401521,163582445,163786733,204288
1359742402,163787248,256,229237,895.4570313,1359742195021,1359742401805,163580269,163787053,206784
1359742402,163787256,287,285805,995.8362369,1359742196421,1359742398021,163581677,163783277,201600
1359742409,163794416,67,69376,1035.462687,1359742382758,1359742408102,163768174,163793518,25344
1359742410,163795196,2,98,49,1359742394433,1359742402881,163779629,163788077,8448
1359742410,163795196,2,98,49,1359742394432,1359742402880,163779628,163788076,8448
1359742410,163795200,5,254,50.8,1359742394685,1359742402877,163779885,163788077,8192
1359742410,163795204,2,98,49,1359742395257,1359742402873,163780461,163788077,7616
1359742410,163795224,7,346,49.42857143,1359742395493,1359742409573,163780717,163794797,14080
1359742410,163795228,8,404,50.5,1359742395936,1359742409760,163781164,163794988,13824
1359742410,163795280,5,254,50.8,1359742394606,1359742402798,163779886,163788078,8192
1359742410,163795280,5,254,50.8,1359742394604,1359742402796,163779884,163788076,8192
1359742410,163795292,2,98,49,1359742395619,1359742403747,163780911,163789039,8128
1359742410,163795292,3,144,48,1359742395619,1359742409635,163780911,163794927,14016
1359742410,163795312,8,404,50.5,1359742395854,1359742407758,163781166,163793070,11904
1359742412,3097076284,3,168,56,1359742386211,1359742411747,3097050495,3097076031,25536
1359742412,3097076356,2,92,46,1359742387610,1359742387674,3097051966,3097052030,64
1359742412,3097076356,2,92,46,1359742387610,1359742387674,3097051966,3097052030,64
1359742413,163798312,64,68962,1077.53125,1359742385036,1359742412172,163770348,163797484,27136
1359742413,163798312,40,41000,1025,1359742385040,1359742412048,163770352,163797360,27008
1359742413,163798312,53,51775,976.8867925,1359742385039,1359742411663,163770351,163796975,26624
1359742413,163798312,5,280,56,1359742386127,1359742412559,163771439,163797871,26432
1359742413,163798392,8,768,96,1359742385852,1359742412668,163771244,163798060,26816
1359742413,163798396,29,24853,857,1359742384955,1359742407355,163770351,163792751,22400
1359742413,163798396,21,19619,934.2380952,1359742384954,1359742397114,163770350,163782510,12160
1359742413,163798396,8,448,56,1359742385978,1359742412538,163771374,163797934,26560
1359742413,163798436,8,448,56,1359742385620,1359742412180,163771056,163797616,26560
1359742416,3097080504,2,92,46,1359742388489,1359742388489,3097052993,3097052993,0
1359742417,163802440,48,52510,1093.958333,1359742391821,1359742410957,163777261,163796397,19136
1359742418,163803232,4,202,50.5,1359742410846,1359742417310,163796078,163802542,6464
1359742418,163803232,3,150,50,1359742410910,1359742417438,163796142,163802670,6528
1359742418,163803232,3,150,50,1359742410910,1359742417438,163796142,163802670,6528
1359742418,163803232,4,202,50.5,1359742410781,1359742417373,163796013,163802605,6592
1359742418,163803232,4,202,50.5,1359742410845,1359742417309,163796077,163802541,6464
1359742418,163803232,4,202,50.5,1359742410909,1359742417373,163796141,163802605,6464
1359742418,163803232,3,150,50,1359742410909,1359742417437,163796141,163802669,6528
1359742418,163803236,2,98,49,1359742411160,1359742416984,163796396,163802220,5824
1359742418,163803236,3,150,50,1359742411160,1359742417048,163796396,163802284,5888
1359742418,163803236,3,150,50,1359742411036,1359742417116,163796272,163802352,6080
1359742418,163803236,3,150,50,1359742411162,1359742417050,163796398,163802286,5888
1359742418,163803264,6,306,51,1359742408317,1359742417149,163793581,163802413,8832
1359742418,163803264,6,306,51,1359742408317,1359742417149,163793581,163802413,8832
1359742418,163803264,6,306,51,1359742408253,1359742417149,163793517,163802413,8896
1359742418,163803268,8,410,51.25,1359742400569,1359742415993,163785837,163801261,15424
1359742418,163803272,4,202,50.5,1359742410102,1359742417078,163795374,163802350,6976
1359742418,163803304,4,202,50.5,1359742410772,1359742417300,163796076,163802604,6528
1359742418,163803304,3,150,50,1359742410836,1359742417364,163796140,163802668,6528
1359742418,163803304,6,306,51,1359742406292,1359742415956,163791596,163801260,9664
1359742418,163803304,3,150,50,1359742410839,1359742417367,163796143,163802671,6528
1359742418,163803304,2,98,49,1359742411094,1359742416918,163796398,163802222,5824
1359742418,163803304,3,150,50,1359742411094,1359742416982,163796398,163802286,5888
1359742418,163803304,3,150,50,1359742411094,1359742416982,163796398,163802286,5888
1359742418,163803304,2,98,49,1359742411093,1359742416917,163796397,163802221,5824
1359742418,163803304,24,28054,1168.916667,1359742398676,1359742415828,163783980,163801132,17152
1359742418,163803308,3,150,50,1359742403730,1359742414930,163789038,163800238,11200
1359742418,163803312,8,404,50.5,1359742399246,1359742414734,163784558,163800046,15488
1359742418,163803344,6,306,51,1359742408238,1359742417070,163793582,163802414,8832
1359742418,163803344,6,306,51,1359742408237,1359742417069,163793581,163802413,8832
1359742418,163803344,8,410,51.25,1359742400492,1359742415852,163785836,163801196,15360
1359742421,163806340,63,81242,1289.555556,1359742394290,1359742419826,163779630,163805166,25536
1359742421,163806380,9,976,108.4444444,1359742395528,1359742410248,163780908,163795628,14720
1359742421,163806492,9,802,89.11111111,1359742396569,1359742408025,163782061,163793517,11456
1359742425,163810356,25,17337,693.48,1359742398626,1359742422562,163783982,163807918,23936
1359742425,163810356,40,45309,1132.725,1359742398626,1359742424482,163783982,163809838,25856
1359742425,163810356,27,26316,974.6666667,1359742398752,1359742423136,163784108,163808492,24384
1359742425,163810360,27,26078,965.8518519,1359742398751,1359742424351,163784111,163809711,25600
1359742425,163810364,16,2758,172.375,1359742399194,1359742410906,163784558,163796270,11712
1359742425,163810372,1,46,46,1359742399955,1359742399955,163785327,163785327,0
1359742425,163810372,1,46,46,1359742399955,1359742399955,163785327,163785327,0
1359742425,163810388,30,18657,621.9,1359742400448,1359742411584,163785836,163796972,11136
1359742425,163810436,29,28637,987.4827586,1359742398672,1359742422160,163784108,163807596,23488
1359742425,163810436,16,17589,1099.3125,1359742398736,1359742405136,163784172,163790572,6400
1359742425,163810452,11,1638,148.9090909,1359742400384,1359742410048,163785836,163795500,9664
1359742425,163810476,10,636,63.6,1359742400362,1359742407594,163785838,163793070,7232
1359742426,163811220,6,300,50,1359742410152,1359742422568,163795372,163807788,12416
1359742426,163811224,5,248,49.6,1359742418148,1359742425252,163803372,163810476,7104
1359742426,163811224,5,248,49.6,1359742418151,1359742424359,163803375,163809583,6208
1359742426,163811224,4,196,49,1359742418151,1359742425895,163803375,163811119,7744
1359742426,163811224,5,248,49.6,1359742418151,1359742424743,163803375,163809967,6592
1359742426,163811224,5,248,49.6,1359742418215,1359742425063,163803439,163810287,6848
1359742426,163811228,3,150,50,1359742418467,1359742421475,163803695,163806703,3008
1359742426,163811232,7,352,50.28571429,1359742411422,1359742425310,163796654,163810542,13888
1359742426,163811232,4,196,49,1359742419229,1359742424925,163804461,163810157,5696
1359742426,163811232,4,196,49,1359742419356,1359742425308,163804588,163810540,5952
1359742426,163811300,4,196,49,1359742418136,1359742424984,163803436,163810284,6848
1359742426,163811304,4,196,49,1359742418071,1359742424599,163803375,163809903,6528
1359742426,163811304,5,248,49.6,1359742418134,1359742424662,163803438,163809966,6528
1359742426,163811304,5,248,49.6,1359742418260,1359742424660,163803564,163809964,6400
1359742426,163811308,4,196,49,1359742418449,1359742424529,163803757,163809837,6080
1359742426,163811316,6,294,49,1359742411083,1359742424331,163796399,163809647,13248
1359742426,163811316,4,196,49,1359742418955,1359742424587,163804271,163809903,5632
1359742426,163811316,4,196,49,1359742419211,1359742424843,163804527,163810159,5632
1359742426,163811316,6,300,50,1359742411338,1359742421066,163796654,163806382,9728
1359742426,163811316,5,248,49.6,1359742411338,1359742425418,163796654,163810734,14080
1359742426,163811316,8,410,51.25,1359742411338,1359742425226,163796654,163810542,13888
1359742426,163811316,8,404,50.5,1359742411401,1359742424841,163796717,163810157,13440
1359742426,163811316,7,358,51.14285714,1359742411337,1359742425225,163796653,163810541,13888
1359742426,163811316,8,404,50.5,1359742411337,1359742425225,163796653,163810541,13888
1359742426,163811316,7,352,50.28571429,1359742411401,1359742424841,163796717,163810157,13440
1359742426,163811320,7,358,51.14285714,1359742403974,1359742423942,163789294,163809262,19968
1359742426,163811348,3,144,48,1359742419944,1359742425768,163805292,163811116,5824
1359742429,163814564,12,749,62.41666667,1359742403345,1359742408721,163788909,163794285,5376
1359742433,163818448,8,703,87.875,1359742406150,1359742410246,163791598,163795694,4096
1359742433,163818472,3,411,137,1359742406766,1359742409710,163792238,163795182,2944
1359742434,163819232,9,456,50.66666667,1359742417887,1359742429727,163803119,163814959,11840
1359742434,163819232,2,92,46,1359742429150,1359742431198,163814382,163816430,2048
1359742434,163819236,3,138,46,1359742426265,1359742430489,163811501,163815725,4224
1359742434,163819236,3,138,46,1359742426200,1359742430552,163811436,163815788,4352
1359742434,163819240,2,92,46,1359742426263,1359742429143,163811503,163814383,2880
1359742434,163819240,4,184,46,1359742429972,1359742431828,163815212,163817068,1856
1359742434,163819244,5,236,47.2,1359742426515,1359742431507,163811759,163816751,4992
1359742434,163819244,8,410,51.25,1359742414161,1359742430993,163799405,163816237,16832
1359742434,163819248,2,92,46,1359742426892,1359742429644,163812140,163814892,2752
1359742434,163819248,5,242,48.4,1359742419022,1359742431182,163804270,163816430,12160
1359742434,163819248,2,92,46,1359742427276,1359742430348,163812524,163815596,3072
1359742434,163819276,2,92,46,1359742427889,1359742431153,163813165,163816429,3264
1359742434,163819288,3,144,48,1359742424103,1359742431207,163809391,163816495,7104
1359742434,163819288,3,144,48,1359742424165,1359742431141,163809453,163816429,6976
1359742434,163819316,3,138,46,1359742426186,1359742431178,163811502,163816494,4992
1359742434,163819316,3,138,46,1359742426186,1359742429962,163811502,163815278,3776
1359742434,163819320,3,138,46,1359742429894,1359742430598,163815214,163815918,704
1359742434,163819320,14,3332,238,1359742430084,1359742431556,163815404,163816876,1472
1359742434,163819324,8,398,49.75,1359742426755,1359742431235,163812079,163816559,4480
1359742434,163819324,3,144,48,1359742426755,1359742431107,163812079,163816431,4352
1359742434,163819324,2,92,46,1359742427136,1359742429504,163812460,163814828,2368
1359742434,163819328,2,92,46,1359742427195,1359742430075,163812523,163815403,2880
1359742434,163819328,2,92,46,1359742427263,1359742431103,163812591,163816431,3840
1359742434,163819328,2,92,46,1359742427263,1359742431103,163812591,163816431,3840
1359742434,163819328,2,92,46,1359742427327,1359742431103,163812655,163816431,3776
1359742434,163819328,2,92,46,1359742427327,1359742431103,163812655,163816431,3776
1359742434,163819368,3,144,48,1359742424084,1359742431124,163809452,163816492,7040
1359742434,163819368,3,144,48,1359742424086,1359742431126,163809454,163816494,7040
1359742437,163822368,25,4272,170.88,1359742410453,1359742430933,163795821,163816301,20480
1359742437,163822368,6,845,140.8333333,1359742410517,1359742411861,163795885,163797229,1344
1359742437,163822396,30,36305,1210.166667,1359742410746,1359742420154,163796142,163805550,9408
1359742437,163822396,9,1062,118,1359742410744,1359742419064,163796140,163804460,8320
1359742437,163822396,12,9631,802.5833333,1359742410808,1359742412472,163796204,163797868,1664
1359742437,163822400,8,706,88.25,1359742410999,1359742413943,163796399,163799343,2944
1359742437,163822400,5,403,80.6,1359742410870,1359742411958,163796270,163797358,1088
1359742437,163822440,1,46,46,1359742412687,1359742412687,163798127,163798127,0
1359742437,163822440,1,46,46,1359742412686,1359742412686,163798126,163798126,0
1359742437,163822440,33,1848,56,1359742412813,1359742436557,163798253,163821997,23744
1359742437,163822444,16,3563,222.6875,1359742409864,1359742425992,163795308,163811436,16128
1359742437,163822472,20,1943,97.15,1359742410349,1359742424749,163795821,163810221,14400
1359742437,163822476,28,33345,1190.892857,1359742410408,1359742425000,163795884,163810476,14592
1359742437,163822480,7,4594,656.2857143,1359742410727,1359742411815,163796207,163797295,1088
1359742437,163822480,50,58322,1166.44,1359742410663,1359742424423,163796143,163809903,13760
1359742437,163822480,3,209,69.66666667,1359742410918,1359742411174,163796398,163796654,256
1359742437,163822488,14,6468,462,1359742411804,1359742414044,163797292,163799532,2240
1359742440,3097104504,19,1064,56,1359742412295,1359742439303,3097076799,3097103807,27008
1359742441,163826332,20,1120,56,1359742413177,1359742440377,163798509,163825709,27200
1359742441,163826344,36,2016,56,1359742414318,1359742440814,163799662,163826158,26496
1359742441,163826376,11,9294,844.9090909,1359742414413,1359742429581,163799789,163814957,15168
1359742441,163826424,39,3744,96,1359742413021,1359742440157,163798445,163825581,27136
1359742441,163826468,8,4768,596,1359742415153,1359742429041,163800621,163814509,13888
1359742442,163827216,7,352,50.28571429,1359742425838,1359742437166,163811054,163822382,11328
1359742442,163827252,11,815,74.09090909,1359742431562,1359742434186,163816814,163819438,2624
1359742442,163827260,8,404,50.5,1359742425922,1359742437122,163811182,163822382,11200
1359742442,163827260,7,358,51.14285714,1359742425985,1359742436929,163811245,163822189,10944
1359742442,163827288,17,5143,302.5294118,1359742429863,1359742435367,163815151,163820655,5504
1359742442,163827288,6,306,51,1359742425638,1359742436902,163810926,163822190,11264
1359742442,163827300,14,3338,238.4285714,1359742431256,1359742434136,163816556,163819436,2880
1359742445,163830348,17,15076,886.8235294,1359742417896,1359742428840,163803244,163814188,10944
1359742445,163830364,15,14818,987.8666667,1359742418457,1359742444825,163803821,163830189,26368
1359742445,163830400,2,104,52,1359742419956,1359742423412,163805356,163808812,3456
1359742445,163830428,14,14902,1064.428571,1359742420760,1359742433688,163806188,163819116,12928
1359742445,163830432,13,11293,868.6923077,1359742417812,1359742426516,163803244,163811948,8704
1359742445,163830432,16,9762,610.125,1359742417812,1359742426708,163803244,163812140,8896
1359742445,163830432,8,5103,637.875,1359742417812,1359742426516,163803244,163811948,8704
1359742445,163830440,16,9788,611.75,1359742418059,1359742427019,163803499,163812459,8960
1359742445,163830440,3,156,52,1359742418126,1359742423374,163803566,163808814,5248
1359742445,163830440,3,156,52,1359742418126,1359742423374,163803566,163808814,5248
1359742445,163830440,3,156,52,1359742418125,1359742423373,163803565,163808813,5248
1359742445,163830512,1,46,46,1359742420549,1359742420549,163806061,163806061,0
1359742445,163830512,1,46,46,1359742420420,1359742420420,163805932,163805932,0
1359742449,163834364,14,14902,1064.428571,1359742422106,1359742433882,163807470,163819246,11776
1359742449,163834412,48,62275,1297.395833,1359742423912,1359742444072,163809324,163829484,20160
1359742450,163835236,5,248,49.6,1359742437530,1359742444186,163822766,163829422,6656
1359742450,163835272,3,144,48,1359742438963,1359742445171,163824235,163830443,6208
1359742450,163835276,4,196,49,1359742439027,1359742445427,163824303,163830703,6400
1359742450,163835276,3,144,48,1359742439281,1359742445041,163824557,163830317,5760
1359742450,163835360,5,1692,338.4,1359742448796,1359742449052,163834156,163834412,256
1359742450,163835360,7,1319,188.4285714,1359742448796,1359742449564,163834156,163834924,768
1359742450,3097114184,7,1138,162.5714286,1359742448841,1359742449929,3097113025,3097114113,1088
1359742453,163838352,5,1692,338.4,1359742448867,1359742449123,163834219,163834475,256
1359742453,163838356,12,11956,996.3333333,1359742425887,1359742434143,163811243,163819499,8256
1359742453,163838360,11,7690,699.0909091,1359742426079,1359742429599,163811439,163814959,3520
1359742453,163838364,2,1516,758,1359742426330,1359742427418,163811694,163812782,1088
1359742453,163838392,1,46,46,1359742426621,1359742426621,163812013,163812013,0
1359742453,163838392,1,46,46,1359742426623,1359742426623,163812015,163812015,0
1359742453,163838392,15,12112,807.4666667,1359742426686,1359742434238,163812078,163819630,7552
1359742453,163838392,14,14374,1026.714286,1359742426813,1359742433725,163812205,163819117,6912
1359742453,163838396,1,46,46,1359742427065,1359742427065,163812461,163812461,0
1359742453,163838400,1,46,46,1359742427318,1359742427318,163812718,163812718,0
1359742453,163838400,6,1692,282,1359742427381,1359742429877,163812781,163815277,2496
1359742453,163838400,1,46,46,1359742427381,1359742427381,163812781,163812781,0
1359742453,163838476,18,18024,1001.333333,1359742426473,1359742433513,163811949,163818989,7040
1359742453,163838476,15,12112,807.4666667,1359742426600,1359742434088,163812076,163819564,7488
1359742453,163838476,15,12112,807.4666667,1359742426600,1359742434280,163812076,163819756,7680
1359742453,163838480,1,46,46,1359742426918,1359742426918,163812398,163812398,0
1359742457,163842352,1,46,46,1359742429094,1359742429094,163814446,163814446,0
1359742457,163842352,1,46,46,1359742429093,1359742429093,163814445,163814445,0
1359742457,163842352,1,46,46,1359742429093,1359742429093,163814445,163814445,0
1359742457,163842360,5,594,118.8,1359742430045,1359742430301,163815405,163815661,256
1359742457,163842436,1,46,46,1359742429074,1359742429074,163814510,163814510,0
1359742457,163842440,1,46,46,1359742429581,1359742429581,163815021,163815021,0
1359742457,163842440,19,10236,538.7368421,1359742429517,1359742433549,163814957,163818989,4032
1359742457,163842444,10,3064,306.4,1359742429961,1359742431753,163815405,163817197,1792
1359742457,163842476,1,46,46,1359742430952,1359742430952,163816428,163816428,0
1359742458,163843260,2,92,46,1359742448961,1359742454977,163834221,163840237,6016
1359742458,163843264,6,294,49,1359742448955,1359742457275,163834219,163842539,8320
1359742458,163843264,7,346,49.42857143,1359742445244,1359742455420,163830508,163840684,10176
1359742458,163843308,6,294,49,1359742444819,1359742456211,163830127,163841519,11392
1359742458,163843308,6,300,50,1359742440529,1359742452625,163825837,163837933,12096
1359742458,163843312,12,3555,296.25,1359742448847,1359742456655,163834159,163841967,7808
1359742458,163843312,7,346,49.42857143,1359742448909,1359742457229,163834221,163842541,8320
1359742458,163843316,7,358,51.14285714,1359742445194,1359742452746,163830510,163838062,7552
1359742458,163843356,8,488,61,1359742454818,1359742456738,163840174,163842094,1920
1359742458,163843392,2,92,46,1359742448830,1359742454846,163834222,163840238,6016
1359742458,3097122180,7,340,48.57142857,1359742448845,1359742455885,3097113025,3097120065,7040
1359742458,3097122188,7,727,103.8571429,1359742450181,1359742453061,3097114369,3097117249,2880
1359742458,3097122188,16,2374,148.375,1359742448836,1359742457476,3097113024,3097121664,8640
1359742461,163846392,1,46,46,1359742436796,1359742436796,163822188,163822188,0
1359742461,163846408,10,11858,1185.8,1359742434348,1359742434540,163819756,163819948,192
1359742461,163846436,10,11858,1185.8,1359742434515,1359742434643,163819951,163820079,128
1359742461,163846436,11,11904,1082.181818,1359742434704,1359742434832,163820140,163820268,128
1359742461,163846436,15,17784,1185.6,1359742434832,1359742435088,163820268,163820524,256
1359742461,163846440,2,92,46,1359742434894,1359742435086,163820334,163820526,192
1359742461,163846444,11,11904,1082.181818,1359742435337,1359742435465,163820781,163820909,128
1359742461,163846448,11,11904,1082.181818,1359742435654,1359742435782,163821102,163821230,128
1359742461,163846448,11,11904,1082.181818,1359742435781,1359742435909,163821229,163821357,128
1359742461,163846448,2,92,46,1359742435780,1359742435844,163821228,163821292,64
1359742461,163846480,10,11858,1185.8,1359742436711,1359742436903,163822191,163822383,192
1359742461,163846520,2,92,46,1359742434558,1359742434558,163820078,163820078,0
1359742461,163846524,11,11904,1082.181818,1359742435000,1359742435128,163820524,163820652,128
1359742461,163846528,11,11904,1082.181818,1359742435126,1359742435254,163820654,163820782,128
1359742461,163846532,11,11904,1082.181818,1359742435379,1359742435571,163820911,163821103,192
1359742461,163846532,11,11904,1082.181818,1359742435824,1359742435952,163821356,163821484,128
1359742461,163846552,11,11904,1082.181818,1359742436123,1359742436315,163821675,163821867,192
1359742461,163846552,15,17784,1185.6,1359742435934,1359742436126,163821486,163821678,192
1359742461,163846552,10,11858,1185.8,1359742436507,1359742436571,163822059,163822123,64
1359742461,163846556,11,11904,1082.181818,1359742436314,1359742436506,163821870,163822062,192
1359742465,163850412,26,1456,56,1359742437163,1359742457131,163822575,163842543,19968
1359742465,163850416,5,457,91.4,1359742437670,1359742438950,163823086,163824366,1280
1359742465,163850460,16,2775,173.4375,1359742440123,1359742458171,163825583,163843631,18048
1359742465,163850488,18,20664,1148,1359742437085,1359742438877,163822573,163824365,1792
1359742465,163850488,11,1647,149.7272727,1359742437212,1359742463324,163822700,163848812,26112
1359742465,163850532,7,1323,189,1359742438705,1359742438961,163824237,163824493,256
1359742465,163850540,1,46,46,1359742439721,1359742439721,163825261,163825261,0
1359742465,163850544,2,92,46,1359742439654,1359742439718,163825198,163825262,64
1359742466,163851228,3,144,48,1359742458275,1359742459107,163843503,163844335,832
1359742466,163851236,3,138,46,1359742459226,1359742460570,163844462,163845806,1344
1359742466,163851236,6,300,50,1359742454552,1359742464984,163839788,163850220,10432
1359742466,163851304,5,236,47.2,1359742458452,1359742459604,163843756,163844908,1152
1359742466,163851308,3,150,50,1359742454098,1359742464914,163839406,163850222,10816
1359742466,163851308,7,352,50.28571429,1359742450897,1359742463121,163836205,163848429,12224
1359742466,163851312,5,230,46,1359742459917,1359742463053,163845229,163848365,3136
1359742466,163851312,5,248,49.6,1359742451724,1359742463244,163837036,163848556,11520
1359742466,163851316,2,92,46,1359742460106,1359742460554,163845422,163845870,448
1359742466,3097130216,4,184,46,1359742458921,1359742460009,3097123137,3097124225,1088
1359742468,3097132536,9,504,56,1359742441641,1359742456553,3097106177,3097121089,14912
1359742469,163854408,16,1536,96,1359742441067,1359742455659,163826475,163841067,14592
1359742469,163854456,15,840,56,1359742443773,1359742457149,163829229,163842605,13376
1359742469,163854460,9,504,56,1359742444026,1359742456442,163829486,163841902,12416
1359742469,163854564,14,14813,1058.071429,1359742444499,1359742446483,163830063,163832047,1984
1359742469,163854564,52,57044,1097,1359742444499,1359742456723,163830063,163842287,12224
1359742473,163858424,55,76518,1391.236364,1359742445021,1359742450269,163830445,163835693,5248
1359742473,163858472,1,137,137,1359742448238,1359742448238,163833710,163833710,0
1359742473,163858472,4,544,136,1359742448683,1359742448875,163834155,163834347,192
1359742473,163858584,4,672,168,1359742448636,1359742448828,163834220,163834412,192
1359742473,163858588,3,626,208.6666667,1359742448632,1359742448696,163834220,163834284,64
1359742473,163858588,3,498,166,1359742448632,1359742448696,163834220,163834284,64
1359742474,163859224,6,300,50,1359742459110,1359742467174,163844334,163852398,8064
1359742474,163859252,3,144,48,1359742463562,1359742469066,163848814,163854318,5504
1359742474,163859252,5,254,50.8,1359742460617,1359742469001,163845869,163854253,8384
1359742474,163859292,6,300,50,1359742459169,1359742466977,163844461,163852269,7808
1359742474,163859304,6,300,50,1359742460502,1359742468054,163845806,163853358,7552
1359742474,163859304,6,300,50,1359742460566,1359742469014,163845870,163854318,8448
1359742477,163862452,1,46,46,1359742450370,1359742450370,163835822,163835822,0
1359742477,163862476,7,932,133.1428571,1359742450729,1359742456809,163836205,163842285,6080
1359742477,163862560,6,601,100.1666667,1359742450643,1359742460883,163836203,163846443,10240
1359742477,163862560,6,880,146.6666667,1359742450647,1359742462935,163836207,163848495,12288
1359742481,163866496,4,252,63,1359742455445,1359742459925,163840941,163845421,4480
1359742481,163866616,76,74331,978.0394737,1359742456476,1359742474268,163842092,163859884,17792
1359742481,163866616,18,1998,111,1359742456475,1359742460315,163842091,163845931,3840
1359742485,163870512,1,46,46,1359742457860,1359742457860,163843372,163843372,0
1359742485,163870516,1,46,46,1359742458239,1359742458239,163843755,163843755,0
1359742493,163878552,3,138,46,1359742467294,1359742467294,163852846,163852846,0
1359742497,163882472,3,138,46,1359742469996,1359742470060,163855468,163855532,64
1359742497,163882504,3,138,46,1359742471371,1359742471435,163856875,163856939,64
1359742497,163882544,3,492,164,1359742469155,1359742469219,163854699,163854763,64
1359742497,163882556,8,1196,149.5,1359742470298,1359742479834,163855854,163865390,9536
1359742501,163886576,3,169,56.33333333,1359742475333,1359742475333,163860909,163860909,0
1359742505,163890448,209,309156,1479.215311,1359742187524,1359742202436,163572972,163587884,14912
1359742505,163890544,2,123,61.5,1359742478374,1359742478374,163863918,163863918,0
1359742505,163890576,3,437,145.6666667,1359742479748,1359742479812,163865324,163865388,64
1359742505,163890576,4,483,120.75,1359742479812,1359742481476,163865388,163867052,1664
1359742509,163894572,5,3130,626,1359742483529,1359742505801,163869101,163891373,22272
1359742513,163898464,1,137,137,1359742485301,1359742485301,163870765,163870765,0
1359742514,163899232,6,1246,207.6666667,1359742513051,1359742513115,163898283,163898347,64
1359742514,163899280,5,1731,346.2,1359742512683,1359742512811,163897963,163898091,128
1359742514,3097178192,5,635,127,1359742512447,1359742512511,3097176639,3097176703,64
1359742522,163907268,3,144,48,1359742510263,1359742516279,163895531,163901547,6016
1359742522,163907304,3,144,48,1359742511253,1359742517269,163896557,163902573,6016
1359742522,163907308,7,1861,265.8571429,1359742512720,1359742515280,163898028,163900588,2560
1359742522,163907312,2008,2882012,1435.26494,1359742513102,1359742519374,163898414,163904686,6272
1359742522,163907312,2,98,49,1359742513101,1359742518221,163898413,163903533,5120
1359742522,163907348,3,144,48,1359742511207,1359742517223,163896555,163902571,6016
1359742522,3097186208,5,635,127,1359742514992,1359742515056,3097179200,3097179264,64
1359742525,163910604,2,92,46,1359742499562,1359742499626,163885166,163885230,64
1359742529,163914524,5,332,66.4,1359742504376,1359742511416,163889900,163896940,7040
1359742533,163918508,7,535,76.42857143,1359742506377,1359742509449,163891885,163894957,3072
1359742533,163918612,6,483,80.5,1359742506656,1359742506720,163892268,163892332,64
1359742537,163922500,66,57932,877.7575758,1359742509521,1359742528849,163895021,163914349,19328
1359742537,163922508,3,437,145.6666667,1359742510088,1359742510088,163895596,163895596,0
1359742537,163922532,7,5450,778.5714286,1359742511024,1359742511280,163896556,163896812,256
1359742537,163922532,8,9878,1234.75,1359742511024,1359742512048,163896556,163897580,1024
1359742537,163922532,5,3779,755.8,1359742511023,1359742511087,163896555,163896619,64
1359742537,163922540,14,4096,292.5714286,1359742511592,1359742528296,163897132,163913836,16704
1359742537,163922540,12,13629,1135.75,1359742511719,1359742511783,163897259,163897323,64
1359742537,163922544,7,2419,345.5714286,1359742511971,1359742512099,163897515,163897643,128
1359742537,163922572,7,972,138.8571429,1359742512714,1359742528842,163898286,163914414,16128
1359742537,163922576,3,492,164,1359742509124,1359742509188,163894700,163894764,64
1359742537,163922620,7,5453,779,1359742510934,1359742511062,163896554,163896682,128
1359742537,163922624,6,5247,874.5,1359742510933,1359742510997,163896557,163896621,64
1359742537,163922624,5,4582,916.4,1359742511314,1359742511378,163896938,163897002,64
1359742537,163922628,4,998,249.5,1359742511310,1359742511694,163896938,163897322,384
1359742537,163922628,13,11823,909.4615385,1359742511505,1359742512401,163897133,163898029,896
1359742537,163922652,20,1920,96,1359742512183,1359742536503,163897835,163922155,24320
1359742537,163922656,10,560,56,1359742512310,1359742534454,163897966,163920110,22144
1359742537,163922656,19,1064,56,1359742512500,1359742534388,163898156,163920044,21888
1359742540,3097204596,11,616,56,1359742513005,1359742538349,3097177601,3097202945,25344
1359742541,163926532,22,1232,56,1359742513199,1359742539951,163898731,163925483,26752
1359742541,163926564,8,1586,198.25,1359742515087,1359742539535,163900651,163925099,24448
1359742541,163926564,5,1048,209.6,1359742515087,1359742529487,163900651,163915051,14400
1359742541,163926608,12,3363,280.25,1359742512804,1359742512932,163898412,163898540,128
1359742541,163926648,1,528,528,1359742514876,1359742514876,163900524,163900524,0
1359742541,163926648,1,528,528,1359742514876,1359742514876,163900524,163900524,0
1359742541,163926648,2,301,150.5,1359742515067,1359742515195,163900715,163900843,128
1359742545,163930536,2,123,61.5,1359742520301,1359742520301,163905837,163905837,0
1359742549,163934548,2,123,61.5,1359742523231,1359742523295,163908779,163908843,64
1359742549,163934588,2,92,46,1359742520950,1359742520950,163906538,163906538,0
1359742553,163938536,4,548,137,1359742528814,1359742528942,163914350,163914478,128
1359742553,163938576,2,92,46,1359742526978,1359742526978,163912554,163912554,0
1359742553,163938576,2,92,46,1359742526978,1359742526978,163912554,163912554,0
1359742553,163938656,1,46,46,1359742526900,1359742526900,163912556,163912556,0
1359742553,163938660,1,137,137,1359742527280,1359742527280,163912940,163912940,0
1359742557,163942628,2,92,46,1359742529935,1359742529935,163915563,163915563,0
1359742557,163942628,1,46,46,1359742529935,1359742529935,163915563,163915563,0
1359742562,163947376,323,389086,1204.600619,1359742314571,1359742560203,163699947,163945579,245632
1359742565,163950548,181,240462,1328.519337,1359742220126,1359742262942,163605674,163648490,42816
1359742565,163950564,12,672,56,1359742537551,1359742563983,163923115,163949547,26432
1359742565,163950636,12,1152,96,1359742537865,1359742564681,163923501,163950317,26816
1359742565,163950636,6,336,56,1359742537928,1359742560520,163923564,163946156,22592
1359742569,163954576,1,46,46,1359742541956,1359742541956,163927532,163927532,0
1359742569,163954576,1,46,46,1359742541956,1359742541956,163927532,163927532,0
1359742569,163954616,13,728,56,1359742543900,1359742568732,163929516,163954348,24832
1359742569,163954644,2,92,46,1359742540864,1359742540928,163926508,163926572,64
1359742569,163954644,1,46,46,1359742540864,1359742540864,163926508,163926508,0
1359742569,163954644,1,46,46,1359742540928,1359742540928,163926572,163926572,0
1359742569,163954656,2,92,46,1359742541876,1359742541876,163927532,163927532,0
1359742569,163954656,1,46,46,1359742541876,1359742541876,163927532,163927532,0
1359742569,163954656,1,46,46,1359742541876,1359742541876,163927532,163927532,0
1359742569,163954724,2,92,46,1359742543793,1359742543857,163929517,163929581,64
1359742570,163955396,7,412,58.85714286,1359742568441,1359742568441,163953837,163953837,0
1359742570,163955404,8,458,57.25,1359742565424,1359742565424,163950828,163950828,0
1359742572,3097236604,7,392,56,1359742547811,1359742571235,3097212415,3097235839,23424
1359742578,163963160,4,538,134.5,1359742549540,1359742550052,163934700,163935212,512
1359742578,163963744,3,169,56.33333333,1359742551066,1359742551194,163936810,163936938,128
1359742578,163963928,7,1146,163.7142857,1359742549026,1359742559074,163934954,163945002,10048
1359742578,163963976,6,1088,181.3333333,1359742549171,1359742559347,163935147,163945323,10176
1359742579,163964384,1,48,48,1359742551106,1359742551106,163936490,163936490,0
1359742581,163966540,2,123,61.5,1359742554280,1359742554280,163939820,163939820,0
1359742581,163966660,2,123,61.5,1359742556144,1359742556144,163941804,163941804,0
1359742585,163970532,2,123,61.5,1359742557295,1359742557359,163942827,163942891,64
1359742586,163971368,3846,5516760,1434.414977,1359742510098,1359742581586,163895466,163966954,71488
1359742589,163974696,2,92,46,1359742563849,1359742563849,163949545,163949545,0
1359742593,163978628,5,280,56,1359742565519,1359742575887,163951147,163961515,10368
1359742593,163978636,2,112,56,1359742566279,1359742567815,163951915,163953451,1536
1359742593,163978744,4,384,96,1359742566109,1359742568861,163951853,163954605,2752
1359742597,163982772,1,137,137,1359742571457,1359742571457,163957229,163957229,0
1359742601,163986768,2,92,46,1359742575749,1359742575813,163961517,163961581,64
1359742617,164002720,3,492,164,1359742589045,1359742589109,163974765,163974829,64
1359742621,164006656,7,392,56,1359742594162,1359742620146,163979818,164005802,25984
1359742621,164006704,6,336,56,1359742596355,1359742619843,163982059,164005547,23488
1359742621,164006772,6,576,96,1359742595069,1359742619453,163980841,164005225,24384
1359742621,164006780,3,168,56,1359742595958,1359742618998,163981738,164004778,23040
1359742621,164006784,2,123,61.5,1359742596020,1359742596084,163981804,163981868,64
1359742625,3097288784,3,168,56,1359742600216,1359742620248,3097264000,3097284032,20032
1359742625,164010696,2,123,61.5,1359742599115,1359742599115,163984811,163984811,0
1359742625,164010708,3,544,181.3333333,1359742599681,1359742599681,163985389,163985389,0
1359742629,164014668,2,123,61.5,1359742601125,1359742601189,163986793,163986857,64
1359742629,164014784,2,123,61.5,1359742602034,1359742602034,163987818,163987818,0
1359742637,164022652,1,137,137,1359742609782,1359742609782,163995434,163995434,0
1359742642,164027480,7,412,58.85714286,1359742641380,1359742641380,164026860,164026860,0
1359742650,164035416,199,269487,1354.20603,1359742506848,1359742645152,163892264,164030568,138304
1359742650,164035416,7,412,58.85714286,1359742646434,1359742646434,164031850,164031850,0
1359742650,164035520,8,458,57.25,1359742644284,1359742644348,164029804,164029868,64
1359742650,164035520,7,412,58.85714286,1359742647291,1359742647355,164032811,164032875,64
1359742653,164038672,2,92,46,1359742625892,1359742625892,164011564,164011564,0
1359742653,164038708,1,46,46,1359742626815,1359742626815,164012523,164012523,0
1359742653,164038708,1,46,46,1359742626815,1359742626815,164012523,164012523,0
1359742653,164038708,2,92,46,1359742626814,1359742626878,164012522,164012586,64
1359742653,164038708,1,46,46,1359742626814,1359742626814,164012522,164012522,0
1359742653,164038716,10,560,56,1359742627829,1359742650933,164013545,164036649,23104
1359742653,164038716,1,46,46,1359742627829,1359742627829,164013545,164013545,0
1359742653,164038716,2,92,46,1359742627829,1359742627893,164013545,164013609,64
1359742653,164038748,10,960,96,1359742625750,1359742646038,164011498,164031786,20288
1359742653,164038788,1,46,46,1359742626734,1359742626734,164012522,164012522,0
1359742653,164038792,2,92,46,1359742626728,1359742626792,164012520,164012584,64
1359742653,164038792,5,280,56,1359742626728,1359742645352,164012520,164031144,18624
1359742653,164038828,2,92,46,1359742627720,1359742627720,164013548,164013548,0
1359742653,164038836,1,46,46,1359742628544,1359742628544,164014380,164014380,0
1359742653,164038836,9,504,56,1359742628543,1359742645567,164014379,164031403,17024
1359742657,3097320768,5,280,56,1359742629866,1359742647722,3097293634,3097311490,17856
1359742657,164042696,2,92,46,1359742630858,1359742630858,164016554,164016554,0
1359742657,164042696,1,46,46,1359742630858,1359742630858,164016554,164016554,0
1359742657,164042740,3,492,164,1359742628957,1359742629021,164014697,164014761,64
1359742657,164042784,2,92,46,1359742630897,1359742631089,164016681,164016873,192
1359742658,164043400,2,98,49,1359742646002,1359742651250,164031402,164036650,5248
1359742658,164043400,2,98,49,1359742646002,1359742651250,164031402,164036650,5248
1359742658,164043452,2,98,49,1359742645948,1359742651196,164031400,164036648,5248
1359742658,164043452,3,144,48,1359742645948,1359742651260,164031400,164036712,5312
1359742658,164043452,3,144,48,1359742645948,1359742651324,164031400,164036776,5376
1359742665,164050812,3,544,181.3333333,1359742639637,1359742639893,164025449,164025705,256
1359742669,164054712,1,46,46,1359742643835,1359742643835,164029547,164029547,0
1359742669,164054796,1,46,46,1359742643750,1359742643750,164029546,164029546,0
1359742669,164054820,2,92,46,1359742643727,1359742643791,164029547,164029611,64
1359742669,164054820,1,46,46,1359742643727,1359742643727,164029547,164029547,0
1359742673,164058744,8,1636,204.5,1359742644890,1359742645338,164030634,164031082,448
1359742681,164066664,13,728,56,1359742653418,1359742669418,164039082,164055082,16000
1359742681,164066752,1,137,137,1359742653395,1359742653395,164039147,164039147,0
1359742685,164070848,13,1248,96,1359742660594,1359742674802,164046442,164060650,14208
1359742689,3097352892,7,392,56,1359742662125,1359742687341,3097326017,3097351233,25216
1359742689,164074664,8,448,56,1359742661099,1359742687851,164046763,164073515,26752
1359742689,164074664,14,784,56,1359742661352,1359742687656,164047016,164073320,26304
1359742690,3097354184,4,184,46,1359742687176,1359742688840,3097351360,3097353024,1664
1359742697,164082808,3,492,164,1359742668952,1359742669016,164054760,164054824,64
1359742698,3097362192,2,92,46,1359742689151,1359742690879,3097353343,3097355071,1728
1359742701,164086856,2,92,46,1359742674795,1359742674795,164060651,164060651,0
1359742705,164090976,3,544,181.3333333,1359742679602,1359742679666,164065578,164065642,64
1359742713,164098832,12,672,56,1359742686337,1359742709761,164072169,164095593,23424
1359742713,164098836,11,1056,96,1359742686590,1359742709182,164072426,164095018,22592
1359742717,3097380956,5,280,56,1359742691501,1359742709869,3097355457,3097373825,18368
1359742717,164102828,11,616,56,1359742689222,1359742713734,164075050,164099562,24512
1359742725,164110848,1,137,137,1359742698034,1359742698034,164083882,164083882,0
1359742729,164114912,6,336,56,1359742701231,1359742721711,164087143,164107623,20480
1359742737,164122712,3,492,164,1359742708985,1359742709049,164094697,164094761,64
1359742737,164122812,4,489,122.25,1359742709331,1359742709523,164095143,164095335,192
1359742741,164126928,8,768,96,1359742713057,1359742738977,164098985,164124905,25920
1359742741,164126928,3,604,201.3333333,1359742713121,1359742713441,164099049,164099369,320
1359742745,164130948,3,544,181.3333333,1359742719757,1359742719757,164105705,164105705,0
1359742745,164130952,8,448,56,1359742720456,1359742741000,164106408,164126952,20544
1359742749,3097412956,4,224,56,1359742721517,1359742741229,3097385473,3097405185,19712
1359742749,164134836,629,814734,1295.284579,1359742410044,1359742448060,163795880,163833896,38016
1359742749,164134924,7,392,56,1359742721061,1359742740709,164106985,164126633,19648
1359742765,164150856,5,280,56,1359742737511,1359742764519,164123367,164150375,27008
1359742765,164150860,1,137,137,1359742738469,1359742738469,164124329,164124329,0
1359742777,164162948,3,492,164,1359742748812,1359742748876,164134760,164134824,64
1359742778,3097442208,4,184,46,1359742771380,1359742772916,3097435588,3097437124,1536
1359742785,164170996,3,544,181.3333333,1359742759774,1359742759838,164145770,164145834,64
1359742789,3097453016,5,280,56,1359742762803,1359742787315,3097426819,3097451331,24512
1359742789,164174968,10,560,56,1359742761722,1359742787002,164147690,164172970,25280
1359742789,164174976,10,560,56,1359742761906,1359742788786,164147882,164174762,26880
1359742789,164174980,10,960,96,1359742761516,1359742784684,164147496,164170664,23168
1359742793,164179004,2,112,56,1359742767061,1359742782485,164153065,164168489,15424
1359742797,164182932,1,137,137,1359742770780,1359742770780,164156712,164156712,0
1359742813,164199072,3,492,164,1359742788686,1359742788686,164174758,164174758,0
1359742817,164202928,5,480,96,1359742789087,1359742812511,164175015,164198439,23424
1359742825,3097489004,4,224,56,1359742798910,1359742824318,3097462914,3097488322,25408
1359742825,164210928,7,392,56,1359742797727,1359742823839,164183655,164209767,26112
1359742825,164211008,4,224,56,1359742797391,1359742823183,164183399,164209191,25792
1359742825,164211012,7,392,56,1359742797898,1359742824330,164183910,164210342,26432
1359742825,164211052,3,544,181.3333333,1359742799842,1359742799842,164185894,164185894,0
1359742834,164219604,3,138,46,1359742829667,1359742829667,164215271,164215271,0
1359742837,164222996,1,137,137,1359742812507,1359742812507,164198503,164198503,0
1359742849,164235088,9,864,96,1359742821249,1359742840897,164207337,164226985,19648
1359742854,164239260,6,336,56,1359742829818,1359742842298,164215078,164227558,12480
1359742854,164239264,3,168,56,1359742825975,1359742841463,164211239,164226727,15488
1359742854,164239340,6,336,56,1359742829355,1359742841963,164214695,164227303,12608
1359742854,164239348,2,92,46,1359742825825,1359742825889,164211173,164211237,64
1359742854,164239420,3,492,164,1359742829274,1359742829338,164214694,164214758,64
1359742865,3097529068,4,224,56,1359742839231,1359742858687,3097503299,3097522755,19456
1359742866,164251312,2,498,249,1359742840649,1359742840649,164225961,164225961,0
1359742878,164263412,1,137,137,1359742852066,1359742852066,164237478,164237478,0
1359742882,164267340,4,224,56,1359742856489,1359742881001,164241829,164266341,24512
1359742882,164267348,3,168,56,1359742857317,1359742875109,164242665,164260457,17792
1359742882,164267420,4,384,96,1359742856157,1359742875357,164241577,164260777,19200
1359742882,164267420,2,112,56,1359742856347,1359742872731,164241767,164258151,16384
1359742894,164279376,3,492,164,1359742869383,1359742869447,164254759,164254823,64
1359742905,3097569104,4,224,56,1359742880603,1359742900123,3097544707,3097564227,19520
1359742906,164291376,3,544,181.3333333,1359742880712,1359742880776,164266088,164266152,64
1359742918,164303472,1,137,137,1359742890278,1359742890278,164275750,164275750,0
1359742922,164307452,11,616,56,1359742897148,1359742921660,164282600,164307112,24512
1359742922,164307452,11,1056,96,1359742897211,1359742921723,164282663,164307175,24512
1359742922,164307452,5,280,56,1359742897338,1359742920890,164282790,164306342,23552
1359742922,164307480,10,560,56,1359742897376,1359742921504,164282856,164306984,24128
1359742934,164319460,3,492,164,1359742909235,1359742909299,164294695,164294759,64
1359742945,3097609052,2,112,56,1359742918287,1359742921423,3097582339,3097585475,3136
1359742946,164331496,1,56,56,1359742921807,1359742921807,164307303,164307303,0
1359742946,164331548,1,137,137,1359742920474,1359742920474,164306022,164306022,0
1359742946,164331548,2,498,249,1359742920601,1359742920665,164306149,164306213,64
1359742950,164335488,4,224,56,1359742921876,1359742948436,164307364,164333924,26560
1359742950,164335492,4,384,96,1359742922256,1359742949008,164307748,164334500,26752
1359742950,164335492,4,224,56,1359742921940,1359742948308,164307432,164333800,26368
1359742954,164339680,3,144,48,1359742946199,1359742951447,164331879,164337127,5248
1359742954,164339736,3,144,48,1359742946140,1359742951452,164331876,164337188,5312
1359742970,164355624,8,1368,171,1359742945485,1359742945997,164331109,164331621,512
1359742973,3097637272,3,168,56,1359742946227,1359742967475,3097610499,3097631747,21248
1359742974,164359496,3,492,164,1359742949261,1359742949325,164334757,164334821,64
1359742974,164359564,3,168,56,1359742947275,1359742968011,164332839,164353575,20736
1359742978,164363552,2,112,56,1359742949974,1359742967702,164335526,164353254,17728
1359742978,164363556,2,112,56,1359742950354,1359742967826,164335910,164353382,17472
1359742978,164363588,2,192,96,1359742951538,1359742967922,164337126,164353510,16384
1359742986,164371512,3,544,181.3333333,1359742960766,1359742960830,164346278,164346342,64
1359742990,164375488,1,137,137,1359742962519,1359742962519,164348007,164348007,0
1359743014,164399860,3,492,164,1359742988834,1359742988898,164374694,164374758,64
1359743018,164403856,1,137,137,1359742993254,1359742993254,164379110,164379110,0
1359743022,164407824,8,448,56,1359742997059,1359743002307,164382883,164388131,5248
1359743022,164407828,8,768,96,1359742997122,1359743017986,164382950,164403814,20864
1359743022,164407836,4,224,56,1359742997751,1359743018039,164383587,164403875,20288
1359743022,164407916,8,448,56,1359742997226,1359743021738,164383142,164407654,24512
1359743025,3097689312,5,280,56,1359742997388,1359743022732,3097661700,3097687044,25344
1359743026,164411960,3,544,181.3333333,1359743000444,1359743000444,164386404,164386404,0
1359743036,164421816,31563,44846759,1420.864905,1359742509643,1359743022155,163895459,164407971,512512
1359743036,164421984,1,56,56,1359743028707,1359743028707,164414691,164414691,0
1359743037,164422352,2,112,56,1359743022685,1359743029597,164408037,164414949,6912
1359743037,164422360,2,192,96,1359743022742,1359743030230,164408102,164415590,7488
1359743037,164422752,3,492,164,1359743028942,1359743029006,164414694,164414758,64
1359743037,164422836,1,137,137,1359743029815,1359743029815,164415651,164415651,0
1359743067,164452152,3,138,46,1359743062052,1359743062116,164447204,164447268,64
1359743067,164452268,3,544,181.3333333,1359743041199,1359743041263,164426467,164426531,64
1359743077,3097741356,1,56,56,1359743052382,1359743052382,3097716738,3097716738,0
1359743079,164464148,1,56,56,1359743051753,1359743051753,164436901,164436901,0
1359743079,164464148,2,112,56,1359743051689,1359743055465,164436837,164440613,3776
1359743079,164464148,2,112,56,1359743051753,1359743055593,164436901,164440741,3840
1359743079,164464148,2,192,96,1359743052006,1359743055910,164437154,164441058,3904
1359743095,164480328,3,492,164,1359743069427,1359743069491,164454755,164454819,64
1359743095,164480336,1,137,137,1359743070186,1359743070186,164455522,164455522,0
1359743107,164492296,1,56,56,1359743081426,1359743081426,164466722,164466722,0
1359743107,164492300,1,56,56,1359743081553,1359743081553,164466853,164466853,0
1359743107,164492376,3,544,181.3333333,1359743081219,1359743081219,164466595,164466595,0
1359743111,164496364,1,56,56,1359743084111,1359743084111,164469475,164469475,0
1359743111,164496364,1,96,96,1359743084366,1359743084366,164469730,164469730,0
1359743135,164520432,3,492,164,1359743109259,1359743109323,164494691,164494755,64
1359743137,3097801592,5,280,56,1359743110899,1359743120627,3097775491,3097785219,9728
1359743139,164524276,8,448,56,1359743111847,1359743116519,164497123,164501795,4672
1359743139,164524276,9,504,56,1359743111782,1359743121638,164497058,164506914,9856
1359743139,164524276,8,768,96,1359743111974,1359743118822,164497250,164504098,6848
1359743139,164524280,4,224,56,1359743112163,1359743115875,164497443,164501155,3712
1359743139,164524320,1,137,137,1359743114106,1359743114106,164499426,164499426,0
1359743146,164531944,4029,5638025,1399.360884,1359743050633,1359743145353,164436577,164531297,94720
1359743147,164532316,3,544,181.3333333,1359743121279,1359743121343,164506595,164506659,64
1359743175,164560336,1,137,137,1359743149225,1359743149225,164534561,164534561,0
1359743175,164560432,3,492,164,1359743149256,1359743149320,164534688,164534752,64
1359743187,164572364,3,544,181.3333333,1359743161231,1359743161295,164546595,164546659,64
1359743215,164600392,3,492,164,1359743189363,1359743189427,164574755,164574819,64
1359743215,164600444,1,137,137,1359743188223,1359743188223,164573667,164573667,0
1359743219,164604416,4,656,164,1359743193947,1359743194331,164579363,164579747,384
1359743227,164612476,10,560,56,1359743201502,1359743221086,164586978,164606562,19584
1359743227,164612552,3,544,181.3333333,1359743201105,1359743201169,164586657,164586721,64
1359743227,164612556,10,560,56,1359743201613,1359743221965,164587169,164607521,20352
1359743227,164612556,10,960,96,1359743201484,1359743221068,164587040,164606624,19584
1359743227,164612560,5,280,56,1359743201675,1359743220683,164587235,164606243,19008
1359743229,3097893528,5,280,56,1359743201590,1359743220982,3097866118,3097885510,19392
1359743247,164632440,1,137,137,1359743219136,1359743219136,164604576,164604576,0
1359743255,164640584,3,492,164,1359743229168,1359743229232,164614752,164614816,64
1359743259,164644548,8,448,56,1359743233110,1359743237398,164618658,164622946,4288
1359743259,164644548,8,768,96,1359743233300,1359743237716,164618848,164623264,4416
1359743259,164644548,4,224,56,1359743233363,1359743237203,164618911,164622751,3840
1359743259,164644552,7,392,56,1359743233489,1359743237265,164619041,164622817,3776
1359743261,3097925600,4,224,56,1359743233775,1359743256815,3097898375,3097921415,23040
1359743267,164652520,3,544,181.3333333,1359743241266,1359743241266,164626786,164626786,0
1359743271,164656516,7,1091,155.8571429,1359743246133,1359743246581,164631649,164632097,448
1359743275,164660468,1,137,137,1359743250467,1359743250467,164635935,164635935,0
1359743287,164672624,1,56,56,1359743258826,1359743258826,164644450,164644450,0
1359743287,164672664,1,56,56,1359743261023,1359743261023,164646687,164646687,0
1359743287,164672668,1,96,96,1359743261340,1359743261340,164647008,164647008,0
1359743295,164680552,3,492,164,1359743269201,1359743269201,164654753,164654753,0
1359743307,164692532,3,544,181.3333333,1359743281316,1359743281380,164666848,164666912,64
1359743311,164696672,1,137,137,1359743286490,1359743286490,164672162,164672162,0
1359743318,3097982164,1,56,56,1359743293155,1359743293155,3097957319,3097957319,0
1359743319,164704488,2,112,56,1359743291282,1359743295122,164676770,164680610,3840
1359743319,164704496,2,112,56,1359743292744,1359743294280,164678240,164679776,1536
1359743319,164704496,2,112,56,1359743292807,1359743294791,164678303,164680287,1984
1359743319,164704576,2,192,96,1359743292921,1359743294777,164678497,164680353,1856
1359743335,164720748,3,492,164,1359743308938,1359743309002,164694686,164694750,64
1359743346,3098010080,5,280,56,1359743319541,1359743342069,3097983621,3098006149,22528
1359743347,164732744,9,504,56,1359743318927,1359743340047,164704671,164725791,21120
1359743347,164732748,9,504,56,1359743319050,1359743341322,164704798,164727070,22272
1359743347,164732784,4,224,56,1359743319848,1359743339816,164705632,164725600,19968
1359743347,164732840,9,864,96,1359743319023,1359743341359,164704863,164727199,22336
1359743347,164732884,3,544,181.3333333,1359743321089,1359743321153,164706973,164707037,64
1359743351,164736872,1,137,137,1359743326031,1359743326031,164711903,164711903,0
1359743363,164748100,4,184,46,1359743362452,1359743362708,164747552,164747808,256
1359743375,164760892,3,492,164,1359743348857,1359743348921,164734749,164734813,64
1359743383,164768868,8,448,56,1359743358100,1359743362196,164743968,164748064,4096
1359743383,164768868,8,448,56,1359743358035,1359743361875,164743903,164747743,3840
1359743383,164768868,7,672,96,1359743358226,1359743361618,164744094,164747486,3392
1359743383,164768972,4,224,56,1359743358252,1359743361708,164744224,164747680,3456
1359743386,3098050152,3,168,56,1359743359214,1359743361646,3098023366,3098025798,2432
1359743387,164772828,4,1002,250.5,1359743361210,1359743361594,164747038,164747422,384
1359743395,164780932,1,137,137,1359743368721,1359743368721,164754653,164754653,0
1359743411,164796892,2,192,96,1359743386108,1359743390332,164772000,164776224,4224
1359743414,3098078076,1,56,56,1359743387450,1359743387450,3098051526,3098051526,0
1359743415,164800944,2,112,56,1359743390024,1359743390472,164775968,164776416,448
1359743415,164800968,2,112,56,1359743390192,1359743390704,164776160,164776672,512
1359743415,164800968,1,56,56,1359743390381,1359743390381,164776349,164776349,0
1359743415,164801016,3,492,164,1359743388670,1359743388734,164774686,164774750,64
1359743427,164813064,4,590,147.5,1359743401102,1359743401166,164787166,164787230,64
1359743427,164813072,1,137,137,1359743401735,1359743401735,164787807,164787807,0
1359743442,3098106112,10,560,56,1359743417173,1359743428565,3098081285,3098092677,11392
1359743443,164829080,20,1920,96,1359743416447,1359743428479,164802527,164814559,12032
1359743443,164829080,20,1120,56,1359743416575,1359743428863,164802655,164814943,12288
1359743443,164829084,18,1008,56,1359743416636,1359743428092,164802720,164814176,11456
1359743443,164829088,10,560,56,1359743417142,1359743428726,164803230,164814814,11584
1359743455,164840980,3,492,164,1359743428706,1359743428770,164814686,164814750,64
1359743463,164848992,1,137,137,1359743437844,1359743437844,164823836,164823836,0
1359743467,164852996,3,544,181.3333333,1359743441299,1359743441427,164827295,164827423,128
1359743475,164860968,9,864,96,1359743450095,1359743455919,164836063,164841887,5824
1359743475,164860972,8,448,56,1359743450282,1359743455466,164836254,164841438,5184
1359743476,164861164,4,224,56,1359743451346,1359743456210,164836510,164841374,4864
1359743476,164861240,9,504,56,1359743450695,1359743456327,164835935,164841567,5632
1359743478,3098142112,4,224,56,1359743450711,1359743455511,3098114823,3098119623,4800
1359743491,164876204,14607,20755147,1420.904156,1359743201257,1359743485801,164586461,164871005,284544
1359743496,164881252,3,492,164,1359743469496,1359743469496,164854748,164854748,0
1359743499,164884112,17,8946,526.2352941,1359743492615,1359743493319,164877727,164878431,704
1359743499,164884116,16,7756,484.75,1359743493376,1359743493888,164878492,164879004,512
1359743499,164884152,12,5821,485.0833333,1359743490655,1359743496031,164875807,164881183,5376
1359743499,164884192,13,5690,437.6923077,1359743491830,1359743492534,164877022,164877726,704
1359743507,164892140,8,544,68,1359743496170,1359743501930,164881310,164887070,5760
1359743507,164892140,8,544,68,1359743496169,1359743501929,164881309,164887069,5760
1359743507,164892140,9,590,65.55555556,1359743496169,1359743501929,164881309,164887069,5760
1359743507,164892184,9,2292,254.6666667,1359743495803,1359743500859,164880987,164886043,5056
1359743507,164892188,8,2264,283,1359743495867,1359743501883,164881055,164887071,6016
1359743507,164892192,8,544,68,1359743496118,1359743501878,164881310,164887070,5760
1359743507,164892192,8,544,68,1359743496117,1359743501877,164881309,164887069,5760
1359743507,164892224,10,4927,492.7,1359743493269,1359743498837,164878493,164884061,5568
1359743507,164892224,10,4897,489.7,1359743493844,1359743499860,164879068,164885084,6016
1359743507,164892224,8,4805,600.625,1359743493844,1359743499860,164879068,164885084,6016
1359743508,164893228,1,137,137,1359743479826,1359743479826,164865054,164865054,0
1359743508,164893392,3,544,181.3333333,1359743481966,1359743481966,164867358,164867358,0
1359743516,164901332,19,10200,536.8421053,1359743491368,1359743493992,164876700,164879324,2624
1359743520,164905192,19,7648,402.5263158,1359743492150,1359743493110,164877342,164878302,960
1359743520,164905236,13,7902,607.8461538,1359743494154,1359743494602,164879390,164879838,448
1359743520,164905240,67,55237,824.4328358,1359743494660,1359743516100,164879900,164901340,21440
1359743520,164905284,7,2656,379.4285714,1359743492762,1359743492954,164878046,164878238,192
1359743520,164905360,20,10329,516.45,1359743495630,1359743497678,164880990,164883038,2048
1359743522,3098186140,4,224,56,1359743495803,1359743499899,3098159943,3098164039,4096
1359743522,3098186432,2,98,49,1359743515479,1359743521495,3098179911,3098185927,6016
1359743522,3098186452,2,98,49,1359743515460,1359743521476,3098179912,3098185928,6016
1359743522,3098186452,2,98,49,1359743515460,1359743521476,3098179912,3098185928,6016
1359743522,3098186452,3,144,48,1359743515460,1359743521476,3098179912,3098185928,6016
1359743523,164908188,3,144,48,1359743516090,1359743522106,164901278,164907294,6016
1359743524,164909208,5,280,56,1359743496742,1359743523494,164881950,164908702,26752
1359743524,164909276,10,560,56,1359743496097,1359743523553,164881373,164908829,27456
1359743524,164909276,10,560,56,1359743496224,1359743523680,164881500,164908956,27456
1359743524,164909284,10,960,96,1359743496407,1359743523799,164881691,164909083,27392
1359743531,164916180,4,190,47.5,1359743521217,1359743527169,164906397,164912349,5952
1359743531,164916188,5,466,93.2,1359743529914,1359743529978,164915102,164915166,64
1359743536,164921216,10,3397,339.7,1359743509468,1359743533916,164894684,164919132,24448
1359743538,3098202436,2,98,49,1359743528980,1359743534420,3098193416,3098198856,5440
1359743538,3098202436,3,144,48,1359743529427,1359743534483,3098193863,3098198919,5056
1359743538,3098202452,4,190,47.5,1359743527427,1359743532483,3098191879,3098196935,5056
1359743538,3098202456,2,98,49,1359743528959,1359743534399,3098193415,3098198855,5440
1359743539,164924188,3,144,48,1359743529978,1359743535098,164915166,164920286,5120
1359743539,164924268,2,94,47,1359743529895,1359743534951,164915163,164920219,5056
1359743542,3098206088,4,398,99.5,1359743515822,1359743515886,3098179910,3098179974,64
1359743542,3098206136,3,352,117.3333333,1359743515775,1359743515839,3098179911,3098179975,64
1359743544,164929296,13,1245,95.76923077,1359743515917,1359743529997,164901213,164915293,14080
1359743544,164929296,2,339,169.5,1359743515980,1359743516044,164901276,164901340,64
1359743544,164929300,4,319,79.75,1359743516106,1359743516170,164901406,164901470,64
1359743546,3098210436,3,144,48,1359743538514,1359743543506,3098202950,3098207942,4992
1359743548,164933232,1,137,137,1359743520845,1359743520845,164906077,164906077,0
1359743548,164933244,5,2850,570,1359743521922,1359743522626,164907166,164907870,704
1359743548,164933248,48,64914,1352.375,1359743522429,1359743523453,164907677,164908701,1024
1359743548,164933248,19,21348,1123.578947,1359743522493,1359743523453,164907741,164908701,960
1359743548,164933248,19,21677,1140.894737,1359743522428,1359743523004,164907676,164908252,576
1359743548,164933248,20,23282,1164.1,1359743522428,1359743523452,164907676,164908700,1024
1359743548,164933324,21,7921,377.1904762,1359743521072,1359743530160,164906396,164915484,9088
1359743548,164933332,18,20075,1115.277778,1359743522344,1359743522920,164907676,164908252,576
1359743548,164933332,20,22222,1111.1,1359743522408,1359743523432,164907740,164908764,1024
1359743548,164933356,19,21330,1122.631579,1359743522321,1359743522833,164907677,164908189,512
1359743548,164933356,31,38325,1236.290323,1359743522320,1359743523408,164907676,164908764,1088
1359743548,164933356,20,23202,1160.1,1359743522384,1359743522832,164907740,164908188,448
1359743550,3098214116,5,280,56,1359743522899,1359743538835,3098187015,3098202951,15936
1359743552,164937240,9,504,56,1359743526980,1359743551108,164912220,164936348,24128
1359743552,164937324,10,560,56,1359743526834,1359743551794,164912158,164937118,24960
1359743552,164937328,9,864,96,1359743527468,1359743551084,164912796,164936412,23616
1359743554,3098218124,7,5839,834.1428571,1359743529290,1359743529354,3098193414,3098193478,64
1359743554,3098218172,6,4946,824.3333333,1359743529242,1359743529306,3098193414,3098193478,64
1359743555,164940160,5,318,63.6,1359743536851,1359743551443,164922011,164936603,14592
1359743555,164940268,2,98,49,1359743550569,1359743550633,164935837,164935901,64
1359743555,164940272,3,144,48,1359743551140,1359743551204,164936412,164936476,64
1359743556,164941208,7,392,56,1359743527908,1359743555684,164913116,164940892,27776
1359743556,164941264,6,635,105.8333333,1359743529837,1359743529965,164915101,164915229,128
1359743556,164941268,5,476,95.2,1359743529833,1359743529961,164915101,164915229,128
1359743562,3098226432,7,3059,437,1359743555607,1359743555927,3098220039,3098220359,320
1359743562,3098226432,7,1548,221.1428571,1359743555926,1359743556246,3098220358,3098220678,320
1359743563,164948168,2,98,49,1359743556557,1359743562189,164941725,164947357,5632
1359743563,164948172,2,98,49,1359743556873,1359743562185,164942045,164947357,5312
1359743563,164948248,3,144,48,1359743556794,1359743562106,164942042,164947354,5312
1359743563,164948256,5,691,138.2,1359743557619,1359743562803,164942875,164948059,5184
1359743563,164948260,8,1014,126.75,1359743557614,1359743562798,164942874,164948058,5184
1359743563,164948260,6,667,111.1666667,1359743557809,1359743558961,164943069,164944221,1152
1359743567,3098231392,8,448,56,1359743550016,1359743564608,3098214408,3098229000,14592
1359743567,3098231612,3,144,48,1359743559011,1359743564451,3098223623,3098229063,5440
1359743567,3098231628,12,2176,181.3333333,1359743555860,1359743566164,3098220488,3098230792,10304
1359743568,3098231896,7,1977,282.4285714,1359743559727,1359743559855,3098223623,3098223751,128
1359743568,3098232276,2,98,49,1359743557107,1359743562739,3098221383,3098227015,5632
1359743568,3098232288,3,144,48,1359743557350,1359743562726,3098221638,3098227014,5376
1359743568,3098232332,1,52,52,1359743566652,1359743566652,3098230984,3098230984,0
1359743568,3098232332,6,1502,250.3333333,1359743566652,1359743566908,3098230984,3098231240,256
1359743568,3098232332,1,56,56,1359743566716,1359743566716,3098231048,3098231048,0
1359743568,3098232332,5,497,99.4,1359743566842,1359743566970,3098231174,3098231302,128
1359743568,164953876,7,810,115.7142857,1359743539464,1359743539848,164925340,164925724,384
1359743568,164954020,25,17438,697.52,1359743555320,1359743566456,164941340,164952476,11136
1359743568,164954024,138,175473,1271.543478,1359743559157,1359743565493,164945181,164951517,6336
1359743568,164954024,16,1536,96,1359743551220,1359743566964,164937244,164952988,15744
1359743569,164954208,8,2016,252,1359743556834,1359743567330,164942042,164952538,10496
1359743569,164954220,136,144615,1063.345588,1359743547799,1359743552151,164933019,164937371,4352
1359743569,164954220,56,63662,1136.821429,1359743560663,1359743560983,164945883,164946203,320
1359743569,164954284,6,336,56,1359743557207,1359743567895,164942491,164953179,10688
1359743569,164954292,5,1041,208.2,1359743552974,1359743553102,164938266,164938394,128
1359743569,164954300,4,1271,317.75,1359743553160,1359743553224,164938460,164938524,64
1359743569,164954336,10,2344,234.4,1359743557348,1359743563044,164942684,164948380,5696
1359743569,164954340,2,92,46,1359743557535,1359743563039,164942875,164948379,5504
1359743569,164954340,9,4272,474.6666667,1359743557535,1359743562783,164942875,164948123,5248
1359743569,164954340,3,822,274,1359743557535,1359743563039,164942875,164948379,5504
1359743569,164954348,2,94,47,1359743557655,1359743563031,164943003,164948379,5376
1359743569,164954372,5,1745,349,1359743557631,1359743557759,164943003,164943131,128
1359743569,164954376,3,355,118.3333333,1359743557692,1359743563004,164943068,164948380,5312
1359743569,164954380,6,1508,251.3333333,1359743557689,1359743567353,164943069,164952733,9664
1359743569,164954380,2,98,49,1359743557689,1359743563001,164943069,164948381,5312
1359743569,164954380,12,4640,386.6666667,1359743557687,1359743567607,164943067,164952987,9920
1359743569,164954380,11,4609,419,1359743557687,1359743567735,164943067,164953115,10048
1359743569,164954388,3,144,48,1359743557870,1359743562990,164943258,164948378,5120
1359743569,164954420,1,137,137,1359743561489,1359743561489,164946909,164946909,0
1359743569,164954456,131,121109,924.4961832,1359743497453,1359743526509,164882909,164911965,29056
1359743569,164954460,4,317,79.25,1359743566888,1359743567144,164952348,164952604,256
1359743569,164954468,11,3948,358.9090909,1359743550433,1359743550689,164935901,164936157,256
1359743569,164954496,13,7489,576.0769231,1359743550404,1359743550724,164935900,164936220,320
1359743569,164954496,3,550,183.3333333,1359743567044,1359743567108,164952540,164952604,64
1359743569,164954508,7,2471,353,1359743558585,1359743558841,164944093,164944349,256
1359743569,164954508,4,575,143.75,1359743567161,1359743567353,164952669,164952861,192
1359743569,164954528,2,776,388,1359743567204,1359743567332,164952732,164952860,128
1359743569,164954532,1,46,46,1359743567265,1359743567265,164952797,164952797,0
1359743569,164954532,178,231339,1299.657303,1359743554335,1359743567007,164939867,164952539,12672
1359743569,164954536,8,3189,398.625,1359743550876,1359743551004,164936412,164936540,128
1359743569,164954540,11,3564,324,1359743550938,1359743551194,164936478,164936734,256
1359743569,164954584,39,37092,951.0769231,1359743554282,1359743566314,164939866,164951898,12032
1359743569,164954584,45,46860,1041.333333,1359743559274,1359743560618,164944858,164946202,1344
1359743569,164954656,6,2445,407.5,1359743555684,1359743566500,164941340,164952156,10816
1359743569,164954660,17,952,56,1359743551518,1359743567774,164937178,164953434,16256
1359743569,164954668,10,5498,549.8,1359743559513,1359743559705,164945181,164945373,192
1359743569,164954772,4,447,111.75,1359743555889,1359743556209,164941661,164941981,320
1359743569,164954944,16,896,56,1359743552323,1359743567491,164938267,164953435,15168
1359743569,164954980,100,67037,670.37,1359743520415,1359743539231,164906395,164925211,18816
1359743569,164954992,3,812,270.6666667,1359743552531,1359743552595,164938523,164938587,64
1359743569,164955012,2,92,46,1359743556864,1359743562368,164942876,164948380,5504
1359743569,164955012,2,98,49,1359743556863,1359743562367,164942875,164948379,5504
1359743569,164955012,2,92,46,1359743556863,1359743562367,164942875,164948379,5504
1359743569,164955020,3,355,118.3333333,1359743557049,1359743562361,164943069,164948381,5312
1359743569,164955020,3,355,118.3333333,1359743557049,1359743562361,164943069,164948381,5312
1359743569,164955020,4,196,49,1359743557047,1359743562423,164943067,164948443,5376
1359743569,164955028,11,4594,417.6363636,1359743557041,1359743566705,164943069,164952733,9664
1359743569,164955028,6,1246,207.6666667,1359743557168,1359743566832,164943196,164952860,9664
1359743570,164955112,5,437,87.4,1359743550661,1359743550789,164935773,164935901,128
1359743570,164955140,19,5117,269.3157895,1359743558761,1359743568297,164943901,164953437,9536
1359743570,164955152,13,6948,534.4615385,1359743550621,1359743550749,164935773,164935901,128
1359743570,164955152,1,52,52,1359743567451,1359743567451,164952603,164952603,0
1359743570,164955180,3,599,199.6666667,1359743567554,1359743567618,164952734,164952798,64
1359743570,164955180,4,830,207.5,1359743567551,1359743567615,164952731,164952795,64
1359743570,164955184,1,46,46,1359743567614,1359743567614,164952798,164952798,0
1359743570,164955184,1,46,46,1359743567613,1359743567613,164952797,164952797,0
1359743570,164955184,1,46,46,1359743567611,1359743567611,164952795,164952795,0
1359743570,164955188,459,614472,1338.718954,1359743554488,1359743567736,164939676,164952924,13248
1359743570,164955224,26,12108,465.6923077,1359743551252,1359743551572,164936476,164936796,320
1359743570,164955224,97,123779,1276.072165,1359743554643,1359743566739,164939867,164951963,12096
1359743570,164955228,57,59065,1036.22807,1359743554640,1359743567120,164939868,164952348,12480
1359743570,164955228,35,28212,806.0571429,1359743554640,1359743566672,164939868,164951900,12032
1359743571,164956116,3,138,46,1359743568640,1359743568704,164953756,164953820,64
1359743571,164956116,3,138,46,1359743568768,1359743568832,164953884,164953948,64
1359743578,3098242420,3,144,48,1359743572258,1359743577826,3098236678,3098242246,5568
1359743579,164964172,3,138,46,1359743572617,1359743572681,164957789,164957853,64
1359743579,164964220,4,205,51.25,1359743572377,1359743572377,164957597,164957597,0
1359743587,164972180,8,544,68,1359743580224,1359743585920,164965404,164971100,5696
1359743587,164972252,8,544,68,1359743580153,1359743585849,164965405,164971101,5696
1359743587,164972252,9,590,65.55555556,1359743580152,1359743585848,164965404,164971100,5696
1359743587,164972252,9,590,65.55555556,1359743580150,1359743585846,164965402,164971098,5696
1359743587,164972256,8,544,68,1359743580146,1359743585906,164965402,164971162,5760
1359743587,164972256,12,5821,485.0833333,1359743578676,1359743583988,164963932,164969244,5312
1359743587,164972256,9,2292,254.6666667,1359743580723,1359743586867,164965979,164972123,6144
1359743587,164972260,15,8843,589.5333333,1359743582064,1359743582384,164967324,164967644,320
1359743594,3098258100,5,280,56,1359743568483,1359743585635,3098232583,3098249735,17152
1359743596,164981412,9,504,56,1359743570968,1359743586712,164956380,164972124,15744
1359743596,164981416,46,51919,1128.673913,1359743570962,1359743589714,164956378,164975130,18752
1359743596,164981452,9,504,56,1359743571055,1359743589359,164956507,164974811,18304
1359743596,164981452,43,50743,1180.069767,1359743571118,1359743589678,164956570,164975130,18560
1359743596,164981460,1,46,46,1359743571496,1359743571496,164956956,164956956,0
1359743596,164981460,16,16306,1019.125,1359743571560,1359743572136,164957020,164957596,576
1359743596,164981460,14,14368,1026.285714,1359743571559,1359743571943,164957019,164957403,384
1359743596,164981488,10,960,96,1359743568203,1359743589451,164953691,164974939,21248
1359743596,164981604,20,21352,1067.6,1359743571415,1359743571991,164957019,164957595,576
1359743596,164981604,13,13839,1064.538462,1359743571414,1359743571862,164957018,164957466,448
1359743596,164981604,2,813,406.5,1359743571414,1359743571606,164957018,164957210,192
1359743596,164981608,5,280,56,1359743571541,1359743589461,164957149,164975069,17920
1359743598,3098262204,2,92,46,1359743572027,1359743572091,3098236231,3098236295,64
1359743600,164985328,5,970,194,1359743571948,1359743596908,164957276,164982236,24960
1359743600,164985372,2,92,46,1359743573250,1359743573314,164958622,164958686,64
1359743600,164985372,1,46,46,1359743573249,1359743573249,164958621,164958621,0
1359743600,164985372,3,492,164,1359743573375,1359743573439,164958747,164958811,64
1359743600,164985432,2,577,288.5,1359743571909,1359743572101,164957341,164957533,192
1359743600,164985456,6,1492,248.6666667,1359743572268,1359743598828,164957724,164984284,26560
1359743600,164985460,2,92,46,1359743572330,1359743572394,164957790,164957854,64
1359743600,164985464,3,138,46,1359743572646,1359743572646,164958110,164958110,0
1359743600,164985468,2,92,46,1359743573152,1359743573152,164958620,164958620,0
1359743600,164985468,1,46,46,1359743573152,1359743573152,164958620,164958620,0
1359743600,164985472,2,92,46,1359743573149,1359743573213,164958621,164958685,64
1359743604,164989312,36,35675,990.9722222,1359743579323,1359743581307,164964635,164966619,1984
1359743604,164989396,4,1839,459.75,1359743578918,1359743579238,164964314,164964634,320
1359743604,164989488,6,1283,213.8333333,1359743578443,1359743578827,164963931,164964315,384
1359743608,164993324,3,138,46,1359743582574,1359743582638,164967898,164967962,64
1359743608,164993324,3,378,126,1359743582638,1359743582702,164967962,164968026,64
1359743608,164993328,3,138,46,1359743582637,1359743582701,164967965,164968029,64
1359743608,164993396,25,18357,734.28,1359743580968,1359743582440,164966364,164967836,1472
1359743608,164993412,3,138,46,1359743582296,1359743582360,164967708,164967772,64
1359743608,164993412,3,379,126.3333333,1359743582615,1359743584663,164968027,164970075,2048
1359743610,3098274424,3,144,48,1359743598046,1359743603166,3098262470,3098267590,5120
1359743611,164996260,9,568,63.11111111,1359743598575,1359743603631,164983835,164988891,5056
1359743612,164997364,1,46,46,1359743586759,1359743586759,164972123,164972123,0
1359743616,165001336,3,138,46,1359743589604,1359743589668,164974940,164975004,64
1359743620,165005312,1,77,77,1359743595641,1359743595641,164980953,164980953,0
1359743620,165005316,2,123,61.5,1359743595641,1359743595705,164980957,164981021,64
1359743620,165005316,2,123,61.5,1359743595641,1359743595641,164980957,164980957,0
1359743620,165005316,2,123,61.5,1359743595641,1359743595641,164980957,164980957,0
1359743620,165005384,2,123,61.5,1359743594609,1359743594609,164979993,164979993,0
1359743620,165005420,1,77,77,1359743595536,1359743595536,164980956,164980956,0
1359743620,165005476,2,123,61.5,1359743594520,1359743594520,164979996,164979996,0
1359743622,3098286196,8,448,56,1359743597636,1359743620228,3098261832,3098284424,22592
1359743624,165009368,2,123,61.5,1359743596610,1359743596674,164981978,164982042,64
1359743624,165009372,61,69326,1136.491803,1359743597054,1359743614782,164982426,165000154,17728
1359743624,165009408,46,46625,1013.586957,1359743597211,1359743614811,164982619,165000219,17600
1359743624,165009416,17,952,56,1359743597589,1359743622869,164983005,165008285,25280
1359743624,165009416,2,92,46,1359743597715,1359743597971,164983131,164983387,256
1359743624,165009504,78,91381,1171.551282,1359743596858,1359743619002,164982362,165004506,22144
1359743624,165009508,53,62716,1183.320755,1359743596918,1359743614646,164982426,165000154,17728
1359743624,165009508,66,82053,1243.227273,1359743596921,1359743614585,164982429,165000093,17664
1359743624,165009512,17,952,56,1359743597298,1359743622514,164982810,165008026,25216
1359743624,165009540,16,1536,96,1359743597590,1359743621334,164983130,165006874,23744
1359743624,165009548,9,1530,170,1359743597968,1359743619856,164983516,165005404,21888
1359743624,165009548,8,448,56,1359743598222,1359743621966,164983770,165007514,23744
1359743626,3098290424,2,98,49,1359743614816,1359743620000,3098279240,3098284424,5184
1359743626,3098290432,3,144,48,1359743619991,1359743625047,3098284423,3098289479,5056
1359743627,165012308,9,568,63.11111111,1359743615294,1359743620478,165000602,165005786,5184
1359743632,165017464,1,137,137,1359743604642,1359743604642,164990106,164990106,0
1359743636,165021632,4,1309,327.25,1359743609659,1359743609723,164995291,164995355,64
1359743636,165021668,3,758,252.6666667,1359743610710,1359743610774,164996378,164996442,64
1359743636,165021708,1,46,46,1359743608240,1359743608240,164993948,164993948,0
1359743636,165021708,1,46,46,1359743608240,1359743608240,164993948,164993948,0
1359743636,165021748,18,13648,758.2222222,1359743609609,1359743609865,164995357,164995613,256
1359743640,165025620,9,2592,288,1359743613061,1359743638405,164998681,165024025,25344
1359743643,165028252,2,92,46,1359743638581,1359743638581,165023833,165023833,0
1359743643,165028252,2,92,46,1359743638581,1359743638581,165023833,165023833,0
1359743643,165028252,2,92,46,1359743638581,1359743638581,165023833,165023833,0
1359743643,165028252,2,92,46,1359743638581,1359743638581,165023833,165023833,0
1359743643,165028252,2,92,46,1359743638645,1359743638645,165023897,165023897,0
1359743643,165028304,3,138,46,1359743638532,1359743638532,165023836,165023836,0
1359743643,165028304,3,138,46,1359743638532,1359743638596,165023836,165023900,64
1359743643,165028304,2,92,46,1359743638596,1359743638596,165023900,165023900,0
1359743643,165028304,3,138,46,1359743638596,1359743638660,165023900,165023964,64
1359743644,165029636,8,2192,274,1359743616247,1359743642423,165001883,165028059,26176
1359743644,165029836,2,180,90,1359743616240,1359743616304,165002076,165002140,64
1359743648,165033652,8,2021,252.625,1359743621927,1359743622439,165007579,165008091,512
1359743650,3098314424,3,144,48,1359743641822,1359743647070,3098306246,3098311494,5248
1359743651,165036248,9,568,63.11111111,1359743642299,1359743647547,165027547,165032795,5248
1359743651,165036296,3,138,46,1359743645578,1359743645642,165030874,165030938,64
1359743652,165037756,1,96,96,1359743625022,1359743625022,165010778,165010778,0
1359743656,165041760,1,46,46,1359743631036,1359743631036,165016796,165016796,0
1359743658,3098322128,4,224,56,1359743631369,1359743657865,3098295497,3098321993,26496
1359743658,3098322128,1,46,46,1359743631369,1359743631369,3098295497,3098295497,0
1359743658,3098322176,2,92,46,1359743631321,1359743631321,3098295497,3098295497,0
1359743658,3098322432,3,144,48,1359743651415,1359743657239,3098315847,3098321671,5824
1359743658,3098322452,5,236,47.2,1359743651714,1359743657474,3098316166,3098321926,5760
1359743659,165044224,2,98,49,1359743651923,1359743657555,165037147,165042779,5632
1359743659,165044228,10,620,62,1359743651981,1359743657741,165037209,165042969,5760
1359743659,165044228,2,98,49,1359743652239,1359743657551,165037467,165042779,5312
1359743659,165044284,2,98,49,1359743652184,1359743657496,165037468,165042780,5312
1359743659,165044284,2,98,49,1359743652184,1359743657496,165037468,165042780,5312
1359743659,165044284,12,2463,205.25,1359743652184,1359743657752,165037468,165043036,5568
1359743659,165044304,7,1068,152.5714286,1359743642243,1359743651203,165027547,165036507,8960
1359743664,165049664,1,46,46,1359743638169,1359743638169,165023833,165023833,0
1359743664,165049708,2,123,61.5,1359743639213,1359743639277,165024921,165024985,64
1359743664,165049708,1,77,77,1359743639214,1359743639214,165024922,165024922,0
1359743668,165053608,1,46,46,1359743642834,1359743642834,165028442,165028442,0
1359743668,165053620,2,123,61.5,1359743640327,1359743640327,165025947,165025947,0
1359743668,165053620,2,123,61.5,1359743640327,1359743640391,165025947,165026011,64
1359743668,165053620,1,77,77,1359743640327,1359743640327,165025947,165025947,0
1359743668,165053624,1,46,46,1359743643653,1359743643653,165029277,165029277,0
1359743668,165053660,11,4946,449.6363636,1359743641630,1359743659230,165027290,165044890,17600
1359743668,165053664,19,22692,1194.315789,1359743641691,1359743651803,165027355,165037467,10112
1359743668,165053692,1,46,46,1359743642813,1359743642813,165028505,165028505,0
1359743668,165053704,1,77,77,1359743640241,1359743640241,165025945,165025945,0
1359743668,165053704,1,77,77,1359743640241,1359743640241,165025945,165025945,0
1359743668,165053732,2,123,61.5,1359743641239,1359743641303,165026971,165027035,64
1359743668,165053736,1,767,767,1359743641618,1359743641618,165027354,165027354,0
1359743668,165053740,2,577,288.5,1359743641936,1359743641936,165027676,165027676,0
1359743670,3098334184,1,46,46,1359743645329,1359743645329,3098309513,3098309513,0
1359743670,3098334184,2,92,46,1359743645263,1359743645327,3098309447,3098309511,64
1359743672,165057664,2,92,46,1359743645145,1359743645145,165030809,165030809,0
1359743672,165057668,1,46,46,1359743645399,1359743645399,165031067,165031067,0
1359743672,165057668,1,46,46,1359743645463,1359743645463,165031131,165031131,0
1359743672,165057700,1,46,46,1359743646456,1359743646456,165032156,165032156,0
1359743672,165057728,6,764,127.3333333,1359743647195,1359743654555,165032923,165040283,7360
1359743672,165057732,1,137,137,1359743647253,1359743647253,165032985,165032985,0
1359743672,165057740,1,46,46,1359743643984,1359743643984,165029724,165029724,0
1359743672,165057744,1,46,46,1359743644553,1359743644553,165030297,165030297,0
1359743672,165057776,1,46,46,1359743645291,1359743645291,165031067,165031067,0
1359743676,165061656,9,1172,130.2222222,1359743651235,1359743656227,165036891,165041883,4992
1359743676,165061724,19,26444,1391.789474,1359743650974,1359743651742,165036698,165037466,768
1359743680,165065656,24,2304,96,1359743652450,1359743675810,165038106,165061466,23360
1359743680,165065732,5,1446,289.2,1359743651862,1359743656726,165037594,165042458,4864
1359743680,165065736,24,1344,56,1359743652051,1359743675219,165037787,165060955,23168
1359743680,165065736,24,1344,56,1359743652177,1359743675473,165037913,165061209,23296
1359743680,165065772,12,672,56,1359743653040,1359743674992,165038812,165060764,21952
1359743683,165068192,3,169,56.33333333,1359743676531,1359743676531,165061723,165061723,0
1359743683,165068192,4,215,53.75,1359743676594,1359743676594,165061786,165061786,0
1359743683,165068200,3,169,56.33333333,1359743675562,1359743675562,165060762,165060762,0
1359743683,165068248,3,169,56.33333333,1359743681532,1359743681532,165066780,165066780,0
1359743684,165069660,2,180,90,1359743656414,1359743656478,165042074,165042138,64
1359743686,3098350188,9,504,56,1359743659086,1359743676238,3098323274,3098340426,17152
1359743691,165076224,6,366,61,1359743684627,1359743684627,165069851,165069851,0
1359743691,165076224,7,412,58.85714286,1359743684627,1359743684627,165069851,165069851,0
1359743691,165076228,7,412,58.85714286,1359743685581,1359743685645,165070809,165070873,64
1359743691,165076228,7,412,58.85714286,1359743685581,1359743685645,165070809,165070873,64
1359743691,165076228,6,366,61,1359743685581,1359743685645,165070809,165070873,64
1359743691,165076236,8,458,57.25,1359743686599,1359743686727,165071835,165071963,128
1359743691,165076300,7,412,58.85714286,1359743685510,1359743685574,165070810,165070874,64
1359743691,165076300,7,412,58.85714286,1359743685510,1359743685574,165070810,165070874,64
1359743696,165081620,2,92,46,1359743668104,1359743668168,165053724,165053788,64
1359743696,165081704,1,46,46,1359743668084,1359743668084,165053788,165053788,0
1359743699,165084240,2,92,46,1359743694531,1359743694531,165079771,165079771,0
1359743699,165084292,3,138,46,1359743694476,1359743694540,165079768,165079832,64
1359743700,165085736,2,92,46,1359743672020,1359743672020,165057756,165057756,0
1359743700,165085744,3,604,201.3333333,1359743675274,1359743675530,165061018,165061274,256
1359743700,165085780,2,92,46,1359743672997,1359743672997,165058777,165058777,0
1359743700,165085812,1,46,46,1359743674055,1359743674055,165059867,165059867,0
1359743702,3098366140,2,92,46,1359743675258,1359743675258,3098339398,3098339398,0
1359743704,165089728,3,606,202,1359743679577,1359743679641,165065305,165065369,64
1359743707,165092268,2,92,46,1359743700518,1359743700518,165085786,165085786,0
1359743708,165093672,2,92,46,1359743683090,1359743683090,165068762,165068762,0
1359743708,165093756,1,46,46,1359743681982,1359743681982,165067738,165067738,0
1359743706,3098370488,1,46,46,1359743681953,1359743681953,3098346441,3098346441,0
1359743712,165097740,1,137,137,1359743687632,1359743687632,165073372,165073372,0
1359743724,165109720,7,4090,584.2857143,1359743696353,1359743708769,165082073,165094489,12416
1359743724,165109764,2,92,46,1359743697974,1359743698038,165083738,165083802,64
1359743736,165121696,8,4216,527,1359743708987,1359743709179,165094683,165094875,192
1359743736,165121696,92,92436,1004.73913,1359743708922,1359743710458,165094618,165096154,1536
1359743736,165121728,2,192,96,1359743710104,1359743710616,165095832,165096344,512
1359743736,165121732,1,56,56,1359743710167,1359743710167,165095899,165095899,0
1359743736,165121780,11,5054,459.4545455,1359743708711,1359743708839,165094491,165094619,128
1359743736,165121816,2,112,56,1359743709762,1359743710210,165095578,165096026,448
1359743736,165121816,2,112,56,1359743709888,1359743710336,165095704,165096152,448
1359743744,165129792,6,1098,183,1359743718938,1359743739610,165104730,165125402,20672
1359743748,165133668,7,1059,151.2857143,1359743722647,1359743723095,165108315,165108763,448
1359743752,165137700,2,92,46,1359743724855,1359743724855,165110555,165110555,0
1359743752,165137816,2,92,46,1359743725698,1359743725762,165111514,165111578,64
1359743752,165137828,1,137,137,1359743726901,1359743726901,165112729,165112729,0
1359743756,165141728,2,92,46,1359743729816,1359743729880,165115544,165115608,64
1359743756,165141728,1,46,46,1359743729816,1359743729816,165115544,165115544,0
1359743764,165149780,2,180,90,1359743736357,1359743736357,165122137,165122137,0
1359743771,165156348,3,138,46,1359743770262,1359743770262,165155610,165155610,0
1359743778,3098442460,3,144,48,1359743771390,1359743776766,3098435850,3098441226,5376
1359743779,165164300,3,144,48,1359743771654,1359743777222,165156954,165162522,5568
1359743779,165164304,8,522,65.25,1359743771907,1359743777219,165157211,165162523,5312
1359743779,165164304,3,144,48,1359743772032,1359743777216,165157336,165162520,5184
1359743779,165164376,2,94,47,1359743771577,1359743777145,165156953,165162521,5568
1359743779,165164388,4,205,51.25,1359743772142,1359743772142,165157530,165157530,0
1359743780,165165744,3,605,201.6666667,1359743755592,1359743755656,165141336,165141400,64
1359743783,3098447636,3,168,56,1359743770510,1359743781454,3098435146,3098446090,10944
1359743783,165168988,1,137,137,1359743763796,1359743763796,165149784,165149784,0
1359743783,165168988,53,51104,964.2264151,1359743770259,1359743781203,165156247,165167191,10944
1359743783,165168988,54,54833,1015.425926,1359743770323,1359743781203,165156311,165167191,10880
1359743783,165169016,67,69109,1031.477612,1359743770232,1359743781176,165156248,165167192,10944
1359743783,165169028,650,910393,1400.604615,1359743596206,1359743618798,164982234,165004826,22592
1359743784,165169100,4,384,96,1359743773005,1359743782029,165158105,165167129,9024
1359743784,165169132,4,907,226.75,1359743771438,1359743771886,165156570,165157018,448
1359743784,165169176,4,224,56,1359743771585,1359743781825,165156761,165167001,10240
1359743784,165169308,3,514,171.3333333,1359743771900,1359743772028,165157208,165157336,128
1359743784,165169468,2,92,46,1359743758107,1359743758107,165143575,165143575,0
1359743784,165169504,1267,1706112,1346.576164,1359743641208,1359743781688,165026712,165167192,140480
1359743784,165169560,1,46,46,1359743766978,1359743766978,165152538,165152538,0
1359743784,165169712,41,41215,1005.243902,1359743770602,1359743772202,165156314,165157914,1600
1359743784,165169712,52,55221,1061.942308,1359743770536,1359743772648,165156248,165158360,2112
1359743784,165169828,4,224,56,1359743770803,1359743781043,165156631,165166871,10240
1359743784,165169840,2,180,90,1359743776298,1359743776362,165162138,165162202,64
1359743784,165169876,2,112,56,1359743772551,1359743776647,165158427,165162523,4096
1359743784,165169912,11,3333,303,1359743772576,1359743773088,165158488,165159000,512
1359743784,165170000,2,92,46,1359743756553,1359743756617,165142553,165142617,64
1359743784,165170004,1,46,46,1359743771206,1359743771206,165157210,165157210,0
1359743784,165170004,3,629,209.6666667,1359743771205,1359743771397,165157209,165157401,192
1359743785,165170384,2,92,46,1359743767153,1359743767217,165152537,165152601,64
1359743787,165172236,4,554,138.5,1359743785091,1359743785091,165170327,165170327,0
1359743794,3098458448,3,144,48,1359743785290,1359743790346,3098449738,3098454794,5056
1359743795,165180324,9,568,63.11111111,1359743785774,1359743790830,165171098,165176154,5056
1359743795,165180372,2,98,49,1359743785534,1359743790782,165170906,165176154,5248
1359743795,165180372,2,94,47,1359743785534,1359743790782,165170906,165176154,5248
1359743802,3098466452,3,144,48,1359743792645,1359743798405,3098457097,3098462857,5760
1359743803,165188324,9,568,63.11111111,1359743793068,1359743798892,165178392,165184216,5824
1359743803,165188396,3,144,48,1359743792803,1359743797795,165178199,165183191,4992
1359743803,165188396,2,94,47,1359743792803,1359743797795,165178199,165183191,4992
1359743813,165198156,6,1490,248.3333333,1359743786132,1359743794004,165171288,165179160,7872
1359743813,165198280,3,168,56,1359743784983,1359743796311,165170263,165181591,11328
1359743813,165198292,8,1120,140,1359743785420,1359743793100,165170712,165178392,7680
1359743820,165206064,1,56,56,1359743794311,1359743794311,165180375,165180375,0
1359743820,165206068,3,492,164,1359743794627,1359743794691,165180695,165180759,64
1359743821,165206148,3,168,56,1359743794974,1359743798046,165180122,165183194,3072
1359743821,165206228,1,137,137,1359743796429,1359743796429,165181657,165181657,0
1359743821,165206240,3,288,96,1359743794818,1359743798978,165180058,165184218,4160
1359743822,3098486272,1,56,56,1359743795385,1359743795385,3098459657,3098459657,0
1359743826,3098490556,4,190,47.5,1359743816671,1359743822495,3098481227,3098487051,5824
1359743827,165212328,9,568,63.11111111,1359743817255,1359743823015,165202583,165208343,5760
1359743827,165212364,2,92,46,1359743825027,1359743825027,165210391,165210391,0
1359743827,165212368,3,169,56.33333333,1359743825022,1359743825022,165210390,165210390,0
1359743827,165212368,2,92,46,1359743826049,1359743826049,165211417,165211417,0
1359743827,165212404,2,94,47,1359743816926,1359743821982,165202330,165207386,5056
1359743827,165212404,3,144,48,1359743816926,1359743821982,165202330,165207386,5056
1359743835,165220336,3,144,48,1359743824606,1359743830110,165209942,165215446,5504
1359743842,3098506560,3,144,48,1359743830874,1359743835930,3098495434,3098500490,5056
1359743843,165228364,9,568,63.11111111,1359743831365,1359743836485,165216729,165221849,5120
1359743843,165228416,2,98,49,1359743831121,1359743836369,165216537,165221785,5248
1359743843,165228416,2,94,47,1359743831120,1359743836432,165216536,165221848,5312
1359743845,165230132,8,1848,231,1359743817454,1359743831662,165202586,165216794,14208
1359743845,165230152,4,1154,288.5,1359743817432,1359743831704,165202584,165216856,14272
1359743845,165230156,6,1491,248.5,1359743817620,1359743832084,165202776,165217240,14464
1359743845,165230236,2,180,90,1359743816902,1359743816966,165202138,165202202,64
1359743845,165230240,4,1622,405.5,1359743817150,1359743831358,165202390,165216598,14208
1359743849,165234260,7,1245,177.8571429,1359743823915,1359743824299,165209175,165209559,384
1359743861,165246200,6,1956,326,1359743835430,1359743846950,165220630,165232150,11520
1359743865,165250292,1,137,137,1359743840270,1359743840270,165225562,165225562,0
1359743875,165260380,2,94,47,1359743869557,1359743874869,165254937,165260249,5312
1359743875,165260456,2,98,49,1359743869480,1359743874792,165254936,165260248,5312
1359743875,165260456,7,476,68,1359743869735,1359743874791,165255191,165260247,5056
1359743882,3098546604,4,190,47.5,1359743869227,1359743874283,3098533831,3098538887,5056
1359743885,165270220,2,180,90,1359743856914,1359743856978,165242134,165242198,64
1359743889,165274232,10,3761,376.1,1359743864265,1359743879369,165249497,165264601,15104
1359743890,3098554584,3,144,48,1359743883137,1359743888321,3098547721,3098552905,5184
1359743891,165276372,2,94,47,1359743883514,1359743888890,165268886,165274262,5376
1359743891,165276376,9,568,63.11111111,1359743883703,1359743888887,165269079,165274263,5184
1359743891,165276448,3,144,48,1359743883438,1359743888750,165268886,165274198,5312
1359743897,165282196,1,416,416,1359743869162,1359743869162,165254358,165254358,0
1359743897,165282204,1,228,228,1359743869731,1359743869731,165254935,165254935,0
1359743897,165282288,13,2090,160.7692308,1359743869520,1359743896336,165254808,165281624,26816
1359743897,165282288,3,138,46,1359743869774,1359743869838,165255062,165255126,64
1359743897,165282308,9,2236,248.4444444,1359743870011,1359743896571,165255319,165281879,26560
1359743898,3098562584,4,190,47.5,1359743891522,1359743897410,3098556106,3098561994,5888
1359743899,165284372,5,393,78.6,1359743896762,1359743896826,165282134,165282198,64
1359743899,165284388,2,94,47,1359743891883,1359743897835,165277271,165283223,5952
1359743899,165284388,8,522,65.25,1359743892074,1359743897834,165277462,165283222,5760
1359743899,165284464,2,98,49,1359743891809,1359743897761,165277273,165283225,5952
1359743901,165286212,1,137,137,1359743872986,1359743872986,165258198,165258198,0
1359743907,165292380,7,444,63.42857143,1359743896885,1359743904053,165282265,165289433,7168
1359743913,165298220,3,168,56,1359743885908,1359743898068,165271128,165283288,12160
1359743913,165298264,2,92,46,1359743887975,1359743887975,165273239,165273239,0
1359743913,165298304,2,112,56,1359743885503,1359743897919,165270807,165283223,12416
1359743913,165298376,3,168,56,1359743887864,1359743898040,165273240,165283416,10176
1359743914,3098578584,3,144,48,1359743905923,1359743910979,3098570507,3098575563,5056
1359743915,165300400,9,568,63.11111111,1359743906397,1359743911517,165291797,165296917,5120
1359743915,165300400,2,98,49,1359743906205,1359743911517,165291605,165296917,5312
1359743915,165300472,2,94,47,1359743906198,1359743911446,165291670,165296918,5248
1359743917,165302220,3,288,96,1359743888980,1359743898452,165274200,165283672,9472
1359743917,165302220,1,46,46,1359743889042,1359743889042,165274262,165274262,0
1359743918,3098582456,1,56,56,1359743890690,1359743890690,3098555146,3098555146,0
1359743925,165310220,4,1398,349.5,1359743896913,1359743907217,165282133,165292437,10304
1359743925,165310220,1,46,46,1359743896979,1359743896979,165282199,165282199,0
1359743925,165310308,10,1789,178.9,1359743896892,1359743897148,165282200,165282456,256
1359743931,165316492,2,98,49,1359743925572,1359743930628,165311064,165316120,5056
1359743933,165318388,4,924,231,1359743906411,1359743927723,165291799,165313111,21312
1359743937,165322364,1,137,137,1359743910785,1359743910785,165296149,165296149,0
1359743938,3098602604,3,144,48,1359743927150,1359743933166,3098591754,3098597770,6016
1359743939,165324428,3,144,48,1359743927425,1359743932673,165312853,165318101,5248
1359743939,165324436,8,522,65.25,1359743927677,1359743933693,165313113,165319129,6016
1359743939,165324476,2,94,47,1359743927378,1359743932626,165312854,165318102,5248
1359743945,165330444,6,1960,326.6666667,1359743918324,1359743935348,165303768,165320792,17024
1359743947,165332480,3,144,48,1359743935248,1359743940304,165320728,165325784,5056
1359743949,165334600,7,1231,175.8571429,1359743924758,1359743925142,165310358,165310742,384
1359743953,165338560,3,319,106.3333333,1359743927295,1359743927359,165312855,165312919,64
1359743953,165338560,4,372,93,1359743927294,1359743927358,165312854,165312918,64
1359743953,165338560,4,372,93,1359743927293,1359743927357,165312853,165312917,64
1359743953,165338644,5,424,84.8,1359743927210,1359743927274,165312854,165312918,64
1359743953,165338644,1,763,763,1359743927274,1359743927274,165312918,165312918,0
1359743953,165338644,4,378,94.5,1359743927209,1359743927273,165312853,165312917,64
1359743953,165338664,2,577,288.5,1359743927509,1359743927509,165313173,165313173,0
1359743953,165338668,3,745,248.3333333,1359743927699,1359743927955,165313367,165313623,256
1359743961,165346572,2,180,90,1359743936628,1359743936692,165322200,165322264,64
1359743973,165358524,1,137,137,1359743947553,1359743947553,165333077,165333077,0
1359743981,165366628,3,606,202,1359743955068,1359743955132,165340696,165340760,64
1359744001,165386748,2,180,90,1359743976449,1359743976513,165362197,165362261,64
1359744003,165388456,9,711,79,1359744001573,1359744001829,165387029,165387285,256
1359744003,165388496,3,144,48,1359743991741,1359743996797,165377237,165382293,5056
1359744003,165388508,11,3023,274.8181818,1359744001264,1359744001584,165386772,165387092,320
1359744009,165394736,1,137,137,1359743982159,1359743982159,165367895,165367895,0
1359744011,165396432,9,568,63.11111111,1359744001276,1359744006908,165386708,165392340,5632
1359744011,165396432,9,3693,410.3333333,1359744001276,1359744006908,165386708,165392340,5632
1359744011,165396444,2,92,46,1359744001970,1359744008050,165387414,165393494,6080
1359744011,165396444,2,92,46,1359744001969,1359744008049,165387413,165393493,6080
1359744011,165396448,2,92,46,1359744002223,1359744008047,165387671,165393495,5824
1359744011,165396448,2,92,46,1359744002223,1359744008047,165387671,165393495,5824
1359744011,165396484,9,2296,255.1111111,1359744001035,1359744006859,165386519,165392343,5824
1359744011,165396488,8,544,68,1359744001222,1359744006854,165386710,165392342,5632
1359744011,165396516,2,92,46,1359744001898,1359744007978,165387414,165393494,6080
1359744011,165396520,2,92,46,1359744002151,1359744007975,165387671,165393495,5824
1359744017,165402784,9,4360,484.4444444,1359743991388,1359744011484,165377172,165397268,20096
1359744025,165410680,95,77248,813.1368421,1359743999623,1359744001863,165385303,165387543,2240
1359744025,165410708,24,19006,791.9166667,1359744000424,1359744001064,165386132,165386772,640
1359744025,165410708,6,336,56,1359744000488,1359744016808,165386196,165402516,16320
1359744025,165410712,6,336,56,1359744000615,1359744017319,165386327,165403031,16704
1359744025,165410792,56,50861,908.2321429,1359744000021,1359744001941,165385813,165387733,1920
1359744025,165410792,65,30206,464.7076923,1359744000021,1359744001749,165385813,165387541,1728
1359744025,165410792,47,39070,831.2765957,1359744000020,1359744001748,165385812,165387540,1728
1359744025,165410796,12,3890,324.1666667,1359744000338,1359744001298,165386134,165387094,960
1359744026,3098690460,4,224,56,1359744000318,1359744021566,3098664778,3098686026,21248
1359744029,165414644,8,4750,593.75,1359744000875,1359744001835,165386519,165387479,960
1359744029,165414656,14,5312,379.4285714,1359744001502,1359744002206,165387158,165387862,704
1359744029,165414696,3,750,250,1359744004214,1359744004534,165389910,165390230,320
1359744029,165414768,6,576,96,1359744001901,1359744017581,165387669,165403349,15680
1359744029,165414772,3,168,56,1359744002091,1359744016683,165387863,165402455,14592
1359744029,165414776,3,388,129.3333333,1359744002215,1359744002535,165387991,165388311,320
1359744035,165420472,17,4086,240.3529412,1359744034262,1359744034454,165419734,165419926,192
1359744035,165420544,6,1843,307.1666667,1359744033806,1359744033998,165419350,165419542,192
1359744035,165420548,3,144,48,1359744034121,1359744034185,165419669,165419733,64
1359744035,165420552,2,98,49,1359744034373,1359744034501,165419925,165420053,128
1359744041,165426788,3,292,97.33333333,1359744016408,1359744016472,165402196,165402260,64
1359744042,3098706584,3,144,48,1359744033091,1359744038275,3098697675,3098702859,5184
1359744043,165428480,2,94,47,1359744033100,1359744038732,165418580,165424212,5632
1359744043,165428484,9,2298,255.3333333,1359744033544,1359744038728,165419028,165424212,5184
1359744043,165428492,10,3058,305.8,1359744033984,1359744039744,165419476,165425236,5760
1359744043,165428500,11,5700,518.1818182,1359744034298,1359744039738,165419798,165425238,5440
1359744043,165428536,3,138,46,1359744040661,1359744040725,165426197,165426261,64
1359744043,165428564,3,144,48,1359744033147,1359744038651,165418711,165424215,5504
1359744043,165428564,2,98,49,1359744033337,1359744038649,165418901,165424213,5312
1359744043,165428568,17,4593,270.1764706,1359744033653,1359744039669,165419221,165425237,6016
1359744043,165428572,6,1065,177.5,1359744033841,1359744036209,165419413,165421781,2368
1359744049,165434716,1,137,137,1359744021667,1359744021667,165407383,165407383,0
1359744051,165436468,23,10676,464.173913,1359744034010,1359744049498,165419478,165434966,15488
1359744053,165438820,3,606,202,1359744028216,1359744028280,165414036,165414100,64
1359744057,165442912,11,7849,713.5454545,1359744032411,1359744032987,165418323,165418899,576
1359744061,165446624,3,168,56,1359744032891,1359744038843,165418515,165424467,5952
1359744061,165446628,3,514,171.3333333,1359744033272,1359744033336,165418900,165418964,64
1359744061,165446632,3,514,171.3333333,1359744033271,1359744033399,165418903,165419031,128
1359744061,165446636,13,3861,297,1359744033583,1359744034031,165419219,165419667,448
1359744061,165446636,9,2657,295.2222222,1359744033712,1359744033904,165419348,165419540,192
1359744061,165446636,2,112,56,1359744035248,1359744039536,165420884,165425172,4288
1359744061,165446676,9,5354,594.8888889,1359744034058,1359744034378,165419734,165420054,320
1359744061,165446708,3,288,96,1359744034602,1359744040490,165420310,165426198,5888
1359744061,165446716,9,3703,411.4444444,1359744032993,1359744033249,165418709,165418965,256
1359744061,165446716,4,1509,377.25,1359744032993,1359744033121,165418709,165418837,128
1359744061,165446716,5,1724,344.8,1359744032993,1359744033441,165418709,165419157,448
1359744061,165446716,2,112,56,1359744034721,1359744042465,165420437,165428181,7744
1359744061,165446716,5,956,191.2,1359744032992,1359744033248,165418708,165418964,256
1359744061,165446720,3,514,171.3333333,1359744033182,1359744033310,165418902,165419030,128
1359744061,165446720,3,878,292.6666667,1359744033180,1359744033308,165418900,165419028,128
1359744061,165446724,5,606,121.2,1359744033175,1359744033431,165418899,165419155,256
1359744061,165446748,14,10173,726.6428571,1359744033536,1359744033856,165419284,165419604,320
1359744061,165446788,12,3060,255,1359744034267,1359744034459,165420055,165420247,192
1359744061,165446792,3,745,248.3333333,1359744034515,1359744034835,165420307,165420627,320
1359744066,3098730672,1,56,56,1359744038186,1359744038186,3098702858,3098702858,0
1359744069,165454680,2,92,46,1359744042502,1359744042502,165428182,165428182,0
1359744069,165454800,1,46,46,1359744042381,1359744042381,165428181,165428181,0
1359744073,165458724,2,123,61.5,1359744045785,1359744045849,165431509,165431573,64
1359744081,165466844,2,180,90,1359744056418,1359744056482,165442262,165442326,64
1359744089,165474704,1,137,137,1359744063018,1359744063018,165448722,165448722,0
1359744093,165478812,6,1097,182.8333333,1359744067969,1359744086849,165453781,165472661,18880
1359744099,165484532,4,215,53.75,1359744079002,1359744098714,165464534,165484246,19712
1359744099,165484532,2,123,61.5,1359744098712,1359744098712,165484244,165484244,0
1359744099,165484532,3,169,56.33333333,1359744098711,1359744098711,165484243,165484243,0
1359744099,165484532,2,123,61.5,1359744098711,1359744098711,165484243,165484243,0
1359744099,165484532,2,92,46,1359744098711,1359744098711,165484243,165484243,0
1359744099,165484532,4,215,53.75,1359744098711,1359744098775,165484243,165484307,64
1359744099,165484536,4,205,51.25,1359744098707,1359744098707,165484243,165484243,0
1359744099,165484540,123,138073,1122.544715,1359744000272,1359744098704,165385812,165484244,98432
1359744099,165484540,9,1129,125.4444444,1359744096720,1359744098704,165482260,165484244,1984
1359744099,165484540,187,193710,1035.882353,1359744000272,1359744098704,165385812,165484244,98432
1359744099,165484544,152,189199,1244.730263,1359744032782,1359744098702,165418326,165484246,65920
1359744099,165484544,4,215,53.75,1359744090957,1359744098701,165476501,165484245,7744
1359744099,165484548,622,429800,690.9967846,1359743784778,1359744098762,165170326,165484310,313984
1359744099,165484572,3,169,56.33333333,1359744077936,1359744098672,165463508,165484244,20736
1359744099,165484580,4,215,53.75,1359744078951,1359744098663,165464531,165484243,19712
1359744099,165484584,3,144,48,1359744098596,1359744098660,165484180,165484244,64
1359744099,165484584,3,159,53,1359744098659,1359744098659,165484243,165484243,0
1359744099,165484588,2,92,46,1359744098658,1359744098658,165484246,165484246,0
1359744099,165484588,3,169,56.33333333,1359744098657,1359744098657,165484245,165484245,0
1359744099,165484616,4,272,68,1359744096646,1359744098118,165482262,165483734,1472
1359744115,165500500,2,92,46,1359744101750,1359744107766,165487250,165493266,6016
1359744122,165507148,1,137,137,1359744095130,1359744095130,165480278,165480278,0
1359744122,165507160,7,1257,179.5714286,1359744096714,1359744098634,165481874,165483794,1920
1359744125,165511028,1,46,46,1359744098471,1359744098471,165484499,165484499,0
1359744125,165511092,1,46,46,1359744098153,1359744098153,165484245,165484245,0
1359744125,165511092,1,46,46,1359744098153,1359744098153,165484245,165484245,0
1359744125,165511092,1,46,46,1359744098153,1359744098153,165484245,165484245,0
1359744125,165511092,2,92,46,1359744098153,1359744098217,165484245,165484309,64
1359744125,165511092,1,46,46,1359744098153,1359744098153,165484245,165484245,0
1359744125,165511092,1,46,46,1359744098153,1359744098153,165484245,165484245,0
1359744125,165511092,1,46,46,1359744098216,1359744098216,165484308,165484308,0
1359744126,165511148,1,46,46,1359744099802,1359744099802,165484950,165484950,0
1359744126,165511212,1,46,46,1359744099034,1359744099034,165484246,165484246,0
1359744126,165511212,1,46,46,1359744099034,1359744099034,165484246,165484246,0
1359744126,165511212,2,92,46,1359744099033,1359744099097,165484245,165484309,64
1359744126,165511216,2,92,46,1359744099029,1359744099029,165484245,165484245,0
1359744131,165516588,2,92,46,1359744117664,1359744127648,165503252,165513236,9984
1359744139,165524608,4,1246,311.5,1359744137098,1359744137930,165522706,165523538,832
1359744165,165551048,4,1600,400,1359744138513,1359744153169,165524561,165539217,14656
1359744165,165551048,1,46,46,1359744137170,1359744137170,165523218,165523218,0
1359744198,165583324,1,400,400,1359744170661,1359744170661,165555985,165555985,0
1359744230,165615368,1,400,400,1359744204089,1359744204089,165589457,165589457,0
1359745321,166706164,1,56,56,1359745294903,1359745294903,166680067,166680067,0
1359745589,166974728,1,46,46,1359745561982,1359745561982,166947710,166947710,0
1359746676,168061724,1,46,46,1359746649457,1359746649457,168035181,168035181,0
1359747145,168530780,1,46,46,1359747119729,1359747119729,168505509,168505509,0
1359747269,168654904,1,46,46,1359747244274,1359747244274,168630178,168630178,0
1359747711,169096216,1,60,60,1359747686172,1359747686172,169071388,169071388,0
1359747995,169380692,1,48,48,1359747969790,1359747969790,169355482,169355482,0
1359748197,169583000,1,46,46,1359748170183,1359748170183,169556183,169556183,0
1359749150,170535744,2,122,61,1359749122742,1359749124854,170508486,170510598,2112
1359749150,170535820,1,46,46,1359749122092,1359749122092,170507912,170507912,0
1359751599,172984196,1,46,46,1359751573366,1359751573366,172958562,172958562,0
1359751948,173333688,1,46,46,1359751921477,1359751921477,173307165,173307165,0
1359751948,173333720,1,46,46,1359751921507,1359751921507,173307227,173307227,0
1359751948,173333756,1,46,46,1359751921471,1359751921471,173307227,173307227,0
1359751949,173334480,1,46,46,1359751921685,1359751921685,173307165,173307165,0
1359751949,173334592,1,46,46,1359751921637,1359751921637,173307229,173307229,0
1359752472,173857260,1,46,46,1359752444391,1359752444391,173829651,173829651,0
1359752625,174010292,1,46,46,1359752599687,1359752599687,173984979,173984979,0
1359752853,174238996,1,46,46,1359752825794,1359752825794,174211790,174211790,0
1359752934,174319224,1,46,46,1359752907525,1359752907525,174292749,174292749,0
1359753019,174404384,1,64,64,1359752992100,1359752992100,174377484,174377484,0
1359753055,3107719212,1,48,48,1359753025714,1359753025714,3107689926,3107689926,0
1359754625,176010252,4,190,47.5,1359754602256,1359754623248,175987508,176008500,20992
1359758963,3113627468,1,46,46,1359758935258,1359758935258,3113599726,3113599726,0
1359759358,180743952,1,48,48,1359759327881,1359759327881,180713833,180713833,0
1359760553,181938880,1,64,64,1359760528257,1359760528257,181914137,181914137,0
1359761758,183143920,1,46,46,1359761731527,1359761731527,183117447,183117447,0
1359762526,183911760,2,92,46,1359762498780,1359762501788,183884540,183887548,3008
1359763709,185094044,1,46,46,1359763683923,1359763683923,185068967,185068967,0
1359765232,186617436,1,46,46,1359765204407,1359765204407,186589843,186589843,0
1359766321,187706636,1,78,78,1359766295326,1359766295326,187680962,187680962,0
1359766790,188175316,1,86,86,1359766762198,1359766762198,188147514,188147514,0
1359767443,188828544,1,60,60,1359767418344,1359767418344,188803888,188803888,0
1359767656,189041244,1,60,60,1359767629072,1359767629072,189014316,189014316,0
1359767788,189173580,1,60,60,1359767761085,1359767761085,189146665,189146665,0
1359767788,189173668,1,46,46,1359767760934,1359767760934,189146602,189146602,0
1359767824,189209760,1,60,60,1359767797899,1359767797899,189183659,189183659,0
1359767840,189225688,1,60,60,1359767812304,1359767812304,189197992,189197992,0
1359767900,189285824,1,60,60,1359767875335,1359767875335,189261159,189261159,0
1359770020,191405948,1,58,58,1359769992494,1359769992494,191378442,191378442,0
1359770049,191434216,4,192,48,1359770022536,1359770044552,191407752,191429768,22016
1359770125,191510196,1,48,48,1359770097434,1359770097434,191482630,191482630,0
1359772657,194042996,1,46,46,1359772628755,1359772628755,194014751,194014751,0
1359772658,194043044,1,46,46,1359772629774,1359772629774,194014818,194014818,0
1359772925,194310668,2,120,60,1359772898775,1359772901783,194284443,194287451,3008
1359775172,3129836228,1,48,48,1359775146228,1359775146228,3129810456,3129810456,0
1359775431,196816012,1,46,46,1359775404354,1359775404354,196789366,196789366,0
1359775544,196929952,1,64,64,1359775517013,1359775517013,196902965,196902965,0
1359776958,198343968,1,46,46,1359776930863,1359776930863,198316831,198316831,0
1359777018,198403124,1,46,46,1359776990012,1359776990012,198375136,198375136,0
1359777841,199226240,2,120,60,1359777816439,1359777819447,199201679,199204687,3008
1359781028,202413800,1,46,46,1359781002712,1359781002712,202388512,202388512,0
1359783366,204751592,2,96,48,1359783341062,1359783344006,204726654,204729598,2944
1359784001,205386876,1,46,46,1359783973022,1359783973022,205358898,205358898,0
1359784002,205387040,1,46,46,1359783973989,1359783973989,205359029,205359029,0
1359784003,205388292,1,46,46,1359783973672,1359783973672,205358964,205358964,0
1359784003,205388336,1,46,46,1359783973625,1359783973625,205358961,205358961,0
1359784003,205388372,1,46,46,1359783973655,1359783973655,205359027,205359027,0
1359784003,205388384,1,46,46,1359783973643,1359783973643,205359027,205359027,0
1359784003,205388460,1,46,46,1359783973631,1359783973631,205359091,205359091,0
1359784003,205388496,1,46,46,1359783973596,1359783973596,205359092,205359092,0
1359784003,205388532,1,46,46,1359783973561,1359783973561,205359093,205359093,0
1359784003,205388576,1,46,46,1359783973581,1359783973581,205359157,205359157,0
1359784003,205388584,1,46,46,1359783973570,1359783973570,205359154,205359154,0
1359784003,205388624,1,46,46,1359783973594,1359783973594,205359218,205359218,0
1359784003,205388656,1,46,46,1359783973562,1359783973562,205359218,205359218,0
1359785266,3139930524,1,404,404,1359785238604,1359785238604,3139903128,3139903128,0
1359785315,206700216,1,48,48,1359785289185,1359785289185,206674401,206674401,0
1359786141,207526048,1,46,46,1359786113594,1359786113594,207498642,207498642,0
1359786189,207574164,1,46,46,1359786161156,1359786161156,207546320,207546320,0
1359788683,210068720,1,56,56,1359788657141,1359788657141,210042861,210042861,0
1359788735,210120884,1,60,60,1359788708047,1359788708047,210093931,210093931,0
1359788888,210273360,1,46,46,1359788861274,1359788861274,210246634,210246634,0
1359789858,211243424,1,48,48,1359789830729,1359789830729,211216153,211216153,0
1359790736,212121908,1,60,60,1359790711320,1359790711320,212097228,212097228,0
1359792925,214310428,1,60,60,1359792900568,1359792900568,214285996,214285996,0
1359794136,215521028,1,48,48,1359794110935,1359794110935,215495963,215495963,0
1359794207,215592264,1,48,48,1359794180968,1359794180968,215566232,215566232,0
1359794580,215965076,1,48,48,1359794552477,1359794552477,215937553,215937553,0
1359795729,217114000,1,46,46,1359795703320,1359795703320,217088320,217088320,0
1359795729,217114080,1,46,46,1359795703306,1359795703306,217088386,217088386,0
1359795729,217114112,1,46,46,1359795703271,1359795703271,217088383,217088383,0
1359795729,217114124,1,46,46,1359795703325,1359795703325,217088449,217088449,0
1359795729,217114168,1,46,46,1359795703283,1359795703283,217088451,217088451,0
1359795729,217114492,1,46,46,1359795702765,1359795702765,217088257,217088257,0
1359795729,217114532,1,46,46,1359795702789,1359795702789,217088321,217088321,0
1359795730,217115088,1,46,46,1359795703168,1359795703168,217088256,217088256,0
1359795730,217115160,1,46,46,1359795703223,1359795703223,217088383,217088383,0
1359795730,217115356,1,46,46,1359795703159,1359795703159,217088515,217088515,0
1359796861,218246880,1,46,46,1359796834329,1359796834329,218220209,218220209,0
1359801847,223232840,1,46,46,1359801821875,1359801821875,223207715,223207715,0
1359801932,223317800,1,46,46,1359801904920,1359801904920,223290720,223290720,0
1359803178,224563244,1,48,48,1359803150258,1359803150258,224535502,224535502,0
1359804035,225420888,1,48,48,1359804006242,1359804006242,225392130,225392130,0
1359806630,228015176,5,250,50,1359806602051,1359806624003,227987227,228009179,21952
1359806674,228059184,1,48,48,1359806648442,1359806648442,228033626,228033626,0
1359806702,228087244,1,48,48,1359806677822,1359806677822,228063066,228063066,0
1359807326,228711020,1,46,46,1359807297042,1359807297042,228682062,228682062,0
1359807326,228711052,1,46,46,1359807297013,1359807297013,228682065,228682065,0
1359807326,228711092,1,46,46,1359807297037,1359807297037,228682129,228682129,0
1359807326,228711180,1,46,46,1359807297011,1359807297011,228682191,228682191,0
1359807326,228711216,1,46,46,1359807296977,1359807296977,228682193,228682193,0
1359807327,228712356,1,46,46,1359807296645,1359807296645,228682001,228682001,0
1359807327,228712396,1,46,46,1359807296605,1359807296605,228682001,228682001,0
1359807327,228712516,1,46,46,1359807296610,1359807296610,228682126,228682126,0
1359807327,228712560,1,46,46,1359807296570,1359807296570,228682130,228682130,0
1359807327,228712648,1,46,46,1359807296544,1359807296544,228682192,228682192,0
1359808067,229452552,1,46,46,1359808038966,1359808038966,229424518,229424518,0
1359808733,230118540,1,48,48,1359808705269,1359808705269,230090809,230090809,0
1359808750,230135204,1,64,64,1359808722053,1359808722053,230107257,230107257,0
1359810029,231414040,1,74,74,1359810003861,1359810003861,231388901,231388901,0
1359814627,236012624,1,60,60,1359814601737,1359814601737,235987361,235987361,0
1359814848,236233240,3,180,60,1359814822597,1359814831621,236207837,236216861,9024
1359814928,236313496,1,60,60,1359814900291,1359814900291,236285787,236285787,0
1359815483,236868004,1,48,48,1359815455209,1359815455209,236840213,236840213,0
1359815971,237356272,1,46,46,1359815944086,1359815944086,237329358,237329358,0
1359818124,239509392,4,202,50.5,1359818097852,1359818107580,239483244,239492972,9728
1359819147,240532508,1,46,46,1359819118202,1359819118202,240503710,240503710,0
1359819147,240532536,1,46,46,1359819118172,1359819118172,240503708,240503708,0
1359819148,240533468,1,46,46,1359819118113,1359819118113,240503581,240503581,0
1359819148,240533500,1,46,46,1359819118079,1359819118079,240503579,240503579,0
1359819148,240533512,1,46,46,1359819118132,1359819118132,240503644,240503644,0
1359819148,240533552,1,46,46,1359819118091,1359819118091,240503643,240503643,0
1359819148,240533664,1,46,46,1359819118042,1359819118042,240503706,240503706,0
1359819148,240533700,1,46,46,1359819118070,1359819118070,240503770,240503770,0
1359819148,240533712,1,46,46,1359819118059,1359819118059,240503771,240503771,0
1359819148,240533752,1,46,46,1359819118083,1359819118083,240503835,240503835,0
1359820890,242275336,2,122,61,1359820862090,1359820864074,242247426,242249410,1984
1359821539,242924200,1,48,48,1359821513033,1359821513033,242898233,242898233,0
1359821747,243132336,1,46,46,1359821721916,1359821721916,243107252,243107252,0
1359822910,244295080,1,46,46,1359822882413,1359822882413,244267493,244267493,0
1359823491,244876716,1,60,60,1359823466216,1359823466216,244851932,244851932,0
1359824915,246300136,3,144,48,1359824886869,1359824895829,246272005,246280965,8960
1359824939,246324184,1,48,48,1359824912357,1359824912357,246297541,246297541,0
1359825271,246656092,1,46,46,1359825244345,1359825244345,246629437,246629437,0
1359825869,247254148,1,46,46,1359825844603,1359825844603,247229751,247229751,0
1359826743,248127864,2,122,61,1359826715082,1359826717322,248099946,248102186,2240
1359827247,248632736,2,96,48,1359827222297,1359827225177,248608033,248610913,2880
1359829384,250769372,1,60,60,1359829356518,1359829356518,250741890,250741890,0
1359829829,251214764,1,46,46,1359829802068,1359829802068,251187832,251187832,0
1359830335,251719884,1,46,46,1359830308670,1359830308670,251693554,251693554,0
1359830392,251776860,1,46,46,1359830364116,1359830364116,251748976,251748976,0
1359830392,251776892,1,46,46,1359830364148,1359830364148,251749040,251749040,0
1359830392,251776936,1,46,46,1359830364106,1359830364106,251749042,251749042,0
1359830392,251777008,1,46,46,1359830364098,1359830364098,251749106,251749106,0
1359830392,251777044,1,46,46,1359830364060,1359830364060,251749104,251749104,0
1359830393,251777848,1,46,46,1359830364257,1359830364257,251749105,251749105,0
1359831257,252642212,1,56,56,1359831231655,1359831231655,252616867,252616867,0
1359832529,253913924,1,46,46,1359832500915,1359832500915,253885839,253885839,0
1359832926,254311352,1,46,46,1359832900802,1359832900802,254286154,254286154,0
1359833046,254431668,1,46,46,1359833021379,1359833021379,254407047,254407047,0
1359834861,256246372,1,48,48,1359834832976,1359834832976,256218348,256218348,0
1359836559,257944632,1,60,60,1359836531250,1359836531250,257916882,257916882,0
1359836872,258257796,1,48,48,1359836846922,1359836846922,258232718,258232718,0
1359837013,258398644,1,48,48,1359836984801,1359836984801,258370445,258370445,0
1359837381,258766256,1,48,48,1359837351134,1359837351134,258736390,258736390,0
1359837574,258959332,2,120,60,1359837545873,1359837548881,258931205,258934213,3008
1359837738,259123528,1,60,60,1359837711496,1359837711496,259097024,259097024,0
1359837766,259151648,1,60,60,1359837740879,1359837740879,259126527,259126527,0
1359837830,259215664,1,60,60,1359837804417,1359837804417,259190081,259190081,0
1359837842,259227740,1,60,60,1359837815221,1359837815221,259200961,259200961,0
1359838135,259520224,1,60,60,1359838109044,1359838109044,259494268,259494268,0
1359838914,3193578496,2,96,48,1359838888972,1359838891980,3193553468,3193556476,3008
1359841294,262679688,1,46,46,1359841269233,1359841269233,262654921,262654921,0
1359841326,262711748,1,48,48,1359841300214,1359841300214,262685962,262685962,0
1359841512,262897128,1,46,46,1359841484253,1359841484253,262869381,262869381,0
1359841513,262897924,1,46,46,1359841484397,1359841484397,262869321,262869321,0
1359841513,262897996,1,46,46,1359841484323,1359841484323,262869319,262869319,0
1359841513,262898032,1,46,46,1359841484350,1359841484350,262869382,262869382,0
1359841513,262898048,1,46,46,1359841484337,1359841484337,262869385,262869385,0
1359841513,262898112,1,46,46,1359841484334,1359841484334,262869446,262869446,0
1359841623,263008500,1,48,48,1359841597545,1359841597545,262983045,262983045,0
1359841627,263012612,1,46,46,1359841600251,1359841600251,262985863,262985863,0
1359843315,264700396,1,60,60,1359843289338,1359843289338,264674734,264674734,0
1359843319,264704484,1,60,60,1359843291874,1359843291874,264677358,264677358,0
1359843567,264952780,1,60,60,1359843541942,1359843541942,264927722,264927722,0
1359843572,264956796,1,46,46,1359843547148,1359843547148,264931944,264931944,0
1359843664,265049068,1,60,60,1359843636475,1359843636475,265021543,265021543,0
1359843708,265092980,1,60,60,1359843681490,1359843681490,265066470,265066470,0
1359843720,265105124,1,60,60,1359843694339,1359843694339,265079463,265079463,0
1359843844,265229188,1,60,60,1359843817022,1359843817022,265202210,265202210,0
1359844437,265822068,1,48,48,1359844408817,1359844408817,265793885,265793885,0
1359844655,266040156,1,64,64,1359844627989,1359844627989,266013145,266013145,0
1359846915,268300124,1,46,46,1359846887890,1359846887890,268273014,268273014,0
1359846915,268300236,1,46,46,1359846888225,1359846888225,268273461,268273461,0
1359846923,268308380,1,48,48,1359846895059,1359846895059,268280439,268280439,0
1359847261,268645780,1,52,52,1359847236133,1359847236133,268620913,268620913,0
1359847324,268709620,1,52,52,1359847295963,1359847295963,268681583,268681583,0
1359847946,269331276,1,60,60,1359847918824,1359847918824,269304100,269304100,0
1359848744,270128844,1,404,404,1359848719694,1359848719694,270104538,270104538,0
1359850531,271916620,1,46,46,1359850504235,1359850504235,271889855,271889855,0
1359850531,271916704,1,46,46,1359850504279,1359850504279,271889983,271889983,0
1359850868,272253072,1,48,48,1359850841610,1359850841610,272226682,272226682,0
1359850888,272273348,1,52,52,1359850863286,1359850863286,272248634,272248634,0
1359852702,274087216,1,46,46,1359852673950,1359852673950,274059166,274059166,0
1359852702,274087220,1,46,46,1359852673944,1359852673944,274059164,274059164,0
1359852702,274087300,1,46,46,1359852673929,1359852673929,274059229,274059229,0
1359852703,274088032,1,46,46,1359852674003,1359852674003,274059035,274059035,0
1359852703,274088076,1,46,46,1359852673962,1359852673962,274059038,274059038,0
1359852703,274088148,1,46,46,1359852673951,1359852673951,274059099,274059099,0
1359852703,274088184,1,46,46,1359852673980,1359852673980,274059164,274059164,0
1359852703,274088264,1,46,46,1359852673965,1359852673965,274059229,274059229,0
1359852729,274113932,1,48,48,1359852701369,1359852701369,274086301,274086301,0
1359852929,274314332,1,46,46,1359852900708,1359852900708,274286040,274286040,0
1359853250,274634812,1,60,60,1359853224359,1359853224359,274609171,274609171,0
1359853518,274903708,1,60,60,1359853492771,1359853492771,274878479,274878479,0
1359853543,274927976,1,60,60,1359853516225,1359853516225,274901201,274901201,0
1359853551,274935768,1,60,60,1359853523215,1359853523215,274907983,274907983,0
1359853663,275048008,1,60,60,1359853637084,1359853637084,275022092,275022092,0
1359853694,275079524,1,46,46,1359853664728,1359853664728,275050252,275050252,0
1359853739,275124452,1,78,78,1359853711586,1359853711586,275097038,275097038,0
1359853907,275292588,1,60,60,1359853880724,1359853880724,275266312,275266312,0
1359853922,275306824,1,48,48,1359853895378,1359853895378,275280202,275280202,0
1359856847,278231896,1,46,46,1359856819166,1359856819166,278204062,278204062,0
1359857489,278873924,1,48,48,1359857461368,1359857461368,278846292,278846292,0
1359858819,280204520,3,144,48,1359858793873,1359858803025,280179393,280188545,9152
1359860725,282109856,1,46,46,1359860697226,1359860697226,282082082,282082082,0
1359862401,283786012,1,48,48,1359862375443,1359862375443,283760455,283760455,0
1359864294,285679364,1,46,46,1359864266007,1359864266007,285651371,285651371,0
1359864294,285679376,1,46,46,1359864265994,1359864265994,285651370,285651370,0
1359864294,285679428,1,46,46,1359864266005,1359864266005,285651433,285651433,0
1359864295,285680316,1,46,46,1359864266185,1359864266185,285651501,285651501,0
1359864942,286327504,1,46,46,1359864914115,1359864914115,286299619,286299619,0
1359867814,289198940,1,46,46,1359867786312,1359867786312,289171252,289171252,0
1359869581,290965728,1,48,48,1359869553793,1359869553793,290938521,290938521,0
1359869581,290965764,1,46,46,1359869555228,1359869555228,290939992,290939992,0
1359871244,292629544,1,60,60,1359871216951,1359871216951,292602495,292602495,0
1359871251,292635900,1,48,48,1359871224060,1359871224060,292608960,292608960,0
1359872202,293587380,1,60,60,1359872175949,1359872175949,293561329,293561329,0
1359872335,293719772,1,60,60,1359872309034,1359872309034,293693806,293693806,0
1359872339,293723744,1,60,60,1359872312392,1359872312392,293697136,293697136,0
1359872363,293747720,1,60,60,1359872336991,1359872336991,293721711,293721711,0
1359872527,293911868,1,60,60,1359872499593,1359872499593,293884461,293884461,0
1359872787,294172280,1,46,46,1359872761385,1359872761385,294146665,294146665,0
1359874559,295943756,1,46,46,1359874530714,1359874530714,295915470,295915470,0
1359875127,296512640,1,46,46,1359875102044,1359875102044,296487684,296487684,0
1359875260,296644956,1,60,60,1359875232391,1359875232391,296617347,296617347,0
1359875508,296893564,1,404,404,1359875483233,1359875483233,296868797,296868797,0
1359875779,297164648,1,46,46,1359875751499,1359875751499,297137147,297137147,0
1359878143,299527804,1,46,46,1359878117554,1359878117554,299502358,299502358,0
1359879149,300534340,3,144,48,1359879121869,1359879131021,300507209,300516361,9152
1359879221,300606492,1,48,48,1359879196595,1359879196595,300582087,300582087,0
1359879314,300698824,1,46,46,1359879288078,1359879288078,300672902,300672902,0
1359879314,300698876,1,46,46,1359879286999,1359879286999,300671875,300671875,0
1359879446,300830892,1,46,46,1359879419719,1359879419719,300804611,300804611,0
1359879948,3234612476,1,48,48,1359879923115,1359879923115,3234587591,3234587591,0
1359880921,302306296,1,60,60,1359880895898,1359880895898,302281194,302281194,0
1359882108,303492776,1,46,46,1359882083282,1359882083282,303468058,303468058,0
1359882288,303673408,1,60,60,1359882262294,1359882262294,303647702,303647702,0
1359883856,305241252,1,48,48,1359883829789,1359883829789,305215041,305215041,0
1359884554,305939524,1,48,48,1359884526914,1359884526914,305912438,305912438,0
1359884731,306116320,1,46,46,1359884704011,1359884704011,306089331,306089331,0
1359886625,308010456,1,60,60,1359886599715,1359886599715,307985171,307985171,0
1359887190,308575512,1,46,46,1359887164964,1359887164964,308550476,308550476,0
1359887467,308852424,1,46,46,1359887440887,1359887440887,308826311,308826311,0
1359887467,308852460,1,46,46,1359887440915,1359887440915,308826375,308826375,0
1359887467,308852504,1,46,46,1359887440872,1359887440872,308826376,308826376,0
1359887468,308852972,1,46,46,1359887441341,1359887441341,308826313,308826313,0
1359887468,308852984,1,46,46,1359887441327,1359887441327,308826311,308826311,0
1359887468,308853100,1,46,46,1359887441341,1359887441341,308826441,308826441,0
1359888079,309464620,1,60,60,1359888052012,1359888052012,309437632,309437632,0
1359888172,309556684,1,52,52,1359888146639,1359888146639,309531323,309531323,0
1359888746,310131300,1,46,46,1359888718432,1359888718432,310103732,310103732,0
1359888925,3243589072,1,46,46,1359888897916,1359888897916,3243561988,3243561988,0
1359889358,310743060,7,372,53.14285714,1359889332295,1359889354183,310717355,310739243,21888
1359889394,310779300,2,96,48,1359889366230,1359889390358,310751530,310775658,24128
1359890732,312117040,1,48,48,1359890705349,1359890705349,312090389,312090389,0
1359891038,312423520,1,48,48,1359891008354,1359891008354,312393874,312393874,0
1359891576,312961024,1,46,46,1359891548679,1359891548679,312933703,312933703,0
1359892052,313437628,1,46,46,1359892026213,1359892026213,313411841,313411841,0
1359892317,313702084,1,46,46,1359892289987,1359892289987,313675071,313675071,0
1359892638,314023564,1,46,46,1359892611484,1359892611484,313997048,313997048,0
1359893224,314608816,1,46,46,1359893197182,1359893197182,314581998,314581998,0
1359893970,315355044,1,46,46,1359893942736,1359893942736,315327780,315327780,0
1359894616,316000864,1,46,46,1359894591354,1359894591354,315976218,315976218,0
1359894748,316133324,1,46,46,1359894721261,1359894721261,316106585,316106585,0
1359894925,316309708,1,46,46,1359894898450,1359894898450,316283158,316283158,0
1359895037,316422084,1,46,46,1359895011607,1359895011607,316396691,316396691,0
1359897446,318830868,1,71,71,1359897420300,1359897420300,318805168,318805168,0
1359898486,319870768,1,46,46,1359898458272,1359898458272,319843040,319843040,0
1359899519,320903672,1,404,404,1359899493296,1359899493296,320877968,320877968,0
1359900593,321977976,1,48,48,1359900567534,1359900567534,321952510,321952510,0
1359900656,322041420,1,60,60,1359900628083,1359900628083,322013503,322013503,0
1359900712,322097496,1,60,60,1359900685990,1359900685990,322071486,322071486,0
1359900906,322291536,1,48,48,1359900880379,1359900880379,322265915,322265915,0
1359900953,322337780,1,46,46,1359900927403,1359900927403,322312183,322312183,0
1359900977,322361652,1,60,60,1359900948975,1359900948975,322333627,322333627,0
1359901001,322385712,1,60,60,1359900975984,1359900975984,322360696,322360696,0
1359901061,322445844,1,60,60,1359901034797,1359901034797,322419641,322419641,0
1359902124,323509040,1,46,46,1359902099801,1359902099801,323484841,323484841,0
1359902385,323769724,1,60,60,1359902357392,1359902357392,323742116,323742116,0
1359904630,326014960,1,46,46,1359904604033,1359904604033,325988993,325988993,0
1359904853,326238552,1,46,46,1359904825516,1359904825516,326211068,326211068,0
1359905344,326728864,1,148,148,1359905319191,1359905319191,326704055,326704055,0
1359908295,329679600,1,148,148,1359908270833,1359908270833,329655433,329655433,0
1359908391,329775712,1,60,60,1359908364030,1359908364030,329748742,329748742,0
1359909061,330445988,1,46,46,1359909033315,1359909033315,330418303,330418303,0
1359909309,330694368,1,56,56,1359909281377,1359909281377,330666745,330666745,0
1359909446,330830820,1,60,60,1359909419204,1359909419204,330804024,330804024,0
1359909558,330942996,3,138,46,1359909532368,1359909532368,330917364,330917364,0
1359909747,331132340,1,46,46,1359909719736,1359909719736,331105076,331105076,0
1359909747,331132484,1,46,46,1359909719718,1359909719718,331105202,331105202,0
1359909748,331133164,1,46,46,1359909719974,1359909719974,331105138,331105138,0
1359909748,331133180,1,46,46,1359909719960,1359909719960,331105140,331105140,0
1359909748,331133216,1,46,46,1359909719924,1359909719924,331105140,331105140,0
1359909748,331133288,1,46,46,1359909719913,1359909719913,331105201,331105201,0
1359913232,334616776,1,46,46,1359913204470,1359913204470,334589246,334589246,0
1359913820,335205216,1,46,46,1359913792884,1359913792884,335178100,335178100,0
1359913998,335383212,1,48,48,1359913970548,1359913970548,335355760,335355760,0
1359914124,335509512,3,138,46,1359914096071,1359914096071,335481583,335481583,0
1359914201,335585780,2,122,61,1359914173025,1359914175329,335557805,335560109,2304
1359914317,335701916,1,60,60,1359914291608,1359914291608,335676524,335676524,0
1359914317,335701928,1,60,60,1359914292367,1359914292367,335677295,335677295,0
1359914449,335834436,1,60,60,1359914423696,1359914423696,335809132,335809132,0
1359914489,335874308,1,60,60,1359914461583,1359914461583,335846891,335846891,0
1359914553,335938424,1,60,60,1359914527578,1359914527578,335913002,335913002,0
1359914798,336182800,1,46,46,1359914771587,1359914771587,336156387,336156387,0
1359914818,336202692,1,60,60,1359914790834,1359914790834,336175526,336175526,0
1359914862,336246708,1,148,148,1359914834911,1359914834911,336219619,336219619,0
1359914994,336378772,1,60,60,1359914966240,1359914966240,336351012,336351012,0
1359915583,336968348,1,46,46,1359915558487,1359915558487,336943835,336943835,0
1359915587,336972260,1,46,46,1359915558957,1359915558957,336944217,336944217,0
1359916112,337497204,1,434,434,1359916086811,1359916086811,337472015,337472015,0
1359917637,339021820,1,48,48,1359917609671,1359917609671,338994491,338994491,0
1359918161,339546540,1,60,60,1359918136493,1359918136493,339522033,339522033,0
1359918847,340231648,1,148,148,1359918822240,1359918822240,340206888,340206888,0
1359920017,341402172,1,148,148,1359919991233,1359919991233,341376405,341376405,0
1359920025,341410136,1,148,148,1359920000549,1359920000549,341385685,341385685,0
1359920711,342095776,1,60,60,1359920685956,1359920685956,342070732,342070732,0
1359920802,342187028,1,48,48,1359920774087,1359920774087,342159115,342159115,0
1359920855,342239768,1,60,60,1359920829704,1359920829704,342214472,342214472,0
1359920972,342357256,1,48,48,1359920944863,1359920944863,342330119,342330119,0
1359921023,342408100,1,60,60,1359920997304,1359920997304,342382404,342382404,0
1359921428,342812740,1,46,46,1359921402908,1359921402908,342787648,342787648,0
1359921485,342870108,1,46,46,1359921456810,1359921456810,342841918,342841918,0
1359921486,342870860,1,46,46,1359921456995,1359921456995,342841855,342841855,0
1359922401,343786416,1,148,148,1359922374824,1359922374824,343760240,343760240,0
1359923063,344447632,1,60,60,1359923038639,1359923038639,344423271,344423271,0
1359923600,344985200,2,122,61,1359923575597,1359923578093,344960797,344963293,2496
1359924430,345815104,1,56,56,1359924403648,1359924403648,345788752,345788752,0
1359924748,346132668,1,48,48,1359924720174,1359924720174,346104842,346104842,0
1359924835,346220128,3,444,148,1359924809827,1359924822819,346194955,346207947,12992
1359924851,346236244,1,148,148,1359924825263,1359924825263,346210507,346210507,0
1359926009,347394356,2,106,53,1359925982382,1359925982382,347367738,347367738,0
1359926691,348076332,3,138,46,1359926665977,1359926665977,348051309,348051309,0
1359927384,3282047992,1,404,404,1359927355912,1359927355912,3282019904,3282019904,0
1359927566,348950652,1,56,56,1359927539667,1359927539667,348924319,348924319,0
1359927866,349251360,2,92,46,1359927841038,1359927841038,349226398,349226398,0
1359928071,349455512,1,172,172,1359928043799,1359928043799,349428311,349428311,0
1359928131,349515760,1,46,46,1359928103392,1359928103392,349488152,349488152,0
1359928476,349860728,1,46,46,1359928449468,1359928449468,349834196,349834196,0
1359929591,350976216,1,60,60,1359929564929,1359929564929,350950145,350950145,0
1359929684,351068620,1,60,60,1359929658324,1359929658324,351042944,351042944,0
1359930194,351578884,1,52,52,1359930168579,1359930168579,351553463,351553463,0
1359930254,351638984,1,52,52,1359930228129,1359930228129,351613113,351613113,0
1359931007,352391884,1,46,46,1359930979193,1359930979193,352364077,352364077,0
1359931850,353234504,1,48,48,1359931824553,1359931824553,353209057,353209057,0
1359932896,354281156,1,46,46,1359932869453,1359932869453,354254609,354254609,0
1359932896,354281192,1,46,46,1359932869414,1359932869414,354254606,354254606,0
1359932897,354282092,1,46,46,1359932869513,1359932869513,354254605,354254605,0
1359932897,354282204,1,46,46,1359932869466,1359932869466,354254670,354254670,0
1359933841,355225748,2,104,52,1359933816148,1359933821332,355200896,355206080,5184
1359934507,355892476,1,46,46,1359934479346,1359934479346,355864822,355864822,0
1359935195,356580012,2,122,61,1359935168247,1359935168567,356553259,356553579,320
1359935844,357229004,1,46,46,1359935818679,1359935818679,357203683,357203683,0
1359937890,359274520,1,60,60,1359937862075,1359937862075,359246595,359246595,0
1359937922,359306584,1,60,60,1359937895032,1359937895032,359279616,359279616,0
1359937982,359366628,2,120,60,1359937957645,1359937958605,359342273,359343233,960
1359938238,359622828,1,60,60,1359938212416,1359938212416,359597244,359597244,0
1359938238,359622916,1,60,60,1359938212583,1359938212583,359597499,359597499,0
1359939677,361062236,1,60,60,1359939650385,1359939650385,361035621,361035621,0
1359939746,361130624,1,46,46,1359939718646,1359939718646,361103270,361103270,0
1359939858,361243000,1,46,46,1359939833467,1359939833467,361218467,361218467,0
1359941121,362505544,1,46,46,1359941095154,1359941095154,362479698,362479698,0
1359941157,362541504,1,58,58,1359941128919,1359941128919,362513423,362513423,0
1359941355,362740040,1,48,48,1359941326843,1359941326843,362711883,362711883,0
1359941453,362837832,1,46,46,1359941424971,1359941424971,362809803,362809803,0
1359941898,363282508,2,92,46,1359941870282,1359941871498,363254790,363256006,1216
1359942565,363949668,1,64,64,1359942538846,1359942538846,363923514,363923514,0
1359943008,364392824,1,148,148,1359942981309,1359942981309,364366133,364366133,0
1359943104,364489000,1,60,60,1359943077962,1359943077962,364462962,364462962,0
1359944019,365404196,1,48,48,1359943991160,1359943991160,365376356,365376356,0
1359944131,365516084,2,92,46,1359944103141,1359944103589,365488225,365488673,448
1359944413,365798420,1,46,46,1359944387603,1359944387603,365773023,365773023,0
1359944937,366321792,1,46,46,1359944912254,1359944912254,366297046,366297046,0
1359945995,367380160,1,52,52,1359945968765,1359945968765,367353925,367353925,0
1359945995,367380300,1,52,52,1359945967665,1359945967665,367352965,367352965,0
1359946151,367536348,1,48,48,1359946123199,1359946123199,367508547,367508547,0
1359946829,368213928,1,46,46,1359946804182,1359946804182,368189110,368189110,0
1359947410,368794704,4,184,46,1359947383598,1359947384622,368768302,368769326,1024
1359949320,370704516,1,60,60,1359949293645,1359949293645,370678161,370678161,0
1359949436,370820604,1,60,60,1359949407986,1359949407986,370792590,370792590,0
1359949576,370960720,1,60,60,1359949549567,1359949549567,370934287,370934287,0
1359949592,370976704,1,60,60,1359949564622,1359949564622,370949326,370949326,0
1359949600,370984696,1,60,60,1359949572437,1359949572437,370957133,370957133,0
1359949616,371000736,2,296,148,1359949589932,1359949596396,370974668,370981132,6464
1359949636,371020772,1,148,148,1359949608906,1359949608906,370993678,370993678,0
1359949749,3304413152,1,48,48,1359949720317,1359949720317,3304384469,3304384469,0
1359953590,374974988,3,144,48,1359953564339,1359953573235,374949327,374958223,8896
1359956133,377517476,1,48,48,1359956114123,1359956114123,377498599,377498599,0
1359956133,377518416,1,46,46,1359956116193,1359956116193,377501609,377501609,0
1359956134,377518536,1,46,46,1359956117139,1359956117139,377501675,377501675,0
1359956136,377520944,1,46,46,1359956116663,1359956116663,377501607,377501607,0
1359956136,377520944,1,46,46,1359956116665,1359956116665,377501609,377501609,0
1359956361,377745852,2,96,48,1359956335442,1359956338450,377720294,377723302,3008
1359957720,379104560,3,138,46,1359957692640,1359957692640,379077200,379077200,0
1359958065,379449476,1,46,46,1359958036974,1359958036974,379421450,379421450,0
1359958357,379742288,2,96,48,1359958330303,1359958333311,379715591,379718599,3008
1359959211,380595652,1,46,46,1359959184812,1359959184812,380569464,380569464,0
1359959760,381144980,1,46,46,1359959733403,1359959733403,381118383,381118383,0
1359960506,381890956,1,46,46,1359960480425,1359960480425,381865381,381865381,0
1359961662,383046440,1,46,46,1359961633946,1359961633946,383018386,383018386,0
1359962719,384104228,1,46,46,1359962694841,1359962694841,384080069,384080069,0
1359962835,384220308,1,46,46,1359962809383,1359962809383,384194691,384194691,0
1359963048,384433100,1,60,60,1359963021811,1359963021811,384406911,384406911,0
1359963048,384433112,1,60,60,1359963022504,1359963022504,384407616,384407616,0
1359963048,384433312,1,60,60,1359963021727,1359963021727,384407039,384407039,0
1359963048,384433316,1,60,60,1359963022043,1359963022043,384407359,384407359,0
1359963048,384433352,1,60,60,1359963022584,1359963022584,384407936,384407936,0
1359963072,384457212,1,46,46,1359963044417,1359963044417,384429629,384429629,0
1359963177,384561568,1,60,60,1359963151620,1359963151620,384536188,384536188,0
1359963181,384565612,1,60,60,1359963155546,1359963155546,384540158,384540158,0
1359963181,384565808,1,60,60,1359963155478,1359963155478,384540286,384540286,0
1359963209,384593552,1,60,60,1359963183762,1359963183762,384568314,384568314,0
1359963277,384661648,1,60,60,1359963252722,1359963252722,384637370,384637370,0
1359964215,385599612,1,48,48,1359964188999,1359964188999,385573611,385573611,0
1359964716,386101036,1,60,60,1359964689305,1359964689305,386074341,386074341,0
1359965306,386691128,1,46,46,1359965278261,1359965278261,386663389,386663389,0
1359965880,387264552,1,46,46,1359965852265,1359965852265,387236817,387236817,0
1359966344,387728916,5,250,50,1359966316217,1359966337401,387701133,387722317,21184
1359966388,387773304,1,48,48,1359966361203,1359966361203,387746507,387746507,0
1359966416,387801340,1,48,48,1359966390349,1359966390349,387775689,387775689,0
1359966637,388021880,2,230,115,1359966611351,1359966611351,387996231,387996231,0
1359967074,388459140,2,122,61,1359967046922,1359967048970,388432062,388434110,2048
1359967447,388831468,3,138,46,1359967420326,1359967420326,388804794,388804794,0
1359967832,389217296,1,46,46,1359967803813,1359967803813,389189109,389189109,0
1359967832,389217332,1,46,46,1359967803778,1359967803778,389189110,389189110,0
1359967832,389217384,1,46,46,1359967803724,1359967803724,389189108,389189108,0
1359967833,389217476,1,46,46,1359967804762,1359967804762,389189238,389189238,0
1359967833,389217680,1,46,46,1359967804490,1359967804490,389189170,389189170,0
1359967833,389217688,1,46,46,1359967804485,1359967804485,389189173,389189173,0
1359968319,389704152,1,46,46,1359968290475,1359968290475,389675627,389675627,0
1359969708,391092372,1,46,46,1359969681636,1359969681636,391066008,391066008,0
1359970064,391448688,1,48,48,1359970037218,1359970037218,391421906,391421906,0
1359971210,392595264,1,46,46,1359971182286,1359971182286,392567550,392567550,0
1359972359,393744332,1,46,46,1359972331707,1359972331707,393717039,393717039,0
1359973567,394951840,1,46,46,1359973542163,1359973542163,394927003,394927003,0
1359973739,395123508,1,46,46,1359973711070,1359973711070,395095578,395095578,0
1359974957,396342316,1,46,46,1359974930595,1359974930595,396315911,396315911,0
1359975230,396615204,1,46,46,1359975202127,1359975202127,396587331,396587331,0
1359975567,396952024,1,46,46,1359975541179,1359975541179,396926203,396926203,0
1359978152,399537144,1,46,46,1359978125918,1359978125918,399511062,399511062,0
1359978445,399830400,1,46,46,1359978417818,1359978417818,399803218,399803218,0
1359979296,400680952,1,46,46,1359979267210,1359979267210,400652162,400652162,0
1359979296,400680992,1,46,46,1359979267233,1359979267233,400652225,400652225,0
1359979296,400681104,1,46,46,1359979267188,1359979267188,400652292,400652292,0
1359979297,400681948,1,46,46,1359979267277,1359979267277,400652225,400652225,0
1359979297,400682016,1,46,46,1359979267274,1359979267274,400652290,400652290,0
1359979297,400682100,1,46,46,1359979267255,1359979267255,400652355,400652355,0
1359979297,400682144,1,46,46,1359979267210,1359979267210,400652354,400652354,0
1359979507,400892320,1,439,439,1359979482008,1359979482008,400867328,400867328,0
1359980846,402230756,1,444,444,1359980821433,1359980821433,402206189,402206189,0
1359981519,402904152,1,56,56,1359981491744,1359981491744,402876896,402876896,0
1359982689,404074028,1,46,46,1359982661900,1359982661900,404046928,404046928,0
1359982986,404370804,3,156,52,1359982960359,1359982969319,404345163,404354123,8960
1359999083,420467456,5,250,50,1359999056646,1359999078342,420441102,420462798,21696
1359999127,420511540,1,48,48,1359999102771,1359999102771,420487311,420487311,0
1359999159,420543608,1,48,48,1359999132272,1359999132272,420516880,420516880,0
1359999696,421081164,1,46,46,1359999668536,1359999668536,421053700,421053700,0
1360001016,3355679460,6,455,75.83333333,1360001011137,1360001011201,3355674597,3355674661,64
1360001027,422412220,6,632,105.3333333,1360001006766,1360001022062,422391986,422407282,15296
1360001027,422412232,3,144,48,1360001020835,1360001026787,422406067,422412019,5952
1360001032,3355695436,2,98,49,1360001021464,1360001026712,3355684900,3355690148,5248
1360001032,3355695436,2,98,49,1360001021464,1360001026712,3355684900,3355690148,5248
1360001032,3355695436,3,150,50,1360001021528,1360001026712,3355684964,3355690148,5184
1360001032,3355695444,2,98,49,1360001021455,1360001026703,3355684899,3355690147,5248
1360001032,3355695444,2,98,49,1360001021455,1360001026703,3355684899,3355690147,5248
1360001032,3355695444,3,144,48,1360001021518,1360001026766,3355684962,3355690210,5248
1360001035,422420212,6,282,47,1360001027894,1360001034102,422413106,422419314,6208
1360001035,422420212,3,144,48,1360001027957,1360001033973,422413169,422419185,6016
1360001035,422420212,5,236,47.2,1360001027893,1360001034101,422413105,422419313,6208
1360001035,422420212,6,288,48,1360001028021,1360001034101,422413233,422419313,6080
1360001035,422420212,5,236,47.2,1360001028020,1360001034036,422413232,422419248,6016
1360001035,422420220,5,466,93.2,1360001029357,1360001034029,422414577,422419249,4672
1360001035,422420256,2,92,46,1360001027145,1360001027977,422412401,422413233,832
1360001035,422420260,3,144,48,1360001027845,1360001034053,422413105,422419313,6208
1360001035,422420260,3,144,48,1360001027845,1360001033925,422413105,422419185,6080
1360001035,422420260,5,242,48.4,1360001027845,1360001034053,422413105,422419313,6208
1360001035,422420260,5,242,48.4,1360001027845,1360001034053,422413105,422419313,6208
1360001035,422420260,4,190,47.5,1360001027972,1360001034052,422413232,422419312,6080
1360001035,422420260,5,236,47.2,1360001027971,1360001033987,422413231,422419247,6016
1360001035,422420260,2,98,49,1360001028035,1360001033667,422413295,422418927,5632
1360001037,3355700472,1,204,204,1360001009269,1360001009269,3355672741,3355672741,0
1360001040,3355703444,3,144,48,1360001027088,1360001032464,3355690532,3355695908,5376
1360001040,3355703444,4,190,47.5,1360001027088,1360001032528,3355690532,3355695972,5440
1360001040,3355703448,4,190,47.5,1360001028684,1360001034828,3355692132,3355698276,6144
1360001040,3355703448,5,236,47.2,1360001028812,1360001034764,3355692260,3355698212,5952
1360001040,3355703464,3,144,48,1360001027068,1360001032508,3355690532,3355695972,5440
1360001040,3355703464,2,98,49,1360001027068,1360001032444,3355690532,3355695908,5376
1360001040,3355703464,3,144,48,1360001027068,1360001032444,3355690532,3355695908,5376
1360001040,3355703468,4,190,47.5,1360001028664,1360001034808,3355692132,3355698276,6144
1360001040,3355703468,4,190,47.5,1360001028664,1360001034808,3355692132,3355698276,6144
1360001040,3355703468,5,236,47.2,1360001028792,1360001034744,3355692260,3355698212,5952
1360001043,422428236,4,190,47.5,1360001035678,1360001041374,422420914,422426610,5696
1360001043,422428236,3,144,48,1360001035933,1360001041309,422421169,422426545,5376
1360001043,422428244,2,98,49,1360001029908,1360001035476,422415152,422420720,5568
1360001043,422428248,3,144,48,1360001029907,1360001035475,422415155,422420723,5568
1360001043,422428248,3,144,48,1360001029970,1360001035474,422415218,422420722,5504
1360001044,422428284,4,190,47.5,1360001036885,1360001042325,422421169,422426609,5440
1360001044,422428316,3,144,48,1360001030839,1360001036471,422415155,422420787,5632
1360001044,422428316,2,98,49,1360001030839,1360001036407,422415155,422420723,5568
1360001044,422428316,2,98,49,1360001030837,1360001036405,422415153,422420721,5568
1360001045,3355708544,8,1857,232.125,1360001019051,1360001037483,3355682595,3355701027,18432
1360001047,422431884,10,960,96,1360001021630,1360001034110,422406514,422418994,12480
1360001047,422431932,4,658,164.5,1360001020557,1360001020621,422405489,422405553,64
1360001047,422431932,45,38489,855.3111111,1360001020620,1360001029516,422405552,422414448,8896
1360001047,422431956,6,336,56,1360001021429,1360001033845,422406385,422418801,12416
1360001047,422431960,12,3354,279.5,1360001021810,1360001026226,422406770,422411186,4416
1360001048,3355711440,3,144,48,1360001034515,1360001040211,3355697955,3355703651,5696
1360001048,3355711452,3,144,48,1360001034503,1360001040199,3355697955,3355703651,5696
1360001048,3355711464,3,144,48,1360001034813,1360001040189,3355698277,3355703653,5376
1360001048,3355711464,2,98,49,1360001034812,1360001040188,3355698276,3355703652,5376
1360001049,3355712540,4,224,56,1360001022447,1360001031535,3355685987,3355695075,9088
1360001049,3355712580,6,576,96,1360001022153,1360001034441,3355685733,3355698021,12288
1360001051,422435996,9,2632,292.4444444,1360001026126,1360001026574,422411122,422411570,448
1360001051,422436216,11,3433,312.0909091,1360001043375,1360001043503,422428591,422428719,128
1360001051,422436224,19,12223,643.3157895,1360001047530,1360001048426,422432754,422433650,896
1360001051,422436260,13,5690,437.6923077,1360001046404,1360001047492,422431664,422432752,1088
1360001051,422436268,2,98,49,1360001042367,1360001047807,422427635,422433075,5440
1360001052,422436304,17,7802,458.9411765,1360001049473,1360001049921,422433777,422434225,448
1360001053,3355716564,11,9898,899.8181818,1360001028568,1360001029080,3355692132,3355692644,512
1360001053,3355716564,17,13953,820.7647059,1360001028632,1360001034648,3355692196,3355698212,6016
1360001053,3355716592,4,418,104.5,1360001028542,1360001028990,3355692134,3355692582,448
1360001053,3355716596,12,8839,736.5833333,1360001028537,1360001030201,3355692133,3355693797,1664
1360001055,422439860,34,45014,1323.941176,1360001028371,1360001028563,422413231,422413423,192
1360001055,422439864,6,3344,557.3333333,1360001028435,1360001029779,422413299,422414643,1344
1360001055,422439944,9,5731,636.7777778,1360001028353,1360001029697,422413297,422414641,1344
1360001055,422439944,13,10646,818.9230769,1360001028352,1360001043456,422413296,422428400,15104
1360001055,422439944,8,4840,605,1360001028352,1360001029696,422413296,422414640,1344
1360001055,422439944,6,3562,593.6666667,1360001028352,1360001029760,422413296,422414704,1408
1360001055,422439976,6,528,88,1360001029601,1360001034145,422414577,422419121,4544
1360001055,422439976,7,1040,148.5714286,1360001029665,1360001034209,422414641,422419185,4544
1360001056,3355719448,4,190,47.5,1360001044364,1360001049612,3355707812,3355713060,5248
1360001056,3355719448,2,98,49,1360001044364,1360001049612,3355707812,3355713060,5248
1360001056,3355719468,4,190,47.5,1360001043192,1360001048632,3355706660,3355712100,5440
1360001056,3355719468,2,98,49,1360001044343,1360001049591,3355707811,3355713059,5248
1360001059,422444228,6,398,66.33333333,1360001052197,1360001058661,422437425,422443889,6464
1360001059,422444228,6,398,66.33333333,1360001052197,1360001058661,422437425,422443889,6464
1360001059,422444228,9,2292,254.6666667,1360001052197,1360001057445,422437425,422442673,5248
1360001059,422444236,8,544,68,1360001053404,1360001058460,422438640,422443696,5056
1360001059,422444260,11,4943,449.3636364,1360001049028,1360001054468,422434288,422439728,5440
1360001059,422444260,3,144,48,1360001046020,1360001051844,422431280,422437104,5824
1360001059,422444260,9,4851,539,1360001049027,1360001054467,422434287,422439727,5440
1360001060,422444300,11,3868,351.6363636,1360001053125,1360001058373,422437425,422442673,5248
1360001060,422444308,10,4923,492.3,1360001049470,1360001055422,422433778,422439730,5952
1360001060,422444308,9,590,65.55555556,1360001054333,1360001059389,422438641,422443697,5056
1360001060,422444308,8,544,68,1360001054333,1360001059389,422438641,422443697,5056
1360001060,422444312,11,5775,525,1360001046970,1360001052794,422431282,422437106,5824
1360001063,422447880,15,3067,204.4666667,1360001036290,1360001042498,422421170,422427378,6208
1360001063,422447952,16,5785,361.5625,1360001035578,1360001042490,422420530,422427442,6912
1360001067,422451912,8,1315,164.375,1360001042083,1360001042339,422426995,422427251,256
1360001067,422452000,6,3233,538.8333333,1360001042056,1360001043400,422427056,422428400,1344
1360001067,422452248,7,498,71.14285714,1360001056529,1360001060049,422441777,422445297,3520
1360001067,422452248,8,544,68,1360001053391,1360001059471,422438639,422444719,6080
1360001068,422452324,8,544,68,1360001054379,1360001060331,422438703,422444655,5952
1360001071,422455888,30,12487,416.2333333,1360001043512,1360001044152,422428400,422429040,640
1360001071,422455892,1,46,46,1360001043764,1360001043764,422428656,422428656,0
1360001071,422455944,18,10142,563.4444444,1360001046337,1360001049473,422431281,422434417,3136
1360001071,422455976,7,3143,449,1360001043425,1360001043617,422428401,422428593,192
1360001071,422455984,1,46,46,1360001044567,1360001044567,422429551,422429551,0
1360001071,422456024,8,1288,161,1360001046257,1360001068465,422431281,422453489,22208
1360001075,422459904,7,2656,379.4285714,1360001048231,1360001048487,422433135,422433391,256
1360001075,422459972,19,7648,402.5263158,1360001047269,1360001048549,422432241,422433521,1280
1360001075,422460016,13,7906,608.1538462,1360001049527,1360001049847,422434543,422434863,320
1360001079,422463896,40,38921,973.025,1360001051250,1360001054770,422436146,422439666,3520
1360001079,422463992,18,10239,568.8333333,1360001052434,1360001055378,422437426,422440370,2944
1360001079,422464020,13,1248,96,1360001052918,1360001071286,422437938,422456306,18368
1360001079,422464028,7,392,56,1360001053804,1360001074540,422438832,422459568,20736
1360001081,3355744536,7,392,56,1360001053236,1360001071028,3355716772,3355734564,17792
1360001081,3355744592,6,576,96,1360001054779,1360001069755,3355718371,3355733347,14976
1360001083,422468028,2,474,237,1360001056940,1360001057004,422441968,422442032,64
1360001085,3355748568,13,1706,131.2307692,1360001056982,1360001064790,3355720550,3355728358,7808
1360001091,422476052,6,1082,180.3333333,1360001066643,1360001067219,422451695,422452271,576
1360001095,422479968,2,123,61.5,1360001070313,1360001070377,422455281,422455345,64
1360001099,422483924,3,169,56.33333333,1360001071380,1360001071380,422456304,422456304,0
1360001099,422483972,2,123,61.5,1360001074342,1360001074342,422459314,422459314,0
1360001107,422492004,3,1463,487.6666667,1360001079875,1360001079939,422464879,422464943,64
1360001115,422499936,2,123,61.5,1360001088329,1360001088329,422473265,422473265,0
1360001115,422500016,2,123,61.5,1360001088249,1360001088313,422473265,422473329,64
1360001116,422500380,5,726,145.2,1360001114100,1360001114228,422498480,422498608,128
1360001119,422503984,22,12926,587.5454545,1360001092634,1360001118682,422477618,422503666,26048
1360001119,422503992,3,138,46,1360001093584,1360001093584,422478576,422478576,0
1360001124,422508364,7,502,71.71428571,1360001118147,1360001121923,422502511,422506287,3776
1360001124,422508392,10,3138,313.8,1360001114089,1360001119145,422498481,422503537,5056
1360001124,422508392,8,2930,366.25,1360001114087,1360001119143,422498479,422503535,5056
1360001124,422508440,11,923,83.90909091,1360001110519,1360001118967,422494959,422503407,8448
1360001132,422516344,190,252178,1327.252632,1360001067736,1360001129368,422452080,422513712,61632
1360001132,422516392,180,248817,1382.316667,1360001067880,1360001129896,422452272,422514288,62016
1360001135,422520168,3,274,91.33333333,1360001109663,1360001109727,422494831,422494895,64
1360001139,422524172,60,85341,1422.35,1360001113306,1360001113690,422498478,422498862,384
1360001139,422524172,5,754,150.8,1360001113306,1360001113434,422498478,422498606,128
1360001139,422524176,6,576,96,1360001113559,1360001118487,422498735,422503663,4928
1360001140,422524304,12,7035,586.25,1360001114175,1360001114303,422498479,422498607,128
1360001140,422524328,8,2130,266.25,1360001114151,1360001114535,422498479,422498863,384
1360001140,422524344,2,112,56,1360001115289,1360001117977,422499633,422502321,2688
1360001141,3355804588,3,288,96,1360001114306,1360001118274,3355777894,3355781862,3968
1360001141,3355804632,3,168,56,1360001114518,1360001118934,3355778150,3355782566,4416
1360001143,422528112,2,123,61.5,1360001115159,1360001115159,422500271,422500271,0
1360001143,422528228,2,123,61.5,1360001116066,1360001116066,422501294,422501294,0
1360001143,422528240,3,510,170,1360001117080,1360001117144,422502320,422502384,64
1360001147,422532276,2,123,61.5,1360001118962,1360001119026,422504238,422504302,64
1360001148,422532288,3,491,163.6666667,1360001120848,1360001120912,422505136,422505200,64
1360001148,422532644,3,138,46,1360001144877,1360001144877,422529521,422529521,0
1360001155,422540160,2,92,46,1360001128040,1360001128040,422513200,422513200,0
1360001159,422544188,1,77,77,1360001133067,1360001133067,422518255,422518255,0
1360001159,422544192,2,123,61.5,1360001133063,1360001133063,422518255,422518255,0
1360001159,422544200,2,180,90,1360001134273,1360001134337,422519473,422519537,64
1360001163,422548256,2,92,46,1360001136262,1360001136326,422521518,422521582,64
1360001164,422548420,2,92,46,1360001158089,1360001158089,422542509,422542509,0
1360001164,422548420,2,92,46,1360001158089,1360001158089,422542509,422542509,0
1360001164,422548460,8,458,57.25,1360001160739,1360001160739,422545199,422545199,0
1360001164,422548488,3,138,46,1360001158022,1360001158086,422542510,422542574,64
1360001164,422548492,7,412,58.85714286,1360001161668,1360001161732,422546160,422546224,64
1360001164,422548496,3,138,46,1360001158976,1360001159040,422543472,422543536,64
1360001171,422556212,2,92,46,1360001145267,1360001145331,422530479,422530543,64
1360001171,422556212,1,46,46,1360001145329,1360001145329,422530541,422530541,0
1360001172,422556288,1,46,46,1360001146190,1360001146190,422530478,422530478,0
1360001172,422556292,1,46,46,1360001146253,1360001146253,422530545,422530545,0
1360001172,422556408,7,412,58.85714286,1360001164759,1360001164823,422549167,422549231,64
1360001172,422556460,3,138,46,1360001165029,1360001165093,422549489,422549553,64
1360001172,422556488,3,138,46,1360001166023,1360001166087,422550511,422550575,64
1360001172,422556496,2,92,46,1360001171007,1360001171007,422555503,422555503,0
1360001169,3355832656,1,46,46,1360001144830,1360001144830,3355808486,3355808486,0
1360001169,3355832656,2,92,46,1360001144830,1360001144830,3355808486,3355808486,0
1360001173,3355836592,2,92,46,1360001145916,1360001145980,3355809508,3355809572,64
1360001176,422560524,3,605,201.6666667,1360001148130,1360001148194,422532654,422532718,64
1360001176,422560564,2,92,46,1360001149949,1360001149949,422534513,422534513,0
1360001176,422560600,1,46,46,1360001151192,1360001151192,422535792,422535792,0
1360001177,3355840696,2,92,46,1360001149781,1360001149845,3355813477,3355813541,64
1360001180,422564752,7,412,58.85714286,1360001178430,1360001178494,422563182,422563246,64
1360001180,422564804,8,458,57.25,1360001178380,1360001178444,422563184,422563248,64
1360001184,422568564,2,92,46,1360001158906,1360001158970,422543470,422543534,64
1360001192,422576472,1,46,46,1360001167831,1360001167831,422552303,422552303,0
1360001192,422576560,1,46,46,1360001164031,1360001164031,422548591,422548591,0
1360001192,422576560,1,46,46,1360001164031,1360001164031,422548591,422548591,0
1360001192,422576588,1,46,46,1360001164579,1360001164579,422549167,422549167,0
1360001196,422580728,1,46,46,1360001168792,1360001168792,422553520,422553520,0
1360001196,422580728,1,46,46,1360001168792,1360001168792,422553520,422553520,0
1360001200,422584448,1,46,46,1360001172272,1360001172272,422556720,422556720,0
1360001200,422584496,2,180,90,1360001174974,1360001175038,422559470,422559534,64
1360001212,422596532,25,22725,909,1360001204378,1360001207962,422588910,422592494,3584
1360001212,422596748,3,1443,481,1360001186049,1360001186113,422570797,422570861,64
1360001212,422596832,10,4508,450.8,1360001186096,1360001186224,422570928,422571056,128
1360001228,422612500,1024,951209,928.9150391,1360001207993,1360001222521,422592493,422607021,14528
1360001233,3355896732,16,1536,96,1360001208688,1360001232880,3355872420,3355896612,24192
1360001233,3355896748,15,840,56,1360001208864,1360001231648,3355872612,3355895396,22784
1360001236,422620464,2,92,46,1360001229469,1360001229469,422613933,422613933,0
1360001236,422620468,2,92,46,1360001229464,1360001229464,422613932,422613932,0
1360001236,422620468,2,92,46,1360001229467,1360001229467,422613935,422613935,0
1360001236,422620584,2,92,46,1360001229350,1360001229350,422613934,422613934,0
1360001236,422620608,159,140698,884.8930818,1360001052812,1360001234764,422437420,422619372,181952
1360001236,422620664,18,1008,56,1360001208533,1360001235477,422593197,422620141,26944
1360001236,422620748,35,3360,96,1360001208577,1360001235649,422593325,422620397,27072
1360001240,422624612,16,896,56,1360001212233,1360001236745,422596845,422621357,24512
1360001240,422624740,4,272,68,1360001214729,1360001237065,422599469,422621805,22336
1360001244,422628632,804,827283,1028.958955,1360001222390,1360001236918,422607022,422621550,14528
1360001244,422628636,5,906,181.2,1360001242417,1360001242481,422627053,422627117,64
1360001244,422628664,47,56205,1195.851064,1360001242901,1360001243733,422627565,422628397,832
1360001244,422628664,50,62150,1243,1360001242708,1360001243348,422627372,422628012,640
1360001252,422636468,4,784,196,1360001244953,1360001245401,422629421,422629869,448
1360001252,422636500,5,242,48.4,1360001241913,1360001247737,422626413,422632237,5824
1360001252,422636504,3,144,48,1360001241976,1360001247416,422626480,422631920,5440
1360001252,422636508,6,662,110.3333333,1360001242546,1360001251378,422627054,422635886,8832
1360001252,422636512,39,49375,1266.025641,1360001242926,1360001244206,422627438,422628718,1280
1360001252,422636512,6,300,50,1360001243053,1360001251437,422627565,422635949,8384
1360001252,422636512,9,2332,259.1111111,1360001243117,1360001250925,422627629,422635437,7808
1360001252,422636544,468,329437,703.9252137,1360001237006,1360001250702,422621550,422635246,13696
1360001252,422636620,3,144,48,1360001241858,1360001247298,422626478,422631918,5440
1360001252,422636652,6,662,110.3333333,1360001242404,1360001251236,422627056,422635888,8832
1360001252,422636656,35,41165,1176.142857,1360001242780,1360001243996,422627436,422628652,1216
1360001252,422636656,5,248,49.6,1360001242975,1360001251295,422627631,422635951,8320
1360001252,422636656,8,392,49,1360001242975,1360001250975,422627631,422635631,8000
1360001252,422636656,6,300,50,1360001242974,1360001251678,422627630,422636334,8704
1360001252,422636656,5,674,134.8,1360001243549,1360001244061,422628205,422628717,512
1360001252,422636820,3,491,163.6666667,1360001226107,1360001226171,422610927,422610991,64
1360001260,422644460,3,144,48,1360001252322,1360001257442,422636782,422641902,5120
1360001260,422644464,11,6416,583.2727273,1360001240412,1360001256604,422624876,422641068,16192
1360001260,422644464,2,98,49,1360001244511,1360001259871,422628975,422644335,15360
1360001260,422644464,2,279,139.5,1360001253021,1360001257437,422637485,422641901,4416
1360001260,422644468,3,144,48,1360001244888,1360001258968,422629356,422643436,14080
1360001260,422644468,2,94,47,1360001245210,1360001256282,422629678,422640750,11072
1360001260,422644504,4,196,49,1360001247606,1360001257078,422632110,422641582,9472
1360001260,422644508,1240,1797647,1449.715323,1360001243634,1360001258034,422628142,422642542,14400
1360001260,422644512,4,184,46,1360001252527,1360001256879,422637039,422641391,4352
1360001260,422644512,2,279,139.5,1360001252973,1360001257389,422637485,422641901,4416
1360001260,422644512,3,144,48,1360001244845,1360001258029,422629357,422642541,13184
1360001260,422644512,4,190,47.5,1360001253037,1360001258029,422637549,422642541,4992
1360001260,422644512,2,94,47,1360001244908,1360001257132,422629420,422641644,12224
1360001260,422644512,2,94,47,1360001244908,1360001257324,422629420,422641836,12416
1360001260,422644540,13,5149,396.0769231,1360001256912,1360001257552,422641452,422642092,640
1360001260,422644540,2,94,47,1360001245136,1360001256208,422629676,422640748,11072
1360001260,422644544,2,94,47,1360001245135,1360001255311,422629679,422639855,10176
1360001260,422644544,16,5287,330.4375,1360001257356,1360001257932,422641900,422642476,576
1360001260,422644552,4,602,150.5,1360001241861,1360001252293,422626413,422636845,10432
1360001260,422644552,3,144,48,1360001254852,1360001257284,422639404,422641836,2432
1360001260,422644556,2,98,49,1360001247043,1360001257475,422631599,422642031,10432
1360001260,422644560,4,196,49,1360001247550,1360001256958,422632110,422641518,9408
1360001260,422644676,10,2371,237.1,1360001243145,1360001256009,422627821,422640685,12864
1360001260,422644676,2,98,49,1360001243529,1360001257737,422628205,422642413,14208
1360001260,422644676,2,98,49,1360001243593,1360001258505,422628269,422643181,14912
1360001261,3355924744,16,1536,96,1360001234596,1360001259556,3355898340,3355923300,24960
1360001261,3355924776,17,952,56,1360001233605,1360001259781,3355897381,3355923557,26176
1360001264,3355927444,3,150,50,1360001243344,1360001261520,3355906788,3355924964,18176
1360001264,3355927448,4,196,49,1360001243727,1360001257039,3355907175,3355920487,13312
1360001264,3355927448,3,144,48,1360001243854,1360001258766,3355907302,3355922214,14912
1360001264,422648728,33,3168,96,1360001236246,1360001263126,422620974,422647854,26880
1360001264,422648740,71,62975,886.971831,1360001237064,1360001245768,422621804,422630508,8704
1360001264,422648740,42,34021,810.0238095,1360001237514,1360001261130,422622254,422645870,23616
1360001264,422648764,21,6111,291,1360001237490,1360001261106,422622254,422645870,23616
1360001264,422648772,5,735,147,1360001238569,1360001239273,422623341,422624045,704
1360001264,422648776,4,447,111.75,1360001238566,1360001238950,422623342,422623726,384
1360001264,422648816,17,952,56,1360001236669,1360001263549,422621485,422648365,26880
1360001264,422648840,20,3610,180.5,1360001237412,1360001261028,422622252,422645868,23616
1360001264,422648844,19,3627,190.8947368,1360001237411,1360001261027,422622255,422645871,23616
1360001264,422648844,22,7649,347.6818182,1360001237411,1360001261027,422622255,422645871,23616
1360001264,422648856,4,432,108,1360001238487,1360001241559,422623343,422626415,3072
1360001268,422652464,3,144,48,1360001244893,1360001260317,422629357,422644781,15424
1360001268,422652476,4,483,120.75,1360001241937,1360001262161,422626413,422646637,20224
1360001268,422652508,3,144,48,1360001243632,1360001261616,422628140,422646124,17984
1360001268,422652516,2,98,49,1360001244841,1360001260265,422629357,422644781,15424
1360001268,422652536,3,150,50,1360001257301,1360001263637,422641837,422648173,6336
1360001268,422652544,4,483,120.75,1360001241871,1360001262415,422626415,422646959,20544
1360001268,422652680,4,196,49,1360001243719,1360001260743,422628399,422645423,17024
1360001268,422652680,2,98,49,1360001243719,1360001261319,422628399,422645999,17600
1360001268,422652688,12,4632,386,1360001240509,1360001243453,422625197,422628141,2944
1360001268,422652736,9,3232,359.1111111,1360001242958,1360001243982,422627694,422628718,1024
1360001268,422652736,7,800,114.2857143,1360001243085,1360001247245,422627821,422631981,4160
1360001268,422652764,3,161,53.66666667,1360001243443,1360001243635,422628207,422628399,192
1360001268,422652764,15,11116,741.0666667,1360001243507,1360001246707,422628271,422631471,3200
1360001268,422652812,7,1927,275.2857143,1360001242307,1360001243459,422627119,422628271,1152
1360001268,422652816,6,754,125.6666667,1360001243006,1360001247230,422627822,422632046,4224
1360001268,422652816,17,952,56,1360001242685,1360001266429,422627501,422651245,23744
1360001268,422652836,8,2585,323.125,1360001243370,1360001243946,422628206,422628782,576
1360001269,3355932988,11,5796,526.9090909,1360001243251,1360001245555,3355907239,3355909543,2304
1360001272,422656680,2,92,46,1360001243908,1360001243908,422628588,422628588,0
1360001272,422656808,35,42276,1207.885714,1360001246725,1360001254597,422631533,422639405,7872
1360001280,422664840,4,184,46,1360001253095,1360001255655,422637935,422640495,2560
1360001280,422664908,1,46,46,1360001255395,1360001255395,422640303,422640303,0
1360001284,422668520,908,956926,1053.88326,1360001255654,1360001278438,422640174,422662958,22784
1360001284,422668832,4,1308,327,1360001256558,1360001256686,422641390,422641518,128
1360001284,422668832,31,37072,1195.870968,1360001256748,1360001257772,422641580,422642604,1024
1360001288,422672832,32,3072,96,1360001263789,1360001287341,422648621,422672173,23552
1360001289,3355952992,19,1824,96,1360001260974,1360001288366,3355924966,3355952358,27392
1360001289,3355952992,19,1064,56,1360001261164,1360001288620,3355925156,3355952612,27456
1360001292,422676544,1361,1949966,1432.74504,1360001276107,1360001284619,422660651,422669163,8512
1360001292,422676776,19,1064,56,1360001265061,1360001291621,422649837,422676397,26560
1360001292,422676812,5,1049,209.8,1360001266689,1360001272257,422651501,422657069,5568
1360001296,422680800,18,1008,56,1360001268494,1360001293006,422653294,422677806,24512
1360001296,422680804,2,454,227,1360001269066,1360001293066,422653870,422677870,24000
1360001296,422680884,2,454,227,1360001268985,1360001292985,422653869,422677869,24000
1360001304,422688808,7,3516,502.2857143,1360001277316,1360001291972,422662124,422676780,14656
1360001308,422692512,4,628,157,1360001305324,1360001305388,422689836,422689900,64
1360001308,422692588,2,123,61.5,1360001301537,1360001301537,422686125,422686125,0
1360001308,422692592,1198,1159436,967.8096828,1360001277919,1360001301855,422662511,422686447,23936
1360001308,422692624,5,643,128.6,1360001303228,1360001303420,422687852,422688044,192
1360001308,422692628,2,92,46,1360001307511,1360001307511,422692139,422692139,0
1360001308,422692632,6,2910,485,1360001291446,1360001307510,422676078,422692142,16064
1360001316,422700504,6,1128,188,1360001308277,1360001308661,422692781,422693165,384
1360001316,422700508,6,1128,188,1360001308082,1360001308210,422692590,422692718,128
1360001316,422700516,5,455,91,1360001309479,1360001309543,422693995,422694059,64
1360001316,422700628,2,279,139.5,1360001303223,1360001308471,422687851,422693099,5248
1360001316,422700888,30,2880,96,1360001287924,1360001315636,422672812,422700524,27712
1360001317,3355980984,15,1440,96,1360001289526,1360001316662,3355953510,3355980646,27136
1360001317,3355980984,13,728,56,1360001289780,1360001315380,3355953764,3355979364,25600
1360001320,422704832,14,784,56,1360001293230,1360001319662,422678062,422704494,26432
1360001320,422704860,3,1394,464.6666667,1360001294223,1360001294287,422679083,422679147,64
1360001324,422708532,970,1065254,1098.2,1360001301978,1360001316186,422686510,422700718,14208
1360001324,422708832,14,784,56,1360001297134,1360001321838,422681966,422706670,24704
1360001324,422708944,1,46,46,1360001298364,1360001298364,422683308,422683308,0
1360001328,422712908,3,138,46,1360001303391,1360001303455,422688299,422688363,64
1360001332,422716516,1113,1076408,967.1230907,1360001316202,1360001331562,422700718,422716078,15360
1360001332,422716516,7,2447,349.5714286,1360001324329,1360001327785,422708845,422712301,3456
1360001332,422716568,8,5176,647,1360001324406,1360001327670,422708974,422712238,3264
1360001332,422716952,18,16410,911.6666667,1360001307381,1360001308277,422692333,422693229,896
1360001336,422720836,1,46,46,1360001308970,1360001308970,422693806,422693806,0
1360001336,422720908,18,16410,911.6666667,1360001308831,1360001308959,422693739,422693867,128
1360001340,422724524,839,1132903,1350.301549,1360001332959,1360001338399,422717483,422722923,5440
1360001340,422724564,262,295018,1126.022901,1360001331511,1360001339191,422716075,422723755,7680
1360001340,422724848,1,46,46,1360001312605,1360001312605,422697453,422697453,0
1360001340,422724856,1,46,46,1360001313174,1360001313174,422698030,422698030,0
1360001340,422724968,1,46,46,1360001313830,1360001313830,422698798,422698798,0
1360001344,422728852,22,2112,96,1360001316569,1360001335961,422701421,422720813,19392
1360001344,3356007560,10,560,56,1360001317342,1360001336158,3355980902,3355999718,18816
1360001345,3356009028,10,960,96,1360001318154,1360001335434,3355982182,3355999462,17280
1360001348,422732836,6,5084,847.3333333,1360001323689,1360001323753,422708525,422708589,64
1360001348,422732840,4,2309,577.25,1360001323813,1360001323877,422708653,422708717,64
1360001348,422732876,9,504,56,1360001322049,1360001336193,422706925,422721069,14144
1360001348,422732920,8,4612,576.5,1360001323796,1360001323924,422708716,422708844,128
1360001348,422732976,3,3004,1001.333333,1360001323356,1360001323484,422708332,422708460,128
1360001352,422736856,8,448,56,1360001324373,1360001336085,422709229,422720941,11712
1360001352,422736928,9,3683,409.2222222,1360001327691,1360001349707,422712619,422734635,22016
1360001352,422736932,5,4598,919.6,1360001323850,1360001323914,422708782,422708846,64
1360001352,422736944,4,762,190.5,1360001324988,1360001325244,422709932,422710188,256
1360001352,422736972,7,7111,1015.857143,1360001325791,1360001325919,422710763,422710891,128
1360001352,422737012,10,4565,456.5,1360001327482,1360001327866,422712494,422712878,384
1360001364,422748648,4,184,46,1360001356133,1360001363749,422740781,422748397,7616
1360001364,422748656,7,2399,342.7142857,1360001360796,1360001363868,422745452,422748524,3072
1360001364,422748692,5,251,50.2,1360001359672,1360001359736,422744364,422744428,64
1360001364,422748692,4,184,46,1360001359800,1360001360760,422744492,422745452,960
1360001364,422748696,3,551,183.6666667,1360001363125,1360001363253,422747821,422747949,128
1360001364,422748736,118,155694,1319.440678,1360001237708,1360001357900,422622444,422742636,120192
1360001364,422748744,5,236,47.2,1360001359619,1360001360323,422744363,422745067,704
1360001364,422748744,5,236,47.2,1360001359619,1360001360259,422744363,422745003,640
1360001368,422752900,1,227,227,1360001340967,1360001340967,422725867,422725867,0
1360001368,422752900,1,227,227,1360001340967,1360001340967,422725867,422725867,0
1360001368,422752976,1,1420,1420,1360001340444,1360001340444,422725420,422725420,0
1360001368,422753012,2,3000,1500,1360001341880,1360001348088,422726892,422733100,6208
1360001372,422756652,4,184,46,1360001364385,1360001368417,422749037,422753069,4032
1360001372,422756652,3,138,46,1360001364448,1360001367776,422749100,422752428,3328
1360001372,422756660,27,19479,721.4444444,1360001360921,1360001371353,422745581,422756013,10432
1360001372,422756700,4,377,94.25,1360001363185,1360001371249,422747885,422755949,8064
1360001372,422756704,4,184,46,1360001363948,1360001368876,422748652,422753580,4928
1360001380,422764656,3,144,48,1360001372445,1360001378141,422757101,422762797,5696
1360001380,422764656,2,98,49,1360001372445,1360001378141,422757101,422762797,5696
1360001380,422764656,4,190,47.5,1360001372572,1360001378268,422757228,422762924,5696
1360001380,422764660,5,2355,471,1360001372889,1360001376601,422757549,422761261,3712
1360001380,422764660,7,5130,732.8571429,1360001373016,1360001376600,422757676,422761260,3584
1360001380,422764664,2,92,46,1360001373460,1360001379156,422758124,422763820,5696
1360001380,422764668,118,145667,1234.466102,1360001373904,1360001375504,422758572,422760172,1600
1360001380,422764700,3,144,48,1360001362737,1360001372145,422747437,422756845,9408
1360001380,422764700,5,674,134.8,1360001372079,1360001372207,422756779,422756907,128
1360001380,422764704,3,144,48,1360001372397,1360001378093,422757101,422762797,5696
1360001380,422764784,5,242,48.4,1360001362653,1360001372061,422747437,422756845,9408
1360001384,422768992,3,144,48,1360001359370,1360001359498,422744362,422744490,128
1360001384,422768992,7,963,137.5714286,1360001359437,1360001363917,422744429,422748909,4480
1360001384,422769032,2,92,46,1360001357091,1360001357155,422742123,422742187,64
1360001388,422772656,2,92,46,1360001374173,1360001380125,422758829,422764781,5952
1360001388,422772696,819,1129235,1378.797314,1360001380914,1360001385138,422765610,422769834,4224
1360001388,422772920,4,657,164.25,1360001360146,1360001379410,422745066,422764330,19264
1360001392,422777040,3,545,181.6666667,1360001365915,1360001370587,422750955,422755627,4672
1360001396,422780784,1613,1800745,1116.394916,1360001371226,1360001390298,422756010,422775082,19072
1360001396,422781000,2,92,46,1360001371779,1360001371779,422756779,422756779,0
1360001396,422781052,2,98,49,1360001370510,1360001370574,422755562,422755626,64
1360001396,422781092,1,46,46,1360001371751,1360001371751,422756843,422756843,0
1360001396,422781168,1,46,46,1360001370972,1360001370972,422756140,422756140,0
1360001396,422781172,8,1443,180.375,1360001371289,1360001371673,422756461,422756845,384
1360001397,3356061028,3,144,48,1360001370569,1360001370633,3356034597,3356034661,64
1360001400,422784972,4,3050,762.5,1360001372193,1360001372321,422757165,422757293,128
1360001400,422784972,4,2309,577.25,1360001372320,1360001372384,422757292,422757356,64
1360001400,422784984,32,3072,96,1360001373332,1360001398868,422758316,422783852,25536
1360001400,422785016,16,896,56,1360001374389,1360001398773,422759405,422783789,24384
1360001400,422785016,1,46,46,1360001374579,1360001374579,422759595,422759595,0
1360001400,422785052,6,5084,847.3333333,1360001372237,1360001372237,422757289,422757289,0
1360001400,422785052,6,5084,847.3333333,1360001372369,1360001372433,422757421,422757485,64
1360001400,422785052,8,4612,576.5,1360001372304,1360001372496,422757356,422757548,192
1360001400,422785056,1,46,46,1360001372749,1360001372749,422757805,422757805,0
1360001400,422785060,1,46,46,1360001373320,1360001373320,422758380,422758380,0
1360001400,422785092,16,896,56,1360001374120,1360001398056,422759212,422783148,23936
1360001401,3356065000,17,952,56,1360001373094,1360001399590,3356037094,3356063590,26496
1360001401,3356065020,15,1440,96,1360001375443,1360001399315,3356039463,3356063335,23872
1360001404,422788664,3,169,56.33333333,1360001397589,1360001397653,422782253,422782317,64
1360001404,422788668,693,452747,653.3145743,1360001390415,1360001403535,422775083,422788203,13120
1360001404,422788672,3,169,56.33333333,1360001398604,1360001398604,422783276,422783276,0
1360001416,422801148,7,2468,352.5714286,1360001391598,1360001391854,422776746,422777002,256
1360001420,422804708,6,2401,400.1666667,1360001415336,1360001418600,422800044,422803308,3264
1360001420,422804760,8,5176,647,1360001415412,1360001418548,422800172,422803308,3136
1360001428,422812684,5,674,134.8,1360001425149,1360001425277,422809833,422809961,128
1360001428,422812692,5,643,128.6,1360001423160,1360001423224,422807852,422807916,64
1360001428,422812776,1137,1107466,974.0246262,1360001403429,1360001420773,422788205,422805549,17344
1360001428,422813088,10,560,56,1360001400747,1360001422699,422785835,422807787,21952
1360001428,422813092,10,560,56,1360001401190,1360001424806,422786282,422809898,23616
1360001428,422813164,19,1824,96,1360001400160,1360001420384,422785324,422805548,20224
1360001429,3356093036,9,864,96,1360001401859,1360001418243,3356065895,3356082279,16384
1360001429,3356093040,9,504,56,1360001402303,1360001420223,3356066343,3356084263,17920
1360001440,422825160,2,560,280,1360001412065,1360001412129,422797225,422797289,64
1360001440,422825212,5,2355,471,1360001414641,1360001414705,422799853,422799917,64
1360001440,422825212,6,5084,847.3333333,1360001414576,1360001414576,422799788,422799788,0
1360001440,422825212,6,5084,847.3333333,1360001414767,1360001414831,422799979,422800043,64
1360001440,422825212,8,4612,576.5,1360001414702,1360001414830,422799914,422800042,128
1360001441,422825296,3,3004,1001.333333,1360001415425,1360001415489,422799721,422799785,64
1360001452,422836812,3,144,48,1360001446080,1360001451136,422830892,422835948,5056
1360001464,422849168,1,227,227,1360001436698,1360001436698,422821866,422821866,0
1360001464,422849248,1,227,227,1360001436617,1360001436617,422821865,422821865,0
1360001468,422852704,7,5130,732.8571429,1360001457900,1360001461548,422842604,422846252,3648
1360001468,422852772,7,2447,349.5714286,1360001457704,1360001461480,422842476,422846252,3776
1360001473,422857300,6,2097,349.5,1360001446589,1360001449277,422830889,422833577,2688
1360001484,422868804,5,643,128.6,1360001483014,1360001483206,422867818,422868010,192
1360001484,422869268,3,3009,1003,1360001456952,1360001457016,422842220,422842284,64
1360001484,422869268,6,5084,847.3333333,1360001456952,1360001457016,422842220,422842284,64
1360001485,422869288,5,2355,471,1360001457993,1360001458057,422842281,422842345,64
1360001485,422869292,8,4612,576.5,1360001458056,1360001458184,422842348,422842476,128
1360001485,422869292,6,5084,847.3333333,1360001458120,1360001458184,422842412,422842476,64
1360001492,422876768,3,138,46,1360001487977,1360001488105,422872745,422872873,128
1360001492,422876800,5,674,134.8,1360001485066,1360001485194,422869866,422869994,128
1360001500,422884816,7,908,129.7142857,1360001478905,1360001494969,422863721,422879785,16064
1360001508,422892748,6,2401,400.1666667,1360001503292,1360001506492,422888040,422891240,3200
1360001508,422892828,8,5176,647,1360001503343,1360001506415,422888171,422891243,3072
1360001513,422897660,3,492,164,1360001488407,1360001488535,422873067,422873195,128
1360001524,422908808,1196,1755554,1467.854515,1360001511296,1360001516992,422896104,422901800,5696
1360001524,422909232,6,5084,847.3333333,1360001499483,1360001499611,422884715,422884843,128
1360001525,422909316,3,3004,1001.333333,1360001500334,1360001500462,422884650,422884778,128
1360001529,422913272,8,4612,576.5,1360001503577,1360001503769,422887849,422888041,192
1360001529,422913356,5,2355,471,1360001503431,1360001503495,422887787,422887851,64
1360001529,422913356,6,5084,847.3333333,1360001503557,1360001503621,422887913,422887977,64
1360001533,422917312,4,2892,723,1360001508785,1360001508913,422893097,422893225,128
1360001537,422921288,15,1440,96,1360001512457,1360001528649,422896745,422912937,16192
1360001537,3356201016,7,672,96,1360001511897,1360001528089,3356175913,3356192105,16192
1360001537,3356201060,7,392,56,1360001511981,1360001523693,3356176041,3356187753,11712
1360001540,422925244,5,1996,399.2,1360001512076,1360001538444,422897320,422923688,26368
1360001540,422925248,7,392,56,1360001512138,1360001523914,422897386,422909162,11776
1360001541,422925328,7,392,56,1360001513121,1360001525153,422897449,422909481,12032
1360001548,422932760,5,674,134.8,1360001545074,1360001545266,422929834,422930026,192
1360001548,422932840,6,689,114.8333333,1360001543010,1360001543138,422927850,422927978,128
1360001548,422933256,7,4093,584.7142857,1360001523520,1360001524032,422908776,422909288,512
1360001553,422937448,3,492,164,1360001528488,1360001528616,422912936,422913064,128
1360001556,422940868,2,92,46,1360001554054,1360001554054,422938922,422938922,0
1360001588,422972872,3,144,48,1360001578879,1360001583999,422963751,422968871,5120
1360001593,422977640,6,1972,328.6666667,1360001568231,1360001579239,422952871,422963879,11008
1360001596,422980792,7,2447,349.5714286,1360001585808,1360001589456,422970600,422974248,3648
1360001596,422980796,7,5130,732.8571429,1360001585866,1360001589450,422970662,422974246,3584
1360001597,422981576,1,46,46,1360001572137,1360001572137,422956713,422956713,0
1360001597,422981628,1,46,46,1360001570997,1360001570997,422955625,422955625,0
1360001604,422988916,5,643,128.6,1360001602901,1360001603093,422987817,422988009,192
1360001612,422996824,28,27951,998.25,1360001603057,1360001606449,422987881,422991273,3392
1360001612,422996836,5,674,134.8,1360001605029,1360001605157,422989865,422989993,128
1360001613,422997576,5,2355,471,1360001585831,1360001585895,422970407,422970471,64
1360001613,422997604,6,5084,847.3333333,1360001585867,1360001585931,422970471,422970535,64
1360001613,422997684,4,3055,763.75,1360001585532,1360001585724,422970216,422970408,192
1360001613,422997688,6,5084,847.3333333,1360001585656,1360001585720,422970344,422970408,64
1360001613,422997688,8,4612,576.5,1360001585783,1360001585911,422970471,422970599,128
1360001620,423004840,3,138,46,1360001618334,1360001619358,423003174,423004198,1024
1360001628,423012864,2,92,46,1360001621320,1360001625352,423006184,423010216,4032
1360001633,3356297252,6,722,120.3333333,1360001607595,1360001612267,3356271847,3356276519,4672
1360001636,423020808,7,2447,349.5714286,1360001628223,1360001631487,423013031,423016295,3264
1360001636,423020808,7,5130,732.8571429,1360001628286,1360001631422,423013094,423016230,3136
1360001636,423020816,7,907,129.5714286,1360001613879,1360001629943,422998695,423014759,16064
1360001637,423021588,151,123960,820.9271523,1360001019291,1360001335451,422403879,422720039,316160
1360001644,423028828,3,138,46,1360001639978,1360001640042,423024806,423024870,64
1360001645,423029656,3,492,164,1360001619929,1360001620057,423004585,423004713,128
1360001653,423037584,3,3004,1001.333333,1360001628129,1360001628193,423012713,423012777,64
1360001653,423037584,6,5084,847.3333333,1360001628192,1360001628192,423012776,423012776,0
1360001653,423037584,8,4612,576.5,1360001628254,1360001628382,423012838,423012966,128
1360001653,423037588,6,5084,847.3333333,1360001628317,1360001628381,423012905,423012969,64
1360001653,423037672,5,2355,471,1360001628103,1360001628167,423012775,423012839,64
1360001660,423044804,4,184,46,1360001653250,1360001656258,423038054,423041062,3008
1360001668,423052860,5,643,128.6,1360001662989,1360001663117,423047849,423047977,128
1360001668,423052876,5,674,134.8,1360001664957,1360001665149,423049833,423050025,192
1360001676,423060860,6,497,82.83333333,1360001669065,1360001671433,423053925,423056293,2368
1360001676,423060900,6,2401,400.1666667,1360001670946,1360001674338,423055846,423059238,3392
1360001676,423060904,8,5176,647,1360001671007,1360001674399,423055911,423059303,3392
1360001684,423068868,3,150,50,1360001672836,1360001678020,423057704,423062888,5184
1360001684,423068868,3,144,48,1360001672836,1360001678020,423057704,423062888,5184
1360001685,423069660,3,492,164,1360001659346,1360001659474,423044006,423044134,128
1360001685,423069696,1,46,46,1360001660399,1360001660399,423045095,423045095,0
1360001697,423081660,5,2355,471,1360001670546,1360001670610,423055206,423055270,64
1360001697,423081664,6,5084,847.3333333,1360001670736,1360001670736,423055400,423055400,0
1360001697,423081664,6,5084,847.3333333,1360001670544,1360001670544,423055208,423055208,0
1360001697,423081712,1,46,46,1360001669213,1360001669213,423053925,423053925,0
1360001697,423081744,3,3009,1003,1360001670397,1360001670461,423055141,423055205,64
1360001697,423081744,9,4664,518.2222222,1360001670527,1360001671039,423055271,423055783,512
1360001697,423081804,8,1360,170,1360001672001,1360001672577,423056805,423057381,576
1360001724,423108840,8,5176,647,1360001713568,1360001717408,423098408,423102248,3840
1360001724,423108840,6,2401,400.1666667,1360001713504,1360001717408,423098344,423102248,3904
1360001724,423108876,5,643,128.6,1360001722939,1360001723131,423107815,423108007,192
1360001725,423109880,3,492,164,1360001699830,1360001699958,423084710,423084838,128
1360001732,423116840,4,628,157,1360001725023,1360001725279,423109863,423110119,256
1360001732,423116892,1556,2244415,1442.426093,1360001723435,1360001728811,423108327,423113703,5376
1360001741,423125732,3,3009,1003,1360001713227,1360001713355,423097959,423098087,128
1360001741,423125732,5,2355,471,1360001713417,1360001713417,423098149,423098149,0
1360001741,423125736,8,4612,576.5,1360001713414,1360001713606,423098150,423098342,192
1360001741,423125736,6,5084,847.3333333,1360001713477,1360001713605,423098213,423098341,128
1360001741,423125812,6,5084,847.3333333,1360001713273,1360001713337,423098085,423098149,64
1360001749,423134120,9,4208,467.5555556,1360001724230,1360001733958,423109350,423119078,9728
1360001750,3356413492,4,224,56,1360001724326,1360001729126,3356387818,3356392618,4800
1360001753,423138048,8,768,96,1360001724940,1360001734220,423109988,423119268,9280
1360001753,423138148,3,1438,479.3333333,1360001725418,1360001725610,423110566,423110758,192
1360001753,423138148,4,434,108.5,1360001725481,1360001725993,423110629,423111141,512
1360001753,423138172,4,224,56,1360001725649,1360001733777,423110821,423118949,8128
1360001753,423138176,4,224,56,1360001725839,1360001733903,423111015,423119079,8064
1360001754,3356417552,3,288,96,1360001726696,1360001728808,3356390248,3356392360,2112
1360001756,423140844,2,92,46,1360001750041,1360001750041,423134885,423134885,0
1360001764,423148932,6,2401,400.1666667,1360001755843,1360001759299,423140775,423144231,3456
1360001764,423148980,8,5176,647,1360001755860,1360001759316,423140840,423144296,3456
1360001769,423154256,2,96,48,1360001743743,1360001746943,423128999,423132199,3200
1360001780,423164880,22,24998,1136.272727,1360001775091,1360001775283,423159971,423160163,192
1360001780,423164880,29,37611,1296.931034,1360001775095,1360001776119,423159975,423160999,1024
1360001780,423165264,53,67131,1266.622642,1360001774772,1360001775028,423160036,423160292,256
1360001781,423166184,3,3009,1003,1360001755334,1360001755398,423140518,423140582,64
1360001781,423166184,6,5084,847.3333333,1360001755334,1360001755398,423140518,423140582,64
1360001782,423166268,5,2355,471,1360001756314,1360001756378,423140582,423140646,64
1360001782,423166268,8,4612,576.5,1360001756378,1360001756506,423140646,423140774,128
1360001785,423170032,6,5084,847.3333333,1360001755676,1360001755740,423140708,423140772,64
1360001788,423172868,4,190,47.5,1360001774336,1360001780288,423159204,423165156,5952
1360001788,423172868,3,144,48,1360001774336,1360001780288,423159204,423165156,5952
1360001788,423172868,3,144,48,1360001774400,1360001780224,423159268,423165092,5824
1360001788,423172872,3,144,48,1360001774781,1360001780221,423159653,423165093,5440
1360001788,423172896,3,144,48,1360001775332,1360001781348,423160228,423166244,6016
1360001788,423172904,3,144,48,1360001776541,1360001782173,423161445,423167077,5632
1360001788,423172908,5,674,134.8,1360001784922,1360001785114,423169830,423170022,192
1360001788,423172936,4,602,150.5,1360001773949,1360001787069,423158885,423172005,13120
1360001788,423172940,3,144,48,1360001774329,1360001780153,423159269,423165093,5824
1360001788,423172948,5,643,128.6,1360001782895,1360001783023,423167843,423167971,128
1360001788,423172948,3,144,48,1360001774706,1360001780146,423159654,423165094,5440
1360001788,423172948,1433,2097239,1463.530356,1360001775345,1360001781297,423160293,423166245,5952
1360001788,423172948,3,144,48,1360001775215,1360001781167,423160163,423166115,5952
1360001788,423172952,3,144,48,1360001775406,1360001781230,423160358,423166182,5824
1360001790,423174420,3,492,164,1360001765506,1360001765634,423149926,423150054,128
1360001796,423180860,3,138,46,1360001788235,1360001788299,423173095,423173159,64
1360001796,423180864,6,575,95.83333333,1360001774021,1360001794821,423158885,423179685,20800
1360001796,423180904,9,2097,233,1360001773149,1360001790237,423158053,423175141,17088
1360001796,423180908,10,1262,126.2,1360001773336,1360001790232,423158244,423175140,16896
1360001796,423180936,6,575,95.83333333,1360001773949,1360001794941,423158885,423179877,20992
1360001797,423182236,13,7817,601.3076923,1360001772818,1360001776530,423158054,423161766,3712
1360001801,423186168,4,560,140,1360001773718,1360001774038,423158886,423159206,320
1360001801,423186176,15,6354,423.6,1360001774542,1360001797454,423159718,423182630,22912
1360001801,423186240,7,392,56,1360001776716,1360001789836,423161956,423175076,13120
1360001802,423186292,13,1248,96,1360001776705,1360001788289,423160997,423172581,11584
1360001802,423186320,3,273,91,1360001776932,1360001777124,423161252,423161444,192
1360001802,423186328,7,392,56,1360001777502,1360001788702,423161830,423173030,11200
1360001802,3356465572,7,672,96,1360001775828,1360001785236,3356439400,3356448808,9408
1360001802,3356465580,7,392,56,1360001776142,1360001787470,3356439722,3356451050,11328
1360001802,3356465592,4,432,108,1360001774274,1360001774402,3356437866,3356437994,128
1360001804,423188892,8,5176,647,1360001798375,1360001802343,423183267,423187235,3968
1360001804,423188964,7,2447,349.5714286,1360001798242,1360001801314,423183206,423186278,3072
1360001806,423190292,3,1379,459.6666667,1360001779905,1360001780161,423164197,423164453,256
1360001809,423194236,1,46,46,1360001783696,1360001783696,423168932,423168932,0
1360001826,423210412,3,3009,1003,1360001798538,1360001798602,423182950,423183014,64
1360001826,423210412,5,2355,471,1360001798601,1360001798665,423183013,423183077,64
1360001826,423210412,6,5084,847.3333333,1360001798537,1360001798601,423182949,423183013,64
1360001826,423210412,6,5084,847.3333333,1360001798728,1360001798728,423183140,423183140,0
1360001826,423210412,8,4612,576.5,1360001798663,1360001798791,423183075,423183203,128
1360001830,423214304,6,1915,319.1666667,1360001805621,1360001806645,423189925,423190949,1024
1360001833,423218184,3,382,127.3333333,1360001805700,1360001805956,423190884,423191140,256
1360001836,423220948,7,508,72.57142857,1360001827889,1360001835249,423212837,423220197,7360
1360001844,423228912,5,643,128.6,1360001842900,1360001843092,423227812,423228004,192
1360001852,423236920,7,2447,349.5714286,1360001840716,1360001844364,423225636,423229284,3648
1360001852,423236956,6,720,120,1360001844905,1360001846057,423229861,423231013,1152
1360001852,423237004,8,5176,647,1360001840762,1360001844282,423225766,423229286,3520
1360001853,423238208,3,632,210.6666667,1360001827694,1360001827758,423212902,423212966,64
1360001858,423242364,1,46,46,1360001833206,1360001833206,423217570,423217570,0
1360001860,423244908,4,524,131,1360001838744,1360001853976,423223652,423238884,15232
1360001861,423246268,1,46,46,1360001834098,1360001834098,423219366,423219366,0
1360001866,423250276,8,4612,576.5,1360001841234,1360001841362,423225510,423225638,128
1360001866,423250300,5,2355,471,1360001841145,1360001841209,423225445,423225509,64
1360001866,423250384,3,3004,1001.333333,1360001840932,1360001841060,423225316,423225444,128
1360001866,423250384,6,5084,847.3333333,1360001840995,1360001841059,423225379,423225443,64
1360001866,423250388,6,5084,847.3333333,1360001841185,1360001841185,423225573,423225573,0
1360001869,423254264,2,154,77,1360001842482,1360001857650,423227746,423242914,15168
1360001874,423258300,3,492,164,1360001846582,1360001846710,423230882,423231010,128
1360001892,423276904,8,5176,647,1360001883357,1360001887389,423268261,423272293,4032
1360001892,423276944,7,976,139.4285714,1360001868787,1360001884851,423253731,423269795,16064
1360001892,423276952,7,2447,349.5714286,1360001883244,1360001886316,423268196,423271268,3072
1360001900,423284912,143,197282,1379.594406,1360001776341,1360001894869,423161253,423279781,118528
1360001908,423292880,5,643,128.6,1360001902963,1360001903091,423287843,423287971,128
1360001908,423292924,6,720,120,1360001904902,1360001906758,423289826,423291682,1856
1360001910,423294536,3,3004,1001.333333,1360001883275,1360001883339,423267811,423267875,64
1360001910,423294616,6,5084,847.3333333,1360001883259,1360001883323,423267875,423267939,64
1360001910,423294616,5,2355,471,1360001883322,1360001883386,423267938,423268002,64
1360001910,423294616,8,4612,576.5,1360001883386,1360001883578,423268002,423268194,192
1360001910,423294620,6,5084,847.3333333,1360001883449,1360001883513,423268069,423268133,64
1360001914,423298588,3,492,164,1360001886424,1360001886616,423271012,423271204,192
1360001914,423298652,1,77,77,1360001888536,1360001888536,423273188,423273188,0
1360001916,423300888,6,497,82.83333333,1360001910059,1360001912427,423294947,423297315,2368
1360001918,3356581592,2,92,46,1360001890178,1360001890178,3356553770,3356553770,0
1360001918,423302624,1,46,46,1360001890099,1360001890099,423274723,423274723,0
1360001918,423302700,2,92,46,1360001892070,1360001892070,423276770,423276770,0
1360001924,423308984,3,138,46,1360001921932,1360001921932,423306916,423306916,0
1360001926,423310580,2,574,287,1360001898016,1360001898080,423282596,423282660,64
1360001932,423316984,8,5176,647,1360001925834,1360001929290,423310818,423314274,3456
1360001932,423316988,7,2447,349.5714286,1360001925769,1360001929289,423310757,423314277,3520
1360001938,423322652,1,46,46,1360001910294,1360001910294,423294946,423294946,0
1360001948,423333008,3,144,48,1360001940594,1360001945650,423325602,423330658,5056
1360001950,423334672,5,2355,471,1360001925763,1360001925827,423310435,423310499,64
1360001950,423334724,3,3004,1001.333333,1360001925647,1360001925711,423310371,423310435,64
1360001950,423334724,6,5084,847.3333333,1360001925646,1360001925710,423310370,423310434,64
1360001954,423338596,9,4658,517.5555556,1360001925903,1360001926159,423310499,423310755,256
1360001954,423338612,6,1946,324.3333333,1360001927168,1360001941120,423311780,423325732,13952
1360001954,423338680,6,5084,847.3333333,1360001925882,1360001925946,423310562,423310626,64
1360001964,423348912,5,655,131,1360001962897,1360001963409,423347809,423348321,512
1360001972,423356908,6,720,120,1360001964950,1360001966102,423349858,423351010,1152
1360001980,423364960,2,98,49,1360001973344,1360001978464,423358304,423363424,5120
1360001980,423365040,3,144,48,1360001973264,1360001978448,423358304,423363488,5184
1360001980,423365040,6,2401,400.1666667,1360001968210,1360001972178,423353250,423357218,3968
1360001980,423365040,8,5176,647,1360001968273,1360001972241,423353313,423357281,3968
1360001994,423378784,3,3004,1001.333333,1360001968144,1360001968208,423352928,423352992,64
1360001994,423378784,6,5084,847.3333333,1360001968144,1360001968208,423352928,423352992,64
1360001994,423378784,5,2355,471,1360001968275,1360001968275,423353059,423353059,0
1360001994,423378784,8,4612,576.5,1360001968273,1360001968465,423353057,423353249,192
1360001994,423378912,6,5084,847.3333333,1360001968209,1360001968273,423353121,423353185,64
1360001994,423378916,1,46,46,1360001968717,1360001968717,423353633,423353633,0
1360001998,423382744,7,1391,198.7142857,1360001972665,1360001973177,423357409,423357921,512
1360002006,423390740,3,492,164,1360001980348,1360001980476,423365088,423365216,128
1360002020,423405004,7,2447,349.5714286,1360002010676,1360002014260,423395680,423399264,3584
1360002020,423405004,7,5130,732.8571429,1360002010742,1360002014262,423395746,423399266,3520
1360002028,423413004,5,643,128.6,1360002022837,1360002022965,423407841,423407969,128
1360002028,423413048,5,674,134.8,1360002024779,1360002024971,423409827,423410019,192
1360002030,423414784,3,604,201.3333333,1360002004627,1360002004947,423389411,423389731,320
1360002030,423414856,16,4830,301.875,1360002003851,1360002029323,423388707,423414179,25472
1360002036,423421048,1257,1744150,1387.549722,1360002027786,1360002031242,423412834,423416290,3456
1360002038,423422800,6,5084,847.3333333,1360002010624,1360002010688,423395424,423395488,64
1360002038,423422800,5,2355,471,1360002010688,1360002010752,423395488,423395552,64
1360002038,423422824,8,4612,576.5,1360002010729,1360002010857,423395553,423395681,128
1360002038,423422824,2,92,46,1360002012905,1360002012969,423397729,423397793,64
1360002038,423422828,6,5084,847.3333333,1360002010788,1360002010852,423395616,423395680,64
1360002038,423422904,3,3009,1003,1360002010522,1360002010586,423395426,423395490,64
1360002042,423426880,4,672,168,1360002017711,1360002017839,423402591,423402719,128
1360002046,423430868,3,492,164,1360002020095,1360002020223,423404963,423405091,128
1360002054,423438896,2,192,96,1360002028963,1360002030371,423413859,423415267,1408
1360002054,3356717988,1,96,96,1360002029813,1360002029813,3356693801,3356693801,0
1360002058,3356721868,1,56,56,1360002030126,1360002030126,3356693994,3356693994,0
1360002060,423445012,6,2401,400.1666667,1360002053102,1360002056238,423438114,423441250,3136
1360002060,423445068,8,5176,647,1360002053107,1360002056179,423438175,423441247,3072
1360002074,423459032,2,92,46,1360002046295,1360002046359,423431327,423431391,64
1360002078,423462980,3,3009,1003,1360002052879,1360002052943,423437859,423437923,64
1360002078,423462980,5,2355,471,1360002052942,1360002053006,423437922,423437986,64
1360002078,423462980,6,5084,847.3333333,1360002053068,1360002053132,423438048,423438112,64
1360002078,423462980,8,4612,576.5,1360002053003,1360002053131,423437983,423438111,128
1360002078,423463064,6,5084,847.3333333,1360002052791,1360002052855,423437855,423437919,64
1360002084,423469032,5,643,128.6,1360002082776,1360002082968,423467808,423468000,192
1360002086,423471084,3,492,164,1360002060645,1360002060773,423445729,423445857,128
1360002092,423477028,5,674,134.8,1360002085083,1360002085275,423470111,423470303,192
1360002100,423485024,2,92,46,1360002087842,1360002092898,423472866,423477922,5056
1360002125,423509424,3,138,46,1360002120504,1360002120568,423504928,423504992,64
1360002126,423511052,3,492,164,1360002101700,1360002101828,423486752,423486880,128
1360002148,423533104,5,643,128.6,1360002142735,1360002142927,423527839,423528031,192
1360002148,423533148,6,720,120,1360002144677,1360002145893,423529825,423531041,1216
1360002148,423533188,3,144,48,1360002138555,1360002143739,423523743,423528927,5184
1360002156,423541144,6,503,83.83333333,1360002150822,1360002153190,423535966,423538334,2368
1360002156,423541148,11,3428,311.6363636,1360002138530,1360002154786,423523678,423539934,16256
1360002158,423543040,2,92,46,1360002132817,1360002132881,423517857,423517921,64
1360002170,423555060,3,492,164,1360002142522,1360002142650,423527582,423527710,128
1360002178,423563056,1,46,46,1360002150911,1360002150911,423535967,423535967,0
1360002204,423589116,5,643,128.6,1360002202690,1360002202882,423587806,423587998,192
1360002207,423591784,1,46,46,1360002179534,1360002179534,423564318,423564318,0
1360002207,423591828,1,46,46,1360002179492,1360002179492,423564320,423564320,0
1360002207,423591864,1,46,46,1360002179455,1360002179455,423564319,423564319,0
1360002207,423591900,1,46,46,1360002179484,1360002179484,423564384,423564384,0
1360002207,423591936,1,46,46,1360002179447,1360002179447,423564383,423564383,0
1360002208,423592704,1,46,46,1360002179680,1360002179680,423564384,423564384,0
1360002208,423592728,1,46,46,1360002179719,1360002179719,423564447,423564447,0
1360002208,423592772,1,46,46,1360002179674,1360002179674,423564446,423564446,0
1360002210,423595148,3,492,164,1360002182180,1360002182308,423567328,423567456,128
1360002212,423597176,6,720,120,1360002204677,1360002205829,423589853,423591005,1152
1360002244,423629096,1258,1834244,1458.063593,1360002238037,1360002241493,423623133,423626589,3456
1360002250,423635184,3,492,164,1360002222080,1360002222272,423607264,423607456,192
1360002252,423637220,3,144,48,1360002239386,1360002245018,423624606,423630238,5632
1360002266,3356930188,3,288,96,1360002238895,1360002241391,3356903083,3356905579,2496
1360002266,3356930188,2,112,56,1360002239087,1360002240751,3356903275,3356904939,1664
1360002266,423651160,5,480,96,1360002238804,1360002241300,423623964,423626460,2496
1360002266,423651240,3,168,56,1360002238469,1360002240901,423623709,423626141,2432
1360002266,423651244,3,168,56,1360002238532,1360002241092,423623776,423626336,2560
1360002267,423651272,7,6389,912.7142857,1360002240140,1360002240588,423624412,423624860,448
1360002268,423653176,5,674,134.8,1360002264648,1360002264840,423649824,423650016,192
1360002268,423653212,5,643,128.6,1360002262691,1360002262819,423647903,423648031,128
1360002290,423675240,3,492,164,1360002262533,1360002262661,423647773,423647901,128
1360002292,423677136,4,190,47.5,1360002276142,1360002291118,423661278,423676254,14976
1360002292,423677148,3,144,48,1360002276770,1360002291618,423661918,423676766,14848
1360002292,423677228,3,144,48,1360002276690,1360002291602,423661918,423676830,14912
1360002292,423677272,2,98,49,1360002276645,1360002291237,423661917,423676509,14592
1360002302,423687180,7,1369,195.5714286,1360002275843,1360002276419,423661023,423661599,576
1360002323,423707328,1,46,46,1360002297621,1360002297621,423681949,423681949,0
1360002324,423709240,5,643,128.6,1360002322563,1360002322755,423707803,423707995,192
1360002330,423715260,3,492,164,1360002302704,1360002302896,423687964,423688156,192
1360002332,423717248,5,674,134.8,1360002324606,1360002324798,423709854,423710046,192
1360002340,423725160,7,2425,346.4285714,1360002335571,1360002339091,423720731,423724251,3520
1360002340,423725164,7,5130,732.8571429,1360002335634,1360002339090,423720798,423724254,3456
1360002357,423741268,2,92,46,1360002355663,1360002355663,423739931,423739931,0
1360002362,423747212,6,5084,847.3333333,1360002335455,1360002335519,423720667,423720731,64
1360002363,423747324,4,3040,760,1360002336026,1360002336218,423720350,423720542,192
1360002363,423747324,6,5084,847.3333333,1360002336153,1360002336217,423720477,423720541,64
1360002363,423747324,5,2333,466.6,1360002336216,1360002336280,423720540,423720604,64
1360002363,423747324,8,4568,571,1360002336279,1360002336407,423720603,423720731,128
1360002370,423755244,3,492,164,1360002342913,1360002343041,423728157,423728285,128
1360002388,423773188,7,2425,346.4285714,1360002378106,1360002382138,423763294,423767326,4032
1360002388,423773196,5,643,128.6,1360002382638,1360002382894,423767834,423768090,256
1360002388,423773240,6,720,120,1360002384580,1360002385796,423769820,423771036,1216
1360002388,423773268,7,5130,732.8571429,1360002378088,1360002381992,423763356,423767260,3904
1360002396,423781232,6,498,83,1360002391690,1360002394122,423776922,423779354,2432
1360002397,423781288,3,138,46,1360002392635,1360002392699,423776923,423776987,64
1360002403,423787388,8,4568,571,1360002378714,1360002378906,423763102,423763294,192
1360002403,423787436,3,3009,1003,1360002378472,1360002378536,423762908,423762972,64
1360002403,423787436,6,5084,847.3333333,1360002378471,1360002378535,423762907,423762971,64
1360002403,423787436,5,2333,466.6,1360002378599,1360002378663,423763035,423763099,64
1360002405,423789328,3,144,48,1360002394453,1360002399509,423778781,423783837,5056
1360002407,423791284,6,5084,847.3333333,1360002378879,1360002378943,423763163,423763227,64
1360002411,423795284,3,492,164,1360002383616,1360002383808,423767900,423768092,192
1360002419,423803348,1,46,46,1360002392574,1360002392574,423776922,423776922,0
1360002428,423813232,7,2425,346.4285714,1360002420555,1360002424075,423805787,423809307,3520
1360002429,423813316,7,5130,732.8571429,1360002421536,1360002424928,423805852,423809244,3392
1360002444,423829224,5,643,128.6,1360002442645,1360002442773,423827869,423827997,128
1360002447,423831348,3,3004,1001.333333,1360002421119,1360002421183,423805467,423805531,64
1360002447,423831348,6,5084,847.3333333,1360002421119,1360002421183,423805467,423805531,64
1360002447,423831348,5,2333,466.6,1360002421181,1360002421245,423805529,423805593,64
1360002447,423831352,6,5084,847.3333333,1360002421306,1360002421370,423805658,423805722,64
1360002447,423831456,7,4522,646,1360002421138,1360002421266,423805594,423805722,128
1360002451,423835448,3,492,164,1360002423708,1360002423836,423808156,423808284,128
1360002453,423837312,5,674,134.8,1360002445540,1360002445732,423829852,423830044,192
1360002460,423845224,5,576,115.2,1360002438418,1360002453714,423823642,423838938,15296
1360002468,423853256,1030,1422604,1381.168932,1360002458803,1360002466803,423844059,423852059,8000
1360002468,423853260,6,2379,396.5,1360002463151,1360002467055,423848411,423852315,3904
1360002469,423853360,8,5176,647,1360002464181,1360002467893,423848541,423852253,3712
1360002487,423871464,9,864,96,1360002460875,1360002467467,423845339,423851931,6592
1360002487,423871468,5,280,56,1360002461062,1360002469190,423845530,423853658,8128
1360002487,423871472,4,224,56,1360002461124,1360002465732,423845596,423850204,4608
1360002487,3357150504,5,280,56,1360002460700,1360002466524,3357124204,3357130028,5824
1360002487,3357150520,4,384,96,1360002461261,1360002465997,3357124781,3357129517,4736
1360002491,423875404,3,3009,1003,1360002463495,1360002463559,423847899,423847963,64
1360002491,423875404,5,4598,919.6,1360002463558,1360002463622,423847962,423848026,64
1360002491,423875512,5,2333,466.6,1360002463514,1360002463642,423848026,423848154,128
1360002491,423875512,8,4568,571,1360002463641,1360002463897,423848153,423848409,256
1360002491,423875516,4,3098,774.5,1360002463768,1360002463832,423848284,423848348,64
1360002491,423875520,3,492,164,1360002464083,1360002464211,423848603,423848731,128
1360002509,423893340,5,674,134.8,1360002505608,1360002505736,423889948,423890076,128
1360002509,423893376,5,643,128.6,1360002503459,1360002503587,423887835,423887963,128
1360002511,423895540,4,656,164,1360002485248,1360002485504,423869788,423870044,256
1360002517,423901372,6,2379,396.5,1360002506599,1360002509863,423890971,423894235,3264
1360002517,423901372,8,5176,647,1360002506663,1360002509927,423891035,423894299,3264
1360002531,423915504,3,492,164,1360002504098,1360002504290,423888602,423888794,192
1360002531,423915544,6,5084,847.3333333,1360002506171,1360002506235,423890715,423890779,64
1360002531,423915560,5,2333,466.6,1360002506220,1360002506284,423890780,423890844,64
1360002531,423915560,3,3009,1003,1360002506153,1360002506217,423890713,423890777,64
1360002531,423915564,8,4568,571,1360002506279,1360002506407,423890843,423890971,128
1360002531,423915564,6,5084,847.3333333,1360002506343,1360002506407,423890907,423890971,64
1360002541,423925416,3,144,48,1360002529338,1360002534394,423913754,423918810,5056
1360002543,423927664,1,46,46,1360002518402,1360002518402,423903066,423903066,0
1360002557,423941300,7,2425,346.4285714,1360002549166,1360002552942,423933466,423937242,3776
1360002557,423941368,7,5130,732.8571429,1360002549160,1360002552872,423933528,423937240,3712
1360002565,423949384,5,643,128.6,1360002563483,1360002563675,423947867,423948059,192
1360002571,423955640,3,492,164,1360002543258,1360002543386,423927898,423928026,128
1360002573,423957328,5,674,134.8,1360002565521,1360002565777,423949849,423950105,256
1360002575,423959580,8,4568,571,1360002548695,1360002548887,423933275,423933467,192
1360002575,423959580,6,5084,847.3333333,1360002548758,1360002548822,423933338,423933402,64
1360002575,423959664,3,3009,1003,1360002548483,1360002548547,423933147,423933211,64
1360002575,423959664,5,2333,466.6,1360002548544,1360002548608,423933208,423933272,64
1360002575,423959752,6,5084,847.3333333,1360002548394,1360002548458,423933146,423933210,64
1360002589,423973440,3,144,48,1360002577825,1360002582881,423962265,423967321,5056
1360002597,423981336,45,53186,1181.911111,1360002589643,1360002589963,423973979,423974299,320
1360002597,423981336,2,98,49,1360002589706,1360002595274,423974042,423979610,5568
1360002597,423981336,44,50696,1152.181818,1360002589768,1360002590408,423974104,423974744,640
1360002597,423981356,3,144,48,1360002589811,1360002595251,423974167,423979607,5440
1360002597,423981356,3,144,48,1360002589875,1360002595315,423974231,423979671,5440
1360002597,423981412,7,2425,346.4285714,1360002591740,1360002594876,423976152,423979288,3136
1360002597,423981416,8,5176,647,1360002591866,1360002595898,423976282,423980314,4032
1360002597,423981416,52,63690,1224.807692,1360002589624,1360002590392,423974040,423974808,768
1360002603,423987616,7,1199,171.2857143,1360002577136,1360002577328,423961752,423961944,192
1360002611,423995676,3,492,164,1360002583540,1360002583668,423968216,423968344,128
1360002615,423999588,6,4644,774,1360002588942,1360002589454,423973530,423974042,512
1360002615,423999664,2,112,56,1360002590143,1360002591807,423974807,423976471,1664
1360002619,3357282556,2,192,96,1360002591082,1360002594730,3357254638,3357258286,3648
1360002619,3357282568,2,112,56,1360002591328,1360002595744,3357254896,3357259312,4416
1360002619,424003608,4,384,96,1360002590905,1360002596793,423975513,423981401,5888
1360002619,424003608,3,3009,1003,1360002591032,1360002591096,423975640,423975704,64
1360002619,424003608,6,5084,847.3333333,1360002591031,1360002591159,423975639,423975767,128
1360002619,424003612,6,5084,847.3333333,1360002591411,1360002591475,423976023,423976087,64
1360002619,424003620,1,56,56,1360002591726,1360002591726,423976346,423976346,0
1360002619,424003692,5,2333,466.6,1360002591075,1360002591203,423975767,423975895,128
1360002619,424003696,8,4568,571,1360002591266,1360002591458,423975962,423976154,192
1360002629,424013328,5,643,128.6,1360002623502,1360002623694,424007830,424008022,192
1360002629,424013372,6,720,120,1360002625444,1360002627044,424009816,424011416,1600
1360002637,424021316,765,1036412,1354.786928,1360002631774,1360002635742,424016090,424020058,3968
1360002645,424029388,7,2425,346.4285714,1360002634325,1360002637909,424018713,424022297,3584
1360002645,424029388,7,5130,732.8571429,1360002634389,1360002637845,424018777,424022233,3456
1360002651,424035656,3,492,164,1360002623559,1360002623751,424008215,424008407,192
1360002659,424043712,3,2058,686,1360002632718,1360002632782,424017430,424017494,64
1360002659,424043720,5,4598,919.6,1360002633672,1360002633736,424018392,424018456,64
1360002659,424043720,5,2333,466.6,1360002633735,1360002633799,424018455,424018519,64
1360002659,424043720,7,4522,646,1360002633799,1360002633991,424018519,424018711,192
1360002659,424043724,5,4598,919.6,1360002633926,1360002633926,424018650,424018650,0
1360002659,424043832,1,46,46,1360002633432,1360002633432,424018264,424018264,0
1360002659,424043836,3,2999,999.6666667,1360002633558,1360002633622,424018394,424018458,64
1360002661,424045476,6,501,83.5,1360002642301,1360002653885,424026777,424038361,11584
1360002663,424047672,3,168,56,1360002634873,1360002653625,424019545,424038297,18752
1360002663,424047680,3,168,56,1360002635375,1360002653679,424020055,424038359,18304
1360002663,3357326792,3,288,96,1360002637503,1360002654591,3357301295,3357318383,17088
1360002663,424047800,6,576,96,1360002635958,1360002657718,424020758,424042518,21760
1360002667,3357330764,3,168,56,1360002641945,1360002657689,3357305709,3357321453,15744
1360002669,424053456,52,56042,1077.730769,1360002653904,1360002668176,424038360,424052632,14272
1360002671,424055792,1,46,46,1360002642943,1360002642943,424027735,424027735,0
1360002671,424055828,1,46,46,1360002643611,1360002643611,424028439,424028439,0
1360002675,424059740,1,46,46,1360002649395,1360002649395,424034135,424034135,0
1360002675,424059828,1,46,46,1360002648539,1360002648539,424033367,424033367,0
1360002677,424061396,3,138,46,1360002669006,1360002673422,424053402,424057818,4416
1360002679,424063808,1,46,46,1360002651376,1360002651376,424036184,424036184,0
1360002685,424069316,8,5176,647,1360002676957,1360002680989,424061273,424065305,4032
1360002685,424069360,7,2425,346.4285714,1360002676785,1360002679921,424061145,424064281,3136
1360002685,424069396,5,643,128.6,1360002683466,1360002683594,424067862,424067990,128
1360002691,424075708,1,56,56,1360002663445,1360002663445,424048153,424048153,0
1360002691,424075708,1,56,56,1360002663571,1360002663571,424048279,424048279,0
1360002691,424075708,1,96,96,1360002663762,1360002663762,424048470,424048470,0
1360002691,3357354764,1,96,96,1360002663833,1360002663833,3357327597,3357327597,0
1360002691,424075784,4,544,136,1360002663110,1360002663558,424047894,424048342,448
1360002693,424077408,5,674,134.8,1360002685440,1360002685632,424069848,424070040,192
1360002701,424085324,3,138,46,1360002693650,1360002693714,424077974,424078038,64
1360002703,424087752,6,5084,847.3333333,1360002676198,1360002676198,424060950,424060950,0
1360002703,424087756,8,4568,571,1360002676260,1360002676388,424061016,424061144,128
1360002703,424087756,6,5084,847.3333333,1360002676323,1360002676387,424061079,424061143,64
1360002703,424087948,3,3004,1001.333333,1360002675941,1360002676005,424060889,424060953,64
1360002703,424087948,5,2333,466.6,1360002676002,1360002676066,424060950,424061014,64
1360002715,424099872,1,46,46,1360002688045,1360002688045,424072917,424072917,0
1360002725,424109324,7,2425,346.4285714,1360002719316,1360002722964,424103640,424107288,3648
1360002725,424109324,8,5176,647,1360002719443,1360002722963,424103767,424107287,3520
1360002731,424115780,3,492,164,1360002704076,1360002704268,424088856,424089048,192
1360002743,424127876,6,5084,847.3333333,1360002718505,1360002718569,424103381,424103445,64
1360002743,424127876,5,2333,466.6,1360002718572,1360002718636,424103448,424103512,64
1360002743,424127960,3,3009,1003,1360002718424,1360002718488,424103384,424103448,64
1360002743,424127960,8,4568,571,1360002718550,1360002718678,424103510,424103638,128
1360002743,424127960,6,5084,847.3333333,1360002718614,1360002718614,424103574,424103574,0
1360002749,424133436,5,643,128.6,1360002743394,1360002743522,424127830,424127958,128
1360002749,424133488,6,720,120,1360002745328,1360002746544,424129816,424131032,1216
1360002757,424141448,6,636,106,1360002739542,1360002755478,424123990,424139926,15936
1360002765,424149368,1590,2272213,1429.06478,1360002757031,1360002763431,424141399,424147799,6400
1360002765,424149420,7,5130,732.8571429,1360002761780,1360002764852,424146200,424149272,3072
1360002765,424149492,6,2379,396.5,1360002761644,1360002764780,424146136,424149272,3136
1360002771,424155948,3,492,164,1360002744352,1360002744480,424129300,424129428,128
1360002783,3357446836,7,392,56,1360002757138,1360002762962,3357420974,3357426798,5824
1360002783,3357446852,6,576,96,1360002757762,1360002762626,3357421614,3357426478,4864
1360002783,424167848,13,1248,96,1360002757125,1360002764421,424141973,424149269,7296
1360002783,424167876,6,336,56,1360002757353,1360002762153,424142229,424147029,4800
1360002783,424167880,4,2428,607,1360002757797,1360002758053,424142677,424142933,256
1360002783,424167884,6,336,56,1360002757667,1360002762275,424142551,424147159,4608
1360002787,424171852,6,5084,847.3333333,1360002761024,1360002761088,424145876,424145940,64
1360002787,424171856,5,2333,466.6,1360002761087,1360002761151,424145943,424146007,64
1360002787,424171856,3,3009,1003,1360002760958,1360002761022,424145814,424145878,64
1360002787,424171856,8,4568,571,1360002761148,1360002761276,424146004,424146132,128
1360002787,424171936,6,5084,847.3333333,1360002761135,1360002761199,424146071,424146135,64
1360002791,424175912,1,46,46,1360002764360,1360002764360,424149272,424149272,0
1360002805,424189476,5,643,128.6,1360002803387,1360002803515,424187863,424187991,128
1360002811,424195888,3,492,164,1360002784669,1360002784861,424169557,424169749,192
1360002813,424197420,6,720,120,1360002805427,1360002806643,424189847,424191063,1216
1360002813,424197424,7,2425,346.4285714,1360002804143,1360002807855,424188567,424192279,3712
1360002813,424197500,8,5176,647,1360002804128,1360002807776,424188628,424192276,3648
1360002831,424215912,6,5084,847.3333333,1360002803398,1360002803462,424188310,424188374,64
1360002831,424215996,3,3009,1003,1360002803314,1360002803378,424188310,424188374,64
1360002831,424215996,8,4568,571,1360002803442,1360002803570,424188438,424188566,128
1360002831,424215996,5,2333,466.6,1360002803377,1360002803441,424188373,424188437,64
1360002831,424215996,6,5084,847.3333333,1360002803504,1360002803568,424188500,424188564,64
1360002839,424223920,1,46,46,1360002813372,1360002813372,424198292,424198292,0
1360002851,424235952,3,492,164,1360002824731,1360002824859,424209683,424209811,128
1360002853,424237576,6,2379,396.5,1360002846420,1360002849684,424230996,424234260,3264
1360002853,424237576,8,5176,647,1360002846547,1360002849683,424231123,424234259,3136
1360002861,424245584,3,144,48,1360002849483,1360002855307,424234067,424239891,5824
1360002869,424253536,5,643,128.6,1360002863294,1360002863486,424247830,424248022,192
1360002869,424253576,5,674,134.8,1360002865300,1360002865428,424249876,424250004,128
1360002871,424255996,6,5084,847.3333333,1360002845745,1360002845809,424230741,424230805,64
1360002871,424256000,3,3009,1003,1360002845741,1360002845805,424230741,424230805,64
1360002871,424256004,6,5084,847.3333333,1360002845928,1360002845992,424230932,424230996,64
1360002871,424256084,8,4568,571,1360002845786,1360002845914,424230870,424230998,128
1360002871,424256084,5,2333,466.6,1360002845721,1360002845785,424230805,424230869,64
1360002871,424256084,33,33648,1019.636364,1360002844312,1360002849624,424229396,424234708,5312
1360002875,424259980,4,2698,674.5,1360002849090,1360002849666,424234070,424234646,576
1360002875,424259980,6,3639,606.5,1360002849090,1360002849858,424234070,424234838,768
1360002875,424259980,32,41434,1294.8125,1360002849090,1360002849474,424234070,424234454,384
1360002875,424259988,2,112,56,1360002850040,1360002872888,424235028,424257876,22848
1360002875,3357539032,7,5561,794.4285714,1360002849040,1360002849488,3357513072,3357513520,448
1360002875,424260068,5,2256,451.2,1360002849001,1360002849129,424234069,424234197,128
1360002875,424260068,6,3818,636.3333333,1360002848999,1360002849575,424234067,424234643,576
1360002875,424260068,6,3301,550.1666667,1360002848999,1360002849703,424234067,424234771,704
1360002875,424260068,42,56019,1333.785714,1360002848999,1360002849447,424234067,424234515,448
1360002875,424260076,2,112,56,1360002849889,1360002868769,424234965,424253845,18880
1360002877,424261580,3,325,108.3333333,1360002863249,1360002869329,424247829,424253909,6080
1360002877,424261644,2,92,46,1360002873231,1360002873231,424257875,424257875,0
1360002879,424263956,3,288,96,1360002851223,1360002877015,424236179,424261971,25792
1360002879,3357543088,2,192,96,1360002854746,1360002877402,3357518834,3357541490,22656
1360002887,424271948,4,902,225.5,1360002862881,1360002863073,424247829,424248021,192
1360002891,3357555016,1,56,56,1360002862944,1360002862944,3357526960,3357526960,0
1360002893,424277600,6,2379,396.5,1360002888956,1360002892668,424273556,424277268,3712
1360002893,424277600,8,5176,647,1360002889019,1360002892667,424273619,424277267,3648
1360002903,424288004,8,2583,322.875,1360002877032,1360002877480,424262036,424262484,448
1360002915,424300236,6,5084,847.3333333,1360002888063,1360002888127,424273299,424273363,64
1360002915,424300236,5,2333,466.6,1360002888126,1360002888126,424273362,424273362,0
1360002915,424300236,8,4568,571,1360002888126,1360002888318,424273362,424273554,192
1360002915,424300252,6,5084,847.3333333,1360002888177,1360002888241,424273429,424273493,64
1360002916,424300348,3,3004,1001.333333,1360002888888,1360002889016,424273236,424273364,128
1360002917,424301592,6,498,83,1360002911364,1360002913732,424295956,424298324,2368
1360002923,424308228,3,138,46,1360002896008,1360002896072,424281236,424281300,64
1360002925,424309628,5,643,128.6,1360002923231,1360002923359,424307859,424307987,128
1360002928,424312408,3,138,46,1360002901820,1360002901884,424286228,424286292,64
1360002932,424316296,3,492,164,1360002903850,1360002903978,424288146,424288274,128
1360002932,424316300,2,92,46,1360002903913,1360002903977,424288213,424288277,64
1360002932,424316380,3,138,46,1360002903831,1360002903895,424288211,424288275,64
1360002933,424317660,6,720,120,1360002925184,1360002926336,424309844,424310996,1152
1360002936,424320364,1,46,46,1360002911590,1360002911590,424295954,424295954,0
1360002940,424324320,3,138,46,1360002914900,1360002914964,424299220,424299284,64
1360002941,424325632,8,5176,647,1360002931419,1360002934619,424316051,424319251,3200
1360002941,424325680,3,144,48,1360002934122,1360002939178,424318802,424323858,5056
1360002941,424325716,6,2379,396.5,1360002931272,1360002934536,424315988,424319252,3264
1360002956,424340324,5,2333,466.6,1360002931472,1360002931472,424315796,424315796,0
1360002956,424340348,6,5084,847.3333333,1360002931513,1360002931577,424315861,424315925,64
1360002956,424340432,8,4568,571,1360002931362,1360002931554,424315794,424315986,192
1360002956,424340432,3,3004,1001.333333,1360002931234,1360002931298,424315666,424315730,64
1360002956,424340432,6,5084,847.3333333,1360002931298,1360002931362,424315730,424315794,64
1360002968,424352476,3,492,164,1360002943479,1360002943607,424327955,424328083,128
1360002973,424357576,4,184,46,1360002965267,1360002971219,424349843,424355795,5952
1360002973,424357656,3,138,46,1360002965185,1360002970625,424349841,424355281,5440
1360002989,424373616,3,144,48,1360002980843,1360002986475,424365459,424371091,5632
1360002989,424373624,5,643,128.6,1360002983203,1360002983395,424367827,424368019,192
1360002989,424373668,6,720,120,1360002985206,1360002986358,424369874,424371026,1152
1360002989,424373672,3,144,48,1360002980785,1360002986417,424365457,424371089,5632
1360002991,3357655168,2,92,46,1360002964680,1360002964680,3357628848,3357628848,0
1360002992,424376408,3,604,201.3333333,1360002965755,1360002966011,424350163,424350419,256
1360002997,424381584,5,466,93.2,1360002980426,1360002996554,424365010,424381138,16128
1360002997,424381584,6,2774,462.3333333,1360002980426,1360002996554,424365010,424381138,16128
1360002997,424381584,5,465,93,1360002980425,1360002996553,424365009,424381137,16128
1360002997,424381656,5,465,93,1360002980356,1360002996484,424365012,424381140,16128
1360003008,424392580,2,446,223,1360002983375,1360002983503,424367955,424368083,128
1360003029,424413612,7,1653,236.1428571,1360003019952,1360003028464,424404564,424413076,8512
1360003029,424413700,3,138,46,1360003028375,1360003028439,424413075,424413139,64
1360003052,424436436,4,538,134.5,1360003024157,1360003027997,424408593,424412433,3840
1360003056,424440544,1,46,46,1360003027952,1360003027952,424412496,424412496,0
1360003069,424453612,6,2046,341,1360003063981,1360003067821,424448593,424452433,3840
1360003100,424484696,2,800,400,1360003071832,1360003080024,424456528,424464720,8192
1360003124,424508732,1,400,400,1360003096307,1360003096307,424481039,424481039,0
1360003156,424540832,1,400,400,1360003128911,1360003128911,424513743,424513743,0
1360003229,424613832,4,184,46,1360003221005,1360003228045,424605837,424612877,7040
1360003260,424645256,1,46,46,1360003235621,1360003235621,424620877,424620877,0
1360003473,424857728,2,122,61,1360003446321,1360003446513,424831049,424831241,192
1360003846,425230400,1,46,46,1360003819124,1360003819124,425203524,425203524,0
1360004009,425394216,1,48,48,1360003979908,1360003979908,425365124,425365124,0
1360005291,426676128,1,46,46,1360005264391,1360005264391,426649519,426649519,0
1360005421,3360084968,1,46,46,1360005392673,1360005392673,3360056641,3360056641,0
1360006152,427537244,1,46,46,1360006126277,1360006126277,427511521,427511521,0
1360007096,428481156,1,46,46,1360007069838,1360007069838,428454994,428454994,0
1360007706,429090892,1,46,46,1360007681487,1360007681487,429066379,429066379,0
1360007754,429138952,1,48,48,1360007727826,1360007727826,429112778,429112778,0
1360009118,430502320,1,46,46,1360009091060,1360009091060,430475380,430475380,0
1360009118,430502320,1,46,46,1360009091378,1360009091378,430475698,430475698,0
1360009234,430618988,1,46,46,1360009207254,1360009207254,430592242,430592242,0
1360009370,430754964,1,46,46,1360009345259,1360009345259,430730223,430730223,0
1360009426,430811024,1,46,46,1360009398319,1360009398319,430783343,430783343,0
1360009450,430835068,1,48,48,1360009422529,1360009422529,430807597,430807597,0
1360009855,431240188,1,46,46,1360009827076,1360009827076,431212264,431212264,0
1360009919,431304040,1,46,46,1360009893335,1360009893335,431278375,431278375,0
1360010168,431552320,1,46,46,1360010140516,1360010140516,431524836,431524836,0
1360010208,431592392,1,46,46,1360010182746,1360010182746,431567138,431567138,0
1360010244,431628556,1,46,46,1360010218998,1360010218998,431603554,431603554,0
1360010621,432005424,1,46,46,1360010595123,1360010595123,431979547,431979547,0
1360010885,432269776,1,46,46,1360010860559,1360010860559,432245335,432245335,0
1360011618,433003172,1,46,46,1360011591097,1360011591097,432976269,432976269,0
1360011960,433345144,1,46,46,1360011934798,1360011934798,433319942,433319942,0
1360011989,3366652888,1,46,46,1360011962524,1360011962524,3366626412,3366626412,0
1360012199,433583420,1,46,46,1360012172001,1360012172001,433556421,433556421,0
1360012850,434234668,3,138,46,1360012822493,1360012824861,434207161,434209529,2368
1360013111,434495288,2,122,61,1360013085013,1360013087509,434469301,434471797,2496
1360013291,434675532,1,148,148,1360013262878,1360013262878,434647410,434647410,0
1360013371,434755584,2,96,48,1360013345640,1360013347880,434730224,434732464,2240
1360013750,435134952,1,46,46,1360013721972,1360013721972,435106924,435106924,0
1360013750,435135032,1,46,46,1360013721890,1360013721890,435106922,435106922,0
1360013750,435135064,1,46,46,1360013721924,1360013721924,435106988,435106988,0
1360013750,435135096,1,46,46,1360013721892,1360013721892,435106988,435106988,0
1360013750,435135140,1,46,46,1360013721911,1360013721911,435107051,435107051,0
1360013750,435135188,1,46,46,1360013721865,1360013721865,435107053,435107053,0
1360013751,435136184,1,46,46,1360013721613,1360013721613,435106797,435106797,0
1360013751,435136196,1,46,46,1360013721598,1360013721598,435106794,435106794,0
1360013752,435136232,1,46,46,1360013722563,1360013722563,435106795,435106795,0
1360013752,435136264,1,46,46,1360013722595,1360013722595,435106859,435106859,0
1360013752,435136312,1,46,46,1360013722545,1360013722545,435106857,435106857,0
1360013752,435136388,1,46,46,1360013722534,1360013722534,435106922,435106922,0
1360013752,435136552,1,46,46,1360013722501,1360013722501,435107053,435107053,0
1360013977,435361256,1,46,46,1360013948904,1360013948904,435333160,435333160,0
1360014498,435882932,1,46,46,1360014470075,1360014470075,435855007,435855007,0
1360014827,436211824,1,46,46,1360014801507,1360014801507,436186331,436186331,0
1360014859,436244000,1,46,46,1360014832369,1360014832369,436217369,436217369,0
1360015208,436592872,1,48,48,1360015180973,1360015180973,436565845,436565845,0
1360015208,436592968,1,48,48,1360015180878,1360015180878,436565846,436565846,0
1360015208,436593004,1,48,48,1360015180393,1360015180393,436565397,436565397,0
1360015493,436878044,1,46,46,1360015465918,1360015465918,436850962,436850962,0
1360015557,436942128,3,138,46,1360015532454,1360015535590,436917582,436920718,3136
1360015782,437167040,1,46,46,1360015754875,1360015754875,437139915,437139915,0
1360016668,438052528,1,46,46,1360016641389,1360016641389,438025917,438025917,0
1360017085,438469236,1,443,443,1360017059789,1360017059789,438444025,438444025,0
1360017245,438629736,1,46,46,1360017217108,1360017217108,438601844,438601844,0
1360017261,438645660,1,48,48,1360017234338,1360017234338,438618998,438618998,0
1360017285,438669704,1,60,60,1360017258294,1360017258294,438642998,438642998,0
1360017798,439182448,1,46,46,1360017771246,1360017771246,439155694,439155694,0
1360017806,439190412,1,46,46,1360017778768,1360017778768,439163180,439163180,0
1360017806,439190568,1,48,48,1360017780854,1360017780854,439165422,439165422,0
1360018556,439940784,1,46,46,1360018531793,1360018531793,439916577,439916577,0
1360019105,440489652,1,52,52,1360019078858,1360019078858,440463510,440463510,0
1360019486,440870272,1,46,46,1360019458497,1360019458497,440842769,440842769,0
1360019510,440894452,1,46,46,1360019482124,1360019482124,440866576,440866576,0
1360019923,441307676,1,46,46,1360019896168,1360019896168,441280844,441280844,0
1360020038,441422652,1,46,46,1360020010301,1360020010301,441394953,441394953,0
1360020167,441552144,1,46,46,1360020142287,1360020142287,441527431,441527431,0
1360020784,442169136,2,92,46,1360020756493,1360020777421,442141629,442162557,20928
1360020800,442185096,1,60,60,1360020774133,1360020774133,442159229,442159229,0
1360020821,442205364,1,46,46,1360020793490,1360020793490,442177854,442177854,0
1360020833,442217416,1,46,46,1360020806939,1360020806939,442191355,442191355,0
1360021001,442385880,1,46,46,1360020974025,1360020974025,442358905,442358905,0
1360021226,442610996,1,46,46,1360021198353,1360021198353,442583349,442583349,0
1360021482,442866660,1,46,46,1360021454302,1360021454302,442838962,442838962,0
1360021980,443364328,1,46,46,1360021952481,1360021952481,443336809,443336809,0
1360022095,443479856,1,46,46,1360022067089,1360022067089,443451945,443451945,0
1360022444,443828828,1,46,46,1360022418281,1360022418281,443803109,443803109,0
1360022737,444121404,1,46,46,1360022710282,1360022710282,444094686,444094686,0
1360023150,444534564,1,46,46,1360023124198,1360023124198,444508762,444508762,0
1360023234,444618616,1,46,46,1360023205936,1360023205936,444590552,444590552,0
1360023494,444878928,1,46,46,1360023466165,1360023466165,444851093,444851093,0
1360023494,444878940,1,46,46,1360023467494,1360023467494,444852434,444852434,0
1360023522,444907096,1,46,46,1360023496268,1360023496268,444881364,444881364,0
1360023551,444935216,1,46,46,1360023525114,1360023525114,444909330,444909330,0
1360023795,445179972,1,46,46,1360023769413,1360023769413,445154385,445154385,0
1360024614,445998832,1,46,46,1360024586818,1360024586818,445971650,445971650,0
1360024614,445998872,1,46,46,1360024586843,1360024586843,445971715,445971715,0
1360024614,445998952,1,46,46,1360024586763,1360024586763,445971715,445971715,0
1360024614,445999040,1,46,46,1360024586802,1360024586802,445971842,445971842,0
1360024614,445999076,1,46,46,1360024586767,1360024586767,445971843,445971843,0
1360024615,445999716,1,46,46,1360024586933,1360024586933,445971649,445971649,0
1360024615,445999840,1,46,46,1360024586875,1360024586875,445971715,445971715,0
1360024615,445999916,1,46,46,1360024586860,1360024586860,445971776,445971776,0
1360024615,445999952,1,46,46,1360024586824,1360024586824,445971776,445971776,0
1360025543,446927548,1,46,46,1360025515470,1360025515470,446900018,446900018,0
1360025788,447172272,1,443,443,1360025762784,1360025762784,447147056,447147056,0
1360026004,447388996,1,46,46,1360025976584,1360025976584,447361580,447361580,0
1360028409,449794188,1,46,46,1360028382308,1360028382308,449767496,449767496,0
1360028550,449934400,1,92,92,1360028523189,1360028523189,449907589,449907589,0
1360029431,450815904,1,46,46,1360029404785,1360029404785,450789689,450789689,0
1360030109,451493524,1,46,46,1360030081569,1360030081569,451466093,451466093,0
1360030137,451521688,1,46,46,1360030110462,1360030110462,451495150,451495150,0
1360030149,451533616,1,46,46,1360030123140,1360030123140,451507756,451507756,0
1360030253,451637768,1,46,46,1360030226346,1360030226346,451611114,451611114,0
1360030309,451693820,1,52,52,1360030282868,1360030282868,451667688,451667688,0
1360030554,451938316,1,46,46,1360030529195,1360030529195,451913511,451913511,0
1360030622,452006336,1,46,46,1360030594645,1360030594645,451978981,451978981,0
1360030740,452124788,1,46,46,1360030712589,1360030712589,452097377,452097377,0
1360031239,452623564,1,46,46,1360031210982,1360031210982,452595546,452595546,0
1360035819,457203500,1,46,46,1360035792802,1360035792802,457177302,457177302,0
1360035819,457203540,1,46,46,1360035792827,1360035792827,457177367,457177367,0
1360035819,457203572,1,46,46,1360035792794,1360035792794,457177366,457177366,0
1360035819,457203636,1,46,46,1360035792729,1360035792729,457177365,457177365,0
1360035819,457203672,1,46,46,1360035792758,1360035792758,457177430,457177430,0
1360035820,457204828,1,46,46,1360035792471,1360035792471,457177299,457177299,0
1360037209,458593372,1,46,46,1360037182861,1360037182861,458567233,458567233,0
1360038051,459435764,1,46,46,1360038026166,1360038026166,459410930,459410930,0
1360039157,460541156,1,48,48,1360039127236,1360039127236,460511392,460511392,0
1360039546,460930700,1,46,46,1360039520479,1360039520479,460905179,460905179,0
1360039626,461010724,1,46,46,1360039600135,1360039600135,460984859,460984859,0
1360039674,461058720,1,46,46,1360039645959,1360039645959,461030679,461030679,0
1360039722,461106952,1,46,46,1360039696927,1360039696927,461081879,461081879,0
1360040227,461611412,1,46,46,1360040200694,1360040200694,461585106,461585106,0
1360042199,463583532,1,46,46,1360042173470,1360042173470,463558002,463558002,0
1360042199,463583560,1,46,46,1360042174147,1360042174147,463558707,463558707,0
1360044873,466257440,1,46,46,1360044847631,1360044847631,466232071,466232071,0
1360047352,468736296,1,46,46,1360047324858,1360047324858,468709154,468709154,0
1360047352,468736336,1,46,46,1360047324883,1360047324883,468709219,468709219,0
1360047352,468736504,1,46,46,1360047324781,1360047324781,468709285,468709285,0
1360047352,468736540,1,46,46,1360047324742,1360047324742,468709282,468709282,0
1360047352,468736616,1,46,46,1360047324731,1360047324731,468709347,468709347,0
1360047352,468736652,1,46,46,1360047324693,1360047324693,468709345,468709345,0
1360047353,468737588,1,46,46,1360047324566,1360047324566,468709154,468709154,0
1360047353,468737624,1,46,46,1360047324530,1360047324530,468709154,468709154,0
1360047353,468737736,1,46,46,1360047324483,1360047324483,468709219,468709219,0
1360047353,468737784,1,46,46,1360047324500,1360047324500,468709284,468709284,0
1360047353,468737864,1,46,46,1360047324483,1360047324483,468709347,468709347,0
1360047353,468737984,1,46,46,1360047324429,1360047324429,468709413,468709413,0
1360047353,468738016,1,46,46,1360047324395,1360047324395,468709411,468709411,0
1360048930,470314300,1,46,46,1360048905631,1360048905631,470289931,470289931,0
1360049002,470386344,1,46,46,1360048975984,1360048975984,470360328,470360328,0
1360049363,470747504,1,46,46,1360049336141,1360049336141,470720645,470720645,0
1360050349,471733680,1,46,46,1360050321422,1360050321422,471706102,471706102,0
1360050810,472194340,1,48,48,1360050780186,1360050780186,472164526,472164526,0
1360052686,474070684,1,46,46,1360052659940,1360052659940,474044624,474044624,0
1360053688,475072588,1,48,48,1360053660534,1360053660534,475045122,475045122,0
1360055299,476683664,1,46,46,1360055271760,1360055271760,476656424,476656424,0
1360056748,478132892,1,46,46,1360056719832,1360056719832,478104724,478104724,0
1360057753,3412416296,1,48,48,1360057726680,1360057726680,3412389976,3412389976,0
1360058238,479622116,1,46,46,1360058211272,1360058211272,479595388,479595388,0
1360058648,480032432,1,46,46,1360058619909,1360058619909,480004341,480004341,0
1360058648,480032448,1,46,46,1360058619959,1360058619959,480004407,480004407,0
1360058648,480032596,1,46,46,1360058619872,1360058619872,480004468,480004468,0
1360058648,480032608,1,46,46,1360058619926,1360058619926,480004534,480004534,0
1360058649,480033592,1,46,46,1360058619748,1360058619748,480004340,480004340,0
1360058649,480033684,1,46,46,1360058619720,1360058619720,480004404,480004404,0
1360058649,480033724,1,46,46,1360058619743,1360058619743,480004467,480004467,0
1360058649,480033760,1,46,46,1360058619709,1360058619709,480004469,480004469,0
1360062905,484289316,1,46,46,1360062877302,1360062877302,484261618,484261618,0
1360064055,485439984,1,46,46,1360064026827,1360064026827,485411811,485411811,0
1360064458,485842528,1,76,76,1360064430283,1360064430283,485814811,485814811,0
1360064942,486326424,1,48,48,1360064913836,1360064913836,486298260,486298260,0
1360067907,489291284,1,46,46,1360067878218,1360067878218,489262502,489262502,0
1360068033,489417992,1,48,48,1360068007877,1360068007877,489392869,489392869,0
1360068178,489562408,1,48,48,1360068153419,1360068153419,489537827,489537827,0
1360069340,490724304,1,48,48,1360069315809,1360069315809,490700113,490700113,0
1360070175,491559700,1,46,46,1360070146821,1360070146821,491531521,491531521,0
1360070175,491559812,1,46,46,1360070146775,1360070146775,491531587,491531587,0
1360070175,491559852,1,46,46,1360070146800,1360070146800,491531652,491531652,0
1360070175,491559892,1,46,46,1360070146758,1360070146758,491531650,491531650,0
1360070176,491560484,1,46,46,1360070146976,1360070146976,491531460,491531460,0
1360070176,491560552,1,46,46,1360070146973,1360070146973,491531525,491531525,0
1360070176,491560560,1,46,46,1360070146963,1360070146963,491531523,491531523,0
1360070176,491560596,1,46,46,1360070146990,1360070146990,491531586,491531586,0
1360070176,491560712,1,46,46,1360070146941,1360070146941,491531653,491531653,0
1360070258,491642664,1,434,434,1360070233705,1360070233705,491618369,491618369,0
1360071773,3426436760,1,46,46,1360071744929,1360071744929,3426408689,3426408689,0
1360072234,493618868,5,250,50,1360072207809,1360072229633,493592677,493614501,21824
1360072258,493643016,1,127,127,1360072230763,1360072230763,493615779,493615779,0
1360072597,493981472,1,48,48,1360072569348,1360072569348,493953820,493953820,0
1360073307,494691536,1,48,48,1360073279995,1360073279995,494664531,494664531,0
1360088506,509890384,1,48,48,1360088480293,1360088480293,509864677,509864677,0
1360089127,510511644,1,46,46,1360089099927,1360089099927,510484571,510484571,0
1360089233,3443897084,6,455,75.83333333,1360089227602,1360089227666,3443891686,3443891750,64
1360089246,510630264,6,632,105.3333333,1360089225683,1360089240787,510609947,510625051,15104
1360089249,3443913076,3,144,48,1360089243162,1360089248666,3443907238,3443912742,5504
1360089249,3443913076,3,144,48,1360089243162,1360089248666,3443907238,3443912742,5504
1360089249,3443913076,3,144,48,1360089243162,1360089248666,3443907238,3443912742,5504
1360089249,3443913096,3,144,48,1360089243143,1360089248647,3443907239,3443912743,5504
1360089249,3443913096,3,144,48,1360089243143,1360089248647,3443907239,3443912743,5504
1360089249,3443913096,4,190,47.5,1360089243143,1360089248647,3443907239,3443912743,5504
1360089254,510638144,3,144,48,1360089243977,1360089249481,510628121,510633625,5504
1360089257,3443921084,2,98,49,1360089250770,1360089256402,3443914854,3443920486,5632
1360089257,3443921084,3,144,48,1360089250770,1360089256466,3443914854,3443920550,5696
1360089257,3443921084,2,98,49,1360089250769,1360089256401,3443914853,3443920485,5632
1360089257,3443921084,2,98,49,1360089250769,1360089256401,3443914853,3443920485,5632
1360089257,3443921084,2,98,49,1360089250769,1360089256401,3443914853,3443920485,5632
1360089257,3443921104,2,98,49,1360089250749,1360089256381,3443914853,3443920485,5632
1360089257,3443921104,3,144,48,1360089250749,1360089256445,3443914853,3443920549,5696
1360089257,3443921104,3,144,48,1360089250749,1360089256445,3443914853,3443920549,5696
1360089257,3443921104,3,144,48,1360089250813,1360089256381,3443914917,3443920485,5568
1360089261,3443924928,6,722,120.3333333,1360089233772,1360089240940,3443897700,3443904868,7168
1360089262,510646164,2,98,49,1360089251573,1360089257269,510635737,510641433,5696
1360089262,510646164,2,98,49,1360089251573,1360089257269,510635737,510641433,5696
1360089262,510646164,2,98,49,1360089251637,1360089257269,510635801,510641433,5632
1360089262,510646164,2,98,49,1360089251701,1360089257269,510635865,510641433,5568
1360089262,510646172,2,98,49,1360089252142,1360089257198,510636314,510641370,5056
1360089262,510646180,14,5532,395.1428571,1360089252646,1360089255974,510636826,510640154,3328
1360089262,510646204,4,190,47.5,1360089255245,1360089261325,510639449,510645529,6080
1360089262,510646216,7,498,71.14285714,1360089258690,1360089261762,510642906,510645978,3072
1360089262,510646220,2,92,46,1360089255359,1360089261247,510639579,510645467,5888
1360089262,510646240,2,98,49,1360089251498,1360089257194,510635738,510641434,5696
1360089262,510646240,3,144,48,1360089251498,1360089257194,510635738,510641434,5696
1360089262,510646240,2,98,49,1360089251561,1360089257193,510635801,510641433,5632
1360089262,510646240,3,144,48,1360089251561,1360089257193,510635801,510641433,5632
1360089262,510646240,3,144,48,1360089251561,1360089257257,510635801,510641497,5696
1360089262,510646248,15,5228,348.5333333,1360089256355,1360089256547,510640603,510640795,192
1360089262,510646252,19,6372,335.3684211,1360089252573,1360089256221,510636825,510640473,3648
1360089267,510651772,4,658,164.5,1360089242582,1360089242838,510627354,510627610,256
1360089269,3443933036,8,768,96,1360089244481,1360089263105,3443908517,3443927141,18624
1360089270,510654228,4,190,47.5,1360089263736,1360089268856,510647964,510653084,5120
1360089270,510654232,4,190,47.5,1360089256178,1360089262194,510640410,510646426,6016
1360089270,510654240,7,1825,260.7142857,1360089262954,1360089263082,510647194,510647322,128
1360089270,510654264,15,7315,487.6666667,1360089263187,1360089263891,510647451,510648155,704
1360089270,510654280,7,1784,254.8571429,1360089263682,1360089263810,510647962,510648090,128
1360089270,510654304,7,1878,268.2857143,1360089264360,1360089264488,510648664,510648792,128
1360089270,510654308,7,1878,268.2857143,1360089262565,1360089262693,510646873,510647001,128
1360089271,510655696,46,37118,806.9130435,1360089243424,1360089255776,510628120,510640472,12352
1360089271,510655852,9,504,56,1360089244229,1360089264325,510629081,510649177,20096
1360089271,510655856,17,1632,96,1360089244419,1360089268163,510629275,510653019,23744
1360089273,3443936932,8,448,56,1360089245481,1360089263593,3443909413,3443927525,18112
1360089275,510659732,12,3307,275.5833333,1360089248701,1360089248957,510633433,510633689,256
1360089275,510659736,9,2632,292.4444444,1360089249081,1360089250553,510633817,510635289,1472
1360089275,510659776,5,2498,499.6,1360089250513,1360089251537,510635289,510636313,1024
1360089275,510659776,12,7347,612.25,1360089250448,1360089251664,510635224,510636440,1216
1360089275,510659780,8,5204,650.5,1360089250511,1360089251535,510635291,510636315,1024
1360089275,510659864,16,11188,699.25,1360089250360,1360089251512,510635224,510636376,1152
1360089277,3443940944,8,6237,779.625,1360089250911,1360089251615,3443914855,3443915559,704
1360089277,3443940992,6,3485,580.8333333,1360089250862,1360089251054,3443914854,3443915046,192
1360089278,510662264,19,12631,664.7894737,1360089271058,1360089276050,510655322,510660314,4992
1360089278,510662304,8,3185,398.125,1360089272360,1360089276008,510656664,510660312,3648
1360089278,510662308,9,590,65.55555556,1360089264612,1360089270436,510648920,510654744,5824
1360089279,510663688,19,7730,406.8421053,1360089254828,1360089272364,510639516,510657052,17536
1360089279,510663692,29,37379,1288.931034,1360089251046,1360089251430,510635738,510636122,384
1360089279,510663692,5,3201,640.2,1360089251109,1360089251621,510635801,510636313,512
1360089279,510663692,7,392,56,1360089251109,1360089264229,510635801,510648921,13120
1360089279,510663708,5,3456,691.2,1360089251608,1360089251608,510636316,510636316,0
1360089279,510663748,3,1201,400.3333333,1360089254639,1360089254895,510639387,510639643,256
1360089279,510663776,8,1199,149.875,1360089253075,1360089254739,510637851,510639515,1664
1360089279,510663828,18,3615,200.8333333,1360089251935,1360089253023,510636763,510637851,1088
1360089279,510663860,7,2253,321.8571429,1360089254655,1360089254911,510639515,510639771,256
1360089279,510663868,8,1489,186.125,1360089252917,1360089254773,510637785,510639641,1856
1360089279,510663868,9,4864,540.4444444,1360089252981,1360089254837,510637849,510639705,1856
1360089283,510667684,16,3438,214.875,1360089255212,1360089255788,510639896,510640472,576
1360089283,510667720,8,3189,398.625,1360089256523,1360089256715,510641243,510641435,192
1360089283,510667724,18,4044,224.6666667,1360089256647,1360089257479,510641371,510642203,832
1360089283,510667812,25,12096,483.84,1360089256430,1360089256750,510641242,510641562,320
1360089283,510667856,2,473,236.5,1360089258176,1360089258240,510643032,510643096,64
1360089283,510667856,2,98,49,1360089258434,1360089258498,510643290,510643354,64
1360089285,3443948984,12,1660,138.3333333,1360089257780,1360089276532,3443921764,3443940516,18752
1360089286,510670200,14,5073,362.3571429,1360089279891,1360089285715,510664091,510669915,5824
1360089287,510671820,14,10424,744.5714286,1360089261863,1360089262503,510646683,510647323,640
1360089291,510675696,15,3436,229.0666667,1360089263140,1360089263460,510647836,510648156,320
1360089291,510675700,19,11669,614.1578947,1360089263774,1360089264286,510648474,510648986,512
1360089294,510678304,191,215548,1128.52356,1360089272364,1360089291308,510656668,510675612,18944
1360089297,3443960968,4,384,96,1360089269830,1360089290694,3443933798,3443954662,20864
1360089299,510683680,1,46,46,1360089271090,1360089271090,510655770,510655770,0
1360089299,510683680,7,2548,364,1360089271217,1360089271473,510655897,510656153,256
1360089299,510683688,10,7426,742.6,1360089271850,1360089272426,510656538,510657114,576
1360089299,510683688,65,83591,1286.015385,1360089271977,1360089282473,510656665,510667161,10496
1360089307,510691800,5,280,56,1360089282681,1360089301561,510667481,510686361,18880
1360089307,510691880,9,864,96,1360089282473,1360089300777,510667353,510685657,18304
1360089309,3443972964,5,280,56,1360089282187,1360089300555,3443946151,3443964519,18368
1360089310,510694240,5,280,56,1360089283370,1360089302378,510667610,510686618,19008
1360089319,510703712,2,123,61.5,1360089293648,1360089293712,510678360,510678424,64
1360089319,510703844,3,169,56.33333333,1360089294542,1360089294542,510679386,510679386,0
1360089323,510707808,3,138,46,1360089298160,1360089298160,510682968,510682968,0
1360089323,510707816,3,138,46,1360089295145,1360089295145,510679961,510679961,0
1360089323,510707884,2,123,61.5,1360089297510,1360089297510,510682394,510682394,0
1360089323,510707884,3,491,163.6666667,1360089297701,1360089297765,510682585,510682649,64
1360089325,3443988984,2,192,96,1360089298038,1360089307830,3443962022,3443971814,9792
1360089326,510710300,4,184,46,1360089325549,1360089325613,510709849,510709913,64
1360089327,510711720,2,123,61.5,1360089301640,1360089301640,510686360,510686360,0
1360089327,510711772,3,169,56.33333333,1360089300630,1360089300630,510685402,510685402,0
1360089327,510711772,1,77,77,1360089300630,1360089300630,510685402,510685402,0
1360089327,510711772,2,123,61.5,1360089300629,1360089300693,510685401,510685465,64
1360089327,510711804,2,123,61.5,1360089301556,1360089301556,510686360,510686360,0
1360089334,510718252,11,923,83.90909091,1360089318110,1360089326750,510702362,510711002,8640
1360089334,510718336,7,500,71.42857143,1360089326344,1360089329672,510710680,510714008,3328
1360089335,510719756,2,123,61.5,1360089307620,1360089307620,510692376,510692376,0
1360089335,510719868,1,96,96,1360089307508,1360089307508,510692376,510692376,0
1360089343,510727840,3,274,91.33333333,1360089317330,1360089317394,510702170,510702234,64
1360089347,510731760,3,138,46,1360089320224,1360089320224,510704984,510704984,0
1360089347,510731764,2,92,46,1360089320222,1360089320222,510704986,510704986,0
1360089347,510731876,2,92,46,1360089320111,1360089320111,510704987,510704987,0
1360089351,510735952,3,510,170,1360089324450,1360089324514,510709402,510709466,64
1360089358,510742308,28,13960,498.5714286,1360089349668,1360089353764,510733976,510738072,4096
1360089363,510747880,3,491,163.6666667,1360089337898,1360089337962,510722778,510722842,64
1360089363,510747884,2,123,61.5,1360089338468,1360089338532,510723352,510723416,64
1360089367,510751932,2,123,61.5,1360089339443,1360089339443,510724375,510724375,0
1360089367,510751968,2,123,61.5,1360089342417,1360089342417,510727385,510727385,0
1360089371,510755904,1,77,77,1360089345423,1360089345423,510730327,510730327,0
1360089371,510755908,2,123,61.5,1360089345420,1360089345484,510730328,510730392,64
1360089371,510755908,2,123,61.5,1360089345484,1360089345548,510730392,510730456,64
1360089371,510755932,2,123,61.5,1360089346420,1360089346420,510731352,510731352,0
1360089371,510755932,1,77,77,1360089346420,1360089346420,510731352,510731352,0
1360089374,510758296,2,92,46,1360089367727,1360089367727,510752023,510752023,0
1360089374,510758348,3,138,46,1360089370686,1360089370750,510755034,510755098,64
1360089374,510758348,2,92,46,1360089370686,1360089370686,510755034,510755034,0
1360089374,510758348,2,92,46,1360089370686,1360089370686,510755034,510755034,0
1360089374,510758380,3,138,46,1360089367646,1360089367646,510752026,510752026,0
1360089374,510758428,2,92,46,1360089370605,1360089370605,510755033,510755033,0
1360089375,510759808,5,480,96,1360089349807,1360089374447,510734615,510759255,24640
1360089375,510759852,2,112,56,1360089350341,1360089356741,510735193,510741593,6400
1360089375,510759932,3,168,56,1360089349942,1360089374582,510734874,510759514,24640
1360089375,510759940,4,1984,496,1360089350251,1360089367467,510735191,510752407,17216
1360089378,3444041284,3,288,96,1360089353458,1360089376114,3444016742,3444039398,22656
1360089378,3444041292,4,224,56,1360089350252,1360089376620,3444013544,3444039912,26368
1360089379,510763820,2,123,61.5,1360089352547,1360089352547,510737367,510737367,0
1360089382,510766360,12,8094,674.5,1360089375343,1360089379951,510759703,510764311,4608
1360089382,510766364,9,4662,518,1360089379436,1360089379628,510763800,510763992,192
1360089382,510766372,2,98,49,1360089376038,1360089381478,510760410,510765850,5440
1360089382,510766372,2,98,49,1360089376294,1360089381478,510760666,510765850,5184
1360089382,510766372,6,505,84.16666667,1360089376357,1360089376549,510760729,510760921,192
1360089382,510766372,2,98,49,1360089376227,1360089381475,510760599,510765847,5248
1360089382,510766376,4,467,116.75,1360089376418,1360089376546,510760794,510760922,128
1360089382,510766376,6,3199,533.1666667,1360089380129,1360089380321,510764505,510764697,192
1360089382,510766376,7,2414,344.8571429,1360089380192,1360089380320,510764568,510764696,128
1360089382,510766408,5,1049,209.8,1360089380862,1360089380990,510765270,510765398,128
1360089382,510766408,5,454,90.8,1360089380993,1360089381185,510765401,510765593,192
1360089382,510766412,3,155,51.66666667,1360089378619,1360089378619,510763031,510763031,0
1360089382,510766440,8,4715,589.375,1360089379423,1360089379551,510763863,510763991,128
1360089382,510766448,3,140,46.66666667,1360089376025,1360089381401,510760473,510765849,5376
1360089382,510766448,4,196,49,1360089376281,1360089381465,510760729,510765913,5184
1360089382,510766456,14,14035,1002.5,1360089376850,1360089377106,510761306,510761562,256
1360089382,510766460,4,325,81.25,1360089380620,1360089380812,510765080,510765272,192
1360089382,510766488,7,2384,340.5714286,1360089381041,1360089381169,510765529,510765657,128
1360089382,510766492,7,4465,637.8571429,1360089378538,1360089378730,510763030,510763222,192
1360089383,510767920,2,92,46,1360089358079,1360089358143,510742999,510743063,64
1360089386,3444049180,3,144,48,1360089375579,1360089380827,3444038759,3444044007,5248
1360089386,3444049184,3,144,48,1360089377366,1360089382806,3444040550,3444045990,5440
1360089386,3444049188,2,98,49,1360089378002,1360089383762,3444041190,3444046950,5760
1360089386,3444049188,3,144,48,1360089378002,1360089383762,3444041190,3444046950,5760
1360089386,3444049204,2,98,49,1360089377024,1360089382720,3444040228,3444045924,5696
1360089390,510774352,2,98,49,1360089381879,1360089387447,510766231,510771799,5568
1360089390,510774356,7,412,58.85714286,1360089383541,1360089383541,510767897,510767897,0
1360089390,510774356,5,834,166.8,1360089379444,1360089382452,510763800,510766808,3008
1360089390,510774356,2,98,49,1360089379507,1360089385459,510763863,510769815,5952
1360089390,510774360,3,144,48,1360089379759,1360089385455,510764119,510769815,5696
1360089390,510774364,39,35585,912.4358974,1360089379822,1360089386414,510764186,510770778,6592
1360089390,510774364,28,11714,418.3571429,1360089380076,1360089382188,510764440,510766552,2112
1360089390,510774368,7,412,58.85714286,1360089384490,1360089384554,510768858,510768922,64
1360089390,510774368,2,98,49,1360089376937,1360089382441,510761305,510766809,5504
1360089390,510774368,4,190,47.5,1360089377256,1360089382568,510761624,510766936,5312
1360089390,510774372,3,144,48,1360089380578,1360089386466,510764950,510770838,5888
1360089390,510774392,2,98,49,1360089380561,1360089386449,510764953,510770841,5888
1360089390,510774392,53,55566,1048.415094,1360089377743,1360089386447,510762135,510770839,8704
1360089390,510774396,3,144,48,1360089377870,1360089383438,510762266,510767834,5568
1360089390,510774396,8,535,66.875,1360089380876,1360089386444,510765272,510770840,5568
1360089390,510774396,3,144,48,1360089378123,1360089383435,510762519,510767831,5312
1360089390,510774400,3,144,48,1360089378314,1360089383434,510762714,510767834,5120
1360089390,510774400,3,144,48,1360089381130,1360089386442,510765530,510770842,5312
1360089390,510774400,3,144,48,1360089381449,1360089387465,510765849,510771865,6016
1360089390,510774400,3,144,48,1360089381449,1360089387465,510765849,510771865,6016
1360089390,510774400,11,1707,155.1818182,1360089378568,1360089386888,510762968,510771288,8320
1360089390,510774404,3,144,48,1360089381510,1360089387462,510765914,510771866,5952
1360089390,510774404,4,190,47.5,1360089378886,1360089384454,510763290,510768858,5568
1360089390,510774408,13,9799,753.7692308,1360089375298,1360089388610,510759706,510773018,13312
1360089390,510774408,7,412,58.85714286,1360089387456,1360089387520,510771864,510771928,64
1360089390,510774408,2,98,49,1360089379456,1360089385408,510763864,510769816,5952
1360089390,510774428,3,150,50,1360089379757,1360089385389,510764185,510769817,5632
1360089390,510774432,8,2252,281.5,1360089376680,1360089382376,510761112,510766808,5696
1360089390,510774432,4,196,49,1360089376935,1360089382567,510761367,510766999,5632
1360089390,510774440,7,694,99.14285714,1360089377634,1360089382818,510762074,510767258,5184
1360089390,510774440,4,196,49,1360089380833,1360089386401,510765273,510770841,5568
1360089390,510774472,6,926,154.3333333,1360089381376,1360089384704,510765848,510769176,3328
1360089390,510774472,3,144,48,1360089381376,1360089387392,510765848,510771864,6016
1360089390,510774472,3,144,48,1360089381376,1360089387392,510765848,510771864,6016
1360089390,510774472,3,144,48,1360089381374,1360089387390,510765846,510771862,6016
1360089390,510774476,3,144,48,1360089381756,1360089387324,510766232,510771800,5568
1360089394,3444057312,2,92,46,1360089366805,1360089366805,3444030117,3444030117,0
1360089394,3444057336,2,92,46,1360089367808,1360089367808,3444031144,3444031144,0
1360089395,510779808,1,1500,1500,1360089367601,1360089367601,510752409,510752409,0
1360089395,510779852,39,42143,1080.589744,1360089370116,1360089370372,510754968,510755224,256
1360089395,510779964,5,1678,335.6,1360089369938,1360089370002,510754902,510754966,64
1360089395,510779964,1,46,46,1360089370132,1360089370132,510755096,510755096,0
1360089398,510782356,6,366,61,1360089391542,1360089391542,510775898,510775898,0
1360089398,510782396,7,412,58.85714286,1360089397516,1360089397516,510781912,510781912,0
1360089398,510782404,7,412,58.85714286,1360089391494,1360089391494,510775898,510775898,0
1360089398,510782436,6,366,61,1360089390502,1360089390502,510774938,510774938,0
1360089398,510782436,7,412,58.85714286,1360089390438,1360089390502,510774874,510774938,64
1360089398,510782444,74,83042,1122.189189,1360089374940,1360089391580,510759384,510776024,16640
1360089399,510783792,71,81141,1142.830986,1360089374846,1360089378558,510759638,510763350,3712
1360089399,510783960,8,2589,323.625,1360089374681,1360089374873,510759641,510759833,192
1360089399,510783960,3,347,115.6666667,1360089374681,1360089375321,510759641,510760281,640
1360089399,510783960,4,527,131.75,1360089374681,1360089375385,510759641,510760345,704
1360089399,510783960,9,504,56,1360089374745,1360089398233,510759705,510783193,23488
1360089402,3444065260,4,968,242,1360089377804,1360089378444,3444041064,3444041704,640
1360089402,3444065300,8,3969,496.125,1360089377251,1360089379427,3444040551,3444042727,2176
1360089403,510787780,4,544,136,1360089374859,1360089375627,510759639,510760407,768
1360089403,510787784,16,1536,96,1360089375240,1360089398024,510760024,510782808,22784
1360089403,510787788,25,17957,718.28,1360089375811,1360089379715,510760599,510764503,3904
1360089403,510787792,4,529,132.25,1360089375870,1360089379710,510760662,510764502,3840
1360089403,510787792,1,46,46,1360089375681,1360089375681,510760473,510760473,0
1360089403,510787792,9,1659,184.3333333,1360089375808,1360089379200,510760600,510763992,3392
1360089403,510787796,5,706,141.2,1360089376508,1360089377788,510761304,510762584,1280
1360089403,510787824,24,14214,592.25,1360089376992,1360089377376,510761816,510762200,384
1360089403,510787832,3,1350,450,1360089377689,1360089378521,510762521,510763353,832
1360089403,510787836,2,445,222.5,1360089378006,1360089378390,510762842,510763226,384
1360089403,510787856,3,1533,511,1360089378240,1360089378496,510763096,510763352,256
1360089403,510787856,7,4664,666.2857143,1360089378239,1360089385599,510763095,510770455,7360
1360089403,510787856,21,21429,1020.428571,1360089378239,1360089385535,510763095,510770391,7296
1360089403,510787856,12,9315,776.25,1360089378239,1360089385535,510763095,510770391,7296
1360089403,510787856,5,1701,340.2,1360089378239,1360089378495,510763095,510763351,256
1360089403,510787856,1,46,46,1360089378303,1360089378303,510763159,510763159,0
1360089403,510787868,7,585,83.57142857,1360089375731,1360089398131,510760599,510782999,22400
1360089403,510787868,5,975,195,1360089375731,1360089380147,510760599,510765015,4416
1360089403,510787904,4,844,211,1360089376593,1360089376593,510761497,510761497,0
1360089403,510787904,8,448,56,1360089376912,1360089398096,510761816,510783000,21184
1360089403,510787912,10,6812,681.2,1360089377353,1360089377545,510762265,510762457,192
1360089403,510787936,3,301,100.3333333,1360089377583,1360089377647,510762519,510762583,64
1360089403,510787944,5,718,143.6,1360089378218,1360089378410,510763162,510763354,192
1360089403,510787944,11,7607,691.5454545,1360089378153,1360089385449,510763097,510770393,7296
1360089406,3444069156,40,50010,1250.25,1360089379316,1360089379956,3444042472,3444043112,640
1360089406,3444069176,31,33080,1067.096774,1360089381213,1360089381597,3444044389,3444044773,384
1360089406,3444069184,7,672,96,1360089378454,1360089397526,3444041638,3444060710,19072
1360089406,3444069196,7,392,56,1360089378762,1360089398538,3444041958,3444061734,19776
1360089406,3444069220,69,88372,1280.753623,1360089381169,1360089382001,3444044389,3444045221,832
1360089406,510790368,6,1540,256.6666667,1360089400618,1360089404650,510784986,510789018,4032
1360089406,510790404,8,1632,204,1360089397061,1360089400581,510781465,510784985,3520
1360089406,510790448,7,3897,556.7142857,1360089398743,1360089403799,510783191,510788247,5056
1360089406,510790480,10,1580,158,1360089396792,1360089404600,510781272,510789080,7808
1360089407,510791968,4,590,147.5,1360089379023,1360089379407,510763991,510764375,384
1360089408,510791996,5,1887,377.4,1360089380509,1360089381341,510764505,510765337,832
1360089408,510791996,4,834,208.5,1360089380636,1360089380828,510764632,510764824,192
1360089408,510791996,4,1655,413.75,1360089380570,1360089380762,510764566,510764758,192
1360089408,510792000,5,1034,206.8,1360089380759,1360089380951,510764759,510764951,192
1360089408,510792000,10,4906,490.6,1360089380887,1360089381655,510764887,510765655,768
1360089408,510792004,5,1115,223,1360089380949,1360089381141,510764953,510765145,192
1360089408,510792036,6,2425,404.1666667,1360089380981,1360089381109,510765017,510765145,128
1360089408,510792040,7,4999,714.1428571,1360089381042,1360089381234,510765082,510765274,192
1360089408,510792048,3,183,61,1360089381674,1360089381738,510765722,510765786,64
1360089411,510795868,26,32320,1243.076923,1360089385462,1360089385590,510770330,510770458,128
1360089411,510795976,44,55941,1271.386364,1360089385033,1360089385673,510770009,510770649,640
1360089414,3444077196,3,378,126,1360089385930,1360089386058,3444049126,3444049254,128
1360089415,510799880,1,46,46,1360089387048,1360089387048,510771928,510771928,0
1360089422,510806364,3,144,48,1360089414317,1360089420333,510798681,510804697,6016
1360089422,510806364,3,144,48,1360089414570,1360089420330,510798934,510804694,5760
1360089422,510806432,3,144,48,1360089414249,1360089420265,510798681,510804697,6016
1360089422,510806436,4,190,47.5,1360089414500,1360089420324,510798936,510804760,5824
1360089423,510807832,4,740,185,1360089397976,1360089398360,510782808,510783192,384
1360089423,510807952,5,2332,466.4,1360089398113,1360089398305,510783065,510783257,192
1360089423,510807980,5,1226,245.2,1360089396227,1360089399939,510781207,510784919,3712
1360089424,510807988,6,3937,656.1666667,1360089397541,1360089397669,510781529,510781657,128
1360089425,3444089116,4,190,47.5,1360089414132,1360089419764,3444078248,3444083880,5632
1360089426,3444089140,3,144,48,1360089414596,1360089419652,3444077736,3444082792,5056
1360089430,510814396,27,23396,866.5185185,1360089421003,1360089427723,510805399,510812119,6720
1360089438,510822420,38,23837,627.2894737,1360089427700,1360089430644,510812120,510815064,2944
1360089439,510823856,8,8635,1079.375,1360089413759,1360089414399,510798615,510799255,640
1360089439,510823856,40,48561,1214.025,1360089413759,1360089414271,510798615,510799127,512
1360089439,510823856,9,9368,1040.888889,1360089413759,1360089414335,510798615,510799191,576
1360089439,510823864,4,384,96,1360089413942,1360089419894,510798806,510804758,5952
1360089439,510823896,3,2600,866.6666667,1360089414233,1360089414233,510799129,510799129,0
1360089439,510823896,35,41421,1183.457143,1360089414168,1360089414552,510799064,510799448,384
1360089439,510823972,14,12509,893.5,1360089413643,1360089414347,510798615,510799319,704
1360089439,510823972,52,74724,1437,1360089413642,1360089414218,510798614,510799190,576
1360089439,510823972,49,66138,1349.755102,1360089413644,1360089414156,510798616,510799128,512
1360089439,510823972,12,11983,998.5833333,1360089413644,1360089414284,510798616,510799256,640
1360089439,510823972,10,6874,687.4,1360089413708,1360089414732,510798680,510799704,1024
1360089439,510823984,11,12179,1107.181818,1360089414078,1360089414142,510799062,510799126,64
1360089442,3444105232,7,6176,882.2857143,1360089414568,1360089415208,3444077800,3444078440,640
1360089442,3444105276,23,24181,1051.347826,1360089414459,1360089415163,3444077735,3444078439,704
1360089442,3444105276,2,192,96,1360089414841,1360089419769,3444078117,3444083045,4928
1360089442,3444105280,2,112,56,1360089415477,1360089420469,3444078757,3444083749,4992
1360089443,510827904,8,2033,254.125,1360089418000,1360089424272,510802904,510809176,6272
1360089443,510827908,2,112,56,1360089417997,1360089420493,510802905,510805401,2496
1360089443,510827980,3,138,46,1360089416962,1360089417026,510801942,510802006,64
1360089444,510827996,2,112,56,1360089419162,1360089442266,510803158,510826262,23104
1360089447,510831840,3,169,56.33333333,1360089422030,1360089422094,510806870,510806934,64
1360089447,510831908,3,169,56.33333333,1360089421003,1360089421003,510805911,510805911,0
1360089447,510831916,3,169,56.33333333,1360089419011,1360089419011,510803927,510803927,0
1360089450,3444113180,2,98,49,1360089442011,1360089447003,3444105191,3444110183,4992
1360089450,3444113192,4,190,47.5,1360089441998,1360089447054,3444105190,3444110246,5056
1360089454,510838416,3,144,48,1360089442037,1360089447733,510826453,510832149,5696
1360089459,510843908,2,92,46,1360089434634,1360089434634,510819542,510819542,0
1360089460,510843996,3,138,46,1360089435549,1360089435549,510819545,510819545,0
1360089467,510851860,3,138,46,1360089440443,1360089440507,510825303,510825367,64
1360089467,510851868,16,13002,812.625,1360089440949,1360089455669,510825817,510840537,14720
1360089467,510851872,2,192,96,1360089441520,1360089446192,510826392,510831064,4672
1360089467,510851904,3,138,46,1360089439118,1360089439118,510824022,510824022,0
1360089467,510851976,2,2868,1434,1360089440840,1360089440840,510825816,510825816,0
1360089467,510851976,4,4218,1054.5,1360089440840,1360089455560,510825816,510840536,14720
1360089467,510851976,13,6965,535.7692308,1360089440839,1360089455623,510825815,510840599,14784
1360089467,510851976,12,14118,1176.5,1360089440775,1360089440839,510825751,510825815,64
1360089467,510851976,5,5614,1122.8,1360089440839,1360089455559,510825815,510840535,14720
1360089467,510851976,41,53475,1304.268293,1360089440839,1360089441095,510825815,510826071,256
1360089467,510851976,22,17098,777.1818182,1360089440839,1360089455559,510825815,510840535,14720
1360089470,3444133264,1,96,96,1360089442309,1360089442309,3444105573,3444105573,0
1360089470,3444133316,1,56,56,1360089442961,1360089442961,3444106277,3444106277,0
1360089486,510870412,13,5722,440.1538462,1360089479481,1360089480121,510863893,510864533,640
1360089486,510870452,17,7802,458.9411765,1360089481171,1360089481555,510865623,510866007,384
1360089486,510870456,12,5821,485.0833333,1360089479117,1360089484429,510863573,510868885,5312
1360089486,510870488,14,5195,371.0714286,1360089479407,1360089479855,510863895,510864343,448
1360089486,510870500,17,8962,527.1764706,1360089480033,1360089481057,510864533,510865557,1024
1360089491,510875880,1,77,77,1360089463974,1360089463974,510848854,510848854,0
1360089492,510875996,4,537,134.25,1360089464859,1360089464987,510848855,510848983,128
1360089492,510876060,2,123,61.5,1360089466777,1360089466777,510850837,510850837,0
1360089494,510878432,7,444,63.42857143,1360089487078,1360089493670,510871510,510878102,6592
1360089494,510878436,11,4973,452.0909091,1360089481188,1360089486436,510865624,510870872,5248
1360089494,510878440,9,2292,254.6666667,1360089484705,1360089490465,510869145,510874905,5760
1360089494,510878440,10,2356,235.6,1360089484768,1360089490400,510869208,510874840,5632
1360089494,510878440,11,4943,449.3636364,1360089481632,1360089487456,510866072,510871896,5824
1360089494,510878512,10,4897,489.7,1360089481557,1360089487381,510866069,510871893,5824
1360089494,510878516,2,92,46,1360089493332,1360089493332,510877848,510877848,0
1360089495,510879872,2,123,61.5,1360089466990,1360089466990,510851862,510851862,0
1360089497,3444161120,3,138,46,1360089494893,1360089495149,3444159013,3444159269,256
1360089502,510886392,3,138,46,1360089494542,1360089494606,510878934,510878998,64
1360089502,510886396,2,123,61.5,1360089496459,1360089496459,510880855,510880855,0
1360089503,510887956,2,92,46,1360089477018,1360089477018,510861974,510861974,0
1360089503,510887956,2,92,46,1360089477018,1360089477018,510861974,510861974,0
1360089504,510888040,19,10209,537.3157895,1360089479533,1360089483309,510863573,510867349,3776
1360089504,510888072,3,138,46,1360089477904,1360089477904,510861976,510861976,0
1360089507,510891988,13,5146,395.8461538,1360089479227,1360089480443,510864215,510865431,1216
1360089508,510892000,7,2656,379.4285714,1360089480984,1360089481176,510864984,510865176,192
1360089508,510892068,14,9409,672.0714286,1360089483347,1360089483731,510867415,510867799,384
1360089510,510894428,7,412,58.85714286,1360089509419,1360089509483,510893847,510893911,64
1360089511,510895880,10,960,96,1360089485542,1360089496934,510870422,510881814,11392
1360089511,510895888,1,46,46,1360089485917,1360089485917,510870805,510870805,0
1360089511,510895892,2,92,46,1360089485912,1360089485912,510870804,510870804,0
1360089511,510895896,7,3347,478.1428571,1360089486040,1360089487640,510870936,510872536,1600
1360089511,510895956,12,5598,466.5,1360089484252,1360089487772,510869208,510872728,3520
1360089511,510895956,6,336,56,1360089484442,1360089497370,510869398,510882326,12928
1360089511,510895972,46,39849,866.2826087,1360089482828,1360089494284,510867800,510879256,11456
1360089512,510896036,9,2008,223.1111111,1360089487409,1360089488625,510871445,510872661,1216
1360089512,510896048,5,280,56,1360089485414,1360089495654,510869462,510879702,10240
1360089514,3444177288,5,280,56,1360089486641,1360089496817,3444149929,3444160105,10176
1360089514,3444177344,5,480,96,1360089486391,1360089495927,3444149735,3444159271,9536
1360089518,3444181296,2,92,46,1360089493673,1360089493673,3444156969,3444156969,0
1360089518,510902396,7,412,58.85714286,1360089511433,1360089511433,510895829,510895829,0
1360089518,510902408,7,412,58.85714286,1360089512445,1360089512445,510896853,510896853,0
1360089519,510903972,2,92,46,1360089490889,1360089490889,510875861,510875861,0
1360089520,510904008,1,46,46,1360089494864,1360089494864,510878872,510878872,0
1360089520,510904008,1,46,46,1360089494861,1360089494861,510878869,510878869,0
1360089520,510904060,2,92,46,1360089493788,1360089493788,510877848,510877848,0
1360089520,510904060,1,46,46,1360089493788,1360089493788,510877848,510877848,0
1360089522,3444185284,2,92,46,1360089496691,1360089496691,3444159975,3444159975,0
1360089522,3444185296,2,92,46,1360089494697,1360089494697,3444157993,3444157993,0
1360089522,3444185340,2,92,46,1360089497659,1360089497659,3444160999,3444160999,0
1360089523,510907888,1,46,46,1360089494941,1360089494941,510879829,510879829,0
1360089523,510907900,2,92,46,1360089495954,1360089495954,510880854,510880854,0
1360089523,510907900,1,46,46,1360089495954,1360089495954,510880854,510880854,0
1360089523,510907900,1,46,46,1360089495954,1360089495954,510880854,510880854,0
1360089523,510907900,1,46,46,1360089496017,1360089496017,510880917,510880917,0
1360089523,510907984,2,92,46,1360089494847,1360089494847,510879831,510879831,0
1360089523,510907984,2,92,46,1360089494847,1360089494911,510879831,510879895,64
1360089524,510908060,5,878,175.6,1360089498137,1360089498329,510882197,510882389,192
1360089534,510918428,5,455,91,1360089531947,1360089532011,510916375,510916439,64
1360089534,510918460,3,138,46,1360089530377,1360089530441,510914837,510914901,64
1360089534,510918460,2,92,46,1360089530376,1360089530376,510914836,510914836,0
1360089534,510918496,4,184,46,1360089527655,1360089531239,510912151,510915735,3584
1360089534,510918552,3,138,46,1360089530287,1360089530287,510914839,510914839,0
1360089542,510926528,12,5343,445.25,1360089536900,1360089537284,510921428,510921812,384
1360089543,510927924,4,3224,806,1360089518266,1360089518330,510903190,510903254,64
1360089546,3444209120,3,144,48,1360089536919,1360089541911,3444200039,3444205031,4992
1360089546,3444209140,3,144,48,1360089536897,1360089541889,3444200037,3444205029,4992
1360089546,3444209144,9,1498,166.4444444,1360089537854,1360089542910,3444200998,3444206054,5056
1360089550,510934436,2,92,46,1360089535395,1360089543523,510919831,510927959,8128
1360089550,510934480,9,4950,550,1360089537270,1360089542454,510921750,510926934,5184
1360089551,510935980,2,92,46,1360089524996,1360089524996,510909976,510909976,0
1360089552,510936068,3,138,46,1360089525906,1360089525906,510909974,510909974,0
1360089555,510939960,3,138,46,1360089528023,1360089528023,510912983,510912983,0
1360089556,510940148,5,927,185.4,1360089530818,1360089531010,510914966,510915158,192
1360089558,3444221400,2,92,46,1360089530561,1360089530561,3444193961,3444193961,0
1360089558,3444221444,1,46,46,1360089530515,1360089530515,3444193959,3444193959,0
1360089558,510942480,3,138,46,1360089557431,1360089557495,510941911,510941975,64
1360089558,510942564,3,138,46,1360089556322,1360089556386,510940886,510940950,64
1360089560,510944052,20,16502,825.1,1360089532001,1360089532257,510916053,510916309,256
1360089562,3444225436,15,15498,1033.2,1360089536605,1360089536861,3444200041,3444200297,256
1360089562,3444225456,1,96,96,1360089537735,1360089537735,3444201191,3444201191,0
1360089562,3444225484,18,18898,1049.888889,1360089536554,1360089536746,3444200038,3444200230,192
1360089562,3444225484,14,14828,1059.142857,1360089536554,1360089536874,3444200038,3444200358,320
1360089562,3444225484,10,10272,1027.2,1360089536554,1360089536938,3444200038,3444200422,384
1360089564,510948300,9,4519,502.1111111,1360089537002,1360089537386,510921302,510921686,384
1360089564,510948300,1,46,46,1360089537002,1360089537002,510921302,510921302,0
1360089564,510948300,6,527,87.83333333,1360089537128,1360089537512,510921428,510921812,384
1360089564,510948304,6,522,87,1360089537128,1360089537320,510921432,510921624,192
1360089564,510948304,2,112,56,1360089537254,1360089543654,510921558,510927958,6400
1360089564,510948308,2,192,96,1360089537633,1360089540321,510921941,510924629,2688
1360089564,510948440,6,641,106.8333333,1360089537055,1360089537247,510921495,510921687,192
1360089564,510948440,4,544,136,1360089537309,1360089537501,510921749,510921941,192
1360089564,510948468,1,46,46,1360089537921,1360089537921,510922389,510922389,0
1360089566,3444229400,1,56,56,1360089538176,1360089538176,3444201576,3444201576,0
1360089568,510952232,3,138,46,1360089543725,1360089543789,510927957,510928021,64
1360089568,510952248,1,56,56,1360089542620,1360089542620,510926868,510926868,0
1360089568,510952324,2,92,46,1360089543633,1360089543697,510927957,510928021,64
1360089568,510952364,1,46,46,1360089540267,1360089540267,510924631,510924631,0
1360089574,510958480,3,144,48,1360089565430,1360089570742,510949910,510955222,5312
1360089574,510958488,2,98,49,1360089562669,1360089567725,510947157,510952213,5056
1360089574,510958532,3,144,48,1360089565377,1360089570689,510949909,510955221,5312
1360089574,510958564,3,144,48,1360089562595,1360089567651,510947159,510952215,5056
1360089584,510968324,1,46,46,1360089556559,1360089556559,510940883,510940883,0
1360089588,510972272,1,46,46,1360089559943,1360089559943,510944215,510944215,0
1360089588,510972276,1,46,46,1360089560704,1360089560704,510944980,510944980,0
1360089592,510976468,1,46,46,1360089564931,1360089564931,510949399,510949399,0
1360089596,510980340,3,491,163.6666667,1360089570242,1360089570434,510954582,510954774,192
1360089596,510980480,2,180,90,1360089568052,1360089568116,510952532,510952596,64
1360089598,510982456,4,184,46,1360089590028,1360089597068,510974484,510981524,7040
1360089606,510990468,3,138,46,1360089603775,1360089604927,510988243,510989395,1152
1360089606,510990488,3,138,46,1360089598701,1360089598765,510983189,510983253,64
1360089606,510990544,3,138,46,1360089603702,1360089604918,510988246,510989462,1216
1360089606,510990544,3,138,46,1360089603702,1360089604854,510988246,510989398,1152
1360089606,510990564,2,92,46,1360089598626,1360089598690,510983190,510983254,64
1360089614,510998484,2,92,46,1360089605039,1360089612847,510989523,510997331,7808
1360089620,511004480,1,46,46,1360089592244,1360089592244,510976724,510976724,0
1360089624,511008344,1,46,46,1360089595900,1360089595900,510980244,510980244,0
1360089624,511008392,3,138,46,1360089596815,1360089596879,510981207,510981271,64
1360089624,511008504,1,46,46,1360089596763,1360089596763,510981267,510981267,0
1360089636,511020424,2,180,90,1360089608110,1360089608174,510992534,510992598,64
1360089636,511020496,9,2880,320,1360089610470,1360089627878,510994966,511012374,17408
1360089638,511022508,122,107517,881.2868852,1360089486938,1360089635930,510871446,511020438,148992
1360089656,511040624,5,3135,627,1360089627939,1360089628067,511012563,511012691,128
1360089662,511046472,5,318,63.6,1360089648123,1360089660219,511032595,511044691,12096
1360089662,511046476,4,467,116.75,1360089660218,1360089660858,511044694,511045334,640
1360089662,511046476,6,2642,440.3333333,1360089660218,1360089660858,511044694,511045334,640
1360089662,511046484,6,3176,529.3333333,1360089661167,1360089661807,511045651,511046291,640
1360089662,511046524,17,12633,743.1176471,1360089659015,1360089660807,511043539,511045331,1792
1360089662,511046528,5,532,106.4,1360089659717,1360089660421,511044245,511044949,704
1360089662,511046556,6,2636,439.3333333,1360089660137,1360089660969,511044693,511045525,832
1360089662,511046556,5,486,97.2,1360089660136,1360089660904,511044692,511045460,768
1360089662,511046568,5,1649,329.8,1360089661083,1360089661659,511045651,511046227,576
1360089662,511046568,7,3487,498.1428571,1360089661083,1360089661851,511045651,511046419,768
1360089670,511054476,4,190,47.5,1360089661944,1360089668024,511046420,511052500,6080
1360089670,511054480,3,150,50,1360089662068,1360089667892,511046548,511052372,5824
1360089670,511054480,3,150,50,1360089662068,1360089667892,511046548,511052372,5824
1360089670,511054480,2,98,49,1360089660148,1360089666420,511044628,511050900,6272
1360089670,511054480,3,421,140.3333333,1360089660212,1360089663156,511044692,511047636,2944
1360089670,511054480,6,2636,439.3333333,1360089660211,1360089663219,511044691,511047699,3008
1360089670,511054480,6,973,162.1666667,1360089668211,1360089669043,511052691,511053523,832
1360089670,511054484,6,640,106.6666667,1360089664497,1360089665009,511048981,511049493,512
1360089670,511054484,5,504,100.8,1360089664497,1360089665009,511048981,511049493,512
1360089670,511054484,4,548,137,1360089664496,1360089666544,511048980,511051028,2048
1360089670,511054484,7,634,90.57142857,1360089664496,1360089665136,511048980,511049620,640
1360089670,511054484,5,1517,303.4,1360089664560,1360089665072,511049044,511049556,512
1360089670,511054492,3,144,48,1360089660842,1360089666410,511045334,511050902,5568
1360089670,511054516,6,1695,282.5,1360089661136,1360089663248,511045652,511047764,2112
1360089670,511054516,5,594,118.8,1360089661136,1360089663760,511045652,511048276,2624
1360089670,511054516,6,2636,439.3333333,1360089669072,1360089669328,511053588,511053844,256
1360089670,511054520,5,973,194.6,1360089669325,1360089669773,511053845,511054293,448
1360089670,511054520,3,910,303.3333333,1360089669325,1360089669837,511053845,511054357,512
1360089670,511054520,8,1261,157.625,1360089666123,1360089666571,511050643,511051091,448
1360089670,511054520,4,923,230.75,1360089669322,1360089669706,511053842,511054226,384
1360089670,511054528,6,979,163.1666667,1360089666690,1360089667842,511051218,511052370,1152
1360089670,511054528,8,1261,157.625,1360089666694,1360089667846,511051222,511052374,1152
1360089670,511054528,7,634,90.57142857,1360089663558,1360089664390,511048086,511048918,832
1360089670,511054528,6,640,106.6666667,1360089666693,1360089669189,511051221,511053717,2496
1360089670,511054528,4,467,116.75,1360089666693,1360089667845,511051221,511052373,1152
1360089670,511054528,2,92,46,1360089663749,1360089669317,511048277,511053845,5568
1360089670,511054528,2,98,49,1360089663749,1360089669317,511048277,511053845,5568
1360089670,511054528,6,1734,289,1360089666693,1360089667845,511051221,511052373,1152
1360089670,511054528,5,951,190.2,1360089666692,1360089667844,511051220,511052372,1152
1360089670,511054528,6,1024,170.6666667,1360089666692,1360089668740,511051220,511053268,2048
1360089670,511054528,5,933,186.6,1360089666692,1360089668740,511051220,511053268,2048
1360089670,511054528,6,640,106.6666667,1360089663748,1360089664452,511048276,511048980,704
1360089670,511054528,3,421,140.3333333,1360089663748,1360089664452,511048276,511048980,704
1360089670,511054528,7,3562,508.8571429,1360089663748,1360089664964,511048276,511049492,1216
1360089670,511054532,3,140,46.66666667,1360089659585,1360089666369,511044117,511050901,6784
1360089670,511054532,20,1734,86.7,1360089659329,1360089669185,511043861,511053717,9856
1360089670,511054532,2,98,49,1360089659585,1360089666369,511044117,511050901,6784
1360089670,511054532,4,190,47.5,1360089661888,1360089667904,511046420,511052436,6016
1360089670,511054532,3,144,48,1360089661888,1360089667840,511046420,511052372,5952
1360089670,511054556,4,196,49,1360089661991,1360089667879,511046547,511052435,5888
1360089670,511054556,2,98,49,1360089660070,1360089666342,511044626,511050898,6272
1360089670,511054556,3,144,48,1360089660070,1360089666342,511044626,511050898,6272
1360089670,511054556,7,530,75.71428571,1360089660070,1360089669478,511044626,511054034,9408
1360089670,511054560,19,17124,901.2631579,1360089660130,1360089667618,511044690,511052178,7488
1360089670,511054560,90,118545,1317.166667,1360089661986,1360089663586,511046546,511048146,1600
1360089670,511054560,2,98,49,1360089660066,1360089666338,511044626,511050898,6272
1360089670,511054560,2,98,49,1360089660133,1360089666341,511044693,511050901,6208
1360089670,511054560,4,467,116.75,1360089664419,1360089666019,511048979,511050579,1600
1360089670,511054560,6,1563,260.5,1360089664483,1360089666019,511049043,511050579,1536
1360089670,511054560,7,1861,265.8571429,1360089664419,1360089666019,511048979,511050579,1600
1360089670,511054568,3,144,48,1360089662429,1360089667805,511046997,511052373,5376
1360089670,511054568,5,532,106.4,1360089662365,1360089663069,511046933,511047637,704
1360089670,511054568,6,626,104.3333333,1360089665052,1360089666332,511049620,511050900,1280
1360089670,511054568,5,486,97.2,1360089660762,1360089663194,511045330,511047762,2432
1360089670,511054572,2,98,49,1360089660758,1360089666326,511045330,511050898,5568
1360089670,511054572,8,3268,408.5,1360089661079,1360089663639,511045651,511048211,2560
1360089670,511054600,3,144,48,1360089663163,1360089669243,511047763,511053843,6080
1360089670,511054604,17,13030,766.4705882,1360089661498,1360089662906,511046102,511047510,1408
1360089670,511054604,7,2688,384,1360089663162,1360089663546,511047766,511048150,384
1360089670,511054608,6,1735,289.1666667,1360089666610,1360089669170,511051218,511053778,2560
1360089670,511054608,6,987,164.5,1360089666610,1360089667698,511051218,511052306,1088
1360089670,511054608,6,1815,302.5,1360089666674,1360089667698,511051282,511052306,1024
1360089670,511054608,7,605,86.42857143,1360089666613,1360089669173,511051221,511053781,2560
1360089670,511054608,6,626,104.3333333,1360089666613,1360089667765,511051221,511052373,1152
1360089670,511054608,6,973,162.1666667,1360089666613,1360089667765,511051221,511052373,1152
1360089670,511054608,7,3487,498.1428571,1360089663668,1360089664372,511048276,511048980,704
1360089670,511054608,4,467,116.75,1360089663667,1360089664371,511048275,511048979,704
1360089670,511054608,7,3918,559.7142857,1360089663667,1360089664371,511048275,511048979,704
1360089670,511054612,4,196,49,1360089659312,1360089664432,511043924,511049044,5120
1360089673,3444337116,2,98,49,1360089659124,1360089665908,3444323240,3444330024,6784
1360089674,3444337136,3,144,48,1360089659975,1360089666887,3444323111,3444330023,6912
1360089674,3444337136,2,98,49,1360089660103,1360089666887,3444323239,3444330023,6784
1360089674,3444337140,3,144,48,1360089664962,1360089670914,3444328102,3444334054,5952
1360089674,3444337140,2,98,49,1360089664962,1360089670914,3444328102,3444334054,5952
1360089678,3444341536,2,92,46,1360089652791,1360089652791,3444316327,3444316327,0
1360089678,3444341536,1,46,46,1360089652791,1360089652791,3444316327,3444316327,0
1360089678,3444341572,2,92,46,1360089651733,1360089651797,3444315305,3444315369,64
1360089678,3444341584,1,46,46,1360089652743,1360089652743,3444316327,3444316327,0
1360089678,511062476,3,355,118.3333333,1360089668150,1360089675382,511052626,511059858,7232
1360089678,511062476,9,2722,302.4444444,1360089660217,1360089670969,511044693,511055445,10752
1360089678,511062476,4,956,239,1360089672248,1360089676856,511056724,511061332,4608
1360089678,511062480,2,98,49,1360089664498,1360089670450,511048978,511054930,5952
1360089678,511062480,6,778,129.6666667,1360089676852,1360089677108,511061332,511061588,256
1360089678,511062480,6,428,71.33333333,1360089672691,1360089675187,511057171,511059667,2496
1360089678,511062480,6,1823,303.8333333,1360089672627,1360089675379,511057107,511059859,2752
1360089678,511062480,6,428,71.33333333,1360089672691,1360089675251,511057171,511059731,2560
1360089678,511062484,6,1042,173.6666667,1360089676846,1360089677294,511061330,511061778,448
1360089678,511062508,19,5346,281.3684211,1360089665879,1360089671895,511050387,511056403,6016
1360089678,511062508,7,1591,227.2857143,1360089671191,1360089671575,511055699,511056083,384
1360089678,511062508,5,966,193.2,1360089669334,1360089671510,511053842,511056018,2176
1360089678,511062512,6,1012,168.6666667,1360089669334,1360089670422,511053846,511054934,1088
1360089678,511062512,5,1002,200.4,1360089669330,1360089670994,511053842,511055506,1664
1360089678,511062512,8,2734,341.75,1360089669330,1360089670354,511053842,511054866,1024
1360089678,511062520,6,3522,587,1360089671630,1360089672654,511056150,511057174,1024
1360089678,511062520,4,467,116.75,1360089671629,1360089672589,511056149,511057109,960
1360089678,511062520,2,92,46,1360089666701,1360089675341,511051221,511059861,8640
1360089678,511062520,2,92,46,1360089666701,1360089675341,511051221,511059861,8640
1360089678,511062520,2,92,46,1360089666701,1360089675341,511051221,511059861,8640
1360089678,511062520,10,4690,469,1360089663755,1360089674635,511048275,511059155,10880
1360089678,511062520,3,144,48,1360089666699,1360089675403,511051219,511059923,8704
1360089678,511062520,2,92,46,1360089666699,1360089675339,511051219,511059859,8640
1360089678,511062520,3,144,48,1360089666699,1360089672267,511051219,511056787,5568
1360089678,511062520,4,190,47.5,1360089666699,1360089672203,511051219,511056723,5504
1360089678,511062524,23,15797,686.826087,1360089661895,1360089670023,511046419,511054547,8128
1360089678,511062548,24,10228,426.1666667,1360089660143,1360089676463,511044691,511061011,16320
1360089678,511062548,7,1591,227.2857143,1360089672174,1360089673838,511056722,511058386,1664
1360089678,511062548,7,1869,267,1360089672174,1360089673646,511056722,511058194,1472
1360089678,511062552,5,978,195.6,1360089672170,1360089674602,511056722,511059154,2432
1360089678,511062552,8,1341,167.625,1360089664492,1360089676780,511049044,511061332,12288
1360089678,511062552,3,144,48,1360089664492,1360089670444,511049044,511054996,5952
1360089678,511062552,3,140,46.66666667,1360089664428,1360089670380,511048980,511054932,5952
1360089678,511062556,14,8104,578.8571429,1360089670378,1360089677290,511054934,511061846,6912
1360089678,511062556,4,1364,341,1360089676648,1360089676840,511061204,511061396,192
1360089678,511062556,15,11056,737.0666667,1360089670376,1360089677288,511054932,511061844,6912
1360089678,511062556,4,1364,341,1360089676775,1360089676967,511061331,511061523,192
1360089678,511062560,5,732,146.4,1360089676770,1360089677282,511061330,511061842,512
1360089678,511062560,5,996,199.2,1360089676770,1360089677154,511061330,511061714,384
1360089678,511062564,2,98,49,1360089668962,1360089675298,511053526,511059862,6336
1360089678,511062568,2,279,139.5,1360089669277,1360089675293,511053845,511059861,6016
1360089678,511062568,3,140,46.66666667,1360089669276,1360089675292,511053844,511059860,6016
1360089678,511062596,7,3553,507.5714286,1360089671553,1360089673473,511056149,511058069,1920
1360089678,511062596,18,12480,693.3333333,1360089666625,1360089674561,511051221,511059157,7936
1360089678,511062596,11,8927,811.5454545,1360089666625,1360089675265,511051221,511059861,8640
1360089678,511062596,4,467,116.75,1360089671552,1360089672512,511056148,511057108,960
1360089678,511062596,5,1002,200.4,1360089671552,1360089672576,511056148,511057172,1024
1360089678,511062596,19,12525,659.2105263,1360089666624,1360089674560,511051220,511059156,7936
1360089678,511062596,3,325,108.3333333,1360089666623,1360089675327,511051219,511059923,8704
1360089678,511062600,2,279,139.5,1360089666749,1360089675261,511051349,511059861,8512
1360089680,511064520,2,92,46,1360089667851,1360089675339,511052371,511059859,7488
1360089680,511064560,2,92,46,1360089652642,1360089652642,511037202,511037202,0
1360089680,511064564,1,46,46,1360089652642,1360089652642,511037206,511037206,0
1360089680,511064576,1,46,46,1360089653141,1360089653141,511037717,511037717,0
1360089680,511064656,1,46,46,1360089652549,1360089652549,511037205,511037205,0
1360089681,3444345116,2,98,49,1360089669942,1360089678326,3444334058,3444342442,8384
1360089681,3444345116,3,144,48,1360089669942,1360089678326,3444334058,3444342442,8384
1360089681,3444345116,2,98,49,1360089667638,1360089674870,3444331754,3444338986,7232
1360089682,3444345136,2,98,49,1360089670920,1360089679304,3444334056,3444342440,8384
1360089682,3444345144,3,144,48,1360089669825,1360089675841,3444332969,3444338985,6016
1360089684,511068944,4,2036,509,1360089659237,1360089661989,511044181,511046933,2752
1360089685,511069056,5,988,197.6,1360089660058,1360089663130,511044114,511047186,3072
1360089686,3444349500,25,3669,146.76,1360089659740,1360089670620,3444323240,3444334120,10880
1360089686,3444349520,11,1056,96,1360089661257,1360089684809,3444324777,3444348329,23552
1360089686,3444349544,4,451,112.75,1360089659568,1360089659760,3444323112,3444323304,192
1360089686,3444349568,11,616,56,1360089661337,1360089685465,3444324905,3444349033,24128
1360089686,511070468,3,140,46.66666667,1360089672254,1360089678846,511056722,511063314,6592
1360089686,511070468,2,92,46,1360089672254,1360089678846,511056722,511063314,6592
1360089686,511070472,2,279,139.5,1360089672253,1360089678845,511056725,511063317,6592
1360089686,511070472,3,138,46,1360089678269,1360089685629,511062741,511070101,7360
1360089686,511070472,2,279,139.5,1360089678269,1360089684605,511062741,511069077,6336
1360089686,511070476,8,1273,159.125,1360089680566,1360089682166,511065042,511066642,1600
1360089686,511070476,6,626,104.3333333,1360089680570,1360089682170,511065046,511066646,1600
1360089686,511070476,8,2284,285.5,1360089670520,1360089678904,511054996,511063380,8384
1360089686,511070476,2,279,139.5,1360089676855,1360089682167,511061331,511066643,5312
1360089686,511070476,2,279,139.5,1360089676854,1360089682166,511061330,511066642,5312
1360089686,511070480,4,956,239,1360089684851,1360089685043,511069331,511069523,192
1360089686,511070480,5,995,199,1360089684851,1360089685107,511069331,511069587,256
1360089686,511070480,5,1688,337.6,1360089684851,1360089685235,511069331,511069715,384
1360089686,511070480,5,1687,337.4,1360089684851,1360089685299,511069331,511069779,448
1360089686,511070484,2,92,46,1360089671026,1360089678834,511055510,511063318,7808
1360089686,511070508,5,995,199,1360089681816,1360089683544,511066324,511068052,1728
1360089686,511070508,2,98,49,1360089673943,1360089682135,511058451,511066643,8192
1360089686,511070508,2,98,49,1360089673943,1360089682135,511058451,511066643,8192
1360089686,511070512,5,966,193.2,1360089679382,1360089682134,511063894,511066646,2752
1360089686,511070516,2,279,139.5,1360089671633,1360089678801,511056149,511063317,7168
1360089686,511070524,5,966,193.2,1360089678088,1360089679368,511062612,511063892,1280
1360089686,511070524,2,98,49,1360089672199,1360089678791,511056723,511063315,6592
1360089686,511070524,3,144,48,1360089672199,1360089678791,511056723,511063315,6592
1360089686,511070548,3,325,108.3333333,1360089678190,1360089684590,511062738,511069138,6400
1360089686,511070548,2,92,46,1360089678193,1360089685553,511062741,511070101,7360
1360089686,511070548,3,138,46,1360089678193,1360089685617,511062741,511070165,7424
1360089686,511070548,2,92,46,1360089678321,1360089685617,511062869,511070165,7296
1360089686,511070548,6,626,104.3333333,1360089680495,1360089681903,511065043,511066451,1408
1360089686,511070548,7,2238,319.7142857,1360089670447,1360089678767,511054995,511063315,8320
1360089686,511070552,4,190,47.5,1360089670380,1360089678828,511054932,511063380,8448
1360089686,511070560,2,98,49,1360089679011,1360089685539,511063571,511070099,6528
1360089686,511070564,2,92,46,1360089677537,1360089684193,511062101,511068757,6656
1360089686,511070564,5,969,193.8,1360089681760,1360089683488,511066324,511068052,1728
1360089686,511070588,2,98,49,1360089679305,1360089685513,511063893,511070101,6208
1360089686,511070588,5,1002,200.4,1360089679305,1360089680905,511063893,511065493,1600
1360089686,511070588,4,196,49,1360089679494,1360089685638,511064082,511070226,6144
1360089686,511070592,3,140,46.66666667,1360089671556,1360089678724,511056148,511063316,7168
1360089686,511070592,2,98,49,1360089675266,1360089682050,511059858,511066642,6784
1360089686,511070596,3,144,48,1360089675265,1360089682113,511059861,511066709,6848
1360089686,511070596,5,983,196.6,1360089683456,1360089685184,511068052,511069780,1728
1360089688,511072584,22,2112,96,1360089660876,1360089687692,511045460,511072276,26816
1360089688,511072620,4,867,216.75,1360089663142,1360089663270,511047762,511047890,128
1360089688,511072624,11,616,56,1360089661413,1360089687013,511046037,511071637,25600
1360089688,511072636,6,1022,170.3333333,1360089660056,1360089662616,511044692,511047252,2560
1360089688,511072716,10,560,56,1360089661449,1360089687113,511046165,511071829,25664
1360089688,511072740,12,4627,385.5833333,1360089663534,1360089665838,511048274,511050578,2304
1360089690,3444353120,4,190,47.5,1360089677337,1360089682649,3444340457,3444345769,5312
1360089690,3444353124,3,144,48,1360089681494,1360089688534,3444344618,3444351658,7040
1360089690,3444353140,2,98,49,1360089677315,1360089686083,3444340455,3444349223,8768
1360089690,3444353144,2,98,49,1360089681472,1360089688512,3444344616,3444351656,7040
1360089690,3444353512,15,8313,554.2,1360089664593,1360089680209,3444328105,3444343721,15616
1360089690,3444353516,6,4595,765.8333333,1360089665228,1360089665740,3444328744,3444329256,512
1360089690,3444353556,26,14234,547.4615385,1360089664549,1360089679909,3444328105,3444343465,15360
1360089692,511076560,5,1718,343.6,1360089665061,1360089665573,511049621,511050133,512
1360089692,511076560,5,1113,222.6,1360089665061,1360089665701,511049621,511050261,640
1360089692,511076596,1,46,46,1360089666686,1360089666686,511051282,511051282,0
1360089692,511076628,3,491,163.6666667,1360089667294,1360089668126,511051922,511052754,832
1360089692,511076684,6,2016,336,1360089665960,1360089666664,511050644,511051348,704
1360089692,511076704,1,46,46,1360089666578,1360089666578,511051282,511051282,0
1360089694,3444357524,29,34164,1178.068966,1360089669444,1360089669764,3444332968,3444333288,320
1360089694,511078468,5,1030,206,1360089692222,1360089692926,511076690,511077394,704
1360089694,511078472,20,12572,628.6,1360089678266,1360089686522,511062738,511070994,8256
1360089694,511078472,5,1030,206,1360089686269,1360089688061,511070741,511072533,1792
1360089694,511078476,5,966,193.2,1360089692856,1360089693560,511077332,511078036,704
1360089694,511078480,4,467,116.75,1360089686773,1360089687669,511071253,511072149,896
1360089694,511078480,7,2665,380.7142857,1360089686837,1360089687669,511071317,511072149,832
1360089694,511078480,6,3098,516.3333333,1360089689652,1360089690548,511074132,511075028,896
1360089694,511078480,4,467,116.75,1360089689842,1360089690802,511074322,511075282,960
1360089694,511078500,5,1030,206,1360089693473,1360089693665,511077973,511078165,192
1360089694,511078500,7,1215,173.5714286,1360089693599,1360089693791,511078099,511078291,192
1360089694,511078504,7,2665,380.7142857,1360089687452,1360089688284,511071956,511072788,832
1360089694,511078504,3,140,46.66666667,1360089687451,1360089693211,511071955,511077715,5760
1360089694,511078504,3,150,50,1360089685594,1360089691290,511070098,511075794,5696
1360089694,511078504,5,1030,206,1360089690522,1360089691546,511075026,511076050,1024
1360089694,511078508,4,467,116.75,1360089687641,1360089689113,511072149,511073621,1472
1360089694,511078508,4,467,116.75,1360089687639,1360089688407,511072147,511072915,768
1360089694,511078508,2,98,49,1360089687894,1360089693206,511072402,511077714,5312
1360089694,511078512,3,144,48,1360089687765,1360089693205,511072277,511077717,5440
1360089694,511078512,6,1012,168.6666667,1360089691411,1360089692307,511075923,511076819,896
1360089694,511078512,5,1291,258.2,1360089691667,1360089692499,511076179,511077011,832
1360089694,511078516,3,144,48,1360089688017,1360089693201,511072533,511077717,5184
1360089694,511078540,20,12570,628.5,1360089678198,1360089686582,511062738,511071122,8384
1360089694,511078540,5,966,193.2,1360089686198,1360089688822,511070738,511073362,2624
1360089694,511078544,2,98,49,1360089680501,1360089687989,511065045,511072533,7488
1360089694,511078544,8,1028,128.5,1360089680501,1360089690869,511065045,511075413,10368
1360089694,511078544,2,279,139.5,1360089680501,1360089688053,511065045,511072597,7552
1360089694,511078548,3,140,46.66666667,1360089686702,1360089693166,511071250,511077714,6464
1360089694,511078548,3,144,48,1360089680946,1360089688050,511065494,511072598,7104
1360089694,511078548,2,98,49,1360089680946,1360089687986,511065494,511072534,7040
1360089694,511078548,5,1030,206,1360089689201,1360089690161,511073749,511074709,960
1360089694,511078548,6,1012,168.6666667,1360089684784,1360089687216,511069332,511071764,2432
1360089694,511078552,6,2090,348.3333333,1360089689578,1360089690538,511074130,511075090,960
1360089694,511078552,5,966,193.2,1360089689962,1360089690922,511074514,511075474,960
1360089694,511078556,4,467,116.75,1360089690025,1360089691305,511074581,511075861,1280
1360089694,511078584,3,355,118.3333333,1360089682059,1360089688011,511066643,511072595,5952
1360089694,511078588,8,1865,233.125,1360089685513,1360089691273,511070101,511075861,5760
1360089694,511078592,5,741,148.2,1360089687557,1360089691269,511072149,511075861,3712
1360089694,511078592,3,144,48,1360089687811,1360089693123,511072403,511077715,5312
1360089696,511080428,6,1337,222.8333333,1360089691753,1360089692585,511076181,511077013,832
1360089696,511080564,73,34338,470.3835616,1360089668065,1360089693345,511052629,511077909,25280
1360089696,511080564,23,7843,341,1360089668065,1360089686561,511052629,511071125,18496
1360089696,511080564,14,6382,455.8571429,1360089668129,1360089695457,511052693,511080021,27328
1360089696,511080612,10,1531,153.1,1360089669167,1360089670255,511053779,511054867,1088
1360089696,511080612,6,520,86.66666667,1360089669167,1360089669999,511053779,511054611,832
1360089696,511080644,12,11149,929.0833333,1360089671505,1360089675409,511056149,511060053,3904
1360089696,511080652,24,8009,333.7083333,1360089667974,1360089695430,511052626,511080082,27456
1360089696,511080676,1,46,46,1360089670128,1360089670128,511054804,511054804,0
1360089696,511080680,1,46,46,1360089670125,1360089670125,511054805,511054805,0
1360089696,511080692,1,46,46,1360089668704,1360089668704,511053396,511053396,0
1360089696,511080720,20,17513,875.65,1360089670981,1360089675205,511055701,511059925,4224
1360089696,511080728,2,92,46,1360089669693,1360089670077,511054421,511054805,384
1360089698,3444361484,10,1375,137.5,1360089670571,1360089688811,3444334055,3444352295,18240
1360089698,3444361528,8,980,122.5,1360089670530,1360089671618,3444334058,3444335146,1088
1360089700,511084576,46,14364,312.2608696,1360089672533,1360089695061,511057109,511079637,22528
1360089700,511084576,44,14813,336.6590909,1360089672533,1360089695189,511057109,511079765,22656
1360089700,511084576,43,14294,332.4186047,1360089672533,1360089694933,511057109,511079509,22400
1360089700,511084576,48,14751,307.3125,1360089672533,1360089695253,511057109,511079829,22720
1360089700,511084576,46,14212,308.9565217,1360089672533,1360089694741,511057109,511079317,22208
1360089700,511084576,12,1344,112,1360089672596,1360089695828,511057172,511080404,23232
1360089700,511084612,26,8582,330.0769231,1360089673841,1360089697329,511058453,511081941,23488
1360089700,511084612,24,7901,329.2083333,1360089673841,1360089696753,511058453,511081365,22912
1360089700,511084612,25,8552,342.08,1360089673841,1360089697393,511058453,511082005,23552
1360089700,511084684,42,13844,329.6190476,1360089672423,1360089694759,511057107,511079443,22336
1360089700,511084716,24,8530,355.4166667,1360089673736,1360089697096,511058452,511081812,23360
1360089700,511084716,10,1060,106,1360089673799,1360089686023,511058515,511070739,12224
1360089700,511084716,9,1014,112.6666667,1360089673798,1360089689670,511058514,511074386,15872
1360089700,511084732,8,1160,145,1360089675128,1360089697592,511059860,511082324,22464
1360089702,3444365480,15,9900,660,1360089674096,1360089683504,3444337576,3444346984,9408
1360089702,3444365488,15,9894,659.6,1360089675494,1360089686246,3444338982,3444349734,10752
1360089702,3444365512,21,14772,703.4285714,1360089674063,1360089696271,3444337575,3444359783,22208
1360089702,3444365532,15,9894,659.6,1360089675453,1360089684669,3444338985,3444348201,9216
1360089702,511086476,5,1030,206,1360089696185,1360089698617,511080661,511083093,2432
1360089702,511086476,2,98,49,1360089696185,1360089701497,511080661,511085973,5312
1360089702,511086476,2,279,139.5,1360089696184,1360089701496,511080660,511085972,5312
1360089702,511086476,4,186,46.5,1360089696184,1360089701496,511080660,511085972,5312
1360089702,511086476,2,279,139.5,1360089692088,1360089697528,511076564,511082004,5440
1360089702,511086476,4,190,47.5,1360089696184,1360089701496,511080660,511085972,5312
1360089702,511086480,12,6821,568.4166667,1360089692531,1360089697907,511077011,511082387,5376
1360089702,511086484,5,1030,206,1360089700465,1360089700657,511084949,511085141,192
1360089702,511086492,2,279,139.5,1360089689897,1360089695209,511074389,511079701,5312
1360089702,511086492,5,1023,204.6,1360089694888,1360089696168,511079380,511080660,1280
1360089702,511086520,3,144,48,1360089693645,1360089699341,511078165,511083861,5696
1360089702,511086524,13,7844,603.3846154,1360089687751,1360089694343,511072275,511078867,6592
1360089702,511086524,14,7890,563.5714286,1360089687815,1360089694343,511072339,511078867,6528
1360089702,511086528,7,748,106.8571429,1360089691652,1360089701828,511076180,511086356,10176
1360089702,511086528,2,98,49,1360089691652,1360089697476,511076180,511082004,5824
1360089702,511086528,3,325,108.3333333,1360089693890,1360089699394,511078418,511083922,5504
1360089702,511086532,2,279,139.5,1360089691969,1360089697473,511076501,511082005,5504
1360089702,511086532,6,1076,179.3333333,1360089696128,1360089697984,511080660,511082516,1856
1360089702,511086532,2,279,139.5,1360089696128,1360089701440,511080660,511085972,5312
1360089702,511086532,4,467,116.75,1360089696128,1360089697152,511080660,511081684,1024
1360089702,511086532,3,140,46.66666667,1360089696128,1360089701440,511080660,511085972,5312
1360089702,511086532,5,1030,206,1360089696128,1360089696832,511080660,511081364,704
1360089702,511086536,5,966,193.2,1360089694268,1360089695036,511078804,511079572,768
1360089702,511086556,3,138,46,1360089692456,1360089699368,511077012,511083924,6912
1360089702,511086556,6,1076,179.3333333,1360089696743,1360089699111,511081299,511083667,2368
1360089702,511086560,6,1076,179.3333333,1360089700389,1360089700837,511084949,511085397,448
1360089702,511086560,6,1076,179.3333333,1360089700834,1360089700962,511085394,511085522,128
1360089702,511086564,6,1076,179.3333333,1360089700960,1360089701152,511085524,511085716,192
1360089702,511086564,3,144,48,1360089694751,1360089700383,511079315,511084947,5632
1360089702,511086564,5,1030,206,1360089697439,1360089699615,511082003,511084179,2176
1360089702,511086564,2,279,139.5,1360089689822,1360089695134,511074386,511079698,5312
1360089702,511086568,5,1007,201.4,1360089695323,1360089696347,511079891,511080915,1024
1360089702,511086600,3,144,48,1360089693755,1360089699259,511078355,511083859,5504
1360089704,511088564,16,3532,220.75,1360089678109,1360089695197,511062673,511079761,17088
1360089704,511088568,1,46,46,1360089678171,1360089678171,511062739,511062739,0
1360089704,511088568,7,1336,190.8571429,1360089678170,1360089699290,511062738,511083858,21120
1360089704,511088572,1,46,46,1360089678423,1360089678423,511062995,511062995,0
1360089704,511088572,1,46,46,1360089678423,1360089678423,511062995,511062995,0
1360089704,511088576,1,46,46,1360089678420,1360089678420,511062996,511062996,0
1360089704,511088604,7,1409,201.2857143,1360089678776,1360089700280,511063380,511084884,21504
1360089704,511088688,1,46,46,1360089678306,1360089678306,511062994,511062994,0
1360089704,511088692,1,46,46,1360089678301,1360089678301,511062993,511062993,0
1360089704,511088700,14,3031,216.5,1360089678681,1360089695001,511063381,511079701,16320
1360089708,511092828,3,335,111.6666667,1360089681366,1360089688406,511066194,511073234,7040
1360089710,511094480,3,138,46,1360089696755,1360089702451,511081235,511086931,5696
1360089710,511094488,3,140,46.66666667,1360089697388,1360089703468,511081876,511087956,6080
1360089710,511094516,7,982,140.2857143,1360089693520,1360089703888,511078036,511088404,10368
1360089710,511094564,3,140,46.66666667,1360089697377,1360089703393,511081941,511087957,6016
1360089710,511094564,4,186,46.5,1360089697377,1360089703393,511081941,511087957,6016
1360089710,511094568,8,2788,348.5,1360089693469,1360089703837,511078037,511088405,10368
1360089710,511094600,37,38514,1040.918919,1360089698618,1360089703674,511083218,511088274,5056
1360089712,511096564,1,46,46,1360089686302,1360089686302,511070866,511070866,0
1360089712,511096564,1,46,46,1360089686302,1360089686302,511070866,511070866,0
1360089712,511096568,1,46,46,1360089686429,1360089686429,511070997,511070997,0
1360089712,511096672,1,46,46,1360089686196,1360089686196,511070868,511070868,0
1360089714,3444377744,5,480,96,1360089687783,1360089701351,3444351527,3444365095,13568
1360089714,3444377752,2,395,197.5,1360089688482,1360089688482,3444352234,3444352234,0
1360089714,3444377796,5,280,56,1360089688245,1360089701813,3444352041,3444365609,13568
1360089716,511100576,10,960,96,1360089688660,1360089703764,511073236,511088340,15104
1360089716,511100584,5,280,56,1360089689293,1360089703373,511073877,511087957,14080
1360089716,511100604,5,280,56,1360089689591,1360089703671,511074195,511088275,14080
1360089720,511104760,1,46,46,1360089694109,1360089694109,511078869,511078869,0
1360089720,511104784,5,2900,580,1360089694275,1360089694531,511079059,511079315,256
1360089720,511104836,6,2123,353.8333333,1360089695633,1360089697233,511080469,511082069,1600
1360089720,511104872,1,46,46,1360089693995,1360089693995,511078867,511078867,0
1360089724,511108740,3,138,46,1360089699825,1360089699889,511084565,511084629,64
1360089724,511108744,14,3761,268.6428571,1360089696492,1360089699820,511081236,511084564,3328
1360089724,511108744,14,4055,289.6428571,1360089696491,1360089699883,511081235,511084627,3392
1360089724,511108768,13,3715,285.7692308,1360089697172,1360089700180,511081940,511084948,3008
1360089724,511108768,14,4290,306.4285714,1360089697172,1360089700052,511081940,511084820,2880
1360089724,511108768,14,3761,268.6428571,1360089697172,1360089699988,511081940,511084756,2816
1360089724,511108856,4,1410,352.5,1360089696122,1360089696890,511080978,511081746,768
1360089724,511108856,36,32201,894.4722222,1360089696378,1360089716090,511081234,511100946,19712
1360089724,511108864,14,3761,268.6428571,1360089697074,1360089700018,511081938,511084882,2944
1360089726,511110500,4,184,46,1360089721183,1360089722783,511105683,511107283,1600
1360089726,511110548,11,4357,396.0909091,1360089715825,1360089724529,511100373,511109077,8704
1360089728,511112744,2,92,46,1360089700074,1360089700074,511084818,511084818,0
1360089728,511112748,1,46,46,1360089702182,1360089702182,511086930,511086930,0
1360089728,511112872,1,46,46,1360089702252,1360089702252,511087124,511087124,0
1360089736,511120768,3,138,46,1360089708178,1360089708178,511092946,511092946,0
1360089736,511120772,3,491,163.6666667,1360089708302,1360089708494,511093074,511093266,192
1360089740,511124804,1,46,46,1360089713838,1360089713838,511098642,511098642,0
1360089740,511124848,5,1847,369.4,1360089715523,1360089716163,511100371,511101011,640
1360089740,511124848,7,3649,521.2857143,1360089715523,1360089715907,511100371,511100755,384
1360089740,511124848,5,1064,212.8,1360089715522,1360089716354,511100370,511101202,832
1360089740,511124936,5,1635,327,1360089715434,1360089716202,511100370,511101138,768
1360089740,511124940,5,1064,212.8,1360089715431,1360089716327,511100371,511101267,896
1360089748,511132844,2,92,46,1360089723398,1360089726470,511108242,511111314,3072
1360089748,511132928,3,138,46,1360089722739,1360089722803,511107667,511107731,64
1360089752,511136888,3,138,46,1360089724441,1360089724569,511109329,511109457,128
1360089756,511140816,3,138,46,1360089730467,1360089730531,511115283,511115347,64
1360089756,511140852,3,138,46,1360089731454,1360089731518,511116306,511116370,64
1360089760,511144788,3,138,46,1360089734141,1360089734205,511118929,511118993,64
1360089760,511144936,3,138,46,1360089734698,1360089734762,511119634,511119698,64
1360089760,511144940,2,92,46,1360089734694,1360089734758,511119634,511119698,64
1360089774,511158624,4,196,49,1360089764002,1360089769122,511148626,511153746,5120
1360089776,511160956,6,1094,182.3333333,1360089748565,1360089750293,511133521,511135249,1728
1360089782,511166516,3,138,46,1360089781263,1360089781327,511165779,511165843,64
1360089782,511166520,2,92,46,1360089778249,1360089778249,511162769,511162769,0
1360089782,511166556,3,138,46,1360089780200,1360089780264,511164756,511164820,64
1360089788,511172824,3,138,46,1360089760091,1360089760155,511144915,511144979,64
1360089796,511180836,1,46,46,1360089768333,1360089768333,511153169,511153169,0
1360089800,511184940,3,138,46,1360089772006,1360089772070,511156946,511157010,64
1360089801,511185008,1,46,46,1360089775627,1360089775627,511159635,511159635,0
1360089802,3444465808,2,92,46,1360089775080,1360089775080,3444438888,3444438888,0
1360089804,511188936,1,46,46,1360089777836,1360089777836,511162772,511162772,0
1360089805,511189020,2,92,46,1360089778748,1360089778748,511162768,511162768,0
1360089805,511189052,9,1813,201.4444444,1360089779293,1360089799709,511163345,511183761,20416
1360089806,3444469836,2,92,46,1360089781068,1360089781068,3444444904,3444444904,0
1360089808,511192984,2,92,46,1360089781817,1360089781881,511166801,511166865,64
1360089814,3444477824,2,92,46,1360089787034,1360089787098,3444450858,3444450922,64
1360089822,511206640,24,27439,1143.291667,1360089817488,1360089821392,511202128,511206032,3904
1360089822,3444485800,2,92,46,1360089795058,1360089795122,3444458858,3444458922,64
1360089822,3444485844,2,92,46,1360089795014,1360089795078,3444458858,3444458922,64
1360089826,3444489832,2,92,46,1360089800080,1360089800080,3444463912,3444463912,0
1360089826,3444489864,2,92,46,1360089799027,1360089799027,3444462891,3444462891,0
1360089826,3444489888,2,92,46,1360089800986,1360089800986,3444464874,3444464874,0
1360089830,511214604,3,144,48,1360089819508,1360089824692,511204112,511209296,5184
1360089830,3444493876,2,92,46,1360089804005,1360089804005,3444467881,3444467881,0
1360089830,3444493876,1,46,46,1360089804004,1360089804004,3444467880,3444467880,0
1360089836,511220960,2,92,46,1360089811793,1360089811793,511196753,511196753,0
1360089838,511222552,2,92,46,1360089832681,1360089832681,511217233,511217233,0
1360089838,511222604,3,138,46,1360089832629,1360089832629,511217233,511217233,0
1360089838,3444501856,2,92,46,1360089811003,1360089811067,3444474859,3444474923,64
1360089840,511224924,1,46,46,1360089812852,1360089812852,511197776,511197776,0
1360089840,511224936,2,92,46,1360089814825,1360089814825,511199761,511199761,0
1360089840,511224936,1,46,46,1360089814825,1360089814825,511199761,511199761,0
1360089841,511225096,2,92,46,1360089813681,1360089813681,511197777,511197777,0
1360089841,511225096,1,46,46,1360089813680,1360089813680,511197776,511197776,0
1360089841,511225096,1,46,46,1360089813680,1360089813680,511197776,511197776,0
1360089841,511225096,1,46,46,1360089813679,1360089813679,511197775,511197775,0
1360089841,511225128,1,46,46,1360089815635,1360089815635,511199763,511199763,0
1360089841,511225136,1,46,46,1360089816587,1360089816587,511200723,511200723,0
1360089841,511225136,1,46,46,1360089816587,1360089816587,511200723,511200723,0
1360089844,511228872,2,92,46,1360089815847,1360089815911,511200719,511200783,64
1360089844,511228872,1,46,46,1360089815851,1360089815851,511200723,511200723,0
1360089844,511228872,1,46,46,1360089815914,1360089815914,511200786,511200786,0
1360089844,511228888,13,14017,1078.230769,1360089817113,1360089817177,511202001,511202065,64
1360089844,511228956,3,1443,481,1360089819157,1360089819285,511204113,511204241,128
1360089850,3444513816,6,722,120.3333333,1360089822305,1360089826977,3444486121,3444490793,4672
1360089853,511237056,4,753,188.25,1360089826841,1360089826905,511210897,511210961,64
1360089856,511240956,19,21123,1111.736842,1360089830996,1360089831124,511215952,511216080,128
1360089857,511240996,13,11627,894.3846154,1360089830741,1360089831701,511214737,511215697,960
1360089857,511241052,8,8688,1086,1360089831835,1360089831835,511215887,511215887,0
1360089857,511241068,2,1050,525,1360089831820,1360089831820,511215888,511215888,0
1360089858,3444521812,1,96,96,1360089831462,1360089831462,3444495274,3444495274,0
1360089858,3444521880,1,56,56,1360089832481,1360089832481,3444496361,3444496361,0
1360089861,511245040,1,46,46,1360089836522,1360089836522,511220562,511220562,0
1360089861,511245040,1,96,96,1360089836522,1360089836522,511220562,511220562,0
1360089870,511254580,2,98,49,1360089864461,1360089869453,511249041,511254033,4992
1360089870,511254632,3,144,48,1360089864408,1360089869464,511249040,511254096,5056
1360089885,511269248,3,492,164,1360089859545,1360089859673,511243793,511243921,128
1360089902,511286712,4,184,46,1360089898504,1360089900104,511283216,511284816,1600
1360089925,511309364,3,492,164,1360089899493,1360089899621,511283857,511283985,128
1360089925,511309400,1,46,46,1360089897151,1360089897151,511281551,511281551,0
1360089950,511334672,6,498,83,1360089945712,1360089948592,511330384,511333264,2880
1360089950,511334676,2,92,46,1360089946411,1360089946411,511331087,511331087,0
1360089950,511334760,2,92,46,1360089946264,1360089946264,511331024,511331024,0
1360089950,511334760,3,138,46,1360089946264,1360089946328,511331024,511331088,64
1360089950,511334760,3,138,46,1360089946327,1360089946327,511331087,511331087,0
1360089953,511337532,2,92,46,1360089926459,1360089926523,511310991,511311055,64
1360089965,511349360,6,1894,315.6666667,1360089939943,1360089963239,511324303,511347599,23296
1360089973,511357424,1,46,46,1360089945959,1360089945959,511330383,511330383,0
1360089974,511358704,3,144,48,1360089962831,1360089968271,511347535,511352975,5440
1360089982,511366792,421,308144,731.9334917,1360089241973,1360089979957,510626765,511364749,737984
1360089985,511369380,1,46,46,1360089958098,1360089958098,511342478,511342478,0
1360090006,511390724,3,144,48,1360089996475,1360090001467,511381199,511386191,4992
1360090029,511413424,4,538,134.5,1360090003686,1360090022822,511388110,511407246,19136
1360090029,511413424,15,8518,567.8666667,1360090003749,1360090023013,511388173,511407437,19264
1360090038,511422692,4,277,69.25,1360090037019,1360090037723,511421711,511422415,704
1360090038,511422732,6,431,71.83333333,1360090031536,1360090035056,511416268,511419788,3520
1360090045,511429748,1,62,62,1360090018723,1360090018723,511403471,511403471,0
1360090046,511430820,5,1646,329.2,1360090042969,1360090044825,511427789,511429645,1856
1360090065,511449760,3,231,77,1360090038805,1360090061397,511423565,511446157,22592
1360090065,511449924,4,308,77,1360090038450,1360090051698,511423374,511436622,13248
1360090073,511457736,3,1200,400,1360090047022,1360090059566,511431758,511444302,12544
1360090093,511477740,1,77,77,1360090066986,1360090066986,511451726,511451726,0
1360090101,511485780,1,400,400,1360090076290,1360090076290,511461070,511461070,0
1360090117,511501772,1,77,77,1360090091527,1360090091527,511476299,511476299,0
1360090117,511501840,1,60,60,1360090089669,1360090089669,511474509,511474509,0
1360090125,511509720,1,77,77,1360090097277,1360090097277,511481997,511481997,0
1360090137,511521884,1,400,400,1360090109658,1360090109658,511494542,511494542,0
1360091203,512587816,5,250,50,1360091177483,1360091199755,512562299,512584571,22272
1360091512,512896208,2,120,60,1360091483815,1360091486823,512868023,512871031,3008
1360091736,513120856,1,48,48,1360091710874,1360091710874,513095730,513095730,0
1360092600,513984388,1,46,46,1360092573793,1360092573793,513958181,513958181,0
1360092730,514114636,5,3366,673.2,1360092702568,1360092724392,514087204,514109028,21824
1360092902,514286748,1,442,442,1360092877814,1360092877814,514262562,514262562,0
1360092902,514286748,1,440,440,1360092877814,1360092877814,514262562,514262562,0
1360092902,514286836,1,442,442,1360092877792,1360092877792,514262628,514262628,0
1360092902,514286956,1,441,441,1360092877604,1360092877604,514262560,514262560,0
1360092902,514286956,1,442,442,1360092877604,1360092877604,514262560,514262560,0
1360092902,514286956,1,441,441,1360092877668,1360092877668,514262624,514262624,0
1360092902,514286956,1,442,442,1360092877668,1360092877668,514262624,514262624,0
1360092906,514290744,1,442,442,1360092877883,1360092877883,514262627,514262627,0
1360092906,514290744,1,441,441,1360092877883,1360092877883,514262627,514262627,0
1360092906,514290744,1,441,441,1360092877883,1360092877883,514262627,514262627,0
1360092906,514290744,1,441,441,1360092877882,1360092877882,514262626,514262626,0
1360092906,514290744,1,443,443,1360092877882,1360092877882,514262626,514262626,0
1360092906,514290744,1,442,442,1360092877882,1360092877882,514262626,514262626,0
1360092906,514290744,1,442,442,1360092877946,1360092877946,514262690,514262690,0
1360092906,514290744,1,442,442,1360092877946,1360092877946,514262690,514262690,0
1360092906,514290744,1,442,442,1360092877946,1360092877946,514262690,514262690,0
1360092906,514290744,1,442,442,1360092877945,1360092877945,514262689,514262689,0
1360092906,514290744,1,442,442,1360092877945,1360092877945,514262689,514262689,0
1360092906,514290744,1,441,441,1360092878009,1360092878009,514262753,514262753,0
1360092906,514290824,1,442,442,1360092877801,1360092877801,514262625,514262625,0
1360092906,514290824,1,442,442,1360092877865,1360092877865,514262689,514262689,0
1360092906,514290824,1,442,442,1360092877865,1360092877865,514262689,514262689,0
1360092906,514290824,1,443,443,1360092877865,1360092877865,514262689,514262689,0
1360092906,514290824,1,441,441,1360092877865,1360092877865,514262689,514262689,0
1360092906,514290824,1,441,441,1360092877865,1360092877865,514262689,514262689,0
1360092906,514290824,1,443,443,1360092877864,1360092877864,514262688,514262688,0
1360092906,514290824,1,442,442,1360092877864,1360092877864,514262688,514262688,0
1360092906,514290824,1,442,442,1360092877928,1360092877928,514262752,514262752,0
1360093784,515168040,1,60,60,1360093757738,1360093757738,515141778,515141778,0
1360094919,516303668,1,46,46,1360094891110,1360094891110,516275778,516275778,0
1360096157,517541460,1,46,46,1360096130595,1360096130595,517515055,517515055,0
1360096504,517888796,1,48,48,1360096477070,1360096477070,517861866,517861866,0
1360096783,518167464,3,252,84,1360096757525,1360096761429,518141989,518145893,3904
1360098346,519730744,1,46,46,1360098318884,1360098318884,519703628,519703628,0
1360098491,519875256,1,48,48,1360098463049,1360098463049,519847305,519847305,0
1360098643,520027228,1,46,46,1360098615078,1360098615078,519999306,519999306,0
1360098725,520109664,1,48,48,1360098696623,1360098696623,520081287,520081287,0
1360099582,520966128,3,1540,513.3333333,1360099554553,1360099579193,520938681,520963321,24640
1360099610,520994120,4,5736,1434,1360099582403,1360099604099,520966523,520988219,21696
1360099654,521038416,1,1434,1434,1360099627863,1360099627863,521012279,521012279,0
1360099682,521066580,1,48,48,1360099656755,1360099656755,521041335,521041335,0
1360101120,3455783836,1,46,46,1360101092184,1360101092184,3455756020,3455756020,0
1360102446,523830736,1,46,46,1360102418860,1360102418860,523803596,523803596,0
1360102665,524049108,3,408,136,1360102638366,1360102644382,524022474,524028490,6016
1360103426,524810572,3,408,136,1360103399491,1360103405507,524784063,524790079,6016
1360103535,524919652,1,46,46,1360103509873,1360103509873,524894525,524894525,0
1360103535,524919688,1,46,46,1360103509838,1360103509838,524894526,524894526,0
1360103535,524919724,1,46,46,1360103509864,1360103509864,524894588,524894588,0
1360103535,524919800,1,46,46,1360103509787,1360103509787,524894587,524894587,0
1360103536,524920400,1,46,46,1360103510253,1360103510253,524894653,524894653,0
1360103536,524920420,1,46,46,1360103510232,1360103510232,524894652,524894652,0
1360103536,524920444,1,46,46,1360103510208,1360103510208,524894652,524894652,0
1360103536,524920452,1,46,46,1360103510200,1360103510200,524894652,524894652,0
1360103536,524920492,1,46,46,1360103510222,1360103510222,524894714,524894714,0
1360103536,524920700,1,46,46,1360103509889,1360103509889,524894589,524894589,0
1360103536,524920804,1,46,46,1360103509785,1360103509785,524894589,524894589,0
1360103536,524920816,1,46,46,1360103509837,1360103509837,524894653,524894653,0
1360103537,524921524,1,46,46,1360103510194,1360103510194,524894718,524894718,0
1360103537,524921560,1,46,46,1360103510157,1360103510157,524894717,524894717,0
1360103537,524921560,1,46,46,1360103510157,1360103510157,524894717,524894717,0
1360104128,525512104,3,408,136,1360104101001,1360104107017,525485105,525491121,6016
1360104740,526124904,3,408,136,1360104712098,1360104718114,526097002,526103018,6016
1360105354,526738244,3,408,136,1360105326570,1360105332586,526710814,526716830,6016
1360105871,527255556,1,46,46,1360105843308,1360105843308,527227864,527227864,0
1360105964,527348040,3,408,136,1360105938286,1360105944302,527322326,527328342,6016
1360106577,527961436,3,408,136,1360106552534,1360106558550,527936970,527942986,6016
1360107191,528575428,3,408,136,1360107163927,1360107169943,528548355,528554371,6016
1360107805,529189168,3,408,136,1360107779088,1360107785168,529163256,529169336,6080
1360108258,529642048,1,48,48,1360108230276,1360108230276,529614324,529614324,0
1360108418,529802280,3,408,136,1360108393110,1360108399190,529777390,529783470,6080
1360109032,530415920,3,408,136,1360109007607,1360109013623,530391527,530397543,6016
1360109468,530852904,1,46,46,1360109442521,1360109442521,530827425,530827425,0
1360109644,531028708,3,408,136,1360109619160,1360109625176,531003868,531009884,6016
1360109829,531213256,1,60,60,1360109804123,1360109804123,531188379,531188379,0
1360110193,531577636,1,52,52,1360110166231,1360110166231,531550867,531550867,0
1360110257,531641724,3,408,136,1360110232639,1360110238655,531617363,531623379,6016
1360110610,531994352,2,230,115,1360110584749,1360110584749,531969101,531969101,0
1360110633,532016980,1,46,46,1360110604831,1360110604831,531988811,531988811,0
1360110870,532254904,3,408,136,1360110844737,1360110850753,532229641,532235657,6016
1360111484,532868712,3,408,136,1360111456952,1360111462968,532841664,532847680,6016
1360112094,533478500,3,408,136,1360112068930,1360112074946,533453430,533459446,6016
1360112118,533502552,3,144,48,1360112091917,1360112100813,533476469,533485365,8896
1360113894,535278808,3,408,136,1360113868723,1360113874803,535253531,535259611,6080
1360114521,3469184436,1,46,46,1360114494909,1360114494909,3469158345,3469158345,0
1360114605,535989008,3,408,136,1360114578760,1360114584776,535962768,535968784,6016
1360115302,536686448,3,408,136,1360115275139,1360115281219,536659587,536665667,6080
1360115723,537107564,1,46,46,1360115698251,1360115698251,537082815,537082815,0
1360115976,537359912,3,408,136,1360115951121,1360115957137,537335033,537341049,6016
1360115988,537371904,1,78,78,1360115961115,1360115961115,537345019,537345019,0
1360116276,537660076,1,46,46,1360116248232,1360116248232,537632308,537632308,0
1360116588,537972632,3,408,136,1360116561591,1360116567671,537946223,537952303,6080
1360117201,538585508,3,408,136,1360117174314,1360117180330,538558822,538564838,6016
1360117425,538809820,2,122,61,1360117399152,1360117401648,538783972,538786468,2496
1360117810,539194756,3,408,136,1360117785642,1360117791658,539170398,539176414,6016
1360118424,539808608,3,408,136,1360118397558,1360118403574,539782166,539788182,6016
1360119037,540421828,3,408,136,1360119011279,1360119017359,540396107,540402187,6080
1360119651,541035080,3,408,136,1360119623474,1360119629554,541007554,541013634,6080
1360119736,541120104,1,48,48,1360119707929,1360119707929,541092033,541092033,0
1360120260,541644340,3,408,136,1360120234726,1360120240742,541619066,541625082,6016
1360120873,542257764,3,408,136,1360120846835,1360120852851,542231599,542237615,6016
1360121459,542843436,1,46,46,1360121433393,1360121433393,542817829,542817829,0
1360121479,542863804,1,48,48,1360121450944,1360121450944,542835748,542835748,0
1360121880,543264820,1,48,48,1360121854443,1360121854443,543239263,543239263,0
1360124136,545520872,3,408,136,1360124109459,1360124115475,545494331,545500347,6016
1360125022,546406372,3,408,136,1360124997563,1360125003579,546381935,546387951,6016
1360125636,547019924,3,408,136,1360125610161,1360125616241,546994085,547000165,6080
1360125772,547156664,1,46,46,1360125747145,1360125747145,547131809,547131809,0
1360125772,547156676,1,46,46,1360125747197,1360125747197,547131873,547131873,0
1360125772,547156872,1,46,46,1360125747004,1360125747004,547131876,547131876,0
1360125773,547157692,1,46,46,1360125746989,1360125746989,547131681,547131681,0
1360125773,547157700,1,46,46,1360125746985,1360125746985,547131685,547131685,0
1360125773,547157704,1,46,46,1360125747041,1360125747041,547131745,547131745,0
1360125773,547157736,1,46,46,1360125747011,1360125747011,547131747,547131747,0
1360125773,547157872,1,46,46,1360125747003,1360125747003,547131875,547131875,0
1360125774,547157948,1,46,46,1360125747929,1360125747929,547131877,547131877,0
1360125774,547158556,1,46,46,1360125747128,1360125747128,547131684,547131684,0
1360125774,547158564,1,46,46,1360125747117,1360125747117,547131681,547131681,0
1360125774,547158672,1,46,46,1360125747074,1360125747074,547131746,547131746,0
1360125774,547158680,1,46,46,1360125747068,1360125747068,547131748,547131748,0
1360125774,547158720,1,46,46,1360125747093,1360125747093,547131813,547131813,0
1360125774,547158720,1,46,46,1360125747090,1360125747090,547131810,547131810,0
1360125774,547158756,1,46,46,1360125747054,1360125747054,547131810,547131810,0
1360126020,547403888,1,46,46,1360125991631,1360125991631,547375519,547375519,0
1360126249,547633072,3,408,136,1360126221973,1360126227989,547606045,547612061,6016
1360126862,548246352,3,408,136,1360126835060,1360126841140,548219412,548225492,6080
1360127475,548858916,3,408,136,1360127447069,1360127453149,548830985,548837065,6080
1360128088,549472220,3,408,136,1360128061538,1360128067618,549445758,549451838,6080
1360128701,550085344,3,408,136,1360128674656,1360128680672,550059000,550065016,6016
1360129307,550691204,1,64,64,1360129280481,1360129280481,550664685,550664685,0
1360129315,550699172,3,408,136,1360129289535,1360129295615,550673707,550679787,6080
1360129929,551312976,3,408,136,1360129903996,1360129910012,551287972,551293988,6016
1360130546,551930060,3,408,136,1360130518299,1360130524315,551902359,551908375,6016
1360131011,552395408,1,46,46,1360130983289,1360130983289,552367697,552367697,0
1360131011,552395416,1,46,46,1360130983732,1360130983732,552368148,552368148,0
1360131156,552539876,3,408,136,1360131129933,1360131135949,552513809,552519825,6016
1360133705,555089464,2,96,48,1360133679834,1360133682714,555064298,555067178,2880
1360136208,557592100,1,48,48,1360136179742,1360136179742,557563842,557563842,0
1360136227,557610956,1,60,60,1360136201135,1360136201135,557585091,557585091,0
1360136455,3491118128,1,46,46,1360136427971,1360136427971,3491091099,3491091099,0
1360136513,557897480,1,46,46,1360136485790,1360136485790,557870270,557870270,0
1360136513,557897524,1,46,46,1360136485746,1360136485746,557870270,557870270,0
1360136513,557897556,1,46,46,1360136485779,1360136485779,557870335,557870335,0
1360136513,557897600,1,46,46,1360136485734,1360136485734,557870334,557870334,0
1360136513,557897604,1,46,46,1360136485731,1360136485731,557870335,557870335,0
1360136513,557897636,1,46,46,1360136485697,1360136485697,557870333,557870333,0
1360136513,557897644,1,46,46,1360136485755,1360136485755,557870399,557870399,0
1360136514,557898524,1,46,46,1360136485682,1360136485682,557870206,557870206,0
1360136514,557898564,1,46,46,1360136485641,1360136485641,557870205,557870205,0
1360136514,557898624,1,46,46,1360136485647,1360136485647,557870271,557870271,0
1360136514,557898624,1,46,46,1360136485647,1360136485647,557870271,557870271,0
1360136514,557898684,1,46,46,1360136485651,1360136485651,557870335,557870335,0
1360136514,557898756,1,46,46,1360136485644,1360136485644,557870400,557870400,0
1360136822,558205900,1,46,46,1360136796636,1360136796636,558180536,558180536,0
1360137033,558417252,2,122,61,1360137008505,1360137010873,558392757,558395125,2368
1360137991,559375388,1,46,46,1360137964389,1360137964389,559348777,559348777,0
1360138381,559765608,1,46,46,1360138354177,1360138354177,559738785,559738785,0
1360138516,559900772,1,60,60,1360138491164,1360138491164,559875936,559875936,0
1360140340,561724432,1,46,46,1360140313556,1360140313556,561697988,561697988,0
1360141792,563176204,1,46,46,1360141767650,1360141767650,563151854,563151854,0
1360142284,563668720,1,46,46,1360142259351,1360142259351,563644071,563644071,0
1360142288,563672684,1,46,46,1360142260410,1360142260410,563645094,563645094,0
1360147436,568820596,1,46,46,1360147410884,1360147410884,568795480,568795480,0
1360147436,568820600,1,46,46,1360147410878,1360147410878,568795478,568795478,0
1360147436,568820636,1,46,46,1360147410907,1360147410907,568795543,568795543,0
1360147439,568823688,1,46,46,1360147410857,1360147410857,568795545,568795545,0
1360147439,568823760,1,46,46,1360147410782,1360147410782,568795542,568795542,0
1360147439,568823768,1,46,46,1360147410774,1360147410774,568795542,568795542,0
1360147439,568823796,1,46,46,1360147410809,1360147410809,568795605,568795605,0
1360147440,568823884,1,46,46,1360147411786,1360147411786,568795670,568795670,0
1360147440,568823912,1,46,46,1360147411760,1360147411760,568795672,568795672,0
1360147440,568823936,1,46,46,1360147411734,1360147411734,568795670,568795670,0
1360147440,568823940,1,46,46,1360147411795,1360147411795,568795735,568795735,0
1360147440,568824056,1,46,46,1360147411551,1360147411551,568795607,568795607,0
1360147440,568824092,1,46,46,1360147411515,1360147411515,568795607,568795607,0
1360147440,568824100,1,46,46,1360147411508,1360147411508,568795608,568795608,0
1360147440,568824128,1,46,46,1360147411478,1360147411478,568795606,568795606,0
1360147440,568824172,1,46,46,1360147411497,1360147411497,568795669,568795669,0
1360148676,570060428,1,48,48,1360148646934,1360148646934,570031362,570031362,0
1360151419,572802952,1,46,46,1360151394120,1360151394120,572778072,572778072,0
1360151900,573284248,1,446,446,1360151872988,1360151872988,573257236,573257236,0
1360154946,576330504,2,120,60,1360154921581,1360154924589,576306085,576309093,3008
1360158368,579752072,1,46,46,1360158340711,1360158340711,579724783,579724783,0
1360159695,581079288,1,74,74,1360159668923,1360159668923,581053211,581053211,0
1360161512,582895824,1,48,48,1360161485934,1360161485934,582869758,582869758,0
1360162205,583589380,1,46,46,1360162177848,1360162177848,583562228,583562228,0
1360162920,584303984,1,46,46,1360162893559,1360162893559,584277543,584277543,0
1360163800,585183916,11,1156,105.0909091,1360163799151,1360163799407,585183067,585183323,256
1360163800,585183968,12,1087,90.58333333,1360163799354,1360163799546,585183322,585183514,192
1360163800,585183972,14,1334,95.28571429,1360163799543,1360163799799,585183515,585183771,256
1360163808,585191904,13,1381,106.2307692,1360163799929,1360163800185,585183833,585184089,256
1360259336,680719900,1,48,48,1360259307106,1360259307106,680691006,680691006,0
1360259753,681137040,1,46,46,1360259724814,1360259724814,681108854,681108854,0
1360259891,681274744,1,56,56,1360259866358,1360259866358,681250102,681250102,0
1360261345,3616008568,6,455,75.83333333,1360261341757,1360261341821,3616005325,3616005389,64
1360261351,682734552,26,14558,559.9230769,1360261338655,1360261345375,682722207,682728927,6720
1360261351,682734672,5,437,87.4,1360261349221,1360261350373,682732893,682734045,1152
1360261350,3616013608,2,98,49,1360261345812,1360261352276,3616009420,3616015884,6464
1360261350,3616013608,3,144,48,1360261345812,1360261352276,3616009420,3616015884,6464
1360261353,3616016560,2,98,49,1360261346885,1360261352325,3616010445,3616015885,5440
1360261353,3616016560,3,144,48,1360261343555,1360261349251,3616007115,3616012811,5696
1360261353,3616016560,3,144,48,1360261343554,1360261349250,3616007114,3616012810,5696
1360261353,3616016568,2,98,49,1360261345853,1360261352317,3616009421,3616015885,6464
1360261353,3616016568,2,98,49,1360261346875,1360261352315,3616010443,3616015883,5440
1360261353,3616016568,4,190,47.5,1360261346875,1360261352315,3616010443,3616015883,5440
1360261353,3616016584,3,144,48,1360261343532,1360261349228,3616007116,3616012812,5696
1360261359,682742564,4,190,47.5,1360261346512,1360261357904,682730076,682741468,11392
1360261359,682742564,3,144,48,1360261346512,1360261351888,682730076,682735452,5376
1360261359,682742564,2,98,49,1360261350484,1360261355924,682734048,682739488,5440
1360261359,682742572,2,98,49,1360261347467,1360261352907,682731039,682736479,5440
1360261359,682742572,4,190,47.5,1360261347466,1360261358346,682731038,682741918,10880
1360261359,682742572,3,144,48,1360261347530,1360261352970,682731102,682736542,5440
1360261359,682742608,2,94,47,1360261349284,1360261354916,682732892,682738524,5632
1360261359,682742608,3,144,48,1360261349348,1360261354916,682732956,682738524,5568
1360261359,682742608,4,190,47.5,1360261349348,1360261354980,682732956,682738588,5632
1360261359,682742608,2,98,49,1360261349927,1360261355879,682733535,682739487,5952
1360261359,682742612,2,98,49,1360261350434,1360261355874,682734046,682739486,5440
1360261359,682742612,2,98,49,1360261346466,1360261351842,682730078,682735454,5376
1360261359,682742612,4,190,47.5,1360261346466,1360261353122,682730078,682736734,6656
1360261359,682742612,3,144,48,1360261346466,1360261352930,682730078,682736542,6464
1360261359,682742612,2,98,49,1360261346530,1360261352930,682730142,682736542,6400
1360261359,682742612,2,98,49,1360261346530,1360261352930,682730142,682736542,6400
1360261359,682742612,2,98,49,1360261346530,1360261352930,682730142,682736542,6400
1360261359,682742640,4,190,47.5,1360261347399,1360261357895,682731039,682741535,10496
1360261359,682742640,4,190,47.5,1360261347397,1360261357893,682731037,682741533,10496
1360261359,682742640,4,190,47.5,1360261347397,1360261357829,682731037,682741469,10432
1360261359,682742640,3,144,48,1360261347461,1360261352965,682731101,682736605,5504
1360261359,682742680,26,25945,997.8846154,1360261348959,1360261351839,682732639,682735519,2880
1360261359,682742680,3,144,48,1360261349088,1360261354848,682732768,682738528,5760
1360261359,682742680,3,144,48,1360261349087,1360261354847,682732767,682738527,5760
1360261359,682742680,3,144,48,1360261349215,1360261354847,682732895,682738527,5632
1360261359,682742684,2,98,49,1360261349851,1360261355803,682733535,682739487,5952
1360261361,3616024576,3,144,48,1360261349813,1360261355317,3616013389,3616018893,5504
1360261362,682745980,23,24420,1061.73913,1360261336755,1360261337715,682720735,682721695,960
1360261370,3616033540,39,51848,1329.435897,1360261343574,1360261344918,3616007114,3616008458,1344
1360261370,682754212,9,3000,333.3333333,1360261342665,1360261342857,682726877,682727069,192
1360261370,682754216,4,658,164.5,1360261342148,1360261342212,682726364,682726428,64
1360261370,682754264,8,3189,398.625,1360261345366,1360261345750,682729630,682730014,384
1360261370,682754280,43,37062,861.9069767,1360261342213,1360261343301,682726493,682727581,1088
1360261370,682754292,10,2725,272.5,1360261342712,1360261343160,682727004,682727452,448
1360261370,682754300,18,6588,366,1360261343218,1360261349106,682727518,682733406,5888
1360261370,682754332,13,4779,367.6153846,1360261344339,1360261344915,682728671,682729247,576
1360261370,682754340,3,519,173,1360261345164,1360261345228,682729504,682729568,64
1360261370,682754340,25,12295,491.8,1360261345227,1360261348363,682729567,682732703,3136
1360261374,682757916,21,25732,1225.333333,1360261346160,1360261346480,682730076,682730396,320
1360261374,682757920,10,6716,671.6,1360261346159,1360261350127,682730079,682734047,3968
1360261374,682757920,9,6598,733.1111111,1360261346159,1360261349871,682730079,682733791,3712
1360261374,682757924,1,137,137,1360261346603,1360261346603,682730527,682730527,0
1360261374,682757952,7,933,133.2857143,1360261347788,1360261348812,682731740,682732764,1024
1360261374,682757968,7,568,81.14285714,1360261348928,1360261349120,682732896,682733088,192
1360261374,682757996,11,6855,623.1818182,1360261346080,1360261347040,682730076,682731036,960
1360261374,682757996,6,3256,542.6666667,1360261346080,1360261346336,682730076,682730332,256
1360261374,682758000,5,3092,618.4,1360261346076,1360261346972,682730076,682730972,896
1360261374,682758000,5,3044,608.8,1360261346076,1360261346844,682730076,682730844,768
1360261374,682758000,1,137,137,1360261346524,1360261346524,682730524,682730524,0
1360261374,682758044,3,1201,400.3333333,1360261348722,1360261348914,682732766,682732958,192
1360261374,682758044,6,635,105.8333333,1360261348913,1360261349361,682732957,682733405,448
1360261374,682758076,9,3421,380.1111111,1360261349459,1360261350739,682733535,682734815,1280
1360261374,3616037436,4,423,105.75,1360261345985,1360261346817,3616009421,3616010253,832
1360261374,3616037436,15,16654,1110.266667,1360261345985,1360261346625,3616009421,3616010061,640
1360261374,3616037536,9,8121,902.3333333,1360261345886,1360261346718,3616009422,3616010254,832
1360261375,682758644,7,498,71.14285714,1360261369667,1360261372803,682753311,682756447,3136
1360261378,682762024,25,21529,861.16,1360261350790,1360261351046,682734814,682735070,256
1360261378,682762060,7,1580,225.7142857,1360261352160,1360261358880,682736220,682742940,6720
1360261394,3616057620,10,1348,134.8,1360261368838,1360261369030,3616032458,3616032650,192
1360261399,682782636,3,421,140.3333333,1360261396040,1360261396744,682779676,682780380,704
1360261399,682782644,7,2478,354,1360261396864,1360261397888,682780508,682781532,1024
1360261399,682782648,13,3572,274.7692308,1360261397501,1360261398141,682781149,682781789,640
1360261399,682782648,6,1372,228.6666667,1360261397565,1360261398269,682781213,682781917,704
1360261399,682782648,5,1389,277.8,1360261397565,1360261398141,682781213,682781789,576
1360261399,682782700,6,505,84.16666667,1360261396042,1360261396426,682779742,682780126,384
1360261399,682782728,14,14029,1002.071429,1360261396780,1360261397292,682780508,682781020,512
1360261407,682790588,3,144,48,1360261398906,1360261404666,682782494,682788254,5760
1360261407,682790588,3,144,48,1360261398906,1360261404602,682782494,682788190,5696
1360261407,682790588,3,144,48,1360261398394,1360261403642,682781982,682787230,5248
1360261407,682790592,2,98,49,1360261399094,1360261404662,682782686,682788254,5568
1360261407,682790592,9,3034,337.1111111,1360261402614,1360261406646,682786206,682790238,4032
1360261407,682790592,2,98,49,1360261398645,1360261404661,682782237,682788253,6016
1360261407,682790592,6,1095,182.5,1360261402677,1360261403765,682786269,682787357,1088
1360261407,682790592,2,98,49,1360261398644,1360261404660,682782236,682788252,6016
1360261407,682790596,11,6458,587.0909091,1360261398834,1360261399858,682782430,682783454,1024
1360261407,682790596,3,144,48,1360261399474,1360261404658,682783070,682788254,5184
1360261407,682790600,2,98,49,1360261399918,1360261405614,682783518,682789214,5696
1360261407,682790600,2,98,49,1360261395246,1360261400750,682778846,682784350,5504
1360261407,682790600,6,473,78.83333333,1360261395245,1360261405869,682778845,682789469,10624
1360261407,682790600,5,796,159.2,1360261403437,1360261405805,682787037,682789405,2368
1360261407,682790600,3,144,48,1360261395245,1360261401133,682778845,682784733,5888
1360261407,682790604,2,279,139.5,1360261400363,1360261405611,682783967,682789215,5248
1360261407,682790604,5,1716,343.2,1360261400554,1360261401770,682784158,682785374,1216
1360261407,682790604,3,150,50,1360261400618,1360261406634,682784222,682790238,6016
1360261407,682790604,6,556,92.66666667,1360261400618,1360261403242,682784222,682786846,2624
1360261407,682790604,3,279,93,1360261400554,1360261401770,682784158,682785374,1216
1360261407,682790604,2,98,49,1360261400618,1360261406634,682784222,682790238,6016
1360261407,682790604,3,144,48,1360261400618,1360261406698,682784222,682790302,6080
1360261407,682790604,2,98,49,1360261400618,1360261406634,682784222,682790238,6016
1360261407,682790604,2,298,149,1360261400617,1360261402793,682784221,682786397,2176
1360261407,682790604,2,279,139.5,1360261400681,1360261406633,682784285,682790237,5952
1360261407,682790604,3,150,50,1360261400745,1360261406633,682784349,682790237,5888
1360261407,682790604,2,92,46,1360261400681,1360261406633,682784285,682790237,5952
1360261407,682790628,8,2418,302.25,1360261403923,1360261404243,682787551,682787871,320
1360261407,682790628,3,140,46.66666667,1360261396050,1360261401938,682779678,682785566,5888
1360261407,682790628,2,98,49,1360261396050,1360261401938,682779678,682785566,5888
1360261407,682790632,3,344,114.6666667,1360261401612,1360261403788,682785244,682787420,2176
1360261407,682790632,8,6012,751.5,1360261401997,1360261405389,682785629,682789021,3392
1360261407,682790636,2,98,49,1360261396747,1360261403595,682780383,682787231,6848
1360261407,682790636,12,7594,632.8333333,1360261396810,1360261406410,682780446,682790046,9600
1360261407,682790636,10,2350,235,1360261397192,1360261403592,682780828,682787228,6400
1360261407,682790640,3,144,48,1360261397511,1360261403591,682781151,682787231,6080
1360261407,682790640,2,98,49,1360261398340,1360261403588,682781980,682787228,5248
1360261407,682790664,8,1315,164.375,1360261402348,1360261406508,682786012,682790172,4160
1360261407,682790668,2,98,49,1360261399210,1360261404586,682782878,682788254,5376
1360261407,682790668,7,2544,363.4285714,1360261402538,1360261403370,682786206,682787038,832
1360261407,682790668,6,699,116.5,1360261402538,1360261406058,682786206,682789726,3520
1360261407,682790668,4,196,49,1360261399146,1360261404586,682782814,682788254,5440
1360261407,682790668,6,801,133.5,1360261402537,1360261406185,682786205,682789853,3648
1360261407,682790672,4,196,49,1360261398758,1360261404582,682782430,682788254,5824
1360261407,682790672,2,98,49,1360261398758,1360261404518,682782430,682788190,5760
1360261407,682790672,2,98,49,1360261398758,1360261404518,682782430,682788190,5760
1360261407,682790672,46,51436,1118.173913,1360261394853,1360261406821,682778525,682790493,11968
1360261407,682790672,3,144,48,1360261398757,1360261404709,682782429,682788381,5952
1360261407,682790672,3,144,48,1360261398820,1360261404580,682782492,682788252,5760
1360261407,682790676,8,1298,162.25,1360261399715,1360261400611,682783391,682784287,896
1360261407,682790676,6,861,143.5,1360261399714,1360261400546,682783390,682784222,832
1360261407,682790676,2,98,49,1360261399714,1360261405538,682783390,682789214,5824
1360261407,682790676,7,519,74.14285714,1360261395170,1360261406818,682778846,682790494,11648
1360261407,682790676,7,738,105.4285714,1360261403360,1360261405984,682787036,682789660,2624
1360261407,682790676,6,1101,183.5,1360261403360,1360261403872,682787036,682787548,512
1360261407,682790680,4,190,47.5,1360261403292,1360261405788,682786972,682789468,2496
1360261407,682790680,16,13398,837.375,1360261395423,1360261400031,682779103,682783711,4608
1360261407,682790680,3,144,48,1360261400286,1360261405790,682783966,682789470,5504
1360261407,682790680,7,4463,637.5714286,1360261400477,1360261401693,682784157,682785373,1216
1360261407,682790680,7,4461,637.2857143,1360261400477,1360261401693,682784157,682785373,1216
1360261407,682790680,3,144,48,1360261400541,1360261406557,682784221,682790237,6016
1360261407,682790680,2,298,149,1360261400541,1360261402717,682784221,682786397,2176
1360261407,682790680,2,92,46,1360261400541,1360261406557,682784221,682790237,6016
1360261407,682790680,3,150,50,1360261400669,1360261406557,682784349,682790237,5888
1360261407,682790680,2,98,49,1360261400541,1360261406557,682784221,682790237,6016
1360261407,682790680,2,98,49,1360261400668,1360261406556,682784348,682790236,5888
1360261407,682790684,3,144,48,1360261395930,1360261401946,682779614,682785630,6016
1360261407,682790684,2,98,49,1360261395930,1360261401946,682779614,682785630,6016
1360261407,682790684,8,2418,302.25,1360261403866,1360261404058,682787550,682787742,192
1360261407,682790684,6,696,116,1360261395930,1360261399706,682779614,682783390,3776
1360261407,682790684,3,140,46.66666667,1360261395993,1360261401881,682779677,682785565,5888
1360261407,682790684,4,196,49,1360261396057,1360261401945,682779741,682785629,5888
1360261407,682790700,2,92,46,1360261401416,1360261406536,682785116,682790236,5120
1360261407,682790704,2,298,149,1360261401543,1360261403655,682785247,682787359,2112
1360261407,682790704,2,298,149,1360261401542,1360261403654,682785246,682787358,2112
1360261407,682790704,2,298,149,1360261401670,1360261403654,682785374,682787358,1984
1360261407,682790708,13,10727,825.1538462,1360261396674,1360261405762,682780382,682789470,9088
1360261407,682790708,3,144,48,1360261396674,1360261401922,682780382,682785630,5248
1360261407,682790708,2,98,49,1360261396674,1360261403522,682780382,682787230,6848
1360261407,682790708,11,7914,719.4545455,1360261396738,1360261405826,682780446,682789534,9088
1360261407,682790708,2,98,49,1360261396673,1360261403521,682780381,682787229,6848
1360261407,682790708,2,98,49,1360261396673,1360261401857,682780381,682785565,5184
1360261407,682790716,4,196,49,1360261397499,1360261403707,682781215,682787423,6208
1360261408,3616071652,2,98,49,1360261402089,1360261407913,3616065741,3616071565,5824
1360261409,3616072572,3,144,48,1360261401976,1360261408056,3616065548,3616071628,6080
1360261409,3616072572,3,144,48,1360261396599,1360261402999,3616060171,3616066571,6400
1360261409,3616072576,2,98,49,1360261396597,1360261402997,3616060173,3616066573,6400
1360261409,3616072576,2,98,49,1360261396917,1360261402997,3616060493,3616066573,6080
1360261409,3616072580,2,98,49,1360261402162,1360261407986,3616065742,3616071566,5824
1360261409,3616072580,3,144,48,1360261398322,1360261404082,3616061902,3616067662,5760
1360261409,3616072584,3,144,48,1360261395374,1360261401390,3616058958,3616064974,6016
1360261410,682794044,6,1546,257.6666667,1360261381810,1360261383026,682765854,682767070,1216
1360261414,682797972,3,169,56.33333333,1360261387067,1360261387067,682771039,682771039,0
1360261414,682798004,1,77,77,1360261388059,1360261388059,682772063,682772063,0
1360261414,682798056,1,137,137,1360261387109,1360261387109,682771165,682771165,0
1360261414,682798080,3,169,56.33333333,1360261387919,1360261387983,682771999,682772063,64
1360261415,682798608,2,92,46,1360261403430,1360261408742,682787038,682792350,5312
1360261415,682798608,3,138,46,1360261403493,1360261409893,682787101,682793501,6400
1360261415,682798608,4,196,49,1360261403748,1360261409828,682787356,682793436,6080
1360261415,682798612,4,190,47.5,1360261403616,1360261409632,682787228,682793244,6016
1360261415,682798612,2,92,46,1360261403811,1360261409635,682787423,682793247,5824
1360261415,682798636,3,144,48,1360261401610,1360261407626,682785246,682791262,6016
1360261415,682798636,2,98,49,1360261401738,1360261407562,682785374,682791198,5824
1360261415,682798636,3,150,50,1360261401738,1360261407562,682785374,682791198,5824
1360261415,682798636,10,4538,453.8,1360261401737,1360261407561,682785373,682791197,5824
1360261415,682798636,2,92,46,1360261401609,1360261407625,682785245,682791261,6016
1360261415,682798636,2,98,49,1360261401609,1360261407561,682785245,682791197,5952
1360261415,682798652,3,144,48,1360261402554,1360261408634,682786206,682792286,6080
1360261415,682798672,2,92,46,1360261403364,1360261408676,682787036,682792348,5312
1360261415,682798676,3,138,46,1360261403873,1360261409569,682787549,682793245,5696
1360261415,682798676,3,138,46,1360261403872,1360261409568,682787548,682793244,5696
1360261415,682798680,2,98,49,1360261401566,1360261407518,682785246,682791198,5952
1360261415,682798680,2,92,46,1360261401502,1360261407582,682785182,682791262,6080
1360261415,682798680,2,98,49,1360261401565,1360261407517,682785245,682791197,5952
1360261415,682798680,2,98,49,1360261401565,1360261407517,682785245,682791197,5952
1360261415,682798680,2,92,46,1360261401565,1360261407581,682785245,682791261,6016
1360261415,682798680,2,98,49,1360261401693,1360261407517,682785373,682791197,5824
1360261415,682798680,3,144,48,1360261401565,1360261407517,682785245,682791197,5952
1360261415,682798680,3,144,48,1360261401693,1360261407517,682785373,682791197,5824
1360261415,682798680,2,98,49,1360261401820,1360261407516,682785500,682791196,5696
1360261418,682802060,2,123,61.5,1360261389986,1360261389986,682774046,682774046,0
1360261418,682802100,2,123,61.5,1360261392888,1360261392952,682776988,682777052,64
1360261422,682805976,3,138,46,1360261394422,1360261394486,682778398,682778462,64
1360261422,682805980,9,2635,292.7777778,1360261394930,1360261395378,682778910,682779358,448
1360261422,682805980,4,393,98.25,1360261395312,1360261395632,682779292,682779612,320
1360261422,682805980,8,842,105.25,1360261395312,1360261397808,682779292,682781788,2496
1360261422,682806016,13,10971,843.9230769,1360261396366,1360261398862,682780382,682782878,2496
1360261422,682806016,4,553,138.25,1360261396366,1360261400270,682780382,682784286,3904
1360261422,682806020,10,6803,680.3,1360261397128,1360261397576,682781148,682781596,448
1360261422,682806024,2,92,46,1360261397382,1360261397510,682781406,682781534,128
1360261422,682806052,48,52721,1098.354167,1360261394792,1360261418408,682778844,682802460,23616
1360261422,682806056,5,927,185.4,1360261395236,1360261395684,682779292,682779740,448
1360261422,682806060,3,138,46,1360261395363,1360261395555,682779423,682779615,192
1360261422,682806060,8,842,105.25,1360261395553,1360261397857,682779613,682781917,2304
1360261422,682806060,4,319,79.75,1360261395616,1360261395936,682779676,682779996,320
1360261422,682806060,8,1484,185.5,1360261395616,1360261399008,682779676,682783068,3392
1360261422,682806104,6,997,166.1666667,1360261395959,1360261399223,682780063,682783327,3264
1360261422,682806104,50,61546,1230.92,1360261395958,1360261420342,682780062,682804446,24384
1360261422,682806104,11,3879,352.6363636,1360261396275,1360261398067,682780379,682782171,1792
1360261422,682806104,5,2542,508.4,1360261396275,1360261398259,682780379,682782363,1984
1360261422,682806116,2,92,46,1360261397289,1360261397417,682781405,682781533,128
1360261423,3616085816,8,3963,495.375,1360261397356,1360261399084,3616060172,3616061900,1728
1360261423,682806684,4,190,47.5,1360261409882,1360261415770,682793566,682799454,5888
1360261426,682810004,10,8634,863.4,1360261399385,1360261399577,682783389,682783581,192
1360261426,682810036,3,543,181,1360261400122,1360261400442,682784158,682784478,320
1360261426,682810036,4,465,116.25,1360261400122,1360261401082,682784158,682785118,960
1360261426,682810036,3,543,181,1360261400121,1360261400633,682784157,682784669,512
1360261426,682810036,14,12452,889.4285714,1360261400185,1360261403833,682784221,682787869,3648
1360261426,682810036,4,629,157.25,1360261400121,1360261400953,682784157,682784989,832
1360261426,682810036,4,1626,406.5,1360261400248,1360261401272,682784284,682785308,1024
1360261426,682810076,7,2271,324.4285714,1360261398162,1360261399122,682782238,682783198,960
1360261426,682810076,3,802,267.3333333,1360261398930,1360261398994,682783006,682783070,64
1360261426,682810084,7,3552,507.4285714,1360261399370,1360261399754,682783454,682783838,384
1360261426,682810084,3,544,181.3333333,1360261399306,1360261399818,682783390,682783902,512
1360261426,682810112,12,3508,292.3333333,1360261399980,1360261403308,682784092,682787420,3328
1360261426,682810116,29,36112,1245.241379,1360261400103,1360261400743,682784219,682784859,640
1360261426,682810116,3,584,194.6666667,1360261400043,1360261400811,682784159,682784927,768
1360261426,682810116,12,3380,281.6666667,1360261400043,1360261401323,682784159,682785439,1280
1360261426,682810116,5,1614,322.8,1360261400170,1360261401258,682784286,682785374,1088
1360261426,682810116,20,10600,530,1360261400233,1360261403753,682784349,682787869,3520
1360261426,682810124,9,2806,311.7777778,1360261401186,1360261401570,682785310,682785694,384
1360261426,682810124,3,138,46,1360261401250,1360261401378,682785374,682785502,128
1360261426,3616089752,4,417,104.25,1360261398147,1360261398275,3616061899,3616062027,128
1360261426,3616089788,4,417,104.25,1360261398112,1360261399008,3616061900,3616062796,896
1360261427,3616089808,30,37608,1253.6,1360261400243,1360261400563,3616063051,3616063371,320
1360261427,3616089824,40,50587,1264.675,1360261402726,1360261403046,3616065550,3616065870,320
1360261430,682813992,7,2471,353,1360261402406,1360261403046,682786398,682787038,640
1360261430,682814000,5,3917,783.4,1360261403230,1360261403422,682787230,682787422,192
1360261430,682814024,8,4805,600.625,1360261403910,1360261404038,682787934,682788062,128
1360261430,682814068,7,2471,353,1360261402199,1360261402967,682786267,682787035,768
1360261430,682814076,4,229,57.25,1360261403347,1360261403475,682787423,682787551,128
1360261430,3616093768,9,4513,501.4444444,1360261403891,1360261404275,3616067659,3616068043,384
1360261430,3616093768,27,28024,1037.925926,1360261403891,1360261404531,3616067659,3616068299,640
1360261430,3616093772,9,6236,692.8888889,1360261403890,1360261404274,3616067662,3616068046,384
1360261431,3616093820,85,102079,1200.929412,1360261404455,1360261405223,3616067275,3616068043,768
1360261431,3616093820,25,25848,1033.92,1360261404839,1360261405415,3616067659,3616068235,576
1360261431,3616093820,41,48994,1194.97561,1360261404839,1360261406183,3616067659,3616069003,1344
1360261431,682814608,3,144,48,1360261419365,1360261425445,682802973,682809053,6080
1360261431,682814640,3,144,48,1360261420677,1360261426373,682804317,682810013,5696
1360261431,682814648,4,190,47.5,1360261421311,1360261426431,682804959,682810079,5120
1360261431,682814716,3,144,48,1360261420730,1360261426298,682804446,682810014,5568
1360261431,682814724,5,236,47.2,1360261421168,1360261430768,682804892,682814492,9600
1360261434,682817992,6,336,56,1360261406500,1360261431204,682790492,682815196,24704
1360261434,682818008,3,168,56,1360261407189,1360261425941,682791197,682809949,18752
1360261434,682818040,3,288,96,1360261408180,1360261430516,682792220,682814556,22336
1360261434,682818052,3,168,56,1360261409195,1360261432107,682793247,682816159,22912
1360261434,682818132,5,280,56,1360261408792,1360261431320,682792924,682815452,22528
1360261434,682818132,3,138,46,1360261408792,1360261408792,682792924,682792924,0
1360261434,682818140,4,546,136.5,1360261409232,1360261409360,682793372,682793500,128
1360261434,682818140,4,546,136.5,1360261409235,1360261409491,682793375,682793631,256
1360261435,3616097808,3,168,56,1360261409907,1360261433011,3616072715,3616095819,23104
1360261446,682830004,11,9255,841.3636364,1360261418967,1360261420567,682802971,682804571,1600
1360261446,682830008,56,71849,1283.017857,1360261419285,1360261420629,682803293,682804637,1344
1360261446,682830008,27,33582,1243.777778,1360261419412,1360261419732,682803420,682803740,320
1360261446,682830040,9,6525,725,1360261420148,1360261420852,682804188,682804892,704
1360261446,682830076,1,137,137,1360261417874,1360261417874,682801950,682801950,0
1360261446,682830088,13,9387,722.0769231,1360261418883,1360261420867,682802971,682804955,1984
1360261446,682830088,21,18540,882.8571429,1360261418885,1360261420677,682802973,682804765,1792
1360261446,682830088,17,10145,596.7647059,1360261418885,1360261420677,682802973,682804765,1792
1360261446,682830092,48,60057,1251.1875,1360261419330,1360261420610,682803422,682804702,1280
1360261446,682830116,6,3986,664.3333333,1360261420072,1360261420392,682804188,682804508,320
1360261450,682834108,8,1196,149.5,1360261422896,1360261434480,682807004,682818588,11584
1360261458,682842028,2,123,61.5,1360261431168,1360261431168,682815196,682815196,0
1360261458,682842068,2,123,61.5,1360261432154,1360261432218,682816222,682816286,64
1360261458,682842148,2,123,61.5,1360261432072,1360261432072,682816220,682816220,0
1360261462,682846044,3,168,56,1360261434098,1360261440114,682818142,682824158,6016
1360261462,682846044,3,168,56,1360261434416,1360261440368,682818460,682824412,5952
1360261462,682846044,1,46,46,1360261434415,1360261434415,682818459,682818459,0
1360261462,682846048,1,46,46,1360261434542,1360261434542,682818590,682818590,0
1360261462,682846048,2,112,56,1360261434542,1360261440430,682818590,682824478,5888
1360261462,682846048,2,192,96,1360261434667,1360261442091,682818715,682826139,7424
1360261462,682846088,2,123,61.5,1360261437123,1360261437123,682821211,682821211,0
1360261462,682846092,1,56,56,1360261437376,1360261437376,682821468,682821468,0
1360261462,682846124,2,123,61.5,1360261434082,1360261434082,682818206,682818206,0
1360261462,682846168,1,46,46,1360261435955,1360261435955,682820123,682820123,0
1360261463,682846620,4,215,53.75,1360261455768,1360261455832,682839388,682839452,64
1360261466,682850040,3,138,46,1360261439349,1360261439413,682823389,682823453,64
1360261466,682850040,2,92,46,1360261439349,1360261439413,682823389,682823453,64
1360261466,682850068,3,138,46,1360261440346,1360261440346,682824414,682824414,0
1360261466,682850148,3,169,56.33333333,1360261440008,1360261440072,682824156,682824220,64
1360261466,3616129804,1,56,56,1360261438993,1360261438993,3616102797,3616102797,0
1360261471,682854620,3,138,46,1360261463386,1360261463386,682847006,682847006,0
1360261471,682854624,3,138,46,1360261464403,1360261464467,682848027,682848091,64
1360261471,682854652,3,138,46,1360261465399,1360261465399,682849051,682849051,0
1360261474,682858080,2,123,61.5,1360261446093,1360261446093,682830173,682830173,0
1360261474,682858080,2,123,61.5,1360261446093,1360261446093,682830173,682830173,0
1360261478,682862220,1,137,137,1360261452415,1360261452415,682836635,682836635,0
1360261479,682862628,8,458,57.25,1360261475600,1360261475600,682859228,682859228,0
1360261479,682862660,14,5435,388.2142857,1360261473199,1360261473903,682856859,682857563,704
1360261479,682862660,8,458,57.25,1360261476528,1360261476592,682860188,682860252,64
1360261479,682862672,7,412,58.85714286,1360261477541,1360261477605,682861213,682861277,64
1360261479,682862696,7,412,58.85714286,1360261478542,1360261478542,682862238,682862238,0
1360261479,682862732,14,5473,390.9285714,1360261472616,1360261473192,682856348,682856924,576
1360261481,3616144572,8,1452,181.5,1360261473401,1360261478713,3616136973,3616142285,5312
1360261481,3616144580,3,144,48,1360261473009,1360261478705,3616136589,3616142285,5696
1360261481,3616144596,2,98,49,1360261471650,1360261477730,3616135246,3616141326,6080
1360261482,682866164,3,138,46,1360261454711,1360261454775,682838875,682838939,64
1360261486,682870096,3,138,46,1360261458876,1360261458940,682842972,682843036,64
1360261486,682870208,22,7032,319.6363636,1360261459978,1360261473034,682844186,682857242,13056
1360261486,682870216,8,5455,681.875,1360261460677,1360261471813,682844893,682856029,11136
1360261487,3616149840,1,46,46,1360261462547,1360261462547,3616125387,3616125387,0
1360261487,3616149840,1,46,46,1360261462547,1360261462547,3616125387,3616125387,0
1360261487,3616149844,2,92,46,1360261462545,1360261462545,3616125389,3616125389,0
1360261487,682870608,4,190,47.5,1360261474469,1360261480357,682858077,682863965,5888
1360261487,682870648,8,458,57.25,1360261481594,1360261481594,682865242,682865242,0
1360261490,682874128,3,138,46,1360261462622,1360261462622,682846750,682846750,0
1360261490,682874204,2,92,46,1360261465807,1360261465807,682850011,682850011,0
1360261494,682878112,2,92,46,1360261466860,1360261466924,682850972,682851036,64
1360261498,682882152,7,681,97.28571429,1360261472194,1360261472450,682856346,682856602,256
1360261498,682882152,11,616,56,1360261472325,1360261487301,682856477,682871453,14976
1360261498,682882152,6,522,87,1360261472325,1360261472389,682856477,682856541,64
1360261498,682882156,6,336,56,1360261472574,1360261487422,682856730,682871578,14848
1360261498,682882160,5,280,56,1360261473148,1360261486012,682857308,682870172,12864
1360261498,682882164,1,46,46,1360261473337,1360261473337,682857501,682857501,0
1360261498,682882184,13,2634,202.6153846,1360261470563,1360261472099,682854747,682856283,1536
1360261498,682882228,12,672,56,1360261471991,1360261487799,682856219,682872027,15808
1360261498,682882240,5,480,96,1360261473196,1360261486252,682857436,682870492,13056
1360261499,3616161804,4,424,106,1360261473786,1360261474170,3616136590,3616136974,384
1360261499,3616161816,25,27725,1109,1360261472366,1360261474030,3616135182,3616136846,1664
1360261499,3616161836,6,336,56,1360261473368,1360261488216,3616136204,3616151052,14848
1360261499,3616161852,4,424,106,1360261473738,1360261473994,3616136590,3616136846,256
1360261499,3616161864,25,26629,1065.16,1360261472318,1360261473918,3616135182,3616136782,1600
1360261499,3616161864,18,21047,1169.277778,1360261472317,1360261472637,3616135181,3616135501,320
1360261502,682886116,19,2674,140.7368421,1360261474536,1360261478120,682858652,682862236,3584
1360261502,682886192,3,138,46,1360261474206,1360261474270,682858398,682858462,64
1360261502,682886200,3,138,46,1360261475219,1360261475219,682859419,682859419,0
1360261506,682890116,3,138,46,1360261478311,1360261478311,682862427,682862427,0
1360261506,682890120,2,92,46,1360261479269,1360261479333,682863389,682863453,64
1360261506,682890156,3,138,46,1360261480257,1360261480257,682864413,682864413,0
1360261506,682890196,3,138,46,1360261479190,1360261479254,682863386,682863450,64
1360261510,682894180,2,123,61.5,1360261484070,1360261484070,682868250,682868250,0
1360261510,682894184,1,137,137,1360261484324,1360261484324,682868508,682868508,0
1360261514,682898268,1,46,46,1360261488271,1360261488271,682872539,682872539,0
1360261518,682902136,1,77,77,1360261490069,1360261490069,682874205,682874205,0
1360261518,682902224,2,123,61.5,1360261489981,1360261490045,682874205,682874269,64
1360261519,682902728,110,146700,1333.636364,1360261398698,1360261518250,682782426,682901978,119552
1360261519,682902768,2,92,46,1360261513219,1360261513219,682896987,682896987,0
1360261521,3616184580,3,169,56.33333333,1360261520754,1360261520754,3616184334,3616184334,0
1360261521,3616184600,2,123,61.5,1360261519711,1360261519711,3616183311,3616183311,0
1360261521,3616184600,3,169,56.33333333,1360261519711,1360261519711,3616183311,3616183311,0
1360261521,3616184600,3,169,56.33333333,1360261519711,1360261519775,3616183311,3616183375,64
1360261521,3616184600,2,123,61.5,1360261519711,1360261519711,3616183311,3616183311,0
1360261521,3616184600,3,169,56.33333333,1360261520732,1360261520732,3616184332,3616184332,0
1360261527,682910912,3,169,56.33333333,1360261519026,1360261519090,682902938,682903002,64
1360261527,682910912,5,251,50.2,1360261519093,1360261519157,682903005,682903069,64
1360261527,682910912,4,205,51.25,1360261519093,1360261519093,682903005,682903005,0
1360261534,682918200,3,138,46,1360261508180,1360261508244,682892380,682892444,64
1360261535,682918728,120,111090,925.75,1360261390315,1360261530603,682774043,682914331,140288
1360261535,682918732,7,412,58.85714286,1360261534566,1360261534566,682918298,682918298,0
1360261535,682918816,6,366,61,1360261534485,1360261534485,682918301,682918301,0
1360261535,682918848,7,412,58.85714286,1360261528500,1360261528500,682912348,682912348,0
1360261538,682922180,2,92,46,1360261510758,1360261510822,682894938,682895002,64
1360261538,682922212,2,92,46,1360261511752,1360261511752,682895964,682895964,0
1360261538,682922216,3,1475,491.6666667,1360261512132,1360261512260,682896348,682896476,128
1360261538,682922252,2,92,46,1360261513695,1360261513759,682897947,682898011,64
1360261538,682922300,2,92,46,1360261512686,1360261512686,682896986,682896986,0
1360261538,682922328,1,46,46,1360261513619,1360261513619,682897947,682897947,0
1360261538,682922332,1,46,46,1360261513617,1360261513617,682897949,682897949,0
1360261539,3616201820,1,46,46,1360261514536,1360261514536,3616177356,3616177356,0
1360261539,3616201864,2,92,46,1360261514491,1360261514491,3616177355,3616177355,0
1360261542,682926196,1,46,46,1360261514776,1360261514776,682898972,682898972,0
1360261542,682926236,2,92,46,1360261516720,1360261516720,682900956,682900956,0
1360261542,682926236,1,46,46,1360261516720,1360261516720,682900956,682900956,0
1360261542,682926236,1,46,46,1360261516720,1360261516720,682900956,682900956,0
1360261542,682926268,1,46,46,1360261517837,1360261517837,682902105,682902105,0
1360261542,682926276,1,46,46,1360261514695,1360261514695,682898971,682898971,0
1360261542,682926276,2,92,46,1360261514694,1360261514758,682898970,682899034,64
1360261542,682926280,2,92,46,1360261514690,1360261514690,682898970,682898970,0
1360261542,682926280,1,46,46,1360261514690,1360261514690,682898970,682898970,0
1360261542,682926316,1,46,46,1360261516641,1360261516641,682900957,682900957,0
1360261542,682926340,3,138,46,1360261517063,1360261517127,682901403,682901467,64
1360261543,3616205820,2,92,46,1360261516522,1360261516522,3616179342,3616179342,0
1360261543,3616205860,1,46,46,1360261515457,1360261515457,3616178317,3616178317,0
1360261543,3616205892,1,46,46,1360261518433,1360261518433,3616181325,3616181325,0
1360261543,682926732,4,184,46,1360261535270,1360261542822,682919002,682926554,7552
1360261543,682926744,3,138,46,1360261536221,1360261536285,682919965,682920029,64
1360261543,682926824,3,138,46,1360261536141,1360261536141,682919965,682919965,0
1360261546,682930196,2,92,46,1360261518745,1360261518809,682902941,682903005,64
1360261546,682930196,1,46,46,1360261518871,1360261518871,682903067,682903067,0
1360261546,682930228,7,2164,309.1428571,1360261519736,1360261519992,682903964,682904220,256
1360261550,682934236,1,46,46,1360261524721,1360261524721,682908957,682908957,0
1360261550,682934316,2,92,46,1360261524641,1360261524641,682908957,682908957,0
1360261554,682938236,1,137,137,1360261527983,1360261527983,682912219,682912219,0
1360261558,682942352,3,138,46,1360261531579,1360261531579,682915931,682915931,0
1360261559,682942768,2,98,49,1360261549955,1360261555011,682933723,682938779,5056
1360261559,682942768,2,98,49,1360261549955,1360261555011,682933723,682938779,5056
1360261559,682942768,3,144,48,1360261549955,1360261555011,682933723,682938779,5056
1360261559,682942848,2,98,49,1360261549877,1360261554933,682933725,682938781,5056
1360261559,682942848,2,98,49,1360261549877,1360261554933,682933725,682938781,5056
1360261570,682954244,1,46,46,1360261544487,1360261544487,682928731,682928731,0
1360261570,682954244,10,4146,414.6,1360261544678,1360261565606,682928922,682949850,20928
1360261570,682954340,3,382,127.3333333,1360261544712,1360261544776,682929052,682929116,64
1360261570,682954348,1,46,46,1360261545341,1360261545341,682929689,682929689,0
1360261575,682958848,3,144,48,1360261565874,1360261570994,682949722,682954842,5120
1360261590,682974252,1,137,137,1360261562592,1360261562592,682946844,682946844,0
1360261607,682990740,6,498,83,1360261594654,1360261599710,682978394,682983450,5056
1360261610,682994408,18,5894,327.4444444,1360261584193,1360261608641,682968601,682993049,24448
1360261614,682998372,1,46,46,1360261587494,1360261587494,682971866,682971866,0
1360261615,3616278032,2,92,46,1360261588182,1360261588182,3616251214,3616251214,0
1360261615,3616278052,2,92,46,1360261589185,1360261589185,3616252237,3616252237,0
1360261615,3616278052,1,46,46,1360261589185,1360261589185,3616252237,3616252237,0
1360261615,3616278052,1,46,46,1360261589185,1360261589185,3616252237,3616252237,0
1360261615,3616278104,1,46,46,1360261589135,1360261589135,3616252239,3616252239,0
1360261622,683006288,1,46,46,1360261594106,1360261594106,682978394,682978394,0
1360261622,683006344,1,137,137,1360261597378,1360261597378,682981722,682981722,0
1360261639,683022836,3,138,46,1360261636029,1360261636093,683019865,683019929,64
1360261647,683030756,2,98,49,1360261639312,1360261644880,683023068,683028636,5568
1360261647,683030804,13,5421,417,1360261638877,1360261639389,683022681,683023193,512
1360261647,683030804,4,414,103.5,1360261638877,1360261639645,683022681,683023449,768
1360261647,683030804,3,144,48,1360261638940,1360261644828,683022744,683028632,5888
1360261647,683030804,3,144,48,1360261638940,1360261644828,683022744,683028632,5888
1360261647,683030804,2,94,47,1360261638940,1360261644828,683022744,683028632,5888
1360261647,683030884,4,190,47.5,1360261638221,1360261643789,683022105,683027673,5568
1360261649,3616312696,4,190,47.5,1360261642496,1360261648320,3616306192,3616312016,5824
1360261649,3616312704,2,98,49,1360261638773,1360261644277,3616302477,3616307981,5504
1360261649,3616312704,9,590,65.55555556,1360261638900,1360261644276,3616302604,3616307980,5376
1360261649,3616312724,3,144,48,1360261637923,1360261643299,3616301647,3616307023,5376
1360261655,683038440,15,4603,306.8666667,1360261630216,1360261647240,683013656,683030680,17024
1360261655,683038764,3,144,48,1360261647877,1360261653893,683031641,683037657,6016
1360261655,683038852,2,98,49,1360261647790,1360261653742,683031642,683037594,5952
1360261655,683038884,3,144,48,1360261649487,1360261649487,683033371,683033371,0
1360261658,683042420,1,137,137,1360261632309,1360261632309,683016729,683016729,0
1360261662,683046380,18,14063,781.2777778,1360261637343,1360261657375,683021723,683041755,20032
1360261662,683046380,19,14456,760.8421053,1360261637148,1360261657308,683021528,683041688,20160
1360261663,3616326124,13,14316,1101.230769,1360261638266,1360261638586,3616301390,3616301710,320
1360261663,683046796,3,144,48,1360261657125,1360261662821,683040921,683046617,5696
1360261663,683046804,3,138,46,1360261660830,1360261660894,683044634,683044698,64
1360261663,683046880,3,144,48,1360261657489,1360261662737,683041369,683046617,5248
1360261665,3616328720,3,144,48,1360261656358,1360261662310,3616320078,3616326030,5952
1360261665,3616328720,2,98,49,1360261656614,1360261662246,3616320334,3616325966,5632
1360261666,683050308,6,522,87,1360261638372,1360261638692,683022680,683023000,320
1360261666,683050400,6,635,105.8333333,1360261638346,1360261638666,683022746,683023066,320
1360261674,683058404,7,392,56,1360261649414,1360261667462,683033818,683051866,18048
1360261678,683062348,3,288,96,1360261650684,1360261660284,683035032,683044632,9600
1360261678,683062424,3,168,56,1360261650033,1360261657585,683034457,683042009,7552
1360261679,683062456,6,336,56,1360261651832,1360261665336,683035288,683048792,13504
1360261679,683062464,3,168,56,1360261652403,1360261664947,683035867,683048411,12544
1360261679,3616342132,3,168,56,1360261653684,1360261664756,3616316816,3616327888,11072
1360261679,683062804,2,92,46,1360261662877,1360261673757,683046681,683057561,10880
1360261683,683066472,15,3153,210.2,1360261657002,1360261665130,683040474,683048602,8128
1360261683,683066476,36,46340,1287.222222,1360261657444,1360261657700,683040920,683041176,256
1360261690,683074436,1,137,137,1360261662439,1360261662439,683046875,683046875,0
1360261694,683078360,1,46,46,1360261667440,1360261667440,683051800,683051800,0
1360261707,683090516,19,4979,262.0526316,1360261682429,1360261700797,683065945,683084313,18368
1360261711,683094808,3,144,48,1360261702618,1360261708442,683086426,683092250,5824
1360261711,683094808,20,12285,614.25,1360261703191,1360261704087,683086999,683087895,896
1360261711,683094812,9,4745,527.2222222,1360261703316,1360261708436,683087128,683092248,5120
1360261711,683094820,16,7756,484.75,1360261704141,1360261704653,683087961,683088473,512
1360261711,683094824,2,98,49,1360261700105,1360261705353,683083929,683089177,5248
1360261711,683094856,3,144,48,1360261700583,1360261706407,683084439,683090263,5824
1360261711,683094860,3,144,48,1360261701286,1360261706342,683085146,683090202,5056
1360261711,683094860,8,2252,281.5,1360261701286,1360261706342,683085146,683090202,5056
1360261711,683094860,13,5722,440.1538462,1360261701606,1360261703142,683085466,683087002,1536
1360261711,683094860,4,190,47.5,1360261701795,1360261707363,683085655,683091223,5568
1360261711,683094888,2,98,49,1360261702536,1360261708296,683086424,683092184,5760
1360261711,683094888,3,144,48,1360261702535,1360261708359,683086423,683092247,5824
1360261711,683094892,2,92,46,1360261702981,1360261708357,683086873,683092249,5376
1360261711,683094892,2,92,46,1360261702661,1360261708357,683086553,683092249,5696
1360261711,683094896,15,6188,412.5333333,1360261702785,1360261703233,683086681,683087129,448
1360261711,683094900,2,92,46,1360261703422,1360261709374,683087322,683093274,5952
1360261711,683094904,11,4969,451.7272727,1360261704057,1360261709369,683087961,683093273,5312
1360261711,683094908,2,98,49,1360261700021,1360261705269,683083929,683089177,5248
1360261711,683094932,10,4897,489.7,1360261704861,1360261710237,683088793,683094169,5376
1360261711,683094932,9,4851,539,1360261704861,1360261710237,683088793,683094169,5376
1360261711,683094940,11,5775,525,1360261701204,1360261706260,683085144,683090200,5056
1360261711,683094940,9,581,64.55555556,1360261701331,1360261706579,683085271,683090519,5248
1360261713,3616376704,3,144,48,1360261700790,1360261705910,3616364494,3616369614,5120
1360261713,3616376712,3,144,48,1360261704431,1360261709807,3616368143,3616373519,5376
1360261719,683102580,83,84556,1018.746988,1360261694715,1360261701435,683078295,683085015,6720
1360261719,683102820,8,2264,283,1360261710543,1360261716367,683094363,683100187,5824
1360261719,683102820,11,2396,217.8181818,1360261710542,1360261716302,683094362,683100122,5760
1360261719,683102900,9,568,63.11111111,1360261706619,1360261712187,683090519,683096087,5568
1360261719,683102952,4,547,136.75,1360261718217,1360261718793,683102169,683102745,576
1360261721,3616384716,4,190,47.5,1360261709994,1360261715754,3616373710,3616379470,5760
1360261723,683106508,72,80638,1119.972222,1360261696132,1360261701188,683079640,683084696,5056
1360261723,683106532,10,560,56,1360261696364,1360261720044,683079896,683103576,23680
1360261723,683106624,92,106474,1157.326087,1360261696018,1360261705170,683079642,683088794,9152
1360261723,683106624,92,104713,1138.184783,1360261696018,1360261704978,683079642,683088602,8960
1360261727,683110504,20,17187,859.35,1360261699145,1360261710921,683082649,683094425,11776
1360261727,683110504,6,1716,286,1360261699145,1360261710601,683082649,683094105,11456
1360261727,683110504,3,1215,405,1360261699145,1360261699529,683082649,683083033,384
1360261727,683110540,7,585,83.57142857,1360261700389,1360261720869,683083929,683104409,20480
1360261727,683110580,10,560,56,1360261702141,1360261720509,683085721,683104089,18368
1360261727,683110580,9,4963,551.4444444,1360261702395,1360261702843,683085975,683086423,448
1360261727,683110584,8,5007,625.875,1360261702200,1360261702904,683085784,683086488,704
1360261727,683110596,3,138,46,1360261699309,1360261699437,683082905,683083033,128
1360261727,683110636,18,1008,56,1360261700676,1360261720836,683084312,683104472,20160
1360261727,683110660,6,1252,208.6666667,1360261701227,1360261710891,683084887,683094551,9664
1360261727,683110664,18,10128,562.6666667,1360261701480,1360261705448,683085144,683089112,3968
1360261727,683110664,13,2570,197.6923077,1360261701544,1360261711208,683085208,683094872,9664
1360261727,683110668,19,1064,56,1360261701860,1360261720228,683085528,683103896,18368
1360261727,683110672,6,3836,639.3333333,1360261701986,1360261702178,683085658,683085850,192
1360261727,3616390096,11,9915,901.3636364,1360261701973,1360261702485,3616365069,3616365581,512
1360261727,3616390100,4,424,106,1360261701972,1360261702356,3616365072,3616365456,384
1360261727,3616390100,10,560,56,1360261702226,1360261720466,3616365326,3616383566,18240
1360261727,3616390112,13,15210,1170,1360261702344,1360261702408,3616365456,3616365520,64
1360261727,683110900,4,482,120.5,1360261719164,1360261719484,683103064,683103384,320
1360261731,683114504,7,2534,362,1360261703368,1360261703624,683086872,683087128,256
1360261731,683114508,19,7648,402.5263158,1360261703045,1360261704133,683086553,683087641,1088
1360261731,683114508,9,864,96,1360261703556,1360261720196,683087064,683103704,16640
1360261731,683114512,7,2656,379.4285714,1360261703807,1360261703999,683087319,683087511,192
1360261731,3616394036,6,1931,321.8333333,1360261705107,1360261705299,3616368143,3616368335,192
1360261731,683114644,39,40933,1049.564103,1360261704765,1360261706301,683088409,683089945,1536
1360261731,683114668,12,7846,653.8333333,1360261705443,1360261706083,683089111,683089751,640
1360261731,683114668,10,5498,549.8,1360261705507,1360261705763,683089175,683089431,256
1360261731,683114676,42,44224,1052.952381,1360261706076,1360261719004,683089752,683102680,12928
1360261731,683114676,52,63670,1224.423077,1360261706267,1360261706651,683089943,683090327,384
1360261735,683118516,1,137,137,1360261707707,1360261707707,683091223,683091223,0
1360261735,683118672,1,77,77,1360261709600,1360261709600,683093272,683093272,0
1360261738,683122392,6,989,164.8333333,1360261717713,1360261728401,683102105,683112793,10688
1360261739,683122580,7,3891,555.8571429,1360261713403,1360261713723,683096983,683097303,320
1360261739,683122624,10,2213,221.3,1360261711632,1360261735248,683095256,683118872,23616
1360261739,683122656,1,46,46,1360261712945,1360261712945,683096601,683096601,0
1360261739,683122660,8,1960,245,1360261713325,1360261713773,683096985,683097433,448
1360261739,683122660,8,3385,423.125,1360261713323,1360261713771,683096983,683097431,448
1360261739,683122664,7,1900,271.4285714,1360261713382,1360261713702,683097046,683097366,320
1360261743,3616406044,13,13509,1039.153846,1360261718410,1360261718922,3616381454,3616381966,512
1360261743,3616406048,7,5003,714.7142857,1360261718407,1360261718599,3616381455,3616381647,192
1360261743,3616406048,35,42943,1226.942857,1360261718407,1360261719111,3616381455,3616382159,704
1360261743,3616406096,47,59662,1269.404255,1360261718359,1360261718999,3616381455,3616382095,640
1360261747,683130612,2,92,46,1360261719261,1360261719261,683102873,683102873,0
1360261759,683142948,2,98,49,1360261752587,1360261758155,683136535,683142103,5568
1360261761,3616424712,3,144,48,1360261752047,1360261757807,3616415759,3616421519,5760
1360261761,3616424720,2,98,49,1360261752041,1360261757801,3616415761,3616421521,5760
1360261761,3616424732,2,98,49,1360261752028,1360261757788,3616415760,3616421520,5760
1360261761,3616424732,3,144,48,1360261752028,1360261757788,3616415760,3616421520,5760
1360261767,683150580,1,137,137,1360261740925,1360261740925,683124505,683124505,0
1360261767,683150988,3,144,48,1360261753443,1360261759139,683137431,683143127,5696
1360261775,683158672,6,1214,202.3333333,1360261749728,1360261758880,683133400,683142552,9152
1360261775,683159116,3,138,46,1360261773028,1360261773028,683157144,683157144,0
1360261779,683162552,5,3213,642.6,1360261752407,1360261752471,683135959,683136023,64
1360261779,683162580,4,319,79.75,1360261752957,1360261753085,683136537,683136665,128
1360261779,683162612,2,123,61.5,1360261754523,1360261754587,683138135,683138199,64
1360261779,683162660,7,7721,1103,1360261752493,1360261752557,683136153,683136217,64
1360261779,683162660,3,378,126,1360261752684,1360261752812,683136344,683136472,128
1360261779,3616442088,4,398,99.5,1360261752671,1360261752863,3616415759,3616415951,192
1360261779,683162696,3,385,128.3333333,1360261753737,1360261753865,683137433,683137561,128
1360261779,3616442124,4,398,99.5,1360261752637,1360261752765,3616415761,3616415889,128
1360261783,683167000,4,553,138.25,1360261774870,1360261774934,683158870,683158934,64
1360261785,3616448716,3,144,48,1360261777706,1360261783786,3616441422,3616447502,6080
1360261785,3616448716,2,98,49,1360261777642,1360261782762,3616441358,3616446478,5120
1360261791,683174984,2,98,49,1360261777897,1360261783145,683161881,683167129,5248
1360261791,683174984,9,2298,255.3333333,1360261777961,1360261783145,683161945,683167129,5184
1360261791,683174984,2,98,49,1360261778088,1360261784104,683162072,683168088,6016
1360261791,683174988,3,138,46,1360261789412,1360261790116,683173400,683174104,704
1360261791,683175036,391,485817,1242.498721,1360261649332,1360261786740,683033368,683170776,137408
1360261791,683175056,9,2298,255.3333333,1360261778017,1360261784033,683162073,683168089,6016
1360261795,683178680,37,41471,1120.837838,1360261769369,1360261777881,683153049,683161561,8512
1360261795,683178768,30,32613,1087.1,1360261769089,1360261777729,683152857,683161497,8640
1360261795,683178772,25,24430,977.2,1360261769338,1360261777914,683153110,683161686,8576
1360261803,683186692,6,336,56,1360261775882,1360261785034,683159574,683168726,9152
1360261803,683186732,4,559,139.75,1360261777314,1360261778338,683161046,683162070,1024
1360261803,683186744,11,616,56,1360261778072,1360261785560,683161816,683169304,7488
1360261803,683186780,12,672,56,1360261775667,1360261786931,683159447,683170711,11264
1360261803,683186816,6,576,96,1360261776974,1360261785038,683160790,683168854,8064
1360261807,3616470064,5,280,56,1360261779128,1360261784568,3616442192,3616447632,5440
1360261807,683190668,5,280,56,1360261778914,1360261784418,683162582,683168086,5504
1360261807,683190676,6,1304,217.3333333,1360261779164,1360261784220,683162840,683167896,5056
1360261807,683190756,1,137,137,1360261779211,1360261779211,683162967,683162967,0
1360261807,683190792,1,46,46,1360261780137,1360261780137,683163929,683163929,0
1360261807,683191156,136,175603,1291.198529,1360261705018,1360261806586,683089174,683190742,101568
1360261819,683202728,5,670,134,1360261793385,1360261809193,683177113,683192921,15808
1360261823,683206860,7,2800,400,1360261798435,1360261814563,683182295,683198423,16128
1360261823,683207180,3,138,46,1360261821667,1360261822307,683205847,683206487,640
1360261831,683215120,3,138,46,1360261823263,1360261828639,683207383,683212759,5376
1360261835,683218800,5,385,77,1360261807645,1360261828957,683191445,683212757,21312
1360261841,3616504724,162,215777,1331.95679,1360261717733,1360261839333,3616381457,3616503057,121600
1360261841,3616504744,143,187066,1308.153846,1360261717711,1360261840271,3616381455,3616504015,122560
1360261851,683234860,2,268,134,1360261825251,1360261833315,683209111,683217175,8064
1360261851,683234900,1,46,46,1360261826490,1360261826490,683210390,683210390,0
1360261855,683239076,5,236,47.2,1360261843212,1360261854092,683227288,683238168,10880
1360261855,683239076,2,98,49,1360261843276,1360261849228,683227352,683233304,5952
1360261855,683239080,2,92,46,1360261835846,1360261850118,683219926,683234198,14272
1360261855,683239160,6,497,82.83333333,1360261844215,1360261848311,683228375,683232471,4096
1360261859,683242804,2,446,223,1360261831065,1360261858457,683214869,683242261,27392
1360261863,683247140,3,144,48,1360261850571,1360261855627,683234711,683239767,5056
1360261863,683247224,3,144,48,1360261851317,1360261856501,683235541,683240725,5184
1360261863,683247228,3,144,48,1360261851312,1360261856496,683235540,683240724,5184
1360261867,683250820,1,46,46,1360261840140,1360261840140,683223960,683223960,0
1360261867,683250888,1,137,137,1360261842120,1360261842120,683226008,683226008,0
1360261867,683250972,1,137,137,1360261841969,1360261841969,683225941,683225941,0
1360261867,683250976,9,1528,169.7777778,1360261842285,1360261852653,683226261,683236629,10368
1360261871,3616534064,1,46,46,1360261843768,1360261843768,3616506832,3616506832,0
1360261871,3616534108,2,92,46,1360261843723,1360261843723,3616506831,3616506831,0
1360261871,3616534108,1,46,46,1360261843723,1360261843723,3616506831,3616506831,0
1360261871,3616534108,1,46,46,1360261843722,1360261843722,3616506830,3616506830,0
1360261871,683254952,1,46,46,1360261842758,1360261842758,683226710,683226710,0
1360261871,683255040,1,46,46,1360261842671,1360261842671,683226711,683226711,0
1360261871,683255040,1,46,46,1360261842670,1360261842670,683226710,683226710,0
1360261871,683255244,308,370989,1204.50974,1360261695396,1360261866212,683079640,683250456,170816
1360261871,683255276,2,92,46,1360261868420,1360261868420,683252696,683252696,0
1360261871,683255320,3,138,46,1360261867415,1360261868631,683251735,683252951,1216
1360261871,683255352,116,102824,886.4137931,1360261712629,1360261868597,683096981,683252949,155968
1360261879,683263040,1,77,77,1360261851376,1360261851376,683235416,683235416,0
1360261879,683263328,1248,1746816,1399.692308,1360261775567,1360261874127,683159895,683258455,98560
1360261879,683263376,4,190,47.5,1360261869470,1360261874654,683253846,683259030,5184
1360261883,683267004,1,134,134,1360261857298,1360261857298,683241302,683241302,0
1360261895,3616558068,2,92,46,1360261868021,1360261868021,3616531089,3616531089,0
1360261895,3616558112,1,46,46,1360261867976,1360261867976,3616531088,3616531088,0
1360261895,683279064,2,92,46,1360261867671,1360261867671,683251735,683251735,0
1360261895,683279064,1,46,46,1360261867670,1360261867670,683251734,683251734,0
1360261895,683279112,11,2192,199.2727273,1360261869476,1360261894500,683253588,683278612,25024
1360261895,683279332,157,181954,1158.942675,1360261695304,1360261893640,683079636,683277972,198336
1360261903,683287132,1,137,137,1360261878609,1360261878609,683262741,683262741,0
1360261903,683287232,4,205,51.25,1360261898733,1360261898733,683282965,683282965,0
1360261911,683295352,8,458,57.25,1360261904181,1360261908405,683288533,683292757,4224
1360261919,683303120,2,92,46,1360261892831,1360261892831,683276951,683276951,0
1360261919,683303124,1,46,46,1360261893784,1360261893784,683277908,683277908,0
1360261919,683303256,1,46,46,1360261892692,1360261892692,683276948,683276948,0
1360261919,683303256,2,92,46,1360261892692,1360261892756,683276948,683277012,64
1360261923,683307080,3,655,218.3333333,1360261895236,1360261895364,683279316,683279444,128
1360261939,683323052,10,1789,178.9,1360261913184,1360261913440,683297236,683297492,256
1360261943,683327076,1,137,137,1360261914826,1360261914826,683298902,683298902,0
1360261951,683335104,3,606,202,1360261923758,1360261923886,683307862,683307990,128
1360261959,683343404,2,98,49,1360261953026,1360261958338,683337430,683342742,5312
1360261961,3616624728,3,144,48,1360261954082,1360261959394,3616617810,3616623122,5312
1360261967,683351416,3,144,48,1360261956787,1360261965363,683341203,683349779,8576
1360261967,683351420,8,2252,281.5,1360261954032,1360261959280,683338452,683343700,5248
1360261967,683351420,2,98,49,1360261954032,1360261959280,683338452,683343700,5248
1360261968,683351496,3,144,48,1360261957710,1360261963278,683341206,683346774,5568
1360261968,683351496,9,568,63.11111111,1360261957710,1360261963278,683341206,683346774,5568
1360261968,683351496,2,98,49,1360261954189,1360261960205,683337685,683343701,6016
1360261970,3616632812,3,144,48,1360261957747,1360261963315,3616620559,3616626127,5568
1360261975,683359152,1,137,137,1360261948028,1360261948028,683332180,683332180,0
1360261979,683363092,4,559,139.75,1360261952826,1360261953850,683336918,683337942,1024
1360261979,683363092,4,907,226.75,1360261952825,1360261953593,683336917,683337685,768
1360261979,683363100,7,2019,288.4285714,1360261953586,1360261967474,683337686,683351574,13888
1360261979,683363100,13,10531,810.0769231,1360261953586,1360261967282,683337686,683351382,13696
1360261979,683363100,11,8940,812.7272727,1360261953586,1360261967410,683337686,683351510,13824
1360261979,683363136,8,1121,140.125,1360261954699,1360261954891,683338835,683339027,192
1360261979,683363144,44,39382,895.0454545,1360261951558,1360261967430,683335702,683351574,15872
1360261979,683363184,2,180,90,1360261952988,1360261953052,683337172,683337236,64
1360261979,683363200,13,10205,785,1360261953484,1360261967244,683337684,683351444,13760
1360261979,683363204,4,384,96,1360261953481,1360261954313,683337685,683338517,832
1360261979,683363208,4,675,168.75,1360261954244,1360261954372,683338452,683338580,128
1360261984,683367432,3,144,48,1360261971084,1360261977164,683354516,683360596,6080
1360261991,683375108,6,1100,183.3333333,1360261964072,1360261965928,683348180,683350036,1856
1360262011,683395220,1,137,137,1360261984502,1360261984502,683368722,683368722,0
1360262019,683403164,2,180,90,1360261993071,1360261993071,683377235,683377235,0
1360262019,683403164,1,96,96,1360261993070,1360261993070,683377234,683377234,0
1360262023,683407132,3,605,201.6666667,1360261995343,1360261995535,683379475,683379667,192
1360262023,683407136,19,10523,553.8421053,1360261995660,1360262008908,683379796,683393044,13248
1360262023,683407252,8,1844,230.5,1360261995994,1360262009050,683380246,683393302,13056
1360262023,683407420,2,92,46,1360262014640,1360262020080,683399060,683404500,5440
1360262023,683407420,2,92,46,1360262014766,1360262020078,683399186,683404498,5312
1360262024,683407476,9,2296,255.1111111,1360262014369,1360262020001,683397845,683403477,5632
1360262024,683407476,9,2296,255.1111111,1360262014241,1360262020001,683397717,683403477,5760
1360262024,683407496,2,92,46,1360262015565,1360262021005,683399061,683404501,5440
1360262024,683407496,2,92,46,1360262015564,1360262021004,683399060,683404500,5440
1360262024,683407496,2,92,46,1360262015884,1360262021004,683399380,683404500,5120
1360262024,683407552,9,568,63.11111111,1360262014354,1360262019922,683397906,683403474,5568
1360262024,683407556,10,3763,376.3,1360262014418,1360262019922,683397974,683403478,5504
1360262024,683407556,10,620,62,1360262014673,1360262019921,683398229,683403477,5248
1360262027,683411356,2,92,46,1360262014640,1360262020144,683398996,683404500,5504
1360262032,683415756,2,92,46,1360262029706,1360262030730,683413462,683414486,1024
1360262032,683415824,2,92,46,1360262029893,1360262030917,683413717,683414741,1024
1360262032,683415824,2,92,46,1360262029636,1360262030596,683413460,683414420,960
1360262039,3616702332,5,280,56,1360262013292,1360262036780,3616676624,3616700112,23488
1360262039,683423400,9,2841,315.6666667,1360262014723,1360262015747,683399123,683400147,1024
1360262039,683423412,25,14452,578.08,1360262012086,1360262015414,683396498,683399826,3328
1360262040,683423440,27,19154,709.4074074,1360262013700,1360262015748,683397140,683399188,2048
1360262040,683423444,8,4774,596.75,1360262013953,1360262016257,683397397,683399701,2304
1360262040,683423444,9,504,56,1360262013951,1360262038655,683397395,683422099,24704
1360262040,683423448,9,2806,311.7777778,1360262014266,1360262015610,683397714,683399058,1344
1360262040,683423568,16,4214,263.375,1360262015364,1360262035972,683398932,683419540,20608
1360262040,683423576,50,48953,979.06,1360262011834,1360262016378,683395410,683399954,4544
1360262040,683423604,40,43600,1090,1360262012895,1360262016159,683396499,683399763,3264
1360262040,683423604,52,51922,998.5,1360262012895,1360262016351,683396499,683399955,3456
1360262040,683423608,5,280,56,1360262013276,1360262037020,683396884,683420628,23744
1360262040,683423612,13,4233,325.6153846,1360262013529,1360262035225,683397141,683418837,21696
1360262040,683423612,8,448,56,1360262013783,1360262036887,683397395,683420499,23104
1360262040,683423616,4,224,56,1360262013909,1360262035477,683397525,683419093,21568
1360262040,683423616,4,384,96,1360262013971,1360262036307,683397587,683419923,22336
1360262040,683423648,7,2749,392.7142857,1360262014004,1360262015348,683397652,683398996,1344
1360262040,683423652,7,2656,379.4285714,1360262015086,1360262015726,683398738,683399378,640
1360262040,683423660,7,2656,379.4285714,1360262015082,1360262015722,683398742,683399382,640
1360262040,683423700,7,1883,269,1360262035968,1360262036224,683419668,683419924,256
1360262040,683423704,2,92,46,1360262032763,1360262036731,683416467,683420435,3968
1360262040,683423704,2,92,46,1360262032762,1360262036794,683416466,683420498,4032
1360262040,683423780,6,1065,177.5,1360262035887,1360262038319,683419667,683422099,2432
1360262040,683423788,2,92,46,1360262032937,1360262036969,683416725,683420757,4032
1360262041,3616704796,3,144,48,1360262034715,1360262040155,3616698511,3616703951,5440
1360262043,683427424,6,1496,249.3333333,1360262015980,1360262036140,683400404,683420564,20160
1360262048,683431696,14,3737,266.9285714,1360262036101,1360262041605,683419797,683425301,5504
1360262048,683431736,2,98,49,1360262035419,1360262040859,683419155,683424595,5440
1360262048,683431736,3,144,48,1360262035418,1360262040858,683419154,683424594,5440
1360262048,683431736,9,580,64.44444444,1360262035418,1360262040858,683419154,683424594,5440
1360262048,683431772,16,4052,253.25,1360262035830,1360262041014,683419602,683424786,5184
1360262048,683431780,13,5792,445.5384615,1360262036401,1360262041841,683420181,683425621,5440
1360262048,683431816,2,98,49,1360262034442,1360262039754,683418258,683423570,5312
1360262057,683441104,1,46,46,1360262028909,1360262028909,683413013,683413013,0
1360262057,683441128,1,137,137,1360262028883,1360262028883,683413011,683413011,0
1360262057,683441168,1,46,46,1360262028844,1360262028844,683413012,683413012,0
1360262058,683442136,1,46,46,1360262028746,1360262028746,683412882,683412882,0
1360262058,683442180,1,46,46,1360262028830,1360262028830,683413010,683413010,0
1360262059,683442540,1,46,46,1360262029533,1360262029533,683413073,683413073,0
1360262059,683442980,30,15586,519.5333333,1360262035942,1360262051302,683419922,683435282,15360
1360262060,683443468,9,10280,1142.222222,1360262034470,1360262035430,683417938,683418898,960
1360262060,683443472,9,7375,819.4444444,1360262034530,1360262035426,683418002,683418898,896
1360262060,683443504,15,3101,206.7333333,1360262035587,1360262048259,683419091,683431763,12672
1360262060,683443504,4,559,139.75,1360262035650,1360262035906,683419154,683419410,256
1360262060,683443540,2,180,90,1360262033694,1360262033758,683417234,683417298,64
1360262060,683443544,16,10635,664.6875,1360262034075,1360262035419,683417619,683418963,1344
1360262060,683443588,2,680,340,1360262035185,1360262035313,683418773,683418901,128
1360262060,683443588,4,922,230.5,1360262035310,1360262035630,683418898,683419218,320
1360262060,683443592,1,625,625,1360262035245,1360262035245,683418837,683418837,0
1360262060,683443592,4,559,139.75,1360262035564,1360262035884,683419156,683419476,320
1360262060,683443592,4,559,139.75,1360262035562,1360262035690,683419154,683419282,128
1360262063,683447408,14,10173,726.6428571,1360262035132,1360262035580,683419540,683419988,448
1360262063,683447408,7,2565,366.4285714,1360262035195,1360262035323,683419603,683419731,128
1360262063,683447416,10,5400,540,1360262035698,1360262035954,683420114,683420370,256
1360262064,683448388,22,21626,983,1360262060111,1360262063823,683444499,683448211,3712
1360262064,683448388,15,13008,867.2,1360262060111,1360262063823,683444499,683448211,3712
1360262064,683448388,18,19154,1064.111111,1360262060111,1360262063823,683444499,683448211,3712
1360262064,683448392,22,19296,877.0909091,1360262060105,1360262063817,683444497,683448209,3712
1360262064,683448412,2,98,49,1360262058040,1360262063608,683442452,683448020,5568
1360262065,683448464,2,98,49,1360262058988,1360262064556,683442452,683448020,5568
1360262065,683448488,14,10301,735.7857143,1360262060946,1360262064530,683444434,683448018,3584
1360262065,683448492,15,11086,739.0666667,1360262061005,1360262064717,683444497,683448209,3712
1360262067,3616730324,10,560,56,1360262042419,1360262065907,3616705743,3616729231,23488
1360262067,683451408,22,1232,56,1360262039164,1360262066300,683423572,683450708,27136
1360262068,683451452,19,1064,56,1360262041845,1360262067125,683425297,683450577,25280
1360262068,683451532,10,560,56,1360262041064,1360262066728,683424596,683450260,25664
1360262068,683451536,11,1056,96,1360262041253,1360262066917,683424789,683450453,25664
1360262068,683451568,11,616,56,1360262042564,1360262067204,683426132,683450772,24640
1360262072,683455428,1,46,46,1360262045328,1360262045328,683428756,683428756,0
1360262072,683455572,31,26038,839.9354839,1360262046400,1360262067328,683429972,683450900,20928
1360262072,683456376,5,242,48.4,1360262064029,1360262065437,683448405,683449813,1408
1360262072,683456376,3,150,50,1360262064028,1360262064668,683448404,683449044,640
1360262072,683456376,3,1568,522.6666667,1360262064028,1360262064348,683448404,683448724,320
1360262072,683456376,5,242,48.4,1360262059354,1360262065946,683443730,683450322,6592
1360262072,683456384,5,248,49.6,1360262063633,1360262069713,683448017,683454097,6080
1360262072,683456384,21,20281,965.7619048,1360262060114,1360262063890,683444498,683448274,3776
1360262072,683456384,21,22361,1064.809524,1360262060114,1360262064082,683444498,683448466,3968
1360262072,683456384,3,150,50,1360262064850,1360262071698,683449234,683456082,6848
1360262073,683456452,2,1378,689,1360262064950,1360262064950,683448402,683448402,0
1360262073,683456456,2,98,49,1360262060019,1360262065587,683443475,683449043,5568
1360262073,683456456,4,196,49,1360262060019,1360262066675,683443475,683450131,6656
1360262073,683456456,6,294,49,1360262060146,1360262066866,683443602,683450322,6720
1360262073,683456460,6,288,48,1360262060271,1360262066863,683443731,683450323,6592
1360262073,683456464,5,248,49.6,1360262064557,1360262070637,683448021,683454101,6080
1360262073,683456464,4,202,50.5,1360262064557,1360262070637,683448021,683454101,6080
1360262073,683456468,5,248,49.6,1360262065705,1360262072617,683449173,683456085,6912
1360262073,683456500,8,544,68,1360262067080,1360262072584,683450580,683456084,5504
1360262080,683464388,3,144,48,1360262067471,1360262073679,683451859,683458067,6208
1360262080,683464388,2,98,49,1360262067471,1360262073679,683451859,683458067,6208
1360262080,683464388,3,144,48,1360262067471,1360262073743,683451859,683458131,6272
1360262080,683464388,3,144,48,1360262067470,1360262073678,683451858,683458066,6208
1360262080,683464392,2,98,49,1360262067723,1360262073675,683452115,683458067,5952
1360262080,683464392,2,98,49,1360262067723,1360262073675,683452115,683458067,5952
1360262080,683464392,2,98,49,1360262067723,1360262073739,683452115,683458131,6016
1360262080,683464392,2,98,49,1360262067787,1360262073675,683452179,683458067,5888
1360262080,683464392,3,144,48,1360262067722,1360262073802,683452114,683458194,6080
1360262080,683464396,3,144,48,1360262068165,1360262073733,683452561,683458129,5568
1360262080,683464396,2,98,49,1360262068165,1360262073669,683452561,683458065,5504
1360262081,683464436,3,144,48,1360262071687,1360262077703,683455123,683461139,6016
1360262081,683464464,2,98,49,1360262068394,1360262074602,683451858,683458066,6208
1360262081,683464464,2,98,49,1360262068393,1360262074601,683451857,683458065,6208
1360262081,683464464,2,98,49,1360262068393,1360262074601,683451857,683458065,6208
1360262081,683464468,2,98,49,1360262068646,1360262074598,683452114,683458066,5952
1360262081,683464468,2,98,49,1360262068646,1360262074662,683452114,683458130,6016
1360262081,683464468,2,98,49,1360262068646,1360262074662,683452114,683458130,6016
1360262081,683464472,2,98,49,1360262068963,1360262074595,683452435,683458067,5632
1360262081,683464476,2,98,49,1360262069089,1360262074593,683452565,683458069,5504
1360262083,683467416,55,67934,1235.163636,1360262056050,1360262059442,683440466,683443858,3392
1360262083,683467420,25,28105,1124.2,1360262056048,1360262057712,683440468,683442132,1664
1360262084,683467468,7,3991,570.1428571,1360262058984,1360262059688,683442452,683443156,704
1360262084,683467468,4,252,63,1360262059111,1360262059687,683442579,683443155,576
1360262084,683467468,3,175,58.33333333,1360262059174,1360262059558,683442642,683443026,384
1360262084,683467500,71,91104,1283.15493,1360262056966,1360262059078,683440466,683442578,2112
1360262084,683467500,92,122073,1326.880435,1360262056966,1360262061062,683440466,683444562,4096
1360262084,683467504,20,20171,1008.55,1360262056964,1360262058500,683440468,683442004,1536
1360262084,683467504,43,56800,1320.930233,1360262056964,1360262059780,683440468,683443284,2816
1360262084,683467548,11,9466,860.5454545,1360262058837,1360262059605,683442385,683443153,768
1360262084,683467576,59,64856,1099.254237,1360262055995,1360262066427,683439571,683450003,10432
1360262087,683471420,2,129,64.5,1360262059185,1360262059505,683443605,683443925,320
1360262088,683471428,4,399,99.75,1360262060749,1360262061069,683444177,683444497,320
1360262088,683471428,1,137,137,1360262060749,1360262060749,683444177,683444177,0
1360262088,683471428,16,15137,946.0625,1360262061005,1360262063949,683444433,683447377,2944
1360262088,683471432,29,31488,1085.793103,1360262061069,1360262065165,683444501,683448597,4096
1360262088,683471432,30,29720,990.6666667,1360262061069,1360262068813,683444501,683452245,7744
1360262088,683471432,40,39924,998.1,1360262061004,1360262068684,683444436,683452116,7680
1360262088,683471432,23,25944,1128,1360262061004,1360262064396,683444436,683447828,3392
1360262088,683471432,21,21991,1047.190476,1360262061068,1360262064716,683444500,683448148,3648
1360262088,683471432,21,21492,1023.428571,1360262061068,1360262069004,683444500,683452436,7936
1360262088,683471572,2,123,61.5,1360262062973,1360262062973,683446545,683446545,0
1360262088,683471584,54,66797,1236.981481,1360262059761,1360262065265,683443345,683448849,5504
1360262088,683471624,24,25895,1078.958333,1360262060813,1360262063693,683444437,683447317,2880
1360262088,683471624,12,9460,788.3333333,1360262060813,1360262064141,683444437,683447765,3328
1360262088,683471624,38,44440,1169.473684,1360262060876,1360262064972,683444500,683448596,4096
1360262088,683471624,12,7334,611.1666667,1360262060876,1360262068108,683444500,683451732,7232
1360262088,683471624,11,3145,285.9090909,1360262060876,1360262063372,683444500,683446996,2496
1360262088,683471624,19,19845,1044.473684,1360262060876,1360262063500,683444500,683447124,2624
1360262088,683471624,41,47394,1155.95122,1360262060876,1360262068556,683444500,683452180,7680
1360262088,683471624,20,19272,963.6,1360262060876,1360262068108,683444500,683451732,7232
1360262088,683471624,15,16953,1130.2,1360262060876,1360262063244,683444500,683446868,2368
1360262088,683471624,13,15408,1185.230769,1360262060876,1360262063244,683444500,683446868,2368
1360262092,683475492,24,24264,1011,1360262067408,1360262069008,683450900,683452500,1600
1360262092,683475492,24,23320,971.6666667,1360262067405,1360262069069,683450897,683452561,1664
1360262092,683475496,4,4652,1163,1360262064778,1360262065226,683448274,683448722,448
1360262092,683475532,14,3638,259.8571429,1360262064486,1360262068198,683448018,683451730,3712
1360262092,683475540,11,3355,305,1360262065695,1360262067039,683449235,683450579,1344
1360262092,683475568,7,3974,567.7142857,1360262066691,1360262066691,683450259,683450259,0
1360262095,3616758272,5,280,56,1360262067115,1360262085547,3616730387,3616748819,18432
1360262096,683479440,10,560,56,1360262068354,1360262089026,683451794,683472466,20672
1360262096,683479444,5,2778,555.6,1360262068417,1360262068801,683451861,683452245,384
1360262096,683479444,16,15178,948.625,1360262068417,1360262069185,683451861,683452629,768
1360262096,683479444,12,12084,1007,1360262068416,1360262069120,683451860,683452564,704
1360262096,683479444,9,8827,980.7777778,1360262068416,1360262068864,683451860,683452308,448
1360262096,683479448,9,504,56,1360262068601,1360262087865,683452049,683471313,19264
1360262096,683479448,5,280,56,1360262068732,1360262087996,683452180,683471444,19264
1360262096,683479452,5,480,96,1360262069174,1360262088118,683452626,683471570,18944
1360262096,683479472,4,224,56,1360262069473,1360262086049,683452945,683469521,16576
1360262096,683479476,2,92,46,1360262069599,1360262069599,683453075,683453075,0
1360262096,683479524,5,2723,544.6,1360262071599,1360262071791,683455123,683455315,192
1360262096,683479532,4,2975,743.75,1360262068326,1360262068902,683451858,683452434,576
1360262096,683479604,1,46,46,1360262070496,1360262070496,683454100,683454100,0
1360262096,683480420,6,499,83.16666667,1360262084976,1360262088048,683469396,683472468,3072
1360262100,683483556,9,9544,1060.444444,1360262072653,1360262072781,683456209,683456337,128
1360262108,683491468,2,123,61.5,1360262080037,1360262080037,683463505,683463505,0
1360262108,683491552,2,123,61.5,1360262080977,1360262080977,683464529,683464529,0
1360262112,683495712,12,4618,384.8333333,1360262087538,1360262110770,683471250,683494482,23232
1360262112,683495776,1,46,46,1360262085619,1360262085619,683469395,683469395,0
1360262112,683496404,2,98,49,1360262102909,1360262108669,683487313,683493073,5760
1360262113,683496452,2,98,49,1360262107063,1360262112631,683490515,683496083,5568
1360262120,683504416,3,144,48,1360262111537,1360262117745,683495953,683502161,6208
1360262120,683504424,3,144,48,1360262108010,1360262113642,683492434,683498066,5632
1360262120,683504424,2,98,49,1360262108009,1360262113641,683492433,683498065,5632
1360262121,683504448,3,144,48,1360262109498,1360262115322,683492946,683498770,5824
1360262121,683504452,2,98,49,1360262109624,1360262115640,683493076,683499092,6016
1360262121,683504452,3,144,48,1360262109877,1360262115637,683493329,683499089,5760
1360262121,683504460,3,144,48,1360262110575,1360262116719,683494035,683500179,6144
1360262121,683504460,2,98,49,1360262107694,1360262113646,683491154,683497106,5952
1360262121,683504460,4,196,49,1360262107758,1360262114030,683491218,683497490,6272
1360262121,683504464,3,150,50,1360262107688,1360262114024,683491152,683497488,6336
1360262121,683504464,2,98,49,1360262107692,1360262113644,683491156,683497108,5952
1360262121,683504464,4,190,47.5,1360262107692,1360262114028,683491156,683497492,6336
1360262121,683504508,3,150,50,1360262108990,1360262114878,683492498,683498386,5888
1360262121,683504508,4,196,49,1360262108989,1360262115133,683492497,683498641,6144
1360262121,683504532,3,144,48,1360262109543,1360262115559,683493075,683499091,6016
1360262121,683504536,5,292,58.4,1360262114852,1360262115556,683498388,683499092,704
1360262121,683504544,2,98,49,1360262107610,1360262113498,683491154,683497042,5888
1360262121,683504544,2,98,49,1360262107610,1360262113498,683491154,683497042,5888
1360262121,683504544,4,202,50.5,1360262107610,1360262113882,683491154,683497426,6272
1360262121,683504544,3,150,50,1360262107609,1360262113945,683491153,683497489,6336
1360262121,683504544,4,196,49,1360262107673,1360262114009,683491217,683497553,6336
1360262128,683511528,82,63266,771.5365854,1360262102059,1360262127083,683485587,683510611,25024
1360262131,3616794348,25,1400,56,1360262103965,1360262130397,3616767313,3616793745,26432
1360262132,683515488,3,271,90.33333333,1360262104913,1360262105105,683488401,683488593,192
1360262132,683515492,23,2208,96,1360262105038,1360262131278,683488530,683514770,26240
1360262132,683515496,50,2800,56,1360262104266,1360262131466,683487762,683514962,27200
1360262132,683515496,68,89160,1311.176471,1360262104330,1360262106890,683487826,683490386,2560
1360262132,683515496,3,169,56.33333333,1360262105098,1360262105098,683488594,683488594,0
1360262132,683515496,4,489,122.25,1360262105097,1360262105289,683488593,683488785,192
1360262132,683515564,29,34806,1200.206897,1360262106887,1360262109383,683490451,683492947,2496
1360262132,683515568,3,169,56.33333333,1360262107586,1360262107650,683491154,683491218,64
1360262132,683515568,1,77,77,1360262107586,1360262107586,683491154,683491154,0
1360262132,683515568,11,1785,162.2727273,1360262107586,1360262114306,683491154,683497874,6720
1360262132,683515572,7,1882,268.8571429,1360262107582,1360262108222,683491154,683491794,640
1360262132,683515572,3,626,208.6666667,1360262107582,1360262108030,683491154,683491602,448
1360262132,683515572,4,429,107.25,1360262107582,1360262108158,683491154,683491730,576
1360262132,683515572,8,6924,865.5,1360262107582,1360262107902,683491154,683491474,320
1360262132,683515572,10,1668,166.8,1360262107582,1360262114302,683491154,683497874,6720
1360262132,683515604,1,137,137,1360262104095,1360262104095,683487699,683487699,0
1360262132,683515604,25,1400,56,1360262104221,1360262131421,683487825,683515025,27200
1360262132,683515612,49,2744,56,1360262104471,1360262131735,683488083,683515347,27264
1360262132,683515616,24,1344,56,1360262104595,1360262131091,683488211,683514707,26496
1360262132,683515616,31,35086,1131.806452,1360262105362,1360262107474,683488978,683491090,2112
1360262132,683515620,3,169,56.33333333,1360262105488,1360262105552,683489108,683489172,64
1360262132,683515620,2,123,61.5,1360262105488,1360262105488,683489108,683489108,0
1360262132,683515620,12,12944,1078.666667,1360262105614,1360262105870,683489234,683489490,256
1360262132,683515644,9,1017,113,1360262105847,1360262108855,683489491,683492499,3008
1360262132,683515652,4,345,86.25,1360262106351,1360262106607,683490003,683490259,256
1360262132,683515660,3,2379,793,1360262106856,1360262106856,683490516,683490516,0
1360262132,683515660,5,3765,753,1360262106918,1360262106918,683490578,683490578,0
1360262132,683515660,5,4585,917,1360262106982,1360262106982,683490642,683490642,0
1360262132,683515664,5,5048,1009.6,1360262107043,1360262107107,683490707,683490771,64
1360262132,683515688,3,498,166,1360262107466,1360262107850,683491154,683491538,384
1360262132,683515688,3,626,208.6666667,1360262107466,1360262108042,683491154,683491730,576
1360262132,683515692,2,221,110.5,1360262107463,1360262107655,683491155,683491347,192
1360262136,683519512,1,255,255,1360262109241,1360262109241,683492753,683492753,0
1360262136,683519624,16,2410,150.625,1360262109322,1360262129930,683492946,683513554,20608
1360262136,683519628,11,1748,158.9090909,1360262109444,1360262129604,683493072,683513232,20160
1360262136,683519660,3,212,70.66666667,1360262110821,1360262110949,683494481,683494609,128
1360262136,683519668,3,169,56.33333333,1360262111518,1360262111646,683495186,683495314,128
1360262137,683520444,135,170141,1260.303704,1360262013055,1360262131647,683396499,683515091,118592
1360262137,683520480,3,138,46,1360262131610,1360262131674,683515090,683515154,64
1360262137,683520556,3,169,56.33333333,1360262131534,1360262131598,683515090,683515154,64
1360262137,683520560,3,169,56.33333333,1360262131531,1360262131531,683515091,683515091,0
1360262137,683520560,3,169,56.33333333,1360262131531,1360262131531,683515091,683515091,0
1360262140,683523636,1,46,46,1360262112701,1360262112701,683496337,683496337,0
1360262140,683523644,2,180,90,1360262113591,1360262114167,683497235,683497811,576
1360262152,683535528,4,283,70.75,1360262124652,1360262125612,683508180,683509140,960
1360262152,683535652,3,206,68.66666667,1360262125551,1360262125935,683509203,683509587,384
1360262153,683536500,7,412,58.85714286,1360262152709,1360262152773,683536209,683536273,64
1360262153,683536532,8,458,57.25,1360262149670,1360262149734,683533202,683533266,64
1360262153,683536532,8,458,57.25,1360262149733,1360262149733,683533265,683533265,0
1360262153,683536532,7,412,58.85714286,1360262149733,1360262149733,683533265,683533265,0
1360262153,683536536,141,199813,1417.113475,1360262034593,1360262151585,683418129,683535121,116992
1360262153,683536548,3,169,56.33333333,1360262151573,1360262151573,683535121,683535121,0
1360262153,683536580,3,138,46,1360262152501,1360262152757,683536081,683536337,256
1360262153,683536580,4,205,51.25,1360262152501,1360262152565,683536081,683536145,64
1360262153,683536588,158,206271,1305.512658,1360262012911,1360262149487,683396499,683533075,136576
1360262153,683536620,3,159,53,1360262151436,1360262151436,683535056,683535056,0
1360262156,683539528,22,3058,139,1360262129258,1360262152938,683512786,683536466,23680
1360262156,683539600,1,46,46,1360262131552,1360262131552,683515152,683515152,0
1360262156,683539688,1,46,46,1360262131464,1360262131464,683515152,683515152,0
1360262159,3616822276,12,672,56,1360262131302,1360262156582,3616794578,3616819858,25280
1360262160,683543508,11,616,56,1360262131967,1360262158271,683515475,683541779,26304
1360262160,683543508,12,1152,96,1360262132094,1360262158590,683515602,683542098,26496
1360262160,683543508,21,1176,56,1360262132157,1360262157373,683515665,683540881,25216
1360262160,683543592,23,1288,56,1360262131816,1360262157608,683515408,683541200,25792
1360262160,683543600,11,616,56,1360262132258,1360262156578,683515858,683540178,24320
1360262164,683547584,3,544,181.3333333,1360262139312,1360262139376,683522896,683522960,64
1360262164,683547680,3,544,181.3333333,1360262139537,1360262139601,683523217,683523281,64
1360262169,683552540,2586,3704425,1432.492266,1360262102942,1360262164574,683486482,683548114,61632
1360262176,683559524,1,137,137,1360262148780,1360262148780,683532304,683532304,0
1360262176,683559560,1,46,46,1360262150536,1360262150536,683534096,683534096,0
1360262176,683559564,1,46,46,1360262150534,1360262150534,683534098,683534098,0
1360262176,683559676,2,92,46,1360262150422,1360262150422,683534098,683534098,0
1360262176,683559676,1,46,46,1360262150422,1360262150422,683534098,683534098,0
1360262176,683559680,1,46,46,1360262150418,1360262150418,683534098,683534098,0
1360262176,683559684,1,46,46,1360262151437,1360262151437,683535121,683535121,0
1360262176,683559684,1,46,46,1360262151437,1360262151437,683535121,683535121,0
1360262176,683559684,3,492,164,1360262150797,1360262150925,683534481,683534609,128
1360262176,683559688,2,92,46,1360262151432,1360262151432,683535120,683535120,0
1360262176,683559688,1,46,46,1360262151432,1360262151432,683535120,683535120,0
1360262177,683560540,8,458,57.25,1360262170718,1360262170718,683554258,683554258,0
1360262177,683560624,8,458,57.25,1360262170634,1360262170698,683554258,683554322,64
1360262180,683563580,2,180,90,1360262153655,1360262153719,683537235,683537299,64
1360262180,683563668,2,123,61.5,1360262152542,1360262152606,683536210,683536274,64
1360262180,683563716,2,123,61.5,1360262155502,1360262155502,683539218,683539218,0
1360262184,683567940,2,123,61.5,1360262156301,1360262156301,683540241,683540241,0
1360262184,683567944,19,2674,140.7368421,1360262156618,1360262181514,683540562,683565458,24896
1360262192,683575816,14,784,56,1360262164299,1360262189899,683548115,683573715,25600
1360262192,683575900,6,336,56,1360262167797,1360262187189,683551697,683571089,19392
1360262192,683575904,15,840,56,1360262163887,1360262190639,683547791,683574543,26752
1360262193,683576572,2,92,46,1360262188541,1360262188541,683572113,683572113,0
1360262193,683576660,723,455065,629.4121715,1360261343847,1360262186599,682727507,683570259,842752
1360262195,3616858352,7,392,56,1360262168024,1360262188120,3616831376,3616851472,20096
1360262200,683583904,1,46,46,1360262174191,1360262174191,683558095,683558095,0
1360262200,683583904,2,92,46,1360262174195,1360262174323,683558099,683558227,128
1360262200,683583904,8,768,96,1360262174448,1360262197680,683558352,683581584,23232
1360262200,683583936,1,46,46,1360262175186,1360262175186,683559122,683559122,0
1360262200,683584012,2,92,46,1360262174083,1360262174211,683558095,683558223,128
1360262200,683584012,8,448,56,1360262174150,1360262196678,683558162,683580690,22528
1360262200,683584024,2,92,46,1360262175097,1360262175289,683559121,683559313,192
1360262201,683584668,7,412,58.85714286,1360262196572,1360262196636,683580240,683580304,64
1360262201,683584672,8,458,57.25,1360262200666,1360262200730,683584338,683584402,64
1360262204,683587952,3,544,181.3333333,1360262179395,1360262179459,683563347,683563411,64
1360262208,683591884,1,137,137,1360262180484,1360262180484,683564368,683564368,0
1360262208,683591960,1,46,46,1360262183096,1360262183096,683567056,683567056,0
1360262208,683592052,2,92,46,1360262183005,1360262183069,683567057,683567121,64
1360262209,683592612,5,230,46,1360262202773,1360262204437,683586385,683588049,1664
1360262209,683592700,3613,5035019,1393.584002,1360262102781,1360262207421,683486481,683591121,104640
1360262209,3616872788,4,184,46,1360262201637,1360262202341,3616865425,3616866129,704
1360262209,3616872788,5,230,46,1360262201637,1360262203237,3616865425,3616867025,1600
1360262209,3616872796,5,230,46,1360262201756,1360262203356,3616865552,3616867152,1600
1360262212,683595900,1,46,46,1360262184181,1360262184181,683568081,683568081,0
1360262212,683595900,1,46,46,1360262184181,1360262184181,683568081,683568081,0
1360262212,683595992,2,92,46,1360262184090,1360262184090,683568082,683568082,0
1360262212,683595992,2,92,46,1360262184090,1360262184154,683568082,683568146,64
1360262212,683595992,1,46,46,1360262184089,1360262184089,683568081,683568081,0
1360262212,683596068,2,92,46,1360262187022,1360262187086,683571090,683571154,64
1360262216,683600020,32,5782,180.6875,1360262189374,1360262214334,683573394,683598354,24960
1360262216,683600028,30,6461,215.3666667,1360262190196,1360262206708,683574224,683590736,16512
1360262220,683603932,2,180,90,1360262193364,1360262193428,683577296,683577360,64
1360262220,683603936,4,224,56,1360262193618,1360262202450,683577554,683586386,8832
1360262220,683604024,9,504,56,1360262193272,1360262203768,683577296,683587792,10496
1360262223,3616886348,4,224,56,1360262196254,1360262202654,3616859602,3616866002,6400
1360262224,683608024,7,392,56,1360262196410,1360262203642,683580434,683587666,7232
1360262224,683608076,2,123,61.5,1360262199236,1360262199236,683583312,683583312,0
1360262225,683608628,190,262999,1384.205263,1360262103812,1360262222020,683487440,683605648,118208
1360262228,683611984,3,288,96,1360262200096,1360262203296,683584080,683587280,3200
1360262228,683612032,2,112,56,1360262201905,1360262202993,683585937,683587025,1088
1360262240,683623940,15,2437,162.4666667,1360262213710,1360262236622,683597650,683620562,22912
1360262241,683624608,4,190,47.5,1360262232536,1360262237976,683616144,683621584,5440
1360262241,683624608,2,98,49,1360262232471,1360262237911,683616079,683621519,5440
1360262241,683624612,4,190,47.5,1360262232534,1360262237974,683616146,683621586,5440
1360262241,683624612,2,98,49,1360262232534,1360262237910,683616146,683621522,5376
1360262241,683624612,6,454,75.66666667,1360262233683,1360262233747,683617295,683617359,64
1360262241,683624656,3,144,48,1360262231592,1360262236968,683615248,683620624,5376
1360262241,683624684,2,98,49,1360262232395,1360262237835,683616079,683621519,5440
1360262241,683624684,2,98,49,1360262232395,1360262237835,683616079,683621519,5440
1360262244,683628036,18,2622,145.6666667,1360262216366,1360262236590,683600402,683620626,20224
1360262244,683628084,3,544,181.3333333,1360262219388,1360262219452,683603472,683603536,64
1360262244,683628084,2,92,46,1360262219579,1360262219579,683603663,683603663,0
1360262248,683631920,2,92,46,1360262220705,1360262220769,683604625,683604689,64
1360262248,683631952,2,92,46,1360262221697,1360262221761,683605649,683605713,64
1360262248,683631964,2,92,46,1360262222709,1360262222709,683606673,683606673,0
1360262248,683631964,1,46,46,1360262222709,1360262222709,683606673,683606673,0
1360262248,683631996,1,46,46,1360262223635,1360262223635,683607631,683607631,0
1360262248,683631996,1,46,46,1360262223635,1360262223635,683607631,683607631,0
1360262248,683631996,2,92,46,1360262223698,1360262223698,683607694,683607694,0
1360262248,683631996,1,137,137,1360262223766,1360262223766,683607762,683607762,0
1360262248,683631996,1,46,46,1360262223638,1360262223638,683607634,683607634,0
1360262248,683632008,1,46,46,1360262220618,1360262220618,683604626,683604626,0
1360262248,683632040,1,46,46,1360262221608,1360262221608,683605648,683605648,0
1360262248,683632040,1,46,46,1360262221608,1360262221608,683605648,683605648,0
1360262248,683632048,1,46,46,1360262222175,1360262222175,683606223,683606223,0
1360262248,683632068,1,46,46,1360262222606,1360262222606,683606674,683606674,0
1360262248,683632068,2,92,46,1360262222606,1360262222606,683606674,683606674,0
1360262248,683632080,2,92,46,1360262223554,1360262223618,683607634,683607698,64
1360262248,683632080,1,46,46,1360262223554,1360262223554,683607634,683607634,0
1360262248,683632080,1,46,46,1360262223554,1360262223554,683607634,683607634,0
1360262249,683632636,3,144,48,1360262237117,1360262242941,683620753,683626577,5824
1360262249,683632688,7,412,58.85714286,1360262243785,1360262243913,683627473,683627601,128
1360262252,683635904,2,92,46,1360262224816,1360262224880,683608720,683608784,64
1360262252,683635992,2,92,46,1360262224664,1360262224664,683608656,683608656,0
1360262256,683639968,1,46,46,1360262229681,1360262229681,683613649,683613649,0
1360262256,683639976,16,16758,1047.375,1360262230823,1360262248295,683614799,683632271,17472
1360262256,683639976,14,9966,711.8571429,1360262230823,1360262248039,683614799,683632015,17216
1360262256,683639984,47,52485,1116.702128,1360262230818,1360262248162,683614802,683632146,17344
1360262256,683639984,23,21303,926.2173913,1360262230818,1360262248226,683614802,683632210,17408
1360262256,683639984,43,47116,1095.72093,1360262231266,1360262251682,683615250,683635666,20416
1360262256,683639984,23,25702,1117.478261,1360262231266,1360262232034,683615250,683616018,768
1360262256,683640004,9,504,56,1360262231374,1360262255502,683615378,683639506,24128
1360262256,683640056,2,92,46,1360262229594,1360262229594,683613650,683613650,0
1360262256,683640060,18,20278,1126.555556,1360262230355,1360262230611,683614415,683614671,256
1360262256,683640084,34,38603,1135.382353,1360262230716,1360262247740,683614800,683631824,17024
1360262256,683640092,28,30761,1098.607143,1360262231158,1360262249974,683615250,683634066,18816
1360262257,683640608,5,242,48.4,1360262248921,1360262254617,683632529,683638225,5696
1360262257,683640608,4,196,49,1360262248921,1360262254809,683632529,683638417,5888
1360262257,683640608,5,236,47.2,1360262248983,1360262256023,683632591,683639631,7040
1360262257,683640616,6,288,48,1360262249550,1360262256398,683633166,683640014,6848
1360262257,683640648,5,236,47.2,1360262254447,1360262255343,683638095,683638991,896
1360262257,683640656,3,144,48,1360262252074,1360262252330,683635730,683635986,256
1360262257,683640660,9,1941,215.6666667,1360262252323,1360262252643,683635983,683636303,320
1360262257,683640696,2,98,49,1360262248830,1360262249086,683632526,683632782,256
1360262257,683640732,2,98,49,1360262246556,1360262251932,683630288,683635664,5376
1360262257,683640732,2,98,49,1360262246556,1360262251932,683630288,683635664,5376
1360262257,683640740,3,144,48,1360262247765,1360262252949,683631505,683636689,5184
1360262257,683640740,3,144,48,1360262247765,1360262252949,683631505,683636689,5184
1360262257,683640740,2,98,49,1360262247765,1360262252949,683631505,683636689,5184
1360262259,3616922384,10,560,56,1360262232188,1360262256764,3616895572,3616920148,24576
1360262260,683643948,21,1176,56,1360262232516,1360262259460,683616464,683643408,26944
1360262260,683643972,20,1120,56,1360262233323,1360262259691,683617295,683643663,26368
1360262260,683644064,11,616,56,1360262233423,1360262259727,683617487,683643791,26304
1360262264,683647952,13,1248,96,1360262236482,1360262263170,683620434,683647122,26688
1360262264,683647952,5,535,107,1360262236609,1360262236865,683620561,683620817,256
1360262264,683647952,22,3902,177.3636364,1360262236608,1360262263424,683620560,683647376,26816
1360262265,683648632,3,144,48,1360262256193,1360262262785,683639825,683646417,6592
1360262265,683648632,2,98,49,1360262252351,1360262258175,683635983,683641807,5824
1360262265,683648644,7,1321,188.7142857,1360262261683,1360262262707,683645327,683646351,1024
1360262265,683648672,4,202,50.5,1360262254424,1360262260120,683638096,683643792,5696
1360262265,683648672,4,196,49,1360262254424,1360262260312,683638096,683643984,5888
1360262265,683648672,3,150,50,1360262254423,1360262260119,683638095,683643791,5696
1360262265,683648680,5,248,49.6,1360262255376,1360262261328,683639056,683645008,5952
1360262265,683648684,2,98,49,1360262256139,1360262262219,683639823,683645903,6080
1360262265,683648684,3,150,50,1360262256139,1360262262219,683639823,683645903,6080
1360262265,683648752,3,150,50,1360262254345,1360262261065,683638097,683644817,6720
1360262265,683648752,3,150,50,1360262254534,1360262261254,683638286,683645006,6720
1360262265,683648756,3,150,50,1360262255172,1360262261188,683638928,683644944,6016
1360262265,683648756,4,196,49,1360262255107,1360262261059,683638863,683644815,5952
1360262265,683648756,4,196,49,1360262255171,1360262261443,683638927,683645199,6272
1360262265,683648760,3,144,48,1360262256065,1360262262593,683639825,683646353,6528
1360262265,683648760,3,144,48,1360262256062,1360262262590,683639822,683646350,6528
1360262268,683651976,9,3000,333.3333333,1360262241191,1360262241511,683625167,683625487,320
1360262272,683656004,3,492,164,1360262246476,1360262247180,683630480,683631184,704
1360262272,683656004,4,489,122.25,1360262246284,1360262246668,683630288,683630672,384
1360262272,683656044,36,18505,514.0277778,1360262247459,1360262260387,683631503,683644431,12928
1360262272,683656120,5,370,74,1360262246166,1360262246422,683630286,683630542,256
1360262272,683656136,8,1610,201.25,1360262247367,1360262250759,683631503,683634895,3392
1360262273,683656700,5,242,48.4,1360262262076,1360262269372,683645776,683653072,7296
1360262276,683659980,28,16281,581.4642857,1360262248547,1360262260579,683632527,683644559,12032
1360262276,683659980,30,8645,288.1666667,1360262248546,1360262265698,683632526,683649678,17152
1360262276,683659992,12,3534,294.5,1360262248793,1360262249113,683632785,683633105,320
1360262276,683660040,9,1149,127.6666667,1360262250471,1360262254311,683634511,683638351,3840
1360262276,683660076,7,832,118.8571429,1360262248450,1360262248770,683632526,683632846,320
1360262276,683660108,17,4074,239.6470588,1360262248421,1360262258981,683632529,683643089,10560
1360262276,683660108,52,56862,1093.5,1360262249059,1360262259747,683633167,683643855,10688
1360262276,683660120,5,2323,464.6,1360262249944,1360262251032,683634064,683635152,1088
1360262276,683660120,4,318,79.5,1360262249944,1360262250072,683634064,683634192,128
1360262280,683663964,48,58672,1222.333333,1360262252467,1360262265651,683636431,683649615,13184
1360262280,683664008,20,3804,190.2,1360262254086,1360262277958,683638094,683661966,23872
1360262280,683664008,9,1264,140.4444444,1360262254089,1360262268489,683638097,683652497,14400
1360262280,683664052,12,3367,280.5833333,1360262251933,1360262252253,683635985,683636305,320
1360262280,683664056,43,37545,873.1395349,1360262252377,1360262261721,683636433,683645777,9344
1360262280,683664092,7,967,138.1428571,1360262253877,1360262256949,683637969,683641041,3072
1360262284,683667984,24,1344,56,1360262256607,1360262283871,683640591,683667855,27264
1360262284,683668036,6,3256,542.6666667,1360262258093,1360262258477,683642129,683642513,384
1360262287,3616950372,23,1288,56,1360262259335,1360262285703,3616922707,3616949075,26368
1360262288,683671996,51,2856,56,1360262260114,1360262287698,683644110,683671694,27584
1360262288,683672004,25,1400,56,1360262260940,1360262287500,683644944,683671504,26560
1360262288,683672088,52,2912,56,1360262260088,1360262287672,683644176,683671760,27584
1360262292,683676060,2,450,225,1360262266261,1360262266325,683650321,683650385,64
1360262292,683676104,23,2208,96,1360262263975,1360262287463,683648079,683671567,23488
1360262292,683676108,1,137,137,1360262264164,1360262264164,683648272,683648272,0
1360262292,683676144,4,470,117.5,1360262266049,1360262266113,683650193,683650257,64
1360262300,683684152,2,180,90,1360262273143,1360262273271,683657295,683657423,128
1360262312,683696024,9,504,56,1360262284729,1360262301753,683668753,683685777,17024
1360262312,683696092,6,2000,333.3333333,1360262287155,1360262288691,683671247,683672783,1536
1360262312,683696236,2,123,61.5,1360262286117,1360262286117,683670353,683670353,0
1360262315,3616978364,7,392,56,1360262287053,1360262302093,3616950417,3616965457,15040
1360262316,683700016,11,616,56,1360262288638,1360262305214,683672654,683689230,16576
1360262316,683700140,11,616,56,1360262288773,1360262306373,683672913,683690513,17600
1360262320,683704048,6,336,56,1360262292831,1360262313311,683676879,683697359,20480
1360262320,683704052,6,576,96,1360262293084,1360262313564,683677136,683697616,20480
1360262320,683704168,2,123,61.5,1360262293160,1360262293224,683677328,683677392,64
1360262321,683704776,1307,1837368,1405.79036,1360262246512,1360262316912,683630288,683700688,70400
1360262324,683708148,1,77,77,1360262296187,1360262296187,683680335,683680335,0
1360262332,683716088,3,138,46,1360262306423,1360262306423,683690511,683690511,0
1360262332,683716160,1,137,137,1360262304943,1360262304943,683689103,683689103,0
1360262337,683720736,6,503,83.83333333,1360262326744,1360262330712,683710480,683714448,3968
1360262340,683724340,2,180,90,1360262312954,1360262313018,683697294,683697358,64
1360262344,683728404,5,280,56,1360262316220,1360262338172,683700624,683722576,21952
1360262344,683728420,3,138,46,1360262317482,1360262317546,683701902,683701966,64
1360262344,683728420,5,280,56,1360262317482,1360262340970,683701902,683725390,23488
1360262347,3617010408,2,112,56,1360262320291,1360262330595,3616983699,3616994003,10304
1360262348,683732296,3,168,56,1360262319909,1360262341221,683704205,683725517,21312
1360262348,683732384,3,604,201.3333333,1360262319822,1360262319950,683704206,683704334,128
1360262352,683736344,2,192,96,1360262326453,1360262337909,683710797,683722253,11456
1360262352,683736380,6,1936,322.6666667,1360262327701,1360262350741,683712081,683735121,23040
1360262353,683736432,1,46,46,1360262327049,1360262327049,683710481,683710481,0
1360262353,683736444,2,112,56,1360262327098,1360262336250,683710542,683719694,9152
1360262357,683740480,2,123,61.5,1360262331799,1360262331863,683715279,683715343,64
1360262360,683744380,1,137,137,1360262335314,1360262335314,683719694,683719694,0
1360262364,683748348,2,123,61.5,1360262337970,1360262337970,683722318,683722318,0
1360262368,683752392,2,123,61.5,1360262340872,1360262340936,683725264,683725328,64
1360262373,683756444,2,92,46,1360262347644,1360262347708,683731088,683731152,64
1360262373,683756520,2,92,46,1360262346606,1360262346606,683730126,683730126,0
1360262377,683760812,8,458,57.25,1360262376394,1360262376458,683760206,683760270,64
1360262381,683764524,2,180,90,1360262353835,1360262353899,683737359,683737423,64
1360262381,683764600,12,2598,216.5,1360262356512,1360262359456,683740112,683743056,2944
1360262385,683768732,2,98,49,1360262371609,1360262377369,683755341,683761101,5760
1360262385,683768744,7,412,58.85714286,1360262383500,1360262383500,683767244,683767244,0
1360262385,683768812,3,144,48,1360262371529,1360262377289,683755341,683761101,5760
1360262385,683768816,3,144,48,1360262371528,1360262377352,683755344,683761168,5824
1360262389,683772456,1,46,46,1360262363631,1360262363631,683747087,683747087,0
1360262389,683772468,1,46,46,1360262364643,1360262364643,683748111,683748111,0
1360262389,683772512,2,92,46,1360262362612,1360262362612,683746124,683746124,0
1360262389,683772628,2,92,46,1360262363460,1360262363524,683747088,683747152,64
1360262389,683772660,2,92,46,1360262364451,1360262364451,683748111,683748111,0
1360262389,683772660,2,92,46,1360262364450,1360262364450,683748110,683748110,0
1360262392,683776400,1,46,46,1360262364671,1360262364671,683749071,683749071,0
1360262393,683776436,2,92,46,1360262366656,1360262366656,683750092,683750092,0
1360262393,683776520,1,46,46,1360262366573,1360262366573,683750093,683750093,0
1360262393,683776556,2,92,46,1360262367562,1360262367562,683751118,683751118,0
1360262393,683776812,8,458,57.25,1360262386377,1360262386441,683770189,683770253,64
1360262396,683780424,2,92,46,1360262369703,1360262369703,683754127,683754127,0
1360262397,683780436,2,92,46,1360262371843,1360262372099,683755279,683755535,256
1360262397,683780544,7,1315,187.8571429,1360262371350,1360262371478,683754894,683755022,128
1360262401,683784460,2,92,46,1360262376617,1360262376681,683760077,683760141,64
1360262401,683784512,2,92,46,1360262374583,1360262374583,683758095,683758095,0
1360262401,683784540,2,92,46,1360262375579,1360262375579,683759119,683759119,0
1360262401,683784552,1,46,46,1360262376527,1360262376527,683760079,683760079,0
1360262405,683788516,1,46,46,1360262377585,1360262377585,683761101,683761101,0
1360262405,683788572,1,137,137,1360262380025,1360262380025,683763597,683763597,0
1360262408,683792424,2,92,46,1360262380711,1360262380711,683765135,683765135,0
1360262409,683792456,1,46,46,1360262382638,1360262382638,683766094,683766094,0
1360262409,683792456,2,92,46,1360262382637,1360262382637,683766093,683766093,0
1360262409,683792584,2,92,46,1360262384495,1360262384559,683768079,683768143,64
1360262420,683804420,2,92,46,1360262392681,1360262392681,683777101,683777101,0
1360262420,683804424,4,338,84.5,1360262392933,1360262393189,683777357,683777613,256
1360262425,683808748,3,492,164,1360262399499,1360262399627,683783247,683783375,128
1360262425,683808824,773,918163,1187.791721,1360262293117,1360262417277,683676941,683801101,124160
1360262441,683824676,1,137,137,1360262414736,1360262414736,683798412,683798412,0
1360262445,683828616,21,2762,131.5238095,1360262417228,1360262417804,683800844,683801420,576
1360262461,683844668,2,180,90,1360262433688,1360262433752,683817356,683817420,64
1360262465,683848788,3,492,164,1360262439522,1360262439650,683823310,683823438,128
1360262473,683857004,111,93841,845.4144144,1360262245771,1360262469131,683629775,683853135,223360
1360262485,683868600,1,137,137,1360262458460,1360262458460,683842060,683842060,0
1360262489,683873032,3,138,46,1360262486126,1360262486190,683870158,683870222,64
1360262501,683884768,5,773,154.6,1360262474294,1360262474486,683858062,683858254,192
1360262501,683884852,2,180,90,1360262473505,1360262473569,683857357,683857421,64
1360262505,683888840,3,492,164,1360262479277,1360262479405,683863117,683863245,128
1360262521,683904912,1,137,137,1360262492771,1360262492771,683876683,683876683,0
1360262525,683908780,2,96,48,1360262497898,1360262500842,683881678,683884622,2944
1360262533,683916800,34,8563,251.8529412,1360262505940,1360262516500,683889740,683900300,10560
1360262541,683924896,2,180,90,1360262513458,1360262513522,683897354,683897418,64
1360262549,683932920,1,137,137,1360262523229,1360262523229,683907149,683907149,0
1360262553,683937192,3,144,48,1360262546764,1360262551884,683930956,683936076,5120
1360262561,683945172,4,332,83,1360262553246,1360262553310,683937418,683937482,64
1360262569,683952800,1177,1635864,1389.858963,1360262252626,1360262265746,683636426,683649546,13120
1360262569,683952880,26,7453,286.6538462,1360262544194,1360262565442,683928074,683949322,21248
1360262577,683961148,6,498,83,1360262567221,1360262569333,683951369,683953481,2112
1360262581,683964920,14,7269,519.2142857,1360262553562,1360262553946,683937482,683937866,384
1360262589,683972928,1,137,137,1360262561233,1360262561233,683945161,683945161,0
1360262593,683976852,5,2939,587.8,1360262565406,1360262565534,683949258,683949386,128
1360262593,683977004,1,46,46,1360262567365,1360262567365,683951369,683951369,0
1360262617,684000892,2,92,46,1360262589432,1360262589432,683973324,683973324,0
1360262621,684005056,2,180,90,1360262593362,1360262593426,683977418,683977482,64
1360262625,684008888,1,137,137,1360262597882,1360262597882,683981770,683981770,0
1360262633,684016912,3,493,164.3333333,1360262605474,1360262605602,683989386,683989514,128
1360262633,684017024,3,138,46,1360262608370,1360262608434,683992394,683992458,64
1360262661,684045356,2,180,90,1360262633062,1360262633126,684017418,684017482,64
1360262665,684049384,1,137,137,1360262640713,1360262640713,684025097,684025097,0
1360262674,684057436,3,493,164.3333333,1360262646463,1360262646591,684029899,684030027,128
1360262682,684065728,3,144,48,1360262672154,1360262677402,684055882,684061130,5248
1360262682,684065808,3,144,48,1360262672008,1360262677320,684055816,684061128,5312
1360262697,684081380,8,1403,175.375,1360262670667,1360262671179,684055047,684055559,512
1360262701,684085248,2,180,90,1360262673171,1360262673299,684057419,684057547,128
1360262710,684093464,1,137,137,1360262682465,1360262682465,684065929,684065929,0
1360262714,684097576,3,493,164.3333333,1360262686578,1360262686706,684070154,684070282,128
1360262742,684125464,7,3618,516.8571429,1360262714783,1360262715039,684098247,684098503,256
1360262742,684125600,2,180,90,1360262713880,1360262713880,684097480,684097480,0
1360262750,684133464,1,137,137,1360262722527,1360262722527,684105991,684105991,0
1360262754,684137488,3,493,164.3333333,1360262726600,1360262726728,684110088,684110216,128
1360262782,684165684,2,180,90,1360262753794,1360262753858,684137478,684137542,64
1360262786,684169712,1,137,137,1360262760489,1360262760489,684144201,684144201,0
1360262794,684177576,3,493,164.3333333,1360262767216,1360262767344,684150792,684150920,128
1360262794,684178112,3,138,46,1360262787287,1360262787351,684171399,684171463,64
1360262818,684201768,2,180,90,1360262793713,1360262793777,684177481,684177545,64
1360262818,684202152,1,137,137,1360262792622,1360262792622,684176774,684176774,0
1360262826,684210168,4,656,164,1360262800221,1360262800413,684184389,684184581,192
1360262834,684217808,3,493,164.3333333,1360262806600,1360262806728,684190408,684190536,128
1360262854,684238100,1,78,78,1360262828515,1360262828515,684212615,684212615,0
1360262858,684241844,2,92,46,1360262830561,1360262830561,684214405,684214405,0
1360262858,684242224,2,180,90,1360262833254,1360262833318,684217478,684217542,64
1360262858,684242228,1,137,137,1360262833316,1360262833316,684217544,684217544,0
1360262874,684258176,3,493,164.3333333,1360262845911,1360262846039,684230087,684230215,128
1360262875,684258460,4,332,83,1360262874083,1360262874147,684257543,684257607,64
1360262894,684278092,1,137,137,1360262866988,1360262866988,684251080,684251080,0
1360262898,684282020,11,1850,168.1818182,1360262873588,1360262873844,684257608,684257864,256
1360262902,684285912,1,46,46,1360262874846,1360262874846,684258758,684258758,0
1360262914,684298048,3,493,164.3333333,1360262886039,1360262886167,684270087,684270215,128
1360262923,684306496,3,138,46,1360262916159,1360262916223,684299655,684299719,64
1360262934,684318212,1,137,137,1360262908272,1360262908272,684292484,684292484,0
1360262938,684322204,2,180,90,1360262913339,1360262913403,684297543,684297607,64
1360262954,684337964,2,96,48,1360262927528,1360262930536,684311492,684314500,3008
1360262954,684338100,3,493,164.3333333,1360262925985,1360262926113,684310085,684310213,128
1360262954,684338176,2,96,48,1360262927316,1360262930324,684311492,684314500,3008
1360262978,684362308,1,137,137,1360262952465,1360262952465,684336773,684336773,0
1360262978,684362596,2,180,90,1360262952945,1360262953009,684337541,684337605,64
1360262979,684362672,3,144,48,1360262972365,1360262977933,684356037,684361605,5568
1360262979,684362752,6,398,66.33333333,1360262971964,1360262977916,684355716,684361668,5952
1360262994,684378148,3,493,164.3333333,1360262965937,1360262966065,684350085,684350213,128
1360262998,684382252,8,1281,160.125,1360262971338,1360262971530,684355590,684355782,192
1360262998,684382252,11,8634,784.9090909,1360262971337,1360262971657,684355589,684355909,320
1360263019,684402584,1,137,137,1360262992867,1360262992867,684376451,684376451,0
1360263019,684402632,2,180,90,1360262993909,1360262993973,684377541,684377605,64
1360263034,684418376,3,389,129.6666667,1360263009550,1360263009550,684393926,684393926,0
1360263034,684418380,3,493,164.3333333,1360263005705,1360263005833,684390085,684390213,128
1360263035,684418608,4,472,118,1360263010318,1360263010446,684393926,684394054,128
1360263035,684418612,6,865,144.1666667,1360263010121,1360263010377,684393733,684393989,256
1360263035,684418612,4,433,108.25,1360263010311,1360263010375,684393923,684393987,64
1360263042,684426220,7,3409,487,1360263014313,1360263014505,684398533,684398725,192
1360263054,684438324,1,137,137,1360263028481,1360263028481,684412805,684412805,0
1360263059,684442632,2,180,90,1360263033910,1360263033974,684417542,684417606,64
1360263074,684458280,3,493,164.3333333,1360263045995,1360263046123,684430275,684430403,128
1360263074,684458316,1,46,46,1360263046857,1360263046857,684431173,684431173,0
1360263091,684474692,3,138,46,1360263087928,1360263089144,684471620,684472836,1216
1360263091,684474764,3,138,46,1360263087853,1360263087917,684471617,684471681,64
1360263094,684478244,1,137,137,1360263066320,1360263066320,684450564,684450564,0
1360263099,684482576,2,180,90,1360263074026,1360263074090,684457602,684457666,64
1360263114,684498300,3,493,164.3333333,1360263085846,1360263085974,684470146,684470274,128
1360263131,684514884,1,137,137,1360263103798,1360263103798,684487682,684487682,0
1360263139,684522844,2,180,90,1360263113760,1360263113824,684497604,684497668,64
1360263143,684526800,5,1699,339.8,1360263114825,1360263114953,684498625,684498753,128
1360263143,684526808,19,13101,689.5263158,1360263114946,1360263115138,684498754,684498946,192
1360263151,684534640,3,493,164.3333333,1360263126825,1360263126953,684510465,684510593,128
1360263159,684542828,2,92,46,1360263131183,1360263131247,684515011,684515075,64
1360263167,684551004,1,137,137,1360263142335,1360263142335,684526339,684526339,0
1360263179,684562740,2,180,90,1360263153863,1360263153927,684537603,684537667,64
1360263195,684578668,3,493,164.3333333,1360263166863,1360263167055,684550531,684550723,192
1360263195,684579020,4,332,83,1360263193581,1360263193645,684577601,684577665,64
1360263211,684594812,1,137,137,1360263184062,1360263184062,684567874,684567874,0
1360263219,684602868,10,1789,178.9,1360263193797,1360263194117,684577665,684577985,320
1360263235,684618792,3,493,164.3333333,1360263207249,1360263207377,684591041,684591169,128
1360263243,684626844,1,137,137,1360263215263,1360263215263,684599107,684599107,0
1360263255,684638936,2,92,46,1360263230784,1360263230784,684614720,684614720,0
1360263255,684638936,1,46,46,1360263230784,1360263230784,684614720,684614720,0
1360263259,684643080,2,180,90,1360263233583,1360263233647,684617663,684617727,64
1360263275,684658868,3,493,164.3333333,1360263247942,1360263248070,684631810,684631938,128
1360263279,684663076,1,137,137,1360263252277,1360263252277,684636353,684636353,0
1360263283,684667400,3,144,48,1360263271918,1360263277486,684656318,684661886,5568
1360263284,684667488,2,98,49,1360263272834,1360263278338,684656322,684661826,5504
1360263299,684683064,11,1968,178.9090909,1360263271744,1360263280704,684655808,684664768,8960
1360263299,684683176,2,180,90,1360263273489,1360263273553,684657665,684657729,64
1360263315,684699196,3,493,164.3333333,1360263287293,1360263287421,684671489,684671617,128
1360263315,684699316,1,137,137,1360263287875,1360263287875,684672191,684672191,0
1360263339,684723284,2,180,90,1360263313381,1360263313445,684697665,684697729,64
1360263339,684723436,5,2718,543.6,1360263314316,1360263314508,684698752,684698944,192
1360263343,684727248,1,137,137,1360263318470,1360263318470,684702718,684702718,0
1360263355,684739176,3,493,164.3333333,1360263326926,1360263327054,684711102,684711230,128
1360263367,684751260,1,46,46,1360263339451,1360263339451,684723711,684723711,0
1360263379,684763228,1,134,134,1360263353434,1360263353434,684737662,684737662,0
1360263383,684767192,1,137,137,1360263355968,1360263355968,684740160,684740160,0
1360263395,684779188,3,493,164.3333333,1360263367427,1360263367555,684751615,684751743,128
1360263396,684779604,32,27134,847.9375,1360263385802,1360263391882,684769406,684775486,6080
1360263396,684779608,10,5863,586.3,1360263386246,1360263393478,684769854,684777086,7232
1360263404,684787568,15,7557,503.8,1360263386031,1360263399343,684769599,684782911,13312
1360263404,684787604,8,368,46,1360263396298,1360263398346,684779902,684781950,2048
1360263404,684787644,6,282,47,1360263398242,1360263399842,684781886,684783486,1600
1360263404,684787680,4,250,62.5,1360263386816,1360263398912,684770496,684782592,12096
1360263407,684791372,1,46,46,1360263382025,1360263382025,684766397,684766397,0
1360263411,684795200,30,1680,56,1360263383415,1360263398583,684767615,684782783,15168
1360263411,684795200,28,1568,56,1360263383605,1360263398325,684767805,684782525,14720
1360263411,684795236,14,1344,96,1360263384786,1360263398418,684769022,684782654,13632
1360263411,684795284,15,840,56,1360263383586,1360263398370,684767870,684782654,14784
1360263411,684795320,15,840,56,1360263384252,1360263398588,684768572,684782908,14336
1360263412,3618074844,15,840,56,1360263384095,1360263400031,3618046939,3618062875,15936
1360263412,684795528,8,2143,267.875,1360263397975,1360263411479,684781503,684795007,13504
1360263423,684807312,1,137,137,1360263395269,1360263395269,684779581,684779581,0
1360263516,684899936,3,138,46,1360263510015,1360263510783,684893951,684894719,768
1360263536,684919620,1,46,46,1360263508216,1360263508216,684891836,684891836,0
1360263653,685036632,1,46,46,1360263626860,1360263626860,685010492,685010492,0
1360263677,685060576,1,46,46,1360263649377,1360263649377,685032953,685032953,0
1360263701,685084464,1030,1423199,1381.746602,1360263383312,1360263398160,684766776,684781624,14848
1360263701,685084464,115,165565,1439.695652,1360263394704,1360263397968,684778168,684781432,3264
1360263853,685236848,1,46,46,1360263826063,1360263826063,685209911,685209911,0
1360263949,685332908,1,46,46,1360263921489,1360263921489,685305397,685305397,0
1360264029,685412996,1,46,46,1360264004602,1360264004602,685388598,685388598,0
1360264322,685705536,1,46,46,1360264297025,1360264297025,685680561,685680561,0
1360264659,686042472,1,46,46,1360264632699,1360264632699,686016171,686016171,0
1360264747,686130804,3,144,48,1360264722092,1360264723180,686105896,686106984,1088
1360265104,686488144,1,46,46,1360265076244,1360265076244,686460388,686460388,0
1360265268,686651776,1,137,137,1360265241729,1360265241729,686625505,686625505,0
1360265268,686651884,1,137,137,1360265241622,1360265241622,686625506,686625506,0
1360265277,686661160,7,498,71.14285714,1360265267073,1360265270273,686651233,686654433,3200
1360265291,3619953984,2,98,49,1360265284448,1360265290336,3619947432,3619953320,5888
1360265291,3619953984,2,98,49,1360265284447,1360265290335,3619947431,3619953319,5888
1360265291,3619954004,3,144,48,1360265284425,1360265290377,3619947429,3619953381,5952
1360265291,3619954004,2,98,49,1360265284425,1360265290377,3619947429,3619953381,5952
1360265293,3619955972,10,1348,134.8,1360265267369,1360265267625,3619930341,3619930597,256
1360265293,686677112,33,31993,969.4848485,1360265282543,1360265285359,686666655,686669471,2816
1360265299,3619961956,3,144,48,1360265291322,1360265297146,3619954278,3619960102,5824
1360265299,3619961964,2,98,49,1360265288435,1360265294195,3619951399,3619957159,5760
1360265299,3619961964,2,98,49,1360265288435,1360265294131,3619951399,3619957095,5696
1360265299,3619961964,3,144,48,1360265288435,1360265294131,3619951399,3619957095,5696
1360265299,3619961964,2,98,49,1360265288627,1360265294131,3619951591,3619957095,5504
1360265299,3619961964,3,144,48,1360265288627,1360265294195,3619951591,3619957159,5568
1360265299,3619961968,4,190,47.5,1360265291311,1360265297199,3619954279,3619960167,5888
1360265299,3619961980,3,150,50,1360265288612,1360265294116,3619951592,3619957096,5504
1360265299,3619961984,2,98,49,1360265288608,1360265294112,3619951592,3619957096,5504
1360265299,3619961984,3,144,48,1360265288416,1360265294176,3619951400,3619957160,5760
1360265299,3619961984,3,144,48,1360265288416,1360265294112,3619951400,3619957096,5696
1360265301,686685116,3,150,50,1360265287915,1360265293675,686672031,686677791,5760
1360265301,686685120,3,144,48,1360265287911,1360265293735,686672031,686677855,5824
1360265301,686685120,2,98,49,1360265287913,1360265293673,686672033,686677793,5760
1360265301,686685120,2,98,49,1360265287913,1360265293673,686672033,686677793,5760
1360265301,686685120,4,190,47.5,1360265288040,1360265298920,686672160,686683040,10880
1360265301,686685124,4,190,47.5,1360265288612,1360265299812,686672736,686683936,11200
1360265301,686685124,3,144,48,1360265288612,1360265294628,686672736,686678752,6016
1360265301,686685124,3,144,48,1360265288611,1360265294627,686672735,686678751,6016
1360265301,686685128,4,190,47.5,1360265288675,1360265294755,686672803,686678883,6080
1360265301,686685152,4,196,49,1360265289098,1360265294602,686673250,686678754,5504
1360265301,686685160,3,144,48,1360265289666,1360265295618,686673826,686679778,5952
1360265301,686685196,2,98,49,1360265287836,1360265293596,686672032,686677792,5760
1360265301,686685196,3,144,48,1360265287836,1360265293596,686672032,686677792,5760
1360265301,686685196,2,98,49,1360265287836,1360265293596,686672032,686677792,5760
1360265301,686685196,3,144,48,1360265287835,1360265293979,686672031,686678175,6144
1360265301,686685200,4,190,47.5,1360265287961,1360265300185,686672161,686684385,12224
1360265301,686685204,3,144,48,1360265288469,1360265294549,686672673,686678753,6080
1360265301,686685208,3,144,48,1360265288463,1360265294543,686672671,686678751,6080
1360265301,686685208,2,98,49,1360265288530,1360265294546,686672738,686678754,6016
1360265301,686685236,4,190,47.5,1360265289011,1360265294579,686673247,686678815,5568
1360265312,686695752,13,6025,463.4615385,1360265285402,1360265288602,686669154,686672354,3200
1360265312,686695752,15,2724,181.6,1360265285402,1360265288538,686669154,686672290,3136
1360265312,686695760,18,11799,655.5,1360265284625,1360265288721,686668385,686672481,4096
1360265312,686695760,20,17141,857.05,1360265284624,1360265288912,686668384,686672672,4288
1360265312,686695804,1,137,137,1360265286822,1360265286822,686670626,686670626,0
1360265312,686695840,8,768,96,1360265285248,1360265307648,686669088,686691488,22400
1360265312,686695840,46,54931,1194.152174,1360265285248,1360265287744,686669088,686671584,2496
1360265312,686695840,23,27349,1189.086957,1360265285311,1360265286527,686669151,686670367,1216
1360265312,686695868,63,63750,1011.904762,1360265284196,1360265285348,686668064,686669216,1152
1360265312,686695868,4,658,164.5,1360265284070,1360265284134,686667938,686668002,64
1360265312,686695876,7,392,56,1360265285660,1360265300508,686669536,686684384,14848
1360265312,686695876,9,3000,333.3333333,1360265284571,1360265285083,686668447,686668959,512
1360265312,686695880,16,896,56,1360265284696,1360265311512,686668576,686695392,26816
1360265312,686695880,38,37157,977.8157895,1360265284696,1360265288216,686668576,686672096,3520
1360265312,686695880,16,896,56,1360265284951,1360265311575,686668831,686695455,26624
1360265312,686695904,8,448,56,1360265285057,1360265307393,686668961,686691297,22336
1360265313,3619975880,15,12653,843.5333333,1360265286917,1360265288837,3619949797,3619951717,1920
1360265313,3619975904,18,16847,935.9444444,1360265288493,1360265289517,3619951397,3619952421,1024
1360265313,3619975936,7,392,56,1360265286223,1360265305679,3619949159,3619968615,19456
1360265313,3619975968,7,4965,709.2857143,1360265288431,1360265289519,3619951399,3619952487,1088
1360265315,3619977984,3,144,48,1360265306781,1360265311773,3619969765,3619974757,4992
1360265316,686699752,6,887,147.8333333,1360265288472,1360265289240,686672224,686672992,768
1360265316,686699756,9,3471,385.6666667,1360265288979,1360265290195,686672735,686673951,1216
1360265316,686699796,16,4068,254.25,1360265290541,1360265290989,686674337,686674785,448
1360265316,686699832,8,2447,305.875,1360265291721,1360265307465,686675553,686691297,15744
1360265316,686699840,6,3237,539.5,1360265288127,1360265288575,686671967,686672415,448
1360265316,686699840,7,2649,378.4285714,1360265288191,1360265315583,686672031,686699423,27392
1360265316,686699840,8,3657,457.125,1360265288194,1360265315586,686672034,686699426,27392
1360265316,686699868,6,522,87,1360265288867,1360265289123,686672735,686672991,256
1360265316,686699868,9,3235,359.4444444,1360265288867,1360265289763,686672735,686673631,896
1360265316,686699872,14,3308,236.2857143,1360265288865,1360265290337,686672737,686674209,1472
1360265316,686699872,52,45000,865.3846154,1360265288865,1360265290529,686672737,686674401,1664
1360265316,686699872,6,635,105.8333333,1360265288865,1360265289185,686672737,686673057,320
1360265325,686709084,2,98,49,1360265312141,1360265317389,686696225,686701473,5248
1360265325,686709084,2,98,49,1360265312141,1360265317389,686696225,686701473,5248
1360265325,686709084,4,190,47.5,1360265312141,1360265317389,686696225,686701473,5248
1360265325,686709088,3,144,48,1360265316231,1360265321415,686700319,686705503,5184
1360265325,686709088,4,190,47.5,1360265312647,1360265318407,686696735,686702495,5760
1360265325,686709128,2,98,49,1360265315105,1360265320353,686699233,686704481,5248
1360265325,686709128,2,98,49,1360265315105,1360265320353,686699233,686704481,5248
1360265325,686709128,2,98,49,1360265314912,1360265320352,686699040,686704480,5440
1360265325,686709128,2,98,49,1360265315103,1360265320351,686699231,686704479,5248
1360265325,686709160,2,98,49,1360265312066,1360265317314,686696226,686701474,5248
1360265325,686709160,2,98,49,1360265312066,1360265317314,686696226,686701474,5248
1360265325,686709160,3,144,48,1360265312065,1360265317313,686696225,686701473,5248
1360265325,686709204,3,144,48,1360265314708,1360265320276,686698912,686704480,5568
1360265332,686715784,1,46,46,1360265305399,1360265305399,686689183,686689183,0
1360265333,686717076,2,98,49,1360265327698,1360265332882,686711774,686716958,5184
1360265333,686717080,3,144,48,1360265325074,1360265330834,686709154,686714914,5760
1360265333,686717116,2,98,49,1360265324781,1360265330797,686708897,686714913,6016
1360265333,686717136,2,98,49,1360265327642,1360265332826,686711778,686716962,5184
1360265336,686719964,71,71417,1005.873239,1360265311492,1360265328580,686695456,686712544,17088
1360265340,686723880,13,728,56,1360265312216,1360265338968,686696096,686722848,26752
1360265340,686723884,6,4214,702.3333333,1360265312532,1360265312660,686696416,686696544,128
1360265340,686723884,5,2510,502,1360265312531,1360265312723,686696415,686696607,192
1360265340,686723888,81,103562,1278.54321,1360265312784,1360265316176,686696672,686700064,3392
1360265340,686723892,5,2730,546,1360265312974,1360265313614,686696866,686697506,640
1360265340,686723892,11,9606,873.2727273,1360265312974,1360265315086,686696866,686698978,2112
1360265340,686723892,40,42878,1071.95,1360265312974,1360265329230,686696866,686713122,16256
1360265340,686723892,20,21753,1087.65,1360265312973,1360265328781,686696865,686712673,15808
1360265340,686723892,5,2540,508,1360265312973,1360265313741,686696865,686697633,768
1360265340,686723892,68,80468,1183.352941,1360265312973,1360265325965,686696865,686709857,12992
1360265340,686723892,11,9286,844.1818182,1360265312973,1360265313997,686696865,686697889,1024
1360265340,686723892,18,20728,1151.555556,1360265312972,1360265314892,686696864,686698784,1920
1360265340,686723892,12,5482,456.8333333,1360265312972,1360265315404,686696864,686699296,2432
1360265340,686723960,6,540,90,1360265315017,1360265324873,686698977,686708833,9856
1360265340,686723960,12,3606,300.5,1360265315081,1360265329161,686699041,686713121,14080
1360265340,686723960,24,1344,56,1360265315337,1360265338761,686699297,686722721,23424
1360265340,686723964,25,1400,56,1360265315266,1360265339650,686699230,686723614,24384
1360265340,686723964,8,3205,400.625,1360265315270,1360265315590,686699234,686699554,320
1360265340,686724004,22,21833,992.4090909,1360265312862,1360265328862,686696866,686712866,16000
1360265340,686724004,5,2015,403,1360265312862,1360265313630,686696866,686697634,768
1360265340,686724004,15,10091,672.7333333,1360265312861,1360265329373,686696865,686713377,16512
1360265340,686724004,6,700,116.6666667,1360265312861,1360265329565,686696865,686713569,16704
1360265340,686724004,20,18192,909.6,1360265312861,1360265329181,686696865,686713185,16320
1360265340,686724004,6,3497,582.8333333,1360265312861,1360265312989,686696865,686696993,128
1360265340,686724004,18,14770,820.5555556,1360265312861,1360265315549,686696865,686699553,2688
1360265340,686724004,6,3789,631.5,1360265312861,1360265313373,686696865,686697377,512
1360265340,686724004,10,8589,858.9,1360265312861,1360265314973,686696865,686698977,2112
1360265340,686724004,5,2992,598.4,1360265312861,1360265313565,686696865,686697569,704
1360265340,686724004,32,36808,1150.25,1360265312861,1360265328861,686696865,686712865,16000
1360265340,686724004,21,19382,922.952381,1360265312861,1360265315357,686696865,686699361,2496
1360265340,686724004,19,20060,1055.789474,1360265312861,1360265328605,686696865,686712609,15744
1360265340,686724004,8,6482,810.25,1360265312861,1360265314781,686696865,686698785,1920
1360265340,686724004,10,6969,696.9,1360265312861,1360265314973,686696865,686698977,2112
1360265340,686724004,25,25129,1005.16,1360265312861,1360265328797,686696865,686712801,15936
1360265340,686724048,5,2233,446.6,1360265314929,1360265315377,686698977,686699425,448
1360265340,686724076,12,672,56,1360265315541,1360265338261,686699617,686722337,22720
1360265341,3620003880,13,728,56,1360265315655,1360265339591,3619978535,3620002471,23936
1360265341,686725076,3,144,48,1360265333202,1360265333842,686717278,686717918,640
1360265341,686725080,4,190,47.5,1360265333201,1360265333841,686717281,686717921,640
1360265341,686725112,4,196,49,1360265329071,1360265335151,686713183,686719263,6080
1360265341,686725116,2,98,49,1360265329390,1360265334830,686713506,686718946,5440
1360265341,686725116,2,98,49,1360265329450,1360265334826,686713566,686718942,5376
1360265341,686725120,2,98,49,1360265329577,1360265334825,686713697,686718945,5248
1360265341,686725168,2,98,49,1360265329016,1360265334776,686713184,686718944,5760
1360265341,686725168,3,150,50,1360265329016,1360265334776,686713184,686718944,5760
1360265341,686725172,2,98,49,1360265329334,1360265334774,686713506,686718946,5440
1360265341,686725172,3,144,48,1360265329334,1360265335030,686713506,686719202,5696
1360265344,686727780,14,1344,96,1360265316028,1360265342204,686699808,686725984,26176
1360265344,686727788,2,92,46,1360265317618,1360265317618,686701406,686701406,0
1360265344,686727900,3,138,46,1360265317507,1360265317507,686701407,686701407,0
1360265348,686731852,1,137,137,1360265323508,1360265323508,686707360,686707360,0
1360265352,686735764,6,1212,202,1360265325389,1360265340621,686709153,686724385,15232
1360265352,686735808,5,1194,238.8,1360265326175,1360265327007,686709983,686710815,832
1360265352,686735852,10,1428,142.8,1360265327670,1360265329526,686711522,686713378,1856
1360265352,686735924,4,557,139.25,1360265324972,1360265325036,686708896,686708960,64
1360265356,686739812,5,1701,340.2,1360265329690,1360265329818,686713502,686713630,128
1360265356,686739864,4,324,81,1360265327911,1360265328103,686711775,686711967,192
1360265356,686739896,6,744,124,1360265328393,1360265329481,686712289,686713377,1088
1360265356,686739904,3,169,56.33333333,1360265329214,1360265329342,686713118,686713246,128
1360265356,686739908,4,1014,253.5,1360265329278,1360265329982,686713186,686713890,704
1360265356,686739912,13,2246,172.7692308,1360265329657,1360265350201,686713569,686734113,20544
1360265356,686739912,18,12975,720.8333333,1360265329783,1360265330103,686713695,686714015,320
1360265356,686739940,2,123,61.5,1360265330206,1360265330270,686714146,686714210,64
1360265360,686743796,2,123,61.5,1360265332330,1360265332522,686716126,686716318,192
1360265360,686743836,1,77,77,1360265334276,1360265334276,686718112,686718112,0
1360265360,686743868,3,181,60.33333333,1360265335268,1360265335524,686719136,686719392,256
1360265360,686743868,4,227,56.75,1360265335268,1360265335524,686719136,686719392,256
1360265360,686743924,3,169,56.33333333,1360265334188,1360265334316,686718112,686718240,128
1360265360,686743960,3,206,68.66666667,1360265335177,1360265335497,686719137,686719457,320
1360265365,686749100,2,98,49,1360265356795,1360265361787,686740895,686745887,4992
1360265365,686749100,3,144,48,1360265356795,1360265362811,686740895,686746911,6016
1360265365,686749104,2,98,49,1360265356794,1360265361786,686740898,686745890,4992
1360265365,686749184,3,144,48,1360265356649,1360265361705,686740833,686745889,5056
1360265365,686749184,3,144,48,1360265356713,1360265361705,686740897,686745889,4992
1360265365,686749184,2,98,49,1360265356712,1360265361704,686740896,686745888,4992
1360265368,686751804,24,1344,56,1360265339938,1360265367650,686723742,686751454,27712
1360265368,686751892,12,672,56,1360265341130,1360265367754,686725022,686751646,26624
1360265368,686751932,12,672,56,1360265340581,1360265366565,686724513,686750497,25984
1360265368,686751936,23,1288,56,1360265340896,1360265367264,686724832,686751200,26368
1360265369,3620031932,12,672,56,1360265341713,1360265368209,3620004645,3620031141,26496
1360265372,686755828,11,1056,96,1360265344330,1360265369418,686728158,686753246,25088
1360265373,686757124,3,144,48,1360265365988,1360265371300,686750112,686755424,5312
1360265373,686757152,3,144,48,1360265367047,1360265372295,686751199,686756447,5248
1360265373,686757200,2,98,49,1360265365848,1360265371224,686750048,686755424,5376
1360265373,686757200,2,98,49,1360265365911,1360265371223,686750111,686755423,5312
1360265373,686757200,3,144,48,1360265365975,1360265371223,686750175,686755423,5248
1360265373,686757204,3,144,48,1360265365970,1360265371218,686750174,686755422,5248
1360265373,686757224,2,98,49,1360265366977,1360265372225,686751201,686756449,5248
1360265373,686757228,2,98,49,1360265367100,1360265372156,686751328,686756384,5056
1360265376,686759964,2,92,46,1360265348484,1360265348548,686732448,686732512,64
1360265381,686765084,2675,3708008,1386.171215,1360265327691,1360265377483,686711775,686761567,49792
1360265381,686765092,4,190,47.5,1360265368258,1360265373890,686752350,686757982,5632
1360265381,686765096,2,94,47,1360265373696,1360265379328,686757792,686763424,5632
1360265381,686765096,2,98,49,1360265373694,1360265379326,686757790,686763422,5632
1360265381,686765100,2,94,47,1360265373885,1360265379325,686757985,686763425,5440
1360265381,686765104,2,98,49,1360265374137,1360265379321,686758241,686763425,5184
1360265381,686765168,3,345,115,1360265373623,1360265374199,686757791,686758367,576
1360265381,686765172,2,98,49,1360265373621,1360265379253,686757793,686763425,5632
1360265381,686765172,2,94,47,1360265373812,1360265379252,686757984,686763424,5440
1360265381,686765172,2,98,49,1360265373938,1360265379250,686758110,686763422,5312
1360265381,686765176,2,98,49,1360265374065,1360265379249,686758241,686763425,5184
1360265384,686767820,3,144,48,1360265371602,1360265377618,686755422,686761438,6016
1360265384,686767832,3,2364,788,1360265357641,1360265357641,686741473,686741473,0
1360265384,686767832,6,915,152.5,1360265357831,1360265373255,686741663,686757087,15424
1360265384,686767860,7,6433,919,1360265357995,1360265368235,686741855,686752095,10240
1360265384,686767864,24,26490,1103.75,1360265357864,1360265369704,686741728,686753568,11840
1360265384,686767868,45,54635,1214.111111,1360265357988,1360265375780,686741856,686759648,17792
1360265384,686767868,9,630,70,1360265358051,1360265368483,686741919,686752351,10432
1360265384,686767900,3,169,56.33333333,1360265359170,1360265359234,686743070,686743134,64
1360265384,686767920,47,48309,1027.851064,1360265357425,1360265374449,686741345,686758369,17024
1360265384,686767940,3,138,46,1360265357467,1360265357531,686741407,686741471,64
1360265387,3620049964,3,144,48,1360265374769,1360265379825,3620037733,3620042789,5056
1360265388,686771860,12,14987,1248.916667,1360265361324,1360265361324,686745184,686745184,0
1360265388,686771932,3,169,56.33333333,1360265360162,1360265360162,686744094,686744094,0
1360265388,686771964,2,574,287,1360265360645,1360265360645,686744609,686744609,0
1360265388,686772012,1,137,137,1360265363474,1360265363474,686747486,686747486,0
1360265389,686773092,2636,3672230,1393.10698,1360265327681,1360265382529,686711773,686766621,54848
1360265389,686773172,4,184,46,1360265387765,1360265388149,686771937,686772321,384
1360265392,686775932,2,219,109.5,1360265367012,1360265367076,686750944,686751008,64
1360265392,686775936,8,1758,219.75,1360265367264,1360265368800,686751200,686752736,1536
1360265392,686776028,4,489,122.25,1360265367171,1360265367299,686751199,686751327,128
1360265392,686776028,17,4648,273.4117647,1360265367171,1360265374531,686751199,686758559,7360
1360265392,686776028,4,344,86,1360265367618,1360265367874,686751646,686751902,256
1360265396,686779852,36,17398,483.2777778,1360265368498,1360265384050,686752350,686767902,15552
1360265396,686779852,4,602,150.5,1360265368498,1360265369586,686752350,686753438,1088
1360265396,686779852,4,602,150.5,1360265368498,1360265370418,686752350,686754270,1920
1360265396,686779856,29,1624,56,1360265368623,1360265394671,686752479,686778527,26048
1360265396,686779860,5,730,146,1360265369004,1360265373612,686752864,686757472,4608
1360265396,686779928,19,10317,543,1360265371111,1360265384551,686755039,686768479,13440
1360265396,686779960,23,15597,678.1304348,1360265368390,1360265374662,686752350,686758622,6272
1360265396,686779968,7,1304,186.2857143,1360265368894,1360265373374,686752862,686757342,4480
1360265396,686779972,30,1680,56,1360265368957,1360265394749,686752929,686778721,25792
1360265396,686779972,10,8179,817.9,1360265369020,1360265370812,686752992,686754784,1792
1360265396,686779972,15,840,56,1360265369083,1360265394427,686753055,686778399,25344
1360265396,686779980,5,364,72.8,1360265369525,1360265369653,686753505,686753633,128
1360265396,686779980,30,13092,436.4,1360265369523,1360265375283,686753503,686759263,5760
1360265396,686780020,15,840,56,1360265371403,1360265394891,686755423,686778911,23488
1360265397,3620059960,15,840,56,1360265371959,1360265395447,3620034919,3620058407,23488
1360265397,686781096,3,144,48,1360265384512,1360265389632,686768608,686773728,5120
1360265397,686781124,4,190,47.5,1360265388770,1360265394722,686772894,686778846,5952
1360265400,686783876,10,1678,167.8,1360265373787,1360265395803,686757663,686779679,22016
1360265400,686783904,2,123,61.5,1360265374016,1360265374208,686757920,686758112,192
1360265400,686783988,8,1186,148.25,1360265373805,1360265385645,686757793,686769633,11840
1360265400,686783992,17,1632,96,1360265372965,1360265398629,686756957,686782621,25664
1360265400,686784020,2,123,61.5,1360265374730,1360265374730,686758750,686758750,0
1360265404,686787884,2,129,64.5,1360265376788,1360265377044,686760672,686760928,256
1360265404,686787952,2,123,61.5,1360265378705,1360265378705,686762657,686762657,0
1360265404,686787952,1,77,77,1360265378705,1360265378705,686762657,686762657,0
1360265404,686787960,3,169,56.33333333,1360265379719,1360265379719,686763679,686763679,0
1360265404,686788076,2,123,61.5,1360265379604,1360265379604,686763680,686763680,0
1360265405,686789060,2,123,61.5,1360265379618,1360265379618,686763678,686763678,0
1360265405,686789100,3,138,46,1360265404604,1360265404668,686788704,686788768,64
1360265405,686789104,6,276,46,1360265401529,1360265402169,686785633,686786273,640
1360265405,686789144,2,92,46,1360265403473,1360265403473,686787617,686787617,0
1360265405,686789144,2,92,46,1360265403535,1360265403535,686787679,686787679,0
1360265405,686789220,3,138,46,1360265403458,1360265403522,686787678,686787742,64
1360265408,686791868,3,491,163.6666667,1360265380197,1360265380325,686764065,686764193,128
1360265413,686797144,154,210064,1364.051948,1360265370897,1360265406417,686755041,686790561,35520
1360265413,686797248,1354,1837531,1357.112999,1360265370790,1360265407782,686755038,686792030,36992
1360265421,686805140,7,412,58.85714286,1360265418516,1360265418580,686802656,686802720,64
1360265421,686805140,8,458,57.25,1360265419537,1360265419601,686803677,686803741,64
1360265424,686807884,24,1344,56,1360265396307,1360265421843,686780191,686805727,25536
1360265424,686807884,24,1344,56,1360265396371,1360265422803,686780255,686806687,26432
1360265424,686807920,12,672,56,1360265396913,1360265423729,686780833,686807649,26816
1360265424,686807996,12,672,56,1360265396513,1360265420449,686780509,686804445,23936
1360265424,686808048,1,46,46,1360265399598,1360265399598,686783646,686783646,0
1360265425,3620087892,11,616,56,1360265397562,1360265417914,3620060454,3620080806,20352
1360265428,686812024,9,864,96,1360265401349,1360265420741,686785373,686804765,19392
1360265428,686812068,1,77,77,1360265403610,1360265403610,686787678,686787678,0
1360265429,3620091936,2,92,46,1360265404109,1360265404109,3620067045,3620067045,0
1360265429,686813112,7,412,58.85714286,1360265424558,1360265424622,686808670,686808734,64
1360265429,686813116,7,412,58.85714286,1360265424556,1360265424620,686808672,686808736,64
1360265429,686813156,8,458,57.25,1360265423492,1360265423556,686807648,686807712,64
1360265429,686813192,7,412,58.85714286,1360265424480,1360265424544,686808672,686808736,64
1360265429,686813192,9,504,56,1360265421472,1360265421536,686805664,686805728,64
1360265429,686813224,7,412,58.85714286,1360265422461,1360265422461,686806685,686806685,0
1360265432,686816020,2,123,61.5,1360265404617,1360265404681,686788637,686788701,64
1360265432,686816108,6,1094,182.3333333,1360265405363,1360265415411,686789471,686799519,10048
1360265432,686816112,6,1088,181.3333333,1360265405549,1360265415725,686789661,686799837,10176
1360265433,3620095888,2,92,46,1360265405119,1360265405119,3620068007,3620068007,0
1360265433,3620095888,1,46,46,1360265405119,1360265405119,3620068007,3620068007,0
1360265436,686819960,1,137,137,1360265408072,1360265408072,686792032,686792032,0
1360265436,686819972,1,46,46,1360265409021,1360265409021,686792993,686792993,0
1360265436,686820088,1,46,46,1360265409479,1360265409479,686793567,686793567,0
1360265437,686821200,2686,3713368,1382.489948,1360265365976,1360265433048,686750176,686817248,67072
1360265440,686824012,3,181,60.33333333,1360265412691,1360265413011,686796703,686797023,320
1360265448,686832072,6,2401,400.1666667,1360265419862,1360265442518,686803934,686826590,22656
1360265453,3620115872,5,280,56,1360265425167,1360265449743,3620088039,3620112615,24576
1360265453,686837128,5,236,47.2,1360265445535,1360265446111,686829663,686830239,576
1360265453,686837200,8,458,57.25,1360265448470,1360265448534,686832670,686832734,64
1360265453,686837200,7,412,58.85714286,1360265448469,1360265448533,686832669,686832733,64
1360265453,686837240,2,98,49,1360265442285,1360265447405,686826525,686831645,5120
1360265456,686840020,1,46,46,1360265429642,1360265429642,686813662,686813662,0
1360265456,686840048,1,46,46,1360265429616,1360265429616,686813664,686813664,0
1360265456,686840048,1,46,46,1360265429616,1360265429616,686813664,686813664,0
1360265456,686840060,1,46,46,1360265430563,1360265430563,686814623,686814623,0
1360265456,686840060,1,46,46,1360265430562,1360265430562,686814622,686814622,0
1360265456,686840136,2,92,46,1360265429527,1360265429527,686813663,686813663,0
1360265456,686840136,1,46,46,1360265429527,1360265429527,686813663,686813663,0
1360265456,686840136,1,46,46,1360265429527,1360265429527,686813663,686813663,0
1360265456,686840136,1,46,46,1360265429527,1360265429527,686813663,686813663,0
1360265456,686840136,1,46,46,1360265429527,1360265429527,686813663,686813663,0
1360265456,686840136,2,92,46,1360265429526,1360265429590,686813662,686813726,64
1360265456,686840176,2,92,46,1360265430447,1360265430511,686814623,686814687,64
1360265456,686840176,2,92,46,1360265430447,1360265430575,686814623,686814751,128
1360265456,686840176,1,46,46,1360265430447,1360265430447,686814623,686814623,0
1360265456,686840176,1,46,46,1360265430447,1360265430447,686814623,686814623,0
1360265468,686851988,5,280,56,1360265443883,1360265449515,686827871,686833503,5632
1360265468,686851996,2,92,46,1360265440673,1360265440673,686824669,686824669,0
1360265468,686852044,10,560,56,1360265442929,1360265450161,686826973,686834205,7232
1360265468,686852072,1,137,137,1360265442902,1360265442902,686826974,686826974,0
1360265468,686852112,1,46,46,1360265440558,1360265440558,686824670,686824670,0
1360265468,686852164,10,560,56,1360265442748,1360265449660,686826912,686833824,6912
1360265472,686856004,1,46,46,1360265444700,1360265444700,686828704,686828704,0
1360265472,686856024,2,92,46,1360265444614,1360265444678,686828638,686828702,64
1360265472,686856076,5,480,96,1360265443857,1360265449553,686827933,686833629,5696
1360265472,686856112,4,224,56,1360265444526,1360265449070,686828638,686833182,4544
1360265472,686856112,1,46,46,1360265444589,1360265444589,686828701,686828701,0
1360265472,686856116,1,46,46,1360265444524,1360265444524,686828640,686828640,0
1360265472,686856116,1,46,46,1360265444524,1360265444524,686828640,686828640,0
1360265480,686864024,3,544,181.3333333,1360265455880,1360265455880,686839904,686839904,0
1360265484,686868172,3,169,56.33333333,1360265457522,1360265457522,686841694,686841694,0
1360265500,686884080,6,336,56,1360265473742,1360265493006,686857822,686877086,19264
1360265500,686884136,2,92,46,1360265472536,1360265472536,686856672,686856672,0
1360265500,686884168,7,392,56,1360265473269,1360265496373,686857437,686880541,23104
1360265500,686884172,13,728,56,1360265473522,1360265499506,686857694,686883678,25984
1360265500,686884172,12,672,56,1360265473585,1360265496177,686857757,686880349,22592
1360265500,686884176,6,576,96,1360265473711,1360265494447,686857887,686878623,20736
1360265500,686884200,1,137,137,1360265474581,1360265474581,686858781,686858781,0
1360265500,686884212,2,92,46,1360265475465,1360265475465,686859677,686859677,0
1360265501,3620163904,7,392,56,1360265473969,1360265497137,3620136873,3620160041,23168
1360265501,686885228,154,136501,886.3701299,1360265355963,1360265500475,686740191,686884703,144512
1360265501,686885236,3,144,48,1360265488819,1360265494451,686873055,686878687,5632
1360265504,686888140,1,46,46,1360265476497,1360265476497,686860637,686860637,0
1360265508,686892092,1,46,46,1360265482563,1360265482563,686866655,686866655,0
1360265508,686892120,1,46,46,1360265483556,1360265483556,686867676,686867676,0
1360265508,686892168,9,1897,210.7777778,1360265481909,1360265496373,686866077,686880541,14464
1360265508,686892204,2,92,46,1360265482451,1360265482515,686866655,686866719,64
1360265508,686892216,2,92,46,1360265483461,1360265483461,686867677,686867677,0
1360265509,686893144,3,144,48,1360265496589,1360265502541,686880733,686886685,5952
1360265509,686893260,7,412,58.85714286,1360265502427,1360265502491,686886687,686886751,64
1360265512,686896080,1,46,46,1360265484558,1360265484558,686868638,686868638,0
1360265512,686896084,1,46,46,1360265484556,1360265484556,686868640,686868640,0
1360265512,686896084,1,46,46,1360265484556,1360265484556,686868640,686868640,0
1360265512,686896160,2,92,46,1360265485500,1360265485500,686869660,686869660,0
1360265512,686896164,2,92,46,1360265484472,1360265484536,686868636,686868700,64
1360265512,686896220,2,92,46,1360265486465,1360265486465,686870685,686870685,0
1360265516,686900084,1,46,46,1360265488585,1360265488585,686872669,686872669,0
1360265516,686900084,2,92,46,1360265488584,1360265488648,686872668,686872732,64
1360265516,686900116,2,92,46,1360265489514,1360265489578,686873630,686873694,64
1360265516,686900128,1,46,46,1360265490525,1360265490525,686874653,686874653,0
1360265516,686900168,2,92,46,1360265488501,1360265488501,686872669,686872669,0
1360265516,686900208,1,46,46,1360265489423,1360265489423,686873631,686873631,0
1360265516,686900236,2,92,46,1360265490417,1360265490417,686874653,686874653,0
1360265516,686900252,2,92,46,1360265491427,1360265491427,686875679,686875679,0
1360265524,686908256,2,92,46,1360265499421,1360265499421,686883677,686883677,0
1360265524,686908256,1,46,46,1360265499421,1360265499421,686883677,686883677,0
1360265524,686908260,3,544,181.3333333,1360265495707,1360265495771,686879967,686880031,64
1360265528,686912136,11,616,56,1360265500503,1360265512087,686884639,686896223,11584
1360265528,686912172,6,336,56,1360265502450,1360265512370,686886622,686896542,9920
1360265532,686916312,10,560,56,1360265504804,1360265511780,686889116,686896092,6976
1360265532,686916416,5,480,96,1360265504443,1360265509755,686888859,686894171,5312
1360265532,686916428,5,280,56,1360265505075,1360265510643,686889503,686895071,5568
1360265533,3620195908,5,280,56,1360265506155,1360265512555,3620169063,3620175463,6400
1360265533,686917220,6,502,83.66666667,1360265528065,1360265530241,686912285,686914461,2176
1360265536,686920432,1,137,137,1360265507950,1360265507950,686892382,686892382,0
1360265556,686940296,1,46,46,1360265527988,1360265527988,686912284,686912284,0
1360265556,686940348,2,92,46,1360265530305,1360265530369,686914653,686914717,64
1360265560,686944396,8,2133,266.625,1360265535696,1360265540112,686920092,686924508,4416
1360265564,686948348,4,608,152,1360265537663,1360265537791,686922011,686922139,128
1360265564,686948392,13,728,56,1360265539604,1360265547284,686923996,686931676,7680
1360265564,686948396,7,672,96,1360265539410,1360265547090,686923806,686931486,7680
1360265564,686948396,14,784,56,1360265539473,1360265547793,686923869,686932189,8320
1360265565,686948492,7,392,56,1360265540569,1360265548313,686924061,686931805,7744
1360265565,3620228032,7,392,56,1360265540590,1360265548270,3620203622,3620211302,7680
1360265568,686952340,6,336,56,1360265540297,1360265547081,686924637,686931421,6784
1360265569,686952456,1,137,137,1360265542331,1360265542331,686925787,686925787,0
1360265581,686965240,8072,11226334,1390.774777,1360265387374,1360265577006,686771614,686961246,189632
1360265588,686972324,3,605,201.6666667,1360265560216,1360265560344,686944540,686944668,128
1360265597,686980536,1,137,137,1360265572523,1360265572523,686956059,686956059,0
1360265597,686981168,4,190,47.5,1360265589107,1360265594291,686973275,686978459,5184
1360265597,686981216,3,144,48,1360265589060,1360265595204,686973276,686979420,6144
1360265600,686984376,5,535,107,1360265573476,1360265573732,686957852,686958108,256
1360265601,686984616,3,544,181.3333333,1360265576476,1360265576540,686960092,686960156,64
1360265608,686992400,24,1344,56,1360265581326,1360265601294,686965726,686985694,19968
1360265609,686992484,13,728,56,1360265582114,1360265603426,686965598,686986910,21312
1360265609,686992484,25,1400,56,1360265581986,1360265602530,686965470,686986014,20544
1360265609,686992484,13,1248,96,1360265582240,1360265603680,686965724,686987164,21440
1360265609,686992496,12,672,56,1360265582612,1360265595540,686966108,686979036,12928
1360265609,3620271984,12,672,56,1360265582561,1360265595745,3620245545,3620258729,13184
1360265617,687000500,12,3787,315.5833333,1360265590864,1360265603472,686974364,686986972,12608
1360265640,687024456,4,224,56,1360265613013,1360265619989,686997469,687004445,6976
1360265641,687024488,1,137,137,1360265614747,1360265614747,686998235,686998235,0
1360265641,687024528,2,498,249,1360265616564,1360265616564,687000092,687000092,0
1360265641,687024532,8,448,56,1360265613679,1360265621423,686997211,687004955,7744
1360265641,3620303968,4,224,56,1360265614002,1360265620914,3620276970,3620283882,6912
1360265641,687024572,8,448,56,1360265613511,1360265621063,686997083,687004635,7552
1360265641,687024576,4,224,56,1360265614405,1360265621317,686997981,687004893,6912
1360265641,687024576,4,384,96,1360265614532,1360265621636,686998108,687005212,7104
1360265669,687052632,3,492,164,1360265643981,1360265644109,687027613,687027741,128
1360265672,687056472,15,840,56,1360265644289,1360265654081,687028761,687038553,9792
1360265672,687056476,8,448,56,1360265644417,1360265655937,687028893,687040413,11520
1360265673,687056584,7,392,56,1360265645820,1360265654588,687029404,687038172,8768
1360265673,687056584,15,840,56,1360265645243,1360265656507,687028827,687040091,11264
1360265673,687056592,7,672,96,1360265646067,1360265654643,687029659,687038235,8576
1360265673,3620336060,7,392,56,1360265645334,1360265654166,3620308394,3620317226,8832
1360265681,687064484,1,137,137,1360265653343,1360265653343,687036827,687036827,0
1360265681,687064564,3,544,181.3333333,1360265656526,1360265656590,687040090,687040154,64
1360265705,3620367980,6,336,56,1360265678372,1360265685220,3620341352,3620348200,6848
1360265705,687088792,11,616,56,1360265678250,1360265689194,687062042,687072986,10944
1360265705,687088812,6,336,56,1360265679576,1360265689560,687063388,687073372,9984
1360265705,687088844,5,280,56,1360265680376,1360265684664,687064220,687068508,4288
1360265705,687088916,11,616,56,1360265679280,1360265689264,687063196,687073180,9984
1360265705,687088924,5,480,96,1360265679849,1360265684009,687063773,687067933,4160
1360265709,687092828,8,1549,193.625,1360265683528,1360265695752,687067356,687079580,12224
1360265717,687100924,2,92,46,1360265689448,1360265689448,687073372,687073372,0
1360265717,687101256,9,3160,351.1111111,1360265695451,1360265715483,687079707,687099739,20032
1360265721,687105028,3,544,181.3333333,1360265696128,1360265696128,687080156,687080156,0
1360265725,687108816,1,137,137,1360265697875,1360265697875,687081691,687081691,0
1360265737,3620400028,7,392,56,1360265711476,1360265719028,3620374504,3620382056,7552
1360265737,687120860,14,784,56,1360265711078,1360265719590,687094938,687103450,8512
1360265737,687120948,8,768,96,1360265710736,1360265719312,687094684,687103260,8576
1360265737,687120972,15,840,56,1360265711032,1360265719544,687095004,687103516,8512
1360265737,687120972,8,448,56,1360265711031,1360265719927,687095003,687103899,8896
1360265737,687120984,7,392,56,1360265711916,1360265719148,687095900,687103132,7232
1360265749,687133364,3,144,48,1360265743149,1360265748205,687127513,687132569,5056
1360265757,687140936,9,3525,391.6666667,1360265729113,1360265751897,687113049,687135833,22784
1360265761,687145048,3,544,181.3333333,1360265736043,1360265736107,687120091,687120155,64
1360265765,687148848,1,137,137,1360265738225,1360265738225,687122073,687122073,0
1360265765,687148956,1,46,46,1360265737669,1360265737669,687121625,687121625,0
1360265769,3620432008,9,504,56,1360265741127,1360265752327,3620404135,3620415335,11200
1360265769,687152896,8,448,56,1360265741441,1360265748161,687125337,687132057,6720
1360265769,687152900,8,448,56,1360265741756,1360265751804,687125656,687135704,10048
1360265769,687152980,16,896,56,1360265741166,1360265748206,687125146,687132186,7040
1360265769,687152980,15,840,56,1360265741292,1360265748524,687125272,687132504,7232
1360265769,687152984,8,768,96,1360265741417,1360265748137,687125401,687132121,6720
1360265773,687157252,6,496,82.66666667,1360265769056,1360265771232,687153308,687155484,2176
1360265797,687180964,1,46,46,1360265769341,1360265769341,687153305,687153305,0
1360265801,3620464144,4,224,56,1360265774209,1360265785473,3620437353,3620448617,11264
1360265801,687184968,6,576,96,1360265773242,1360265788922,687157210,687172890,15680
1360265801,687184972,10,560,56,1360265772980,1360265788660,687156952,687172632,15680
1360265801,687184976,6,336,56,1360265773107,1360265788787,687157083,687172763,15680
1360265801,687184984,5,280,56,1360265773866,1360265781610,687157850,687165594,7744
1360265801,687185060,11,616,56,1360265772828,1360265785372,687156888,687169432,12544
1360265801,687185168,4,1002,250.5,1360265775922,1360265776178,687160090,687160346,256
1360265805,687189136,1,137,137,1360265778897,1360265778897,687163033,687163033,0
1360265813,687197068,6,2046,341,1360265785110,1360265788694,687169178,687172762,3584
1360265829,3620492144,8,448,56,1360265804481,1360265812801,3620467625,3620475945,8320
1360265829,687213068,16,896,56,1360265803924,1360265812884,687187992,687196952,8960
1360265829,687213164,17,952,56,1360265803767,1360265816375,687187931,687200539,12608
1360265829,687213164,8,448,56,1360265803957,1360265812277,687188121,687196441,8320
1360265829,687213192,8,448,56,1360265804377,1360265813081,687188569,687197273,8704
1360265829,687213192,8,768,96,1360265804504,1360265816024,687188696,687200216,11520
1360265837,687221108,1,137,137,1360265810734,1360265810734,687194842,687194842,0
1360265841,687225168,4,590,147.5,1360265816049,1360265816113,687200217,687200281,64
1360265853,687237436,10,4015,401.5,1360265827749,1360265848165,687212185,687232601,20416
1360265861,3620524076,11,616,56,1360265834821,1360265848773,3620497897,3620511849,13952
1360265861,687245244,22,1232,56,1360265834085,1360265848485,687218329,687232729,14400
1360265861,687245260,10,560,56,1360265835154,1360265843410,687219414,687227670,8256
1360265861,687245260,10,960,96,1360265835348,1360265843476,687219608,687227736,8128
1360265861,687245340,11,616,56,1360265834117,1360265843845,687218457,687228185,9728
1360265861,687245344,21,1176,56,1360265834366,1360265848254,687218710,687232598,13888
1360265869,687253204,1,137,137,1360265841358,1360265841358,687225562,687225562,0
1360265881,687265400,3,544,181.3333333,1360265855817,1360265855817,687240217,687240217,0
1360265886,687269504,151,119135,788.9735099,1360265284169,1360265885129,686667673,687268633,600960
1360265893,3620556056,9,504,56,1360265867225,1360265886681,3620530281,3620549737,19456
1360265893,687277224,10,560,56,1360265866230,1360265886582,687250454,687270806,20352
1360265893,687277228,10,960,96,1360265866290,1360265886642,687250518,687270870,20352
1360265893,687277244,18,1008,56,1360265866405,1360265886373,687250649,687270617,19968
1360265893,687277244,9,504,56,1360265866532,1360265884324,687250776,687268568,17792
1360265893,687277244,19,1064,56,1360265866531,1360265886819,687250775,687271063,20288
1360265893,687277368,3,606,202,1360265867302,1360265867430,687251670,687251798,128
1360265909,687293332,1,137,137,1360265881100,1360265881100,687265432,687265432,0
1360265910,687293640,13352,18738329,1403.409901,1360265580991,1360265904127,686964631,687287767,323136
1360265913,687297376,7,832,118.8571429,1360265886049,1360265886497,687270425,687270873,448
1360265921,687305336,3,544,181.3333333,1360265895879,1360265895943,687280215,687280279,64
1360265921,687305388,11,1407,127.9090909,1360265894037,1360265894357,687278425,687278745,320
1360265934,687317576,3,492,164,1360265908289,1360265908353,687291865,687291929,64
1360265934,687317724,3,144,48,1360265925866,1360265930858,687309590,687314582,4992
1360265941,687325392,1,137,137,1360265914447,1360265914447,687298839,687298839,0
1360265962,687345424,3,544,181.3333333,1360265936920,1360265936920,687320344,687320344,0
1360265966,687349804,3,144,48,1360265960092,1360265965212,687343896,687349016,5120
1360265974,687357536,9,3418,379.7777778,1360265947686,1360265965222,687331222,687348758,17536
1360265977,3620640272,7,392,56,1360265950915,1360265960003,3620614187,3620623275,9088
1360265977,687361388,12,672,56,1360265950099,1360265958803,687334487,687343191,8704
1360265977,687361388,7,392,56,1360265950289,1360265959185,687334677,687343573,8896
1360265978,687361424,6,336,56,1360265951768,1360265958552,687335192,687341976,6784
1360265978,687361424,6,576,96,1360265951893,1360265959637,687335317,687343061,7744
1360265978,687361516,12,672,56,1360265951417,1360265960633,687334933,687344149,9216
1360265986,687369432,1,137,137,1360265959824,1360265959824,687343256,687343256,0
1360265998,687381800,3,144,48,1360265990047,1360265995423,687373847,687379223,5376
1360265998,687381800,4,190,47.5,1360265990047,1360265996447,687373847,687380247,6400
1360265998,687381800,3,144,48,1360265990047,1360265995423,687373847,687379223,5376
1360265998,687381804,5,242,48.4,1360265990492,1360265996444,687374296,687380248,5952
1360265998,687381884,2,98,49,1360265990411,1360265996299,687374295,687380183,5888
1360265998,687381884,4,190,47.5,1360265990410,1360265996362,687374294,687380246,5952
1360266002,687385720,3,544,181.3333333,1360265976687,1360265976751,687360407,687360471,64
1360266006,687390064,145,189049,1303.786207,1360265880469,1360265998165,687264533,687382229,117696
1360266009,3620672508,6,336,56,1360265983189,1360265996117,3620646697,3620659625,12928
1360266010,687393660,6,576,96,1360265982954,1360265991274,687366614,687374934,8320
1360266010,687393768,13,728,56,1360265982592,1360265998528,687366360,687382296,15936
1360266010,687393768,7,392,56,1360265982718,1360265998718,687366486,687382486,16000
1360266010,687393772,12,672,56,1360265982972,1360265998396,687366744,687382168,15424
1360266010,687393772,6,336,56,1360265983226,1360265996410,687366998,687380182,13184
1360266014,687397752,6,1299,216.5,1360265989519,1360265989775,687373271,687373527,256
1360266014,687398140,2,92,46,1360266010250,1360266010570,687394390,687394710,320
1360266014,687398140,6,498,83,1360266010250,1360266013642,687394390,687397782,3392
1360266018,687401724,1,137,137,1360265992937,1360265992937,687376661,687376661,0
1360266026,687409628,3,624,208,1360265998602,1360265998730,687382230,687382358,128
1360266037,3620700480,14,784,56,1360266011700,1360266025140,3620675180,3620688620,13440
1360266038,687421640,15,1440,96,1360266011326,1360266028414,687394966,687412054,17088
1360266038,687421644,28,1568,56,1360266011640,1360266025720,687395284,687409364,14080
1360266038,687421660,14,784,56,1360266012010,1360266025514,687395670,687409174,13504
1360266038,687421664,14,784,56,1360266012452,1360266026020,687396116,687409684,13568
1360266038,687421716,28,1568,56,1360266011377,1360266025585,687395093,687409301,14208
1360266042,687425764,2,498,249,1360266016768,1360266016768,687400532,687400532,0
1360266054,687437684,1,137,137,1360266028435,1360266028435,687412119,687412119,0
1360266066,687449748,3,492,164,1360266038418,1360266038546,687422166,687422294,128
1360266069,3620732456,6,336,56,1360266044490,1360266049482,3620707946,3620712938,4992
1360266070,687453800,12,672,56,1360266044124,1360266050268,687427924,687434068,6144
1360266070,687453812,5,480,96,1360266045135,1360266049359,687428947,687433171,4224
1360266070,687453848,12,672,56,1360266042734,1360266049838,687426582,687433686,7104
1360266070,687453948,6,336,56,1360266044232,1360266049480,687428180,687433428,5248
1360266070,687453956,5,280,56,1360266044801,1360266049089,687428757,687433045,4288
1360266082,687465836,3,544,181.3333333,1360266056699,1360266056763,687440535,687440599,64
1360266086,687469696,1,137,137,1360266059525,1360266059525,687443221,687443221,0
1360266086,687470060,5364,7421386,1383.554437,1360265949722,1360266079066,687333782,687463126,129344
1360266102,687486036,3,144,48,1360266093681,1360266098737,687477717,687482773,5056
1360266106,687489780,6,1958,326.3333333,1360266078767,1360266093999,687462547,687477779,15232
1360266110,687494180,3,138,46,1360266104608,1360266104736,687488788,687488916,128
1360266118,687502040,1,137,137,1360266093483,1360266093483,687477523,687477523,0
1360266122,687505824,3,544,181.3333333,1360266096773,1360266096837,687480597,687480661,64
1360266133,3620796576,11,616,56,1360266107538,1360266119890,3620771114,3620783466,12352
1360266134,687517812,21,1176,56,1360266107407,1360266120591,687491219,687504403,13184
1360266134,687517840,11,616,56,1360266107573,1360266120181,687491413,687504021,12608
1360266134,687517912,11,616,56,1360266106860,1360266119980,687490772,687503892,13120
1360266134,687517916,11,1056,96,1360266107113,1360266119849,687491029,687503765,12736
1360266134,687517920,22,1232,56,1360266107429,1360266125541,687491349,687509461,18112
1360266150,687533944,1,137,137,1360266125580,1360266125580,687509524,687509524,0
1360266158,687542268,3,492,164,1360266133639,1360266133767,687517907,687518035,128
1360266162,687546184,15,840,56,1360266137754,1360266154138,687521938,687538322,16384
1360266162,687546232,3,544,181.3333333,1360266136363,1360266136427,687520595,687520659,64
1360266162,687546260,8,448,56,1360266137169,1360266153681,687521429,687537941,16512
1360266162,687546260,8,768,96,1360266137232,1360266153936,687521492,687538196,16704
1360266162,687546260,16,896,56,1360266137359,1360266154767,687521619,687539027,17408
1360266166,3620828888,8,448,56,1360266138692,1360266155076,3620801580,3620817964,16384
1360266166,687550368,8,448,56,1360266137699,1360266154147,687522067,687538515,16448
1360266190,687574524,1,137,137,1360266164617,1360266164617,687549141,687549141,0
1360266194,687578292,23,1288,56,1360266169329,1360266181809,687553621,687566101,12480
1360266194,687578292,12,672,56,1360266169518,1360266182382,687553810,687566674,12864
1360266194,687578368,24,1344,56,1360266168485,1360266181797,687552853,687566165,13312
1360266194,687578372,12,672,56,1360266168800,1360266181472,687553172,687565844,12672
1360266194,687578376,12,1152,96,1360266169180,1360266181596,687553556,687565972,12416
1360266198,3620860884,12,672,56,1360266170505,1360266183945,3620833389,3620846829,13440
1360266202,687586224,6,984,164,1360266173876,1360266174516,687558100,687558740,640
1360266202,687586272,2,498,249,1360266176452,1360266176452,687560724,687560724,0
1360266222,687606452,1,137,137,1360266196432,1360266196432,687580884,687580884,0
1360266223,687606560,17,952,56,1360266197577,1360266217609,687581137,687601169,20032
1360266226,3620888872,8,448,56,1360266200469,1360266217493,3620863341,3620880365,17024
1360266226,687610280,16,896,56,1360266198009,1360266216377,687582289,687600657,18368
1360266226,687610292,8,448,56,1360266198957,1360266214189,687583249,687598481,15232
1360266226,687610296,8,768,96,1360266199083,1360266214315,687583379,687598611,15232
1360266226,687610320,8,448,56,1360266199508,1360266216532,687583828,687600852,17024
1360266242,687626396,6,2049,341.5,1360266214085,1360266216645,687598481,687601041,2560
1360266243,687626464,3,544,181.3333333,1360266217259,1360266217323,687600723,687600787,64
1360266255,687638468,9,504,56,1360266228263,1360266238759,687611731,687622227,10496
1360266255,687638508,9,504,56,1360266229952,1360266239104,687613460,687622612,9152
1360266255,687638552,18,1008,56,1360266227987,1360266238867,687611539,687622419,10880
1360266255,687638584,9,864,96,1360266229488,1360266238704,687613072,687622288,9216
1360266255,687638588,17,952,56,1360266229678,1360266238766,687613266,687622354,9088
1360266258,3620920816,9,504,56,1360266230285,1360266239501,3620893101,3620902317,9216
1360266262,687646208,6,496,82.66666667,1360266252099,1360266254275,687636307,687638483,2176
1360266263,687646568,1,137,137,1360266235971,1360266235971,687619539,687619539,0
1360266275,687658456,4,656,164,1360266249328,1360266249776,687632784,687633232,448
1360266279,687662564,1,46,46,1360266252740,1360266252740,687636304,687636304,0
1360266282,687666388,4,224,56,1360266257806,1360266265806,687642194,687650194,8000
1360266283,687666432,3,544,181.3333333,1360266257289,1360266257353,687640721,687640785,64
1360266283,687666436,3,492,164,1360266257605,1360266257733,687641041,687641169,128
1360266287,687670444,4,224,56,1360266260925,1360266266813,687644369,687650257,5888
1360266287,687670452,2,112,56,1360266261430,1360266266486,687644882,687649938,5056
1360266287,687670456,2,192,96,1360266261745,1360266266673,687645201,687650129,4928
1360266290,3620952856,2,112,56,1360266265060,1360266267876,3620927916,3620930732,2816
1360266291,687674568,2,112,56,1360266264899,1360266267011,687648467,687650579,2112
1360266295,687678516,1,137,137,1360266267893,1360266267893,687651409,687651409,0
1360266302,687686308,2,98,49,1360266289948,1360266295004,687674256,687679312,5056
1360266302,687686308,3,144,48,1360266289951,1360266295007,687674259,687679315,5056
1360266315,687698708,7,1414,202,1360266289975,1360266290295,687673683,687674003,320
1360266318,3620980848,5,280,56,1360266293357,1360266304941,3620956205,3620967789,11584
1360266319,687702588,5,480,96,1360266292717,1360266297837,687676305,687681425,5120
1360266319,687702588,5,280,56,1360266293037,1360266298349,687676625,687681937,5312
1360266319,687702636,10,560,56,1360266291518,1360266297918,687675154,687681554,6400
1360266319,687702636,10,560,56,1360266291773,1360266298109,687675409,687681745,6336
1360266319,687702664,5,280,56,1360266292577,1360266297697,687676241,687681361,5120
1360266323,687706572,4,892,223,1360266297595,1360266298043,687681167,687681615,448
1360266323,687706648,6,1106,184.3333333,1360266297075,1360266297395,687680723,687681043,320
1360266331,687714712,1,137,137,1360266304690,1360266304690,687688402,687688402,0
1360266350,3621012892,5,280,56,1360266324479,1360266337599,3620987371,3621000491,13120
1360266351,687734580,11,616,56,1360266323445,1360266337909,687707025,687721489,14464
1360266351,687734612,5,280,56,1360266324244,1360266337172,687707856,687720784,12928
1360266351,687734668,11,616,56,1360266323293,1360266337565,687706961,687721233,14272
1360266351,687734672,5,280,56,1360266323610,1360266328794,687707282,687712466,5184
1360266351,687734672,5,480,96,1360266323737,1360266328985,687707409,687712657,5248
1360266363,687746632,1,137,137,1360266335682,1360266335682,687719314,687719314,0
1360266363,687746672,3,492,164,1360266337562,1360266337690,687721234,687721362,128
1360266363,687746748,4,590,147.5,1360266337036,1360266337100,687720784,687720848,64
1360266383,687766648,3,288,96,1360266356018,1360266360690,687739666,687744338,4672
1360266383,687766680,4,224,56,1360266357265,1360266360273,687740945,687743953,3008
1360266383,687766744,3,168,56,1360266355857,1360266360273,687739601,687744017,4416
1360266383,687766748,4,224,56,1360266356427,1360266359755,687740175,687743503,3328
1360266383,687766756,2,112,56,1360266357379,1360266359171,687741135,687742927,1792
1360266386,3621048992,1,56,56,1360266358428,1360266358428,3621021420,3621021420,0
1360266403,687786648,3,544,181.3333333,1360266377137,1360266377201,687760785,687760849,64
1360266403,687786652,3,492,164,1360266377962,1360266378090,687761614,687761742,128
1360266406,687790272,3,138,46,1360266405121,1360266405249,687789393,687789521,128
1360266407,687790604,1,137,137,1360266379676,1360266379676,687763280,687763280,0
1360266414,3621076880,3,168,56,1360266387981,1360266390925,3621050861,3621053805,2944
1360266415,687798620,6,336,56,1360266387403,1360266391947,687771023,687775567,4544
1360266415,687798624,3,168,56,1360266387720,1360266390600,687771344,687774224,2880
1360266415,687798704,6,336,56,1360266387448,1360266390904,687771152,687774608,3456
1360266415,687798708,2,112,56,1360266388210,1360266389298,687771918,687773006,1088
1360266415,687798732,2,192,96,1360266388316,1360266389468,687772048,687773200,1152
1360266422,687806320,13620,18598973,1365.563363,1360266105808,1360266420688,687490128,687805008,314880
1360266439,687822740,1,137,137,1360266412050,1360266412050,687795790,687795790,0
1360266443,687826772,3,544,181.3333333,1360266417012,1360266417076,687800784,687800848,64
1360266443,687826780,3,492,164,1360266417645,1360266417773,687801425,687801553,128
1360266475,687858796,1,137,137,1360266449306,1360266449306,687833102,687833102,0
1360266483,687866704,3,492,164,1360266457591,1360266457719,687841295,687841423,128
1360266498,3621161060,3,168,56,1360266473433,1360266476441,3621136493,3621139501,3008
1360266499,687882728,4,224,56,1360266472668,1360266476892,687856396,687860620,4224
1360266499,687882732,7,392,56,1360266472986,1360266477274,687856718,687861006,4288
1360266499,687882736,6,336,56,1360266473111,1360266476567,687856847,687860303,3456
1360266499,687882736,3,168,56,1360266473366,1360266476310,687857102,687860046,2944
1360266499,687882820,4,384,96,1360266472772,1360266476868,687856592,687860688,4096
1360266502,687886408,6,497,82.83333333,1360266492918,1360266495030,687877326,687879438,2112
1360266511,687894480,1274,1833367,1439.063579,1360266472596,1360266507028,687856076,687890508,34432
1360266511,687894784,1,137,137,1360266486629,1360266486629,687870413,687870413,0
1360266519,687902932,1,46,46,1360266493395,1360266493395,687877327,687877327,0
1360266523,687906752,3,492,164,1360266497412,1360266497540,687881164,687881292,128
1360266523,687906832,3,544,181.3333333,1360266497076,1360266497076,687880908,687880908,0
1360266555,687938804,1,137,137,1360266530451,1360266530451,687914255,687914255,0
1360266563,687946776,3,492,164,1360266537323,1360266537451,687921099,687921227,128
1360266563,687946864,3,544,181.3333333,1360266537109,1360266537173,687920973,687921037,64
1360266583,687966760,11,616,56,1360266558525,1360266568445,687942285,687952205,9920
1360266583,687966764,21,1176,56,1360266558714,1360266571194,687942478,687954958,12480
1360266583,687966808,21,1176,56,1360266558349,1360266568333,687942157,687952141,9984
1360266586,3621249044,10,560,56,1360266558700,1360266568940,3621221744,3621231984,10240
1360266587,687970760,10,960,96,1360266559100,1360266568252,687942860,687952012,9152
1360266587,687970836,10,560,56,1360266558896,1360266568112,687942732,687951948,9216
1360266599,687982440,9,432,48,1360266591678,1360266598270,687975118,687981710,6592
1360266599,687982572,5,236,47.2,1360266590648,1360266598008,687974220,687981580,7360
1360266599,687982836,1,137,137,1360266571184,1360266571184,687955020,687955020,0
1360266603,687986944,3,544,181.3333333,1360266577094,1360266577094,687961038,687961038,0
1360266603,687986944,2,446,223,1360266577094,1360266577222,687961038,687961166,128
1360266615,687998968,7,1220,174.2857143,1360266590062,1360266590894,687974030,687974862,832
1360266618,3621281068,10,560,56,1360266592788,1360266603028,3621255856,3621266096,10240
1360266619,688002860,21,1176,56,1360266592087,1360266603159,687975947,687987019,11072
1360266619,688002864,20,1120,56,1360266592277,1360266602837,687976141,687986701,10560
1360266619,688002864,10,560,56,1360266592532,1360266602644,687976396,687986508,10112
1360266619,688002968,10,560,56,1360266592045,1360266602093,687976013,687986061,10048
1360266619,688002968,10,960,96,1360266592109,1360266602221,687976077,687986189,10112
1360266639,688022964,1,137,137,1360266611950,1360266611950,687995914,687995914,0
1360266643,688026908,3,492,164,1360266617896,1360266618024,688001804,688001932,128
1360266643,688026980,3,544,181.3333333,1360266617121,1360266617185,688001101,688001165,64
1360266651,688034940,4,224,56,1360266626184,1360266630920,688010124,688014860,4736
1360266651,688035020,2,112,56,1360266625846,1360266630134,688009866,688014154,4288
1360266651,688035020,2,192,96,1360266625913,1360266630265,688009933,688014285,4352
1360266655,688038852,7,392,56,1360266627039,1360266654623,688010891,688038475,27584
1360266655,688038988,4,224,56,1360266629721,1360266654809,688013709,688038797,25088
1360266654,3621317352,3,168,56,1360266629750,1360266653814,3621293102,3621317166,24064
1360266675,688058900,1,137,137,1360266649584,1360266649584,688033484,688033484,0
1360266679,688062904,6,336,56,1360266653357,1360266658605,688037261,688042509,5248
1360266679,688062980,6,576,96,1360266653408,1360266658656,688037388,688042636,5248
1360266679,688062980,11,616,56,1360266653472,1360266658784,688037452,688042764,5312
1360266682,3621345300,4,224,56,1360266654953,1360266658153,3621318253,3621321453,3200
1360266683,688066868,8,448,56,1360266655184,1360266659024,688039052,688042892,3840
1360266683,688066876,4,224,56,1360266656198,1360266659526,688040074,688043402,3328
1360266683,688066916,5,938,187.6,1360266658079,1360266659103,688041995,688043019,1024
1360266683,688066996,4,1002,250.5,1360266657230,1360266657486,688041226,688041482,256
1360266711,688094652,3,138,46,1360266706856,1360266706920,688090508,688090572,64
1360266711,688094968,11,616,56,1360266686123,1360266698155,688070091,688082123,12032
1360266711,688094968,11,616,56,1360266686058,1360266697642,688070026,688081610,11584
1360266711,688094972,6,336,56,1360266686181,1360266698469,688070153,688082441,12288
1360266711,688094980,5,280,56,1360266686813,1360266694301,688070793,688078281,7488
1360266711,688095056,5,480,96,1360266686228,1360266693844,688070284,688077900,7616
1360266714,3621377316,6,336,56,1360266685978,1360266697370,3621349294,3621360686,11392
1360266719,688102952,1,137,137,1360266693690,1360266693690,688077642,688077642,0
1360266723,688107044,4,590,147.5,1360266697249,1360266697313,688081293,688081357,64
1360266723,688107048,3,492,164,1360266698074,1360266698202,688082122,688082250,128
1360266742,3621405328,12,672,56,1360266717329,1360266727953,3621380657,3621391281,10624
1360266743,688126648,6,499,83.16666667,1360266734634,1360266736810,688118282,688120458,2176
1360266743,688126980,22,1232,56,1360266717022,1360266729182,688101002,688113162,12160
1360266743,688126980,12,672,56,1360266717085,1360266727837,688101065,688111817,10752
1360266743,688126992,12,672,56,1360266717520,1360266729296,688101512,688113288,11776
1360266743,688127068,13,1248,96,1360266716744,1360266729544,688100812,688113612,12800
1360266743,688127068,24,1344,56,1360266716807,1360266728135,688100875,688112203,11328
1360266751,688134988,1,137,137,1360266725976,1360266725976,688109964,688109964,0
1360266755,688139048,4,656,164,1360266729180,1360266729372,688113228,688113420,192
1360266759,688143060,1,46,46,1360266734223,1360266734223,688118283,688118283,0
1360266763,688147064,3,544,181.3333333,1360266737354,1360266737354,688121418,688121418,0
1360266763,688147088,3,492,164,1360266738291,1360266738419,688122379,688122507,128
1360266775,688159020,17,952,56,1360266749560,1360266759672,688133580,688143692,10112
1360266775,688159060,6,336,56,1360266750733,1360266758797,688134793,688142857,8064
1360266775,688159104,16,896,56,1360266749539,1360266758563,688133643,688142667,9024
1360266775,688159128,8,448,56,1360266750025,1360266758153,688134153,688142281,8128
1360266778,3621441360,8,448,56,1360266750256,1360266758448,3621413616,3621421808,8192
1360266779,688163064,8,768,96,1360266751177,1360266759177,688135241,688143241,8000
1360266783,688166996,1,137,137,1360266758478,1360266758478,688142474,688142474,0
1360266803,688187048,3,492,164,1360266778010,1360266778138,688162058,688162186,128
1360266803,688187128,3,544,181.3333333,1360266777353,1360266777417,688161481,688161545,64
1360266810,3621473500,12,672,56,1360266783397,1360266809317,3621446897,3621472817,25920
1360266811,688195028,12,672,56,1360266783340,1360266796268,688167368,688180296,12928
1360266811,688195036,11,1056,96,1360266783844,1360266795876,688167880,688179912,12032
1360266811,688195108,25,1400,56,1360266783197,1360266809565,688167305,688193673,26368
1360266811,688195112,24,1344,56,1360266783448,1360266809368,688167560,688193480,25920
1360266811,688195116,12,672,56,1360266783639,1360266809943,688167755,688194059,26304
1360266828,688211416,1,137,137,1360266800976,1360266800976,688184392,688184392,0
1360266839,688223324,19,1824,96,1360266814598,1360266835910,688198922,688220234,21312
1360266839,688223396,33,1848,56,1360266814587,1360266837371,688198983,688221767,22784
1360266842,3621505712,19,1064,56,1360266815440,1360266837776,3621479152,3621501488,22336
1360266843,688227320,42,2352,56,1360266815115,1360266842315,688199435,688226635,27200
1360266843,688227320,18,1008,56,1360266815368,1360266841736,688199688,688226056,26368
1360266843,688227356,3,544,181.3333333,1360266817253,1360266817317,688201609,688201673,64
1360266843,688227364,18,1008,56,1360266817819,1360266842459,688202183,688226823,24640
1360266843,688227364,6,984,164,1360266818076,1360266818844,688202440,688203208,768
1360266847,688230616,5,230,46,1360266845642,1360266846218,688229258,688229834,576
1360266859,688243376,2,274,137,1360266833681,1360266835729,688218057,688220105,2048
1360266863,688246628,3,150,50,1360266850558,1360266857214,688234186,688240842,6656
1360266867,688251344,38,2128,56,1360266839281,1360266866673,688223625,688251017,27392
1360266867,688251352,19,1824,96,1360266840105,1360266865897,688224457,688250249,25792
1360266870,3621533744,19,1064,56,1360266842031,1360266869103,3621505775,3621532847,27072
1360266871,688255376,20,1120,56,1360266844687,1360266870159,688229063,688254535,25472
1360266872,688255456,44,2464,56,1360266845479,1360266871399,688228935,688254855,25920
1360266872,688255488,22,1232,56,1360266846152,1360266871496,688229640,688254984,25344
1360266883,688267388,8,1610,201.25,1360266857283,1360266858051,688241671,688242439,768
1360266883,688267396,5,938,187.6,1360266858043,1360266859259,688242439,688243655,1216
1360266895,688279360,41,2296,56,1360266867297,1360266894497,688251657,688278857,27200
1360266896,688279448,23,2208,96,1360266868145,1360266895281,688251593,688278729,27136
1360266898,3621561760,23,1288,56,1360266870369,1360266897249,3621534129,3621561009,26880
1360266899,688283356,46,2576,56,1360266870883,1360266898211,688255239,688282567,27328
1360266899,688283360,23,1288,56,1360266871073,1360266897825,688255433,688282185,26752
1360266899,688283364,21,1176,56,1360266871517,1360266898333,688255881,688282697,26816
1360266903,688287528,2,274,137,1360266877302,1360266879350,688261830,688263878,2048
1360266915,688299592,8,1067,133.375,1360266890359,1360266890807,688274951,688275399,448
1360266919,688303440,31,1736,56,1360266894799,1360266918799,688279239,688303239,24000
1360266922,3621585756,14,784,56,1360266897892,1360266920548,3621561648,3621584304,22656
1360266923,688307496,9,1656,184,1360266897302,1360266898070,688281798,688282566,768
1360266923,688307528,19,1824,96,1360266894905,1360266922553,688279433,688307081,27648
1360266927,688311424,35,1960,56,1360266898912,1360266926496,688283336,688310920,27584
1360266927,688311432,20,1120,56,1360266899094,1360266926550,688283526,688310982,27456
1360266927,688311436,2,446,223,1360266899348,1360266899604,688283784,688284040,256
1360266927,688311552,19,1064,56,1360266899938,1360266926754,688284490,688311306,26816
1360266935,688318656,13343,18732748,1403.938245,1360266558177,1360266934305,687941833,688317961,376128
1360266943,688327428,1,137,137,1360266915355,1360266915355,688299783,688299783,0
1360266947,688331416,52,2912,56,1360266919209,1360266946537,688303625,688330953,27328
1360266950,3621613752,26,1456,56,1360266922279,1360266947175,3621586031,3621610927,24896
1360266951,688335428,26,2496,96,1360266923420,1360266947484,688307848,688331912,24064
1360266955,688339428,25,1400,56,1360266927388,1360266953820,688311816,688338248,26432
1360266955,688339436,26,1456,56,1360266927829,1360266954261,688312265,688338697,26432
1360266955,688339508,53,2968,56,1360266927179,1360266954699,688311687,688339207,27520
1360266959,688342780,2,98,49,1360266945123,1360266951267,688328903,688335047,6144
1360266960,688343444,2,92,46,1360266935796,1360266935796,688319240,688319240,0
1360266964,688347484,6,700,116.6666667,1360266938443,1360266938763,688321927,688322247,320
1360266968,688351472,3,492,164,1360266940760,1360266940888,688324232,688324360,128
1360266972,688355876,31,1736,56,1360266947397,1360266964357,688331273,688348233,16960
1360266975,688358716,2667,3708588,1390.546682,1360266846946,1360266972770,688230662,688356486,125824
1360266976,688359832,1,137,137,1360266949421,1360266949421,688333253,688333253,0
1360266978,3621641764,19,1064,56,1360266950877,1360266977693,3621614641,3621641457,26816
1360266980,688363700,19,1824,96,1360266952051,1360266979507,688335751,688363207,27456
1360266980,688363776,13,728,56,1360266955624,1360266978856,688339400,688362632,23232
1360266980,688363776,28,1568,56,1360266955750,1360266979622,688339526,688363398,23872
1360266984,688367708,16,896,56,1360266956009,1360266982761,688339717,688366469,26752
1360267000,688383764,45,2520,56,1360266972786,1360266995698,688356550,688379462,22912
1360267004,688387768,5,670,134,1360266978479,1360266979055,688362247,688362823,576
1360267007,3621669820,17,952,56,1360266979340,1360266996620,3621642160,3621659440,17280
1360267008,688391724,6,984,164,1360266980313,1360266981465,688364037,688365189,1152
1360267008,688391764,29,1624,56,1360266981682,1360266995826,688365446,688379590,14144
1360267008,688391808,14,1344,96,1360266980103,1360266995591,688363911,688379399,15488
1360267008,688391832,16,896,56,1360266980525,1360266995821,688364357,688379653,15296
1360267012,688395724,13,728,56,1360266984476,1360267010908,688368200,688394632,26432
1360267015,688398760,5,230,46,1360267007349,1360267008757,688391109,688392517,1408
1360267016,688399728,1,137,137,1360266987925,1360266987925,688371653,688371653,0
1360267036,688419780,22,1232,56,1360267011811,1360267032419,688395591,688416199,20608
1360267036,688419832,21,1176,56,1360267010352,1360267031664,688394184,688415496,21312
1360267036,688419880,45,2520,56,1360267009343,1360267032255,688393223,688416135,22912
1360267036,688419880,43,2408,56,1360267009150,1360267032766,688393030,688416646,23616
1360267036,688419908,23,2208,96,1360267009507,1360267032355,688393415,688416263,22848
1360267038,3621701764,25,1400,56,1360267009951,1360267037407,3621673715,3621701171,27456
1360267044,688427860,6,1112,185.3333333,1360267018450,1360267020434,688402310,688404294,1984
1360267048,688431860,7,1036,148,1360267021009,1360267022929,688404869,688406789,1920
1360267052,688435800,1,137,137,1360267023949,1360267023949,688407749,688407749,0
1360267064,688447816,51,2856,56,1360267036093,1360267063677,688419909,688447493,27584
1360267064,688447824,41,2296,56,1360267036404,1360267063604,688420228,688447428,27200
1360267064,688447900,24,1344,56,1360267036139,1360267063659,688420039,688447559,27520
1360267064,688447928,25,1400,56,1360267036495,1360267063247,688420423,688447175,26752
1360267064,688447944,21,2016,96,1360267037503,1360267062655,688421447,688446599,25152
1360267066,3621729788,21,1176,56,1360267039303,1360267064455,3621703091,3621728243,25152
1360267080,688463976,1,137,137,1360267053918,1360267053918,688437894,688437894,0
1360267084,688467852,4,596,149,1360267058392,1360267058712,688442244,688442564,320
1360267088,688471996,5,590,118,1360267062216,1360267063560,688446212,688447556,1344
1360267092,688475836,49,2744,56,1360267064167,1360267091623,688448003,688475459,27456
1360267092,688475840,24,2304,96,1360267064612,1360267091364,688448452,688475204,26752
1360267092,688475916,52,2912,56,1360267063962,1360267091418,688447878,688475334,27456
1360267092,688475920,27,1512,56,1360267064215,1360267091159,688448135,688475079,26944
1360267092,688475924,27,1512,56,1360267064848,1360267091600,688448772,688475524,26752
1360267094,3621757764,27,1512,56,1360267066205,1360267093597,3621729969,3621757361,27392
1360267095,688478816,2,92,46,1360267094331,1360267094715,688478147,688478531,384
1360267103,688486728,3,144,48,1360267090390,1360267097110,688474118,688480838,6720
1360267103,688486728,3,150,50,1360267090581,1360267097365,688474309,688481093,6784
1360267103,688486728,4,202,50.5,1360267090645,1360267097365,688474373,688481093,6720
1360267103,688486728,4,202,50.5,1360267090709,1360267097365,688474437,688481093,6656
1360267103,688486728,4,202,50.5,1360267090709,1360267097365,688474437,688481093,6656
1360267103,688486728,6,294,49,1360267090709,1360267097685,688474437,688481413,6976
1360267103,688486740,30,25588,852.9333333,1360267094411,1360267101707,688478151,688485447,7296
1360267103,688486808,4,202,50.5,1360267090630,1360267097286,688474438,688481094,6656
1360267103,688486808,2,98,49,1360267090310,1360267096326,688474118,688480134,6016
1360267103,688486808,4,196,49,1360267090310,1360267097542,688474118,688481350,7232
1360267103,688486808,3,144,48,1360267090310,1360267097030,688474118,688480838,6720
1360267103,688486812,5,248,49.6,1360267090627,1360267097603,688474439,688481415,6976
1360267103,688486812,4,202,50.5,1360267090627,1360267097283,688474439,688481095,6656
1360267111,688494704,6,300,50,1360267100590,1360267109806,688484294,688493510,9216
1360267111,688494704,4,196,49,1360267096622,1360267103406,688480326,688487110,6784
1360267111,688494784,6,288,48,1360267097499,1360267105755,688481283,688489539,8256
1360267116,688499848,11,9896,899.6363636,1360267089949,1360267091165,688473797,688475013,1216
1360267116,688499904,1,137,137,1360267088422,1360267088422,688472326,688472326,0
1360267116,688499940,11,12431,1130.090909,1360267089857,1360267090177,688473797,688474117,320
1360267116,688499940,23,19053,828.3913043,1360267089857,1360267105217,688473797,688489157,15360
1360267116,688499940,12,2858,238.1666667,1360267089857,1360267107649,688473797,688491589,17792
1360267116,688499944,4,804,201,1360267089854,1360267090878,688473798,688474822,1024
1360267116,688499944,5,600,120,1360267090173,1360267092989,688474117,688476933,2816
1360267119,688502716,5,254,50.8,1360267105505,1360267112609,688489221,688496325,7104
1360267119,688502716,5,248,49.6,1360267105505,1360267113185,688489221,688496901,7680
1360267119,688502744,5,248,49.6,1360267105799,1360267113927,688489543,688497671,8128
1360267119,688502744,5,248,49.6,1360267105799,1360267113607,688489543,688497351,7808
1360267119,688502744,5,248,49.6,1360267106054,1360267113798,688489798,688497542,7744
1360267119,688502744,6,294,49,1360267106052,1360267113924,688489796,688497668,7872
1360267119,688502756,5,248,49.6,1360267114871,1360267118519,688498627,688502275,3648
1360267119,688502776,4,202,50.5,1360267115815,1360267117863,688499591,688501639,2048
1360267119,688502788,4,202,50.5,1360267105175,1360267111511,688488963,688495299,6336
1360267119,688502792,5,254,50.8,1360267105430,1360267112534,688489222,688496326,7104
1360267120,688503812,47,2632,56,1360267092097,1360267119745,688475909,688503557,27648
1360267120,688503816,49,2744,56,1360267092222,1360267119742,688476038,688503558,27520
1360267120,688503816,1,46,46,1360267095355,1360267095355,688479171,688479171,0
1360267120,688503820,22,2112,96,1360267092408,1360267118136,688476228,688501956,25728
1360267120,688503896,24,1344,56,1360267092205,1360267118701,688476101,688502597,26496
1360267120,688503932,26,1456,56,1360267092618,1360267119242,688476550,688503174,26624
1360267123,3621785840,25,1400,56,1360267095224,1360267121720,3621758064,3621784560,26496
1360267124,688507860,7,1546,220.8571429,1360267098512,1360267105808,688482372,688489668,7296
1360267128,688512144,7,1390,198.5714286,1360267103414,1360267106102,688487558,688490246,2688
1360267132,688515828,2,92,46,1360267104175,1360267104239,688488003,688488067,64
1360267132,688515924,9,1884,209.3333333,1360267105042,1360267125010,688488966,688508934,19968
1360267132,688515924,5,648,129.6,1360267105041,1360267106065,688488965,688489989,1024
1360267135,688518700,4,190,47.5,1360267124079,1360267132207,688507779,688515907,8128
1360267135,688518708,3,144,48,1360267128553,1360267128617,688512261,688512325,64
1360267135,688518752,3,144,48,1360267131133,1360267131197,688514885,688514949,64
1360267135,688518756,4,196,49,1360267123257,1360267130809,688507013,688514565,7552
1360267135,688518780,3,144,48,1360267124256,1360267132128,688508036,688515908,7872
1360267135,688518836,6580,9279711,1410.290426,1360266941799,1360267134439,688325635,688518275,192640
1360267135,688518840,3,144,48,1360267123428,1360267131684,688507268,688515524,8256
1360267136,688519844,10,2657,265.7,1360267108128,1360267109792,688491972,688493636,1664
1360267136,688519952,8,587,73.375,1360267111475,1360267112563,688495427,688496515,1088
1360267136,688519956,9,639,71,1360267111474,1360267113074,688495430,688497030,1600
1360267140,688523916,7,535,76.42857143,1360267112218,1360267113306,688496134,688497222,1088
1360267140,688523916,10,3052,305.2,1360267112218,1360267113626,688496134,688497542,1408
1360267144,688527908,12,3182,265.1666667,1360267117730,1360267127842,688501638,688511750,10112
1360267144,688527932,18,1008,56,1360267119817,1360267143561,688503749,688527493,23744
1360267144,688528020,13,3208,246.7692308,1360267117872,1360267126256,688501892,688510276,8384
1360267148,688531864,9,2836,315.1111111,1360267120012,1360267125516,688503876,688509380,5504
1360267148,688531864,18,1728,96,1360267120012,1360267146892,688503876,688530756,26880
1360267148,688531868,35,1960,56,1360267120138,1360267147338,688504006,688531206,27200
1360267148,688531868,39,2184,56,1360267120265,1360267147593,688504133,688531461,27328
1360267148,688531872,17,952,56,1360267120454,1360267147142,688504326,688531014,26688
1360267148,688531948,4,503,125.75,1360267123639,1360267126007,688507587,688509955,2368
1360267148,688531956,1,46,46,1360267120050,1360267120050,688504006,688504006,0
1360267148,688532032,1,46,46,1360267123302,1360267123302,688507334,688507334,0
1360267151,3621813824,18,1008,56,1360267125193,1360267150729,3621788017,3621813553,25536
1360267152,688536036,19,8113,427,1360267126178,1360267128098,688510214,688512134,1920
1360267156,688539880,9,3235,359.4444444,1360267128379,1360267128507,688512259,688512387,128
1360267156,688539924,1,137,137,1360267130446,1360267130446,688514370,688514370,0
1360267156,688540036,8,601,75.125,1360267130911,1360267131231,688514947,688515267,320
1360267156,688540036,31,16469,531.2580645,1360267130912,1360267132384,688514948,688516420,1472
1360267164,688548028,4,608,152,1360267138600,1360267140072,688522628,688524100,1472
1360267172,688555916,16,896,56,1360267144600,1360267169624,688528516,688553540,25024
1360267172,688556000,3,492,164,1360267145091,1360267145859,688529091,688529859,768
1360267176,688559940,28,1568,56,1360267148094,1360267169086,688532034,688553026,20992
1360267176,688559948,15,840,56,1360267148218,1360267169210,688532166,688553158,20992
1360267176,688560024,15,1440,96,1360267147820,1360267169708,688531844,688553732,21888
1360267176,688560024,28,1568,56,1360267147946,1360267169770,688531970,688553794,21824
1360267179,3621842044,14,784,56,1360267151406,1360267178222,3621814450,3621841266,26816
1360267180,688564076,3,169,56.33333333,1360267154167,1360267154231,688538243,688538307,64
1360267184,688567952,4,252,63,1360267156275,1360267157043,688540227,688540995,768
1360267184,688567988,2,123,61.5,1360267157265,1360267157265,688541253,688541253,0
1360267184,688567988,3,169,56.33333333,1360267157265,1360267157329,688541253,688541317,64
1360267184,688568016,3,169,56.33333333,1360267158196,1360267158260,688542212,688542276,64
1360267199,688582768,3,144,48,1360267192235,1360267197611,688576003,688581379,5376
1360267199,688582856,3,144,48,1360267192148,1360267197588,688576004,688581444,5440
1360267204,688587968,11,616,56,1360267176035,1360267201187,688560003,688585155,25152
1360267204,688587968,3,181,60.33333333,1360267176035,1360267176035,688560003,688560003,0
1360267204,688587980,5,480,96,1360267177238,1360267199254,688561218,688583234,22016
1360267204,688588052,5,280,56,1360267175953,1360267187025,688560005,688571077,11072
1360267204,688588052,2,123,61.5,1360267176080,1360267176144,688560132,688560196,64
1360267204,688588052,3,181,60.33333333,1360267176143,1360267176207,688560195,688560259,64
1360267204,688588052,10,560,56,1360267176270,1360267200270,688560322,688584322,24000
1360267204,688588056,4,224,56,1360267176523,1360267197323,688560579,688581379,20800
1360267204,688588064,3,169,56.33333333,1360267177220,1360267177220,688561284,688561284,0
1360267204,688588092,2,498,249,1360267178343,1360267178343,688562435,688562435,0
1360267208,688592056,1,137,137,1360267182605,1360267182605,688566661,688566661,0
1360267211,3621873988,6,336,56,1360267183014,1360267210726,3621846002,3621873714,27712
1360267212,688596164,6,984,164,1360267185248,1360267192736,688569412,688576900,7488
1360267216,688600100,13,3424,263.3846154,1360267191262,1360267210078,688575362,688594178,18816
1360267216,688600104,3,169,56.33333333,1360267191387,1360267191451,688575491,688575555,64
1360267223,688606892,3,150,50,1360267215665,1360267222001,688599557,688605893,6336
1360267224,688608084,2,123,61.5,1360267199150,1360267199214,688583234,688583298,64
1360267224,688608088,3,169,56.33333333,1360267196333,1360267196397,688580421,688580485,64
1360267228,688612016,3,169,56.33333333,1360267201203,1360267201267,688585219,688585283,64
1360267228,688612160,2,129,64.5,1360267202785,1360267202785,688586945,688586945,0
1360267228,688612164,2,129,64.5,1360267202783,1360267202783,688586947,688586947,0
1360267228,688612168,2,123,61.5,1360267203037,1360267203101,688587205,688587269,64
1360267231,688614828,3,144,48,1360267217519,1360267223151,688601347,688606979,5632
1360267231,688614828,3,144,48,1360267217583,1360267223727,688601411,688607555,6144
1360267232,688616012,22,1232,56,1360267207094,1360267224054,688591106,688608066,16960
1360267232,688616016,22,1232,56,1360267207155,1360267226227,688591171,688610243,19072
1360267232,688616020,9,504,56,1360267207277,1360267223533,688591297,688607553,16256
1360267232,688616044,1,46,46,1360267207448,1360267207448,688591492,688591492,0
1360267232,688616048,1,46,46,1360267207445,1360267207445,688591493,688591493,0
1360267232,688616168,12,672,56,1360267206172,1360267226844,688590340,688611012,20672
1360267236,688620000,2,92,46,1360267208387,1360267208387,688592387,688592387,0
1360267236,688620012,2,92,46,1360267209336,1360267209336,688593348,688593348,0
1360267236,688620076,12,1152,96,1360267207990,1360267234934,688592066,688619010,26944
1360267239,3621901988,13,728,56,1360267211557,1360267237989,3621874545,3621900977,26432
1360267240,688624132,4,1540,385,1360267215167,1360267216319,688599299,688600451,1152
1360267244,688628048,3,544,181.3333333,1360267218449,1360267218513,688602497,688602561,64
1360267244,688628076,18,10453,580.7222222,1360267216437,1360267217589,688600513,688601665,1152
1360267247,688630900,4,280,70,1360267246311,1360267246567,688630211,688630467,256
1360267247,688630928,4,280,70,1360267244299,1360267244747,688628227,688628675,448
1360267248,688632032,1,77,77,1360267220195,1360267220195,688604227,688604227,0
1360267248,688632072,1,77,77,1360267221179,1360267221179,688605251,688605251,0
1360267248,688632100,2,92,46,1360267223773,1360267223837,688607873,688607937,64
1360267248,688632112,2,123,61.5,1360267220115,1360267220115,688604227,688604227,0
1360267248,688632188,2,123,61.5,1360267222024,1360267222088,688606212,688606276,64
1360267252,688636064,1,137,137,1360267224068,1360267224068,688608132,688608132,0
1360267252,688636272,3,492,164,1360267225843,1360267226035,688610115,688610307,192
1360267255,688638848,8,464,58,1360267248412,1360267249500,688632260,688633348,1088
1360267255,688638924,5,230,46,1360267248078,1360267248398,688632002,688632322,320
1360267255,688638932,9,510,56.66666667,1360267247304,1360267248840,688631236,688632772,1536
1360267255,688638932,10,556,55.6,1360267247303,1360267248967,688631235,688632899,1664
1360267255,688638932,4,184,46,1360267247493,1360267248005,688631425,688631937,512
1360267260,688644080,39,2184,56,1360267233266,1360267259506,688617346,688643586,26240
1360267260,688644080,39,2184,56,1360267233201,1360267259441,688617281,688643521,26240
1360267260,688644100,17,952,56,1360267233502,1360267259614,688617602,688643714,26112
1360267260,688644108,19,1064,56,1360267234519,1360267259031,688618627,688643139,24512
1360267264,688648156,18,1728,96,1360267235816,1360267261288,688619972,688645444,25472
1360267264,688648160,2,123,61.5,1360267236067,1360267236899,688620227,688621059,832
1360267267,3621930028,22,1232,56,1360267238973,1360267266365,3621902001,3621929393,27392
1360267268,688652076,2,129,64.5,1360267241142,1360267242486,688625218,688626562,1344
1360267268,688652100,1,46,46,1360267241821,1360267241821,688625921,688625921,0
1360267268,688652156,2,92,46,1360267240808,1360267241704,688624964,688625860,896
1360267271,688654848,11,686,62.36363636,1360267265435,1360267265691,688649283,688649539,256
1360267271,688654852,9,516,57.33333333,1360267265684,1360267265940,688649536,688649792,256
1360267271,688654876,5,248,49.6,1360267261884,1360267269436,688645760,688653312,7552
1360267271,688654880,17,1102,64.82352941,1360267267385,1360267269433,688651265,688653313,2048
1360267271,688654964,6,366,61,1360267266277,1360267266341,688650241,688650305,64
1360267271,688654996,4,196,49,1360267262020,1360267269636,688646016,688653632,7616
1360267276,688660152,2,92,46,1360267249065,1360267249257,688633217,688633409,192
1360267284,688668120,1,137,137,1360267259147,1360267259147,688643267,688643267,0
1360267284,688668148,43,2408,56,1360267259824,1360267283312,688643972,688667460,23488
1360267284,688668192,3,550,183.3333333,1360267258433,1360267258689,688642625,688642881,256
1360267288,688672188,47,2632,56,1360267259910,1360267285894,688644098,688670082,25984
1360267288,688672192,25,1400,56,1360267260035,1360267285635,688644227,688669827,25600
1360267288,688672200,26,1456,56,1360267260347,1360267286011,688644547,688670211,25664
1360267292,688676060,21,2016,96,1360267264200,1360267286600,688648260,688670660,22400
1360267292,688676100,4,538,134.5,1360267266654,1360267267614,688650754,688651714,960
1360267295,3621958040,22,1232,56,1360267267379,1360267294323,3621930419,3621957363,26944
1360267295,688678840,8,458,57.25,1360267288610,1360267288674,688672450,688672514,64
1360267295,688678920,9,504,56,1360267287313,1360267287377,688671233,688671297,64
1360267312,688696188,39,2184,56,1360267284104,1360267311496,688668292,688695684,27392
1360267316,688700108,38,2128,56,1360267288342,1360267312278,688672450,688696386,23936
1360267316,688700192,19,1064,56,1360267288385,1360267312385,688672577,688696577,24000
1360267319,3621982220,19,1064,56,1360267294847,1360267312895,3621958067,3621976115,18048
1360267320,688704248,19,1064,56,1360267293258,1360267311754,688677506,688696002,18496
1360267320,688704248,20,1920,96,1360267293321,1360267311817,688677569,688696065,18496
1360267324,688708240,5,1048,209.6,1360267298448,1360267299216,688682688,688683456,768
1360267327,688710928,4,184,46,1360267325450,1360267326154,688709378,688710082,704
1360267332,688716192,1,137,137,1360267303875,1360267303875,688688067,688688067,0
1360267332,688716264,4,538,134.5,1360267307065,1360267307833,688691329,688692097,768
1360267335,688718860,2,92,46,1360267332492,1360267334540,688716352,688718400,2048
1360267340,688724108,25,1400,56,1360267312084,1360267339604,688696192,688723712,27520
1360267351,688734864,6,499,83.16666667,1360267345610,1360267348618,688729474,688732482,3008
1360267351,3622014296,13,728,56,1360267325812,1360267343732,3621989108,3622007028,17920
1360267352,688736172,29,1624,56,1360267324886,1360267347862,688709058,688732034,22976
1360267352,688736180,15,840,56,1360267325454,1360267348238,688709634,688732418,22784
1360267352,688736220,1,46,46,1360267326627,1360267326627,688710847,688710847,0
1360267352,688736260,16,896,56,1360267324860,1360267345276,688709120,688729536,20416
1360267352,688736268,16,1536,96,1360267325044,1360267345524,688709312,688729792,20480
1360267360,688744296,2,92,46,1360267333015,1360267333591,688717311,688717887,576
1360267364,688748328,4,608,152,1360267338743,1360267339319,688723071,688723647,576
1360267368,688752284,1,137,137,1360267340389,1360267340389,688724673,688724673,0
1360267368,688752336,23,1288,56,1360267341681,1360267367153,688726017,688751489,25472
1360267372,688756216,3,492,164,1360267346985,1360267347113,688731201,688731329,128
1360267372,688756264,1,46,46,1360267345208,1360267345208,688729472,688729472,0
1360267383,3622046284,22,1232,56,1360267358271,1360267382399,3622021555,3622045683,24128
1360267384,688768152,21,1176,56,1360267358761,1360267383465,688742913,688767617,24704
1360267384,688768236,44,2464,56,1360267358165,1360267383573,688742401,688767809,25408
1360267384,688768240,23,1288,56,1360267358223,1360267383695,688742463,688767935,25472
1360267384,688768240,22,2112,96,1360267358287,1360267383119,688742527,688767359,24832
1360267396,688780168,44,2464,56,1360267367961,1360267395801,688752129,688779969,27840
1360267399,688782876,3,144,48,1360267391357,1360267397373,688775233,688781249,6016
1360267403,3622066556,7,334,47.71428571,1360267395184,1360267401840,3622058740,3622065396,6656
1360267403,3622066572,9,432,48,1360267393886,1360267401118,3622057458,3622064690,7232
1360267404,688788236,1,137,137,1360267379412,1360267379412,688763648,688763648,0
1360267404,688788292,5,662,132.4,1360267378651,1360267380059,688762943,688764351,1408
1360267407,688790920,3,144,48,1360267394830,1360267401358,688778750,688785278,6528
1360267407,688790924,7,328,46.85714286,1360267395469,1360267402253,688779393,688786177,6784
1360267407,688790924,6,282,47,1360267395468,1360267402124,688779392,688786048,6656
1360267407,688790924,7,334,47.71428571,1360267395468,1360267402188,688779392,688786112,6720
1360267407,688791000,3,144,48,1360267394752,1360267401664,688778752,688785664,6912
1360267407,688791004,6,282,47,1360267395390,1360267402174,688779394,688786178,6784
1360267407,688791032,4,190,47.5,1360267395362,1360267401570,688779394,688785602,6208
1360267407,688791032,6,282,47,1360267395362,1360267402146,688779394,688786178,6784
1360267411,3622074272,22,1232,56,1360267383115,1360267410251,3622046387,3622073523,27136
1360267412,688796180,23,2208,96,1360267383947,1360267411147,688768127,688795327,27200
1360267412,688796188,22,1232,56,1360267384262,1360267410694,688768450,688794882,26432
1360267412,688796264,46,2576,56,1360267383992,1360267411256,688768256,688795520,27264
1360267412,688796272,23,1288,56,1360267384815,1360267411183,688769087,688795455,26368
1360267412,688796312,4,538,134.5,1360267386696,1360267387144,688771008,688771456,448
1360267416,688800312,38,38388,1010.210526,1360267390857,1360267394569,688775169,688778881,3712
1360267419,3622082308,19,15754,829.1578947,1360267394537,1360267395625,3622057845,3622058933,1088
1360267420,688804276,20,23771,1188.55,1360267394222,1360267395822,688778498,688780098,1600
1360267420,688804276,41,47694,1163.268293,1360267394222,1360267396142,688778498,688780418,1920
1360267420,688804276,5,3109,621.8,1360267394221,1360267394925,688778497,688779201,704
1360267420,688804276,5,2437,487.4,1360267394221,1360267395053,688778497,688779329,832
1360267420,688804276,6,3258,543,1360267394221,1360267395181,688778497,688779457,960
1360267420,688804368,6,3406,567.6666667,1360267394064,1360267394640,688778432,688779008,576
1360267420,688804368,5,2980,596,1360267394128,1360267394832,688778496,688779200,704
1360267420,688804384,5,2868,573.6,1360267394112,1360267395008,688778496,688779392,896
1360267420,688804384,6,3460,576.6666667,1360267394046,1360267394686,688778430,688779070,640
1360267424,688808112,629,901119,1432.621622,1360267096207,1360267123663,688480319,688507775,27456
1360267424,688808272,30,1680,56,1360267397424,1360267422640,688781696,688806912,25216
1360267432,688816320,1,46,46,1360267406527,1360267406527,688790847,688790847,0
1360267432,688816364,1,46,46,1360267407638,1360267407638,688792002,688792002,0
1360267436,688820320,21,1176,56,1360267411774,1360267435582,688796094,688819902,23808
1360267436,688820372,1,46,46,1360267410444,1360267410444,688794816,688794816,0
1360267437,688820480,1,46,46,1360267411975,1360267411975,688795455,688795455,0
1360267439,3622102268,12,672,56,1360267411088,1360267437392,3622074356,3622100660,26304
1360267439,688822888,2,98,49,1360267436336,1360267436464,688820224,688820352,128
1360267439,688822896,4,196,49,1360267432937,1360267434473,688816833,688818369,1536
1360267439,688822944,3,144,48,1360267435641,1360267436281,688819585,688820225,640
1360267440,688824236,13,728,56,1360267412052,1360267437972,688796288,688822208,25920
1360267440,688824236,13,1248,96,1360267412178,1360267438354,688796414,688822590,26176
1360267440,688824320,1,46,46,1360267411903,1360267411903,688796223,688796223,0
1360267440,688824392,11,616,56,1360267413240,1360267438776,688797632,688823168,25536
1360267444,688828300,4,590,147.5,1360267418707,1360267418771,688803007,688803071,64
1360267444,688828400,1,137,137,1360267418481,1360267418481,688802881,688802881,0
1360267452,688836232,35,1960,56,1360267424153,1360267449945,688808385,688834177,25792
1360267452,688836348,3,138,46,1360267425061,1360267425061,688809409,688809409,0
1360267452,688836388,2,446,223,1360267426746,1360267426874,688811134,688811262,128
1360267460,688844316,3,138,46,1360267434052,1360267434500,688818368,688818816,448
1360267460,688844328,3,138,46,1360267435065,1360267435321,688819393,688819649,256
1360267460,688844328,2,92,46,1360267435065,1360267435321,688819393,688819649,256
1360267461,688844440,2,92,46,1360267434926,1360267435438,688818366,688818878,512
1360267461,688844448,2,92,46,1360267435943,1360267436199,688819391,688819647,256
1360267464,688848260,37,2072,56,1360267436411,1360267463803,688820671,688848063,27392
1360267464,688848388,15,840,56,1360267439738,1360267463290,688824126,688847678,23552
1360267467,3622130316,19,1064,56,1360267439392,1360267466272,3622102708,3622129588,26880
1360267468,688852352,19,1824,96,1360267439839,1360267467167,688824191,688851519,27328
1360267468,688852360,21,1176,56,1360267440598,1360267467606,688824958,688851966,27008
1360267477,688860588,18,3372,187.3333333,1360267450524,1360267458844,688834112,688842432,8320
1360267481,688864604,41,2296,56,1360267454861,1360267477773,688838465,688861377,22912
1360267485,688868600,1,137,137,1360267460558,1360267460558,688844158,688844158,0
1360267485,688868656,3,544,181.3333333,1360267459477,1360267459477,688843133,688843133,0
1360267489,688872440,137,154775,1129.744526,1360267106417,1360267185393,688489857,688568833,78976
1360267493,688876568,37,2072,56,1360267465071,1360267492399,688848639,688875967,27328
1360267493,688876568,16,896,56,1360267465198,1360267492462,688848766,688876030,27264
1360267493,688876616,4,538,134.5,1360267467902,1360267468990,688851518,688852606,1088
1360267495,3622158300,18,1008,56,1360267467314,1360267494834,3622130614,3622158134,27520
1360267497,688880588,16,1536,96,1360267469276,1360267496156,688852864,688879744,26880
1360267497,688880624,17,952,56,1360267469816,1360267496440,688853440,688880064,26624
1360267503,688886960,3,144,48,1360267494053,1360267500453,688878013,688884413,6400
1360267503,688887040,2,98,49,1360267493720,1360267500376,688877760,688884416,6656
1360267503,688887040,2,98,49,1360267493720,1360267499352,688877760,688883392,5632
1360267503,688887044,3,144,48,1360267493973,1360267500437,688878017,688884481,6464
1360267511,688894952,3,138,46,1360267510447,1360267510511,688894399,688894463,64
1360267513,688896724,37,2072,56,1360267485586,1360267510674,688869310,688894398,25088
1360267517,688900720,12,2851,237.5833333,1360267492055,1360267493271,688875775,688876991,1216
1360267519,688902916,3,138,46,1360267511508,1360267511572,688895424,688895488,64
1360267519,688902948,3,138,46,1360267512500,1360267512500,688896448,688896448,0
1360267521,688904608,30,1680,56,1360267492933,1360267520069,688876541,688903677,27136
1360267521,688904620,15,840,56,1360267493435,1360267519611,688877055,688903231,26176
1360267523,3622186272,14,784,56,1360267496334,1360267521550,3622159606,3622184822,25216
1360267525,688908608,15,1440,96,1360267497093,1360267523589,688880701,688907197,26496
1360267525,688908612,13,728,56,1360267497410,1360267522754,688881022,688906366,25344
1360267525,688908620,1,137,137,1360267497915,1360267497915,688881535,688881535,0
1360267525,688908740,2,498,249,1360267499457,1360267499457,688883197,688883197,0
1360267529,688912736,11,666,60.54545455,1360267503688,1360267505864,688887424,688889600,2176
1360267533,688916812,3,492,164,1360267508475,1360267508603,688892287,688892415,128
1360267539,3622202564,2,92,46,1360267511208,1360267511272,3622174772,3622174836,64
1360267545,688928676,34,1904,56,1360267518082,1360267540290,688901758,688923966,22208
1360267547,3622210540,13,728,56,1360267522688,1360267539136,3622186228,3622202676,16448
1360267549,688932644,15,840,56,1360267520994,1360267540130,688904638,688923774,19136
1360267549,688932696,1,46,46,1360267523501,1360267523501,688907197,688907197,0
1360267549,688932724,29,1624,56,1360267520849,1360267540625,688904573,688924349,19776
1360267549,688932760,1,46,46,1360267521581,1360267521581,688905341,688905341,0
1360267549,688932768,1,46,46,1360267522276,1360267522276,688906044,688906044,0
1360267553,688936676,14,784,56,1360267526083,1360267551875,688909759,688935551,25792
1360267553,688936720,12,1152,96,1360267527638,1360267551446,688911358,688935166,23808
1360267557,688940680,1,137,137,1360267531455,1360267531455,688915135,688915135,0
1360267565,688948756,4,1002,250.5,1360267539443,1360267540083,688923199,688923839,640
1360267573,688956740,3,492,164,1360267548738,1360267548866,688932478,688932606,128
1360267575,3622238504,8,448,56,1360267548390,1360267561894,3622211894,3622225398,13504
1360267577,688960668,14,784,56,1360267548937,1360267562761,688932605,688946429,13824
1360267577,688960672,3,169,56.33333333,1360267551749,1360267551941,688935421,688935613,192
1360267577,688960712,7,392,56,1360267549981,1360267561693,688933693,688945405,11712
1360267577,688960748,14,784,56,1360267549177,1360267562105,688932925,688945853,12928
1360267581,688964672,6,576,96,1360267553030,1360267561862,688936702,688945534,8832
1360267581,688964724,6,336,56,1360267555283,1360267562259,688939007,688945983,6976
1360267591,688975252,449,491220,1094.03118,1360267435713,1360267584193,688819965,688968445,148480
1360267601,688984680,8,458,57.25,1360267596735,1360267596799,688980415,688980479,64
1360267601,688984704,1,137,137,1360267575782,1360267575782,688959486,688959486,0
1360267605,688988824,4,590,147.5,1360267579502,1360267579502,688963326,688963326,0
1360267609,688992756,10,560,56,1360267583474,1360267592690,688967230,688976446,9216
1360267609,688992756,10,960,96,1360267583536,1360267592816,688967292,688976572,9280
1360267609,688992768,10,560,56,1360267583911,1360267593319,688967679,688977087,9408
1360267609,688992840,20,1120,56,1360267583260,1360267592860,688967100,688976700,9600
1360267609,688992876,19,1064,56,1360267583544,1360267592760,688967420,688976636,9216
1360267611,3622274508,10,560,56,1360267583648,1360267596256,3622247156,3622259764,12608
1360267613,688996968,4,538,134.5,1360267588252,1360267589020,688972220,688972988,768
1360267615,688999240,3,138,46,1360267609229,1360267609293,688993469,688993533,64
1360267633,689017092,1,137,137,1360267606242,1360267606242,688990334,688990334,0
1360267641,689025020,8,768,96,1360267615015,1360267623655,688999035,689007675,8640
1360267641,689025028,6,336,56,1360267615328,1360267620320,688999356,689004348,4992
1360267641,689025144,15,840,56,1360267613228,1360267622828,688997372,689006972,9600
1360267641,689025144,14,784,56,1360267613355,1360267622891,688997499,689007035,9536
1360267641,689025192,8,448,56,1360267614525,1360267623101,688998717,689007293,8576
1360267643,3622306496,6,336,56,1360267615276,1360267622764,3622278772,3622286260,7488
1360267645,689029080,3,544,181.3333333,1360267619308,1360267619436,689003388,689003516,128
1360267653,689037096,3,492,164,1360267628060,1360267628188,689012156,689012284,128
1360267665,689049040,1,137,137,1360267637139,1360267637139,689021179,689021179,0
1360267675,3622338588,14,784,56,1360267649937,1360267668753,3622313525,3622332341,18816
1360267677,689061028,28,1568,56,1360267649054,1360267670174,689033082,689054202,21120
1360267677,689061044,10,560,56,1360267650384,1360267662672,689034428,689046716,12288
1360267677,689061116,27,1512,56,1360267649287,1360267668487,689033403,689052603,19200
1360267677,689061148,14,784,56,1360267649833,1360267668649,689033981,689052797,18816
1360267677,689061156,13,1248,96,1360267650529,1360267662625,689034685,689046781,12096
1360267685,689069200,4,1002,250.5,1360267659316,1360267659956,689043516,689044156,640
1360267693,689077132,3,492,164,1360267668473,1360267668601,689052605,689052733,128
1360267697,689081224,1,137,137,1360267669978,1360267669978,689054202,689054202,0
1360267703,689087268,5,242,48.4,1360267690225,1360267696305,689074493,689080573,6080
1360267708,3622370916,12,672,56,1360267682930,1360267700914,3622345846,3622363830,17984
1360267709,689093180,25,1400,56,1360267681672,1360267708808,689065852,689092988,27136
1360267709,689093180,12,672,56,1360267681735,1360267696199,689065915,689080379,14464
1360267709,689093184,12,1152,96,1360267681858,1360267696322,689066042,689080506,14464
1360267709,689093184,24,1344,56,1360267681924,1360267708740,689066108,689092924,26816
1360267709,689093188,12,672,56,1360267682177,1360267699713,689066365,689083901,17536
1360267717,689101276,4,656,164,1360267689960,1360267690984,689074236,689075260,1024
1360267725,689109232,4,590,147.5,1360267699345,1360267699409,689083577,689083641,64
1360267725,689109356,1,137,137,1360267700118,1360267700118,689084474,689084474,0
1360267733,689117356,4,538,134.5,1360267708053,1360267708885,689092409,689093241,832
1360267736,3622398932,16,896,56,1360267710178,1360267735266,3622373110,3622398198,25088
1360267737,689121200,18,1008,56,1360267708916,1360267736308,689093116,689120508,27392
1360267737,689121208,34,1904,56,1360267709229,1360267736173,689093437,689120381,26944
1360267737,689121280,17,1632,96,1360267708898,1360267735330,689093178,689119610,26432
1360267737,689121288,33,1848,56,1360267709148,1360267735964,689093436,689120252,26816
1360267737,689121316,17,952,56,1360267709248,1360267735616,689093564,689119932,26368
1360267751,689135276,3,144,48,1360267747048,1360267747112,689131324,689131388,64
1360267764,3622426884,11,616,56,1360267736595,1360267762643,3622399479,3622425527,26048
1360267765,689149264,20,1120,56,1360267737332,1360267762036,689121596,689146300,24704
1360267765,689149312,3,544,181.3333333,1360267739396,1360267739460,689123708,689123772,64
1360267765,689149336,10,560,56,1360267739626,1360267762090,689123962,689146426,22464
1360267765,689149348,11,1056,96,1360267736989,1360267762141,689121337,689146489,25152
1360267765,689149352,21,1176,56,1360267737052,1360267762588,689121404,689146940,25536
1360267765,689149380,10,560,56,1360267737277,1360267761597,689121657,689145977,24320
1360267769,689153368,1,137,137,1360267743243,1360267743243,689127611,689127611,0
1360267773,689157388,14,4406,314.7142857,1360267746999,1360267747191,689131387,689131579,192
1360267777,689161348,3,492,164,1360267748829,1360267748957,689133177,689133305,128
1360267806,689189604,3,544,181.3333333,1360267780230,1360267780230,689163834,689163834,0
1360267814,689197520,1,137,137,1360267788250,1360267788250,689171770,689171770,0
1360267814,689197564,14,784,56,1360267786348,1360267796140,689169912,689179704,9792
1360267814,689197596,7,392,56,1360267787021,1360267795789,689170617,689179385,8768
1360267814,689197608,12,672,56,1360267787841,1360267796097,689171449,689179705,8256
1360267814,689197632,7,392,56,1360267787817,1360267796137,689171449,689179769,8320
1360267814,689197632,7,672,96,1360267787883,1360267796395,689171515,689180027,8512
1360267812,3622474960,7,392,56,1360267787656,1360267795912,3622450616,3622458872,8256
1360267818,689201480,3,492,164,1360267789888,1360267790080,689173368,689173560,192
1360267818,689201496,1,77,77,1360267792241,1360267792241,689175737,689175737,0
1360267822,689205472,6,990,165,1360267794059,1360267794443,689177531,689177915,384
1360267846,689229520,11,616,56,1360267819864,1360267837208,689203384,689220728,17344
1360267846,689229528,5,280,56,1360267820371,1360267837459,689203899,689220987,17088
1360267846,689229528,5,480,96,1360267820562,1360267829202,689204090,689212730,8640
1360267846,689229596,12,672,56,1360267818828,1360267830476,689202424,689214072,11648
1360267846,689229608,6,336,56,1360267819839,1360267830015,689203447,689213623,10176
1360267846,689229616,3,550,183.3333333,1360267820283,1360267820539,689203899,689204155,256
1360267848,3622510944,6,336,56,1360267820055,1360267830295,3622482999,3622493239,10240
1360267850,689233552,1,137,137,1360267823161,1360267823161,689206713,689206713,0
1360267854,689237572,3,492,164,1360267829732,1360267829860,689213304,689213432,128
1360267856,3622518916,6,889,148.1666667,1360267830130,1360267830322,3622493046,3622493238,192
1360267856,3622518916,3,387,129,1360267830321,1360267830321,3622493237,3622493237,0
1360267856,3622518968,4,433,108.25,1360267830271,1360267830271,3622493239,3622493239,0
1360267856,3622518968,3,426,142,1360267830271,1360267830271,3622493239,3622493239,0
1360267862,689245668,2,123,61.5,1360267837062,1360267837062,689220730,689220730,0
1360267878,689261680,14,1344,96,1360267851576,1360267863800,689235256,689247480,12224
1360267878,689261680,28,1568,56,1360267851639,1360267870071,689235319,689253751,18432
1360267878,689261684,28,1568,56,1360267851702,1360267870198,689235386,689253882,18496
1360267878,689261684,14,784,56,1360267851765,1360267865845,689235449,689249529,14080
1360267878,689261712,13,728,56,1360267852247,1360267863831,689235959,689247543,11584
1360267880,3622543012,14,784,56,1360267851921,1360267869969,3622514933,3622532981,18048
1360267886,689269672,4,596,149,1360267860351,1360267860607,689244023,689244279,256
1360267887,689271368,7,412,58.85714286,1360267881352,1360267881416,689265720,689265784,64
1360267894,689277660,1,137,137,1360267865933,1360267865933,689249593,689249593,0
1360267898,689281672,3,492,164,1360267869953,1360267870081,689253625,689253753,128
1360267910,689293652,5,480,96,1360267883987,1360267893011,689267639,689276663,9024
1360267910,689293656,9,504,56,1360267884050,1360267893074,689267706,689276730,9024
1360267910,689293660,5,280,56,1360267884300,1360267894028,689267960,689277688,9728
1360267910,689293748,5,280,56,1360267883829,1360267892149,689267577,689275897,8320
1360267910,689293752,9,504,56,1360267884146,1360267893746,689267898,689277498,9600
1360267912,3622575104,5,280,56,1360267884407,1360267894263,3622547511,3622557367,9856
1360267914,689297584,3,138,46,1360267909850,1360267909914,689293434,689293498,64
1360267926,689309660,4,590,147.5,1360267900427,1360267900491,689284087,689284151,64
1360267926,689309784,1,137,137,1360267900626,1360267900626,689284410,689284410,0
1360267934,689317636,2,446,223,1360267909797,1360267909925,689293433,689293561,128
1360267938,689321728,14,784,56,1360267913543,1360267922055,689297271,689305783,8512
1360267938,689321764,7,392,56,1360267913637,1360267921509,689297401,689305273,7872
1360267938,689321816,14,784,56,1360267913393,1360267921649,689297209,689305465,8256
1360267940,3622603096,6,336,56,1360267914176,1360267921024,3622577272,3622584120,6848
1360267942,689326012,7,672,96,1360267913579,1360267921387,689297591,689305399,7808
1360267942,689326040,6,336,56,1360267913807,1360267920591,689297847,689304631,6784
1360267962,689346000,1,137,137,1360267934584,1360267934584,689318584,689318584,0
1360267966,689350004,3,544,181.3333333,1360267940212,1360267940276,689324216,689324280,64
1360267970,689354044,4,224,56,1360267945420,1360267952524,689329464,689336568,7104
1360267970,689354048,6,336,56,1360267945670,1360267952710,689329718,689336758,7040
1360267970,689354048,4,224,56,1360267945800,1360267953032,689329848,689337080,7232
1360267972,3622635124,4,224,56,1360267945765,1360267952933,3622608889,3622616057,7168
1360267974,689357844,7,392,56,1360267945877,1360267952981,689329721,689336825,7104
1360267974,689357956,3,288,96,1360267945954,1360267952226,689329910,689336182,6272
1360267974,689358124,3,492,164,1360267949371,1360267949563,689333495,689333687,192
1360268002,689386140,1,137,137,1360267975212,1360267975212,689359352,689359352,0
1360268006,689390092,20,1120,56,1360267980124,1360267990428,689364216,689374520,10304
1360268006,689390092,3,544,181.3333333,1360267980251,1360267980443,689364343,689364535,192
1360268006,689390092,9,504,56,1360267980378,1360267990234,689364470,689374326,9856
1360268006,689390172,9,864,96,1360267979979,1360267989643,689364151,689373815,9664
1360268006,689390172,20,1120,56,1360267980170,1360267990666,689364342,689374838,10496
1360268006,689390208,9,504,56,1360267980712,1360267989480,689364920,689373688,8768
1360268008,3622671176,10,560,56,1360267980784,1360267990640,3622643960,3622653816,9856
1360268014,689398128,3,492,164,1360267988981,1360267989877,689373109,689374005,896
1360268034,689418080,15,840,56,1360268007528,1360268022632,689391608,689406712,15104
1360268034,689418088,29,1624,56,1360268007840,1360268023008,689391928,689407096,15168
1360268034,689418088,15,840,56,1360268007903,1360268029855,689391991,689413943,21952
1360268034,689418116,1,137,137,1360268006722,1360268006722,689390838,689390838,0
1360268034,689418164,15,1440,96,1360268007508,1360268022612,689391672,689406776,15104
1360268034,689418192,28,1568,56,1360268007671,1360268029495,689391863,689413687,21824
1360268036,3622699196,14,784,56,1360268008282,1360268022682,3622671478,3622685878,14400
1360268046,689430136,4,1002,250.5,1360268020269,1360268020781,689404405,689404917,512
1360268054,689438196,3,492,164,1360268029488,1360268029616,689413684,689413812,128
1360268055,689439380,4,196,49,1360268047227,1360268048763,689431607,689433143,1536
1360268055,689439384,4,196,49,1360268047480,1360268049272,689431864,689433656,1792
1360268066,689450188,14,1344,96,1360268040763,1360268055611,689424951,689439799,14848
1360268066,689450264,29,1624,56,1360268040431,1360268055983,689424695,689440247,15552
1360268066,689450264,29,1624,56,1360268040557,1360268056045,689424821,689440309,15488
1360268066,689450292,15,840,56,1360268040595,1360268056467,689424887,689440759,15872
1360268066,689450296,13,728,56,1360268041228,1360268055756,689425524,689440052,14528
1360268068,3622731320,14,784,56,1360268040671,1360268056223,3622703991,3622719543,15552
1360268071,689455388,1,137,137,1360268045555,1360268045555,689429943,689429943,0
1360268074,689458212,13,1761,135.4615385,1360268048929,1360268051937,689433141,689436149,3008
1360268074,689458324,10,697,69.7,1360268049011,1360268052531,689433335,689436855,3520
1360268086,689470172,4,590,147.5,1360268060360,1360268060360,689444532,689444532,0
1360268094,689478184,3,492,164,1360268068925,1360268069373,689453109,689453557,448
1360268094,689478204,11,1056,96,1360268069032,1360268080552,689453236,689464756,11520
1360268094,689478208,22,1232,56,1360268069158,1360268093798,689453366,689478006,24640
1360268094,689478212,10,560,56,1360268069411,1360268088995,689453623,689473207,19584
1360268094,689478376,21,1176,56,1360268069116,1360268088060,689453492,689472436,18944
1360268096,3622759332,11,616,56,1360268069910,1360268093910,3622733242,3622757242,24000
1360268098,689482392,11,616,56,1360268069870,1360268093998,689454262,689478390,24128
1360268103,689487408,4,196,49,1360268094047,1360268100063,689478455,689484471,6016
1360268104,689487488,3,144,48,1360268094966,1360268100982,689478454,689484470,6016
1360268115,689498428,1,137,137,1360268089072,1360268089072,689472500,689472500,0
1360268119,689502460,8,1310,163.75,1360268094480,1360268094672,689477940,689478132,192
1360268119,689502468,26,1456,56,1360268094666,1360268118730,689478134,689502198,24064
1360268122,689506396,15,1440,96,1360268094058,1360268121322,689478454,689505718,27264
1360268123,689506440,3,169,56.33333333,1360268097251,1360268097315,689480691,689480755,64
1360268123,689506528,26,1456,56,1360268097167,1360268122511,689480695,689506039,25344
1360268123,689506528,2,123,61.5,1360268097166,1360268097166,689480694,689480694,0
1360268127,689510488,13,728,56,1360268098998,1360268121846,689482486,689505334,22848
1360268127,689510524,3,544,181.3333333,1360268101074,1360268101138,689484598,689484662,64
1360268128,3622791408,13,728,56,1360268100424,1360268121416,3622763832,3622784824,20992
1360268131,689514508,14,784,56,1360268103395,1360268122339,689486903,689505847,18944
1360268135,689518464,3,492,164,1360268110284,1360268111244,689493748,689494708,960
1360268147,689530460,27,1512,56,1360268121683,1360268146515,689505143,689529975,24832
1360268151,689534444,1,137,137,1360268122912,1360268122912,689506356,689506356,0
1360268159,689542440,19,1064,56,1360268134819,1360268151971,689518259,689535411,17152
1360268160,3622823584,20,1120,56,1360268134167,1360268151639,3622797751,3622815223,17472
1360268163,689546488,39,2184,56,1360268134964,1360268152628,689518452,689536116,17664
1360268163,689546496,19,1824,96,1360268135213,1360268152557,689518709,689536053,17344
1360268163,689546576,18,1008,56,1360268135070,1360268151390,689518646,689534966,16320
1360268167,689550532,1,77,77,1360268142216,1360268142216,689525748,689525748,0
1360268167,689550616,3,544,181.3333333,1360268141108,1360268141108,689524724,689524724,0
1360268167,689550624,2,123,61.5,1360268142124,1360268142124,689525748,689525748,0
1360268175,689558560,29,1624,56,1360268147436,1360268174572,689530996,689558132,27136
1360268179,689562472,4,538,134.5,1360268151106,1360268152002,689534578,689535474,896
1360268191,689574460,1,137,137,1360268162960,1360268162960,689546420,689546420,0
1360268191,689574548,10,560,56,1360268166329,1360268176505,689549877,689560053,10176
1360268192,689575436,6,366,61,1360268187305,1360268187305,689570741,689570741,0
1360268192,689575512,7,412,58.85714286,1360268187229,1360268187229,689570741,689570741,0
1360268192,3622855564,9,504,56,1360268165803,1360268174699,3622829367,3622838263,8896
1360268195,689578504,9,864,96,1360268168229,1360268175909,689551733,689559413,7680
1360268195,689578584,9,504,56,1360268168084,1360268175700,689551668,689559284,7616
1360268195,689578620,18,1008,56,1360268167534,1360268175854,689551154,689559474,8320
1360268199,689582604,2,558,279,1360268171902,1360268171966,689555506,689555570,64
1360268203,689586508,8,448,56,1360268175199,1360268202847,689558707,689586355,27648
1360268207,689590536,3,544,181.3333333,1360268181250,1360268181314,689564786,689564850,64
1360268219,689602604,3,492,164,1360268192191,1360268192319,689575795,689575923,128
1360268223,689606656,1,137,137,1360268198284,1360268198284,689581940,689581940,0
1360268224,3622887596,5,280,56,1360268198607,1360268203983,3622862203,3622867579,5376
1360268227,689610512,4,224,56,1360268200410,1360268204570,689583922,689588082,4160
1360268227,689610544,3,168,56,1360268199676,1360268202940,689583220,689586484,3264
1360268227,689610588,4,384,96,1360268199824,1360268204048,689583412,689587636,4224
1360268227,689610704,9,504,56,1360268199196,1360268204764,689582900,689588468,5568
1360268231,689614536,5,280,56,1360268203525,1360268230725,689587061,689614261,27200
1360268247,689630664,3,544,181.3333333,1360268221251,1360268221251,689604915,689604915,0
1360268255,689638860,4,384,96,1360268229437,1360268235517,689613297,689619377,6080
1360268255,689638888,4,224,56,1360268230562,1360268235874,689614450,689619762,5312
1360268255,689638968,4,224,56,1360268229140,1360268235284,689613108,689619252,6144
1360268255,689638980,7,392,56,1360268230280,1360268235656,689614260,689619636,5376
1360268256,3622919592,3,168,56,1360268230354,1360268234642,3622893946,3622898234,4288
1360268259,689642908,6,336,56,1360268230927,1360268235727,689614835,689619635,4800
1360268259,689642928,4,538,134.5,1360268231163,1360268231739,689615091,689615667,576
1360268263,689646828,1,137,137,1360268235805,1360268235805,689619633,689619633,0
1360268287,689670860,11,616,56,1360268260416,1360268274368,689644276,689658228,13952
1360268287,689670860,10,560,56,1360268260542,1360268271998,689644402,689655858,11456
1360268287,689670868,2,498,249,1360268261175,1360268261175,689645043,689645043,0
1360268287,689670872,5,480,96,1360268261364,1360268267636,689645236,689651508,6272
1360268287,689670872,5,280,56,1360268261746,1360268272114,689645618,689655986,10368
1360268287,689670952,5,280,56,1360268260772,1360268267428,689644724,689651380,6656
1360268289,3622951872,6,336,56,1360268260640,1360268272736,3622923512,3622935608,12096
1360268296,689679516,3,138,46,1360268287957,1360268288021,689671473,689671537,64
1360268299,689682868,3,492,164,1360268271988,1360268272116,689655856,689655984,128
1360268299,689682940,1,137,137,1360268274352,1360268274352,689658292,689658292,0
1360268319,689702868,13,728,56,1360268291318,1360268301558,689675186,689685426,10240
1360268319,689702868,6,336,56,1360268291381,1360268298421,689675249,689682289,7040
1360268319,689702872,12,672,56,1360268291761,1360268301425,689675633,689685297,9664
1360268319,689702956,6,576,96,1360268291422,1360268298462,689675378,689682418,7040
1360268319,689702996,6,336,56,1360268292854,1360268298806,689676850,689682802,5952
1360268320,3622983612,6,336,56,1360268292732,1360268298812,3622956344,3622962424,6080
1360268327,689710916,3,544,181.3333333,1360268301189,1360268301253,689685105,689685169,64
1360268339,689723304,3,492,164,1360268311874,1360268312002,689696178,689696306,128
1360268339,689723332,1,137,137,1360268312548,1360268312548,689696880,689696880,0
1360268351,689735176,14,784,56,1360268323585,1360268337217,689707761,689721393,13632
1360268351,689735176,15,1440,96,1360268323649,1360268337281,689707825,689721457,13632
1360268351,689735180,24,1344,56,1360268323839,1360268341119,689708019,689725299,17280
1360268351,689735284,25,1400,56,1360268323669,1360268337493,689707953,689721777,13824
1360268351,689735288,14,784,56,1360268323921,1360268341265,689708209,689725553,17344
1360268352,3623015608,14,784,56,1360268324100,1360268336900,3622987708,3623000508,12800
1360268360,689743668,3,144,48,1360268352828,1360268352892,689736496,689736560,64
1360268367,689751396,3,544,181.3333333,1360268340836,1360268340900,689725232,689725296,64
1360268379,689763292,15,4456,297.0666667,1360268352271,1360268352655,689736563,689736947,384
1360268380,689763472,3,492,164,1360268352961,1360268353089,689736433,689736561,128
1360268380,3623043600,11,616,56,1360268355401,1360268368265,3623019001,3623031865,12864
1360268383,689767272,21,1176,56,1360268355359,1360268368799,689739631,689753071,13440
1360268383,689767276,10,960,96,1360268355740,1360268368668,689740016,689752944,12928
1360268383,689767280,11,616,56,1360268355993,1360268369305,689740273,689753585,13312
1360268383,689767352,21,1176,56,1360268355409,1360268368977,689739761,689753329,13568
1360268383,689767352,1,137,137,1360268355471,1360268355471,689739823,689739823,0
1360268383,689767356,10,560,56,1360268355535,1360268367631,689739891,689751987,12096
1360268408,689791416,4,596,149,1360268381881,1360268382073,689765297,689765489,192
1360268408,689791604,4,196,49,1360268395899,1360268401915,689779503,689785519,6016
1360268408,689791612,3,144,48,1360268396086,1360268401910,689779698,689785522,5824
1360268408,689791732,4,190,47.5,1360268394686,1360268400830,689778418,689784562,6144
1360268415,689799328,10,960,96,1360268389287,1360268399655,689773615,689783983,10368
1360268415,689799332,10,560,56,1360268389540,1360268400100,689773872,689784432,10560
1360268416,689799412,21,1176,56,1360268390012,1360268402236,689773424,689785648,12224
1360268416,689799416,10,560,56,1360268390072,1360268400504,689773488,689783920,10432
1360268416,689799420,18,1008,56,1360268390326,1360268401462,689773746,689784882,11136
1360268416,3623079616,10,560,56,1360268388923,1360268400315,3623052539,3623063931,11392
1360268419,689803380,3,492,164,1360268391733,1360268392053,689776113,689776433,320
1360268420,689803444,8,1255,156.875,1360268394715,1360268395739,689778159,689779183,1024
1360268423,689807324,5,304,60.8,1360268396910,1360268397230,689781234,689781554,320
1360268427,689811348,1,137,137,1360268400596,1360268400596,689784944,689784944,0
1360268448,689831468,4,596,149,1360268421955,1360268422083,689805423,689805551,128
1360268449,3623111852,11,616,56,1360268424630,1360268436086,3623087482,3623098938,11456
1360268451,689835332,9,504,56,1360268423269,1360268440805,689807601,689825137,17536
1360268451,689835336,22,1232,56,1360268423520,1360268435616,689807856,689819952,12096
1360268452,689835420,12,1152,96,1360268424244,1360268442804,689807664,689826224,18560
1360268452,689835420,22,1232,56,1360268424371,1360268443059,689807791,689826479,18688
1360268452,689835424,11,616,56,1360268424498,1360268436082,689807922,689819506,11584
1360268459,689843356,2,446,223,1360268431691,1360268431883,689816047,689816239,192
1360268467,689851408,1,137,137,1360268440792,1360268440792,689825200,689825200,0
1360268468,689851436,3,169,56.33333333,1360268442789,1360268442789,689826225,689826225,0
1360268481,3623143864,17,952,56,1360268456299,1360268474347,3623119163,3623137211,18048
1360268483,689867360,17,952,56,1360268455305,1360268473417,689839665,689857777,18112
1360268483,689867364,15,840,56,1360268455810,1360268473986,689840174,689858350,18176
1360268483,689867368,14,1344,96,1360268456001,1360268473153,689840369,689857521,17152
1360268484,689867440,34,1904,56,1360268456160,1360268474592,689839600,689858032,18432
1360268484,689867448,32,1792,56,1360268456472,1360268474456,689839920,689857904,17984
1360268488,689871484,2,498,249,1360268462067,1360268462067,689845551,689845551,0
1360268488,689871648,7,412,58.85714286,1360268487568,1360268487632,689871216,689871280,64
1360268500,689883436,3,492,164,1360268473381,1360268473573,689856817,689857009,192
1360268508,689891440,1,137,137,1360268481949,1360268481949,689865389,689865389,0
1360268512,689895748,3,138,46,1360268510828,1360268510892,689894576,689894640,64
1360268516,689899468,15,840,56,1360268490306,1360268502146,689873774,689885614,11840
1360268516,689899472,8,448,56,1360268490496,1360268502400,689873968,689885872,11904
1360268516,689899552,8,768,96,1360268489585,1360268497329,689873137,689880881,7744
1360268516,689899552,14,784,56,1360268489712,1360268497648,689873264,689881200,7936
1360268516,689899588,7,392,56,1360268491341,1360268497165,689874929,689880753,5824
1360268517,3623179844,8,448,56,1360268491134,1360268502654,3623153978,3623165498,11520
1360268528,689911612,3,544,181.3333333,1360268502005,1360268502261,689885617,689885873,256
1360268540,689923600,3,492,164,1360268513597,1360268513725,689897197,689897325,128
1360268548,689931484,13,728,56,1360268521202,1360268529906,689904686,689913390,8704
1360268548,689931508,12,672,56,1360268521241,1360268529241,689904749,689912749,8000
1360268548,689931512,6,576,96,1360268521495,1360268529111,689905007,689912623,7616
1360268548,689931596,1,137,137,1360268520964,1360268520964,689904560,689904560,0
1360268548,689931600,6,336,56,1360268521342,1360268528126,689904942,689911726,6784
1360268548,689931632,5,280,56,1360268522719,1360268529247,689906351,689912879,6528
1360268549,3623211948,6,336,56,1360268522966,1360268529366,3623185914,3623192314,6400
1360268568,689951800,4,596,149,1360268541944,1360268542136,689925744,689925936,192
1360268580,689963844,3,492,164,1360268553292,1360268553420,689937136,689937264,128
1360268584,689967692,20,1120,56,1360268556386,1360268567010,689940078,689950702,10624
1360268584,689967720,20,1120,56,1360268557383,1360268567815,689941103,689951535,10432
1360268584,689967724,1,137,137,1360268557825,1360268557825,689941549,689941549,0
1360268584,689967856,11,616,56,1360268556413,1360268567165,689940269,689951021,10752
1360268584,689967880,11,1056,96,1360268556520,1360268567208,689940400,689951088,10688
1360268584,689967884,8,448,56,1360268557025,1360268565793,689940909,689949677,8768
1360268585,3623247884,10,560,56,1360268557525,1360268566997,3623220409,3623229881,9472
1360268608,689991892,3,544,181.3333333,1360268581913,1360268581977,689965805,689965869,64
1360268616,689999948,5,280,56,1360268590819,1360268598179,689974767,689982127,7360
1360268616,689999996,10,560,56,1360268589424,1360268598384,689973420,689982380,8960
1360268616,690000036,9,504,56,1360268591051,1360268598347,689975087,689982383,7296
1360268616,690000036,5,280,56,1360268591305,1360268598473,689975341,689982509,7168
1360268616,690000036,5,480,96,1360268591432,1360268598728,689975468,689982764,7296
1360268617,3623280128,3,168,56,1360268591203,1360268594659,3623254331,3623257787,3456
1360268620,690003876,2,446,223,1360268593195,1360268593323,689977071,689977199,128
1360268620,690003960,1,137,137,1360268592725,1360268592725,689976685,689976685,0
1360268648,690031840,12,672,56,1360268620429,1360268629453,690004269,690013293,9024
1360268648,690031840,10,560,56,1360268620557,1360268632717,690004397,690016557,12160
1360268648,690031944,2,498,249,1360268621989,1360268621989,690005933,690005933,0
1360268648,690031948,6,336,56,1360268622434,1360268633122,690006382,690017070,10688
1360268648,690032020,6,336,56,1360268621079,1360268628887,690005099,690012907,7808
1360268648,690032032,6,576,96,1360268622414,1360268633294,690006446,690017326,10880
1360268649,3623312112,6,336,56,1360268622134,1360268629302,3623285246,3623292414,7168
1360268656,690040196,2,98,49,1360268652778,1360268653034,690036974,690037230,256
1360268660,690043944,1,137,137,1360268632676,1360268632676,690016620,690016620,0
1360268660,690044056,3,492,164,1360268633015,1360268633143,690017071,690017199,128
1360268664,690048228,3,150,50,1360268656327,1360268662471,690040555,690046699,6144
1360268664,690048228,3,150,50,1360268656327,1360268662471,690040555,690046699,6144
1360268664,690048228,2,98,49,1360268656395,1360268662539,690040623,690046767,6144
1360268664,690048228,3,150,50,1360268656330,1360268662474,690040558,690046702,6144
1360268664,690048228,3,150,50,1360268656584,1360268662472,690040812,690046700,5888
1360268664,690048232,4,196,49,1360268656965,1360268663493,690041197,690047725,6528
1360268664,690048276,662,859724,1298.676737,1360268654617,1360268661209,690038893,690045485,6592
1360268664,690048308,5,450,90,1360268656123,1360268659131,690040431,690043439,3008
1360268664,690048308,2,98,49,1360268656250,1360268662394,690040558,690046702,6144
1360268664,690048308,3,150,50,1360268656504,1360268662392,690040812,690046700,5888
1360268664,690048308,3,144,48,1360268656504,1360268662392,690040812,690046700,5888
1360268664,690048308,4,196,49,1360268656504,1360268662392,690040812,690046700,5888
1360268664,690048308,4,196,49,1360268656504,1360268662456,690040812,690046764,5952
1360268664,690048308,3,150,50,1360268656503,1360268662391,690040811,690046699,5888
1360268664,690048312,2,98,49,1360268652598,1360268658422,690036910,690042734,5824
1360268664,690048312,2,98,49,1360268652598,1360268658422,690036910,690042734,5824
1360268664,690048312,3,150,50,1360268656886,1360268663414,690041198,690047726,6528
1360268664,690048336,3,150,50,1360268657949,1360268663389,690042285,690047725,5440
1360268664,690048348,2,98,49,1360268654543,1360268660367,690038891,690044715,5824
1360268672,690056264,2,98,49,1360268658404,1360268664420,690042668,690048684,6016
1360268672,690056336,3,144,48,1360268658333,1360268664413,690042669,690048749,6080
1360268676,690060016,8,448,56,1360268651164,1360268662684,690035180,690046700,11520
1360268676,690060024,3,610,203.3333333,1360268651606,1360268651798,690035630,690035822,192
1360268676,690060096,4,224,56,1360268651276,1360268662156,690035372,690046252,10880
1360268676,690060096,8,448,56,1360268651339,1360268663563,690035435,690047659,12224
1360268677,3623340120,4,224,56,1360268652525,1360268662701,3623315645,3623325821,10176
1360268680,690064048,5,2349,469.8,1360268652797,1360268653181,690036845,690037229,384
1360268680,690064048,25,18371,734.84,1360268652797,1360268662461,690036845,690046509,9664
1360268680,690064048,8,1826,228.25,1360268652861,1360268661949,690036909,690045997,9088
1360268680,690064244,10,9774,977.4,1360268652537,1360268652665,690036781,690036909,128
1360268680,690064244,3,758,252.6666667,1360268652599,1360268652855,690036843,690037099,256
1360268680,690064244,11,2800,254.5454545,1360268652599,1360268661175,690036843,690045419,8576
1360268680,690064244,4,548,137,1360268652599,1360268653559,690036843,690037803,960
1360268680,690064252,13,4357,335.1538462,1360268652978,1360268653298,690037230,690037550,320
1360268684,690067976,7,1140,162.8571429,1360268656579,1360268662083,690040555,690046059,5504
1360268684,690067976,5,648,129.6,1360268656579,1360268657283,690040555,690041259,704
1360268684,690067980,4,384,96,1360268656705,1360268666049,690040685,690050029,9344
1360268684,690068020,3,498,166,1360268658265,1360268658585,690042285,690042605,320
1360268684,690068080,1,46,46,1360268656348,1360268656348,690040428,690040428,0
1360268684,690068080,4,224,56,1360268656411,1360268664603,690040491,690048683,8192
1360268684,690068084,4,424,106,1360268656474,1360268657050,690040558,690041134,576
1360268684,690068084,4,382,95.5,1360268656474,1360268657306,690040558,690041390,832
1360268692,690076024,1,137,137,1360268666005,1360268666005,690050029,690050029,0
1360268700,690084100,3,492,164,1360268673032,1360268673160,690057132,690057260,128
1360268704,690088224,2,96,48,1360268679242,1360268682122,690063466,690066346,2880
1360268704,690088392,3,144,48,1360268695268,1360268700324,690079660,690084716,5056
1360268712,690095996,12,672,56,1360268687854,1360268698094,690071850,690082090,10240
1360268712,690096156,13,728,56,1360268687567,1360268701839,690071723,690085995,14272
1360268713,3623376136,6,336,56,1360268688412,1360268695836,3623351548,3623358972,7424
1360268716,690100020,6,336,56,1360268687897,1360268695321,690071917,690079341,7424
1360268716,690100028,6,336,56,1360268688463,1360268698383,690072491,690082411,9920
1360268716,690100036,6,576,96,1360268688777,1360268700617,690072813,690084653,11840
1360268720,690104076,7,1216,173.7142857,1360268695135,1360268695263,690079211,690079339,128
1360268724,690108312,2,123,61.5,1360268697842,1360268697842,690082154,690082154,0
1360268728,690112300,3,544,181.3333333,1360268701695,1360268701759,690085995,690086059,64
1360268737,690120508,1,137,137,1360268710233,1360268710233,690093741,690093741,0
1360268740,690124200,3,492,164,1360268712933,1360268713061,690097133,690097261,128
1360268744,690128288,8,448,56,1360268717517,1360268732493,690101805,690116781,14976
1360268744,690128288,5,280,56,1360268717643,1360268730443,690101931,690114731,12800
1360268744,690128292,7,392,56,1360268718024,1360268732360,690102316,690116652,14336
1360268744,690128376,4,224,56,1360268718068,1360268732660,690102444,690117036,14592
1360268744,690128376,3,288,96,1360268718194,1360268729778,690102570,690114154,11584
1360268745,3623408144,5,280,56,1360268718291,1360268732819,3623381435,3623395963,14528
1360268768,690152332,2,123,61.5,1360268742816,1360268742816,690127148,690127148,0
1360268768,690152400,3,544,181.3333333,1360268741723,1360268741723,690126123,690126123,0
1360268772,690156384,2,192,96,1360268747435,1360268751595,690131819,690135979,4160
1360268776,690160316,4,224,56,1360268749552,1360268753456,690133868,690137772,3904
1360268776,690160324,4,224,56,1360268750310,1360268754342,690134634,690138666,4032
1360268776,690160332,2,112,56,1360268750752,1360268753120,690135084,690137452,2368
1360268776,690160352,1,56,56,1360268751561,1360268751561,690135913,690135913,0
1360268777,3623440116,2,112,56,1360268751535,1360268753839,3623414651,3623416955,2304
1360268780,690164228,3,492,164,1360268753289,1360268753417,690137517,690137645,128
1360268780,690164344,1,137,137,1360268754322,1360268754322,690138666,690138666,0
1360268793,690176648,8,458,57.25,1360268787532,1360268787596,690171180,690171244,64
1360268796,690180240,2,92,46,1360268768444,1360268768444,690152684,690152684,0
1360268796,690180324,1,46,46,1360268768359,1360268768359,690152683,690152683,0
1360268796,690180324,1,46,46,1360268768359,1360268768359,690152683,690152683,0
1360268796,690180360,2,92,46,1360268769282,1360268769346,690153642,690153706,64
1360268800,690184352,2,92,46,1360268774282,1360268774346,690158634,690158698,64
1360268800,690184392,2,92,46,1360268772257,1360268772321,690156649,690156713,64
1360268800,690184392,2,92,46,1360268772257,1360268772321,690156649,690156713,64
1360268800,690184396,1,46,46,1360268772256,1360268772256,690156652,690156652,0
1360268804,690188332,2,92,46,1360268776352,1360268776352,690160684,690160684,0
1360268804,690188364,2,92,46,1360268777278,1360268777342,690161642,690161706,64
1360268804,690188364,1,46,46,1360268777278,1360268777278,690161642,690161642,0
1360268805,690188408,5,280,56,1360268780539,1360268785979,690163947,690169387,5440
1360268805,3623468340,5,280,56,1360268780816,1360268786512,3623444156,3623449852,5696
1360268808,690192300,5,480,96,1360268780158,1360268785214,690164458,690169514,5056
1360268808,690192304,5,280,56,1360268780412,1360268785980,690164716,690170284,5568
1360268808,690192344,3,544,181.3333333,1360268781841,1360268781905,690166185,690166249,64
1360268808,690192392,10,560,56,1360268780132,1360268786468,690164524,690170860,6336
1360268808,690192392,10,560,56,1360268780194,1360268786786,690164586,690171178,6592
1360268817,690200660,3,138,46,1360268811069,1360268811133,690194729,690194793,64
1360268820,690204256,3,492,164,1360268792939,1360268793067,690177195,690177323,128
1360268825,690208436,1,137,137,1360268798493,1360268798493,690181929,690181929,0
1360268836,690220340,4,224,56,1360268809556,1360268821972,690193896,690206312,12416
1360268836,690220348,6,336,56,1360268810447,1360268815631,690194795,690199979,5184
1360268836,690220388,2,112,56,1360268811816,1360268815080,690196204,690199468,3264
1360268837,690220428,4,384,96,1360268810533,1360268823141,690193961,690206569,12608
1360268837,690220432,6,336,56,1360268810787,1360268816291,690194219,690199723,5504
1360268837,3623500340,3,168,56,1360268811026,1360268815634,3623474366,3623478974,4608
1360268849,690232504,3,544,181.3333333,1360268822811,1360268822811,690206315,690206315,0
1360268849,690232652,72170,98880009,1370.098504,1360267135428,1360268845700,688519080,690229352,1710272
1360268857,690240552,1,137,137,1360268831913,1360268831913,690215465,690215465,0
1360268861,690244420,3,492,164,1360268833708,1360268833836,690217128,690217256,128
1360268873,690256408,2,112,56,1360268847673,1360268852217,690231081,690235625,4544
1360268873,690256560,3,168,56,1360268846177,1360268850081,690229737,690233641,3904
1360268873,690256596,3,168,56,1360268847293,1360268851709,690230889,690235305,4416
1360268873,3623536416,1,56,56,1360268848837,1360268848837,3623512253,3623512253,0
1360268877,690260412,1,56,56,1360268849782,1360268849782,690233194,690233194,0
1360268877,690260520,1,96,96,1360268850057,1360268850057,690233577,690233577,0
1360268889,690272932,3,544,181.3333333,1360268862447,1360268862511,690246379,690246443,64
1360268897,690280936,1,137,137,1360268869864,1360268869864,690253800,690253800,0
1360268901,690284636,3,492,164,1360268873494,1360268873622,690257130,690257258,128
1360268905,690288876,32,28192,881,1360268897510,1360268901606,690281386,690285482,4096
1360268905,3623568372,2,112,56,1360268877171,1360268880243,3623540543,3623543615,3072
1360268905,690289012,3,168,56,1360268877724,1360268880604,690261736,690264616,2880
1360268905,690289016,2,112,56,1360268877784,1360268880728,690261800,690264744,2944
1360268905,690289048,2,192,96,1360268878523,1360268882363,690262571,690266411,3840
1360268905,690289120,4,224,56,1360268877552,1360268882608,690261672,690266728,5056
1360268905,690289168,1,56,56,1360268879936,1360268879936,690264104,690264104,0
1360268925,690308800,1,46,46,1360268897585,1360268897585,690281385,690281385,0
1360268929,690313056,3,544,181.3333333,1360268902703,1360268902703,690286759,690286759,0
1360268937,690320932,5,280,56,1360268911277,1360268917165,690295209,690301097,5888
1360268937,690320936,8,448,56,1360268911530,1360268916458,690295466,690300394,4928
1360268937,690320936,4,224,56,1360268911657,1360268915945,690295593,690299881,4288
1360268937,3623600388,4,224,56,1360268911331,1360268914019,3623574719,3623577407,2688
1360268937,690320980,1,137,137,1360268909372,1360268909372,690293352,690293352,0
1360268937,690321016,9,504,56,1360268911064,1360268916824,690295080,690300840,5760
1360268937,690321052,4,384,96,1360268911733,1360268916149,690295785,690300201,4416
1360268941,690324860,3,492,164,1360268913204,1360268913396,690297064,690297256,192
1360268961,690344648,3,144,48,1360268953992,1360268954056,690337640,690337704,64
1360268969,690353004,5,1732,346.4,1360268941477,1360268941541,690325481,690325545,64
1360268969,690353032,3,544,181.3333333,1360268942473,1360268942537,690326505,690326569,64
1360268969,690353036,6,336,56,1360268942726,1360268953414,690326762,690337450,10688
1360268969,690353080,3,168,56,1360268944024,1360268949656,690328104,690333736,5632
1360268969,690353080,3,288,96,1360268944087,1360268953111,690328167,690337191,9024
1360268969,690353120,21,15335,730.2380952,1360268941426,1360268941554,690325546,690325674,128
1360268969,690353156,6,336,56,1360268942859,1360268953483,690327015,690337639,10624
1360268969,3623632644,4,224,56,1360268942114,1360268953826,3623605758,3623617470,11712
1360268973,690356996,3,168,56,1360268945453,1360268953837,690329449,690337833,8384
1360268977,690361088,1,137,137,1360268948943,1360268948943,690333031,690333031,0
1360268981,690364996,3,492,164,1360268953197,1360268953325,690337193,690337321,128
1360268981,690365000,12,1710,142.5,1360268953703,1360268953831,690337703,690337831,128
1360268997,690381232,7,392,56,1360268972545,1360268977729,690356777,690361961,5184
1360269001,690385024,7,392,56,1360268973649,1360268978193,690357673,690362217,4544
1360269001,690385028,4,224,56,1360268973901,1360268982541,690357929,690366569,8640
1360269001,690385052,3,168,56,1360268974578,1360268977650,690358630,690361702,3072
1360269001,690385132,4,384,96,1360268974051,1360268982691,690358183,690366823,8640
1360269001,3623664604,3,168,56,1360268974539,1360268977611,3623638143,3623641215,3072
1360269009,690392688,3,144,48,1360268996511,1360269001759,690380199,690385447,5248
1360269009,690392768,2,98,49,1360268996433,1360269001681,690380201,690385449,5248
1360269009,690392768,3,144,48,1360268996432,1360269001616,690380200,690385384,5184
1360269009,690392768,3,144,48,1360268996431,1360269001679,690380199,690385447,5248
1360269009,690393084,3,544,181.3333333,1360268982485,1360268982549,690366569,690366633,64
1360269017,690401176,1,137,137,1360268992057,1360268992057,690376233,690376233,0
1360269021,690405176,3,492,164,1360268993079,1360268993207,690377255,690377383,128
1360269021,690405216,9,2960,328.8888889,1360268995150,1360268995726,690379366,690379942,576
1360269025,690409112,3,169,56.33333333,1360268998136,1360268998136,690382248,690382248,0
1360269029,690413308,6,336,56,1360269004530,1360269009842,690388838,690394150,5312
1360269033,690417124,6,336,56,1360269004907,1360269010347,690389031,690394471,5440
1360269033,690417128,3,168,56,1360269005031,1360269009191,690389159,690393319,4160
1360269033,3623696636,3,168,56,1360269005098,1360269009194,3623668734,3623672830,4096
1360269033,690417304,2,112,56,1360269006839,1360269008503,690391143,690392807,1664
1360269033,690417304,2,192,96,1360269006966,1360269008630,690391270,690392934,1664
1360269049,690433160,3,544,181.3333333,1360269022533,1360269022597,690406693,690406757,64
1360269057,690440656,1,137,137,1360269029311,1360269029311,690412967,690412967,0
1360269061,690445128,3,492,164,1360269033830,1360269033958,690417958,690418086,128
1360269061,690445304,4,224,56,1360269036408,1360269043192,690420712,690427496,6784
1360269061,690445328,3,288,96,1360269036639,1360269040543,690420967,690424871,3904
1360269065,690449132,6,336,56,1360269036961,1360269042657,690421093,690426789,5696
1360269065,3623728592,3,168,56,1360269037846,1360269042198,3623701438,3623705790,4352
1360269065,690449232,6,336,56,1360269037053,1360269043005,690421285,690427237,5952
1360269065,690449260,3,168,56,1360269037665,1360269041121,690421925,690425381,3456
1360269069,690453280,2,123,61.5,1360269042959,1360269042959,690427239,690427239,0
1360269085,690469208,2,92,46,1360269057173,1360269057237,690441381,690441445,64
1360269085,690469208,1,46,46,1360269057172,1360269057172,690441380,690441380,0
1360269089,690472760,7,412,58.85714286,1360269088472,1360269088536,690472232,690472296,64
1360269089,690473200,3,288,96,1360269064479,1360269070495,690448679,690454695,6016
1360269089,690473352,3,544,181.3333333,1360269062469,1360269062469,690446821,690446821,0
1360269093,690477236,5,280,56,1360269066171,1360269074043,690450407,690458279,7872
1360269093,3623756676,2,112,56,1360269066308,1360269068996,3623729984,3623732672,2688
1360269093,690477260,5,280,56,1360269066019,1360269073891,690450279,690458151,7872
1360269093,690477380,3,168,56,1360269066282,1360269074026,690450662,690458406,7744
1360269094,690477432,2,112,56,1360269069344,1360269071008,690452776,690454440,1664
1360269097,690481208,1,137,137,1360269068948,1360269068948,690453156,690453156,0
1360269101,690485340,3,492,164,1360269073808,1360269073936,690458148,690458276,128
1360269113,690496816,3,138,46,1360269111645,1360269111709,690495461,690495525,64
1360269121,3623784752,2,112,56,1360269096501,1360269101301,3623760253,3623765053,4800
1360269125,690509320,2,112,56,1360269099300,1360269102116,690483620,690486436,2816
1360269125,690509404,4,224,56,1360269099088,1360269102800,690483492,690487204,3712
1360269126,690509428,4,224,56,1360269100000,1360269103456,690483428,690486884,3456
1360269126,690509432,1,96,96,1360269100446,1360269100446,690483878,690483878,0
1360269130,690513432,2,112,56,1360269102175,1360269127647,690485607,690511079,25472
1360269130,690513444,3,544,181.3333333,1360269103441,1360269103505,690486885,690486949,64
1360269141,690525284,3,492,164,1360269114057,1360269114185,690498341,690498469,128
1360269141,690525368,1,137,137,1360269113462,1360269113462,690497830,690497830,0
1360269157,690541344,2,112,56,1360269130383,1360269130959,690514727,690515303,576
1360269157,690541348,1,96,96,1360269130825,1360269130825,690515173,690515173,0
1360269157,690541376,1,56,56,1360269131947,1360269131947,690516323,690516323,0
1360269158,3623820816,2,112,56,1360269129888,1360269133152,3623792704,3623795968,3264
1360269158,690541432,1,56,56,1360269131483,1360269131483,690514915,690514915,0
1360269158,690541436,2,112,56,1360269131415,1360269132055,690514851,690515491,640
1360269158,690541468,4,656,164,1360269132474,1360269132922,690515942,690516390,448
1360269169,690553368,3,544,181.3333333,1360269142645,1360269142645,690527013,690527013,0
1360269182,690565480,3,492,164,1360269154990,1360269155118,690538470,690538598,128
1360269182,690565520,1,137,137,1360269156742,1360269156742,690540262,690540262,0
1360269185,690569340,8,448,56,1360269160464,1360269166864,690544804,690551204,6400
1360269185,690569348,7,392,56,1360269160776,1360269166344,690545124,690550692,5568
1360269189,690573368,4,224,56,1360269161524,1360269166388,690545892,690550756,4864
1360269190,690573480,4,384,96,1360269162475,1360269167467,690545955,690550947,4992
1360269190,690573484,3,168,56,1360269163047,1360269166951,690546531,690550435,3904
1360269190,3623852892,3,168,56,1360269162963,1360269166995,3623825855,3623829887,4032
1360269201,690584744,2,98,49,1360269193636,1360269199652,690577380,690583396,6016
1360269201,690584744,14916,20352427,1364.469496,1360268845666,1360269196642,690229410,690580386,350976
1360269201,690584812,4,190,47.5,1360269194082,1360269199586,690577894,690583398,5504
1360269201,690584816,3,144,48,1360269193564,1360269199580,690577380,690583396,6016
1360269210,690593660,3,544,181.3333333,1360269183416,1360269183480,690567076,690567140,64
1360269214,690597664,1,137,137,1360269189300,1360269189300,690572964,690572964,0
1360269218,3623880940,8,6513,814.125,1360269193765,1360269194149,3623856705,3623857089,384
1360269218,690601596,5,2597,519.4,1360269193719,1360269194295,690577315,690577891,576
1360269218,690601596,16,18611,1163.1875,1360269193719,1360269193847,690577315,690577443,128
1360269218,690601596,38,48331,1271.868421,1360269193783,1360269194039,690577379,690577635,256
1360269218,690601600,5,3279,655.8,1360269193718,1360269194230,690577318,690577830,512
1360269218,690601704,5,2619,523.8,1360269193613,1360269194125,690577317,690577829,512
1360269218,690601704,5,2822,564.4,1360269193675,1360269194251,690577379,690577955,576
1360269218,690601744,33,35917,1088.393939,1360269191590,1360269194150,690575334,690577894,2560
1360269222,3623884860,6,336,56,1360269195379,1360269201843,3623858239,3623864703,6464
1360269222,690605628,12,672,56,1360269195482,1360269203674,690579110,690587302,8192
1360269222,690605676,6,336,56,1360269197671,1360269203303,690581347,690586979,5632
1360269222,690605684,12,672,56,1360269194335,1360269201823,690578019,690585507,7488
1360269222,690605688,6,336,56,1360269194398,1360269201374,690578086,690585062,6976
1360269222,690605716,4,538,134.5,1360269195134,1360269195262,690578850,690578978,128
1360269222,690605764,6,576,96,1360269197647,1360269203279,690581411,690587043,5632
1360269234,690617660,1,46,46,1360269208247,1360269208247,690591907,690591907,0
1360269246,690629744,1,137,137,1360269219939,1360269219939,690603683,690603683,0
1360269250,690633748,3,544,181.3333333,1360269223455,1360269223519,690607203,690607267,64
1360269254,690637788,2,92,46,1360269228599,1360269228663,690612387,690612451,64
1360269257,690640856,3,144,48,1360269254003,1360269254067,690637859,690637923,64
1360269258,690641624,1,56,56,1360269230236,1360269230236,690613860,690613860,0
1360269258,690641732,2,112,56,1360269230063,1360269235631,690613795,690619363,5568
1360269258,690641740,2,92,46,1360269233638,1360269233702,690617378,690617442,64
1360269258,690641812,3,138,46,1360269232543,1360269232607,690616355,690616419,64
1360269262,3623924948,2,112,56,1360269234971,1360269260955,3623897919,3623923903,25984
1360269262,690645784,4,224,56,1360269235066,1360269261690,690618850,690645474,26624
1360269262,690645796,2,112,56,1360269235693,1360269261485,690619489,690645281,25792
1360269262,690645796,2,192,96,1360269235888,1360269261616,690619684,690645412,25728
1360269262,690645884,4,538,134.5,1360269235480,1360269235608,690619364,690619492,128
1360269266,690649644,3,138,46,1360269241736,1360269241800,690625380,690625444,64
1360269278,690661780,1,137,137,1360269251326,1360269251326,690635106,690635106,0
1360269282,690665720,15,4462,297.4666667,1360269254140,1360269254332,690637860,690638052,192
1360269286,690669836,6,336,56,1360269260037,1360269266117,690643873,690649953,6080
1360269286,690669844,3,168,56,1360269260542,1360269265534,690644386,690649378,4992
1360269290,690673696,3,168,56,1360269263507,1360269266131,690647203,690649827,2624
1360269290,690673700,1,56,56,1360269263759,1360269263759,690647459,690647459,0
1360269290,690673804,3,544,181.3333333,1360269263465,1360269263529,690647269,690647333,64
1360269290,690673808,1,96,96,1360269263780,1360269263780,690647588,690647588,0
1360269290,3623953236,2,112,56,1360269263227,1360269265659,3623926463,3623928895,2432
1360269302,690685820,4,538,134.5,1360269275349,1360269275477,690659169,690659297,128
1360269305,690688920,3,144,48,1360269296692,1360269302516,690680612,690686436,5824
1360269305,690688996,3,144,48,1360269296613,1360269302373,690680609,690686369,5760
1360269305,690688996,2,98,49,1360269296613,1360269302373,690680609,690686369,5760
1360269305,690689000,2,98,49,1360269296612,1360269302372,690680612,690686372,5760
1360269313,690697028,3,138,46,1360269309383,1360269309383,690693411,690693411,0
1360269313,690697028,2,92,46,1360269309382,1360269309382,690693410,690693410,0
1360269314,690697772,1,137,137,1360269289094,1360269289094,690672866,690672866,0
1360269318,690701768,3,288,96,1360269292300,1360269298892,690676068,690682660,6592
1360269318,690701796,5,280,56,1360269293231,1360269302575,690677027,690686371,9344
1360269318,690701800,5,280,56,1360269293610,1360269303594,690677410,690687394,9984
1360269318,690701848,2,112,56,1360269293691,1360269296251,690677539,690680099,2560
1360269318,690701880,3,168,56,1360269292060,1360269298524,690675940,690682404,6464
1360269322,3623984948,2,112,56,1360269294300,1360269296668,3623957248,3623959616,2368
1360269322,690705884,9,1961,217.8888889,1360269296149,1360269296469,690680033,690680353,320
1360269326,690709832,3,169,56.33333333,1360269298568,1360269298632,690682400,690682464,64
1360269330,690713900,3,544,181.3333333,1360269303495,1360269303559,690687395,690687459,64
1360269334,3623997148,2,92,46,1360269309589,1360269309653,3623972737,3623972801,64
1360269342,690725780,1,46,46,1360269315453,1360269315453,690699233,690699233,0
1360269342,690725872,4,544,136,1360269315361,1360269315809,690699233,690699681,448
1360269346,690729908,1,46,46,1360269319293,1360269319293,690703201,690703201,0
1360269350,3624013104,4,224,56,1360269323905,1360269330177,3623987009,3623993281,6272
1360269350,690734076,6,336,56,1360269324309,1360269329365,690708385,690713441,5056
1360269350,690734080,3,168,56,1360269324625,1360269328785,690708705,690712865,4160
1360269350,690734168,6,336,56,1360269323705,1360269329209,690707873,690713377,5504
1360269350,690734204,3,288,96,1360269324566,1360269328790,690708770,690712994,4224
1360269350,690734208,3,168,56,1360269325072,1360269329488,690709280,690713696,4416
1360269354,690738064,1,137,137,1360269327840,1360269327840,690711904,690711904,0
1360269361,690745120,6,497,82.83333333,1360269356587,1360269359467,690740707,690743587,2880
1360269369,690753068,13,5722,440.1538462,1360269367452,1360269368156,690751520,690752224,704
1360269369,690753160,17,12147,714.5294118,1360269368066,1360269368770,690752226,690752930,704
1360269370,690754184,2,123,61.5,1360269343275,1360269343275,690727459,690727459,0
1360269370,690754184,3,544,181.3333333,1360269343338,1360269343338,690727522,690727522,0
1360269377,690761036,4,184,46,1360269368957,1360269369085,690752993,690753121,128
1360269377,690761040,16,7756,484.75,1360269369147,1360269369531,690753187,690753571,384
1360269377,690761040,9,4877,541.8888889,1360269369147,1360269374395,690753187,690758435,5248
1360269377,690761048,10,4897,489.7,1360269369587,1360269375347,690753635,690759395,5760
1360269377,690761128,10,4897,489.7,1360269369507,1360269375331,690753635,690759459,5824
1360269377,690761156,11,5775,525,1360269367046,1360269372358,690751202,690756514,5312
1360269382,690766060,6,1277,212.8333333,1360269354918,1360269355430,690738978,690739490,512
1360269382,690766208,1,46,46,1360269356497,1360269356497,690740705,690740705,0
1360269382,690766244,23,1288,56,1360269357678,1360269381550,690741922,690765794,23872
1360269385,690769052,10,2356,235.6,1360269371373,1360269377325,690755425,690761377,5952
1360269385,690769160,10,2338,233.8,1360269371328,1360269377216,690755488,690761376,5888
1360269386,3624049172,11,616,56,1360269359419,1360269381947,3624022591,3624045119,22528
1360269386,690770084,11,616,56,1360269358989,1360269381581,690743073,690765665,22592
1360269386,690770120,23,1288,56,1360269357864,1360269381928,690741984,690766048,24064
1360269386,690770124,12,672,56,1360269357925,1360269383589,690742049,690767713,25664
1360269386,690770160,11,1056,96,1360269358275,1360269383683,690742435,690767843,25408
1360269390,690774092,1,137,137,1360269363717,1360269363717,690747809,690747809,0
1360269393,690777116,9,590,65.55555556,1360269380205,1360269385517,690764321,690769633,5312
1360269393,690777116,8,544,68,1360269380205,1360269385517,690764321,690769633,5312
1360269393,690777116,8,544,68,1360269380205,1360269385517,690764321,690769633,5312
1360269393,690777192,7,412,58.85714286,1360269387424,1360269387424,690771616,690771616,0
1360269393,690777200,7,498,71.14285714,1360269380122,1360269385434,690764322,690769634,5312
1360269393,690777200,8,544,68,1360269380122,1360269385434,690764322,690769634,5312
1360269394,690778132,19,7648,402.5263158,1360269367711,1360269368735,690751843,690752867,1024
1360269394,690778208,14,9412,672.2857143,1360269369681,1360269370129,690753889,690754337,448
1360269394,690778232,19,10204,537.0526316,1360269367032,1360269369656,690751264,690753888,2624
1360269394,690778252,7,2656,379.4285714,1360269368295,1360269368551,690752547,690752803,256
1360269398,690782168,47,42214,898.1702128,1360269370167,1360269379767,690754335,690763935,9600
1360269398,690782204,21,10362,493.4285714,1360269371157,1360269373589,690755361,690757793,2432
1360269401,690785120,5,324,64.8,1360269398058,1360269399274,690782178,690783394,1216
1360269406,690790256,9,5516,612.8888889,1360269380066,1360269380386,690764322,690764642,320
1360269410,690794148,3,544,181.3333333,1360269383371,1360269383435,690767519,690767583,64
1360269410,690794212,5,280,56,1360269385355,1360269399243,690769567,690783455,13888
1360269414,690798116,4,224,56,1360269387438,1360269397998,690771554,690782114,10560
1360269414,690798180,2,112,56,1360269389612,1360269394220,690773792,690778400,4608
1360269417,690801172,3,138,46,1360269411509,1360269411573,690795681,690795745,64
1360269418,3624081212,2,112,56,1360269392532,1360269395668,3624055744,3624058880,3136
1360269418,690802128,2,112,56,1360269393762,1360269398114,690777890,690782242,4352
1360269418,690802212,2,192,96,1360269393742,1360269398222,690777954,690782434,4480
1360269422,690806124,2,446,223,1360269394918,1360269395238,690779042,690779362,320
1360269434,690818248,1,137,137,1360269409384,1360269409384,690793632,690793632,0
1360269450,3624113152,2,112,56,1360269424721,1360269427153,3624087873,3624090305,2432
1360269450,690834140,4,224,56,1360269422678,1360269428374,690806818,690812514,5696
1360269450,690834288,2,498,249,1360269423295,1360269423295,690807583,690807583,0
1360269450,690834300,2,112,56,1360269424118,1360269426550,690808418,690810850,2432
1360269450,690834300,4,224,56,1360269424245,1360269435125,690808545,690819425,10880
1360269450,690834300,2,112,56,1360269424563,1360269434867,690808863,690819167,10304
1360269454,690838124,2,192,96,1360269426339,1360269435171,690810463,690819295,8832
1360269462,690846144,3,492,164,1360269434962,1360269435154,690819106,690819298,192
1360269478,690862160,1,137,137,1360269451454,1360269451454,690835614,690835614,0
1360269478,690862300,6,336,56,1360269452661,1360269463669,690836961,690847969,11008
1360269478,690862304,3,168,56,1360269453231,1360269457967,690837535,690842271,4736
1360269482,3624145176,3,168,56,1360269454651,1360269459003,3624117827,3624122179,4352
1360269482,690866152,5,280,56,1360269454345,1360269463497,690838497,690847649,9152
1360269482,690866176,2,112,56,1360269454576,1360269457392,690838752,690841568,2816
1360269482,690866180,2,192,96,1360269454638,1360269457582,690838818,690841762,2944
1360269489,690873240,3,138,46,1360269485358,1360269485422,690869598,690869662,64
1360269489,690873320,3,138,46,1360269485278,1360269485342,690869598,690869662,64
1360269490,690874308,3,544,181.3333333,1360269463340,1360269463404,690847648,690847712,64
1360269497,690881204,3,138,46,1360269489428,1360269490644,690873632,690874848,1216
1360269497,690881252,3,169,56.33333333,1360269496358,1360269496358,690880610,690880610,0
1360269502,690886292,3,492,164,1360269475131,1360269475259,690859423,690859551,128
1360269511,690894480,1,137,137,1360269484455,1360269484455,690867935,690867935,0
1360269511,690894576,1,46,46,1360269485064,1360269485064,690868640,690868640,0
1360269511,690894576,1,46,46,1360269485064,1360269485064,690868640,690868640,0
1360269514,3624177412,2,112,56,1360269488655,1360269490831,3624152067,3624154243,2176
1360269515,690898484,4,224,56,1360269488228,1360269491556,690871712,690875040,3328
1360269515,690898484,4,224,56,1360269488227,1360269491619,690871711,690875103,3392
1360269515,690898568,3,168,56,1360269487566,1360269491662,690871134,690875230,4096
1360269515,690898572,3,288,96,1360269487629,1360269492621,690871201,690876193,4992
1360269515,690898604,2,112,56,1360269488876,1360269491116,690872480,690874720,2240
1360269521,690905368,256,298408,1165.65625,1360269372848,1360269513264,690757216,690897632,140416
1360269531,690914640,3,544,181.3333333,1360269504135,1360269504199,690887775,690887839,64
1360269543,690926496,3,492,164,1360269516054,1360269516182,690899550,690899678,128
1360269543,690926500,1,137,137,1360269516180,1360269516180,690899680,690899680,0
1360269546,3624209412,3,168,56,1360269519821,1360269523917,3624183233,3624187329,4096
1360269547,690930484,3,288,96,1360269521699,1360269524835,690905183,690908319,3136
1360269547,690930536,3,168,56,1360269520241,1360269524081,690903777,690907617,3840
1360269547,690930568,3,168,56,1360269521423,1360269524687,690904991,690908255,3264
1360269547,690930608,7,392,56,1360269519783,1360269525159,690903391,690908767,5376
1360269547,690930612,6,336,56,1360269519844,1360269524516,690903456,690908128,4672
1360269571,690954696,3,544,181.3333333,1360269544208,1360269544208,690927904,690927904,0
1360269574,3624237356,4,224,56,1360269547269,1360269555269,3624210625,3624218625,8000
1360269575,690958548,7,392,56,1360269548066,1360269555938,690931614,690939486,7872
1360269575,690958652,8,448,56,1360269547450,1360269558778,690931102,690942430,11328
1360269575,690958656,4,224,56,1360269547512,1360269553400,690931168,690937056,5888
1360269575,690958664,3,168,56,1360269548144,1360269552816,690931808,690936480,4672
1360269575,690958692,3,288,96,1360269549009,1360269552849,690932701,690936541,3840
1360269583,690966656,1,137,137,1360269558775,1360269558775,690942431,690942431,0
1360269583,690966688,3,492,164,1360269555544,1360269555672,690939232,690939360,128
1360269601,690985268,6,497,82.83333333,1360269597265,1360269600209,690981533,690984477,2944
1360269607,690990672,3,168,56,1360269582632,1360269586280,690966304,690969952,3648
1360269609,690993196,3,288,96,1360269582234,1360269585882,690966430,690970078,3648
1360269609,690993268,2,98,49,1360269597075,1360269602387,690981343,690986655,5312
1360269609,690993268,2,98,49,1360269597075,1360269602387,690981343,690986655,5312
1360269609,690993340,3,144,48,1360269597003,1360269602379,690981343,690986719,5376
1360269610,3624273404,3,168,56,1360269583512,1360269587096,3624246916,3624250500,3584
1360269611,690994588,5,280,56,1360269582907,1360269586555,690966495,690970143,3648
1360269611,690994592,5,280,56,1360269583029,1360269586677,690966621,690970269,3648
1360269611,690994680,3,168,56,1360269583005,1360269586653,690966685,690970333,3648
1360269611,690994748,2,498,249,1360269584218,1360269584218,690967966,690967966,0
1360269619,691002756,1,137,137,1360269592017,1360269592017,690975773,690975773,0
1360269623,691006692,3,492,164,1360269595921,1360269596049,690979613,690979741,128
1360269623,691006708,11,2098,190.7272727,1360269596929,1360269613313,690980637,690997021,16384
1360269623,691006736,1,46,46,1360269597798,1360269597798,690981534,690981534,0
1360269638,3624301456,2,112,56,1360269613793,1360269615713,3624277249,3624279169,1920
1360269639,691022584,5,280,56,1360269612160,1360269616448,690995744,691000032,4288
1360269639,691022608,3,288,96,1360269612454,1360269617190,690996062,691000798,4736
1360269639,691022656,6,336,56,1360269610997,1360269617397,690994653,691001053,6400
1360269639,691022696,3,168,56,1360269612238,1360269616462,690995934,691000158,4224
1360269639,691022708,2,112,56,1360269612996,1360269615940,690996704,690999648,2944
1360269651,691034672,3,544,181.3333333,1360269624422,1360269624422,691008094,691008094,0
1360269651,691034772,1,137,137,1360269624704,1360269624704,691008476,691008476,0
1360269663,691047012,3,492,164,1360269635091,1360269635219,691019103,691019231,128
1360269670,3624333456,2,112,56,1360269645408,1360269648864,3624308864,3624312320,3456
1360269671,691054948,4,224,56,1360269645648,1360269649680,691029596,691033628,4032
1360269671,691055032,5,280,56,1360269644926,1360269649662,691028958,691033694,4736
1360269671,691055032,3,168,56,1360269645053,1360269650237,691029085,691034269,5184
1360269675,691058908,2,192,96,1360269647225,1360269649465,691031133,691033373,2240
1360269675,691059020,2,112,56,1360269646984,1360269649288,691031004,691033308,2304
1360269691,691074960,3,544,181.3333333,1360269664198,1360269664262,691048158,691048222,64
1360269691,691074964,1,137,137,1360269664386,1360269664386,691048350,691048350,0
1360269703,691086932,3,492,164,1360269675936,1360269676064,691059868,691059996,128
1360269706,3624369624,3,168,56,1360269680697,1360269684921,3624344321,3624348545,4224
1360269707,691091012,5,280,56,1360269681103,1360269685391,691065115,691069403,4288
1360269707,691091020,3,168,56,1360269681354,1360269685450,691065374,691069470,4096
1360269707,691091044,3,288,96,1360269681457,1360269686193,691065501,691070237,4736
1360269707,691091128,5,280,56,1360269680926,1360269685150,691065054,691069278,4224
1360269711,691094916,2,112,56,1360269682927,1360269685167,691066843,691069083,2240
1360269729,691113380,3,138,46,1360269728351,1360269728415,691112731,691112795,64
1360269731,691115044,3,544,181.3333333,1360269704239,1360269704239,691088283,691088283,0
1360269731,691115136,1,137,137,1360269703765,1360269703765,691087901,691087901,0
1360269739,691123004,2,112,56,1360269713751,1360269717207,691097755,691101211,3456
1360269739,691123016,2,112,56,1360269714187,1360269717131,691098203,691101147,2944
1360269739,691123020,1,56,56,1360269714314,1360269714314,691098334,691098334,0
1360269742,3624405648,1,56,56,1360269714659,1360269714659,3624378307,3624378307,0
1360269743,691127120,3,492,164,1360269716386,1360269716514,691100506,691100634,128
1360269743,691127132,1,56,56,1360269717270,1360269717270,691101402,691101402,0
1360269763,691147120,1,137,137,1360269735716,1360269735716,691119836,691119836,0
1360269770,3624433696,2,112,56,1360269745073,1360269747761,3624408769,3624411457,2688
1360269771,691155036,2,192,96,1360269743734,1360269747446,691127770,691131482,3712
1360269771,691155080,2,112,56,1360269744970,1360269747914,691129050,691131994,2944
1360269771,691155192,2,498,249,1360269744157,1360269744221,691128349,691128413,64
1360269771,691155196,4,224,56,1360269744791,1360269749527,691128987,691133723,4736
1360269771,691155200,4,224,56,1360269744725,1360269749205,691128925,691133405,4480
1360269775,691159152,1,56,56,1360269747011,1360269747011,691131163,691131163,0
1360269783,691167032,3,492,164,1360269756156,1360269756284,691140188,691140316,128
1360269799,691183032,1,137,137,1360269771129,1360269771129,691155161,691155161,0
1360269803,691187068,8,448,56,1360269778136,1360269784920,691162204,691168988,6784
1360269803,691187084,4,224,56,1360269778568,1360269783688,691162652,691167772,5120
1360269803,691187144,4,224,56,1360269777739,1360269781067,691161883,691165211,3328
1360269803,691187148,4,384,96,1360269777801,1360269781321,691161949,691165469,3520
1360269803,691187156,7,392,56,1360269778175,1360269783231,691162331,691167387,5056
1360269806,3624469784,4,224,56,1360269778393,1360269784025,3624442177,3624447809,5632
1360269811,691195108,3,544,181.3333333,1360269784367,1360269784367,691168475,691168475,0
1360269823,691207352,3,492,164,1360269795834,1360269795962,691180186,691180314,128
1360269832,691215476,1,137,137,1360269805094,1360269805094,691188570,691188570,0
1360269835,691219380,7,392,56,1360269809501,1360269815709,691193881,691200089,6208
1360269836,691219416,3,168,56,1360269811426,1360269815138,691194842,691198554,3712
1360269836,691219488,4,224,56,1360269810522,1360269816922,691194010,691200410,6400
1360269836,691219492,3,288,96,1360269810646,1360269814294,691194138,691197786,3648
1360269836,691219496,6,336,56,1360269810771,1360269816531,691194267,691200027,5760
1360269838,3624501740,3,168,56,1360269810694,1360269815622,3624474434,3624479362,4928
1360269852,691235588,3,544,181.3333333,1360269824952,1360269825016,691208540,691208604,64
1360269864,691247432,3,492,164,1360269837266,1360269837394,691220698,691220826,128
1360269864,691247472,11,616,56,1360269838635,1360269843947,691222107,691227419,5312
1360269864,691247576,6,576,96,1360269838400,1360269843776,691221976,691227352,5376
1360269867,3624529860,5,280,56,1360269840376,1360269843000,3624503236,3624505860,2624
1360269868,691251436,11,616,56,1360269840207,1360269844047,691223643,691227483,3840
1360269868,691251464,5,280,56,1360269840624,1360269843376,691224088,691226840,2752
1360269868,691251548,6,336,56,1360269840224,1360269844256,691223772,691227804,4032
1360269868,691251560,1,137,137,1360269842772,1360269842772,691226332,691226332,0
1360269892,691275636,3,544,181.3333333,1360269865031,1360269865095,691248667,691248731,64
1360269895,3624557896,3,168,56,1360269870226,1360269876562,3624533122,3624539458,6336
1360269896,691279552,5,280,56,1360269871769,1360269876825,691255321,691260377,5056
1360269896,691279628,5,280,56,1360269870414,1360269876622,691254042,691260250,6208
1360269900,691283636,2,112,56,1360269872196,1360269875204,691255832,691258840,3008
1360269900,691283716,3,168,56,1360269871668,1360269899252,691255384,691282968,27584
1360269900,691283716,3,288,96,1360269871732,1360269899444,691255448,691283160,27712
1360269904,691287612,3,492,164,1360269876509,1360269876573,691260121,691260185,64
1360269906,691289504,2,98,49,1360269898058,1360269903178,691281562,691286682,5120
1360269906,691289504,3,144,48,1360269898058,1360269903178,691281562,691286682,5120
1360269912,691295628,1,137,137,1360269886028,1360269886028,691269656,691269656,0
1360269924,691307588,8,1347,168.375,1360269897463,1360269897719,691281051,691281307,256
1360269924,691307668,6,336,56,1360269899687,1360269905383,691283355,691289051,5696
1360269927,3624589924,3,168,56,1360269901303,1360269905207,3624564227,3624568131,3904
1360269928,691311500,3,168,56,1360269900173,1360269905037,691283673,691288537,4864
1360269928,691311540,2,112,56,1360269901860,1360269903524,691285400,691287064,1664
1360269928,691311588,5,280,56,1360269899831,1360269904631,691283419,691288219,4800
1360269928,691311636,2,192,96,1360269901703,1360269904263,691285339,691287899,2560
1360269932,691315572,3,544,181.3333333,1360269905220,1360269905220,691288792,691288792,0
1360269944,691327516,3,492,164,1360269916862,1360269916990,691300378,691300506,128
1360269948,691331520,1,137,137,1360269920186,1360269920186,691303706,691303706,0
1360269959,3624621864,4,224,56,1360269934387,1360269938547,3624597251,3624601411,4160
1360269960,691343564,4,224,56,1360269933835,1360269937099,691317399,691320663,3264
1360269960,691343568,4,224,56,1360269934217,1360269938121,691317785,691321689,3904
1360269960,691343644,9,504,56,1360269933436,1360269945532,691317080,691329176,12096
1360269960,691343648,4,384,96,1360269933691,1360269937659,691317339,691321307,3968
1360269960,691343652,8,448,56,1360269934007,1360269945207,691317659,691328859,11200
1360269972,691355692,3,544,181.3333333,1360269945227,1360269945227,691328919,691328919,0
1360269984,691367804,3,492,164,1360269956830,1360269956958,691340634,691340762,128
1360269988,691371864,5,280,56,1360269962975,1360269968927,691346839,691352791,5952
1360269988,691371868,1,137,137,1360269961309,1360269961309,691345177,691345177,0
1360269988,691371892,10,560,56,1360269963139,1360269969795,691347031,691353687,6656
1360269988,691371896,5,280,56,1360269963328,1360269969408,691347224,691353304,6080
1360269988,691371972,5,480,96,1360269962931,1360269968883,691346903,691352855,5952
1360269988,691371980,9,504,56,1360269963178,1360269969130,691347158,691353110,5952
1360269991,3624653896,5,280,56,1360269963862,1360269969878,3624626758,3624632774,6016
1360270012,691395892,3,544,181.3333333,1360269985092,1360269985092,691368984,691368984,0
1360270018,691401652,3,138,46,1360270013044,1360270013108,691396696,691396760,64
1360270020,691403896,10,560,56,1360269995074,1360270000386,691378970,691384282,5312
1360270020,691403924,5,480,96,1360269995684,1360269999780,691379608,691383704,4096
1360270020,691404016,5,280,56,1360269995463,1360269999623,691379479,691383639,4160
1360270023,3624685928,5,280,56,1360269997494,1360270001270,3624660422,3624664198,3776
1360270024,691407924,2,446,223,1360269996197,1360269996325,691380121,691380249,128
1360270024,691407952,10,560,56,1360269996807,1360270004807,691380759,691388759,8000
1360270024,691407956,5,280,56,1360269996997,1360270000517,691380953,691384473,3520
1360270032,691415856,1,137,137,1360270004903,1360270004903,691388759,691388759,0
1360270052,691435924,6,336,56,1360270026980,1360270032932,691410904,691416856,5952
1360270052,691436008,3,544,181.3333333,1360270025041,1360270025105,691409049,691409113,64
1360270052,691436036,3,168,56,1360270026930,1360270031730,691410966,691415766,4800
1360270055,3624718112,2,112,56,1360270028989,1360270031677,3624692101,3624694789,2688
1360270056,691439884,5,280,56,1360270028554,1360270032778,691412438,691416662,4224
1360270056,691439888,2,112,56,1360270028745,1360270029769,691412633,691413657,1024
1360270056,691439972,3,288,96,1360270027829,1360270031861,691411801,691415833,4032
1360270064,691447900,3,492,164,1360270036155,1360270036283,691420055,691420183,128
1360270072,691455980,1,137,137,1360270046636,1360270046636,691430616,691430616,0
1360270084,691467984,3,168,56,1360270058981,1360270062693,691442965,691446677,3712
1360270084,691467984,3,168,56,1360270056933,1360270061669,691440917,691445653,4736
1360270084,691467988,3,288,96,1360270059107,1360270062755,691443095,691446743,3648
1360270084,691468072,6,336,56,1360270058830,1360270065358,691442902,691449430,6528
1360270084,691468096,6,336,56,1360270058677,1360270065077,691442773,691449173,6400
1360270087,3624750124,3,168,56,1360270058994,1360270062002,3624722118,3624725126,3008
1360270092,691475976,3,544,181.3333333,1360270065197,1360270065261,691449173,691449237,64
1360270104,691487940,3,492,164,1360270076435,1360270076563,691460375,691460503,128
1360270115,3624778176,2,112,56,1360270089214,1360270090878,3624752390,3624754054,1664
1360270116,691499960,4,224,56,1360270089853,1360270093565,691473813,691477525,3712
1360270116,691499964,2,112,56,1360270089977,1360270091577,691473941,691475541,1600
1360270116,691499968,2,192,96,1360270090037,1360270093365,691474005,691477333,3328
1360270116,691499996,3,168,56,1360270088857,1360270093721,691472853,691477717,4864
1360270116,691500004,1,137,137,1360270090642,1360270090642,691474646,691474646,0
1360270116,691500112,4,224,56,1360270088998,1360270093286,691473110,691477398,4288
1360270120,691504068,4,656,164,1360270093011,1360270093459,691477079,691477527,448
1360270132,691516320,3,544,181.3333333,1360270104916,1360270104980,691489236,691489300,64
1360270144,691528272,3,492,164,1360270116036,1360270116164,691500308,691500436,128
1360270148,691532272,6,336,56,1360270123653,1360270127877,691507925,691512149,4224
1360270148,691532280,3,288,96,1360270123836,1360270127292,691508116,691511572,3456
1360270148,691532360,6,336,56,1360270123438,1360270127342,691507798,691511702,3904
1360270148,691532364,3,168,56,1360270123691,1360270126763,691508055,691511127,3072
1360270151,3624814136,3,168,56,1360270123047,1360270127079,3624786183,3624790215,4032
1360270152,691536380,2,112,56,1360270124057,1360270126361,691508437,691510741,2304
1360270160,691544304,1,137,137,1360270134183,1360270134183,691518487,691518487,0
1360270170,691553680,3,144,48,1360270168661,1360270168725,691552341,691552405,64
1360270173,691556420,5,1042,208.4,1360270145945,1360270170265,691529365,691553685,24320
1360270178,691561668,2,98,49,1360270170080,1360270175840,691553748,691559508,5760
1360270178,691561668,3,144,48,1360270170080,1360270175840,691553748,691559508,5760
1360270178,691561680,4,410,102.5,1360270170711,1360270173719,691554391,691557399,3008
1360270178,691561680,3,144,48,1360270169365,1360270174805,691553045,691558485,5440
1360270178,691561716,3,144,48,1360270167792,1360270173744,691551508,691557460,5952
1360270178,691561748,3,144,48,1360270170003,1360270175763,691553751,691559511,5760
1360270178,691561748,2,98,49,1360270170003,1360270175763,691553751,691559511,5760
1360270178,691561760,1799,2397300,1332.573652,1360270169286,1360270175814,691553046,691559574,6528
1360270178,691561800,2,98,49,1360270167708,1360270173660,691551508,691557460,5952
1360270181,691564464,3,168,56,1360270156271,1360270175215,691539735,691558679,18944
1360270181,691564468,3,492,164,1360270156586,1360270156714,691540054,691540182,128
1360270183,3624846156,3,168,56,1360270158164,1360270174996,3624821320,3624838152,16832
1360270185,691568456,6,336,56,1360270158708,1360270177076,691542164,691560532,18368
1360270185,691568456,3,168,56,1360270158901,1360270176629,691542357,691560085,17728
1360270185,691568544,6,336,56,1360270158557,1360270177309,691542101,691560853,18752
1360270185,691568544,3,288,96,1360270158685,1360270176861,691542229,691560405,18176
1360270193,691576440,4,804,201,1360270168069,1360270168261,691551509,691551701,192
1360270193,691576440,9,2220,246.6666667,1360270168069,1360270176709,691551509,691560149,8640
1360270193,691576440,5,3046,609.2,1360270168069,1360270168325,691551509,691551765,256
1360270193,691576440,5,1200,240,1360270168069,1360270175045,691551509,691558485,6976
1360270193,691576472,26,18948,728.7692308,1360270168038,1360270177126,691551510,691560598,9088
1360270193,691576476,12,3446,287.1666667,1360270168738,1360270168866,691552214,691552342,128
1360270193,691576556,15,16054,1070.266667,1360270167890,1360270168018,691551446,691551574,128
1360270193,691576556,4,548,137,1360270167953,1360270168721,691551509,691552277,768
1360270194,691577804,41895,57313597,1368.029526,1360269197531,1360270189659,690581335,691573463,992128
1360270196,691580392,5,648,129.6,1360270169357,1360270169485,691553749,691553877,128
1360270196,691580392,3,336,112,1360270169356,1360270169484,691553748,691553876,128
1360270196,691580392,12,3013,251.0833333,1360270168012,1360270168204,691552404,691552596,192
1360270197,691580480,1,137,137,1360270170206,1360270170206,691553686,691553686,0
1360270197,691580512,1,46,46,1360270170877,1360270170877,691554389,691554389,0
1360270213,691596460,3,544,181.3333333,1360270185968,1360270186032,691569428,691569492,64
1360270224,691608276,3,492,164,1360270195906,1360270196034,691580182,691580310,128
1360270225,691608412,6,1154,192.3333333,1360270197986,1360270198242,691581398,691581654,256
1360270225,691608532,5,3559,711.8,1360270198506,1360270198634,691582038,691582166,128
1360270229,691612456,1,56,56,1360270201910,1360270201910,691585366,691585366,0
1360270231,3624894448,1,56,56,1360270205294,1360270205294,3624868742,3624868742,0
1360270233,691616420,1,137,137,1360270205975,1360270205975,691589395,691589395,0
1360270241,691624488,2,123,61.5,1360270212949,1360270212949,691596437,691596437,0
1360270241,691624524,2,123,61.5,1360270213936,1360270213936,691597460,691597460,0
1360270253,691636560,3,544,181.3333333,1360270225933,1360270225997,691609493,691609557,64
1360270257,691640472,4,224,56,1360270231075,1360270240291,691614547,691623763,9216
1360270257,691640560,4,224,56,1360270230923,1360270237003,691614483,691620563,6080
1360270259,3624922368,1,56,56,1360270234880,1360270234880,3624898248,3624898248,0
1360270261,691644428,1,56,56,1360270234320,1360270234320,691617748,691617748,0
1360270261,691644464,2,192,96,1360270233708,1360270236844,691617172,691620308,3136
1360270261,691644596,3,492,164,1360270236585,1360270236713,691620181,691620309,128
1360270261,691644596,1,56,56,1360270236585,1360270236585,691620181,691620181,0
1360270265,691648552,1,137,137,1360270240212,1360270240212,691623764,691623764,0
1360270285,691668492,2,123,61.5,1360270257937,1360270258001,691641429,691641493,64
1360270285,691668572,2,123,61.5,1360270258881,1360270258881,691642453,691642453,0
1360270289,691672816,2,112,56,1360270264204,1360270267980,691648020,691651796,3776
1360270289,691672820,2,112,56,1360270264519,1360270266439,691648339,691650259,1920
1360270289,691672820,2,112,56,1360270264646,1360270266502,691648466,691650322,1856
1360270291,3624954348,1,56,56,1360270264147,1360270264147,3624927495,3624927495,0
1360270293,691676740,1,96,96,1360270266263,1360270266263,691650003,691650003,0
1360270293,691676848,1,56,56,1360270266089,1360270266089,691649937,691649937,0
1360270293,691676888,3,544,181.3333333,1360270265732,1360270265796,691649620,691649684,64
1360270305,691688784,1,137,137,1360270277612,1360270277612,691661396,691661396,0
1360270305,691688864,3,492,164,1360270276891,1360270277019,691660755,691660883,128
1360270306,691689824,8,458,57.25,1360270303618,1360270303682,691687442,691687506,64
1360270306,691689892,8,458,57.25,1360270302529,1360270302593,691686421,691686485,64
1360270309,691692812,1,46,46,1360270283855,1360270283855,691667667,691667667,0
1360270309,691692892,2,92,46,1360270282815,1360270282815,691666707,691666707,0
1360270309,691692908,2,92,46,1360270283760,1360270283824,691667668,691667732,64
1360270309,691692908,2,92,46,1360270283760,1360270283824,691667668,691667732,64
1360270313,691696860,1,46,46,1360270285854,1360270285854,691669714,691669714,0
1360270313,691696944,2,92,46,1360270285773,1360270285773,691669717,691669717,0
1360270313,691696980,3,138,46,1360270287400,1360270287464,691671380,691671444,64
1360270314,691697864,3,138,46,1360270312860,1360270312988,691696724,691696852,128
1360270317,691700764,2,92,46,1360270289919,1360270289919,691673683,691673683,0
1360270317,691700844,1,46,46,1360270291822,1360270291822,691675666,691675666,0
1360270317,691700844,2,92,46,1360270291823,1360270291887,691675667,691675731,64
1360270323,3624986424,4,224,56,1360270297032,1360270305992,3624960456,3624969416,8960
1360270325,691708768,6,336,56,1360270298555,1360270302715,691682323,691686483,4160
1360270325,691708768,6,336,56,1360270298491,1360270303675,691682259,691687443,5184
1360270325,691708796,3,288,96,1360270298717,1360270302301,691682513,691686097,3584
1360270325,691708804,3,168,56,1360270299159,1360270305879,691682963,691689683,6720
1360270325,691708880,3,168,56,1360270298507,1360270301963,691682387,691685843,3456
1360270333,691716856,3,544,181.3333333,1360270305891,1360270305891,691689747,691689747,0
1360270341,691724864,3,492,164,1360270316700,1360270316828,691700564,691700692,128
1360270345,691728820,1,137,137,1360270318406,1360270318406,691702226,691702226,0
1360270353,691736860,8,448,56,1360270328608,1360270333792,691712468,691717652,5184
1360270353,691736860,8,448,56,1360270328479,1360270333471,691712339,691717331,4992
1360270355,3625018408,3,168,56,1360270330391,1360270332695,3624993799,3624996103,2304
1360270357,691740824,4,384,96,1360270329792,1360270333440,691713616,691717264,3648
1360270357,691740908,4,224,56,1360270329646,1360270333230,691713554,691717138,3584
1360270373,691756928,4,996,249,1360270345882,1360270346138,691729810,691730066,256
1360270377,691760932,1,137,137,1360270349717,1360270349717,691733649,691733649,0
1360270381,691765040,3,492,164,1360270356458,1360270356522,691740498,691740562,64
1360270385,691768896,4,224,56,1360270360441,1360270364665,691744337,691748561,4224
1360270385,691768988,7,392,56,1360270360606,1360270365342,691744594,691749330,4736
1360270385,691769012,7,392,56,1360270360455,1360270365255,691744467,691749267,4800
1360270387,3625050356,4,224,56,1360270360460,1360270365196,3625023816,3625028552,4736
1360270389,691772872,4,384,96,1360270361745,1360270365841,691745617,691749713,4096
1360270389,691772964,4,224,56,1360270361524,1360270365428,691745488,691749392,3904
1360270413,691796832,3,544,181.3333333,1360270386105,1360270386105,691769937,691769937,0
1360270417,691800928,1,137,137,1360270392475,1360270392475,691776403,691776403,0
1360270418,691802092,6,502,83.66666667,1360270411318,1360270414390,691795410,691798482,3072
1360270419,3625082624,4,224,56,1360270394814,1360270399294,3625058438,3625062918,4480
1360270421,691804868,8,448,56,1360270394775,1360270420247,691778643,691804115,25472
1360270421,691804876,8,448,56,1360270394959,1360270420431,691778835,691804307,25472
1360270421,691804880,4,224,56,1360270395083,1360270399627,691778963,691783507,4544
1360270421,691804884,4,224,56,1360270395460,1360270420548,691779344,691804432,25088
1360270421,691804884,3,288,96,1360270395527,1360270397895,691779411,691781779,2368
1360270421,691804908,3,492,164,1360270396268,1360270396396,691780176,691780304,128
1360270437,691820900,1,46,46,1360270411508,1360270411508,691795408,691795408,0
1360270448,3625110796,4,224,56,1360270421819,1360270428667,3625084615,3625091463,6848
1360270449,691832840,5,480,96,1360270420912,1360270431408,691804752,691815248,10496
1360270449,691832844,9,504,56,1360270421227,1360270436395,691805071,691820239,15168
1360270449,691832852,4,224,56,1360270421924,1360270431332,691805776,691815184,9408
1360270449,691832932,9,504,56,1360270420883,1360270431699,691804815,691815631,10816
1360270449,691832932,5,280,56,1360270421204,1360270436564,691805136,691820496,15360
1360270453,691836856,2,498,249,1360270426144,1360270426208,691810000,691810064,64
1360270453,691836864,1,137,137,1360270426331,1360270426331,691810195,691810195,0
1360270461,691845000,3,492,164,1360270436240,1360270436368,691820240,691820368,128
1360270477,691860980,5,280,56,1360270452580,1360270457636,691836560,691841616,5056
1360270477,691860980,5,280,56,1360270452516,1360270457892,691836496,691841872,5376
1360270479,3625142688,3,168,56,1360270451774,1360270456958,3625115462,3625120646,5184
1360270481,691864912,2,112,56,1360270453098,1360270456810,691837010,691840722,3712
1360270481,691865036,2,192,96,1360270455147,1360270456747,691839183,691840783,1600
1360270481,691865072,2,112,56,1360270455623,1360270457095,691839695,691841167,1472
1360270489,691873000,1,137,137,1360270463826,1360270463826,691847826,691847826,0
1360270493,691876928,4,608,152,1360270466455,1360270466519,691850383,691850447,64
1360270501,691884992,3,492,164,1360270476183,1360270476311,691860175,691860303,128
1360270506,691890140,3,144,48,1360270498372,1360270503620,691882512,691887760,5248
1360270508,3625170800,4,224,56,1360270483320,1360270487224,3625146120,3625150024,3904
1360270509,691892952,9,504,56,1360270482562,1360270488258,691866514,691872210,5696
1360270509,691892952,4,224,56,1360270482688,1360270486592,691866640,691870544,3904
1360270509,691893024,5,280,56,1360270482039,1360270487415,691866063,691871439,5376
1360270509,691893024,5,480,96,1360270482102,1360270487670,691866126,691871694,5568
1360270509,691893056,9,504,56,1360270482328,1360270487896,691866384,691871952,5568
1360270525,691908976,6,3854,642.3333333,1360270498535,1360270498663,691882511,691882639,128
1360270525,691909000,8,1327,165.875,1360270497745,1360270498193,691881745,691882193,448
1360270529,691913112,1,137,137,1360270503648,1360270503648,691887760,691887760,0
1360270533,691916972,3,544,181.3333333,1360270506283,1360270506283,691890255,691890255,0
1360270541,691925032,2,446,223,1360270516080,1360270516208,691900112,691900240,128
1360270544,3625206788,3,168,56,1360270517956,1360270520580,3625180744,3625183368,2624
1360270545,691928980,4,224,56,1360270517218,1360270521570,691901198,691905550,4352
1360270545,691929104,6,336,56,1360270517417,1360270521065,691901521,691905169,3648
1360270545,691929108,6,336,56,1360270517861,1360270521189,691901969,691905297,3328
1360270545,691929108,3,168,56,1360270517924,1360270520868,691902032,691904976,2944
1360270545,691929108,3,288,96,1360270518051,1360270520931,691902159,691905039,2880
1360270573,691957044,1,137,137,1360270545765,1360270545765,691929809,691929809,0
1360270573,691957092,3,544,181.3333333,1360270546228,1360270546292,691930320,691930384,64
1360270577,691961056,3,168,56,1360270551896,1360270555608,691935952,691939664,3712
1360270577,691961056,3,288,96,1360270552151,1360270555671,691936207,691939727,3520
1360270577,691961160,6,336,56,1360270551728,1360270555952,691935888,691940112,4224
1360270577,691961164,6,336,56,1360270551597,1360270555821,691935761,691939985,4224
1360270577,691961168,3,168,56,1360270552487,1360270556071,691936655,691940239,3584
1360270580,3625242840,4,224,56,1360270552207,1360270556943,3625215047,3625219783,4736
1360270581,691965068,3,492,164,1360270556044,1360270556172,691940112,691940240,128
1360270586,691970188,16129,22182307,1375.305785,1360270196434,1360270585042,691580622,691969230,388608
1360270601,691985040,3,604,201.3333333,1360270573605,1360270573861,691957645,691957901,256
1360270605,691989032,1,137,137,1360270578159,1360270578159,691962191,691962191,0
1360270613,691997048,3,544,181.3333333,1360270586334,1360270586334,691970382,691970382,0
1360270621,692005208,3,492,164,1360270596351,1360270596479,691980559,691980687,128
1360270637,692021244,1,137,137,1360270610779,1360270610779,691995023,691995023,0
1360270641,692025112,2,92,46,1360270613598,1360270613662,691997710,691997774,64
1360270649,692033200,15,840,56,1360270624261,1360270632709,692008461,692016909,8448
1360270649,692033200,15,840,56,1360270624325,1360270635973,692008525,692020173,11648
1360270649,692033204,8,448,56,1360270624450,1360270636226,692008654,692020430,11776
1360270649,692033204,7,672,96,1360270624577,1360270632065,692008781,692016269,7488
1360270652,3625315120,7,392,56,1360270625721,1360270632889,3625288841,3625296009,7168
1360270653,692037140,2,498,249,1360270626305,1360270626305,692010445,692010445,0
1360270653,692037228,7,392,56,1360270625002,1360270632298,692009230,692016526,7296
1360270658,692042192,30,25661,855.3666667,1360270652236,1360270655308,692036428,692039500,3072
1360270661,692045304,3,492,164,1360270635870,1360270635998,692020174,692020302,128
1360270677,692061232,1,137,137,1360270648932,1360270648932,692033164,692033164,0
1360270677,692061404,1,46,46,1360270652026,1360270652026,692036430,692036430,0
1360270684,3625347244,5,280,56,1360270658363,1360270665339,3625321607,3625328583,6976
1360270685,692069236,5,280,56,1360270658082,1360270664866,692042318,692049102,6784
1360270685,692069236,5,480,96,1360270657058,1360270664354,692041294,692048590,7296
1360270685,692069236,10,560,56,1360270657120,1360270665248,692041356,692049484,8128
1360270685,692069248,10,560,56,1360270657492,1360270666260,692041740,692050508,8768
1360270685,692069268,5,280,56,1360270658370,1360270666562,692042638,692050830,8192
1360270690,692074240,3,138,46,1360270689436,1360270689500,692073676,692073740,64
1360270693,692077368,3,544,181.3333333,1360270666203,1360270666203,692050571,692050571,0
1360270702,692085420,3,492,164,1360270676752,1360270676880,692060172,692060300,128
1360270716,3625379164,7,392,56,1360270691405,1360270697933,3625354569,3625361097,6528
1360270717,692101272,7,672,96,1360270690428,1360270696892,692074700,692081164,6464
1360270717,692101300,7,392,56,1360270690785,1360270697249,692075085,692081549,6464
1360270717,692101312,7,392,56,1360270691604,1360270698388,692075916,692082700,6784
1360270717,692101384,14,784,56,1360270690380,1360270697996,692074764,692082380,7616
1360270717,692101388,14,784,56,1360270690695,1360270698055,692075083,692082443,7360
1360270718,692101428,1,137,137,1360270692873,1360270692873,692076301,692076301,0
1360270734,692117472,3,544,181.3333333,1360270707166,1360270707230,692090638,692090702,64
1360270742,692125612,3,492,164,1360270716496,1360270716624,692100108,692100236,128
1360270750,692133452,5,480,96,1360270725551,1360270730799,692109003,692114251,5248
1360270750,692133452,9,504,56,1360270725678,1360270730990,692109130,692114442,5312
1360270752,3625415188,5,280,56,1360270725749,1360270731765,3625388937,3625394953,6016
1360270753,692137368,9,504,56,1360270724891,1360270730843,692109259,692115211,5952
1360270753,692137404,1,137,137,1360270726455,1360270726455,692110859,692110859,0
1360270754,692137464,5,280,56,1360270725989,1360270731813,692109453,692115277,5824
1360270754,692137508,4,224,56,1360270727928,1360270730680,692111436,692114188,2752
1360270774,692157480,3,544,181.3333333,1360270747284,1360270747284,692130764,692130764,0
1360270780,3625443156,7,392,56,1360270755221,1360270760661,3625418377,3625423817,5440
1360270781,692165408,7,392,56,1360270753780,1360270759540,692138188,692143948,5760
1360270782,692165492,3,492,164,1360270757193,1360270757321,692140685,692140813,128
1360270782,692165504,7,672,96,1360270754812,1360270760572,692138316,692144076,5760
1360270782,692165528,15,840,56,1360270754402,1360270761122,692137930,692144650,6720
1360270782,692165532,15,840,56,1360270754528,1360270768224,692138060,692151756,13696
1360270782,692165536,7,392,56,1360270755293,1360270760797,692138829,692144333,5504
1360270794,692177712,1,137,137,1360270768106,1360270768106,692151818,692151818,0
1360270810,692194228,3,144,48,1360270798568,1360270804072,692182796,692188300,5504
1360270814,692197616,6,336,56,1360270788684,1360270798668,692172300,692182284,9984
1360270814,692197688,3,544,181.3333333,1360270787141,1360270787205,692170829,692170893,64
1360270814,692197732,6,576,96,1360270788696,1360270798680,692172428,692182412,9984
1360270814,692197732,12,672,56,1360270789080,1360270810392,692172812,692194124,21312
1360270814,692197732,6,336,56,1360270789207,1360270799191,692172939,692182923,9984
1360270814,692197732,12,672,56,1360270788886,1360270804502,692172618,692188234,15616
1360270816,3625479212,6,336,56,1360270789152,1360270799328,3625452364,3625462540,10176
1360270822,692205776,3,492,164,1360270796330,1360270796458,692180106,692180234,128
1360270826,692209632,5,2768,553.6,1360270799162,1360270799290,692182794,692182922,128
1360270826,692209716,9,2327,258.5555556,1360270798502,1360270798758,692182218,692182474,256
1360270838,692221596,1,137,137,1360270810590,1360270810590,692194186,692194186,0
1360270842,692225656,2,112,56,1360270816163,1360270824163,692199819,692207819,8000
1360270842,692225656,5,1723,344.6,1360270816163,1360270816291,692199819,692199947,128
1360270842,692225660,18,12629,701.6111111,1360270816285,1360270816413,692199945,692200073,128
1360270846,692229652,4,224,56,1360270820007,1360270827623,692203659,692211275,7616
1360270846,692229740,2,192,96,1360270819407,1360270824143,692203147,692207883,4736
1360270846,692229764,4,224,56,1360270819767,1360270827319,692203531,692211083,7552
1360270846,692229768,2,112,56,1360270820082,1360270825330,692203850,692209098,5248
1360270848,3625511220,2,112,56,1360270820757,1360270825557,3625483977,3625488777,4800
1360270854,692237748,3,544,181.3333333,1360270827208,1360270827272,692210956,692211020,64
1360270858,692242296,9282,13014573,1402.130252,1360270623267,1360270854435,692007563,692238731,231168
1360270862,692245768,3,492,164,1360270836530,1360270836658,692220298,692220426,128
1360270874,692257704,1,137,137,1360270846260,1360270846260,692229964,692229964,0
1360270890,692273696,6,336,56,1360270865722,1360270872058,692249418,692255754,6336
1360270892,3625555204,5,280,56,1360270866216,1360270871592,3625529420,3625534796,5376
1360270894,692277608,6,576,96,1360270865875,1360270872467,692249483,692256075,6592
1360270894,692277616,6,336,56,1360270866376,1360270881864,692249992,692265480,15488
1360270894,692277628,3,544,181.3333333,1360270867327,1360270867583,692250955,692251211,256
1360270894,692277704,11,616,56,1360270865844,1360270877108,692249548,692260812,11264
1360270894,692277708,11,616,56,1360270866095,1360270877423,692249803,692261131,11328
1360270902,692285712,3,492,164,1360270877098,1360270877226,692260810,692260938,128
1360270906,692289824,1,137,137,1360270881657,1360270881657,692265481,692265481,0
1360270906,692290264,6,496,82.66666667,1360270897217,1360270900161,692281481,692284425,2944
1360270915,692298912,3,138,46,1360270913955,1360270914019,692297867,692297931,64
1360270922,692305704,5,280,56,1360270896368,1360270902064,692280072,692285768,5696
1360270922,692305728,5,280,56,1360270896602,1360270902298,692280330,692286026,5696
1360270922,692305744,2,192,96,1360270897674,1360270900106,692281418,692283850,2432
1360270922,692305824,2,112,56,1360270896699,1360270899963,692280523,692283787,3264
1360270922,692306240,1,46,46,1360270897243,1360270897243,692281483,692281483,0
1360270924,3625587220,3,168,56,1360270896023,1360270900759,3625559243,3625563979,4736
1360270926,692309676,2,112,56,1360270898382,1360270900686,692282058,692284362,2304
1360270934,692317724,3,544,181.3333333,1360270907358,1360270907422,692291082,692291146,64
1360270942,692325696,2,92,46,1360270915130,1360270915194,692298826,692298890,64
1360270942,692325728,1,137,137,1360270916441,1360270916441,692300169,692300169,0
1360270942,692325848,3,492,164,1360270916577,1360270916705,692300425,692300553,128
1360270954,692337752,4,224,56,1360270927871,1360270933375,692311623,692317127,5504
1360270954,692337756,6,336,56,1360270928254,1360270932734,692312010,692316490,4480
1360270954,692337880,4,384,96,1360270927873,1360270933121,692311753,692317001,5248
1360270954,692337880,3,168,56,1360270928256,1360270931520,692312136,692315400,3264
1360270954,692337880,7,392,56,1360270928000,1360270933440,692311880,692317320,5440
1360270956,3625619444,3,168,56,1360270928182,1360270931958,3625591626,3625595402,3776
1360270958,692341888,2,92,46,1360270931960,1360270932024,692315848,692315912,64
1360270958,692341888,1,46,46,1360270931960,1360270931960,692315848,692315848,0
1360270970,692354420,3936,5524235,1403.51499,1360270864357,1360270962277,692248777,692346697,97920
1360270974,692357796,3,544,181.3333333,1360270947348,1360270947348,692331144,692331144,0
1360270982,692365804,1,137,137,1360270956427,1360270956427,692340231,692340231,0
1360270982,692365904,3,492,164,1360270956456,1360270956520,692340360,692340424,64
1360271003,692386428,3,144,48,1360270994308,1360271000260,692377736,692383688,5952
1360271003,692386432,4,190,47.5,1360270995074,1360271001282,692378506,692384714,6208
1360271003,692386432,3,144,48,1360270995073,1360271001217,692378505,692384649,6144
1360271003,692386432,3,144,48,1360270995073,1360271001217,692378505,692384649,6144
1360271014,692397840,3,544,181.3333333,1360270987368,1360270987368,692371208,692371208,0
1360271018,692402004,6,336,56,1360270990981,1360271008901,692374985,692392905,17920
1360271018,692402012,36,38672,1074.222222,1360270991613,1360270994045,692375625,692378057,2432
1360271018,692402072,3,168,56,1360270993471,1360270999743,692377543,692383815,6272
1360271020,3625683384,6,4520,753.3333333,1360270993716,1360270994228,3625657100,3625657612,512
1360271020,3625683384,3,168,56,1360270993779,1360271000883,3625657163,3625664267,7104
1360271022,692405776,16,19090,1193.125,1360270993959,1360270994663,692377735,692378439,704
1360271022,692405776,5,2914,582.8,1360270993959,1360270994855,692377735,692378631,896
1360271022,692405776,23,28865,1255,1360270993959,1360270994727,692377735,692378503,768
1360271022,692405776,5,2336,467.2,1360270993958,1360270994726,692377734,692378502,768
1360271022,692405780,10,6444,644.4,1360270993958,1360270994918,692377738,692378698,960
1360271022,692405788,3,168,56,1360270994270,1360271009630,692378058,692393418,15360
1360271022,692405792,2,192,96,1360270994391,1360270998167,692378183,692381959,3776
1360271022,692405860,2,446,223,1360270997142,1360270997270,692381002,692381130,128
1360271022,692405864,9,8532,948,1360270993871,1360270994447,692377735,692378311,576
1360271022,692405868,89,114148,1282.561798,1360270993866,1360270996426,692377734,692380294,2560
1360271022,692405868,4,2940,735,1360270993869,1360270994509,692377737,692378377,640
1360271022,692405868,5,280,56,1360270993996,1360271006476,692377864,692390344,12480
1360271026,692409832,1,137,137,1360270999985,1360270999985,692383817,692383817,0
1360271034,692417848,1,46,46,1360271009057,1360271009057,692392905,692392905,0
1360271034,692417888,1,46,46,1360271006457,1360271006457,692390345,692390345,0
1360271034,692417964,1,46,46,1360271009451,1360271009451,692393415,692393415,0
1360271048,3625711388,4,224,56,1360271022574,1360271027822,3625685962,3625691210,5248
1360271050,692433820,9,504,56,1360271022460,1360271029372,692406280,692413192,6912
1360271050,692433828,4,224,56,1360271023027,1360271028787,692406855,692412615,5760
1360271050,692433908,5,480,96,1360271022179,1360271028835,692406087,692412743,6656
1360271050,692433912,9,504,56,1360271022302,1360271029214,692406214,692413126,6912
1360271050,692433932,5,280,56,1360271022538,1360271029514,692406470,692413446,6976
1360271054,692437872,3,544,181.3333333,1360271027400,1360271027464,692411272,692411336,64
1360271066,692449952,3,492,164,1360271038006,1360271038134,692421958,692422086,128
1360271070,692453856,1,137,137,1360271043415,1360271043415,692427271,692427271,0
1360271080,3625743408,5,280,56,1360271053982,1360271060382,3625717390,3625723790,6400
1360271082,692465848,3,795,265,1360271054109,1360271054301,692437957,692438149,192
1360271082,692465860,9,504,56,1360271054673,1360271067857,692438533,692451717,13184
1360271082,692465860,4,384,96,1360271054994,1360271059474,692438854,692443334,4480
1360271082,692465936,9,504,56,1360271054471,1360271067463,692438407,692451399,12992
1360271082,692465940,4,224,56,1360271054725,1360271059333,692438665,692443273,4608
1360271082,692465972,4,224,56,1360271055459,1360271060067,692439431,692444039,4608
1360271094,692477900,3,544,181.3333333,1360271067497,1360271067561,692451397,692451461,64
1360271102,692485944,1,137,137,1360271077695,1360271077695,692461639,692461639,0
1360271106,692489872,3,492,164,1360271078470,1360271078662,692462342,692462534,192
1360271110,692493960,3,138,46,1360271085423,1360271085423,692469383,692469383,0
1360271110,692494080,2,92,46,1360271085304,1360271085304,692469384,692469384,0
1360271114,692497936,6,336,56,1360271087879,1360271098567,692471815,692482503,10688
1360271114,692498048,6,576,96,1360271087893,1360271098645,692471941,692482693,10752
1360271114,692498052,11,616,56,1360271088146,1360271098834,692472198,692482886,10688
1360271114,692498056,10,560,56,1360271088205,1360271096077,692472261,692480133,7872
1360271114,692498060,5,280,56,1360271088332,1360271095564,692472392,692479624,7232
1360271115,692498536,3,138,46,1360271110166,1360271110166,692493702,692493702,0
1360271115,692498564,200,252580,1262.9,1360270994170,1360271112122,692377734,692495686,117952
1360271115,692498612,2,92,46,1360271112074,1360271112074,692495686,692495686,0
1360271115,692498728,2,92,46,1360271109975,1360271109975,692493703,692493703,0
1360271116,3625779624,5,280,56,1360271088326,1360271095494,3625751950,3625759118,7168
1360271126,692509988,7,1045,149.2857143,1360271098580,1360271098644,692482568,692482632,64
1360271134,692517968,3,544,181.3333333,1360271107493,1360271107557,692491461,692491525,64
1360271134,692517980,2,92,46,1360271108379,1360271108443,692492359,692492423,64
1360271134,692518016,1,46,46,1360271109687,1360271109687,692493703,692493703,0
1360271134,692518068,3,138,46,1360271108290,1360271108354,692492358,692492422,64
1360271136,3625799612,1,46,46,1360271109456,1360271109456,3625773068,3625773068,0
1360271138,692521972,1,137,137,1360271111651,1360271111651,692495623,692495623,0
1360271142,692525988,1,46,46,1360271116499,1360271116499,692500487,692500487,0
1360271142,692526020,1,46,46,1360271117681,1360271117681,692501701,692501701,0
1360271142,692526024,1,46,46,1360271114416,1360271114416,692498440,692498440,0
1360271142,692526112,1,46,46,1360271117527,1360271117527,692501639,692501639,0
1360271146,692529948,3,492,164,1360271118139,1360271118267,692502087,692502215,128
1360271146,692530028,16,896,56,1360271121515,1360271129067,692505543,692513095,7552
1360271146,692530120,8,448,56,1360271121548,1360271128716,692505668,692512836,7168
1360271147,692530528,6,499,83.16666667,1360271138781,1360271140893,692522309,692524421,2112
1360271148,3625811696,8,448,56,1360271121595,1360271128635,3625785291,3625792331,7040
1360271150,692533968,8,448,56,1360271122663,1360271129447,692506631,692513415,6784
1360271150,692533968,15,840,56,1360271122404,1360271129060,692506372,692513028,6656
1360271150,692534092,7,672,96,1360271122667,1360271128491,692506759,692512583,5824
1360271155,692538496,6655,9255089,1390.69707,1360270991102,1360271154366,692374598,692537862,163264
1360271166,692550060,1,46,46,1360271138250,1360271138250,692522310,692522310,0
1360271174,692558084,1,137,137,1360271146288,1360271146288,692530372,692530372,0
1360271174,692558096,4,596,149,1360271147493,1360271147621,692531589,692531717,128
1360271180,3625843784,5,280,56,1360271155174,1360271160486,3625818958,3625824270,5312
1360271182,692565976,5,781,156.2,1360271154270,1360271154590,692538246,692538566,320
1360271182,692566064,5,480,96,1360271154436,1360271160324,692538500,692544388,5888
1360271182,692566068,10,560,56,1360271154561,1360271160897,692538629,692544965,6336
1360271182,692566092,10,560,56,1360271154667,1360271161003,692538759,692545095,6336
1360271182,692566100,5,280,56,1360271155361,1360271160609,692539461,692544709,5248
1360271182,692566108,5,280,56,1360271155930,1360271161306,692540038,692545414,5376
1360271186,692570196,4,538,134.5,1360271157952,1360271158400,692542148,692542596,448
1360271195,692578524,1300,1834563,1411.202308,1360271154466,1360271191074,692537990,692574598,36608
1360271202,692586072,1,137,137,1360271176702,1360271176702,692560774,692560774,0
1360271214,692598020,4,224,56,1360271189811,1360271194611,692573831,692578631,4800
1360271214,692598064,4,384,96,1360271188037,1360271193157,692572101,692577221,5120
1360271214,692598104,8,448,56,1360271189599,1360271198111,692573703,692582215,8512
1360271214,692598148,3,544,181.3333333,1360271187570,1360271187570,692571718,692571718,0
1360271214,692598188,8,448,56,1360271189576,1360271198216,692573764,692582404,8640
1360271216,3625879712,4,224,56,1360271189676,1360271194604,3625853388,3625858316,4928
1360271218,692602156,3,168,56,1360271191082,1360271192938,692575238,692577094,1856
1360271219,692602652,3,138,46,1360271214115,1360271214179,692597767,692597831,64
1360271226,692610080,3,492,164,1360271198070,1360271198198,692582150,692582278,128
1360271242,692626204,1,137,137,1360271216506,1360271216506,692600710,692600710,0
1360271242,692626268,3,138,46,1360271214199,1360271214263,692598467,692598531,64
1360271246,692630244,7,672,96,1360271221264,1360271233424,692605508,692617668,12160
1360271246,692630244,12,672,56,1360271221455,1360271233231,692605699,692617475,11776
1360271246,692630368,7,392,56,1360271221139,1360271233171,692605507,692617539,12032
1360271246,692630372,12,672,56,1360271221202,1360271233554,692605574,692617926,12352
1360271246,692630372,6,336,56,1360271221521,1360271232849,692605893,692617221,11328
1360271248,3625911764,6,336,56,1360271221690,1360271232954,3625885454,3625896718,11264
1360271254,692638216,3,544,181.3333333,1360271227563,1360271227627,692611779,692611843,64
1360271266,692650152,3,492,164,1360271237934,1360271238062,692622086,692622214,128
1360271274,692658220,1,137,137,1360271247850,1360271247850,692632070,692632070,0
1360271280,3625943716,4,224,56,1360271255656,1360271259688,3625919372,3625923404,4032
1360271282,692666168,4,224,56,1360271254106,1360271259674,692638274,692643842,5568
1360271282,692666212,3,168,56,1360271256434,1360271259122,692640646,692643334,2688
1360271282,692666260,8,448,56,1360271253889,1360271260289,692638149,692644549,6400
1360271282,692666332,7,392,56,1360271255800,1360271259960,692640132,692644292,4160
1360271282,692666340,3,288,96,1360271256433,1360271259121,692640773,692643461,2688
1360271295,692678436,3,544,181.3333333,1360271268474,1360271268474,692651910,692651910,0
1360271307,692690404,3,492,164,1360271279128,1360271279256,692662532,692662660,128
1360271307,692690516,1,137,137,1360271279079,1360271279079,692662595,692662595,0
1360271311,692694480,5,280,56,1360271285964,1360271292108,692669444,692675588,6144
1360271311,692694480,8,448,56,1360271286156,1360271291660,692669636,692675140,5504
1360271311,692694572,5,480,96,1360271285938,1360271292274,692669510,692675846,6336
1360271311,692694572,8,448,56,1360271286127,1360271291695,692669699,692675267,5568
1360271313,3625975916,4,224,56,1360271286856,1360271291400,3625949772,3625954316,4544
1360271315,692698404,4,224,56,1360271286873,1360271291417,692670277,692674821,4544
1360271335,692718540,3,544,181.3333333,1360271308433,1360271308497,692691973,692692037,64
1360271335,692718672,1,137,137,1360271310093,1360271310093,692693765,692693765,0
1360271343,692726536,10,560,56,1360271316820,1360271322580,692700356,692706116,5760
1360271343,692726572,3,492,164,1360271318639,1360271318767,692702211,692702339,128
1360271343,692726624,10,560,56,1360271316476,1360271322236,692700100,692705860,5760
1360271343,692726648,5,280,56,1360271316771,1360271321571,692700419,692705219,4800
1360271343,692726656,4,224,56,1360271317404,1360271320924,692701060,692704580,3520
1360271343,692726656,4,384,96,1360271317531,1360271321051,692701187,692704707,3520
1360271345,3626007888,5,280,56,1360271317028,1360271321892,3625979916,3625984780,4864
1360271375,692758548,4,224,56,1360271348488,1360271352904,692732036,692736452,4416
1360271375,692758548,4,384,96,1360271348678,1360271353030,692732226,692736578,4352
1360271375,692758596,1,137,137,1360271347478,1360271347478,692731074,692731074,0
1360271375,692758632,3,544,181.3333333,1360271348467,1360271348531,692732099,692732163,64
1360271375,692758636,8,448,56,1360271348717,1360271354541,692732353,692738177,5824
1360271375,692758636,7,392,56,1360271348720,1360271353520,692732356,692737156,4800
1360271375,692758636,4,224,56,1360271348847,1360271353647,692732483,692737283,4800
1360271377,3626039984,4,224,56,1360271349573,1360271353925,3626012557,3626016909,4352
1360271383,692766728,3,492,164,1360271358612,1360271358740,692742340,692742468,128
1360271405,3626067944,9,504,56,1360271379823,1360271388847,3626042767,3626051791,9024
1360271407,692790552,9,864,96,1360271379396,1360271388420,692762948,692771972,9024
1360271407,692790552,18,1008,56,1360271379459,1360271389187,692763011,692772739,9728
1360271407,692790632,18,1008,56,1360271379060,1360271389364,692762692,692772996,10304
1360271407,692790632,9,504,56,1360271379185,1360271388209,692762817,692771841,9024
1360271407,692790660,9,504,56,1360271379669,1360271388629,692763329,692772289,8960
1360271411,692794664,1,137,137,1360271383697,1360271383697,692767361,692767361,0
1360271411,692794916,4,190,47.5,1360271398806,1360271404950,692782722,692788866,6144
1360271411,692794944,4,190,47.5,1360271399547,1360271404859,692783491,692788803,5312
1360271415,692798608,4,1002,250.5,1360271388619,1360271388811,692772227,692772419,192
1360271427,692810540,8,1257,157.125,1360271399182,1360271399694,692782722,692783234,512
1360271427,692810632,3,492,164,1360271399026,1360271399154,692782658,692782786,128
1360271439,692822688,3,168,56,1360271412664,1360271422712,692796352,692806400,10048
1360271439,692822688,3,288,96,1360271412731,1360271422779,692796419,692806467,10048
1360271439,692822724,5,280,56,1360271413463,1360271422871,692797187,692806595,9408
1360271445,3626108008,3,168,56,1360271420077,1360271428973,3626083085,3626091981,8896
1360271447,692830940,4,224,56,1360271419135,1360271446015,692803075,692829955,26880
1360271447,692831060,7,392,56,1360271419782,1360271446406,692803842,692830466,26624
1360271447,692831092,1,137,137,1360271420324,1360271420324,692804416,692804416,0
1360271455,692838900,4,590,147.5,1360271428389,1360271428453,692812289,692812353,64
1360271463,692847028,3,492,164,1360271438374,1360271438502,692822402,692822530,128
1360271471,692854884,11,616,56,1360271444148,1360271450292,692828032,692834176,6144
1360271471,692854996,6,336,56,1360271444164,1360271450564,692828160,692834560,6400
1360271471,692855004,5,480,96,1360271444479,1360271449535,692828483,692833539,5056
1360271473,3626135976,5,280,56,1360271446478,1360271450510,3626109454,3626113486,4032
1360271475,692859032,8,448,56,1360271446818,1360271450210,692830850,692834242,3392
1360271475,692859032,4,224,56,1360271446945,1360271449889,692830977,692833921,2944
1360271487,692871052,1,137,137,1360271461454,1360271461454,692845506,692845506,0
1360271495,692878916,3,544,181.3333333,1360271468500,1360271468500,692852416,692852416,0
1360271503,692886960,5,480,96,1360271478695,1360271488359,692862655,692872319,9664
1360271505,3626168172,3,168,56,1360271479307,1360271487307,3626142479,3626150479,8000
1360271507,692890884,4,538,134.5,1360271478838,1360271479286,692862722,692863170,448
1360271507,692890884,8,448,56,1360271478838,1360271488822,692862722,692872706,9984
1360271507,692890884,8,448,56,1360271479028,1360271489140,692862912,692873024,10112
1360271507,692890884,3,168,56,1360271479091,1360271486963,692862975,692870847,7872
1360271507,692890924,4,224,56,1360271480717,1360271488269,692864641,692872193,7552
1360271515,692899188,2,92,46,1360271514630,1360271514630,692898818,692898818,0
1360271523,692907232,3,138,46,1360271514904,1360271515032,692899136,692899264,128
1360271527,692911000,1,137,137,1360271499201,1360271499201,692883201,692883201,0
1360271535,692918968,10,560,56,1360271509087,1360271514975,692893055,692898943,5888
1360271535,692918972,5,480,96,1360271509406,1360271514910,692893378,692898882,5504
1360271535,692919048,3,544,181.3333333,1360271508430,1360271508558,692892478,692892606,128
1360271535,692919048,6,336,56,1360271508626,1360271515218,692892674,692899266,6592
1360271535,692919052,10,560,56,1360271509068,1360271514956,692893120,692899008,5888
1360271535,692919072,5,280,56,1360271509178,1360271514682,692893250,692898754,5504
1360271537,3626200108,6,336,56,1360271509066,1360271515722,3626172174,3626178830,6656
1360271547,692930904,3,492,164,1360271519775,1360271519839,692903679,692903743,64
1360271559,692943204,4,656,164,1360271534005,1360271534197,692918209,692918401,192
1360271563,692947164,1,137,137,1360271536221,1360271536221,692920385,692920385,0
1360271563,692947204,7,392,56,1360271538292,1360271548724,692922496,692932928,10432
1360271567,692950980,8,448,56,1360271539986,1360271566098,692923966,692950078,26112
1360271567,692951088,4,224,56,1360271540647,1360271565671,692924735,692949759,25024
1360271567,692951092,4,384,96,1360271540709,1360271565733,692924801,692949825,25024
1360271567,692951096,4,224,56,1360271541090,1360271566306,692925186,692950402,25216
1360271569,3626232104,4,224,56,1360271541773,1360271567053,3626204877,3626230157,25280
1360271575,692958996,3,544,181.3333333,1360271548612,1360271548612,692932608,692932608,0
1360271587,692970984,3,492,164,1360271559249,1360271559377,692943233,692943361,128
1360271591,692975036,8,448,56,1360271566108,1360271572252,692950144,692956288,6144
1360271595,692979068,6,336,56,1360271566906,1360271571450,692950974,692955518,4544
1360271595,692979068,3,168,56,1360271566970,1360271571002,692951038,692955070,4032
1360271595,692979072,3,288,96,1360271567286,1360271571126,692951358,692955198,3840
1360271595,692979076,1,137,137,1360271567345,1360271567345,692951421,692951421,0
1360271595,692979124,3,168,56,1360271569220,1360271571524,692953344,692955648,2304
1360271597,3626260148,3,168,56,1360271569699,1360271572131,3626232847,3626235279,2432
1360271615,692999232,3,544,181.3333333,1360271588437,1360271588501,692972669,692972733,64
1360271617,3626280132,4,433,108.25,1360271589234,1360271589234,3626252366,3626252366,0
1360271617,3626280132,4,478,119.5,1360271589234,1360271589234,3626252366,3626252366,0
1360271617,3626280132,3,387,129,1360271589234,1360271589234,3626252366,3626252366,0
1360271617,3626280168,6,889,148.1666667,1360271589007,1360271589199,3626252175,3626252367,192
1360271623,693007156,12,672,56,1360271597666,1360271604450,692981822,692988606,6784
1360271623,693007156,7,392,56,1360271597857,1360271604705,692982013,692988861,6848
1360271623,693007160,6,576,96,1360271598048,1360271603744,692982208,692987904,5696
1360271623,693007160,12,672,56,1360271598175,1360271604191,692982335,692988351,6016
1360271623,693007184,5,280,56,1360271598405,1360271603973,692982589,692988157,5568
1360271625,3626288144,6,336,56,1360271599654,1360271604518,3626262798,3626267662,4864
1360271627,693011104,3,492,164,1360271599320,1360271599448,692983424,692983552,128
1360271639,693023112,1,137,137,1360271611471,1360271611471,692995583,692995583,0
1360271652,693035420,3,138,46,1360271650820,1360271650884,693034240,693034304,64
1360271655,693039096,3,544,181.3333333,1360271628701,1360271628765,693012797,693012861,64
1360271659,693043120,4,384,96,1360271632776,1360271637768,693016896,693021888,4992
1360271659,693043124,4,224,56,1360271633281,1360271638017,693017405,693022141,4736
1360271659,693043204,8,448,56,1360271632882,1360271638898,693017086,693023102,6016
1360271659,693043208,8,448,56,1360271632942,1360271639150,693017150,693023358,6208
1360271659,693043216,3,168,56,1360271633767,1360271637607,693017983,693021823,3840
1360271661,3626324148,4,224,56,1360271633828,1360271639140,3626296976,3626302288,5312
1360271667,693051148,3,492,164,1360271638956,1360271639084,693023104,693023232,128
1360271679,693063168,1,137,137,1360271651734,1360271651734,693035902,693035902,0
1360271691,693075172,7,672,96,1360271666451,1360271679187,693050623,693063359,12736
1360271691,693075252,8,448,56,1360271666242,1360271690754,693050494,693075006,24512
1360271691,693075388,7,1586,226.5714286,1360271686712,1360271690616,693071100,693075004,3904
1360271693,3626356412,7,392,56,1360271667740,1360271687068,3626331152,3626350480,19328
1360271695,693079092,7,392,56,1360271667363,1360271686883,693051455,693070975,19520
1360271695,693079172,15,840,56,1360271666833,1360271692113,693051005,693076285,25280
1360271695,693079176,14,784,56,1360271667021,1360271693453,693051197,693077629,26432
1360271695,693079212,3,544,181.3333333,1360271668715,1360271668715,693052927,693052927,0
1360271699,693083396,5,230,46,1360271691122,1360271698866,693075518,693083262,7744
1360271707,693091100,3,492,164,1360271679002,1360271679130,693063102,693063230,128
1360271707,693091256,1,137,137,1360271682300,1360271682300,693066556,693066556,0
1360271711,693095196,2,590,295,1360271686779,1360271686843,693070975,693071039,64
1360271719,693103124,7,672,96,1360271691392,1360271705792,693075516,693089916,14400
1360271721,3626384388,6,336,56,1360271695795,1360271705331,3626359183,3626368719,9536
1360271723,693107136,7,392,56,1360271695476,1360271709172,693079612,693093308,13696
1360271723,693107140,11,616,56,1360271695857,1360271706353,693079997,693090493,10496
1360271723,693107140,12,672,56,1360271696048,1360271708848,693080188,693092988,12800
1360271723,693107228,5,280,56,1360271696023,1360271705431,693080251,693089659,9408
1360271724,693107552,2,92,46,1360271706879,1360271721087,693090431,693104639,14208
1360271727,693111232,7,1027,146.7142857,1360271699031,1360271699479,693083263,693083711,448
1360271732,693115500,22821,31511001,1380.789667,1360271187251,1360271729331,692570751,693112831,542080
1360271735,693119184,3,544,181.3333333,1360271708803,1360271708867,693092987,693093051,64
1360271743,693127276,1,137,137,1360271718185,1360271718185,693102461,693102461,0
1360271747,693131136,3,492,164,1360271718901,1360271719029,693103037,693103165,128
1360271757,3626420396,4,224,56,1360271729261,1360271735661,3626392657,3626399057,6400
1360271759,693143180,4,384,96,1360271732360,1360271735880,693116540,693120060,3520
1360271759,693143208,3,168,56,1360271732843,1360271735275,693117051,693119483,2432
1360271759,693143244,8,448,56,1360271731209,1360271736009,693115453,693120253,4800
1360271759,693143248,7,392,56,1360271731331,1360271735555,693115579,693119803,4224
1360271759,693143256,4,224,56,1360271732157,1360271735677,693116413,693119933,3520
1360271772,693155540,3,144,48,1360271764233,1360271769481,693147773,693153021,5248
1360271772,693155628,1327,1835805,1383.425019,1360271729199,1360271766063,693112827,693149691,36864
1360271775,693159224,1,46,46,1360271748509,1360271748509,693132733,693132733,0
1360271775,693159228,3,544,181.3333333,1360271748889,1360271748889,693133117,693133117,0
1360271787,693171192,3,492,164,1360271758910,1360271759038,693143102,693143230,128
1360271787,693171200,1,137,137,1360271759732,1360271759732,693143932,693143932,0
1360271787,693171236,9,504,56,1360271761168,1360271768272,693145404,693152508,7104
1360271787,693171236,5,280,56,1360271761359,1360271768399,693145595,693152635,7040
1360271787,693171332,9,504,56,1360271761456,1360271776624,693145788,693160956,15168
1360271787,693171356,4,224,56,1360271761690,1360271766362,693146046,693150718,4672
1360271789,3626452656,5,280,56,1360271761447,1360271768743,3626425103,3626432399,7296
1360271791,693175320,3,288,96,1360271763902,1360271767422,693148222,693151742,3520
1360271803,693187340,1,46,46,1360271776614,1360271776614,693160954,693160954,0
1360271816,693199400,4,608,152,1360271790099,1360271790163,693173499,693173563,64
1360271819,693203268,12,672,56,1360271792238,1360271799982,693176506,693184250,7744
1360271819,693203288,6,336,56,1360271792347,1360271799515,693176635,693183803,7168
1360271819,693203288,6,576,96,1360271792410,1360271799770,693176698,693184058,7360
1360271819,693203296,11,616,56,1360271792916,1360271799828,693177212,693184124,6912
1360271820,693203412,6,336,56,1360271794183,1360271801159,693177595,693184571,6976
1360271820,693203624,3,138,46,1360271815475,1360271815539,693199099,693199163,64
1360271821,3626484552,6,336,56,1360271793296,1360271805072,3626456848,3626468624,11776
1360271823,693207288,1,137,137,1360271796507,1360271796507,693180795,693180795,0
1360271827,693211256,3,492,164,1360271799292,1360271799356,693183548,693183612,64
1360271832,693215432,1,46,46,1360271805618,1360271805618,693189050,693189050,0
1360271851,693235380,11,1056,96,1360271826688,1360271836800,693211068,693221180,10112
1360271852,693235464,22,1232,56,1360271826581,1360271838229,693210045,693221693,11648
1360271852,693235468,11,616,56,1360271827342,1360271837646,693210810,693221114,10304
1360271852,693235472,21,1176,56,1360271827081,1360271840073,693210553,693223545,12992
1360271853,3626516752,11,616,56,1360271827463,1360271839495,3626491215,3626503247,12032
1360271855,693239304,11,616,56,1360271827468,1360271839372,693211772,693223676,11904
1360271855,693239336,4,1002,250.5,1360271828970,1360271829226,693213306,693213562,256
1360271859,693243348,1,137,137,1360271833118,1360271833118,693217466,693217466,0
1360271860,693243436,1,46,46,1360271833776,1360271833776,693217212,693217212,0
1360271867,693251384,3,492,164,1360271839100,1360271839292,693223484,693223676,192
1360271884,693267476,17,952,56,1360271857541,1360271868933,693241017,693252409,11392
1360271884,693267480,9,504,56,1360271857667,1360271869891,693241147,693253371,12224
1360271884,693267628,17,952,56,1360271857262,1360271868462,693240890,693252090,11200
1360271884,693267660,9,864,96,1360271857613,1360271870029,693241273,693253689,12416
1360271884,693267664,8,448,56,1360271858185,1360271868169,693241849,693251833,9984
1360271885,3626548736,8,448,56,1360271857624,1360271867608,3626521360,3626531344,9984
1360271892,693275648,1,137,137,1360271866905,1360271866905,693250553,693250553,0
1360271896,693279496,4,590,147.5,1360271869874,1360271869938,693253370,693253434,64
1360271908,693291444,3,492,164,1360271880293,1360271880421,693263737,693263865,128
1360271912,693295596,13,728,56,1360271885709,1360271894989,693269305,693278585,9280
1360271912,693295640,6,336,56,1360271887011,1360271894499,693270651,693278139,7488
1360271912,693295640,6,576,96,1360271887138,1360271894626,693270778,693278266,7488
1360271912,693295688,12,672,56,1360271885681,1360271894385,693269369,693278073,8704
1360271912,693295692,5,280,56,1360271885744,1360271894064,693269436,693277756,8320
1360271913,3626576716,6,336,56,1360271885614,1360271893550,3626549330,3626557266,7936
1360271917,693300400,4,184,46,1360271907796,1360271914836,693291196,693298236,7040
1360271936,693319576,1,137,137,1360271908323,1360271908323,693291899,693291899,0
1360271936,693319700,3,544,181.3333333,1360271909796,1360271909860,693293496,693293560,64
1360271940,693324000,2,92,46,1360271922235,1360271934651,693306235,693318651,12416
1360271941,3626604760,6,336,56,1360271916673,1360271923457,3626580433,3626587217,6784
1360271944,693327576,15,840,56,1360271917155,1360271925027,693300731,693308603,7872
1360271944,693327600,13,728,56,1360271917515,1360271924363,693301115,693307963,6848
1360271944,693327604,7,392,56,1360271917831,1360271924551,693301435,693308155,6720
1360271944,693327644,3,492,164,1360271919390,1360271919582,693303034,693303226,192
1360271944,693327680,7,392,56,1360271917179,1360271924091,693300859,693307771,6912
1360271944,693327728,6,576,96,1360271919112,1360271924488,693302840,693308216,5376
1360271972,693355900,13,1248,96,1360271947548,1360271959388,693331448,693343288,11840
1360271972,693355980,13,728,56,1360271946764,1360271958860,693330744,693342840,12096
1360271972,693355984,25,1400,56,1360271947209,1360271959369,693331193,693343353,12160
1360271972,693355984,13,728,56,1360271947336,1360271959176,693331320,693343160,11840
1360271972,693355984,26,1456,56,1360271947144,1360271959688,693331128,693343672,12544
1360271973,3626636732,13,728,56,1360271946525,1360271958557,3626610257,3626622289,12032
1360271976,693359772,3,544,181.3333333,1360271949852,1360271949916,693333624,693333688,64
1360271976,693359864,1,137,137,1360271949313,1360271949313,693333177,693333177,0
1360271984,693367820,3,492,164,1360271959212,1360271959340,693343032,693343160,128
1360272006,3626668836,5,280,56,1360271980702,1360271987230,3626643538,3626650066,6528
1360272008,693391784,5,280,56,1360271980239,1360271986767,693364023,693370551,6528
1360272008,693391788,10,560,56,1360271980430,1360271990222,693364218,693374010,9792
1360272008,693391820,5,280,56,1360271981676,1360271987372,693365496,693371192,5696
1360272008,693391824,5,480,96,1360271981929,1360271989865,693365753,693373689,7936
1360272008,693391912,9,504,56,1360271981458,1360271986962,693365370,693370874,5504
1360272008,693391956,1,137,137,1360271983395,1360271983395,693367351,693367351,0
1360272012,693396040,4,190,47.5,1360271999760,1360272005840,693383800,693389880,6080
1360272016,693399828,3,544,181.3333333,1360271989860,1360271989924,693373688,693373752,64
1360272028,693411836,3,492,164,1360271999901,1360272000029,693383737,693383865,128
1360272028,693411836,11,1880,170.9090909,1360271999900,1360272014812,693383736,693398648,14912
1360272028,693412000,5,2704,540.8,1360272000313,1360272000441,693384313,693384441,128
1360272040,693423896,6,336,56,1360272014432,1360272021536,693398328,693405432,7104
1360272040,693424004,1,137,137,1360272014451,1360272014451,693398455,693398455,0
1360272040,693424004,11,616,56,1360272014258,1360272020978,693398262,693404982,6720
1360272040,693424008,11,616,56,1360272014577,1360272030065,693398585,693414073,15488
1360272042,3626704932,6,336,56,1360272014846,1360272030270,3626677778,3626693202,15424
1360272044,693427988,5,280,56,1360272016069,1360272020613,693400057,693404601,4544
1360272044,693428012,5,480,96,1360272016683,1360272020651,693400695,693404663,3968
1360272056,693439996,3,544,181.3333333,1360272029822,1360272029822,693413818,693413818,0
1360272064,693447940,3,492,164,1360272039155,1360272039283,693423095,693423223,128
1360272072,693455856,9,504,56,1360272044616,1360272050248,693428472,693434104,5632
1360272072,693455972,4,224,56,1360272044755,1360272050323,693428727,693434295,5568
1360272072,693455976,5,480,96,1360272044818,1360272050386,693428794,693434362,5568
1360272072,693455976,9,504,56,1360272045071,1360272050703,693429047,693434679,5632
1360272072,693455984,4,224,56,1360272046024,1360272049800,693430008,693433784,3776
1360272074,3626736980,4,224,56,1360272046668,1360272050252,3626709648,3626713232,3584
1360272084,693467976,1,137,137,1360272058257,1360272058257,693442233,693442233,0
1360272096,693479968,3,544,181.3333333,1360272069909,1360272069973,693453877,693453941,64
1360272104,693488124,3,492,164,1360272079676,1360272079804,693463800,693463928,128
1360272106,3626768948,9,504,56,1360272080814,1360272100398,3626743762,3626763346,19584
1360272108,693492216,7,392,56,1360272080480,1360272097120,693464696,693481336,16640
1360272108,693492216,7,672,96,1360272080734,1360272097246,693464950,693481462,16512
1360272108,693492296,15,840,56,1360272079887,1360272097295,693464183,693481591,17408
1360272108,693492320,7,392,56,1360272079990,1360272096566,693464310,693480886,16576
1360272108,693492324,15,840,56,1360272080242,1360272099954,693464566,693484278,19712
1360272128,693512140,1,137,137,1360272099883,1360272099883,693484023,693484023,0
1360272133,693516484,3,138,46,1360272130364,1360272130428,693513848,693513912,64
1360272136,693520284,3,544,181.3333333,1360272109721,1360272109785,693494005,693494069,64
1360272140,693524252,16,896,56,1360272114170,1360272122746,693498422,693506998,8576
1360272140,693524252,9,504,56,1360272114170,1360272123066,693498422,693507318,8896
1360272140,693524256,9,864,96,1360272114232,1360272129528,693498488,693513784,15296
1360272140,693524256,14,784,56,1360272114296,1360272122616,693498552,693506872,8320
1360272140,693524384,1,46,46,1360272115448,1360272115448,693499832,693499832,0
1360272142,3626804988,8,448,56,1360272116615,1360272123207,3626779603,3626786195,6592
1360272144,693528136,8,448,56,1360272116013,1360272122541,693500149,693506677,6528
1360272144,693528220,2,446,223,1360272118810,1360272118938,693503030,693503158,128
1360272157,693540644,15883,22275896,1402.499276,1360271761307,1360272149339,693144951,693532983,388032
1360272172,693556408,1,137,137,1360272144862,1360272144862,693529270,693529270,0
1360272176,693560208,19,1064,56,1360272149286,1360272158694,693533494,693542902,9408
1360272176,693560236,19,1064,56,1360272149387,1360272158603,693533623,693542839,9216
1360272176,693560240,10,560,56,1360272149576,1360272158920,693533816,693543160,9344
1360272176,693560248,9,504,56,1360272150142,1360272158398,693534390,693542646,8256
1360272176,693560332,2,498,249,1360272149803,1360272149803,693534135,693534135,0
1360272176,693560360,9,864,96,1360272150095,1360272158223,693534455,693542583,8128
1360272178,3626840916,10,560,56,1360272150350,1360272159822,3626813266,3626822738,9472
1360272184,693568264,3,492,164,1360272158832,1360272158960,693543096,693543224,128
1360272189,693572548,1276,1833459,1436.880094,1360272149435,1360272188667,693532983,693572215,39232
1360272204,693588344,14,784,56,1360272179612,1360272190108,693563956,693574452,10496
1360272204,693588344,14,784,56,1360272179420,1360272189852,693563764,693574196,10432
1360272206,3626869088,6,336,56,1360272181284,1360272186148,3626844372,3626849236,4864
1360272208,693592284,7,392,56,1360272180056,1360272187928,693564340,693572212,7872
1360272208,693592296,6,336,56,1360272180620,1360272185228,693564916,693569524,4608
1360272208,693592376,7,672,96,1360272180028,1360272188156,693564404,693572532,8128
1360272216,693600392,1,137,137,1360272188204,1360272188204,693572596,693572596,0
1360272217,693600436,3,544,181.3333333,1360272190762,1360272190826,693574198,693574262,64
1360272224,693608360,3,492,164,1360272198924,1360272199052,693583284,693583412,128
1360272240,693624332,12,672,56,1360272213034,1360272221610,693597366,693605942,8576
1360272240,693624356,6,576,96,1360272213394,1360272221330,693597750,693605686,7936
1360272241,693624440,7,392,56,1360272213668,1360272230820,693597108,693614260,17152
1360272241,693624448,12,672,56,1360272213983,1360272226463,693597431,693609911,12480
1360272241,693624452,6,336,56,1360272214171,1360272222107,693597623,693605559,7936
1360272242,3626905152,6,336,56,1360272214370,1360272230818,3626877522,3626893970,16448
1360272252,693636356,1,137,137,1360272225617,1360272225617,693609973,693609973,0
1360272257,693640444,3,544,181.3333333,1360272230880,1360272230880,693614324,693614324,0
1360272265,693648616,3,492,164,1360272239475,1360272239603,693623091,693623219,128
1360272273,693656652,14,784,56,1360272246159,1360272253071,693629811,693636723,6912
1360272273,693656656,6,576,96,1360272246541,1360272253453,693630197,693637109,6912
1360272273,693656664,7,392,56,1360272246855,1360272252807,693630519,693636471,5952
1360272273,693656744,14,784,56,1360272246131,1360272253043,693629875,693636787,6912
1360272273,693656748,8,448,56,1360272246255,1360272253103,693630003,693636851,6848
1360272274,3626937188,7,392,56,1360272246848,1360272252736,3626910036,3626915924,5888
1360272297,693680620,4,596,149,1360272270767,1360272270895,693654387,693654515,128
1360272297,693680700,1,137,137,1360272269730,1360272269730,693653430,693653430,0
1360272305,693688960,11,616,56,1360272279197,1360272286429,693663157,693670389,7232
1360272305,693688960,2,446,223,1360272279068,1360272279324,693663028,693663284,256
1360272305,693689080,11,616,56,1360272278949,1360272286117,693663029,693670197,7168
1360272305,693689084,6,336,56,1360272279519,1360272286559,693663603,693670643,7040
1360272305,693689120,5,280,56,1360272280190,1360272285246,693664310,693669366,5056
1360272306,3626969272,5,280,56,1360272280044,1360272285100,3626943316,3626948372,5056
1360272309,693692680,5,480,96,1360272280886,1360272285750,693664566,693669430,4864
1360272309,693692952,6,3428,571.3333333,1360272300581,1360272300901,693684533,693684853,320
1360272309,693692952,3,144,48,1360272300835,1360272306083,693684787,693690035,5248
1360272309,693693028,2,98,49,1360272300761,1360272306009,693684789,693690037,5248
1360272325,693708712,6,3634,605.6666667,1360272300819,1360272301075,693684531,693684787,256
1360272325,693708712,6,3321,553.5,1360272300819,1360272301011,693684531,693684723,192
1360272325,693708868,8,1463,182.875,1360272300151,1360272300343,693684019,693684211,192
1360272325,693708876,10,7022,702.2,1360272300657,1360272301041,693684533,693684917,384
1360272329,693712784,1,137,137,1360272303758,1360272303758,693687542,693687542,0
1360272337,693720756,3,544,181.3333333,1360272310761,1360272310761,693694517,693694517,0
1360272337,693720888,17,952,56,1360272312675,1360272322787,693696563,693706675,10112
1360272338,3627001268,9,504,56,1360272312497,1360272322737,3626975765,3626986005,10240
1360272341,693724744,7,392,56,1360272313141,1360272320373,693696885,693704117,7232
1360272341,693724744,8,768,96,1360272313266,1360272320882,693697010,693704626,7616
1360272341,693724892,17,952,56,1360272312800,1360272323168,693696692,693707060,10368
1360272341,693724900,8,448,56,1360272313431,1360272322647,693697331,693706547,9216
1360272345,693728896,3,492,164,1360272319195,1360272319323,693703091,693703219,128
1360272369,693753016,1,137,137,1360272342500,1360272342500,693726516,693726516,0
1360272370,3627033288,7,392,56,1360272345818,1360272351450,3627009106,3627014738,5632
1360272373,693756844,8,448,56,1360272345231,1360272351823,693729075,693735667,6592
1360272373,693756848,8,768,96,1360272345357,1360272351949,693729205,693735797,6592
1360272373,693756848,15,840,56,1360272345483,1360272352331,693729331,693736179,6848
1360272373,693756852,8,448,56,1360272345670,1360272359622,693729522,693743474,13952
1360272373,693757028,15,840,56,1360272345368,1360272359128,693729396,693743156,13760
1360272377,693760980,3,544,181.3333333,1360272350600,1360272350792,693734580,693734772,192
1360272385,693769004,3,492,164,1360272359150,1360272359278,693743154,693743282,128
1360272402,3627065472,8,448,56,1360272376933,1360272383589,3627040405,3627047061,6656
1360272405,693788864,15,840,56,1360272377340,1360272384188,693761204,693768052,6848
1360272405,693788864,15,840,56,1360272377340,1360272383868,693761204,693767732,6528
1360272405,693788864,7,672,96,1360272377466,1360272383418,693761330,693767282,5952
1360272405,693788872,7,392,56,1360272377908,1360272383732,693761780,693767604,5824
1360272405,693788952,8,448,56,1360272377314,1360272386466,693761266,693770418,9152
1360272413,693796996,1,137,137,1360272386424,1360272386424,693770420,693770420,0
1360272417,693801236,3,544,181.3333333,1360272390471,1360272390535,693774707,693774771,64
1360272421,693805352,3,138,46,1360272415698,1360272415762,693800050,693800114,64
1360272425,693809064,7,2092,298.8571429,1360272399473,1360272403953,693783537,693788017,4480
1360272433,693817100,7,672,96,1360272408334,1360272416718,693792434,693800818,8384
1360272433,693817100,14,784,56,1360272408460,1360272417228,693792560,693801328,8768
1360272433,693817104,14,784,56,1360272408521,1360272417673,693792625,693801777,9152
1360272433,693817108,7,392,56,1360272408648,1360272417032,693792756,693801140,8384
1360272434,3627097572,7,392,56,1360272408704,1360272417024,3627072276,3627080596,8320
1360272437,693821200,7,392,56,1360272409001,1360272419305,693793201,693803505,10304
1360272441,693825084,1,46,46,1360272415965,1360272415965,693800049,693800049,0
1360272441,693825088,1,46,46,1360272415962,1360272415962,693800050,693800050,0
1360272441,693825176,1,46,46,1360272415875,1360272415875,693800051,693800051,0
1360272445,693829228,1,137,137,1360272419277,1360272419277,693803505,693803505,0
1360272457,693841072,3,544,181.3333333,1360272430762,1360272430762,693814834,693814834,0
1360272469,693853104,14,784,56,1360272443017,1360272464329,693827121,693848433,21312
1360272469,693853136,3,492,164,1360272443947,1360272444075,693828083,693828211,128
1360272469,693853244,15,1440,96,1360272442109,1360272464445,693826353,693848689,22336
1360272469,693853248,29,1624,56,1360272442172,1360272465020,693826420,693849268,22848
1360272469,693853248,30,1680,56,1360272442235,1360272465339,693826483,693849587,23104
1360272469,693853248,15,840,56,1360272442298,1360272464762,693826546,693849010,22464
1360272470,3627133528,15,840,56,1360272442604,1360272464940,3627106132,3627128468,22336
1360272481,693865172,1,137,137,1360272455044,1360272455044,693839216,693839216,0
1360272497,693881316,3,544,181.3333333,1360272470580,1360272470644,693854896,693854960,64
1360272497,693881320,1,96,96,1360272470897,1360272470897,693855217,693855217,0
1360272498,693881400,1,56,56,1360272471496,1360272471496,693854896,693854896,0
1360272498,3627161632,1,56,56,1360272473475,1360272473475,3627137107,3627137107,0
1360272502,693885428,2,112,56,1360272473772,1360272474540,693857200,693857968,768
1360272502,693885432,1,56,56,1360272473960,1360272473960,693857392,693857392,0
1360272502,693885436,1,56,56,1360272474214,1360272474214,693857650,693857650,0
1360272510,693893424,3,492,164,1360272484850,1360272484978,693868274,693868402,128
1360272510,693893580,2,98,49,1360272501974,1360272507990,693885554,693891570,6016
1360272510,693893580,2,98,49,1360272502038,1360272507990,693885618,693891570,5952
1360272510,693893624,13147,18667177,1419.881114,1360272179111,1360272503783,693562735,693887407,324672
1360272510,693893660,2,98,49,1360272501892,1360272507908,693885552,693891568,6016
1360272510,693893660,2,98,49,1360272501956,1360272507908,693885616,693891568,5952
1360272510,693893660,2,98,49,1360272501892,1360272507908,693885552,693891568,6016
1360272510,693893660,3,144,48,1360272501956,1360272507908,693885616,693891568,5952
1360272518,693901700,31,29153,940.4193548,1360272512798,1360272516766,693896498,693900466,3968
1360272521,693905372,4,656,164,1360272494332,1360272494524,693878704,693878896,192
1360272526,693909464,1,137,137,1360272499977,1360272499977,693883441,693883441,0
1360272526,693909472,18,20277,1126.5,1360272501058,1360272501186,693884530,693884658,128
1360272526,693909496,14,13698,978.4285714,1360272501290,1360272501610,693884786,693885106,320
1360272526,693909496,15,15931,1062.066667,1360272501290,1360272501738,693884786,693885234,448
1360272526,693909496,12,12768,1064,1360272501290,1360272501930,693884786,693885426,640
1360272526,693909500,17,18025,1060.294118,1360272501284,1360272501412,693884784,693884912,128
1360272526,693909500,15,15531,1035.4,1360272501284,1360272501796,693884784,693885296,512
1360272526,693909500,15,15037,1002.466667,1360272501284,1360272501860,693884784,693885360,576
1360272526,693909500,12,11973,997.75,1360272501284,1360272502052,693884784,693885552,768
1360272526,693909580,11,10965,996.8181818,1360272501204,1360272501396,693884784,693884976,192
1360272526,693909580,16,17321,1082.5625,1360272501204,1360272501460,693884784,693885040,256
1360272526,693909580,12,12070,1005.833333,1360272501204,1360272501588,693884784,693885168,384
1360272526,693909584,15,15094,1006.266667,1360272501202,1360272501970,693884786,693885554,768
1360272526,693909584,17,15963,939,1360272501202,1360272502290,693884786,693885874,1088
1360272529,693913388,1,56,56,1360272502957,1360272502957,693887345,693887345,0
1360272530,693913436,2,112,56,1360272502246,1360272508134,693885682,693891570,5888
1360272530,693913436,1,56,56,1360272502374,1360272502374,693885810,693885810,0
1360272530,693913440,1,96,96,1360272502627,1360272502627,693886067,693886067,0
1360272538,693921500,6,1088,181.3333333,1360272511526,1360272531302,693895026,693914802,19776
1360272538,693921536,1,46,46,1360272512959,1360272512959,693896495,693896495,0
1360272541,693925360,6,483,80.5,1360272514311,1360272514503,693898671,693898863,192
1360272548,3627211652,6,294,49,1360272538352,1360272547440,3627202004,3627211092,9088
1360272550,693933624,4,1563,390.75,1360272524393,1360272524457,693908017,693908081,64
1360272550,693933624,16,10998,687.375,1360272524457,1360272524649,693908081,693908273,192
1360272550,693933628,3,492,164,1360272524836,1360272524964,693908464,693908592,128
1360272556,3627219652,4,184,46,1360272548273,1360272550065,3627211925,3627213717,1792
1360272556,3627219660,2,98,49,1360272545065,1360272551785,3627208725,3627215445,6720
1360272556,3627219676,3,150,50,1360272543515,1360272549787,3627207191,3627213463,6272
1360272562,693945440,5,472,94.4,1360272536097,1360272536225,693919537,693919665,128
1360272562,693945440,73,94798,1298.60274,1360272536224,1360272539104,693919664,693922544,2880
1360272566,693949828,33,1848,56,1360272538973,1360272565597,693922801,693949425,26624
1360272566,693949828,15,840,56,1360272539228,1360272565276,693923056,693949104,26048
1360272566,693949828,16,1536,96,1360272539355,1360272565339,693923183,693949167,25984
1360272566,693949908,1,137,137,1360272537997,1360272537997,693921905,693921905,0
1360272566,693949912,18,1008,56,1360272538374,1360272565638,693922286,693949550,27264
1360272566,693949920,31,1736,56,1360272538817,1360272565441,693922737,693949361,26624
1360272566,3627229568,17,952,56,1360272538179,1360272565507,3627201747,3627229075,27328
1360272566,3627229572,51,58257,1142.294118,1360272538370,1360272563522,3627201942,3627227094,25152
1360272566,3627229572,69,81958,1187.797101,1360272538370,1360272564162,3627201942,3627227734,25792
1360272566,3627229572,56,63467,1133.339286,1360272538370,1360272564994,3627201942,3627228566,26624
1360272566,3627229572,35,35314,1008.971429,1360272538434,1360272565890,3627202006,3627229462,27456
1360272566,3627229572,29,30687,1058.172414,1360272538434,1360272564098,3627202006,3627227670,25664
1360272566,3627229572,90,93459,1038.433333,1360272538434,1360272565826,3627202006,3627229398,27392
1360272566,3627229572,76,75954,999.3947368,1360272538433,1360272565249,3627202005,3627228821,26816
1360272566,3627229572,52,52566,1010.884615,1360272538433,1360272565569,3627202005,3627229141,27136
1360272566,3627229572,42,44719,1064.738095,1360272538433,1360272565441,3627202005,3627229013,27008
1360272566,3627229572,55,56624,1029.527273,1360272538433,1360272565825,3627202005,3627229397,27392
1360272566,3627229572,79,75008,949.4683544,1360272538433,1360272565313,3627202005,3627228885,26880
1360272566,3627229572,57,55241,969.1403509,1360272538433,1360272565761,3627202005,3627229333,27328
1360272566,3627229572,63,61879,982.2063492,1360272538433,1360272565761,3627202005,3627229333,27328
1360272566,3627229572,55,62012,1127.490909,1360272538433,1360272562689,3627202005,3627226261,24256
1360272566,3627229572,42,47309,1126.404762,1360272538369,1360272564993,3627201941,3627228565,26624
1360272566,3627229572,80,82179,1027.2375,1360272538433,1360272564161,3627202005,3627227733,25728
1360272566,3627229572,62,62624,1010.064516,1360272538433,1360272565313,3627202005,3627228885,26880
1360272566,3627229572,51,56464,1107.137255,1360272538433,1360272565569,3627202005,3627229141,27136
1360272566,3627229572,60,66781,1113.016667,1360272538433,1360272563457,3627202005,3627227029,25024
1360272566,3627229572,73,72483,992.9178082,1360272538433,1360272562753,3627202005,3627226325,24320
1360272566,3627229572,54,59699,1105.537037,1360272538432,1360272562816,3627202004,3627226388,24384
1360272566,3627229572,79,76626,969.9493671,1360272538496,1360272565888,3627202068,3627229460,27392
1360272566,3627229572,55,54221,985.8363636,1360272538432,1360272564800,3627202004,3627228372,26368
1360272566,3627229572,53,54246,1023.509434,1360272538432,1360272564800,3627202004,3627228372,26368
1360272566,3627229576,77,83398,1083.090909,1360272538686,1360272563966,3627202262,3627227542,25280
1360272566,3627229608,74,80629,1089.581081,1360272541406,1360272565278,3627205014,3627228886,23872
1360272566,3627229608,59,65750,1114.40678,1360272541534,1360272564062,3627205142,3627227670,22528
1360272566,3627229608,53,52382,988.3396226,1360272541597,1360272565021,3627205205,3627228629,23424
1360272566,3627229608,54,57309,1061.277778,1360272541597,1360272565789,3627205205,3627229397,24192
1360272566,3627229608,59,63348,1073.694915,1360272541597,1360272564637,3627205205,3627228245,23040
1360272566,3627229608,54,59303,1098.203704,1360272541597,1360272563677,3627205205,3627227285,22080
1360272566,3627229624,87,99319,1141.597701,1360272538318,1360272565646,3627201942,3627229270,27328
1360272566,3627229624,40,46245,1156.125,1360272538382,1360272562382,3627202006,3627226006,24000
1360272566,3627229624,71,69723,982.0140845,1360272538382,1360272565774,3627202006,3627229398,27392
1360272566,3627229624,67,69506,1037.402985,1360272538382,1360272563982,3627202006,3627227606,25600
1360272566,3627229624,50,53077,1061.54,1360272538382,1360272565710,3627202006,3627229334,27328
1360272566,3627229624,70,64416,920.2285714,1360272538382,1360272564942,3627202006,3627228566,26560
1360272566,3627229624,60,64144,1069.066667,1360272538382,1360272565710,3627202006,3627229334,27328
1360272566,3627229624,52,59658,1147.269231,1360272538382,1360272562638,3627202006,3627226262,24256
1360272566,3627229624,59,67942,1151.559322,1360272538318,1360272565646,3627201942,3627229270,27328
1360272566,3627229624,52,55539,1068.057692,1360272538382,1360272563150,3627202006,3627226774,24768
1360272566,3627229624,21,24525,1167.857143,1360272538318,1360272539470,3627201942,3627203094,1152
1360272566,3627229624,38,38143,1003.763158,1360272538318,1360272562446,3627201942,3627226070,24128
1360272566,3627229624,59,61718,1046.067797,1360272538382,1360272564110,3627202006,3627227734,25728
1360272566,3627229624,33,35668,1080.848485,1360272538382,1360272562638,3627202006,3627226262,24256
1360272566,3627229624,37,39780,1075.135135,1360272538381,1360272565645,3627202005,3627229269,27264
1360272566,3627229624,99,101970,1030,1360272538381,1360272564685,3627202005,3627228309,26304
1360272566,3627229624,87,83663,961.6436782,1360272538381,1360272564365,3627202005,3627227989,25984
1360272566,3627229624,59,62704,1062.779661,1360272538381,1360272564173,3627202005,3627227797,25792
1360272566,3627229624,88,96802,1100.022727,1360272538381,1360272564173,3627202005,3627227797,25792
1360272566,3627229624,87,85897,987.3218391,1360272538381,1360272565901,3627202005,3627229525,27520
1360272566,3627229624,62,67572,1089.870968,1360272538381,1360272564749,3627202005,3627228373,26368
1360272566,3627229624,53,55938,1055.433962,1360272538381,1360272565069,3627202005,3627228693,26688
1360272566,3627229624,65,71395,1098.384615,1360272538381,1360272565837,3627202005,3627229461,27456
1360272566,3627229624,71,75160,1058.591549,1360272538381,1360272565517,3627202005,3627229141,27136
1360272566,3627229624,47,45401,965.9787234,1360272538381,1360272565773,3627202005,3627229397,27392
1360272566,3627229656,68,75918,1116.441176,1360272541550,1360272565678,3627205206,3627229334,24128
1360272566,3627229656,44,46610,1059.318182,1360272541550,1360272564846,3627205206,3627228502,23296
1360272566,3627229656,63,70292,1115.746032,1360272541549,1360272565101,3627205205,3627228757,23552
1360272566,3627229656,69,77158,1118.231884,1360272541549,1360272564205,3627205205,3627227861,22656
1360272574,693957908,5,940,188,1360272563533,1360272570829,693947441,693954737,7296
1360272580,3627243652,13,9602,738.6153846,1360272567154,1360272579378,3627230806,3627243030,12224
1360272582,693965748,5,254,50.8,1360272567918,1360272576302,693951666,693960050,8384
1360272582,693965748,2,94,47,1360272568172,1360272576300,693951920,693960048,8128
1360272582,693965780,10,2116,211.6,1360272571530,1360272579722,693955310,693963502,8192
1360272582,693965784,4,851,212.75,1360272577353,1360272578185,693961137,693961969,832
1360272582,693965788,3,1319,439.6666667,1360272573509,1360272577285,693957297,693961073,3776
1360272582,693965828,3,142,47.33333333,1360272567837,1360272576221,693951665,693960049,8384
1360272582,693965828,3,150,50,1360272568027,1360272576219,693951855,693960047,8192
1360272582,693965832,3,150,50,1360272568152,1360272576216,693951984,693960048,8064
1360272582,693965856,3,142,47.33333333,1360272563330,1360272576194,693947186,693960050,12864
1360272582,693965872,3,1215,405,1360272573425,1360272576689,693957297,693960561,3264
1360272586,693969560,17,14680,863.5294118,1360272558439,1360272569255,693941999,693952815,10816
1360272588,3627251652,20,16061,803.05,1360272567410,1360272581554,3627231062,3627245206,14144
1360272588,3627251660,18,15115,839.7222222,1360272566954,1360272581802,3627230614,3627245462,14848
1360272590,693973460,12,743,61.91666667,1360272562378,1360272566346,693945838,693949806,3968
1360272590,693973496,8,1020,127.5,1360272563689,1360272569065,693947185,693952561,5376
1360272590,693973504,10,1882,188.2,1360272564638,1360272570462,693948142,693953966,5824
1360272590,693973736,3,150,50,1360272577719,1360272583735,693961455,693967471,6016
1360272590,693973736,3,150,50,1360272577719,1360272583735,693961455,693967471,6016
1360272590,693973740,17,8729,513.4705882,1360272577718,1360272583798,693961458,693967538,6080
1360272590,693973744,4,196,49,1360272578224,1360272583728,693961968,693967472,5504
1360272590,693973748,3,150,50,1360272578413,1360272584685,693962161,693968433,6272
1360272590,693973748,3,325,108.3333333,1360272575404,1360272582956,693959152,693966704,7552
1360272590,693973748,3,325,108.3333333,1360272575403,1360272582699,693959151,693966447,7296
1360272590,693973748,2,92,46,1360272578666,1360272585770,693962414,693969518,7104
1360272590,693973780,3,150,50,1360272579468,1360272585676,693963248,693969456,6208
1360272590,693973780,2,92,46,1360272579595,1360272585739,693963375,693969519,6144
1360272590,693973784,2,92,46,1360272579529,1360272585737,693963313,693969521,6208
1360272590,693973784,3,150,50,1360272577351,1360272583687,693961135,693967471,6336
1360272590,693973784,4,196,49,1360272579910,1360272585734,693963694,693969518,5824
1360272590,693973792,2,92,46,1360272577663,1360272583679,693961455,693967471,6016
1360272590,693973792,2,92,46,1360272577663,1360272583679,693961455,693967471,6016
1360272590,693973824,4,196,49,1360272578336,1360272584672,693962160,693968496,6336
1360272590,693973828,2,92,46,1360272578589,1360272585693,693962417,693969521,7104
1360272590,693973860,2,92,46,1360272579451,1360272585659,693963311,693969519,6208
1360272590,693973860,2,92,46,1360272579515,1360272585659,693963375,693969519,6144
1360272590,693973860,3,150,50,1360272579514,1360272585594,693963374,693969454,6080
1360272590,693973868,2,92,46,1360272577333,1360272583605,693961201,693967473,6272
1360272588,3627251672,51,51937,1018.372549,1360272565790,1360272582110,3627229462,3627245782,16320
1360272590,3627253652,32,32155,1004.84375,1360272565873,1360272578289,3627229525,3627241941,12416
1360272590,3627253652,50,51476,1029.52,1360272565873,1360272582705,3627229525,3627246357,16832
1360272590,3627253652,24,21985,916.0416667,1360272565872,1360272577776,3627229524,3627241428,11904
1360272594,693977476,26,1456,56,1360272566397,1360272585341,693949873,693968817,18944
1360272594,693977476,13,728,56,1360272566524,1360272584892,693950000,693968368,18368
1360272594,693977476,14,1344,96,1360272566586,1360272584954,693950062,693968430,18368
1360272594,693977480,14,784,56,1360272566838,1360272585590,693950318,693969070,18752
1360272594,693977564,29,1624,56,1360272566243,1360272585891,693949807,693969455,19648
1360272594,3627257616,38,41872,1101.894737,1360272565908,1360272581460,3627229524,3627245076,15552
1360272594,3627257616,56,51867,926.1964286,1360272565908,1360272582740,3627229524,3627246356,16832
1360272594,3627257616,52,52507,1009.75,1360272565972,1360272583316,3627229588,3627246932,17344
1360272594,3627257616,42,49011,1166.928571,1360272565972,1360272582228,3627229588,3627245844,16256
1360272594,3627257616,28,27611,986.1071429,1360272565908,1360272578388,3627229524,3627242004,12480
1360272594,3627257620,34,37242,1095.352941,1360272566035,1360272579539,3627229655,3627243159,13504
1360272594,3627257620,18,15701,872.2777778,1360272566097,1360272579217,3627229717,3627242837,13120
1360272594,3627257620,33,37956,1150.181818,1360272566161,1360272573329,3627229781,3627236949,7168
1360272594,3627257620,26,27164,1044.769231,1360272566225,1360272580561,3627229845,3627244181,14336
1360272594,3627257620,44,41098,934.0454545,1360272566160,1360272581008,3627229780,3627244628,14848
1360272594,3627257620,14,784,56,1360272566160,1360272585104,3627229780,3627248724,18944
1360272594,3627257620,46,50816,1104.695652,1360272566160,1360272576656,3627229780,3627240276,10496
1360272594,3627257624,50,49882,997.64,1360272566223,1360272582991,3627229847,3627246615,16768
1360272594,3627257624,34,30321,891.7941176,1360272566479,1360272577999,3627230103,3627241623,11520
1360272594,3627257624,12,10713,892.75,1360272566286,1360272578638,3627229910,3627242262,12352
1360272594,3627257624,40,39357,983.925,1360272566414,1360272580046,3627230038,3627243670,13632
1360272594,3627257624,49,53137,1084.428571,1360272566669,1360272582221,3627230293,3627245845,15552
1360272594,3627257624,26,24875,956.7307692,1360272566604,1360272577548,3627230228,3627241172,10944
1360272594,3627257624,28,30029,1072.464286,1360272566863,1360272578959,3627230487,3627242583,12096
1360272594,3627257628,46,47742,1037.869565,1360272567050,1360272582730,3627230678,3627246358,15680
1360272594,3627257628,69,69891,1012.913043,1360272566921,1360272583689,3627230549,3627247317,16768
1360272594,3627257628,16,15148,946.75,1360272567241,1360272580425,3627230869,3627244053,13184
1360272594,3627257632,27,28157,1042.851852,1360272567239,1360272579719,3627230871,3627243351,12480
1360272594,3627257644,16,15277,954.8125,1360272567738,1360272575098,3627231382,3627238742,7360
1360272594,3627257644,34,37484,1102.470588,1360272567802,1360272573178,3627231446,3627236822,5376
1360272594,3627257644,23,27546,1197.652174,1360272567929,1360272571321,3627231573,3627234965,3392
1360272594,3627257644,35,36589,1045.4,1360272567865,1360272579705,3627231509,3627243349,11840
1360272594,3627257648,46,44715,972.0652174,1360272568054,1360272582710,3627231702,3627246358,14656
1360272594,3627257648,12,11903,991.9166667,1360272568438,1360272573110,3627232086,3627236758,4672
1360272594,3627257668,21,24228,1153.714286,1360272565922,1360272575970,3627229590,3627239638,10048
1360272594,3627257668,45,43879,975.0888889,1360272565922,1360272581090,3627229590,3627244758,15168
1360272594,3627257668,27,31477,1165.814815,1360272565922,1360272574370,3627229590,3627238038,8448
1360272594,3627257668,29,30264,1043.586207,1360272565985,1360272580385,3627229653,3627244053,14400
1360272594,3627257668,35,36916,1054.742857,1360272565985,1360272578849,3627229653,3627242517,12864
1360272594,3627257668,53,55847,1053.716981,1360272566049,1360272582945,3627229717,3627246613,16896
1360272594,3627257668,24,26912,1121.333333,1360272566049,1360272577889,3627229717,3627241557,11840
1360272594,3627257668,33,32602,987.9393939,1360272566049,1360272578849,3627229717,3627242517,12800
1360272594,3627257668,21,23140,1101.904762,1360272565984,1360272575520,3627229652,3627239188,9536
1360272594,3627257668,60,59655,994.25,1360272565984,1360272582944,3627229652,3627246612,16960
1360272594,3627257668,32,33766,1055.1875,1360272566112,1360272579808,3627229780,3627243476,13696
1360272594,3627257672,22,24678,1121.727273,1360272566110,1360272570334,3627229782,3627234006,4224
1360272594,3627257672,30,35008,1166.933333,1360272566365,1360272575581,3627230037,3627239253,9216
1360272594,3627257672,33,30915,936.8181818,1360272566492,1360272578652,3627230164,3627242324,12160
1360272594,3627257676,42,48779,1161.404762,1360272566873,1360272578073,3627230549,3627241749,11200
1360272594,3627257676,16,18218,1138.625,1360272566745,1360272571545,3627230421,3627235221,4800
1360272594,3627257680,36,36797,1022.138889,1360272567446,1360272578326,3627231126,3627242006,10880
1360272594,3627257680,32,34725,1085.15625,1360272567189,1360272577941,3627230869,3627241621,10752
1360272594,3627257680,37,37360,1009.72973,1360272567253,1360272580245,3627230933,3627243925,12992
1360272594,3627257692,29,35464,1222.896552,1360272567755,1360272573771,3627231447,3627237463,6016
1360272594,3627257692,29,29114,1003.931034,1360272567562,1360272575498,3627231254,3627239190,7936
1360272594,3627257692,49,47013,959.4489796,1360272567626,1360272582346,3627231318,3627246038,14720
1360272598,693981496,13,7121,547.7692308,1360272571561,1360272577193,693955057,693960689,5632
1360272598,3627261696,18,19738,1096.555556,1360272571143,1360272579335,3627234839,3627243031,8192
1360272598,3627261716,18,19020,1056.666667,1360272573489,1360272579377,3627237205,3627243093,5888
1360272602,693985468,2,274,137,1360272575171,1360272576195,693958639,693959663,1024
1360272602,693985540,4,805,201.25,1360272577596,1360272578236,693961136,693961776,640
1360272602,693985540,12,5498,458.1666667,1360272577660,1360272580668,693961200,693964208,3008
1360272606,693989484,6,911,151.8333333,1360272578420,1360272579316,693961904,693962800,896
1360272606,693989488,6,2488,414.6666667,1360272578927,1360272580143,693962415,693963631,1216
1360272606,693989664,7,2534,362,1360272578751,1360272580223,693962415,693963887,1472
1360272606,693989672,6,630,105,1360272579448,1360272580728,693963120,693964400,1280
1360272606,693989792,6,1540,256.6666667,1360272602432,1360272605632,693986224,693989424,3200
1360272614,693997824,9,1158,128.6666667,1360272603550,1360272611870,693987374,693995694,8320
1360272614,693997860,8,3945,493.125,1360272605498,1360272612282,693989358,693996142,6784
1360272614,693997908,9,796,88.44444444,1360272603469,1360272613133,693987377,693997041,9664
1360272622,694005576,3,138,46,1360272597782,1360272597846,693981358,693981422,64
1360272622,694005772,3,138,46,1360272595348,1360272595348,693979120,693979120,0
1360272622,694005888,2,92,46,1360272614302,1360272618398,693998190,694002286,4096
1360272622,694005956,2,92,46,1360272613660,1360272617500,693997616,694001456,3840
1360272626,694009620,8,2444,305.5,1360272600683,1360272600811,693984303,693984431,128
1360272630,694013576,7,1012,144.5714286,1360272602712,1360272602968,693986288,693986544,256
1360272630,694013612,6,3772,628.6666667,1360272603892,1360272604084,693987504,693987696,192
1360272630,694013640,4,740,185,1360272605079,1360272605527,693988719,693989167,448
1360272630,694013752,2,590,295,1360272602345,1360272602409,693986097,693986161,64
1360272630,694013808,5,2335,467,1360272605104,1360272605296,693988912,693989104,192
1360272630,694014004,2,92,46,1360272616874,1360272624554,694000878,694008558,7680
1360272634,694017732,3,492,164,1360272609146,1360272609274,693992878,693993006,128
1360272638,694021572,3,169,56.33333333,1360272610203,1360272610267,693993775,693993839,64
1360272642,694025556,1,46,46,1360272617771,1360272617771,694001327,694001327,0
1360272642,694025556,2,92,46,1360272617771,1360272617835,694001327,694001391,64
1360272642,694025556,1,46,46,1360272617771,1360272617771,694001327,694001327,0
1360272642,694025556,1,46,46,1360272617771,1360272617771,694001327,694001327,0
1360272642,694025556,1,46,46,1360272617835,1360272617835,694001391,694001391,0
1360272642,694025616,2,92,46,1360272616751,1360272616751,694000367,694000367,0
1360272642,694025736,1,46,46,1360272617592,1360272617592,694001328,694001328,0
1360272642,694025736,1,46,46,1360272617592,1360272617592,694001328,694001328,0
1360272642,694025736,2,92,46,1360272617656,1360272617656,694001392,694001392,0
1360272642,694025736,2,92,46,1360272617656,1360272617656,694001392,694001392,0
1360272642,694025736,1,46,46,1360272617656,1360272617656,694001392,694001392,0
1360272646,694029456,1,46,46,1360272617935,1360272617935,694001391,694001391,0
1360272646,694029456,1,46,46,1360272617935,1360272617935,694001391,694001391,0
1360272646,694029620,1,137,137,1360272620138,1360272620138,694003758,694003758,0
1360272646,694029860,2,92,46,1360272626493,1360272642813,694010353,694026673,16320
1360272646,694029900,2,92,46,1360272625301,1360272640725,694009201,694024625,15424
1360272646,694029980,5,261,52.2,1360272635779,1360272645379,694019759,694029359,9600
1360272654,694037776,3,138,46,1360272627984,1360272628112,694011760,694011888,128
1360272662,694045944,8,458,57.25,1360272654759,1360272654823,694038703,694038767,64
1360272666,694049640,2,92,46,1360272639701,1360272639701,694023341,694023341,0
1360272666,694049732,1,46,46,1360272639612,1360272639612,694023344,694023344,0
1360272666,694049756,1,46,46,1360272640226,1360272640226,694023982,694023982,0
1360272674,694057608,2,92,46,1360272646775,1360272646775,694030383,694030383,0
1360272674,694057768,3,492,164,1360272649368,1360272649496,694033136,694033264,128
1360272676,3627339760,121,127509,1053.793388,1360272538182,1360272672006,3627201942,3627335766,133824
1360272682,694065760,1,137,137,1360272655134,1360272655134,694038894,694038894,0
1360272682,3627345704,2,92,46,1360272657021,1360272657085,3627320725,3627320789,64
1360272690,694073724,3,138,46,1360272661956,1360272662020,694045680,694045744,64
1360272698,694081764,1,46,46,1360272671066,1360272671066,694054830,694054830,0
1360272698,694081880,1,46,46,1360272671591,1360272671591,694055471,694055471,0
1360272700,3627363772,133,138787,1043.511278,1360272538233,1360272695033,3627202005,3627358805,156800
1360272702,694085720,1,46,46,1360272675462,1360272675462,694059182,694059182,0
1360272702,694086016,2,92,46,1360272695389,1360272695389,694079405,694079405,0
1360272710,694093696,2,92,46,1360272684703,1360272684703,694068399,694068399,0
1360272714,694097676,1,137,137,1360272686642,1360272686642,694070318,694070318,0
1360272714,694097872,3,492,164,1360272689262,1360272689390,694073134,694073262,128
1360272714,3627377700,1,46,46,1360272687104,1360272687104,3627350804,3627350804,0
1360272714,3627377724,2,92,46,1360272688043,1360272688107,3627351767,3627351831,64
1360272714,3627377760,2,92,46,1360272687047,1360272687047,3627350807,3627350807,0
1360272715,3627377804,2,92,46,1360272689987,1360272689987,3627352791,3627352791,0
1360272718,694101948,1,46,46,1360272693412,1360272693412,694077360,694077360,0
1360272718,694102040,3,138,46,1360272716356,1360272716420,694100396,694100460,64
1360272718,3627381688,1,46,46,1360272690125,1360272690125,3627353813,3627353813,0
1360272718,3627381688,2,92,46,1360272690125,1360272690125,3627353813,3627353813,0
1360272718,3627381692,1,46,46,1360272692107,1360272692107,3627355799,3627355799,0
1360272718,3627381716,1,46,46,1360272691060,1360272691060,3627354776,3627354776,0
1360272718,3627381728,2,92,46,1360272693032,1360272693096,3627356760,3627356824,64
1360272718,3627381728,1,46,46,1360272693030,1360272693030,3627356758,3627356758,0
1360272718,3627381744,2,92,46,1360272690071,1360272690071,3627353815,3627353815,0
1360272718,3627381744,2,92,46,1360272692054,1360272692054,3627355798,3627355798,0
1360272718,3627381764,2,92,46,1360272691011,1360272691011,3627354775,3627354775,0
1360272718,3627381764,2,92,46,1360272691011,1360272691075,3627354775,3627354839,64
1360272718,3627381768,1,46,46,1360272691008,1360272691008,3627354776,3627354776,0
1360272718,3627381768,1,46,46,1360272691008,1360272691008,3627354776,3627354776,0
1360272718,3627381776,1,46,46,1360272692984,1360272692984,3627356760,3627356760,0
1360272719,3627381788,1,46,46,1360272693972,1360272693972,3627356760,3627356760,0
1360272722,694105688,1,46,46,1360272694692,1360272694692,694078380,694078380,0
1360272722,694105724,1,46,46,1360272695748,1360272695748,694079472,694079472,0
1360272722,694105816,1,46,46,1360272695589,1360272695589,694079405,694079405,0
1360272722,694105852,1,46,46,1360272695619,1360272695619,694079471,694079471,0
1360272722,3627385688,2,92,46,1360272694095,1360272694095,3627357783,3627357783,0
1360272722,3627385688,1,46,46,1360272694095,1360272694095,3627357783,3627357783,0
1360272722,3627385688,1,46,46,1360272694095,1360272694095,3627357783,3627357783,0
1360272722,3627385696,2,92,46,1360272695110,1360272695110,3627358806,3627358806,0
1360272722,3627385696,1,46,46,1360272695110,1360272695110,3627358806,3627358806,0
1360272722,3627385696,2,92,46,1360272695110,1360272695110,3627358806,3627358806,0
1360272722,3627385696,1,46,46,1360272695110,1360272695110,3627358806,3627358806,0
1360272722,3627385696,1,46,46,1360272695110,1360272695110,3627358806,3627358806,0
1360272722,3627385696,1,46,46,1360272695110,1360272695110,3627358806,3627358806,0
1360272722,3627385716,1,46,46,1360272696049,1360272696049,3627359765,3627359765,0
1360272722,3627385716,1,46,46,1360272696049,1360272696049,3627359765,3627359765,0
1360272722,3627385724,1,46,46,1360272697066,1360272697066,3627360790,3627360790,0
1360272722,3627385744,1,46,46,1360272694036,1360272694036,3627357780,3627357780,0
1360272722,3627385744,1,46,46,1360272694036,1360272694036,3627357780,3627357780,0
1360272722,3627385748,1,46,46,1360272694036,1360272694036,3627357784,3627357784,0
1360272722,3627385748,1,46,46,1360272694036,1360272694036,3627357784,3627357784,0
1360272722,3627385752,1,46,46,1360272695056,1360272695056,3627358808,3627358808,0
1360272722,3627385752,1,46,46,1360272695056,1360272695056,3627358808,3627358808,0
1360272722,3627385752,1,46,46,1360272695056,1360272695056,3627358808,3627358808,0
1360272722,3627385756,1,46,46,1360272695051,1360272695051,3627358807,3627358807,0
1360272722,3627385756,1,46,46,1360272695051,1360272695051,3627358807,3627358807,0
1360272722,3627385776,1,46,46,1360272695991,1360272695991,3627359767,3627359767,0
1360272722,3627385776,1,46,46,1360272695991,1360272695991,3627359767,3627359767,0
1360272722,3627385776,2,92,46,1360272695991,1360272695991,3627359767,3627359767,0
1360272722,3627385784,2,92,46,1360272697006,1360272697006,3627360790,3627360790,0
1360272726,3627389692,1,46,46,1360272698060,1360272698060,3627361752,3627361752,0
1360272726,3627389692,1,46,46,1360272698060,1360272698060,3627361752,3627361752,0
1360272726,3627389692,1,46,46,1360272698123,1360272698123,3627361815,3627361815,0
1360272726,3627389692,1,46,46,1360272698123,1360272698123,3627361815,3627361815,0
1360272726,3627389744,1,46,46,1360272698006,1360272698006,3627361750,3627361750,0
1360272726,3627389744,1,46,46,1360272698005,1360272698005,3627361749,3627361749,0
1360272726,3627389744,1,46,46,1360272698005,1360272698005,3627361749,3627361749,0
1360272726,3627389744,2,92,46,1360272698069,1360272698069,3627361813,3627361813,0
1360272726,3627389744,1,46,46,1360272698069,1360272698069,3627361813,3627361813,0
1360272726,3627389744,2,92,46,1360272698005,1360272698069,3627361749,3627361813,64
1360272726,3627389744,1,46,46,1360272698005,1360272698005,3627361749,3627361749,0
1360272726,3627389768,2,92,46,1360272699004,1360272699004,3627362772,3627362772,0
1360272726,3627389772,1,46,46,1360272699004,1360272699004,3627362776,3627362776,0
1360272754,694138244,3,492,164,1360272729081,1360272729209,694113325,694113453,128
1360272758,694142104,1,137,137,1360272731591,1360272731591,694115695,694115695,0
1360272762,694146024,1,46,46,1360272736086,1360272736086,694120110,694120110,0
1360272766,694150384,6,496,82.66666667,1360272758125,1360272761069,694142509,694145453,2944
1360272786,694170000,1,46,46,1360272758508,1360272758508,694142508,694142508,0
1360272794,694178072,3,492,164,1360272768932,1360272769060,694153004,694153132,128
1360272794,694178084,1,137,137,1360272766041,1360272766041,694150125,694150125,0
1360272798,694182384,4,184,46,1360272788781,1360272795821,694173165,694180205,7040
1360272804,3627467784,4,190,47.5,1360272794863,1360272800367,3627458647,3627464151,5504
1360272805,3627467796,3,144,48,1360272796172,1360272802316,3627458968,3627465112,6144
1360272806,694190388,3,144,48,1360272795241,1360272801321,694179629,694185709,6080
1360272806,694190388,3,144,48,1360272795240,1360272801320,694179628,694185708,6080
1360272806,694190388,3,144,48,1360272795240,1360272801320,694179628,694185708,6080
1360272806,694190388,3,144,48,1360272795240,1360272801320,694179628,694185708,6080
1360272806,694190388,4,196,49,1360272795240,1360272801448,694179628,694185836,6208
1360272807,694190464,4,190,47.5,1360272796164,1360272802308,694179628,694185772,6144
1360272815,694198500,2,92,46,1360272804706,1360272813410,694188206,694196910,8704
1360272818,694202148,6,336,56,1360272793752,1360272812760,694177900,694196908,19008
1360272818,694202208,26,30158,1159.923077,1360272791452,1360272793436,694175660,694177644,1984
1360272819,3627481920,5,1793,358.6,1360272794063,1360272794191,3627456983,3627457111,128
1360272819,3627481936,17,19204,1129.647059,1360272794624,1360272794816,3627457560,3627457752,192
1360272819,3627481936,13,12549,965.3076923,1360272794624,1360272795200,3627457560,3627458136,576
1360272819,3627481936,12,9340,778.3333333,1360272794624,1360272796160,3627457560,3627459096,1536
1360272819,3627481988,10,7821,782.1,1360272794571,1360272795979,3627457559,3627458967,1408
1360272822,694206048,27,30137,1116.185185,1360272794109,1360272796029,694178157,694180077,1920
1360272822,694206048,5,3088,617.6,1360272794108,1360272794492,694178156,694178540,384
1360272822,694206048,33,35303,1069.787879,1360272794108,1360272795900,694178156,694179948,1792
1360272822,694206048,20,22290,1114.5,1360272794107,1360272795515,694178155,694179563,1408
1360272822,694206048,10,8159,815.9,1360272794107,1360272795899,694178155,694179947,1792
1360272822,694206048,12,8368,697.3333333,1360272794107,1360272795835,694178155,694179883,1728
1360272822,694206048,5,1545,309,1360272794107,1360272794555,694178155,694178603,448
1360272822,694206048,9,8934,992.6666667,1360272794107,1360272795579,694178155,694179627,1472
1360272822,694206052,5,280,56,1360272794298,1360272810234,694178350,694194286,15936
1360272822,694206164,3,168,56,1360272793991,1360272809223,694178155,694193387,15232
1360272822,694206168,23,28718,1248.608696,1360272793987,1360272794691,694178155,694178859,704
1360272822,694206168,9,7963,884.7777778,1360272793986,1360272795586,694178154,694179754,1600
1360272822,694206168,11,7912,719.2727273,1360272793986,1360272795650,694178154,694179818,1664
1360272822,694206168,35,33685,962.4285714,1360272793990,1360272796038,694178158,694180206,2048
1360272822,694206168,11,5527,502.4545455,1360272793990,1360272795526,694178158,694179694,1536
1360272822,694206168,3,288,96,1360272794053,1360272809669,694178221,694193837,15616
1360272822,694206296,2,112,56,1360272795972,1360272806340,694180268,694190636,10368
1360272822,694206328,1,46,46,1360272796773,1360272796773,694181101,694181101,0
1360272823,3627485924,2,112,56,1360272796811,1360272807819,3627459735,3627470743,11008
1360272834,694218120,1,137,137,1360272808692,1360272808692,694192812,694192812,0
1360272834,694218128,4,538,134.5,1360272809006,1360272809134,694193134,694193262,128
1360272834,694218136,1,46,46,1360272809699,1360272809699,694193835,694193835,0
1360272834,694218168,1,46,46,1360272806468,1360272806468,694190636,694190636,0
1360272834,694218180,1,46,46,1360272807158,1360272807158,694191338,694191338,0
1360272834,694218180,1,46,46,1360272807159,1360272807159,694191339,694191339,0
1360272838,694222180,1,46,46,1360272810103,1360272810103,694194283,694194283,0
1360272870,694254228,3,138,46,1360272844168,1360272844168,694228396,694228396,0
1360272871,694254424,1,137,137,1360272844779,1360272844779,694228203,694228203,0
1360272874,694258256,4,538,134.5,1360272848877,1360272848941,694233133,694233197,64
1360272874,694258256,2,92,46,1360272849132,1360272849132,694233388,694233388,0
1360272874,694258256,2,92,46,1360272849132,1360272849132,694233388,694233388,0
1360272874,694258268,3,138,46,1360272846112,1360272846112,694230380,694230380,0
1360272874,694258348,3,138,46,1360272849041,1360272849041,694233389,694233389,0
1360272878,694262216,3,138,46,1360272852181,1360272852181,694236397,694236397,0
1360272887,694270464,1,46,46,1360272858563,1360272858563,694242027,694242027,0
1360272903,694286504,1,137,137,1360272877021,1360272877021,694260525,694260525,0
1360272915,694298604,4,544,136,1360272889782,1360272889846,694273386,694273450,64
1360272919,694302720,4,184,46,1360272911300,1360272916932,694295020,694300652,5632
1360272919,694302728,2,92,46,1360272912313,1360272912313,694296041,694296041,0
1360272919,694302800,2,92,46,1360272911217,1360272911217,694295017,694295017,0
1360272919,694302800,2,92,46,1360272911217,1360272911217,694295017,694295017,0
1360272919,694302832,4,184,46,1360272912211,1360272918547,694296043,694302379,6336
1360272927,694310444,6,3664,610.6666667,1360272901525,1360272901717,694284969,694285161,192
1360272927,694310636,8,1629,203.625,1360272900885,1360272901013,694284521,694284649,128
1360272927,694310640,4,2454,613.5,1360272901396,1360272901396,694285036,694285036,0
1360272935,694318596,1,46,46,1360272907774,1360272907774,694291370,694291370,0
1360272935,694318640,1,46,46,1360272909266,1360272909266,694292906,694292906,0
1360272935,3627598220,2,92,46,1360272909221,1360272909221,3627572441,3627572441,0
1360272939,694322508,2,92,46,1360272911511,1360272911639,694295019,694295147,128
1360272939,694322592,1,137,137,1360272914052,1360272914052,694297644,694297644,0
1360272939,3627602160,1,46,46,1360272911264,1360272911264,3627574424,3627574424,0
1360272939,3627602160,2,92,46,1360272911264,1360272911264,3627574424,3627574424,0
1360272939,3627602220,1,46,46,1360272911202,1360272911202,3627574422,3627574422,0
1360272939,3627602220,1,46,46,1360272911202,1360272911202,3627574422,3627574422,0
1360272947,694330396,1,46,46,1360272919623,1360272919623,694303019,694303019,0
1360272947,694330428,1,46,46,1360272920550,1360272920550,694303978,694303978,0
1360272947,694330508,1,46,46,1360272919127,1360272919127,694302635,694302635,0
1360272950,694334392,1,46,46,1360272922080,1360272922080,694306472,694306472,0
1360272955,694338492,3,492,164,1360272930276,1360272930340,694313768,694313832,64
1360272963,694346568,3,138,46,1360272936795,1360272936859,694320363,694320427,64
1360272975,694358804,1,137,137,1360272950317,1360272950317,694334121,694334121,0
1360272995,694378636,3,492,164,1360272969749,1360272969877,694353385,694353513,128
1360273003,694386680,3,604,201.3333333,1360272975274,1360272975338,694358954,694359018,64
1360273007,694390668,1,46,46,1360272980275,1360272980275,694363943,694363943,0
1360273011,694394800,1,137,137,1360272985904,1360272985904,694369704,694369704,0
1360273023,694407048,3,138,46,1360273016952,1360273017016,694401000,694401064,64
1360273035,694418832,4,544,136,1360273010131,1360273010579,694393963,694394411,448
1360273043,694426904,1,137,137,1360273018250,1360273018250,694402154,694402154,0
1360273051,694435016,1,46,46,1360273024279,1360273024279,694408295,694408295,0
1360273067,694450904,1,46,46,1360273040969,1360273040969,694424873,694424873,0
1360273075,694459032,3,492,164,1360273050185,1360273050313,694434217,694434345,128
1360273079,694463096,1,137,137,1360273054280,1360273054280,694438376,694438376,0
1360273087,694471316,6,496,82.66666667,1360273083052,1360273086124,694467368,694470440,3072
1360273093,3627755908,3,144,48,1360273084252,1360273090076,3627747160,3627752984,5824
1360273093,3627755920,2,98,49,1360273084240,1360273090064,3627747160,3627752984,5824
1360273093,3627755920,3,144,48,1360273084240,1360273090064,3627747160,3627752984,5824
1360273093,3627755936,2,98,49,1360273086145,1360273092033,3627749081,3627754969,5888
1360273093,3627755936,3,144,48,1360273086145,1360273092033,3627749081,3627754969,5888
1360273095,694479292,3,138,46,1360273090309,1360273090437,694474601,694474729,128
1360273103,694487328,6,493,82.16666667,1360273096162,1360273101026,694480490,694485354,4864
1360273111,694494932,1,46,46,1360273083757,1360273083757,694467689,694467689,0
1360273111,694494956,26,1456,56,1360273084243,1360273109715,694468199,694493671,25472
1360273111,694494964,50,2800,56,1360273084811,1360273110347,694468775,694494311,25536
1360273111,694494968,50,2800,56,1360273084934,1360273110406,694468902,694494374,25472
1360273111,694494968,25,1400,56,1360273085001,1360273110153,694468969,694494121,25152
1360273111,3627774568,14,14538,1038.428571,1360273083336,1360273083528,3627746904,3627747096,192
1360273111,3627774568,32,37068,1158.375,1360273083336,1360273084808,3627746904,3627748376,1472
1360273111,694495148,25,2400,96,1360273084949,1360273110037,694469097,694494185,25088
1360273111,694495184,1,137,137,1360273085998,1360273085998,694470182,694470182,0
1360273111,3627774600,6,3765,627.5,1360273085353,1360273085737,3627748953,3627749337,384
1360273111,3627774600,46,59919,1302.586957,1360273085416,1360273085928,3627749016,3627749528,512
1360273111,3627774628,24,1344,56,1360273084430,1360273109518,3627748058,3627773146,25088
1360273111,694495232,3,144,48,1360273103231,1360273109247,694487463,694493479,6016
1360273111,3627774628,28,27017,964.8928571,1360273083276,1360273085388,3627746904,3627749016,2112
1360273111,3627774640,4,590,147.5,1360273083521,1360273084865,3627747161,3627748505,1344
1360273111,694495344,4,184,46,1360273104719,1360273106319,694489063,694490663,1600
1360273115,694499156,3,492,164,1360273090636,1360273090828,694474792,694474984,192
1360273119,694503004,35,20699,591.4,1360273092899,1360273095715,694476903,694479719,2816
1360273119,694503204,98,136960,1397.55102,1360273093402,1360273113114,694477606,694497318,19712
1360273119,694503224,20,23676,1183.8,1360273093385,1360273111177,694477609,694495401,17792
1360273127,694511020,1,46,46,1360273101845,1360273101845,694485865,694485865,0
1360273139,694522964,31,1736,56,1360273111051,1360273138699,694495015,694522663,27648
1360273139,694522976,26,1456,56,1360273111488,1360273138304,694495464,694522280,26816
1360273139,694523100,55,3080,56,1360273111173,1360273138757,694495273,694522857,27584
1360273139,694523100,55,3080,56,1360273111235,1360273138499,694495335,694522599,27264
1360273139,694523104,29,2784,96,1360273111488,1360273138240,694495592,694522344,26752
1360273139,3627802544,28,1568,56,1360273111010,1360273138594,3627774554,3627802138,27584
1360273155,694539168,1,137,137,1360273129472,1360273129472,694513640,694513640,0
1360273159,694543004,3,492,164,1360273131682,1360273132002,694515686,694516006,320
1360273167,694551000,66,3696,56,1360273138919,1360273166567,694522919,694550567,27648
1360273167,694551000,34,1904,56,1360273139045,1360273166693,694523045,694550693,27648
1360273167,694551008,67,3752,56,1360273139487,1360273166495,694523495,694550503,27008
1360273167,694551012,32,1792,56,1360273139673,1360273166297,694523685,694550309,26624
1360273167,694551116,33,3168,96,1360273139057,1360273166641,694523173,694550757,27584
1360273167,3627830612,34,1904,56,1360273139550,1360273166174,3627803162,3627829786,26624
1360273168,694551428,607,862219,1420.459638,1360273085284,1360273164068,694468712,694547496,78784
1360273175,694559356,3,138,46,1360273172931,1360273172995,694557287,694557351,64
1360273176,694559396,3,138,46,1360273171905,1360273171969,694555301,694555365,64
1360273176,694559396,607,859085,1415.29654,1360273104066,1360273170178,694487462,694553574,66112
1360273179,694563208,17,4959,291.7058824,1360273152533,1360273155669,694536741,694539877,3136
1360273187,694571216,1,46,46,1360273162640,1360273162640,694546856,694546856,0
1360273191,694575224,1,137,137,1360273165062,1360273165062,694549286,694549286,0
1360273191,694575260,53,2968,56,1360273166627,1360273190499,694550887,694574759,23872
1360273195,694579068,67,3752,56,1360273166882,1360273194530,694550950,694578598,27648
1360273195,694579076,32,1792,56,1360273167386,1360273194138,694551462,694578214,26752
1360273195,3627858560,32,1792,56,1360273167058,1360273194642,3627830618,3627858202,27584
1360273195,694579192,32,1792,56,1360273166822,1360273194534,694551014,694578726,27712
1360273195,694579200,31,2976,96,1360273167391,1360273194143,694551591,694578343,26752
1360273199,694583324,3,492,164,1360273171937,1360273172065,694556261,694556389,128
1360273203,694587316,11,11844,1076.727273,1360273175785,1360273175913,694560101,694560229,128
1360273208,694591708,4,190,47.5,1360273201290,1360273206858,694584998,694590566,5568
1360273216,694599472,46,2576,56,1360273191670,1360273215542,694575142,694599014,23872
1360273216,694599664,4,190,47.5,1360273205685,1360273212405,694589349,694596069,6720
1360273216,694599668,2,98,49,1360273202993,1360273208881,694586661,694592549,5888
1360273216,694599672,3,150,50,1360273202988,1360273208876,694586660,694592548,5888
1360273216,694599672,4,196,49,1360273203056,1360273208880,694586728,694592552,5824
1360273216,694599672,4,190,47.5,1360273203246,1360273208878,694586918,694592550,5632
1360273216,694599748,3,144,48,1360273202912,1360273208800,694586660,694592548,5888
1360273216,694599752,2,98,49,1360273203166,1360273208798,694586918,694592550,5632
1360273216,694599752,6,288,48,1360273205982,1360273212638,694589734,694596390,6656
1360273220,694603412,48,2688,56,1360273195571,1360273219763,694578983,694603175,24192
1360273220,694603416,24,1344,56,1360273195759,1360273218735,694579175,694602151,22976
1360273223,3627886684,25,1400,56,1360273195351,1360273221399,3627859035,3627885083,26048
1360273223,694607316,25,2400,96,1360273194921,1360273222185,694579237,694606501,27264
1360273224,694607504,23,1288,56,1360273195990,1360273223318,694579494,694606822,27328
1360273224,694607688,7,353,50.42857143,1360273215262,1360273216350,694598950,694600038,1088
1360273227,3627890548,2,92,46,1360273199391,1360273199455,3627862939,3627863003,64
1360273227,3627890556,2,92,46,1360273200342,1360273200598,3627863898,3627864154,256
1360273227,3627890556,1,46,46,1360273200342,1360273200342,3627863898,3627863898,0
1360273227,3627890576,2,92,46,1360273201344,1360273201984,3627864920,3627865560,640
1360273227,3627890584,2,92,46,1360273202234,1360273203002,3627865818,3627866586,768
1360273227,3627890632,2,92,46,1360273201289,1360273201993,3627864921,3627865625,704
1360273228,694611412,6,3526,587.6666667,1360273202995,1360273205171,694586407,694588583,2176
1360273228,694611412,7,3336,476.5714286,1360273202995,1360273205299,694586407,694588711,2304
1360273228,694611468,7,1425,203.5714286,1360273201275,1360273201979,694584743,694585447,704
1360273228,694611508,7,3307,472.4285714,1360273202897,1360273203985,694586405,694587493,1088
1360273228,694611536,6,3875,645.8333333,1360273203125,1360273203957,694586661,694587493,832
1360273232,694615532,1,137,137,1360273205177,1360273205177,694588709,694588709,0
1360273240,694623472,3,492,164,1360273213429,1360273213749,694596901,694597221,320
1360273240,694623752,7,328,46.85714286,1360273232606,1360273239006,694616358,694622758,6400
1360273240,694623828,4,190,47.5,1360273232337,1360273238737,694616165,694622565,6400
1360273244,694627424,35,1960,56,1360273215974,1360273243494,694599398,694626918,27520
1360273244,694627460,32,7402,231.3125,1360273216577,1360273243649,694600037,694627109,27072
1360273247,694631328,17,952,56,1360273218973,1360273246493,694603301,694630821,27520
1360273248,694631420,32,1792,56,1360273223336,1360273247208,694606756,694630628,23872
1360273248,694631644,4,196,49,1360273240904,1360273247496,694624548,694631140,6592
1360273248,694631648,2,98,49,1360273241158,1360273247494,694624806,694631142,6336
1360273248,694631648,4,196,49,1360273241157,1360273247493,694624805,694631141,6336
1360273248,694631680,5,466,93.2,1360273242471,1360273245223,694626151,694628903,2752
1360273248,694631724,2,98,49,1360273240826,1360273247418,694624550,694631142,6592
1360273251,3627914548,19,1064,56,1360273224156,1360273250588,3627887704,3627914136,26432
1360273251,694635392,19,1824,96,1360273224733,1360273250781,694609125,694635173,26048
1360273252,694635548,17,952,56,1360273227115,1360273251051,694610663,694634599,23936
1360273253,3627915904,2,98,49,1360273241058,1360273247586,3627903962,3627910490,6528
1360273253,3627915904,4,190,47.5,1360273241313,1360273247649,3627904217,3627910553,6336
1360273253,3627915904,3,144,48,1360273241313,1360273247649,3627904217,3627910553,6336
1360273253,3627915908,4,196,49,1360273242974,1360273249566,3627905882,3627912474,6592
1360273253,3627915908,3,150,50,1360273243997,1360273250589,3627906905,3627913497,6592
1360273253,3627915924,3,144,48,1360273241294,1360273247630,3627904218,3627910554,6336
1360273253,3627915924,2,98,49,1360273241294,1360273247566,3627904218,3627910490,6272
1360273253,3627915928,2,98,49,1360273242443,1360273247563,3627905371,3627910491,5120
1360273253,3627915928,2,98,49,1360273242443,1360273247627,3627905371,3627910555,5184
1360273253,3627915928,2,98,49,1360273242443,1360273247563,3627905371,3627910491,5120
1360273253,3627915928,3,144,48,1360273242443,1360273247627,3627905371,3627910555,5184
1360273253,3627915928,2,98,49,1360273242955,1360273249547,3627905883,3627912475,6592
1360273253,3627915928,4,196,49,1360273242955,1360273249547,3627905883,3627912475,6592
1360273256,694639652,3,140,46.66666667,1360273241344,1360273249472,694624996,694633124,8128
1360273256,694639692,9,3846,427.3333333,1360273242714,1360273254298,694626406,694637990,11584
1360273256,694639700,5,230,46,1360273246547,1360273253459,694630247,694637159,6912
1360273256,694639700,4,184,46,1360273246547,1360273253587,694630247,694637287,7040
1360273256,694639744,2,92,46,1360273249189,1360273254373,694632933,694638117,5184
1360273256,694639744,2,92,46,1360273249189,1360273254373,694632933,694638117,5184
1360273256,694639772,2,94,47,1360273242632,1360273248328,694626404,694632100,5696
1360273259,694643380,16,19145,1196.5625,1360273232553,1360273233641,694616933,694618021,1088
1360273260,694643464,7,1251,178.7142857,1360273232574,1360273247742,694616038,694631206,15168
1360273260,694643464,11,1987,180.6363636,1360273232574,1360273242622,694616038,694626086,10048
1360273263,3627926576,20,21689,1084.45,1360273238784,1360273240640,3627902360,3627904216,1856
1360273263,3627926628,10,6871,687.1,1360273238733,1360273240909,3627902361,3627904537,2176
1360273264,694647676,11,6219,565.3636364,1360273261993,1360273262825,694645669,694646501,832
1360273264,694647748,13,4030,310,1360273242401,1360273261793,694626149,694645541,19392
1360273267,3627930548,13,11475,882.6923077,1360273239135,1360273240287,3627902683,3627903835,1152
1360273267,3627930548,6,3014,502.3333333,1360273239134,1360273240798,3627902682,3627904346,1664
1360273267,3627930552,17,16522,971.8823529,1360273239386,1360273240538,3627902938,3627904090,1152
1360273267,3627930572,7,3477,496.7142857,1360273240392,1360273240968,3627903964,3627904540,576
1360273267,3627930572,5,1916,383.2,1360273240391,1360273241031,3627903963,3627904603,640
1360273267,694651360,12,9262,771.8333333,1360273240126,1360273255998,694624486,694640358,15872
1360273267,694651388,23,23106,1004.608696,1360273240737,1360273255841,694625125,694640229,15104
1360273268,694651472,18,15013,834.0555556,1360273240884,1360273256692,694624356,694640164,15808
1360273268,694651484,5,3152,630.4,1360273241704,1360273241832,694625188,694625316,128
1360273271,3627934624,8,663,82.875,1360273244690,1360273246802,3627908314,3627910426,2112
1360273271,694655400,7,2082,297.4285714,1360273245524,1360273250452,694629924,694634852,4928
1360273272,694655428,48,2688,56,1360273247011,1360273271459,694630439,694654887,24448
1360273272,694655436,1,137,137,1360273247642,1360273247642,694631078,694631078,0
1360273272,694655472,10,4575,457.5,1360273244404,1360273256436,694627876,694639908,12032
1360273272,694655524,7,2082,297.4285714,1360273246531,1360273248195,694630055,694631719,1664
1360273275,694659364,56,3136,56,1360273246905,1360273274681,694631269,694659045,27776
1360273275,694659376,27,1512,56,1360273247471,1360273274415,694631847,694658791,26944
1360273279,3627942680,26,1456,56,1360273251353,1360273278425,3627915033,3627942105,27072
1360273279,694663368,24,1344,56,1360273251063,1360273278263,694635431,694662631,27200
1360273279,694663376,27,2592,96,1360273251757,1360273277997,694636133,694662373,26240
1360273280,694663540,6,984,164,1360273253490,1360273254194,694637030,694637734,704
1360273280,694663760,4,190,47.5,1360273267155,1360273273171,694650915,694656931,6016
1360273292,694675644,9,1643,182.5555556,1360273266825,1360273269833,694650469,694653477,3008
1360273300,694683576,51,2856,56,1360273271950,1360273299342,694655526,694682918,27392
1360273304,694687448,47,2632,56,1360273276108,1360273302156,694659556,694685604,26048
1360273304,694687540,20,1120,56,1360273276079,1360273302255,694659619,694685795,26176
1360273304,694687792,8,1351,168.875,1360273296820,1360273297844,694680612,694681636,1024
1360273304,694687828,7,1889,269.8571429,1360273298514,1360273298834,694682342,694682662,320
1360273304,694687832,17,3619,212.8823529,1360273299021,1360273299341,694682853,694683173,320
1360273304,694687908,8,1940,242.5,1360273298624,1360273301184,694682532,694685092,2560
1360273307,3627970660,19,1064,56,1360273279663,1360273306735,3627943323,3627970395,27072
1360273308,694691564,19,1824,96,1360273279831,1360273307735,694663395,694691299,27904
1360273308,694691568,18,1008,56,1360273280277,1360273307349,694663845,694690917,27072
1360273312,694695592,3,138,46,1360273283772,1360273283900,694667364,694667492,128
1360273312,694695628,1,137,137,1360273285209,1360273285209,694668837,694668837,0
1360273312,694695828,14,3485,248.9285714,1360273287440,1360273294352,694671268,694678180,6912
1360273312,694695828,3,138,46,1360273303569,1360273308177,694687397,694692005,4608
1360273312,694695828,3,138,46,1360273303569,1360273307985,694687397,694691813,4416
1360273312,694695872,3,144,48,1360273298467,1360273308515,694682339,694692387,10048
1360273312,694695904,10,576,57.6,1360273299653,1360273306309,694683557,694690213,6656
1360273312,694695916,3,144,48,1360273300664,1360273306936,694684580,694690852,6272
1360273312,694695948,2,98,49,1360273298392,1360273308376,694682340,694692324,9984
1360273312,694695952,13,6311,485.4615385,1360273309779,1360273311059,694693731,694695011,1280
1360273316,694699764,3,138,46,1360273288594,1360273289106,694672358,694672870,512
1360273317,3627979904,4,202,50.5,1360273309860,1360273316644,3627972764,3627979548,6784
1360273320,694703668,10,6038,603.8,1360273293487,1360273310255,694677155,694693923,16768
1360273320,694703832,73,83715,1146.780822,1360273299725,1360273319629,694683557,694703461,19904
1360273320,694703836,4,196,49,1360273312647,1360273319367,694696483,694703203,6720
1360273320,694703840,9,526,58.44444444,1360273308675,1360273316547,694692515,694700387,7872
1360273320,694703880,10,3892,389.2,1360273309917,1360273316381,694693797,694700261,6464
1360273320,694703960,10,3892,389.2,1360273310092,1360273316300,694694052,694700260,6208
1360273320,694703960,9,3846,427.3333333,1360273310091,1360273316299,694694051,694700259,6208
1360273324,694707572,23,22213,965.7826087,1360273298642,1360273299218,694682214,694682790,576
1360273324,694707572,5,2026,405.2,1360273298769,1360273298961,694682341,694682533,192
1360273324,694707600,64,65108,1017.3125,1360273299252,1360273310260,694682852,694693860,11008
1360273324,694707604,11,4723,429.3636364,1360273299569,1360273300401,694683173,694684005,832
1360273324,694707604,6,1192,198.6666667,1360273299569,1360273300273,694683173,694683877,704
1360273324,694707604,52,57704,1109.692308,1360273299567,1360273316015,694683171,694699619,16448
1360273324,694707684,4,929,232.25,1360273298143,1360273298399,694681827,694682083,256
1360273324,694707696,58,56676,977.1724138,1360273299158,1360273320726,694682854,694704422,21568
1360273324,694707720,7,1654,236.2857143,1360273299451,1360273300155,694683171,694683875,704
1360273325,3627987900,3,144,48,1360273312870,1360273319718,3627975770,3627982618,6848
1360273325,3627987912,4,190,47.5,1360273317850,1360273319002,3627980762,3627981914,1152
1360273328,694711524,11,4422,402,1360273300031,1360273300863,694683555,694684387,832
1360273328,694711644,9,2767,307.4444444,1360273299914,1360273300426,694683558,694684070,512
1360273328,694711644,43,2408,56,1360273300039,1360273327303,694683683,694710947,27264
1360273328,694711916,6,502,83.66666667,1360273324600,1360273327800,694708516,694711716,3200
1360273328,694711916,2,92,46,1360273324600,1360273324920,694708516,694708836,320
1360273332,694715772,23,1288,56,1360273307464,1360273331144,694691236,694714916,23680
1360273332,694715852,46,2576,56,1360273306358,1360273331382,694690210,694715234,25024
1360273335,3627998640,32,30966,967.6875,1360273307649,1360273319809,3627971289,3627983449,12160
1360273335,3627998644,3,2939,979.6666667,1360273308480,1360273308736,3627972124,3627972380,256
1360273335,3627998644,15,12896,859.7333333,1360273307774,1360273318974,3627971418,3627982618,11200
1360273335,3627998660,9,11252,1250.222222,1360273308655,1360273309807,3627972315,3627973467,1152
1360273335,3627998660,12,9663,805.25,1360273308846,1360273318702,3627972506,3627982362,9856
1360273335,3627998696,21,1176,56,1360273307339,1360273334091,3627971035,3627997787,26752
1360273335,3627998700,26,28604,1100.153846,1360273307527,1360273320199,3627971227,3627983899,12672
1360273335,3627998712,22,21941,997.3181818,1360273308474,1360273310522,3627972186,3627974234,2048
1360273335,3627998716,15,20047,1336.466667,1360273308536,1360273310584,3627972252,3627974300,2048
1360273335,3627998716,30,28429,947.6333333,1360273308789,1360273320629,3627972505,3627984345,11840
1360273336,694719628,73,51732,708.6575342,1360273308440,1360273335704,694692068,694719332,27264
1360273336,694719628,79,55280,699.7468354,1360273308440,1360273335320,694692068,694718948,26880
1360273336,694719628,93,69609,748.483871,1360273308439,1360273335319,694692067,694718947,26880
1360273336,694719636,23,2208,96,1360273309136,1360273334288,694692772,694717924,25152
1360273336,694719708,23,1288,56,1360273307848,1360273335624,694691556,694719332,27776
1360273336,694719712,40,47841,1196.025,1360273308037,1360273318021,694691749,694701733,9984
1360273336,694719744,94,69635,740.7978723,1360273308325,1360273335013,694692069,694718757,26688
1360273336,694719860,37,34983,945.4864865,1360273310768,1360273318768,694694628,694702628,8000
1360273340,694723768,4,2685,671.25,1360273311821,1360273312397,694695589,694696165,576
1360273344,694727740,1,137,137,1360273319271,1360273319271,694703011,694703011,0
1360273348,694731772,5,2758,551.6,1360273320200,1360273321032,694703972,694704804,832
1360273349,3628011900,4,202,50.5,1360273340197,1360273348325,3628003097,3628011225,8128
1360273352,694736160,3,144,48,1360273342978,1360273350658,694727138,694734818,7680
1360273352,694736240,7,334,47.71428571,1360273343219,1360273351603,694727459,694735843,8384
1360273356,694739832,45,2520,56,1360273327757,1360273355597,694711589,694739429,27840
1360273356,694739864,1,46,46,1360273328874,1360273328874,694712738,694712738,0
1360273360,694743716,12,8892,741,1360273335872,1360273346240,694719588,694729956,10368
1360273360,694743808,42,2352,56,1360273331939,1360273359779,694715747,694743587,27840
1360273360,694743904,22,1232,56,1360273332741,1360273359045,694716645,694742949,26304
1360273360,694743980,12,3438,286.5,1360273335224,1360273337784,694719204,694721764,2560
1360273360,694744020,5,460,92,1360273351888,1360273352528,694735908,694736548,640
1360273360,694744024,2,94,47,1360273352458,1360273357834,694736482,694741858,5376
1360273360,694744028,4,196,49,1360273352458,1360273357834,694736486,694741862,5376
1360273360,694744064,4,184,46,1360273357794,1360273358306,694741858,694742370,512
1360273360,694744100,6,1101,183.5,1360273352000,1360273352448,694736100,694736548,448
1360273360,694744100,13,2545,195.7692308,1360273352063,1360273358015,694736163,694742115,5952
1360273360,694744100,3,140,46.66666667,1360273352127,1360273358079,694736227,694742179,5952
1360273360,694744104,3,138,46,1360273352572,1360273357756,694736676,694741860,5184
1360273360,694744104,8,2418,302.25,1360273352507,1360273352763,694736611,694736867,256
1360273360,694744112,4,184,46,1360273357363,1360273358195,694741475,694742307,832
1360273360,694744144,3,144,48,1360273346324,1360273352788,694730468,694736932,6464
1360273363,3628026672,9,5530,614.4444444,1360273338340,1360273349028,3628002012,3628012700,10688
1360273363,3628026684,4,1314,328.5,1360273338583,1360273343447,3628002267,3628007131,4864
1360273363,3628026684,19,1064,56,1360273335128,1360273361112,3627998812,3628024796,25984
1360273363,3628026716,59,80644,1366.847458,1360273336952,1360273343800,3628000668,3628007516,6848
1360273363,3628026724,4,2343,585.75,1360273337967,1360273345135,3628001691,3628008859,7168
1360273363,3628026740,15,10405,693.6666667,1360273338462,1360273345630,3628002202,3628009370,7168
1360273364,694747732,7,859,122.7142857,1360273339758,1360273352046,694723490,694735778,12288
1360273364,694747736,28,2688,96,1360273336236,1360273363820,694719972,694747556,27584
1360273364,694747744,24,1344,56,1360273336613,1360273363173,694720357,694746917,26560
1360273364,694747772,13,3408,262.1538462,1360273337352,1360273354888,694721124,694738660,17536
1360273364,694747788,9,4813,534.7777778,1360273338362,1360273348346,694722150,694732134,9984
1360273364,694747908,12,6134,511.1666667,1360273338626,1360273359618,694722534,694743526,20992
1360273365,3628028008,6,744,124,1360273339899,1360273361979,3628002907,3628024987,22080
1360273365,3628028012,3,138,46,1360273363253,1360273364725,3628026265,3628027737,1472
1360273367,3628030644,10,13051,1305.1,1360273339133,1360273339389,3628002777,3628003033,256
1360273367,3628030648,14,8043,574.5,1360273339323,1360273361403,3628002971,3628025051,22080
1360273368,694751728,8,5708,713.5,1360273339955,1360273346163,694723683,694729891,6208
1360273368,694751960,4,1084,271,1360273341582,1360273353486,694725542,694737446,11904
1360273368,694752092,4,196,49,1360273355017,1360273360969,694739109,694745061,5952
1360273368,694752132,2,92,46,1360273363617,1360273364641,694747749,694748773,1024
1360273368,694752176,147,212923,1448.455782,1360273306420,1360273366516,694690596,694750692,60096
1360273368,694752176,2,94,47,1360273354802,1360273360626,694738978,694744802,5824
1360273368,694752180,5,261,52.2,1360273358255,1360273366063,694742435,694750243,7808
1360273376,694759752,4,2405,601.25,1360273348890,1360273349402,694732642,694733154,512
1360273376,694759784,3,1120,373.3333333,1360273349437,1360273349693,694733221,694733477,256
1360273376,694759784,48,58661,1222.104167,1360273349436,1360273354364,694733220,694738148,4928
1360273376,694759796,30,19431,647.7,1360273350383,1360273362223,694734179,694746019,11840
1360273376,694759936,3,1364,454.6666667,1360273349346,1360273349602,694733282,694733538,256
1360273376,694759940,53,53965,1018.207547,1360273349600,1360273360672,694733540,694744612,11072
1360273376,694759960,1,137,137,1360273349773,1360273349773,694733733,694733733,0
1360273376,694760036,61,64115,1051.065574,1360273351487,1360273373759,694735523,694757795,22272
1360273376,694760036,2,92,46,1360273363584,1360273370880,694747620,694754916,7296
1360273376,694760080,2,92,46,1360273365077,1360273370837,694749157,694754917,5760
1360273376,694760080,21,3206,152.6666667,1360273362324,1360273369940,694746404,694754020,7616
1360273376,694760088,3,138,46,1360273366282,1360273372810,694750370,694756898,6528
1360273376,694760092,8,1157,144.625,1360273366150,1360273370118,694750242,694754210,3968
1360273376,694760140,2,92,46,1360273365206,1360273370774,694749346,694754914,5568
1360273376,694760168,3,144,48,1360273366266,1360273371770,694750434,694755938,5504
1360273380,694763740,10,2818,281.8,1360273351976,1360273352936,694735716,694736676,960
1360273380,694763796,11,4990,453.6363636,1360273354480,1360273354800,694738276,694738596,320
1360273380,694763800,3,1132,377.3333333,1360273354477,1360273354541,694738277,694738341,64
1360273380,694763820,19,17993,947,1360273354584,1360273355864,694738404,694739684,1280
1360273380,694763824,2,123,61.5,1360273354773,1360273354837,694738597,694738661,64
1360273384,694767752,41,2296,56,1360273356252,1360273382940,694740004,694766692,26688
1360273388,694771952,6,2425,404.1666667,1360273363219,1360273365203,694747171,694749155,1984
1360273388,694771956,7,2471,353,1360273363471,1360273365391,694747427,694749347,1920
1360273388,694771964,38,2128,56,1360273359944,1360273387592,694743908,694771556,27648
1360273388,694771988,11,616,56,1360273360686,1360273381166,694744674,694765154,20480
1360273388,694772036,20,3832,191.6,1360273362109,1360273369917,694746145,694753953,7808
1360273391,3628054644,13,728,56,1360273363839,1360273386879,3628027483,3628050523,23040
1360273391,3628054660,1,46,46,1360273364847,1360273364847,3628028507,3628028507,0
1360273392,694775812,1,46,46,1360273366111,1360273366111,694749923,694749923,0
1360273392,694775880,13,728,56,1360273364122,1360273388378,694748002,694772258,24256
1360273392,694775892,13,1248,96,1360273365006,1360273382606,694748898,694766498,17600
1360273392,694775896,18,11642,646.7777778,1360273365261,1360273369677,694749157,694753573,4416
1360273392,694776092,9,543,60.33333333,1360273380550,1360273386246,694764642,694770338,5696
1360273392,694776172,5,230,46,1360273385206,1360273386294,694769378,694770466,1088
1360273396,694779916,13,2159,166.0769231,1360273368887,1360273386679,694752803,694770595,17792
1360273400,694783864,11,5223,474.8181818,1360273372074,1360273372778,694755938,694756642,704
1360273400,694784172,135,95625,708.3333333,1360273307894,1360273398454,694692066,694782626,90560
1360273404,694787796,24,13787,574.4583333,1360273376750,1360273403758,694760546,694787554,27008
1360273404,694787876,3,1423,474.3333333,1360273376030,1360273376478,694759906,694760354,448
1360273408,694792240,3,144,48,1360273394289,1360273399729,694778529,694783969,5440
1360273408,694792284,6,282,47,1360273396229,1360273403077,694780513,694787361,6848
1360273408,694792320,4,190,47.5,1360273393956,1360273400868,694778276,694785188,6912
1360273408,694792320,9,420,46.66666667,1360273394210,1360273403746,694778530,694788066,9536
1360273408,694792320,9,420,46.66666667,1360273394337,1360273403745,694778657,694788065,9408
1360273412,694795796,24,1344,56,1360273384240,1360273411760,694768036,694795556,27520
1360273413,3628076012,3,150,50,1360273400630,1360273408950,3628063642,3628071962,8320
1360273413,3628076016,2,98,49,1360273401268,1360273408948,3628064284,3628071964,7680
1360273413,3628076020,5,248,49.6,1360273400622,1360273408942,3628063642,3628071962,8320
1360273413,3628076036,4,202,50.5,1360273402337,1360273408865,3628065373,3628071901,6528
1360273413,3628076036,2,98,49,1360273402337,1360273408865,3628065373,3628071901,6528
1360273416,694799920,1,137,137,1360273389684,1360273389684,694773604,694773604,0
1360273416,694799956,38,16481,433.7105263,1360273391311,1360273406799,694775267,694790755,15488
1360273416,694799984,71,61218,862.2253521,1360273391411,1360273408243,694775395,694792227,16832
1360273416,694800088,6,300,50,1360273403660,1360273411468,694787748,694795556,7808
1360273416,694800100,3,150,50,1360273400833,1360273408513,694784933,694792613,7680
1360273416,694800100,3,150,50,1360273400896,1360273408512,694784996,694792612,7616
1360273416,694800100,4,246,61.5,1360273409278,1360273411966,694793378,694796066,2688
1360273416,694800104,4,190,47.5,1360273404988,1360273414012,694789092,694798116,9024
1360273416,694800124,2,98,49,1360273401639,1360273408423,694785763,694792547,6784
1360273416,694800124,5,242,48.4,1360273401703,1360273408935,694785827,694793059,7232
1360273416,694800128,3,144,48,1360273401893,1360273408421,694786021,694792549,6528
1360273416,694800128,2,98,49,1360273401893,1360273408421,694786021,694792549,6528
1360273416,694800128,3,144,48,1360273401955,1360273410979,694786083,694795107,9024
1360273416,694800128,3,144,48,1360273402082,1360273408610,694786210,694792738,6528
1360273416,694800140,7,352,50.28571429,1360273403414,1360273414422,694787554,694798562,11008
1360273416,694800140,2,98,49,1360273403414,1360273414550,694787554,694798690,11136
1360273416,694800160,3,138,46,1360273415364,1360273415684,694799524,694799844,320
1360273416,694800160,4,204,51,1360273415363,1360273415683,694799523,694799843,320
1360273416,694800176,4,196,49,1360273400820,1360273411892,694784996,694796068,11072
1360273416,694800176,2,98,49,1360273400820,1360273408436,694784996,694792612,7616
1360273416,694800208,3,144,48,1360273401556,1360273408532,694785764,694792740,6976
1360273416,694800208,3,150,50,1360273401556,1360273408340,694785764,694792548,6784
1360273416,694800208,3,144,48,1360273401556,1360273410644,694785764,694794852,9088
1360273416,694800208,3,150,50,1360273401746,1360273408274,694785954,694792482,6528
1360273416,694800208,2,98,49,1360273401746,1360273408338,694785954,694792546,6592
1360273416,694800208,4,196,49,1360273401810,1360273408402,694786018,694792610,6592
1360273416,694800208,4,196,49,1360273401810,1360273408530,694786018,694792738,6720
1360273416,694800212,5,248,49.6,1360273401872,1360273408400,694786084,694792612,6528
1360273416,694800212,2,98,49,1360273401999,1360273408655,694786211,694792867,6656
1360273416,694800212,7,446,63.71428571,1360273410125,1360273413645,694794337,694797857,3520
1360273416,694800220,4,184,46,1360273414278,1360273415302,694798498,694799522,1024
1360273416,694800240,5,242,48.4,1360273403314,1360273412914,694787554,694797154,9600
1360273420,694803796,2,92,46,1360273392559,1360273398383,694776355,694782179,5824
1360273420,694803796,2,92,46,1360273392558,1360273396078,694776354,694779874,3520
1360273420,694803952,44,53690,1220.227273,1360273394259,1360273413459,694778211,694797411,19200
1360273423,3628086668,21,1176,56,1360273396712,1360273422760,3628060380,3628086428,26048
1360273423,3628086724,23,18485,803.6956522,1360273395888,1360273408304,3628059612,3628072028,12416
1360273423,3628086752,22,21447,974.8636364,1360273397842,1360273413906,3628061594,3628077658,16064
1360273424,694807808,29,20059,691.6896552,1360273395939,1360273418019,694779747,694801827,22080
1360273424,694807808,26,23367,898.7307692,1360273395938,1360273411298,694779746,694795106,15360
1360273424,694807852,19,1824,96,1360273397429,1360273423605,694781281,694807457,26176
1360273424,694807892,20,15448,772.4,1360273399119,1360273404175,694783011,694788067,5056
1360273424,694807892,2,123,61.5,1360273398798,1360273398990,694782690,694782882,192
1360273424,694807896,13,8214,631.8461538,1360273399051,1360273402763,694782947,694786659,3712
1360273424,694807896,23,19378,842.5217391,1360273399115,1360273407115,694783011,694791011,8000
1360273424,694807896,16,19184,1199,1360273399179,1360273400971,694783075,694784867,1792
1360273424,694807900,29,19018,655.7931034,1360273395845,1360273408069,694779745,694791969,12224
1360273424,694807900,42,38988,928.2857143,1360273395845,1360273408005,694779745,694791905,12160
1360273424,694807940,3,169,56.33333333,1360273396766,1360273396830,694780706,694780770,64
1360273424,694807944,22,1232,56,1360273397210,1360273423450,694781154,694807394,26240
1360273424,694807944,36,2016,56,1360273397146,1360273423706,694781090,694807650,26560
1360273424,694807968,18,1008,56,1360273397572,1360273422980,694781540,694806948,25408
1360273424,694808260,2,94,47,1360273410784,1360273419232,694795044,694803492,8448
1360273427,3628090652,10,10290,1029,1360273399288,1360273402680,3628062940,3628066332,3392
1360273427,3628090652,21,17403,828.7142857,1360273399541,1360273417461,3628063193,3628081113,17920
1360273427,3628090656,8,4804,600.5,1360273399667,1360273406643,3628063323,3628070299,6976
1360273427,3628090656,21,21962,1045.809524,1360273399666,1360273406130,3628063322,3628069786,6464
1360273427,3628090660,21,22646,1078.380952,1360273400047,1360273414383,3628063707,3628078043,14336
1360273427,3628090724,13,10103,777.1538462,1360273399600,1360273404208,3628063324,3628067932,4608
1360273427,3628090724,9,5316,590.6666667,1360273399664,1360273408048,3628063388,3628071772,8384
1360273427,3628090724,8,6398,799.75,1360273399854,1360273410926,3628063578,3628074650,11072
1360273427,3628090724,7,3446,492.2857143,1360273399918,1360273405614,3628063642,3628069338,5696
1360273427,3628090724,15,13978,931.8666667,1360273399918,1360273407854,3628063642,3628071578,7936
1360273427,3628090744,6,4297,716.1666667,1360273400540,1360273402588,3628064284,3628066332,2048
1360273427,3628090752,11,13200,1200,1360273401364,1360273401428,3628065116,3628065180,64
1360273428,694811832,7,6139,877,1360273400265,1360273406025,694784097,694789857,5760
1360273428,694811864,9,6791,754.5555556,1360273401132,1360273403692,694784996,694787556,2560
1360273428,694811872,8,7748,968.5,1360273401636,1360273408676,694785508,694792548,7040
1360273428,694811880,79,100666,1274.253165,1360273402329,1360273417305,694786209,694801185,14976
1360273428,694811944,19,22001,1157.947368,1360273403740,1360273407900,694787684,694791844,4160
1360273428,694811944,4,1503,375.75,1360273400089,1360273402777,694784033,694786721,2688
1360273428,694811960,15,16560,1104,1360273401034,1360273406218,694784994,694790178,5184
1360273428,694811996,6,4188,698,1360273402085,1360273403749,694786081,694787745,1664
1360273428,694812040,1,46,46,1360273403579,1360273403579,694787619,694787619,0
1360273432,694815876,2,123,61.5,1360273406497,1360273407073,694790373,694790949,576
1360273432,694815984,3,181,60.33333333,1360273405682,1360273406834,694789666,694790818,1152
1360273432,694816240,3,138,46,1360273428275,1360273428339,694812515,694812579,64
1360273440,694823980,42,2352,56,1360273413621,1360273439349,694797601,694823329,25728
1360273440,694824216,4,184,46,1360273427532,1360273438156,694811748,694822372,10624
1360273444,694827824,1,46,46,1360273416404,1360273416404,694800228,694800228,0
1360273444,694827832,1,46,46,1360273416970,1360273416970,694800802,694800802,0
1360273444,694827908,1,46,46,1360273416189,1360273416189,694800097,694800097,0
1360273444,694828056,1,46,46,1360273416170,1360273416170,694800226,694800226,0
1360273444,694828064,1,46,46,1360273416675,1360273416675,694800739,694800739,0
1360273444,694828064,3,498,166,1360273416737,1360273417697,694800801,694801761,960
1360273444,694828068,5,1000,200,1360273416927,1360273417439,694800995,694801507,512
1360273448,694831904,1,137,137,1360273422721,1360273422721,694806625,694806625,0
1360273448,694831988,10,4590,459,1360273421870,1360273429038,694805858,694813026,7168
1360273448,694832168,155,116667,752.6903226,1360273307898,1360273444218,694692066,694828386,136320
1360273448,694832296,9,516,57.33333333,1360273443129,1360273443961,694827425,694828257,832
1360273451,3628114640,17,952,56,1360273423684,1360273450756,3628087324,3628114396,27072
1360273451,3628114720,1,46,46,1360273425268,1360273425268,3628088988,3628088988,0
1360273451,3628114720,2,92,46,1360273425202,1360273425650,3628088922,3628089370,448
1360273451,3628114736,2,92,46,1360273426146,1360273426530,3628089882,3628090266,384
1360273452,694835848,17,1632,96,1360273424440,1360273451448,694808288,694835296,27008
1360273452,694835936,19,1064,56,1360273423906,1360273450914,694807842,694834850,27008
1360273452,694835956,18,1008,56,1360273424269,1360273451277,694808225,694835233,27008
1360273452,694835960,36,2016,56,1360273424523,1360273451659,694808483,694835619,27136
1360273455,3628118664,9,7392,821.3333333,1360273429741,1360273430893,3628093405,3628094557,1152
1360273464,694847864,3,138,46,1360273436521,1360273437929,694820385,694821793,1408
1360273464,694848024,2,92,46,1360273436361,1360273437833,694820385,694821857,1472
1360273464,694848068,1,46,46,1360273437020,1360273437020,694821088,694821088,0
1360273468,694851868,41,2296,56,1360273440486,1360273467750,694824354,694851618,27264
1360273468,694851900,3,206,68.66666667,1360273441541,1360273442181,694825441,694826081,640
1360273472,694856276,3,138,46,1360273464270,1360273464334,694848546,694848610,64
1360273472,694856276,3,138,46,1360273464270,1360273464334,694848546,694848610,64
1360273472,694856312,3,138,46,1360273469227,1360273469291,694853539,694853603,64
1360273472,694856360,3,138,46,1360273465209,1360273465209,694849569,694849569,0
1360273473,694856424,5,263,52.6,1360273472160,1360273472480,694855584,694855904,320
1360273476,694859936,5,737,147.4,1360273448354,1360273449954,694832290,694833890,1600
1360273476,694860056,2,123,61.5,1360273451369,1360273451433,694835425,694835489,64
1360273476,694860092,2,92,46,1360273448260,1360273448388,694832352,694832480,128
1360273476,694860180,1,77,77,1360273451247,1360273451247,694835427,694835427,0
1360273480,3628142888,28,1568,56,1360273452276,1360273478836,3628115164,3628141724,26560
1360273480,694863956,58,3248,56,1360273452045,1360273479565,694836001,694863521,27520
1360273480,694863960,29,2784,96,1360273452297,1360273479049,694836257,694863009,26752
1360273480,694864048,27,1512,56,1360273451761,1360273479601,694835809,694863649,27840
1360273480,694864080,26,1456,56,1360273452051,1360273478931,694836131,694863011,26880
1360273480,694864292,4,217,54.25,1360273472064,1360273472704,694856356,694856996,640
1360273484,694868004,3,138,46,1360273458333,1360273458397,694842337,694842401,64
1360273488,694871976,3,138,46,1360273461369,1360273461433,694845345,694845409,64
1360273488,694872308,3,138,46,1360273485229,1360273486701,694869537,694871009,1472
1360273488,694872328,5,326,65.2,1360273487132,1360273487452,694871460,694871780,320
1360273489,694872392,4,205,51.25,1360273486212,1360273486212,694869604,694869604,0
1360273492,694876084,1,137,137,1360273464524,1360273464524,694848608,694848608,0
1360273496,694879968,45,2520,56,1360273468416,1360273495744,694852384,694879712,27328
1360273496,694880312,4,190,47.5,1360273492136,1360273492264,694876448,694876576,128
1360273496,694880340,2,98,49,1360273489423,1360273495247,694873763,694879587,5824
1360273496,694880356,8,458,57.25,1360273495164,1360273495228,694879520,694879584,64
1360273497,694880392,4,196,49,1360273493122,1360273493634,694876514,694877026,512
1360273497,694880396,4,184,46,1360273489853,1360273489853,694873249,694873249,0
1360273497,694880428,3,144,48,1360273490718,1360273490910,694874146,694874338,192
1360273497,694880428,4,414,103.5,1360273490717,1360273491485,694874145,694874913,768
1360273497,694880428,3,144,48,1360273490781,1360273496413,694874209,694879841,5632
1360273497,694880428,3,144,48,1360273490781,1360273496541,694874209,694879969,5760
1360273497,694880428,2,94,47,1360273490781,1360273496157,694874209,694879585,5376
1360273497,694880436,498,594756,1194.289157,1360273299733,1360273495637,694683169,694879073,195904
1360273497,694880468,5,236,47.2,1360273487349,1360273493493,694870817,694876961,6144
1360273497,694880468,7,412,58.85714286,1360273496052,1360273496116,694879520,694879584,64
1360273497,694880468,5,242,48.4,1360273487860,1360273495860,694871328,694879328,8000
1360273501,3628164116,3,144,48,1360273491153,1360273496849,3628154269,3628159965,5696
1360273501,3628164116,3,144,48,1360273491345,1360273496849,3628154461,3628159965,5504
1360273505,694888424,3,144,48,1360273491491,1360273497187,694874915,694880611,5696
1360273505,694888424,2,98,49,1360273491491,1360273497187,694874915,694880611,5696
1360273505,694888424,3,150,50,1360273491681,1360273497121,694875105,694880545,5440
1360273505,694888428,3,144,48,1360273491935,1360273499423,694875363,694882851,7488
1360273508,3628170892,19,1064,56,1360273480238,1360273506542,3628143130,3628169434,26304
1360273508,694891972,1,46,46,1360273480638,1360273480638,694864610,694864610,0
1360273508,694891972,19,1064,56,1360273480637,1360273507197,694864609,694891169,26560
1360273508,694892012,6,1653,275.5,1360273482007,1360273484951,694866019,694868963,2944
1360273508,694892016,40,2240,56,1360273482259,1360273507027,694866275,694891043,24768
1360273508,694892080,1,46,46,1360273480530,1360273480530,694864610,694864610,0
1360273508,694892128,21,1176,56,1360273482531,1360273507619,694866659,694891747,25088
1360273512,3628174940,2,2779,1389.5,1360273487359,1360273487359,3628150299,3628150299,0
1360273512,694896372,24,2304,96,1360273484780,1360273511340,694869152,694895712,26560
1360273513,694896400,12,7333,611.0833333,1360273487160,1360273491000,694870560,694874400,3840
1360273513,694896404,37,47519,1284.297297,1360273487159,1360273489719,694870563,694873123,2560
1360273513,694896404,7,3082,440.2857143,1360273487158,1360273491702,694870562,694875106,4544
1360273513,694896416,6,3352,558.6666667,1360273487914,1360273493098,694871330,694876514,5184
1360273513,694896524,13,6937,533.6153846,1360273487038,1360273490750,694870562,694874274,3712
1360273513,694896528,7,5708,815.4285714,1360273487031,1360273490487,694870559,694874015,3456
1360273513,694896536,5,1611,322.2,1360273487793,1360273487985,694871329,694871521,192
1360273513,694896660,2,92,46,1360273498038,1360273506230,694881698,694889890,8192
1360273516,694900316,14,3302,235.8571429,1360273490598,1360273491942,694874914,694876258,1344
1360273516,694900320,8,2795,349.375,1360273490787,1360273492003,694875107,694876323,1216
1360273516,694900364,3,498,166,1360273488821,1360273490165,694873185,694874529,1344
1360273517,694900396,6,522,87,1360273490812,1360273491132,694874208,694874528,320
1360273517,694900400,6,635,105.8333333,1360273490811,1360273491579,694874211,694874979,768
1360273517,694900408,6,648,108,1360273491507,1360273492979,694874915,694876387,1472
1360273520,694904260,49,2744,56,1360273495839,1360273519775,694880099,694904035,23936
1360273521,694904456,12,4937,411.4166667,1360273493186,1360273493762,694876642,694877218,576
1360273521,694904460,12,3315,276.25,1360273493438,1360273495550,694876898,694879010,2112
1360273521,694904688,3,138,46,1360273516891,1360273516955,694900579,694900643,64
1360273524,694908332,1,46,46,1360273498390,1360273498390,694882722,694882722,0
1360273525,3628188104,3,138,46,1360273523933,1360273524253,3628187037,3628187357,320
1360273528,694912252,12590,18422788,1463.287371,1360273093157,1360273226981,694477409,694611233,133824
1360273529,694912708,2,92,46,1360273522949,1360273522949,694906657,694906657,0
1360273532,694916376,1,137,137,1360273504296,1360273504296,694888672,694888672,0
1360273536,3628198924,27,1512,56,1360273510222,1360273535630,3628173146,3628198554,25408
1360273536,694920300,47,2632,56,1360273509303,1360273535095,694893603,694919395,25792
1360273537,694920452,26,1456,56,1360273509828,1360273536068,694893280,694919520,26240
1360273537,694920536,25,1400,56,1360273512497,1360273535409,694896033,694918945,22912
1360273537,694920652,3,138,46,1360273532987,1360273533051,694916639,694916703,64
1360273540,694924272,28,2688,96,1360273512271,1360273539663,694896543,694923935,27392
1360273541,694924416,3,138,46,1360273513960,1360273513960,694897376,694897376,0
1360273544,3628206988,2,92,46,1360273517966,1360273517966,3628180954,3628180954,0
1360273544,3628207000,1,46,46,1360273518981,1360273518981,3628181981,3628181981,0
1360273544,3628207012,2,92,46,1360273518969,1360273519865,3628181981,3628182877,896
1360273544,3628207068,2,92,46,1360273518912,1360273519872,3628181980,3628182940,960
1360273544,694928256,3,138,46,1360273516130,1360273516130,694900386,694900386,0
1360273544,694928292,2,92,46,1360273517307,1360273517371,694901599,694901663,64
1360273544,694928304,1,46,46,1360273518320,1360273518320,694902624,694902624,0
1360273544,694928304,1,46,46,1360273518320,1360273518320,694902624,694902624,0
1360273545,694928444,3,138,46,1360273517899,1360273517963,694901343,694901407,64
1360273545,694928484,1,46,46,1360273519143,1360273519143,694902627,694902627,0
1360273545,694928484,3,150,50,1360273519143,1360273520039,694902627,694903523,896
1360273545,694928512,2,92,46,1360273520072,1360273520456,694903584,694903968,384
1360273548,3628210896,2,92,46,1360273521068,1360273521132,3628183964,3628184028,64
1360273548,3628210940,2,92,46,1360273523071,1360273523327,3628186011,3628186267,256
1360273548,694932280,53,2968,56,1360273520649,1360273547785,694904929,694932065,27136
1360273549,694932404,3,138,46,1360273521973,1360273521973,694905377,694905377,0
1360273549,694932408,2,92,46,1360273522225,1360273522609,694905633,694906017,384
1360273549,694932440,1,46,46,1360273523153,1360273523153,694906593,694906593,0
1360273549,694932444,2,92,46,1360273523150,1360273523406,694906594,694906850,256
1360273549,694932448,3,138,46,1360273523595,1360273524107,694907043,694907555,512
1360273553,694936400,1,46,46,1360273525115,1360273525115,694908515,694908515,0
1360273553,694936644,5,230,46,1360273550787,1360273552195,694934431,694935839,1408
1360273556,3628218912,2,92,46,1360273528922,1360273529306,3628191834,3628192218,384
1360273556,3628218916,2,92,46,1360273529048,1360273529368,3628191964,3628192284,320
1360273557,694940424,3,492,164,1360273530911,1360273531039,694914335,694914463,128
1360273557,694940464,12,3361,280.0833333,1360273529081,1360273546105,694912545,694929569,17024
1360273557,3628220100,3,138,46,1360273548894,1360273556702,3628211994,3628219802,7808
1360273560,3628222892,2,92,46,1360273532078,1360273532078,3628194970,3628194970,0
1360273560,3628222996,1,46,46,1360273534024,1360273534024,3628197020,3628197020,0
1360273560,694944324,2,92,46,1360273533277,1360273533469,694917601,694917793,192
1360273564,3628226884,22,1232,56,1360273536504,1360273563320,3628199388,3628226204,26816
1360273564,694948272,48,2688,56,1360273536080,1360273563472,694920352,694947744,27392
1360273564,694948272,3,138,46,1360273536079,1360273536271,694920351,694920543,192
1360273564,694948280,2,123,61.5,1360273536393,1360273536393,694920673,694920673,0
1360273564,694948368,24,1344,56,1360273536048,1360273563504,694920416,694947872,27456
1360273564,694948396,3,169,56.33333333,1360273536276,1360273536404,694920672,694920800,128
1360273564,694948396,25,1400,56,1360273536467,1360273563027,694920863,694947423,26560
1360273565,694948404,1,137,137,1360273537587,1360273537587,694920991,694920991,0
1360273565,694948408,2,123,61.5,1360273538226,1360273538354,694921634,694921762,128
1360273565,694948452,4,221,55.25,1360273540227,1360273540355,694923679,694923807,128
1360273568,3628230964,2,92,46,1360273540648,1360273540776,3628203612,3628203740,128
1360273568,694952300,25,2400,96,1360273540532,1360273567796,694924832,694952096,27264
1360273569,694952696,5,452,90.4,1360273565713,1360273568721,694949409,694952417,3008
1360273576,694960296,34,1904,56,1360273548279,1360273573367,694932575,694957663,25088
1360273592,3628255032,22,1232,56,1360273563938,1360273591458,3628226970,3628254490,27520
1360273592,694976356,22,1232,56,1360273564027,1360273591547,694948383,694975903,27520
1360273592,694976360,20,1120,56,1360273564343,1360273591159,694948703,694975519,26816
1360273592,694976372,1,46,46,1360273565037,1360273565037,694949409,694949409,0
1360273593,694976444,44,2464,56,1360273564749,1360273592397,694948193,694975841,27648
1360273597,694980408,10,2980,298,1360273571249,1360273593905,694954657,694977313,22656
1360273597,694980560,21,2016,96,1360273571991,1360273596183,694955551,694979743,24192
1360273600,694984400,1,137,137,1360273574224,1360273574224,694958624,694958624,0
1360273605,694988496,61,3416,56,1360273578137,1360273604569,694961633,694988065,26432
1360273608,694992396,1,77,77,1360273581334,1360273581334,694965730,694965730,0
1360273609,694992492,2,123,61.5,1360273582237,1360273582365,694965729,694965857,128
1360273609,694992492,1,77,77,1360273582299,1360273582299,694965791,694965791,0
1360273609,694992556,2,123,61.5,1360273584221,1360273584221,694967777,694967777,0
1360273609,694992740,2,92,46,1360273604706,1360273604706,694988446,694988446,0
1360273609,694992740,3,138,46,1360273604645,1360273604709,694988385,694988449,64
1360273613,3628276132,3,138,46,1360273602689,1360273606465,3628265821,3628269597,3776
1360273620,3628283084,31,1736,56,1360273592306,1360273619378,3628255390,3628282462,27072
1360273620,695004388,64,3584,56,1360273591899,1360273619739,694976287,695004127,27840
1360273620,695004392,31,1736,56,1360273592024,1360273619800,694976416,695004192,27776
1360273620,695004396,31,1736,56,1360273592468,1360273619412,694976864,695003808,26944
1360273620,695004400,6,3567,594.5,1360273592847,1360273593103,694977247,694977503,256
1360273625,695008424,15,3514,234.2666667,1360273598944,1360273606368,694982368,694989792,7424
1360273625,695008468,32,3072,96,1360273596981,1360273624565,694980449,695008033,27584
1360273632,695016388,61,3416,56,1360273604186,1360273631514,694988574,695015902,27328
1360273633,695016600,2,92,46,1360273608302,1360273608430,694991902,694992030,128
1360273633,695016708,8,458,57.25,1360273629058,1360273629122,695012766,695012830,64
1360273633,695016740,8,458,57.25,1360273627044,1360273627108,695010784,695010848,64
1360273633,695016740,7,412,58.85714286,1360273627042,1360273627106,695010782,695010846,64
1360273633,695016820,8,458,57.25,1360273626963,1360273627027,695010783,695010847,64
1360273637,695020472,1,137,137,1360273610481,1360273610481,694993953,694993953,0
1360273637,695020520,2,92,46,1360273608896,1360273608896,694992416,694992416,0
1360273637,695020604,1,46,46,1360273611562,1360273611562,694995166,694995166,0
1360273641,695025260,1,46,46,1360273614428,1360273614428,694998688,694998688,0
1360273641,695025292,1,46,46,1360273614461,1360273614461,694998753,694998753,0
1360273642,695025572,6,2113,352.1666667,1360273614092,1360273616524,694997664,695000096,2432
1360273642,695025948,1,46,46,1360273614865,1360273614865,694998813,694998813,0
1360273648,3628311104,30,1680,56,1360273621276,1360273647132,3628284380,3628310236,25856
1360273649,695032408,31,1736,56,1360273621233,1360273648433,695004641,695031841,27200
1360273649,695032496,59,3304,56,1360273621014,1360273648534,695004510,695032030,27520
1360273649,695032532,30,1680,56,1360273621748,1360273648628,695005280,695032160,26880
1360273653,695036548,28,2688,96,1360273625509,1360273652581,695009057,695036129,27072
1360273661,695044540,62,3472,56,1360273632938,1360273660778,695016478,695044318,27840
1360273669,695052868,1,137,137,1360273641380,1360273641380,695025248,695025248,0
1360273673,695056672,24,1344,56,1360273648805,1360273671845,695032477,695055517,23040
1360273673,695056764,51,2856,56,1360273648649,1360273672073,695032413,695055837,23424
1360273673,695056836,3,604,201.3333333,1360273646850,1360273646978,695030686,695030814,128
1360273673,695056980,9,445,49.44444444,1360273664947,1360273665971,695048927,695049951,1024
1360273676,3628339188,30,1680,56,1360273648009,1360273675465,3628311197,3628338653,27456
1360273677,695060752,31,1736,56,1360273649367,1360273676695,695033119,695060447,27328
1360273681,695064780,31,2976,96,1360273653307,1360273680507,695037087,695064287,27200
1360273689,695072780,61,3416,56,1360273661371,1360273688763,695045151,695072543,27392
1360273693,695076700,16,6098,381.125,1360273666252,1360273680460,695049952,695064160,14208
1360273697,695080536,5428,7907237,1456.749632,1360273228206,1360273396974,694611742,694780510,168768
1360273701,695084688,64,3584,56,1360273672853,1360273700757,695056541,695084445,27904
1360273701,695084808,31,1736,56,1360273672864,1360273700064,695056672,695083872,27200
1360273704,3628367248,32,1792,56,1360273676046,1360273703374,3628339294,3628366622,27328
1360273705,695088812,31,1736,56,1360273677465,1360273704729,695061277,695088541,27264
1360273709,695092752,32,3072,96,1360273681240,1360273708568,695064992,695092320,27328
1360273709,695092864,1,137,137,1360273684646,1360273684646,695068510,695068510,0
1360273713,695096836,6,1098,183,1360273686338,1360273691394,695070174,695075230,5056
1360273713,695097016,3,138,46,1360273709454,1360273709454,695093470,695093470,0
1360273717,695100696,64,3584,56,1360273689550,1360273716622,695073246,695100318,27072
1360273729,695112672,29,1624,56,1360273701222,1360273727910,695084894,695111582,26688
1360273729,695112764,61,3416,56,1360273701004,1360273728076,695084768,695111840,27072
1360273732,3628395436,28,1568,56,1360273704082,1360273730642,3628367518,3628394078,26560
1360273733,695116672,28,1568,56,1360273705445,1360273732325,695089117,695115997,26880
1360273737,695120680,23,2208,96,1360273709597,1360273735965,695093277,695119645,26368
1360273745,695128740,1,137,137,1360273719203,1360273719203,695102943,695102943,0
1360273745,695128780,34,1904,56,1360273716984,1360273744120,695100764,695127900,27136
1360273745,695128848,1,46,46,1360273718839,1360273718839,695102687,695102687,0
1360273753,695136724,4,1543,385.75,1360273726835,1360273726899,695110559,695110623,64
1360273757,695140744,22,1232,56,1360273730781,1360273756189,695114525,695139933,25408
1360273757,695140748,11,616,56,1360273730843,1360273755931,695114591,695139679,25088
1360273757,695140880,3,492,164,1360273731222,1360273731350,695115102,695115230,128
1360273760,3628423468,9,504,56,1360273735283,1360273755699,3628398751,3628419167,20416
1360273761,695145084,9,504,56,1360273735498,1360273755978,695119582,695140062,20480
1360273765,695148872,8,768,96,1360273739934,1360273756382,695123806,695140254,16448
1360273773,695156828,11,616,56,1360273746443,1360273756555,695130271,695140383,10112
1360273777,695160828,1,137,137,1360273751367,1360273751367,695135195,695135195,0
1360273781,695164848,11,11840,1076.363636,1360273755383,1360273755639,695139231,695139487,256
1360273781,695164884,5,1636,327.2,1360273756177,1360273756305,695140061,695140189,128
1360273797,695181076,3,492,164,1360273771217,1360273771345,695155293,695155421,128
1360273813,695196884,20,6421,321.05,1360273786258,1360273807442,695170142,695191326,21184
1360273816,3628479504,10,560,56,1360273790221,1360273815373,3628453725,3628478877,25152
1360273817,695200880,19,1064,56,1360273790547,1360273811923,695174427,695195803,21376
1360273817,695200884,10,960,96,1360273790800,1360273811664,695174684,695195548,20864
1360273817,695200968,21,1176,56,1360273789758,1360273811966,695173726,695195934,22208
1360273817,695200968,11,616,56,1360273789885,1360273812221,695173853,695196189,22336
1360273817,695200980,10,560,56,1360273790640,1360273811440,695174620,695195420,20800
1360273817,695201264,6,496,82.66666667,1360273806166,1360273809174,695190430,695193438,3008
1360273817,695201272,3,138,46,1360273815180,1360273815180,695199452,695199452,0
1360273821,695205012,1,137,137,1360273794514,1360273794514,695178526,695178526,0
1360273833,695217156,1,46,46,1360273806274,1360273806274,695190430,695190430,0
1360273837,695221188,3,492,164,1360273811743,1360273811871,695195931,695196059,128
1360273845,695229132,40,2240,56,1360273817175,1360273844759,695201307,695228891,27584
1360273845,695229176,19,1064,56,1360273819307,1360273844075,695203483,695228251,24768
1360273845,695229180,20,1920,96,1360273819497,1360273844137,695203677,695228317,24640
1360273845,695229212,9,3179,353.2222222,1360273817159,1360273844551,695201371,695228763,27392
1360273845,695229216,39,2184,56,1360273817476,1360273844548,695201692,695228764,27072
1360273845,695229300,20,1120,56,1360273820210,1360273844338,695204510,695228638,24128
1360273848,3628511464,20,1120,56,1360273820535,1360273844663,3628483999,3628508127,24128
1360273857,695241328,1,137,137,1360273830419,1360273830419,695214747,695214747,0
1360273873,695257140,1,56,56,1360273844881,1360273844881,695229021,695229021,0
1360273873,695257220,1,56,56,1360273844862,1360273844862,695229082,695229082,0
1360273873,695257228,1,96,96,1360273845174,1360273845174,695229402,695229402,0
1360273877,695261216,3,492,164,1360273851908,1360273852036,695236124,695236252,128
1360273889,695273244,1,137,137,1360273864424,1360273864424,695248668,695248668,0
1360273893,695277220,4,1543,385.75,1360273867073,1360273867137,695251293,695251357,64
1360273906,695289508,28971,42610515,1470.798902,1360273397001,1360273904009,694780509,695287517,507008
1360273910,695293448,3,1454,484.6666667,1360273884227,1360273884355,695267675,695267803,128
1360273929,695313308,7,1740,248.5714286,1360273904615,1360273904935,695288923,695289243,320
1360273933,695317340,1,137,137,1360273905608,1360273905608,695289948,695289948,0
1360273950,695333420,3,492,164,1360273923677,1360273923741,695307097,695307161,64
1360273969,695353332,1,137,137,1360273942605,1360273942605,695326937,695326937,0
1360273970,695353736,9,445,49.44444444,1360273965154,1360273965730,695348890,695349466,576
1360273978,695361596,399,328023,822.112782,1360273232494,1360273970478,694616090,695354074,737984
1360273990,695373676,3,492,164,1360273963486,1360273963614,695347162,695347290,128
1360273994,695377716,13,4601,353.9230769,1360273965750,1360273966070,695349466,695349786,320
1360274002,695385692,1,137,137,1360273976527,1360273976527,695360219,695360219,0
1360274022,695405576,3,605,201.6666667,1360273994370,1360273994562,695377946,695378138,192
1360274026,695409740,2,128,64,1360274001245,1360274004253,695384985,695387993,3008
1360274034,695417928,6,307,51.16666667,1360274025634,1360274025954,695409562,695409882,320
1360274046,695429640,1,137,137,1360274019905,1360274019905,695403545,695403545,0
1360274050,695433740,3,1469,489.6666667,1360274025629,1360274025757,695409369,695409497,128
1360274050,695433744,6,3265,544.1666667,1360274025623,1360274025879,695409367,695409623,256
1360274054,695437692,14,4694,335.2857143,1360274026189,1360274026573,695409881,695410265,384
1360274058,695441904,6,496,82.66666667,1360274047546,1360274050554,695431450,695434458,3008
1360274074,695457740,1,46,46,1360274047709,1360274047709,695431449,695431449,0
1360274082,695465604,16,3620,226.25,1360274057830,1360274068518,695441434,695452122,10688
1360274090,695473696,1,137,137,1360274061959,1360274061959,695445655,695445655,0
1360274090,695473780,7,1145,163.5714286,1360274065270,1360274068022,695449050,695451802,2752
1360274134,695517884,1,137,137,1360274106379,1360274106379,695490263,695490263,0
1360274134,695517920,3,492,164,1360274107430,1360274107558,695491350,695491478,128
1360274142,695526092,11,3324,302.1818182,1360274117373,1360274128253,695501465,695512345,10880
1360274146,695530256,3,138,46,1360274141210,1360274141274,695525466,695525530,64
1360274166,695550196,1,137,137,1360274140882,1360274140882,695525078,695525078,0
1360274174,695558208,3,492,164,1360274147721,1360274147849,695531929,695532057,128
1360274179,695562420,1,46,46,1360274151963,1360274151963,695535383,695535383,0
1360274179,695562468,8,1373,171.625,1360274154349,1360274154541,695537817,695538009,192
1360274182,695566272,5,2883,576.6,1360274154118,1360274154246,695538390,695538518,128
1360274194,695578016,9,445,49.44444444,1360274188101,1360274188421,695572117,695572437,320
1360274198,695582388,1,137,137,1360274171732,1360274171732,695556120,695556120,0
1360274206,695590296,3,1577,525.6666667,1360274180401,1360274180593,695564697,695564889,192
1360274206,695590384,9,1375,152.7777778,1360274180440,1360274192408,695564824,695576792,11968
1360274215,695598392,3,138,46,1360274188984,1360274189048,695572376,695572440,64
1360274215,695598392,23,6584,286.2608696,1360274189046,1360274206454,695572438,695589846,17408
1360274218,695602044,4,190,47.5,1360274210348,1360274216300,695594392,695600344,5952
1360274230,695614288,1,137,137,1360274201975,1360274201975,695586263,695586263,0
1360274237,3628899908,33,1848,56,1360274211428,1360274236516,3628874336,3628899424,25088
1360274238,695622344,67,3752,56,1360274210303,1360274237631,695594647,695621975,27328
1360274238,695622352,32,1792,56,1360274211127,1360274237367,695595479,695621719,26240
1360274239,695622428,70,3920,56,1360274211346,1360274238610,695594774,695622038,27264
1360274239,695622460,32,1792,56,1360274211699,1360274238771,695595159,695622231,27072
1360274239,695622460,33,3168,96,1360274211762,1360274237618,695595222,695621078,25856
1360274247,695630404,7,2302,328.8571429,1360274220970,1360274245098,695604374,695628502,24128
1360274251,695634444,4,202,50.5,1360274224707,1360274246787,695608151,695630231,22080
1360274265,3628927928,30,1680,56,1360274237200,1360274264528,3628900128,3628927456,27328
1360274267,695650452,30,1680,56,1360274239289,1360274266169,695622741,695649621,26880
1360274267,695650460,56,3136,56,1360274239603,1360274266483,695623063,695649943,26880
1360274267,695650460,31,1736,56,1360274239665,1360274266673,695623125,695650133,27008
1360274267,695650484,30,2880,96,1360274240024,1360274266712,695623508,695650196,26688
1360274267,695650536,60,3360,56,1360274239076,1360274266340,695622612,695649876,27264
1360274271,695654416,6,771,128.5,1360274245085,1360274245341,695628501,695628757,256
1360274275,695658452,1,137,137,1360274247035,1360274247035,695630487,695630487,0
1360274291,695674424,11,4636,421.4545455,1360274265302,1360274266710,695648726,695650134,1408
1360274291,695674488,4,1568,392,1360274263636,1360274263700,695647124,695647188,64
1360274291,695674492,19,15684,825.4736842,1360274263698,1360274264082,695647190,695647574,384
1360274293,3628955928,26,1456,56,1360274265233,1360274292049,3628928161,3628954977,26816
1360274295,695678480,61,3416,56,1360274266847,1360274294751,695650327,695678231,27904
1360274295,695678488,26,2496,96,1360274267541,1360274294549,695651029,695678037,27008
1360274295,695678572,55,3080,56,1360274266818,1360274294338,695650390,695677910,27520
1360274295,695678572,25,1400,56,1360274266945,1360274293825,695650517,695677397,26880
1360274295,695678576,29,1624,56,1360274267325,1360274294397,695650901,695677973,27072
1360274298,695682168,32,25731,804.09375,1360274288237,1360274293549,695672405,695677717,5312
1360274299,695682592,1,48,48,1360274271212,1360274271212,695654804,695654804,0
1360274311,695694548,1,137,137,1360274283031,1360274283031,695666579,695666579,0
1360274311,695694596,3,492,164,1360274284585,1360274284777,695668181,695668373,192
1360274315,695698564,1,46,46,1360274288842,1360274288842,695672406,695672406,0
1360274317,3628979964,28,1568,56,1360274292910,1360274316590,3628955874,3628979554,23680
1360274323,695706560,61,3416,56,1360274294796,1360274322636,695678356,695706196,27840
1360274323,695706564,31,1736,56,1360274294921,1360274322697,695678485,695706261,27776
1360274323,695706568,58,3248,56,1360274295173,1360274322629,695678741,695706197,27456
1360274323,695706568,32,1792,56,1360274295363,1360274322371,695678931,695705939,27008
1360274323,695706572,31,2976,96,1360274295426,1360274322370,695678998,695705942,26944
1360274327,695710624,1,48,48,1360274300686,1360274300686,695684310,695684310,0
1360274330,695714204,9,445,49.44444444,1360274325897,1360274326281,695710101,695710485,384
1360274345,3629007916,30,1680,56,1360274318235,1360274344923,3628981151,3629007839,26688
1360274347,695730632,1,137,137,1360274321669,1360274321669,695705301,695705301,0
1360274351,695734600,29,2784,96,1360274323238,1360274349158,695706838,695732758,25920
1360274351,695734636,3,492,164,1360274324608,1360274324800,695708244,695708436,192
1360274351,695734684,55,3080,56,1360274323024,1360274350480,695706708,695734164,27456
1360274351,695734688,28,1568,56,1360274323083,1360274349899,695706771,695733587,26816
1360274351,695734688,61,3416,56,1360274323340,1360274350348,695707028,695734036,27008
1360274351,695734716,31,1736,56,1360274323505,1360274350129,695707221,695733845,26624
1360274355,695738584,10,4469,446.9,1360274326901,1360274327605,695710485,695711189,704
1360274362,695746144,3,138,46,1360274360070,1360274360198,695744214,695744342,128
1360274373,3629035920,33,1848,56,1360274345562,1360274372698,3629008482,3629035618,27136
1360274375,695758620,31,2976,96,1360274350866,1360274374226,695734486,695757846,23360
1360274379,695762668,35,1960,56,1360274351070,1360274378782,695734738,695762450,27712
1360274379,695762672,34,1904,56,1360274351450,1360274377370,695735122,695761042,25920
1360274379,695762764,69,3864,56,1360274350783,1360274378495,695734547,695762259,27712
1360274379,695762768,68,3808,56,1360274350845,1360274378557,695734613,695762325,27712
1360274383,695766772,1,137,137,1360274357049,1360274357049,695740821,695740821,0
1360274391,695774664,4,892,223,1360274364578,1360274365218,695748242,695748882,640
1360274394,695778236,12,589,49.08333333,1360274386920,1360274387432,695771156,695771668,512
1360274401,3629064296,32,1792,56,1360274372961,1360274400609,3629036257,3629063905,27648
1360274403,695786660,29,2784,96,1360274374950,1360274402278,695758610,695785938,27328
1360274407,695790660,64,3584,56,1360274378984,1360274406440,695762644,695790100,27456
1360274407,695790668,2,92,46,1360274379488,1360274379680,695763156,695763348,192
1360274407,695790668,1,46,46,1360274379487,1360274379487,695763155,695763155,0
1360274407,695790672,29,1624,56,1360274379740,1360274406620,695763412,695790292,26880
1360274407,695790756,62,3472,56,1360274379078,1360274406406,695762834,695790162,27328
1360274407,695790756,30,1680,56,1360274379145,1360274406089,695762901,695789845,26944
1360274415,695798800,12,2103,175.25,1360274387868,1360274388892,695771668,695772692,1024
1360274427,695810656,1,137,137,1360274398956,1360274398956,695782612,695782612,0
1360274429,3629092392,32,1792,56,1360274401474,1360274428738,3629064866,3629092130,27264
1360274431,695814764,30,2880,96,1360274402942,1360274429310,695786706,695813074,26368
1360274431,695814804,4,538,134.5,1360274404248,1360274404888,695788052,695788692,640
1360274431,695814852,58,3248,56,1360274406633,1360274430633,695790485,695814485,24000
1360274435,695818792,32,1792,56,1360274406883,1360274434339,695790675,695818131,27456
1360274435,695818800,32,1792,56,1360274407257,1360274433881,695791057,695817681,26624
1360274435,695818876,61,3416,56,1360274406736,1360274434192,695790612,695818068,27456
1360274450,695834272,9,445,49.44444444,1360274447874,1360274448578,695832146,695832850,704
1360274455,695839092,23,2208,96,1360274430712,1360274454328,695814804,695838420,23616
1360274455,695839248,1,137,137,1360274429531,1360274429531,695813779,695813779,0
1360274457,3629120380,29,1624,56,1360274429516,1360274456524,3629092896,3629119904,27008
1360274459,695842996,56,3136,56,1360274430870,1360274458838,695814866,695842834,27968
1360274463,695847028,55,3080,56,1360274435384,1360274462520,695819412,695846548,27136
1360274463,695847144,28,1568,56,1360274435330,1360274461954,695819474,695846098,26624
1360274463,695847148,30,1680,56,1360274435645,1360274462333,695819793,695846481,26688
1360274466,695850356,4,190,47.5,1360274454000,1360274460400,695838356,695844756,6400
1360274471,695855040,3,492,164,1360274444460,1360274444716,695828500,695828756,256
1360274475,695859060,13,4601,353.9230769,1360274448791,1360274449623,695832851,695833683,832
1360274479,695863168,10,2090,209,1360274453930,1360274454698,695838098,695838866,768
1360274483,695867108,30,2880,96,1360274455142,1360274482086,695839250,695866194,26944
1360274485,3629148316,31,1736,56,1360274457359,1360274484431,3629120675,3629147747,27072
1360274487,695871060,1,137,137,1360274460886,1360274460886,695844946,695844946,0
1360274487,695871144,58,3248,56,1360274459268,1360274486532,695843412,695870676,27264
1360274491,695875112,61,3416,56,1360274462948,1360274490532,695847060,695874644,27584
1360274491,695875112,31,1736,56,1360274463074,1360274490338,695847186,695874450,27264
1360274491,695875144,32,1792,56,1360274463361,1360274490561,695847505,695874705,27200
1360274511,695895220,29,2784,96,1360274482869,1360274508597,695867089,695892817,25728
1360274511,695895256,3,492,164,1360274483794,1360274483922,695868050,695868178,128
1360274513,3629176324,28,1568,56,1360274485574,1360274512006,3629148898,3629175330,26432
1360274514,695898288,8,430,53.75,1360274508723,1360274509555,695893011,695893843,832
1360274515,695899216,45,2520,56,1360274490745,1360274511929,695874961,695896145,21184
1360274515,695899220,54,3024,56,1360274486838,1360274511798,695871058,695896018,24960
1360274519,695903232,21,1176,56,1360274491114,1360274518378,695875346,695902610,27264
1360274519,695903232,22,1232,56,1360274491368,1360274511976,695875600,695896208,20608
1360274527,695911304,1,137,137,1360274500324,1360274500324,695884628,695884628,0
1360274535,695919272,11,4509,409.9090909,1360274509760,1360274510720,695894032,695894992,960
1360274539,695923148,24,2304,96,1360274511293,1360274538365,695895441,695922513,27072
1360274543,695927228,54,3024,56,1360274518252,1360274542700,695902480,695926928,24448
1360274543,695927236,53,2968,56,1360274518630,1360274542694,695902866,695926930,24064
1360274545,3629208708,31,1736,56,1360274518406,1360274544518,3629182114,3629208226,26112
1360274547,695931200,32,1792,56,1360274519819,1360274546379,695904019,695930579,26560
1360274547,695931244,32,1792,56,1360274518812,1360274546716,695903056,695930960,27904
1360274551,695935208,3,492,164,1360274524035,1360274524163,695908243,695908371,128
1360274559,695943200,1,137,137,1360274531784,1360274531784,695915984,695915984,0
1360274567,695951284,31,2976,96,1360274539124,1360274565108,695923408,695949392,25984
1360274571,695955200,65,3640,56,1360274543177,1360274570377,695927377,695954577,27200
1360274571,695955288,63,3528,56,1360274543026,1360274570738,695927314,695955026,27712
1360274571,695955356,14,3474,248.1428571,1360274544749,1360274570733,695929105,695955089,25984
1360274573,3629236472,30,1680,56,1360274545650,1360274572658,3629209122,3629236130,27008
1360274575,695959204,30,1680,56,1360274547269,1360274574149,695931473,695958353,26880
1360274575,695959212,32,1792,56,1360274547710,1360274574526,695931922,695958738,26816
1360274578,695962288,3,138,46,1360274570225,1360274570417,695954513,695954705,192
1360274586,695970316,1091,1587352,1454.951421,1360274517142,1360274581334,695901458,695965650,64192
1360274591,695975356,3,492,164,1360274563949,1360274564269,695948305,695948625,320
1360274595,695979252,30,2880,96,1360274566932,1360274594324,695951184,695978576,27392
1360274595,695979328,1,46,46,1360274569224,1360274569224,695953552,695953552,0
1360274595,695979336,1,137,137,1360274569731,1360274569731,695954067,695954067,0
1360274599,695983268,62,3472,56,1360274571269,1360274598853,695955537,695983121,27584
1360274599,695983344,1,46,46,1360274570809,1360274570809,695955153,695955153,0
1360274599,695983344,65,3640,56,1360274570809,1360274598521,695955153,695982865,27712
1360274601,3629264392,30,1680,56,1360274573505,1360274600577,3629236897,3629263969,27072
1360274603,695987348,32,1792,56,1360274574900,1360274602804,695959248,695987152,27904
1360274603,695987376,31,1736,56,1360274575319,1360274602263,695959695,695986639,26944
1360274624,696007460,32,3072,96,1360274595947,1360274623147,695979407,696006607,27200
1360274624,696007548,55,3080,56,1360274599635,1360274623827,695983183,696007375,24192
1360274628,696011480,63,3528,56,1360274599898,1360274627738,695983378,696011218,27840
1360274629,3629292408,31,1736,56,1360274601521,1360274628337,3629264929,3629291745,26816
1360274632,696015492,31,1736,56,1360274604109,1360274631181,695987601,696014673,27072
1360274632,696015496,6,1912,318.6666667,1360274604553,1360274627273,695988049,696010769,22720
1360274632,696015544,1,137,137,1360274606682,1360274606682,695990226,695990226,0
1360274632,696015580,32,1792,56,1360274604342,1360274631542,695987922,696015122,27200
1360274635,696018452,10,491,49.1,1360274631540,1360274631860,696014992,696015312,320
1360274652,696035576,31,2976,96,1360274623990,1360274651126,696007566,696034702,27136
1360274652,696035668,62,3472,56,1360274624091,1360274651739,696007759,696035407,27648
1360274656,696039676,63,3528,56,1360274627924,1360274655764,696011600,696039440,27840
1360274656,696039764,14,4694,335.2857143,1360274631550,1360274632126,696015314,696015890,576
1360274657,3629320416,30,1680,56,1360274629228,1360274656236,3629292644,3629319652,27008
1360274660,696043684,32,1792,56,1360274631821,1360274659469,696015505,696043153,27648
1360274660,696043716,29,1624,56,1360274632364,1360274659756,696016080,696043472,27392
1360274668,696051760,1,137,137,1360274643135,1360274643135,696026895,696026895,0
1360274672,696055736,2,104,52,1360274645529,1360274648089,696029265,696031825,2560
1360274680,696063708,33,3168,96,1360274651956,1360274679284,696035664,696062992,27328
1360274680,696063712,63,3528,56,1360274652078,1360274679470,696035790,696063182,27392
1360274684,696067632,65,3640,56,1360274656190,1360274683710,696039822,696067342,27520
1360274685,3629348412,32,1792,56,1360274657073,1360274684401,3629320485,3629347813,27328
1360274688,696071612,33,1848,56,1360274660179,1360274687251,696043791,696070863,27072
1360274688,696071620,32,1792,56,1360274660557,1360274687629,696044177,696071249,27072
1360274692,696075620,3,492,164,1360274666763,1360274667083,696050383,696050703,320
1360274700,696083696,7,3040,434.2857143,1360274675646,1360274692350,696059342,696076046,16704
1360274700,696083816,4,656,164,1360274672969,1360274673225,696056785,696057041,256
1360274708,696091756,71,3976,56,1360274680004,1360274707716,696063760,696091472,27712
1360274708,696091756,34,3264,96,1360274680195,1360274707203,696063951,696090959,27008
1360274708,696091784,1,137,137,1360274683559,1360274683559,696067343,696067343,0
1360274712,696095656,68,3808,56,1360274684070,1360274711334,696067726,696094990,27264
1360274712,696095696,4,192,48,1360274685504,1360274687616,696069200,696071312,2112
1360274713,3629376400,35,1960,56,1360274685116,1360274712316,3629348516,3629375716,27200
1360274716,696099712,35,1960,56,1360274687918,1360274715438,696071630,696099150,27520
1360274716,696099748,11,11840,1076.363636,1360274688649,1360274688905,696072397,696072653,256
1360274716,696099852,34,1904,56,1360274688163,1360274715683,696072015,696099535,27520
1360274732,696115704,4,538,134.5,1360274707125,1360274707253,696090829,696090957,128
1360274736,696119688,64,3584,56,1360274708104,1360274735496,696091792,696119184,27392
1360274736,696119772,32,3072,96,1360274707827,1360274735219,696091599,696118991,27392
1360274737,3629400664,27,1512,56,1360274712819,1360274736115,3629376483,3629399779,23296
1360274740,696123700,63,3528,56,1360274711996,1360274739580,696095696,696123280,27584
1360274744,696127784,32,1792,56,1360274716198,1360274743398,696099982,696127182,27200
1360274744,696127812,32,1792,56,1360274716682,1360274742922,696100494,696126734,26240
1360274748,696131740,1,137,137,1360274721876,1360274721876,696105616,696105616,0
1360274754,696138340,3,138,46,1360274748283,1360274748283,696132623,696132623,0
1360274762,696146316,4,190,47.5,1360274755347,1360274761171,696139663,696145487,5824
1360274763,696146392,3,144,48,1360274756269,1360274762093,696139661,696145485,5824
1360274763,696146436,4,190,47.5,1360274755906,1360274756226,696139342,696139662,320
1360274764,696147972,54,3024,56,1360274739561,1360274763689,696123533,696147661,24128
1360274764,696147976,64,3584,56,1360274735654,1360274763750,696119630,696147726,28096
1360274764,696148072,32,3072,96,1360274735751,1360274763079,696119823,696147151,27328
1360274765,3629428752,32,1792,56,1360274736858,1360274764058,3629400610,3629427810,27200
1360274768,696152084,26,1456,56,1360274743547,1360274767227,696127631,696151311,23680
1360274768,696152128,9,3179,353.2222222,1360274741453,1360274752205,696125581,696136333,10752
1360274772,696156104,31,1736,56,1360274744166,1360274770918,696128270,696155022,26752
1360274772,696156108,3,492,164,1360274746977,1360274747105,696131085,696131213,128
1360274780,696164028,7,3365,480.7142857,1360274755313,1360274755569,696139341,696139597,256
1360274780,696164032,11,7061,641.9090909,1360274755311,1360274755823,696139343,696139855,512
1360274780,696164108,8,1466,183.25,1360274754852,1360274754916,696138960,696139024,64
1360274780,696164112,6,3395,565.8333333,1360274755230,1360274755486,696139342,696139598,256
1360274788,696172076,1,137,137,1360274760001,1360274760001,696144077,696144077,0
1360274792,696175976,32,3072,96,1360274764006,1360274791718,696147982,696175694,27712
1360274792,696176064,62,3472,56,1360274763981,1360274791757,696148045,696175821,27776
1360274792,696176064,61,3416,56,1360274764108,1360274791372,696148172,696175436,27264
1360274793,3629456644,32,1792,56,1360274765130,1360274792650,3629428774,3629456294,27520
1360274796,696180080,31,1736,56,1360274768062,1360274795454,696152142,696179534,27392
1360274800,696183996,32,1792,56,1360274771985,1360274799377,696155981,696183373,27392
1360274808,696192104,3,138,46,1360274783269,1360274783333,696167373,696167437,64
1360274812,696196116,3,138,46,1360274785240,1360274785304,696169356,696169420,64
1360274812,696196136,3,138,46,1360274786247,1360274786247,696170383,696170383,0
1360274812,696196244,3,492,164,1360274787611,1360274787803,696171855,696172047,192
1360274818,696202368,7,353,50.42857143,1360274811484,1360274812060,696195852,696196428,576
1360274820,696204056,64,3584,56,1360274791830,1360274819158,696175886,696203214,27328
1360274820,696204072,31,2976,96,1360274792388,1360274819268,696176460,696203340,26880
1360274820,696204176,64,3584,56,1360274792030,1360274819294,696176206,696203470,27264
1360274821,3629484712,32,1792,56,1360274793603,1360274820483,3629457315,3629484195,26880
1360274824,696208132,31,1736,56,1360274796105,1360274823241,696180237,696207373,27136
1360274828,696212060,1,137,137,1360274802513,1360274802513,696186573,696186573,0
1360274828,696212180,30,1680,56,1360274800155,1360274827419,696184335,696211599,27264
1360274840,696224092,20,7820,391,1360274812338,1360274835954,696196430,696220046,23616
1360274844,696228096,51,2856,56,1360274819822,1360274843310,696203918,696227406,23488
1360274848,696232076,63,3528,56,1360274820095,1360274847871,696204171,696231947,27776
1360274848,696232176,29,2784,96,1360274820253,1360274847261,696204429,696231437,27008
1360274849,3629512680,29,1624,56,1360274821603,1360274848355,3629485283,3629512035,26752
1360274852,696236220,29,1624,56,1360274824112,1360274851120,696208332,696235340,27008
1360274856,696240184,3,492,164,1360274827861,1360274828181,696212045,696212365,320
1360274856,696240216,30,1680,56,1360274828469,1360274855029,696212685,696239245,26560
1360274872,696256208,60,3360,56,1360274843838,1360274871294,696228046,696255502,27456
1360274872,696256252,1,137,137,1360274845713,1360274845713,696229965,696229965,0
1360274875,696258580,3,138,46,1360274870897,1360274870961,696254477,696254541,64
1360274876,696260136,30,2880,96,1360274848069,1360274875141,696232205,696259277,27072
1360274876,696260256,62,3472,56,1360274848074,1360274875722,696232330,696259978,27648
1360274877,3629540768,31,1736,56,1360274849163,1360274876235,3629512931,3629540003,27072
1360274880,696264220,30,1680,56,1360274852014,1360274877934,696236234,696262154,25920
1360274883,696266588,14,3384,241.7142857,1360274878120,1360274879144,696261708,696262732,1024
1360274883,696266600,38,45982,1210.052632,1360274874332,1360274879068,696257932,696262668,4736
1360274883,696266608,25,11122,444.88,1360274864210,1360274879058,696247818,696262666,14848
1360274883,696266636,6,497,82.83333333,1360274875258,1360274877818,696258894,696261454,2560
1360274883,696266668,11,1943,176.6363636,1360274873433,1360274879001,696257101,696262669,5568
1360274883,696266672,10,961,96.1,1360274878484,1360274879060,696262156,696262732,576
1360274884,696268132,26,1456,56,1360274855945,1360274878537,696240077,696262669,22592
1360274885,3629548596,94,111165,1182.606383,1360274864825,1360274878521,3629528421,3629542117,13696
1360274896,696280160,4,538,134.5,1360274868459,1360274878251,696252619,696262411,9792
1360274899,696282552,5,242,48.4,1360274891083,1360274898059,696274635,696281611,6976
1360274899,696282552,8,660,82.5,1360274891082,1360274896906,696274634,696280458,5824
1360274899,696282596,31,20061,647.1290323,1360274887007,1360274896223,696270603,696279819,9216
1360274899,696282600,10,6526,652.6,1360274892381,1360274895965,696275981,696279565,3584
1360274899,696282604,11,6793,617.5454545,1360274890648,1360274895448,696274252,696279052,4800
1360274899,696282604,2,98,49,1360274890712,1360274896856,696274316,696280460,6144
1360274899,696282604,2,98,49,1360274890712,1360274896856,696274316,696280460,6144
1360274899,696282604,4,196,49,1360274890712,1360274896856,696274316,696280460,6144
1360274899,696282604,3,150,50,1360274890712,1360274896856,696274316,696280460,6144
1360274899,696282628,10,5958,595.8,1360274890943,1360274895423,696274571,696279051,4480
1360274899,696282628,10,5790,579,1360274890942,1360274895358,696274570,696278986,4416
1360274899,696282632,4,196,49,1360274890938,1360274897978,696274570,696281610,7040
1360274899,696282632,4,196,49,1360274890938,1360274897978,696274570,696281610,7040
1360274899,696282632,4,196,49,1360274890938,1360274897978,696274570,696281610,7040
1360274899,696282632,21,4155,197.8571429,1360274890938,1360274897082,696274570,696280714,6144
1360274899,696282632,4,196,49,1360274891006,1360274897982,696274638,696281614,6976
1360274899,696282632,4,196,49,1360274890941,1360274897917,696274573,696281549,6976
1360274899,696282632,4,196,49,1360274890941,1360274897981,696274573,696281613,7040
1360274899,696282632,5,236,47.2,1360274888635,1360274895867,696272267,696279499,7232
1360274899,696282672,12,3491,290.9166667,1360274892115,1360274894803,696275787,696278475,2688
1360274899,696282680,2,98,49,1360274890635,1360274896779,696274315,696280459,6144
1360274899,696282680,3,144,48,1360274890635,1360274897163,696274315,696280843,6528
1360274899,696282680,2,98,49,1360274890699,1360274896779,696274379,696280459,6080
1360274899,696282684,12,4104,342,1360274890566,1360274897350,696274250,696281034,6784
1360274900,696284172,1,46,46,1360274874720,1360274874720,696258892,696258892,0
1360274900,696284284,36,2016,56,1360274871920,1360274899120,696256204,696283404,27200
1360274901,3629564588,5,242,48.4,1360274888706,1360274895490,3629552294,3629559078,6784
1360274901,3629564588,4,190,47.5,1360274890112,1360274896576,3629553700,3629560164,6464
1360274901,3629564604,8,380,47.5,1360274888689,1360274895793,3629552293,3629559397,7104
1360274902,3629564860,12,672,56,1360274877911,1360274900311,3629540771,3629563171,22400
1360274904,696288244,16,1536,96,1360274875993,1360274903129,696260237,696287373,27136
1360274904,696288268,29,1624,56,1360274876031,1360274903231,696260299,696287499,27200
1360274907,696290556,2,94,47,1360274892551,1360274899079,696276107,696282635,6528
1360274907,696290556,2,94,47,1360274892550,1360274899078,696276106,696282634,6528
1360274907,696290564,2,98,49,1360274896896,1360274903104,696280460,696286668,6208
1360274907,696290564,3,150,50,1360274893247,1360274900095,696276811,696283659,6848
1360274907,696290572,3,144,48,1360274897335,1360274903543,696280907,696287115,6208
1360274907,696290576,3,144,48,1360274894260,1360274900148,696277836,696283724,5888
1360274907,696290596,3,144,48,1360274894241,1360274900065,696277837,696283661,5824
1360274907,696290596,2,94,47,1360274894241,1360274900065,696277837,696283661,5824
1360274907,696290604,3,144,48,1360274894742,1360274900118,696278346,696283722,5376
1360274907,696290604,6,294,49,1360274892378,1360274906330,696275982,696289934,13952
1360274907,696290604,5,248,49.6,1360274894745,1360274900121,696278349,696283725,5376
1360274907,696290604,5,242,48.4,1360274894872,1360274901144,696278476,696284748,6272
1360274907,696290612,3,150,50,1360274895698,1360274902034,696279310,696285646,6336
1360274907,696290612,4,190,47.5,1360274895953,1360274902161,696279565,696285773,6208
1360274907,696290612,4,190,47.5,1360274895952,1360274902160,696279564,696285772,6208
1360274907,696290640,3,150,50,1360274893172,1360274900020,696276812,696283660,6848
1360274907,696290644,5,248,49.6,1360274892337,1360274898993,696275981,696282637,6656
1360274907,696290644,2,98,49,1360274897263,1360274903023,696280907,696286667,5760
1360274907,696290648,4,190,47.5,1360274894251,1360274900139,696277899,696283787,5888
1360274907,696290648,3,144,48,1360274897706,1360274903018,696281354,696286666,5312
1360274907,696290672,5,248,49.6,1360274892309,1360274898965,696275981,696282637,6656
1360274907,696290672,7,340,48.57142857,1360274892306,1360274906770,696275978,696290442,14464
1360274907,696290672,6,294,49,1360274892306,1360274905490,696275978,696289162,13184
1360274907,696290676,5,248,49.6,1360274892305,1360274898961,696275981,696282637,6656
1360274907,696290684,3,144,48,1360274895625,1360274901961,696279309,696285645,6336
1360274909,3629572596,3,144,48,1360274896760,1360274902584,3629560356,3629566180,5824
1360274912,696296272,29,21916,755.7241379,1360274886333,1360274894781,696270605,696279053,8448
1360274912,696296272,9,2632,292.4444444,1360274886332,1360274886844,696270604,696271116,512
1360274912,696296316,1,137,137,1360274886670,1360274886670,696270986,696270986,0
1360274913,696296456,95,95888,1009.347368,1360274886634,1360274888170,696270090,696271626,1536
1360274913,696296456,4,658,164.5,1360274886509,1360274886637,696269965,696270093,128
1360274913,696296456,35,25087,716.7714286,1360274886636,1360274896300,696270092,696279756,9664
1360274913,696296460,8,2954,369.25,1360274886952,1360274887080,696270412,696270540,128
1360274913,696296472,19,1064,56,1360274887836,1360274912156,696271308,696295628,24320
1360274914,3629576904,9,6499,722.1111111,1360274889389,1360274889773,3629552293,3629552677,384
1360274914,3629576904,5,2532,506.4,1360274889389,1360274889837,3629552293,3629552741,448
1360274914,3629576924,44,43896,997.6363636,1360274887063,1360274898967,3629549987,3629561891,11904
1360274914,3629576924,59,68009,1152.694915,1360274887063,1360274898839,3629549987,3629561763,11776
1360274914,3629576924,28,26263,937.9642857,1360274887067,1360274899035,3629549991,3629561959,11968
1360274914,3629576952,9,7480,831.1111111,1360274889340,1360274889660,3629552292,3629552612,320
1360274914,3629576952,6,4599,766.5,1360274889340,1360274889724,3629552292,3629552676,384
1360274915,696298564,3,492,164,1360274908800,1360274908992,696292364,696292556,192
1360274916,696300152,9,693,77,1360274890483,1360274893619,696274635,696277771,3136
1360274916,696300192,4,1473,368.25,1360274888714,1360274889354,696272906,696273546,640
1360274916,696300196,4,1460,365,1360274888712,1360274888904,696272908,696273100,192
1360274916,696300196,4,742,185.5,1360274888712,1360274889416,696272908,696273612,704
1360274916,696300196,4,1454,363.5,1360274888712,1360274889736,696272908,696273932,1024
1360274916,696300240,54,45209,837.2037037,1360274890267,1360274896603,696274507,696280843,6336
1360274916,696300268,25,1400,56,1360274887872,1360274915648,696272140,696299916,27776
1360274916,696300284,4,1057,264.25,1360274888431,1360274888623,696272715,696272907,192
1360274916,696300308,4,1882,470.5,1360274888598,1360274889942,696272906,696274250,1344
1360274916,696300312,4,1541,385.25,1360274888597,1360274888853,696272909,696273165,256
1360274916,696300312,4,597,149.25,1360274888597,1360274889237,696272909,696273549,640
1360274916,696300316,10,3287,328.7,1360274891470,1360274894158,696275786,696278474,2688
1360274916,696300340,6,3281,546.8333333,1360274891638,1360274894518,696275978,696278858,2880
1360274921,696304444,9,1460,162.2222222,1360274893049,1360274894969,696276493,696278413,1920
1360274921,696304444,8,3947,493.375,1360274893046,1360274895094,696276490,696278538,2048
1360274921,696304444,8,1196,149.5,1360274893046,1360274895798,696276490,696279242,2752
1360274921,696304448,10,3287,328.7,1360274893362,1360274896114,696276810,696279562,2752
1360274921,696304480,13,4608,354.4615385,1360274894291,1360274896403,696277771,696279883,2112
1360274921,696304492,8,1095,136.875,1360274894984,1360274896456,696278476,696279948,1472
1360274921,696304520,5,3040,608,1360274895596,1360274896492,696279116,696280012,896
1360274921,696304520,7,3345,477.8571429,1360274895595,1360274896491,696279115,696280011,896
1360274921,696304520,7,3480,497.1428571,1360274895595,1360274896747,696279115,696280267,1152
1360274921,696304520,6,3300,550,1360274895595,1360274897771,696279115,696281291,2176
1360274921,696304520,11,9422,856.5454545,1360274895595,1360274899307,696279115,696282827,3712
1360274921,696304524,6,2731,455.1666667,1360274895718,1360274896998,696279242,696280522,1280
1360274921,696304564,8,1219,152.375,1360274892929,1360274896769,696276493,696280333,3840
1360274921,696304632,6,3291,548.5,1360274895484,1360274897596,696279116,696281228,2112
1360274921,696304632,5,3263,652.6,1360274895611,1360274896635,696279243,696280267,1024
1360274921,696304632,10,7464,746.4,1360274895611,1360274899259,696279243,696282891,3648
1360274921,696304632,7,3460,494.2857143,1360274895675,1360274897339,696279307,696280971,1664
1360274921,696304632,6,3275,545.8333333,1360274895483,1360274896891,696279115,696280523,1408
1360274923,696306600,2,98,49,1360274913563,1360274919067,696297163,696302667,5504
1360274923,696306612,5,644,128.8,1360274919439,1360274920079,696303051,696303691,640
1360274923,696306616,5,675,135,1360274919883,1360274920587,696303499,696304203,704
1360274923,696306620,25,26964,1078.56,1360274919945,1360274920777,696303565,696304397,832
1360274923,696306620,3,144,48,1360274914632,1360274920584,696298252,696304204,5952
1360274923,696306640,26,26444,1017.076923,1360274920115,1360274921523,696303755,696305163,1408
1360274923,696306648,3,144,48,1360274916907,1360274922603,696300555,696306251,5696
1360274923,696306696,4,697,174.25,1360274919355,1360274920123,696303051,696303819,768
1360274923,696306700,5,907,181.4,1360274919800,1360274920504,696303500,696304204,704
1360274923,696306700,34,36057,1060.5,1360274920055,1360274922103,696303755,696305803,2048
1360274923,696306728,2,98,49,1360274914587,1360274920475,696298315,696304203,5888
1360274925,696308588,25,21326,853.04,1360274896806,1360274921702,696280394,696305290,24896
1360274925,696308640,3,150,50,1360274897716,1360274898164,696281356,696281804,448
1360274929,696312424,48,2688,56,1360274901194,1360274928394,696284618,696311818,27200
1360274929,696312472,93,111411,1197.967742,1360274903644,1360274924124,696287116,696307596,20480
1360274929,696312584,45,28089,624.2,1360274903530,1360274924010,696287114,696307594,20480
1360274930,3629592940,25,1400,56,1360274903306,1360274929418,3629566246,3629592358,26112
1360274931,696314572,3,144,48,1360274920761,1360274926905,696304333,696310477,6144
1360274931,696314572,2,98,49,1360274920824,1360274926904,696304396,696310476,6080
1360274931,696314572,3,144,48,1360274921015,1360274926903,696304587,696310475,5888
1360274931,696314576,12,11432,952.6666667,1360274923186,1360274923890,696306762,696307466,704
1360274931,696314628,100,109671,1096.71,1360274920128,1360274924160,696303756,696307788,4032
1360274931,696314648,3,144,48,1360274920491,1360274925931,696304139,696309579,5440
1360274931,696314648,2,98,49,1360274920555,1360274926827,696304203,696310475,6272
1360274931,696314656,7,816,116.5714286,1360274923171,1360274924259,696306827,696307915,1088
1360274931,696314696,3,144,48,1360274918650,1360274923834,696302346,696307530,5184
1360274931,696314704,14,2561,182.9285714,1360274919602,1360274925042,696303306,696308746,5440
1360274931,696314704,115,155560,1352.695652,1360274904117,1360274925685,696287821,696309389,21568
1360274931,696314728,2,98,49,1360274920347,1360274925723,696304075,696309451,5376
1360274931,696314728,3,144,48,1360274920347,1360274925723,696304075,696309451,5376
1360274931,696314732,2,98,49,1360274920344,1360274925720,696304076,696309452,5376
1360274933,696316432,2,98,49,1360274920772,1360274927044,696304204,696310476,6272
1360274933,696316432,1,46,46,1360274908675,1360274908675,696292107,696292107,0
1360274933,696316436,1,46,46,1360274908800,1360274908800,696292236,696292236,0
1360274933,696316448,1,46,46,1360274907637,1360274907637,696291085,696291085,0
1360274933,696316488,1,46,46,1360274908237,1360274908237,696291725,696291725,0
1360274933,696316488,1,46,46,1360274908237,1360274908237,696291725,696291725,0
1360274933,696316512,1,46,46,1360274906418,1360274906418,696289930,696289930,0
1360274933,696316512,1,46,46,1360274906547,1360274906547,696290059,696290059,0
1360274933,696316520,1,46,46,1360274908589,1360274908589,696292109,696292109,0
1360274933,696316524,1,46,46,1360274907174,1360274907174,696290698,696290698,0
1360274933,696316528,26,2496,96,1360274904868,1360274931812,696288396,696315340,26944
1360274933,696316552,50,2800,56,1360274904973,1360274932621,696288525,696316173,27648
1360274933,696316608,1,46,46,1360274906835,1360274906835,696290443,696290443,0
1360274933,3629596584,3,144,48,1360274920643,1360274926275,3629584227,3629589859,5632
1360274933,3629596588,2,98,49,1360274919299,1360274925251,3629582887,3629588839,5952
1360274937,696320440,18,1008,56,1360274912829,1360274936381,696296269,696319821,23552
1360274937,696320556,1,46,46,1360274909383,1360274909383,696292939,696292939,0
1360274939,696322580,8,827,103.375,1360274933934,1360274937518,696317514,696321098,3584
1360274939,696322616,3,138,46,1360274934731,1360274937419,696318347,696321035,2688
1360274939,696322688,13,6514,501.0769231,1360274915843,1360274931331,696299531,696315019,15488
1360274939,696322732,5,230,46,1360274935640,1360274937304,696319372,696321036,1664
1360274939,696322736,5,648,129.6,1360274920405,1360274931093,696304141,696314829,10688
1360274941,696324472,4,1427,356.75,1360274913692,1360274913820,696297164,696297292,128
1360274941,696324476,13,4678,359.8461538,1360274916247,1360274920727,696299723,696304203,4480
1360274941,696324512,18,12866,714.7777778,1360274914740,1360274915188,696298252,696298700,448
1360274941,696324596,17,16456,968,1360274913953,1360274914593,696297549,696298189,640
1360274941,696324620,52,61637,1185.326923,1360274914630,1360274940742,696298250,696324362,26112
1360274942,3629604920,12,2885,240.4166667,1360274914012,1360274923292,3629576932,3629586212,9280
1360274945,696328568,8,958,119.75,1360274918011,1360274939963,696301579,696323531,21952
1360274945,696328612,17,952,56,1360274919053,1360274941133,696302665,696324745,22080
1360274945,696328616,9,3417,379.6666667,1360274919757,1360274920845,696303373,696304461,1088
1360274945,696328624,5,3922,784.4,1360274920516,1360274920772,696304140,696304396,256
1360274946,3629608940,10,10250,1025,1360274919753,1360274919881,3629582693,3629582821,128
1360274946,3629608964,5,478,95.6,1360274921010,1360274924146,3629583974,3629587110,3136
1360274946,3629608964,20,15788,789.4,1360274921008,1360274923952,3629583972,3629586916,2944
1360274947,696330596,3,144,48,1360274937439,1360274942943,696321035,696326539,5504
1360274947,696330604,2,92,46,1360274939928,1360274939928,696323532,696323532,0
1360274947,696330604,2,92,46,1360274939928,1360274939928,696323532,696323532,0
1360274947,696330628,131,155278,1185.328244,1360274903233,1360274939905,696286861,696323533,36672
1360274947,696330628,213,283169,1329.431925,1360274903488,1360274939904,696287116,696323532,36416
1360274947,696330720,138,163061,1181.601449,1360274903395,1360274941155,696287115,696324875,37760
1360274947,696330748,1313,1830970,1394.493526,1360274920454,1360274940294,696304202,696324042,19840
1360274953,696336556,1,137,137,1360274925445,1360274925445,696309001,696309001,0
1360274957,696340448,25,1400,56,1360274928882,1360274948594,696312330,696332042,19712
1360274957,696340524,3,169,56.33333333,1360274932263,1360274932327,696315787,696315851,64
1360274957,696340568,3,169,56.33333333,1360274931258,1360274931258,696314826,696314826,0
1360274957,696340624,2,123,61.5,1360274932228,1360274932292,696315852,696315916,64
1360274958,3629620956,10,560,56,1360274930296,1360274947896,3629593252,3629610852,17600
1360274961,696344456,8,768,96,1360274932906,1360274946346,696316362,696329802,13440
1360274961,696344460,16,896,56,1360274932968,1360274948520,696316428,696331980,15552
1360274961,696344636,2,92,46,1360274935736,1360274937400,696319372,696321036,1664
1360274965,696348528,2,92,46,1360274940834,1360274940962,696324362,696324490,128
1360274965,696348536,3,169,56.33333333,1360274939225,1360274939673,696322761,696323209,448
1360274965,696348576,2,92,46,1360274937778,1360274937842,696321354,696321418,64
1360274965,696348584,2,123,61.5,1360274940204,1360274940204,696323788,696323788,0
1360274965,696348704,3,138,46,1360274937651,1360274937715,696321355,696321419,64
1360274965,696348704,6,336,56,1360274937651,1360274946675,696321355,696330379,9024
1360274965,696348708,3,492,164,1360274937712,1360274937840,696321420,696321548,128
1360274965,696348712,2,123,61.5,1360274940076,1360274940076,696323788,696323788,0
1360274969,696352532,2,92,46,1360274940959,1360274940959,696324491,696324491,0
1360274969,696352660,3,138,46,1360274941728,1360274948320,696325388,696331980,6592
1360274969,696352664,2,123,61.5,1360274942108,1360274942172,696325772,696325836,64
1360274973,696356612,3,138,46,1360274946768,1360274946768,696330380,696330380,0
1360274973,696356616,2,112,56,1360274944842,1360274950730,696328458,696334346,5888
1360274973,696356732,2,92,46,1360274946645,1360274946645,696330377,696330377,0
1360274977,696360700,3,138,46,1360274950646,1360274950710,696334346,696334410,64
1360274979,696362592,950,1369861,1441.958947,1360274970916,1360274976228,696354508,696359820,5312
1360274979,696362720,3,144,48,1360274970531,1360274976355,696354251,696360075,5824
1360274987,696370616,5,643,128.6,1360274981516,1360274981644,696365132,696365260,128
1360274987,696370740,5,675,135,1360274980302,1360274980494,696364042,696364234,192
1360274987,696370744,5,648,129.6,1360274970315,1360274983051,696354059,696366795,12736
1360274989,696372736,1,137,137,1360274964114,1360274964114,696347850,696347850,0
1360274995,696378648,6,574,95.66666667,1360274970347,1360274990763,696353995,696374411,20416
1360274995,696378648,6,574,95.66666667,1360274970346,1360274991466,696353994,696375114,21120
1360274997,696380600,7,3888,555.4285714,1360274971291,1360274971547,696354891,696355147,256
1360274997,696380600,8,768,96,1360274971289,1360274990745,696354889,696374345,19456
1360274997,696380644,16,896,56,1360274972078,1360274995566,696355722,696379210,23488
1360274997,696380648,16,896,56,1360274972329,1360274996713,696355977,696380361,24384
1360274997,696380720,31,39910,1287.419355,1360274971555,1360274971747,696355275,696355467,192
1360274997,696380796,2,461,230.5,1360274970456,1360274970456,696354252,696354252,0
1360274998,3629660948,2,334,167,1360274970497,1360274970497,3629633445,3629633445,0
1360274998,3629661040,8,448,56,1360274972582,1360274995174,3629635622,3629658214,22592
1360275001,696384676,7,392,56,1360274972815,1360274987983,696356491,696371659,15168
1360275001,696384700,7,392,56,1360274973302,1360274994870,696357002,696378570,21568
1360275001,696384756,2,123,61.5,1360274975998,1360274976126,696359754,696359882,128
1360275005,696388584,2,123,61.5,1360274977130,1360274977130,696360714,696360714,0
1360275005,696388584,1,77,77,1360274977129,1360274977129,696360713,696360713,0
1360275005,696388712,3,492,164,1360274977833,1360274977961,696361545,696361673,128
1360275009,696392952,2,123,61.5,1360274983739,1360274983803,696367691,696367755,64
1360275011,696394660,3,138,46,1360275010463,1360275010591,696394123,696394251,128
1360275013,696396592,2,123,61.5,1360274987105,1360274987169,696370697,696370761,64
1360275013,696396708,2,123,61.5,1360274985007,1360274985007,696368715,696368715,0
1360275013,696396708,1,77,77,1360274985007,1360274985007,696368715,696368715,0
1360275019,696402688,3,138,46,1360275011459,1360275011523,696395147,696395211,64
1360275019,696402688,3,138,46,1360275011459,1360275011587,696395147,696395275,128
1360275019,696402692,3,138,46,1360275014398,1360275014462,696398090,696398154,64
1360275019,696402732,3,138,46,1360275012436,1360275012500,696396168,696396232,64
1360275019,696402732,3,138,46,1360275012438,1360275012502,696396170,696396234,64
1360275019,696402732,2,92,46,1360275012438,1360275012438,696396170,696396170,0
1360275021,3629684584,108,128200,1187.037037,1360274886404,1360275013892,3629549988,3629677476,127488
1360275021,3629684584,130,146816,1129.353846,1360274886404,1360275013892,3629549988,3629677476,127488
1360275021,3629684596,120,149126,1242.716667,1360274886395,1360275013883,3629549991,3629677479,127488
1360275025,696408576,1,137,137,1360274996852,1360274996852,696380428,696380428,0
1360275027,696410616,7,412,58.85714286,1360275021066,1360275021130,696404682,696404746,64
1360275027,696410700,8,458,57.25,1360275022004,1360275022004,696405704,696405704,0
1360275027,696410704,7,412,58.85714286,1360275022000,1360275022064,696405704,696405768,64
1360275029,696412608,2,92,46,1360275001489,1360275001553,696385097,696385161,64
1360275029,696412700,3,168,56,1360275001400,1360275023224,696385100,696406924,21824
1360275029,696412740,2,192,96,1360275004302,1360275012366,696388042,696396106,8064
1360275029,696412740,2,92,46,1360275004365,1360275004429,696388105,696388169,64
1360275030,3629692960,1,46,46,1360275005559,1360275005559,3629668519,3629668519,0
1360275030,3629692960,1,46,46,1360275005558,1360275005558,3629668518,3629668518,0
1360275030,3629693004,1,46,46,1360275005449,1360275005449,3629668453,3629668453,0
1360275030,3629693004,2,92,46,1360275005449,1360275005513,3629668453,3629668517,64
1360275033,696416588,1,46,46,1360275005542,1360275005542,696389130,696389130,0
1360275033,696416588,1,46,46,1360275005542,1360275005542,696389130,696389130,0
1360275033,696416588,1,46,46,1360275005541,1360275005541,696389129,696389129,0
1360275033,696416620,2,92,46,1360275006535,1360275006535,696390155,696390155,0
1360275033,696416676,4,224,56,1360275005391,1360275021007,696389067,696404683,15616
1360275033,696416676,2,92,46,1360275005455,1360275005455,696389131,696389131,0
1360275033,696416676,1,46,46,1360275005454,1360275005454,696389130,696389130,0
1360275033,696416676,1,46,46,1360275005454,1360275005454,696389130,696389130,0
1360275033,696416712,4,224,56,1360275006379,1360275021995,696390091,696405707,15616
1360275035,696418648,8,458,57.25,1360275030056,1360275030056,696413704,696413704,0
1360275035,696418712,8,458,57.25,1360275028970,1360275029034,696412682,696412746,64
1360275035,696418724,7,412,58.85714286,1360275029982,1360275029982,696413706,696413706,0
1360275035,696418792,7,412,58.85714286,1360275031896,1360275031960,696415688,696415752,64
1360275037,696420756,2,112,56,1360275010366,1360275017406,696394122,696401162,7040
1360275037,3629700592,3,138,46,1360275034940,1360275034940,3629698532,3629698532,0
1360275038,3629700924,2,112,56,1360275010713,1360275017881,3629673637,3629680805,7168
1360275042,3629704928,1,46,46,1360275014550,1360275014550,3629677478,3629677478,0
1360275042,3629704972,2,92,46,1360275014505,1360275014505,3629677477,3629677477,0
1360275042,3629704972,1,46,46,1360275014505,1360275014505,3629677477,3629677477,0
1360275043,696426728,5,655,131,1360275041371,1360275041883,696425099,696425611,512
1360275043,696426768,4,205,51.25,1360275036401,1360275036401,696420169,696420169,0
1360275043,696426776,5,675,135,1360275040298,1360275040554,696424074,696424330,256
1360275045,696428636,3,492,164,1360275017463,1360275017591,696401099,696401227,128
1360275049,696432636,1,46,46,1360275023285,1360275023285,696406921,696406921,0
1360275051,696434800,282,373002,1322.702128,1360274903315,1360275049363,696287115,696433163,146048
1360275057,696440632,2,92,46,1360275029432,1360275029496,696413064,696413128,64
1360275057,696440744,1,137,137,1360275029576,1360275029576,696413320,696413320,0
1360275057,696440756,2,92,46,1360275030335,1360275030335,696414091,696414091,0
1360275061,696444820,1,46,46,1360275036350,1360275036350,696420170,696420170,0
1360275066,3629728932,1,46,46,1360275039568,1360275039568,3629702500,3629702500,0
1360275066,3629728984,2,92,46,1360275039517,1360275039517,3629702501,3629702501,0
1360275085,696468960,5,1929,385.8,1360275057970,1360275063922,696441930,696447882,5952
1360275089,696473088,5,2798,559.6,1360275063664,1360275064112,696447752,696448200,448
1360275093,696477048,1,137,137,1360275068696,1360275068696,696452744,696452744,0
1360275099,696482892,4,190,47.5,1360275095796,1360275096052,696479688,696479944,256
1360275107,696490692,5,643,128.6,1360275101435,1360275101563,696485127,696485255,128
1360275107,696490736,5,675,135,1360275100304,1360275100496,696484040,696484232,192
1360275113,696496944,1,46,46,1360275085889,1360275085889,696469833,696469833,0
1360275113,696497068,2,92,46,1360275086790,1360275086790,696470858,696470858,0
1360275113,696497068,1,46,46,1360275086789,1360275086789,696470857,696470857,0
1360275114,3629777216,2,92,46,1360275086005,1360275086005,3629749221,3629749221,0
1360275121,696505192,8,6267,783.375,1360275095496,1360275096008,696479688,696480200,512
1360275123,696506900,10,681,68.1,1360275115627,1360275122219,696499527,696506119,6592
1360275129,696513016,13,4005,308.0769231,1360275103416,1360275120440,696487432,696504456,17024
1360275133,696516952,1,137,137,1360275106616,1360275106616,696490568,696490568,0
1360275141,696524988,1,46,46,1360275115477,1360275115477,696499465,696499465,0
1360275149,696533084,5,3676,735.2,1360275121012,1360275121076,696505096,696505160,64
1360275155,696538832,1250,1790959,1432.7672,1360275136304,1360275151536,696520136,696535368,15232
1360275163,696546768,5,643,128.6,1360275161327,1360275161519,696545095,696545287,192
1360275163,696546816,5,675,135,1360275160255,1360275160383,696544071,696544199,128
1360275165,696549012,12,672,56,1360275139133,1360275154173,696523145,696538185,15040
1360275165,696549088,24,1344,56,1360275138478,1360275153838,696522566,696537926,15360
1360275165,696549112,11,616,56,1360275138649,1360275149785,696522761,696533897,11136
1360275165,696549120,17,16449,967.5882353,1360275137169,1360275153873,696521289,696537993,16704
1360275165,696549192,12,1152,96,1360275138183,1360275150535,696522375,696534727,12352
1360275165,696549196,25,1400,56,1360275138308,1360275153476,696522504,696537672,15168
1360275166,3629829260,11,616,56,1360275138827,1360275150091,3629802087,3629813351,11264
1360275169,696553080,1,137,137,1360275141369,1360275141369,696525449,696525449,0
1360275171,696554848,2,92,46,1360275169312,1360275169312,696553160,696553160,0
1360275181,696565008,104962,155224186,1478.860788,1360274210240,1360274877632,695594248,696261640,667392
1360275185,696569104,9,1710,190,1360275160225,1360275178401,696544329,696562505,18176
1360275203,696586880,3,144,48,1360275196094,1360275202302,696579974,696586182,6208
1360275209,696593328,3,138,46,1360275184065,1360275184065,696568393,696568393,0
1360275209,696593364,1,137,137,1360275181595,1360275181595,696565959,696565959,0
1360275221,696605292,6,3271,545.1666667,1360275195682,1360275195874,696579974,696580166,192
1360275221,696605292,5,2663,532.6,1360275195682,1360275195938,696579974,696580230,256
1360275227,696610836,5,675,135,1360275220201,1360275220393,696604037,696604229,192
1360275227,696610928,5,643,128.6,1360275221199,1360275221327,696605127,696605255,128
1360275235,696618876,5,575,115,1360275213698,1360275229250,696597574,696613126,15552
1360275246,696629572,3,492,164,1360275218547,1360275218675,696602119,696602247,128
1360275250,696633492,1,137,137,1360275223362,1360275223362,696606854,696606854,0
1360275270,696653464,2,92,46,1360275244896,1360275244960,696628360,696628424,64
1360275270,696653552,3,138,46,1360275244805,1360275244869,696628357,696628421,64
1360275274,696657500,9,4456,495.1111111,1360275246329,1360275262777,696629829,696646277,16448
1360275283,696666948,6,721,120.1666667,1360275280122,1360275281274,696664070,696665222,1152
1360275283,696666980,5,643,128.6,1360275281112,1360275281304,696665092,696665284,192
1360275286,696669472,1,137,137,1360275261333,1360275261333,696644805,696644805,0
1360275307,696690936,2,98,49,1360275297031,1360275303047,696680967,696686983,6016
1360275307,696690936,17,16739,984.6470588,1360275288710,1360275305094,696672646,696689030,16384
1360275307,696691028,3,144,48,1360275296937,1360275303017,696680965,696687045,6080
1360275322,696705408,1,137,137,1360275294739,1360275294739,696678147,696678147,0
1360275322,696705480,6,3517,586.1666667,1360275297486,1360275297614,696680966,696681094,128
1360275330,696713532,3,492,164,1360275303257,1360275303385,696686789,696686917,128
1360275347,696730900,5,675,135,1360275340199,1360275340327,696724099,696724227,128
1360275347,696730992,6,689,114.8333333,1360275341132,1360275341324,696725124,696725316,192
1360275354,696737572,4,192,48,1360275328754,1360275330994,696712326,696714566,2240
1360275358,696741620,1,137,137,1360275333632,1360275333632,696717252,696717252,0
1360275362,696745720,6,2936,489.3333333,1360275336669,1360275347165,696720389,696730885,10496
1360275362,696745724,4,3104,776,1360275336792,1360275336856,696720516,696720580,64
1360275363,696747044,5,453,90.6,1360275359576,1360275362328,696743620,696746372,2752
1360275371,696754924,2,98,49,1360275363218,1360275369106,696747142,696753030,5888
1360275371,696754924,2,98,49,1360275361873,1360275367057,696745797,696750981,5184
1360275371,696754924,26,25182,968.5384615,1360275361873,1360275363729,696745797,696747653,1856
1360275371,696754924,47,46262,984.2978723,1360275361936,1360275364880,696745860,696748804,2944
1360275371,696754928,2,98,49,1360275362188,1360275368076,696746116,696752004,5888
1360275371,696754928,2,98,49,1360275362187,1360275368075,696746115,696752003,5888
1360275371,696754932,2,98,49,1360275362186,1360275368138,696746118,696752070,5952
1360275371,696754932,9,1015,112.7777778,1360275366345,1360275366793,696750277,696750725,448
1360275371,696754956,3,144,48,1360275362479,1360275368111,696746435,696752067,5632
1360275371,696754960,2,98,49,1360275364203,1360275370155,696748163,696754115,5952
1360275371,696755000,2,98,49,1360275361155,1360275367043,696745155,696751043,5888
1360275371,696755000,3,144,48,1360275361220,1360275367044,696745220,696751044,5824
1360275371,696755004,3,144,48,1360275362882,1360275369026,696746886,696753030,6144
1360275371,696755008,3,144,48,1360275363198,1360275369022,696747206,696753030,5824
1360275371,696755008,30,37645,1254.833333,1360275361790,1360275364094,696745798,696748102,2304
1360275371,696755008,47,50834,1081.574468,1360275361789,1360275363773,696745797,696747781,1984
1360275371,696755076,3,144,48,1360275362040,1360275368056,696746116,696752132,6016
1360275371,696755076,2,98,49,1360275362103,1360275367991,696746179,696752067,5888
1360275371,696755084,32,32960,1030,1360275362353,1360275370481,696746437,696754565,8128
1360275371,696755112,2,98,49,1360275364243,1360275369939,696748355,696754051,5696
1360275371,696755120,15,10680,712,1360275365132,1360275366156,696749252,696750276,1024
1360275371,696755128,2,98,49,1360275361027,1360275366851,696745155,696750979,5824
1360275371,696755128,3,144,48,1360275361091,1360275366915,696745219,696751043,5824
1360275373,3630036620,3,144,48,1360275363108,1360275368804,3630026728,3630032424,5696
1360275373,3630036632,3,144,48,1360275363097,1360275368793,3630026729,3630032425,5696
1360275373,3630036632,3,144,48,1360275363097,1360275368793,3630026729,3630032425,5696
1360275373,3630036648,2,98,49,1360275360905,1360275366729,3630024553,3630030377,5824
1360275374,696757568,9,4084,453.7777778,1360275347315,1360275347507,696730883,696731075,192
1360275378,696761564,19,1824,96,1360275350137,1360275376569,696733701,696760133,26432
1360275378,696761568,38,2128,56,1360275350389,1360275376693,696733957,696760261,26304
1360275378,696761576,19,1064,56,1360275351084,1360275377388,696734660,696760964,26304
1360275378,696761648,37,2072,56,1360275350371,1360275377571,696734019,696761219,27200
1360275378,696761652,19,1064,56,1360275350498,1360275377698,696734150,696761350,27200
1360275378,696761680,92,115326,1253.543478,1360275350916,1360275366660,696734596,696750340,15744
1360275378,3630041580,18,1008,56,1360275350155,1360275377227,3630013735,3630040807,27072
1360275379,696762924,10,5013,501.3,1360275361490,1360275378194,696745414,696762118,16704
1360275379,696762936,4,196,49,1360275371779,1360275378243,696755715,696762179,6464
1360275379,696762936,2,94,47,1360275366403,1360275372163,696750339,696756099,5760
1360275379,696762940,6,1855,309.1666667,1360275370498,1360275373826,696754438,696757766,3328
1360275379,696762960,4,196,49,1360275370478,1360275377262,696754438,696761222,6784
1360275379,696762972,4,190,47.5,1360275367583,1360275373087,696751555,696757059,5504
1360275379,696762972,10,4844,484.4,1360275367586,1360275374626,696751558,696758598,7040
1360275379,696762972,2,94,47,1360275365281,1360275371105,696749253,696755077,5824
1360275379,696763000,4,196,49,1360275369284,1360275378372,696753284,696762372,9088
1360275379,696763008,6,294,49,1360275370043,1360275378235,696754051,696762243,8192
1360275379,696763012,6,300,50,1360275370039,1360275378359,696754051,696762371,8320
1360275379,696763012,5,254,50.8,1360275370039,1360275378743,696754051,696762755,8704
1360275379,696763012,4,196,49,1360275371703,1360275378167,696755715,696762179,6464
1360275379,696763044,7,346,49.42857143,1360275370520,1360275378008,696754564,696762052,7488
1360275379,696763048,3,144,48,1360275367187,1360275373011,696751235,696757059,5824
1360275379,696763080,5,660,132,1360275360756,1360275371636,696744836,696755716,10880
1360275379,696763080,12,7028,585.6666667,1360275360756,1360275378036,696744836,696762116,17280
1360275381,3630044628,4,202,50.5,1360275374173,1360275380765,3630037801,3630044393,6592
1360275386,696769644,1,46,46,1360275359975,1360275359975,696743619,696743619,0
1360275386,696769676,7,620,88.57142857,1360275361160,1360275385160,696744836,696768836,24000
1360275386,696769768,13,2491,191.6153846,1360275361003,1360275384299,696744771,696768067,23296
1360275386,696769768,7,620,88.57142857,1360275361069,1360275384173,696744837,696767941,23104
1360275386,3630049552,4,432,108,1360275360617,1360275360809,3630024169,3630024361,192
1360275387,696770936,4,190,47.5,1360275379141,1360275380229,696763077,696764165,1088
1360275387,696770936,2,92,46,1360275379331,1360275380163,696763267,696764099,832
1360275387,696770940,160,178778,1117.3625,1360275371520,1360275383232,696755460,696767172,11712
1360275387,696770940,21,4831,230.047619,1360275374464,1360275381248,696758404,696765188,6784
1360275387,696770940,114,91859,805.7807018,1360275371520,1360275381888,696755460,696765828,10368
1360275387,696770940,2,98,49,1360275379647,1360275379967,696763587,696763907,320
1360275387,696770944,2,92,46,1360275382654,1360275382654,696766598,696766598,0
1360275387,696770944,3,150,50,1360275379837,1360275386365,696763781,696770309,6528
1360275387,696770948,16,778,48.625,1360275375098,1360275379898,696759046,696763846,4800
1360275387,696770972,23,10197,443.3478261,1360275364002,1360275383202,696747974,696767174,19200
1360275387,696770976,21,16557,788.4285714,1360275364125,1360275382877,696748101,696766853,18752
1360275387,696771016,2,92,46,1360275378869,1360275379957,696762885,696763973,1088
1360275387,696771020,4,184,46,1360275379183,1360275380079,696763203,696764099,896
1360275387,696771024,2,92,46,1360275379246,1360275380078,696763270,696764102,832
1360275387,696771028,2,92,46,1360275379370,1360275379882,696763398,696763910,512
1360275387,696771028,62,26086,420.7419355,1360275371434,1360275383978,696755462,696768006,12544
1360275387,696771028,15,3190,212.6666667,1360275377961,1360275385129,696761989,696769157,7168
1360275387,696771028,2,92,46,1360275379561,1360275379625,696763589,696763653,64
1360275387,696771028,3,144,48,1360275379559,1360275379879,696763587,696763907,320
1360275387,696771056,15,2960,197.3333333,1360275374798,1360275380174,696758854,696764230,5376
1360275387,696771056,12,731,60.91666667,1360275378190,1360275385166,696762246,696769222,6976
1360275389,3630052624,2,92,46,1360275381534,1360275384094,3630045158,3630047718,2560
1360275390,696773852,22,28429,1292.227273,1360275361625,1360275365913,696745477,696749765,4288
1360275390,696773856,8,1980,247.5,1360275361812,1360275363284,696745668,696747140,1472
1360275390,696773900,18,13791,766.1666667,1360275364264,1360275365160,696748164,696749060,896
1360275390,696773940,62,71405,1151.693548,1360275362944,1360275388864,696746884,696772804,25920
1360275390,696773940,10,4301,430.1,1360275362944,1360275388608,696746884,696772548,25664
1360275390,696773968,4,1004,251,1360275363174,1360275367206,696747142,696751174,4032
1360275390,3630053528,4,1512,378,1360275362816,1360275363200,3630026344,3630026728,384
1360275390,3630053532,12,5837,486.4166667,1360275363197,1360275366205,3630026729,3630029737,3008
1360275394,696777852,3,601,200.3333333,1360275366873,1360275367065,696750725,696750917,192
1360275394,696777924,45,36152,803.3777778,1360275369362,1360275385234,696753286,696769158,15872
1360275394,696777968,24,13693,570.5416667,1360275367268,1360275391332,696751236,696775300,24064
1360275394,696777996,1,137,137,1360275368202,1360275368202,696752198,696752198,0
1360275395,696778936,12,3499,291.5833333,1360275389894,1360275393222,696773830,696777158,3328
1360275395,696778944,2,98,49,1360275382395,1360275389179,696766339,696773123,6784
1360275395,696778944,7,2372,338.8571429,1360275394299,1360275394619,696778243,696778563,320
1360275395,696778976,2,98,49,1360275383133,1360275390109,696767109,696774085,6976
1360275395,696778976,5,248,49.6,1360275379997,1360275389213,696763973,696773189,9216
1360275395,696778988,3,144,48,1360275383889,1360275390097,696767877,696774085,6208
1360275395,696778992,3,144,48,1360275384270,1360275392078,696768262,696776070,7808
1360275395,696779016,14,834,59.57142857,1360275384882,1360275391602,696768898,696775618,6720
1360275395,696779016,4,196,49,1360275385141,1360275392053,696769157,696776069,6912
1360275395,696779020,6,1101,183.5,1360275393841,1360275394161,696777861,696778181,320
1360275395,696779024,7,591,84.42857143,1360275369709,1360275393453,696753733,696777477,23744
1360275395,696779060,2,98,49,1360275382729,1360275390025,696766789,696774085,7296
1360275395,696779064,4,202,50.5,1360275379908,1360275387012,696763972,696771076,7104
1360275395,696779064,3,150,50,1360275383108,1360275390020,696767172,696774084,6912
1360275395,696779068,5,248,49.6,1360275380096,1360275389120,696764164,696773188,9024
1360275395,696779072,3,150,50,1360275383802,1360275391546,696767874,696775618,7744
1360275395,696779076,2,98,49,1360275383800,1360275390008,696767876,696774084,6208
1360275395,696779076,5,242,48.4,1360275383800,1360275390712,696767876,696774788,6912
1360275395,696779076,3,138,46,1360275388472,1360275390264,696772548,696774340,1792
1360275395,696779100,4,196,49,1360275381089,1360275389473,696765189,696773573,8384
1360275395,696779100,4,196,49,1360275381088,1360275389472,696765188,696773572,8384
1360275395,696779104,15,886,59.06666667,1360275384542,1360275392094,696768646,696776198,7552
1360275395,696779104,15,3673,244.8666667,1360275389469,1360275392541,696773573,696776645,3072
1360275395,696779108,3,144,48,1360275385049,1360275392025,696769157,696776133,6976
1360275397,3630060632,2,98,49,1360275384665,1360275391385,3630048297,3630055017,6720
1360275397,3630060632,3,144,48,1360275384408,1360275391384,3630048040,3630055016,6976
1360275398,696781860,5,2282,456.4,1360275369938,1360275370322,696753798,696754182,384
1360275398,696781940,4,774,193.5,1360275369855,1360275370111,696753795,696754051,256
1360275398,696781940,37,38352,1036.540541,1360275369855,1360275371007,696753795,696754947,1152
1360275398,696781964,75,59021,786.9466667,1360275369958,1360275383590,696753922,696767554,13632
1360275398,696781968,59,51713,876.4915254,1360275371494,1360275380326,696755462,696764294,8832
1360275398,696781968,54,43995,814.7222222,1360275371492,1360275380324,696755460,696764292,8832
1360275398,696781972,49,61182,1248.612245,1360275370082,1360275380322,696754054,696764294,10240
1360275402,696785848,36,2016,56,1360275377820,1360275401116,696761668,696784964,23296
1360275402,696785928,37,2072,56,1360275377674,1360275401546,696761602,696785474,23872
1360275402,696785936,2,1421,710.5,1360275374020,1360275374148,696757956,696758084,128
1360275403,696786952,5,242,48.4,1360275389876,1360275396404,696773828,696780356,6528
1360275403,696786952,3,150,50,1360275389940,1360275396148,696773892,696780100,6208
1360275403,696786956,5,242,48.4,1360275390319,1360275396463,696774275,696780419,6144
1360275403,696786960,6,338,56.33333333,1360275395371,1360275396075,696779331,696780035,704
1360275403,696787000,14,10372,740.8571429,1360275385028,1360275398660,696769028,696782660,13632
1360275403,696787000,7,1915,273.5714286,1360275385028,1360275397444,696769028,696781444,12416
1360275403,696787036,5,248,49.6,1360275389856,1360275396320,696773892,696780356,6464
1360275403,696787040,3,150,50,1360275390045,1360275396061,696774085,696780101,6016
1360275403,696787040,11,1041,94.63636364,1360275398172,1360275398940,696782212,696782980,768
1360275403,696787044,3,138,46,1360275394199,1360275400279,696778243,696784323,6080
1360275403,696787084,3,150,50,1360275386738,1360275394994,696770822,696779078,8256
1360275403,696787088,4,196,49,1360275396908,1360275402604,696780996,696786692,5696
1360275403,696787112,3,150,50,1360275389525,1360275395989,696773637,696780101,6464
1360275403,696787112,15,9475,631.6666667,1360275384915,1360275397331,696769027,696781443,12416
1360275403,696787112,2,98,49,1360275393171,1360275399187,696777283,696783299,6016
1360275405,3630068628,4,196,49,1360275396954,1360275402906,3630060582,3630066534,5952
1360275406,696789864,10,6474,647.4,1360275381582,1360275384846,696765446,696768710,3264
1360275406,696789864,22,2112,96,1360275378957,1360275405389,696762821,696789253,26432
1360275406,696789904,21,18228,868,1360275379877,1360275398757,696763781,696782661,18880
1360275406,696789904,23,23237,1010.304348,1360275379876,1360275389220,696763780,696773124,9344
1360275406,696789904,1,46,46,1360275379876,1360275379876,696763780,696763780,0
1360275406,696789908,16,11861,741.3125,1360275380001,1360275398881,696763909,696782789,18880
1360275406,696789916,6,624,104,1360275380377,1360275384089,696764293,696768005,3712
1360275406,696789916,7,670,95.71428571,1360275380375,1360275384087,696764291,696768003,3712
1360275406,696789984,25,1400,56,1360275377876,1360275405204,696761860,696789188,27328
1360275406,696789996,20,1120,56,1360275378313,1360275405513,696762309,696789509,27200
1360275406,696789996,23,22537,979.8695652,1360275379784,1360275398728,696763780,696782724,18944
1360275406,696790064,53,64103,1209.490566,1360275381252,1360275393284,696765316,696777348,12032
1360275406,3630069552,24,1344,56,1360275378281,1360275405481,3630041833,3630069033,27200
1360275410,696793884,31,13588,438.3225806,1360275383226,1360275399226,696767110,696783110,16000
1360275410,696793884,17,6233,366.6470588,1360275383289,1360275391929,696767173,696775813,8640
1360275410,696793884,17,5395,317.3529412,1360275383288,1360275392120,696767172,696776004,8832
1360275410,696793888,71,67868,955.8873239,1360275383286,1360275401142,696767174,696785030,17856
1360275410,696793896,16,5517,344.8125,1360275384235,1360275391659,696768131,696775555,7424
1360275410,696793900,17,5440,320,1360275384426,1360275396202,696768326,696780102,11776
1360275410,696793932,17,2338,137.5294118,1360275385223,1360275398855,696769155,696782787,13632
1360275410,696793976,24,8424,351,1360275382812,1360275399068,696766788,696783044,16256
1360275410,696793980,17,6377,375.1176471,1360275383192,1360275391576,696767172,696775556,8384
1360275410,696793980,22,7105,322.9545455,1360275383192,1360275392664,696767172,696776644,9472
1360275410,696793984,24,8944,372.6666667,1360275383381,1360275399061,696767365,696783045,15680
1360275410,696794008,26,10913,419.7307692,1360275384061,1360275399101,696768069,696783109,15040
1360275410,696794012,50,38588,771.76,1360275384378,1360275399034,696768390,696783046,14656
1360275411,696794956,2,92,46,1360275403120,1360275409392,696787076,696793348,6272
1360275411,696794956,2,279,139.5,1360275403120,1360275410544,696787076,696794500,7424
1360275411,696794956,2,279,139.5,1360275403119,1360275409327,696787075,696793283,6208
1360275411,696794992,3,144,48,1360275399436,1360275405324,696783428,696789316,5888
1360275411,696794992,6,461,76.83333333,1360275404234,1360275404618,696788226,696788610,384
1360275411,696794996,4,190,47.5,1360275404488,1360275405576,696788484,696789572,1088
1360275411,696795008,14,837,59.78571429,1360275397181,1360275404093,696781189,696788101,6912
1360275411,696795024,8,495,61.875,1360275400938,1360275409450,696784962,696793474,8512
1360275411,696795028,5,675,135,1360275401065,1360275403369,696785093,696787397,2304
1360275411,696795028,5,643,128.6,1360275401385,1360275403433,696785413,696787461,2048
1360275411,696795032,2,92,46,1360275403044,1360275409316,696787076,696793348,6272
1360275411,696795076,2,98,49,1360275399351,1360275405239,696783427,696789315,5888
1360275411,696795080,4,190,47.5,1360275404404,1360275405556,696788484,696789636,1152
1360275411,696795120,2,92,46,1360275401294,1360275408206,696785414,696792326,6912
1360275413,3630076636,3,144,48,1360275403094,1360275409430,3630066730,3630073066,6336
1360275413,3630076636,2,98,49,1360275403924,1360275410068,3630067560,3630073704,6144
1360275413,3630076656,3,144,48,1360275403903,1360275410047,3630067559,3630073703,6144
1360275414,696797984,25,12669,506.76,1360275386260,1360275410068,696770244,696794052,23808
1360275414,696798032,7,4026,575.1428571,1360275389604,1360275390948,696773636,696774980,1344
1360275418,696801944,15,12498,833.2,1360275393723,1360275394683,696777667,696778627,960
1360275418,696801948,6,2850,475,1360275389818,1360275399354,696773766,696783302,9536
1360275419,696802952,3,144,48,1360275409842,1360275415666,696793794,696799618,5824
1360275419,696802956,3,144,48,1360275410031,1360275416431,696793987,696800387,6400
1360275419,696803008,14,1203,85.92857143,1360275416571,1360275418043,696800579,696802051,1472
1360275419,696803120,4,371,92.75,1360275401035,1360275415435,696785155,696799555,14400
1360275422,696805912,46,37572,816.7826087,1360275395803,1360275416923,696779715,696800835,21120
1360275422,696805952,6,1383,230.5,1360275397173,1360275410357,696781125,696794309,13184
1360275422,696805960,1,46,46,1360275394988,1360275394988,696778948,696778948,0
1360275422,696806044,3,2595,865,1360275397014,1360275415062,696781058,696799106,18048
1360275426,696809900,70,79824,1140.342857,1360275399210,1360275422762,696783110,696806662,23552
1360275426,696809920,6,5347,891.1666667,1360275399315,1360275399571,696783235,696783491,256
1360275426,696810016,1,137,137,1360275399413,1360275399413,696783429,696783429,0
1360275427,696810976,6,461,76.83333333,1360275422747,1360275423195,696806723,696807171,448
1360275427,696811020,10,2344,234.4,1360275415729,1360275421361,696799749,696805381,5632
1360275427,696811136,3,144,48,1360275416443,1360275422267,696800579,696806403,5824
1360275427,696811136,8,495,61.875,1360275416506,1360275422650,696800642,696806786,6144
1360275427,696811140,14,15159,1082.785714,1360275408824,1360275425272,696792964,696809412,16448
1360275429,3630092656,4,190,47.5,1360275415487,1360275421247,3630079143,3630084903,5760
1360275430,696813876,1,46,46,1360275403328,1360275403328,696787204,696787204,0
1360275430,696813876,46,2576,56,1360275402240,1360275429824,696786116,696813700,27584
1360275430,696813964,49,2744,56,1360275402279,1360275429671,696786243,696813635,27392
1360275430,696814032,3,138,46,1360275405349,1360275405349,696789381,696789381,0
1360275430,3630093636,6,3828,638,1360275403090,1360275403986,3630066726,3630067622,896
1360275434,696817868,24,1344,56,1360275406024,1360275430664,696789892,696814532,24640
1360275434,696817868,25,2400,96,1360275406087,1360275430855,696789955,696814723,24768
1360275434,696817872,21,1176,56,1360275406339,1360275429891,696790211,696813763,23552
1360275434,3630097556,21,1176,56,1360275406181,1360275429733,3630069737,3630093289,23552
1360275435,696818968,2,92,46,1360275427107,1360275429539,696811075,696813507,2432
1360275435,696819060,1590,2107369,1325.389308,1360275361862,1360275428806,696745922,696812866,66944
1360275438,696821968,30,29108,970.2666667,1360275410020,1360275426660,696793988,696810628,16640
1360275438,696822000,17,7782,457.7647059,1360275410499,1360275428739,696794499,696812739,18240
1360275442,696825880,10,9969,996.9,1360275417850,1360275421242,696801730,696805122,3392
1360275442,696825928,18,18546,1030.333333,1360275415885,1360275426829,696799813,696810757,10944
1360275442,696825928,19,16884,888.6315789,1360275415884,1360275429708,696799812,696813636,13824
1360275442,696825928,22,25233,1146.954545,1360275415884,1360275430092,696799812,696814020,14208
1360275442,696825964,19,26741,1407.421053,1360275417065,1360275417577,696801029,696801541,512
1360275442,696826040,18,19900,1105.555556,1360275415772,1360275429724,696799812,696813764,13952
1360275442,696826040,1,77,77,1360275415836,1360275415836,696799876,696799876,0
1360275442,696826048,17,17622,1036.588235,1360275416275,1360275417107,696800323,696801155,832
1360275442,696826052,4,883,220.75,1360275416527,1360275416591,696800579,696800643,64
1360275443,696826976,8,398,49.75,1360275427162,1360275435610,696811138,696819586,8448
1360275443,696827020,4,196,49,1360275428655,1360275435439,696812675,696819459,6784
1360275443,696827100,5,242,48.4,1360275428767,1360275435423,696812867,696819523,6656
1360275443,696827136,131,142432,1087.267176,1360275416188,1360275436348,696800324,696820484,20160
1360275446,696829900,1,46,46,1360275419623,1360275419623,696803523,696803523,0
1360275446,696829932,1,46,46,1360275420294,1360275420294,696804226,696804226,0
1360275446,696829960,1,46,46,1360275420907,1360275420907,696804867,696804867,0
1360275446,696829972,1,46,46,1360275419102,1360275419102,696803074,696803074,0
1360275446,696829976,1,46,46,1360275418010,1360275418010,696801986,696801986,0
1360275446,696830004,1,46,46,1360275418176,1360275418176,696802180,696802180,0
1360275446,696830040,1,46,46,1360275420187,1360275420187,696804227,696804227,0
1360275450,696834004,1,46,46,1360275423616,1360275423616,696807620,696807620,0
1360275450,696834040,5,230,46,1360275424795,1360275425883,696808835,696809923,1088
1360275451,696835104,3,169,56.33333333,1360275447261,1360275447325,696831365,696831429,64
1360275454,696837892,8,642,80.25,1360275426992,1360275429936,696810884,696813828,2944
1360275454,696837908,6,4751,791.8333333,1360275426528,1360275427040,696810436,696810948,512
1360275454,696837908,3,138,46,1360275427615,1360275428895,696811523,696812803,1280
1360275458,696841920,6,336,56,1360275430100,1360275452948,696814020,696836868,22848
1360275458,696842008,6,336,56,1360275430075,1360275452667,696814083,696836675,22592
1360275459,696843032,6,461,76.83333333,1360275452709,1360275452901,696836741,696836933,192
1360275462,696845996,2,112,56,1360275433861,1360275456261,696817857,696840257,22400
1360275462,3630125760,3,168,56,1360275435030,1360275457686,3630098790,3630121446,22656
1360275466,696849920,1,865,865,1360275439188,1360275439188,696823108,696823108,0
1360275466,696849920,3,168,56,1360275439188,1360275461268,696823108,696845188,22080
1360275467,696851132,5,675,135,1360275460928,1360275461120,696845060,696845252,192
1360275467,696851132,5,643,128.6,1360275461054,1360275461182,696845186,696845314,128
1360275470,696853932,2,192,96,1360275443463,1360275461447,696827395,696845379,17984
1360275470,696853932,1,137,137,1360275443462,1360275443462,696827394,696827394,0
1360275470,696854080,10,1406,140.6,1360275444275,1360275468339,696828355,696852419,24064
1360275475,696859048,3,325,108.3333333,1360275461138,1360275467090,696845186,696851138,5952
1360275475,696859096,6,461,76.83333333,1360275467621,1360275467813,696851717,696851909,192
1360275483,696866716,1,46,46,1360275458080,1360275458080,696841796,696841796,0
1360275485,696868760,1,46,46,1360275456243,1360275456243,696840003,696840003,0
1360275485,696869196,8,903,112.875,1360275479104,1360275479360,696863300,696863556,256
1360275485,3630148636,3,150,50,1360275478164,1360275483732,3630141800,3630147368,5568
1360275486,696869996,9,504,56,1360275461062,1360275485638,696845058,696869634,24576
1360275486,696870080,2,123,61.5,1360275460850,1360275460914,696844930,696844994,64
1360275486,696870084,8,448,56,1360275460848,1360275485488,696844932,696869572,24640
1360275486,696870088,3,138,46,1360275461292,1360275461292,696845380,696845380,0
1360275491,696875000,6,461,76.83333333,1360275486021,1360275487621,696870021,696871621,1600
1360275491,696875000,14,2582,184.4285714,1360275478468,1360275484356,696862468,696868356,5888
1360275491,696875004,11,3207,291.5454545,1360275479039,1360275490687,696863043,696874691,11648
1360275491,696875004,3,144,48,1360275479166,1360275484670,696863170,696868674,5504
1360275491,696875040,10,4538,453.8,1360275484380,1360275490652,696868420,696874692,6272
1360275491,696875076,5,236,47.2,1360275477944,1360275484856,696862020,696868932,6912
1360275491,696875084,8,495,61.875,1360275479216,1360275484912,696863300,696868996,5696
1360275491,696875116,4,184,46,1360275482575,1360275484239,696866691,696868355,1664
1360275491,696875116,11,4584,416.7272727,1360275484493,1360275490573,696868609,696874689,6080
1360275502,3630165728,2,92,46,1360275476409,1360275476409,3630140137,3630140137,0
1360275506,696889948,20,18094,904.7,1360275478136,1360275490488,696862084,696874436,12352
1360275506,696889960,26,29912,1150.461538,1360275479018,1360275482858,696862978,696866818,3840
1360275506,696889984,6,994,165.6666667,1360275479252,1360275479316,696863236,696863300,64
1360275506,696889984,14,12664,904.5714286,1360275479314,1360275490386,696863298,696874370,11072
1360275506,696889984,15,15848,1056.533333,1360275479314,1360275490130,696863298,696874114,10816
1360275506,696889988,14,12454,889.5714286,1360275479440,1360275484560,696863428,696868548,5120
1360275506,696889988,7,392,56,1360275479885,1360275492045,696863873,696876033,12160
1360275506,696889988,30,37126,1237.533333,1360275479629,1360275481997,696863617,696865985,2368
1360275506,696890036,38,46502,1223.736842,1360275478110,1360275485854,696862146,696869890,7744
1360275506,696890040,2,461,230.5,1360275478427,1360275478427,696862467,696862467,0
1360275506,696890064,1,46,46,1360275478593,1360275478593,696862657,696862657,0
1360275506,696890104,8,448,56,1360275480346,1360275491290,696864450,696875394,10944
1360275506,696890108,7,672,96,1360275480725,1360275491349,696864833,696875457,10624
1360275506,3630169708,2,92,46,1360275478348,1360275478348,3630142056,3630142056,0
1360275507,3630169820,3,150,50,1360275482565,1360275484485,3630145385,3630147305,1920
1360275507,3630169844,10,560,56,1360275480621,1360275492909,3630143465,3630155753,12288
1360275507,696891000,8,458,57.25,1360275505922,1360275505922,696889922,696889922,0
1360275507,696891048,136,166884,1227.088235,1360275477329,1360275500177,696861377,696884225,22848
1360275507,696891084,3,144,48,1360275506605,1360275506605,696890689,696890689,0
1360275510,696894036,2,92,46,1360275485662,1360275485662,696869698,696869698,0
1360275510,696894072,1,46,46,1360275483644,1360275483644,696867716,696867716,0
1360275510,696894128,1,46,46,1360275485569,1360275485569,696869697,696869697,0
1360275514,696897948,8,448,56,1360275486136,1360275491896,696870084,696875844,5760
1360275514,696897960,1,865,865,1360275487147,1360275487147,696871107,696871107,0
1360275514,696897960,2,274,137,1360275487210,1360275488170,696871170,696872130,960
1360275514,696898036,9,504,56,1360275485920,1360275491680,696869956,696875716,5760
1360275515,696899016,3,138,46,1360275507700,1360275507700,696891716,696891716,0
1360275515,696899016,2,92,46,1360275507763,1360275507763,696891779,696891779,0
1360275515,696899016,3,138,46,1360275507699,1360275507699,696891715,696891715,0
1360275515,696899084,245,307796,1256.310204,1360275368048,1360275512624,696752132,696896708,144576
1360275515,696899096,2,92,46,1360275507617,1360275507617,696891713,696891713,0
1360275515,696899096,2,92,46,1360275507617,1360275507617,696891713,696891713,0
1360275518,696901980,10,11793,1179.3,1360275490134,1360275490966,696874114,696874946,832
1360275518,696901980,3,605,201.6666667,1360275491221,1360275491349,696875201,696875329,128
1360275523,696907016,6,461,76.83333333,1360275515953,1360275516081,696899969,696900097,128
1360275523,696907060,5,643,128.6,1360275521096,1360275521224,696905156,696905284,128
1360275523,696907076,5,675,135,1360275521013,1360275521205,696905089,696905281,192
1360275526,696910076,2,92,46,1360275499573,1360275499637,696883649,696883713,64
1360275530,696914108,2,92,46,1360275504596,1360275504596,696888704,696888704,0
1360275531,696915140,3,325,108.3333333,1360275521016,1360275527032,696905156,696911172,6016
1360275534,696918020,2,92,46,1360275508652,1360275508716,696892672,696892736,64
1360275534,696918100,1,46,46,1360275507808,1360275507808,696891908,696891908,0
1360275542,696925964,18,18993,1055.166667,1360275513957,1360275530533,696897921,696914497,16576
1360275542,696926004,2,92,46,1360275514685,1360275514685,696898689,696898689,0
1360275542,696926100,1,46,46,1360275514591,1360275514591,696898691,696898691,0
1360275542,696926100,2,92,46,1360275514590,1360275514590,696898690,696898690,0
1360275547,3630209848,2,92,46,1360275520232,1360275520232,3630183080,3630183080,0
1360275547,696931020,2,92,46,1360275546157,1360275546157,696930177,696930177,0
1360275547,696931064,2,92,46,1360275544066,1360275544066,696928130,696928130,0
1360275547,696931152,3,138,46,1360275543978,1360275543978,696928130,696928130,0
1360275547,696931160,3,138,46,1360275544995,1360275545059,696929155,696929219,64
1360275551,696934448,1,137,137,1360275525228,1360275525228,696908676,696908676,0
1360275555,696938408,15,4163,277.5333333,1360275527377,1360275533265,696910785,696916673,5888
1360275559,696942416,3,138,46,1360275530953,1360275530953,696914369,696914369,0
1360275562,696946364,4,192,48,1360275535895,1360275538135,696920259,696922499,2240
1360275563,696947044,4,190,47.5,1360275555543,1360275555671,696939587,696939715,128
1360275563,696947044,6,461,76.83333333,1360275559127,1360275559255,696943171,696943299,128
1360275563,696947068,2,98,49,1360275556286,1360275561534,696940354,696945602,5248
1360275563,696947068,3,144,48,1360275556286,1360275561534,696940354,696945602,5248
1360275563,696947068,3,144,48,1360275556286,1360275561534,696940354,696945602,5248
1360275563,696947072,10,2344,234.4,1360275556666,1360275562554,696940738,696946626,5888
1360275563,696947156,2,98,49,1360275556197,1360275561445,696940353,696945601,5248
1360275563,696947168,3,144,48,1360275557211,1360275562459,696941379,696946627,5248
1360275563,696947168,9,949,105.4444444,1360275557339,1360275557723,696941507,696941891,384
1360275565,3630228672,3,144,48,1360275558771,1360275564339,3630222443,3630228011,5568
1360275565,3630228704,3,144,48,1360275556371,1360275562323,3630220075,3630226027,5952
1360275571,696955028,3,144,48,1360275558244,1360275563556,696942272,696947584,5312
1360275571,696955032,2,98,49,1360275558307,1360275563555,696942339,696947587,5248
1360275571,696955036,2,98,49,1360275558685,1360275564573,696942721,696948609,5888
1360275571,696955044,28,21746,776.6428571,1360275555671,1360275568727,696939715,696952771,13056
1360275571,696955080,8,501,62.625,1360275557554,1360275563506,696941634,696947586,5952
1360275571,696955084,11,6187,562.4545455,1360275557808,1360275563504,696941892,696947588,5696
1360275571,696955084,2,98,49,1360275557806,1360275563502,696941890,696947586,5696
1360275571,696955116,2,98,49,1360275558222,1360275563470,696942338,696947586,5248
1360275571,696955116,3,144,48,1360275558222,1360275563470,696942338,696947586,5248
1360275571,696955116,4,190,47.5,1360275558286,1360275563534,696942402,696947650,5248
1360275571,696955120,11,4584,416.7272727,1360275558601,1360275564489,696942721,696948609,5888
1360275571,696955224,7,1265,180.7142857,1360275557024,1360275569568,696941248,696953792,12544
1360275571,696955232,2,98,49,1360275557658,1360275563354,696941890,696947586,5696
1360275579,696963144,135,142600,1056.296296,1360275557362,1360275571634,696941506,696955778,14272
1360275579,696963152,3,144,48,1360275569323,1360275575211,696953475,696959363,5888
1360275583,696966404,4,596,149,1360275556886,1360275556950,696940290,696940354,64
1360275583,696966404,21,16207,771.7619048,1360275556949,1360275561941,696940353,696945345,4992
1360275583,696966412,2,461,230.5,1360275557324,1360275557324,696940736,696940736,0
1360275583,696966436,5,3763,752.6,1360275558198,1360275558518,696941634,696941954,320
1360275583,696966436,6,1954,325.6666667,1360275558262,1360275558774,696941698,696942210,512
1360275583,696966492,7,529,75.57142857,1360275556860,1360275557244,696940352,696940736,384
1360275583,696966516,18,18925,1051.388889,1360275557732,1360275559076,696941248,696942592,1344
1360275583,696966520,5,948,189.6,1360275557985,1360275558049,696941505,696941569,64
1360275583,696966524,18,17279,959.9444444,1360275558175,1360275561759,696941699,696945283,3584
1360275583,696966524,15,13916,927.7333333,1360275558175,1360275561695,696941699,696945219,3520
1360275586,696970344,7,392,56,1360275557993,1360275564265,696942337,696948609,6272
1360275586,696970344,24,26977,1124.041667,1360275557993,1360275558313,696942337,696942657,320
1360275586,696970348,6,336,56,1360275558055,1360275561959,696942403,696946307,3904
1360275586,696970348,3,168,56,1360275558245,1360275561381,696942593,696945729,3136
1360275586,696970348,3,288,96,1360275558436,1360275561508,696942784,696945856,3072
1360275586,696970352,3,168,56,1360275558816,1360275562208,696943168,696946560,3392
1360275587,3630249824,3,168,56,1360275559874,1360275564162,3630222698,3630226986,4288
1360275587,696970432,6,2225,370.8333333,1360275559291,1360275559739,696942723,696943171,448
1360275587,696971076,5,643,128.6,1360275581108,1360275581236,696965184,696965312,128
1360275587,696971244,5,675,135,1360275580815,1360275581007,696965059,696965251,192
1360275595,696978424,4,546,136.5,1360275569921,1360275570113,696953345,696953537,192
1360275595,696978428,1,137,137,1360275569853,1360275569853,696953281,696953281,0
1360275595,696978516,4,546,136.5,1360275569830,1360275569958,696953346,696953474,128
1360275595,696979160,6,461,76.83333333,1360275588898,1360275589090,696973058,696973250,192
1360275595,696979160,3,325,108.3333333,1360275581025,1360275586977,696965185,696971137,5952
1360275599,696982400,3,492,164,1360275572823,1360275572951,696956223,696956351,128
1360275610,696994376,1,865,865,1360275582730,1360275582730,696967106,696967106,0
1360275611,696995108,4,190,47.5,1360275597459,1360275603539,696981567,696987647,6080
1360275611,696995180,6,461,76.83333333,1360275603919,1360275604175,696988099,696988355,256
1360275611,696995220,6,496,82.66666667,1360275600164,1360275603236,696984384,696987456,3072
1360275623,697006544,6,3445,574.1666667,1360275598027,1360275598219,696981571,696981763,192
1360275627,697010440,1,46,46,1360275600944,1360275600944,696984384,696984384,0
1360275627,697010516,4,382,95.5,1360275599779,1360275599907,696983295,696983423,128
1360275627,697010552,3,169,56.33333333,1360275601218,1360275601218,696984770,696984770,0
1360275635,697018504,15,8455,563.6666667,1360275606961,1360275618545,696990465,697002049,11584
1360275635,697019108,1384,1834224,1325.306358,1360275616596,1360275629012,697000704,697013120,12416
1360275638,697022256,6,461,76.83333333,1360275633855,1360275633983,697018111,697018239,128
1360275639,697022428,3,492,164,1360275612667,1360275612795,696996095,696996223,128
1360275639,697022516,1,137,137,1360275612515,1360275612515,696996031,696996031,0
1360275643,697026428,18,1008,56,1360275617597,1360275629565,697001025,697012993,11968
1360275643,697026428,8,768,96,1360275617787,1360275629307,697001215,697012735,11520
1360275643,697026532,9,504,56,1360275617557,1360275629077,697001089,697012609,11520
1360275643,697026536,17,952,56,1360275617807,1360275629263,697001343,697012799,11456
1360275643,697026540,8,448,56,1360275618060,1360275628748,697001600,697012288,10688
1360275643,3630306028,8,448,56,1360275618101,1360275628597,3630281129,3630291625,10496
1360275643,697027096,5,643,128.6,1360275641057,1360275641185,697025153,697025281,128
1360275643,697027268,5,675,135,1360275640822,1360275641014,697025090,697025282,192
1360275651,697035052,4,190,47.5,1360275642701,1360275642957,697026753,697027009,256
1360275651,697035052,3,144,48,1360275643533,1360275649165,697027585,697033217,5632
1360275651,697035056,2,98,49,1360275643722,1360275649162,697027778,697033218,5440
1360275651,697035056,10,2344,234.4,1360275643977,1360275649161,697028033,697033217,5184
1360275651,697035088,3,144,48,1360275644520,1360275650088,697028608,697034176,5568
1360275651,697035088,11,1047,95.18181818,1360275644775,1360275645031,697028863,697029119,256
1360275651,697035092,7,455,65,1360275644770,1360275650082,697028862,697034174,5312
1360275651,697035100,6,461,76.83333333,1360275648860,1360275649116,697032960,697033216,256
1360275651,697035100,4,371,92.75,1360275641051,1360275647195,697025151,697031295,6144
1360275651,697035132,6,1267,211.1666667,1360275646971,1360275647931,697031103,697032063,960
1360275651,697035136,2,98,49,1360275643449,1360275649081,697027585,697033217,5632
1360275651,697035140,2,98,49,1360275643443,1360275649075,697027583,697033215,5632
1360275651,697035172,4,190,47.5,1360275648787,1360275649875,697032959,697034047,1088
1360275653,3630316668,3,144,48,1360275645557,1360275650869,3630309225,3630314537,5312
1360275653,3630316688,4,190,47.5,1360275643682,1360275648930,3630307370,3630312618,5248
1360275653,3630316692,3,144,48,1360275645917,1360275651869,3630309609,3630315561,5952
1360275659,697043056,28,21492,767.5714286,1360275642886,1360275655302,697026942,697039358,12416
1360275659,697043064,10,4538,453.8,1360275646658,1360275652098,697030722,697036162,5440
1360275659,697043064,4,196,49,1360275646847,1360275652159,697030911,697036223,5312
1360275659,697043068,2,92,46,1360275647229,1360275653117,697031297,697037185,5888
1360275659,697043096,118,141735,1201.144068,1360275644642,1360275658402,697028738,697042498,13760
1360275659,697043100,2,92,46,1360275648859,1360275654043,697032959,697038143,5184
1360275659,697043108,10,4538,453.8,1360275646101,1360275652053,697030209,697036161,5952
1360275659,697043144,2,92,46,1360275647151,1360275653039,697031295,697037183,5888
1360275659,697043144,2,92,46,1360275647151,1360275653039,697031295,697037183,5888
1360275659,697043152,2,98,49,1360275647977,1360275653993,697032129,697038145,6016
1360275659,697043152,6,1232,205.3333333,1360275644392,1360275656232,697028544,697040384,11840
1360275659,697043180,2,98,49,1360275644941,1360275650957,697029121,697035137,6016
1360275659,697043180,2,98,49,1360275644939,1360275650955,697029119,697035135,6016
1360275659,697043184,2,98,49,1360275645192,1360275650952,697029376,697035136,5760
1360275659,697043188,3,144,48,1360275645509,1360275651013,697029697,697035201,5504
1360275659,697043188,2,98,49,1360275645445,1360275650949,697029633,697035137,5504
1360275659,697043188,2,98,49,1360275645636,1360275650948,697029824,697035136,5312
1360275659,697043192,3,144,48,1360275646017,1360275652033,697030209,697036225,6016
1360275661,3630324664,3,144,48,1360275648698,1360275653882,3630312362,3630317546,5184
1360275661,3630324672,3,144,48,1360275648690,1360275653874,3630312362,3630317546,5184
1360275662,697046276,928,1319306,1421.665948,1360275349098,1360275361066,696733374,696745342,11968
1360275663,697046440,3,138,46,1360275636913,1360275636977,697020353,697020417,64
1360275667,697051200,17,17881,1051.823529,1360275649591,1360275665975,697033791,697050175,16384
1360275671,697054440,2,461,230.5,1360275644464,1360275644528,697027904,697027968,64
1360275671,697054452,16,15888,993,1360275645603,1360275648483,697029055,697031935,2880
1360275671,697054452,14,12738,909.8571429,1360275645603,1360275648611,697029055,697032063,3008
1360275671,697054452,18,12048,669.3333333,1360275645667,1360275648675,697029119,697032127,3008
1360275671,697054452,13,12527,963.6153846,1360275645603,1360275648419,697029055,697031871,2816
1360275671,697054456,23,26931,1170.913043,1360275645920,1360275646304,697029376,697029760,384
1360275671,697054456,4,224,56,1360275646047,1360275656927,697029503,697040383,10880
1360275671,697054480,33,43369,1314.212121,1360275646086,1360275646854,697029566,697030334,768
1360275671,697054480,6,336,56,1360275646343,1360275654791,697029823,697038271,8448
1360275671,697054484,6,4953,825.5,1360275646723,1360275647043,697030207,697030527,320
1360275671,3630333956,4,224,56,1360275646015,1360275658943,3630308971,3630321899,12928
1360275671,697054528,13,11806,908.1538462,1360275645018,1360275646042,697028546,697029570,1024
1360275671,697054528,4,883,220.75,1360275645271,1360275645271,697028799,697028799,0
1360275671,697054560,4,1821,455.25,1360275645496,1360275645752,697029056,697029312,256
1360275671,697054560,14,14175,1012.5,1360275645496,1360275648184,697029056,697031744,2688
1360275671,697054560,6,3074,512.3333333,1360275645623,1360275645815,697029183,697029375,192
1360275671,697054560,8,3874,484.25,1360275645622,1360275646070,697029182,697029630,448
1360275671,697054568,32,41006,1281.4375,1360275646065,1360275646513,697029633,697030081,448
1360275671,697054572,2,123,61.5,1360275646254,1360275646318,697029826,697029890,64
1360275671,697054572,6,336,56,1360275646573,1360275655789,697030145,697039361,9216
1360275671,3630334000,6,1865,310.8333333,1360275646226,1360275646418,3630309226,3630309418,192
1360275671,3630334004,8,1624,203,1360275646542,1360275647502,3630309546,3630310506,960
1360275674,697058292,3,168,56,1360275645979,1360275653275,697030271,697037567,7296
1360275675,697058456,5,2936,587.2,1360275648609,1360275649505,697032065,697032961,896
1360275675,697058460,7,3492,498.8571429,1360275648989,1360275650461,697032449,697033921,1472
1360275675,697058460,17,15017,883.3529412,1360275648669,1360275649309,697032129,697032769,640
1360275675,697058472,9,4308,478.6666667,1360275650384,1360275650640,697033856,697034112,256
1360275675,697058504,3,288,96,1360275646831,1360275654639,697030335,697038143,7808
1360275675,697058544,8,2971,371.375,1360275648520,1360275649288,697032064,697032832,768
1360275675,697058552,4,235,58.75,1360275649406,1360275649534,697032958,697033086,128
1360275675,3630338008,4,792,198,1360275648968,1360275649096,3630311976,3630312104,128
1360275679,697062596,1,137,137,1360275653973,1360275653973,697037569,697037569,0
1360275683,697067080,6,461,76.83333333,1360275678640,1360275678768,697062720,697062848,128
1360275691,697074472,3,138,46,1360275665871,1360275665935,697049343,697049407,64
1360275691,697075172,2,98,49,1360275679316,1360275685012,697063488,697069184,5696
1360275699,697082592,2,92,46,1360275672535,1360275672599,697056127,697056191,64
1360275699,697083088,9,516,57.33333333,1360275691113,1360275691241,697075201,697075329,128
1360275703,697086804,2,92,46,1360275675331,1360275675395,697059135,697059199,64
1360275707,697090744,16,4618,288.625,1360275679231,1360275683583,697062975,697067327,4352
1360275707,697090932,1,46,46,1360275682115,1360275682115,697066047,697066047,0
1360275707,697091088,5,261,52.2,1360275704296,1360275706024,697088384,697090112,1728
1360275707,697091112,5,675,135,1360275700944,1360275701200,697085056,697085312,256
1360275707,697091192,5,643,128.6,1360275700993,1360275701121,697085185,697085313,128
1360275711,697094800,1,46,46,1360275685382,1360275685382,697069182,697069182,0
1360275711,697094904,2,92,46,1360275685278,1360275685278,697069182,697069182,0
1360275715,697099120,179,128371,717.1564246,1360274885959,1360275713095,696270079,697097215,827136
1360275715,697099120,3,325,108.3333333,1360275701062,1360275707014,697085182,697091134,5952
1360275723,697106716,1,137,137,1360275695066,1360275695066,697078782,697078782,0
1360275731,697115168,6,461,76.83333333,1360275723543,1360275723671,697107711,697107839,128
1360275735,697118884,3,138,46,1360275709042,1360275709106,697092926,697092990,64
1360275743,697126776,2,92,46,1360275715294,1360275715358,697099070,697099134,64
1360275751,697134848,3,492,164,1360275723287,1360275723415,697107135,697107263,128
1360275755,697139228,6,461,76.83333333,1360275753498,1360275753882,697137726,697138110,384
1360275759,697142868,1,137,137,1360275734083,1360275734083,697117951,697117951,0
1360275763,697147112,220,226968,1031.672727,1360275409677,1360275762637,696793789,697146749,352960
1360275763,697147128,4,205,51.25,1360275760639,1360275760639,697144767,697144767,0
1360275763,697147160,5,643,128.6,1360275760992,1360275761184,697145152,697145344,192
1360275763,697147276,5,675,135,1360275760810,1360275761002,697145086,697145278,192
1360275771,697155244,4,184,46,1360275763531,1360275766347,697147775,697150591,2816
1360275771,697155244,4,190,47.5,1360275763531,1360275763659,697147775,697147903,128
1360275771,697155244,2,92,46,1360275763531,1360275763531,697147775,697147775,0
1360275771,697155320,4,371,92.75,1360275760832,1360275766464,697145152,697150784,5632
1360275771,697155332,2,92,46,1360275763508,1360275763508,697147840,697147840,0
1360275771,697155332,3,138,46,1360275763443,1360275763507,697147775,697147839,64
1360275771,697155364,6,461,76.83333333,1360275768339,1360275768467,697152703,697152831,128
1360275783,697167040,1,46,46,1360275755157,1360275755157,697139197,697139197,0
1360275787,3630450192,2,92,46,1360275762961,1360275762961,3630426153,3630426153,0
1360275787,3630450320,2,92,46,1360275761810,1360275761810,3630425130,3630425130,0
1360275787,697170940,2,92,46,1360275759801,1360275759801,697143741,697143741,0
1360275787,697170972,1,46,46,1360275760794,1360275760794,697144766,697144766,0
1360275787,697170972,1,46,46,1360275760793,1360275760793,697144765,697144765,0
1360275787,697170984,1,46,46,1360275761743,1360275761743,697145727,697145727,0
1360275787,697170984,1,46,46,1360275761743,1360275761743,697145727,697145727,0
1360275787,697171004,2,92,46,1360275761722,1360275761786,697145726,697145790,64
1360275787,697171060,2,92,46,1360275760705,1360275760705,697144765,697144765,0
1360275787,697171064,1,46,46,1360275760704,1360275760704,697144768,697144768,0
1360275787,697171096,2,92,46,1360275761631,1360275761695,697145727,697145791,64
1360275787,697171320,6,461,76.83333333,1360275783359,1360275783551,697167679,697167871,192
1360275791,3630454268,2,92,46,1360275764871,1360275764871,3630428139,3630428139,0
1360275791,697174904,3,492,164,1360275763424,1360275763552,697147328,697147456,128
1360275791,697174936,1,46,46,1360275764797,1360275764797,697148733,697148733,0
1360275791,697174940,1,46,46,1360275764792,1360275764792,697148732,697148732,0
1360275791,697175020,2,92,46,1360275764715,1360275764779,697148735,697148799,64
1360275803,697187040,1,137,137,1360275777623,1360275777623,697161663,697161663,0
1360275803,697187320,15,14228,948.5333333,1360275783741,1360275800445,697168061,697184765,16704
1360275819,697203312,6,461,76.83333333,1360275813381,1360275813573,697197693,697197885,192
1360275827,697211304,3,325,108.3333333,1360275820877,1360275826829,697205181,697211133,5952
1360275827,697211308,5,643,128.6,1360275820875,1360275821003,697205183,697205311,128
1360275827,697211384,5,675,135,1360275820671,1360275820927,697205055,697205311,256
1360275831,697214928,3,492,164,1360275803208,1360275803336,697187136,697187264,128
1360275835,697219312,8,2705,338.125,1360275813700,1360275829828,697198012,697214140,16128
1360275839,697223072,1,137,137,1360275812214,1360275812214,697196286,697196286,0
1360275843,697227384,3,138,46,1360275841021,1360275841981,697225405,697226365,960
1360275851,697235288,14,6368,454.8571429,1360275843167,1360275850719,697227455,697235007,7552
1360275851,697235288,3,150,50,1360275843230,1360275849374,697227518,697233662,6144
1360275851,697235288,2,98,49,1360275843229,1360275849373,697227517,697233661,6144
1360275851,697235288,16,6528,408,1360275843356,1360275850844,697227644,697235132,7488
1360275851,697235292,3,150,50,1360275843483,1360275849371,697227775,697233663,5888
1360275851,697235292,3,150,50,1360275843483,1360275849371,697227775,697233663,5888
1360275851,697235292,2,98,49,1360275843547,1360275849371,697227839,697233663,5824
1360275851,697235292,2,98,49,1360275843546,1360275849370,697227838,697233662,5824
1360275851,697235292,4,196,49,1360275843610,1360275849434,697227902,697233726,5824
1360275851,697235296,3,150,50,1360275844054,1360275850454,697228350,697234750,6400
1360275851,697235296,4,202,50.5,1360275844054,1360275850454,697228350,697234750,6400
1360275851,697235296,3,144,48,1360275839509,1360275848405,697223805,697232701,8896
1360275851,697235296,3,150,50,1360275844117,1360275850389,697228413,697234685,6272
1360275851,697235296,3,144,48,1360275844117,1360275850389,697228413,697234685,6272
1360275851,697235296,4,196,49,1360275844117,1360275850837,697228413,697235133,6720
1360275851,697235296,3,144,48,1360275844117,1360275850389,697228413,697234685,6272
1360275851,697235300,2,98,49,1360275844367,1360275850383,697228667,697234683,6016
1360275851,697235300,2,98,49,1360275844371,1360275850387,697228671,697234687,6016
1360275851,697235336,8,589,73.625,1360275841069,1360275847789,697225405,697232125,6720
1360275851,697235340,3,144,48,1360275841961,1360275848361,697226301,697232701,6400
1360275851,697235364,4,196,49,1360275838482,1360275848338,697222846,697232702,9856
1360275851,697235364,4,190,47.5,1360275842896,1360275849168,697227260,697233532,6272
1360275851,697235368,3,150,50,1360275843148,1360275849292,697227516,697233660,6144
1360275851,697235368,3,150,50,1360275843148,1360275849292,697227516,697233660,6144
1360275851,697235368,5,242,48.4,1360275843147,1360275850059,697227515,697234427,6912
1360275851,697235368,4,196,49,1360275843147,1360275849291,697227515,697233659,6144
1360275851,697235372,14,6399,457.0714286,1360275843402,1360275849930,697227774,697234302,6528
1360275851,697235372,15,6445,429.6666667,1360275843402,1360275849994,697227774,697234366,6592
1360275851,697235372,4,196,49,1360275843465,1360275849993,697227837,697234365,6528
1360275851,697235372,2,98,49,1360275843529,1360275850377,697227901,697234749,6848
1360275851,697235376,2,98,49,1360275843715,1360275850371,697228091,697234747,6656
1360275851,697235376,3,144,48,1360275844038,1360275850310,697228414,697234686,6272
1360275851,697235376,4,190,47.5,1360275839620,1360275850628,697223996,697235004,11008
1360275852,697235420,9,456,50.66666667,1360275846531,1360275851715,697229951,697235135,5184
1360275852,697235444,4,196,49,1360275842536,1360275849256,697225980,697232700,6720
1360275852,697235448,3,144,48,1360275843110,1360275849254,697226558,697232702,6144
1360275852,697235448,6,282,47,1360275843301,1360275851621,697226749,697235069,8320
1360275853,3630516728,6,288,48,1360275842875,1360275852347,3630506603,3630516075,9472
1360275853,3630516728,3,150,50,1360275843769,1360275852921,3630507497,3630516649,9152
1360275853,3630516732,3,144,48,1360275844598,1360275852278,3630508330,3630516010,7680
1360275853,3630516736,5,242,48.4,1360275842355,1360275849779,3630506091,3630513515,7424
1360275853,3630516740,6,288,48,1360275842864,1360275852336,3630506604,3630516076,9472
1360275853,3630516756,3,150,50,1360275842336,1360275849056,3630506092,3630512812,6720
1360275860,697243556,2,92,46,1360275851961,1360275854073,697235517,697237629,2112
1360275860,697243560,3,138,46,1360275852342,1360275854646,697235902,697238206,2304
1360275860,697243564,17,4185,246.1764706,1360275844786,1360275854258,697228350,697237822,9472
1360275860,697243564,2,92,46,1360275852849,1360275854833,697236413,697238397,1984
1360275860,697243564,3,138,46,1360275852849,1360275854833,697236413,697238397,1984
1360275860,697243564,4,202,50.5,1360275848305,1360275857137,697231869,697240701,8832
1360275860,697243564,3,150,50,1360275848496,1360275857136,697232060,697240700,8640
1360275860,697243568,3,138,46,1360275853166,1360275854894,697236734,697238462,1728
1360275860,697243568,15,907,60.46666667,1360275848686,1360275858606,697232254,697242174,9920
1360275860,697243596,4,202,50.5,1360275846290,1360275857106,697229886,697240702,10816
1360275860,697243596,7,358,51.14285714,1360275846225,1360275857105,697229821,697240701,10880
1360275860,697243596,7,358,51.14285714,1360275846289,1360275857105,697229885,697240701,10816
1360275860,697243596,7,358,51.14285714,1360275846289,1360275857105,697229885,697240701,10816
1360275860,697243596,7,358,51.14285714,1360275846417,1360275857105,697230013,697240701,10688
1360275860,697243596,4,202,50.5,1360275846289,1360275857105,697229885,697240701,10816
1360275860,697243596,7,358,51.14285714,1360275846416,1360275857104,697230012,697240700,10688
1360275860,697243596,4,202,50.5,1360275846480,1360275857104,697230076,697240700,10624
1360275860,697243600,5,504,100.8,1360275854670,1360275855630,697238270,697239230,960
1360275860,697243600,4,467,116.75,1360275854734,1360275855630,697238334,697239230,896
1360275860,697243604,5,254,50.8,1360275850312,1360275859080,697233916,697242684,8768
1360275860,697243608,6,300,50,1360275850502,1360275859142,697234110,697242750,8640
1360275860,697243608,5,254,50.8,1360275850565,1360275859077,697234173,697242685,8512
1360275860,697243636,13,3545,272.6923077,1360275855655,1360275858599,697239291,697242235,2944
1360275860,697243640,4,202,50.5,1360275847974,1360275857062,697231614,697240702,9088
1360275860,697243640,5,248,49.6,1360275844708,1360275854756,697228348,697238396,10048
1360275860,697243644,3,138,46,1360275852770,1360275854754,697236414,697238398,1984
1360275860,697243644,4,202,50.5,1360275848226,1360275857058,697231870,697240702,8832
1360275860,697243648,13,3942,303.2307692,1360275845279,1360275853983,697228927,697237631,8704
1360275860,697243672,7,358,51.14285714,1360275846214,1360275857030,697229886,697240702,10816
1360275860,697243672,7,358,51.14285714,1360275846214,1360275857030,697229886,697240702,10816
1360275860,697243672,5,248,49.6,1360275846214,1360275858054,697229886,697241726,11840
1360275860,697243672,7,352,50.28571429,1360275846149,1360275857221,697229821,697240893,11072
1360275860,697243672,9,456,50.66666667,1360275846405,1360275851845,697230077,697235517,5440
1360275860,697243672,8,410,51.25,1360275846276,1360275851780,697229948,697235452,5504
1360275860,697243676,7,358,51.14285714,1360275846339,1360275857027,697230015,697240703,10688
1360275860,697243676,4,202,50.5,1360275846403,1360275857027,697230079,697240703,10624
1360275860,697243676,4,202,50.5,1360275846403,1360275857027,697230079,697240703,10624
1360275860,697243676,6,300,50,1360275846403,1360275858051,697230079,697241727,11648
1360275860,697243676,11,854,77.63636364,1360275846530,1360275858050,697230206,697241726,11520
1360275860,697243676,11,854,77.63636364,1360275846530,1360275858050,697230206,697241726,11520
1360275860,697243680,6,300,50,1360275850238,1360275859006,697233918,697242686,8768
1360275860,697243680,6,300,50,1360275850302,1360275859006,697233982,697242686,8704
1360275860,697243680,5,254,50.8,1360275850428,1360275859004,697234108,697242684,8576
1360275861,3630524720,2,92,46,1360275852996,1360275854084,3630516716,3630517804,1088
1360275861,3630524724,3,144,48,1360275844032,1360275854016,3630507756,3630517740,9984
1360275861,3630524724,2,98,49,1360275853950,1360275860414,3630517674,3630524138,6464
1360275861,3630524728,3,150,50,1360275854205,1360275860797,3630517933,3630524525,6592
1360275861,3630524728,3,150,50,1360275854205,1360275860797,3630517933,3630524525,6592
1360275861,3630524728,3,150,50,1360275854205,1360275860797,3630517933,3630524525,6592
1360275861,3630524732,6,294,49,1360275845367,1360275857527,3630509099,3630521259,12160
1360275861,3630524732,5,248,49.6,1360275845367,1360275856503,3630509099,3630520235,11136
1360275861,3630524744,2,98,49,1360275853930,1360275860394,3630517674,3630524138,6464
1360275861,3630524748,3,150,50,1360275854185,1360275860777,3630517933,3630524525,6592
1360275863,697247240,23,1288,56,1360275838606,1360275862478,697222846,697246718,23872
1360275863,697247292,45,2520,56,1360275837402,1360275862618,697221694,697246910,25216
1360275863,697247296,21,1176,56,1360275837590,1360275861654,697221886,697245950,24064
1360275863,697247328,33,22457,680.5151515,1360275838581,1360275858549,697222909,697242877,19968
1360275864,697247404,4,1118,279.5,1360275839186,1360275843602,697222590,697227006,4416
1360275867,3630530228,21,1176,56,1360275839085,1360275866029,3630502313,3630529257,26944
1360275867,3630530304,4,832,208,1360275842337,1360275843425,3630505641,3630506729,1088
1360275867,3630530308,6,3111,518.5,1360275842336,1360275844128,3630505644,3630507436,1792
1360275867,697251332,29,22219,766.1724138,1360275839408,1360275858928,697223740,697243260,19520
1360275867,697251368,10,1747,174.7,1360275840395,1360275842699,697224763,697227067,2304
1360275867,697251368,13,4245,326.5384615,1360275840653,1360275842893,697225021,697227261,2240
1360275868,697251416,30,18408,613.6,1360275843587,1360275859651,697227003,697243067,16064
1360275868,697251420,45,35993,799.8444444,1360275839745,1360275859393,697223165,697242813,19648
1360275868,697251444,24,2304,96,1360275840103,1360275866791,697223547,697250235,26688
1360275868,697251448,49,2744,56,1360275840229,1360275867621,697223677,697251069,27392
1360275868,697251568,25,14162,566.48,1360275841388,1360275863148,697224956,697246716,21760
1360275868,697251580,9,1298,144.2222222,1360275842145,1360275844001,697225725,697227581,1856
1360275868,697251612,15,4326,288.4,1360275843011,1360275864643,697226623,697248255,21632
1360275868,697251664,10,2999,299.9,1360275856078,1360275866318,697239742,697249982,10240
1360275868,697251664,4,184,46,1360275856332,1360275864716,697239996,697248380,8384
1360275868,697251664,8,2907,363.375,1360275856331,1360275865931,697239995,697249595,9600
1360275868,697251668,7,513,73.28571429,1360275864970,1360275865994,697248638,697249662,1024
1360275868,697251668,2,98,49,1360275853193,1360275860041,697236861,697243709,6848
1360275868,697251688,3,144,48,1360275853430,1360275862390,697237118,697246078,8960
1360275868,697251688,2,98,49,1360275865396,1360275867060,697249084,697250748,1664
1360275868,697251696,7,324,46.28571429,1360275854573,1360275864941,697238269,697248637,10368
1360275868,697251700,7,328,46.85714286,1360275854634,1360275863914,697238334,697247614,9280
1360275868,697251700,9,420,46.66666667,1360275854889,1360275864425,697238589,697248125,9536
1360275868,697251704,12,10659,888.25,1360275858535,1360275865063,697242239,697248767,6528
1360275868,697251704,4,184,46,1360275858535,1360275864871,697242239,697248575,6336
1360275868,697251740,9,2953,328.1111111,1360275855682,1360275865794,697239422,697249534,10112
1360275868,697251744,3,138,46,1360275855996,1360275864060,697239740,697247804,8064
1360275868,697251744,10,4544,454.4,1360275856059,1360275863995,697239803,697247739,7936
1360275868,697251748,3,138,46,1360275856249,1360275864057,697239997,697247805,7808
1360275868,697251748,10,4544,454.4,1360275856312,1360275863864,697240060,697247612,7552
1360275868,697251772,2,98,49,1360275865057,1360275866465,697248829,697250237,1408
1360275868,697251772,2,98,49,1360275853216,1360275859936,697236988,697243708,6720
1360275868,697251776,123,160301,1303.260163,1360275838108,1360275866588,697221884,697250364,28480
1360275868,697251784,13,834,64.15384615,1360275854359,1360275863447,697238143,697247231,9088
1360275868,697251784,7,324,46.28571429,1360275854549,1360275864853,697238333,697248637,10304
1360275868,697251784,6,1624,270.6666667,1360275854549,1360275867221,697238333,697251005,12672
1360275868,697251784,8,370,46.25,1360275854804,1360275864852,697238588,697248636,10048
1360275868,697251784,8,370,46.25,1360275854804,1360275864852,697238588,697248636,10048
1360275868,697251784,8,374,46.75,1360275854804,1360275863828,697238588,697247612,9024
1360275868,697251784,8,370,46.25,1360275854803,1360275864851,697238587,697248635,10048
1360275868,697251788,8,370,46.25,1360275854803,1360275864851,697238591,697248639,10048
1360275869,3630532724,3,144,48,1360275858815,1360275864383,3630522539,3630528107,5568
1360275869,3630532728,4,196,49,1360275861372,1360275863996,3630525100,3630527724,2624
1360275869,3630532728,4,196,49,1360275861372,1360275863996,3630525100,3630527724,2624
1360275869,3630532748,4,196,49,1360275861351,1360275863975,3630525099,3630527723,2624
1360275869,3630532748,4,196,49,1360275861350,1360275863974,3630525098,3630527722,2624
1360275871,3630534240,10,8504,850.4,1360275844004,1360275851236,3630507244,3630514476,7232
1360275871,697255244,1,137,137,1360275843337,1360275843337,697227581,697227581,0
1360275871,697255248,12,885,73.75,1360275843589,1360275852037,697227837,697236285,8448
1360275871,697255248,7,6078,868.2857143,1360275843589,1360275847429,697227837,697231677,3840
1360275871,697255248,9,6864,762.6666667,1360275843589,1360275846725,697227837,697230973,3136
1360275871,697255248,10,7184,718.4,1360275843653,1360275848069,697227901,697232317,4416
1360275871,697255276,18,15235,846.3888889,1360275844393,1360275853673,697228669,697237949,9280
1360275871,697255280,9,4820,535.5555556,1360275844771,1360275851171,697229051,697235451,6400
1360275871,697255288,16,11969,748.0625,1360275845595,1360275854683,697229883,697238971,9088
1360275871,697255328,5,611,122.2,1360275843191,1360275844087,697227519,697228415,896
1360275871,697255328,4,498,124.5,1360275843190,1360275844342,697227518,697228670,1152
1360275871,697255328,12,877,73.08333333,1360275843190,1360275849078,697227518,697233406,5888
1360275871,697255328,19,4743,249.6315789,1360275843189,1360275859893,697227517,697244221,16704
1360275871,697255328,7,4610,658.5714286,1360275843253,1360275845557,697227581,697229885,2304
1360275871,697255348,12,8268,689,1360275843489,1360275849377,697227837,697233725,5888
1360275871,697255348,5,2739,547.8,1360275843487,1360275845791,697227835,697230139,2304
1360275871,697255352,8,6044,755.5,1360275843551,1360275850719,697227903,697235071,7168
1360275871,697255364,24,18840,785,1360275844689,1360275852433,697229053,697236797,7744
1360275876,697259576,3,138,46,1360275868134,1360275869158,697251710,697252734,1024
1360275877,3630540720,4,202,50.5,1360275864323,1360275871363,3630528043,3630535083,7040
1360275879,3630542248,5,2316,463.2,1360275854426,1360275855066,3630517674,3630518314,640
1360275879,3630542280,3,947,315.6666667,1360275854395,1360275854907,3630517675,3630518187,512
1360275879,697263240,1,46,46,1360275851085,1360275851085,697235325,697235325,0
1360275879,697263248,1,46,46,1360275851398,1360275851398,697235646,697235646,0
1360275879,697263292,12,1704,142,1360275853593,1360275854681,697237885,697238973,1088
1360275879,697263332,1,46,46,1360275851122,1360275851122,697235454,697235454,0
1360275879,697263368,1,52,52,1360275852301,1360275852301,697236669,697236669,0
1360275879,697263368,28,27161,970.0357143,1360275852428,1360275875020,697236796,697259388,22592
1360275880,697263396,1,46,46,1360275853976,1360275853976,697237372,697237372,0
1360275884,697267392,9,4166,462.8888889,1360275855902,1360275883614,697239294,697267006,27712
1360275884,697267444,15,12139,809.2666667,1360275858664,1360275859112,697242108,697242556,448
1360275884,697267560,15,11021,734.7333333,1360275858551,1360275858999,697242111,697242559,448
1360275884,697267608,6,461,76.83333333,1360275880068,1360275880260,697263676,697263868,192
1360275884,697267696,1543,2151461,1394.336358,1360275837676,1360275883436,697221372,697267132,45760
1360275887,3630550288,35,43252,1235.771429,1360275859250,1360275864434,3630522538,3630527722,5184
1360275887,3630550292,3,150,50,1360275861680,1360275864112,3630524972,3630527404,2432
1360275887,3630550292,2,104,52,1360275861680,1360275863280,3630524972,3630526572,1600
1360275887,697271384,18,1008,56,1360275862779,1360275883579,697247163,697267963,20800
1360275892,697275388,36,2016,56,1360275863904,1360275890272,697247292,697273660,26368
1360275892,697275392,19,1064,56,1360275864156,1360275885084,697247548,697268476,20928
1360275892,697275640,6,695,115.8333333,1360275881764,1360275884900,697265404,697268540,3136
1360275892,697275688,2,279,139.5,1360275884853,1360275890037,697268541,697273725,5184
1360275892,697275696,6,721,120.1666667,1360275881389,1360275884845,697265085,697268541,3456
1360275892,697275696,4,377,94.25,1360275881452,1360275890028,697265148,697273724,8576
1360275892,697275696,3,138,46,1360275881643,1360275890027,697265339,697273723,8384
1360275895,3630558256,16,896,56,1360275866964,1360275889428,3630530220,3630552684,22464
1360275895,697279344,15,1440,96,1360275867622,1360275883814,697251966,697268158,16192
1360275895,697279344,26,1456,56,1360275867875,1360275884067,697252219,697268411,16192
1360275895,697279368,2,92,46,1360275868235,1360275868235,697252603,697252603,0
1360275896,697279524,2,92,46,1360275869082,1360275869082,697252606,697252606,0
1360275896,697279524,2,92,46,1360275869015,1360275869015,697252539,697252539,0
1360275900,697283472,3,138,46,1360275873869,1360275874317,697257341,697257789,448
1360275900,697283560,2,92,46,1360275873782,1360275874230,697257342,697257790,448
1360275900,697283604,3,138,46,1360275874761,1360275874761,697258365,697258365,0
1360275900,697283792,6,461,76.83333333,1360275894860,1360275894988,697278652,697278780,128
1360275903,697287364,3,138,46,1360275875983,1360275877391,697260347,697261755,1408
1360275904,697287520,2,92,46,1360275875870,1360275875870,697259390,697259390,0
1360275904,697287520,3,138,46,1360275875869,1360275875869,697259389,697259389,0
1360275904,697287588,3,138,46,1360275878744,1360275879256,697262332,697262844,512
1360275907,697291356,1,137,137,1360275879384,1360275879384,697263740,697263740,0
1360275908,697291636,42,46854,1115.571429,1360275904810,1360275905962,697288446,697289598,1152
1360275908,697291636,32,30227,944.59375,1360275904937,1360275906793,697288573,697290429,1856
1360275908,697291712,5,3081,616.2,1360275904923,1360275905371,697288635,697289083,448
1360275911,697295388,2,92,46,1360275884023,1360275884087,697268411,697268475,64
1360275912,697295488,4,3092,773,1360275884925,1360275885053,697268413,697268541,128
1360275916,697299492,3,169,56.33333333,1360275889848,1360275889848,697273340,697273340,0
1360275916,697299616,3,169,56.33333333,1360275890749,1360275890749,697274365,697274365,0
1360275916,697299740,3,144,48,1360275903999,1360275909759,697287739,697293499,5760
1360275916,697299744,3,144,48,1360275903930,1360275909690,697287674,697293434,5760
1360275916,697299748,3,144,48,1360275904504,1360275909688,697288252,697293436,5184
1360275916,697299748,56,59073,1054.875,1360275904759,1360275907895,697288507,697291643,3136
1360275916,697299752,3,144,48,1360275904885,1360275910773,697288637,697294525,5888
1360275916,697299752,2,98,49,1360275904948,1360275910708,697288700,697294460,5760
1360275916,697299752,2,94,47,1360275905076,1360275910708,697288828,697294460,5632
1360275916,697299776,3,144,48,1360275905180,1360275910876,697288956,697294652,5696
1360275916,697299776,2,94,47,1360275905116,1360275910684,697288892,697294460,5568
1360275916,697299776,2,98,49,1360275905179,1360275910683,697288955,697294459,5504
1360275916,697299792,3,144,48,1360275907274,1360275912650,697291066,697296442,5376
1360275916,697299816,5,648,129.6,1360275903602,1360275915058,697287418,697298874,11456
1360275916,697299820,3,144,48,1360275903921,1360275909617,697287741,697293437,5696
1360275916,697299828,46,56210,1221.956522,1360275904615,1360275907751,697288443,697291579,3136
1360275916,697299832,2,98,49,1360275904869,1360275910693,697288701,697294525,5824
1360275916,697299856,2,98,49,1360275905034,1360275910602,697288890,697294458,5568
1360275916,697299860,6,461,76.83333333,1360275909770,1360275909962,697293630,697293822,192
1360275916,697299860,2,98,49,1360275905226,1360275910538,697289086,697294398,5312
1360275916,697299864,5,254,50.8,1360275905477,1360275913797,697289341,697297661,8320
1360275917,3630580724,7,346,49.42857143,1360275905023,1360275914687,3630568747,3630578411,9664
1360275917,3630580724,8,392,49,1360275905215,1360275914559,3630568939,3630578283,9344
1360275917,3630580732,8,392,49,1360275905014,1360275914678,3630568746,3630578410,9664
1360275924,697307680,5,1455,291,1360275904444,1360275919804,697288124,697303484,15360
1360275928,697311460,3,492,164,1360275900119,1360275900247,697283579,697283707,128
1360275931,3630594268,12,672,56,1360275905925,1360275925765,3630569193,3630589033,19840
1360275931,3630594288,4,432,108,1360275903537,1360275903601,3630566825,3630566889,64
1360275931,3630594312,21,21879,1041.857143,1360275905242,1360275906714,3630568554,3630570026,1472
1360275931,3630594312,40,38481,962.025,1360275905242,1360275907866,3630568554,3630571178,2624
1360275931,697315380,7,620,88.57142857,1360275903039,1360275925055,697287419,697309435,22016
1360275931,697315384,8,666,83.25,1360275903034,1360275925370,697287418,697309754,22336
1360275931,697315392,4,1172,293,1360275903926,1360275904118,697288318,697288510,192
1360275932,697315416,14,784,56,1360275905477,1360275928453,697288893,697311869,22976
1360275932,697315416,14,1344,96,1360275905603,1360275929539,697289019,697312955,23936
1360275932,697315420,26,1456,56,1360275905791,1360275926335,697289211,697309755,20544
1360275932,697315428,13,728,56,1360275906233,1360275925113,697289661,697308541,18880
1360275932,697315472,2,461,230.5,1360275903949,1360275903949,697287421,697287421,0
1360275932,697315472,12,7472,622.6666667,1360275903948,1360275908236,697287420,697291708,4288
1360275932,697315560,24,1344,56,1360275905202,1360275926258,697288762,697309818,21056
1360275932,697315676,6,461,76.83333333,1360275924992,1360275926208,697308668,697309884,1216
1360275932,697315684,1460,1887500,1292.808219,1360275905145,1360275926137,697288829,697309821,20992
1360275932,697315748,4,190,47.5,1360275928182,1360275929270,697311930,697313018,1088
1360275936,697319464,1,137,137,1360275910997,1360275910997,697294461,697294461,0
1360275948,697331692,4,371,92.75,1360275941487,1360275947503,697325179,697331195,6016
1360275948,697331768,5,643,128.6,1360275941411,1360275941539,697325179,697325307,128
1360275948,697331768,5,675,135,1360275941283,1360275941539,697325051,697325307,256
1360275956,697339688,3,144,48,1360275944116,1360275949428,697327804,697333116,5312
1360275956,697339768,2,98,49,1360275944035,1360275949347,697327803,697333115,5312
1360275956,697339820,6,461,76.83333333,1360275954863,1360275954991,697338683,697338811,128
1360275960,697343584,2,123,61.5,1360275934746,1360275934746,697318330,697318330,0
1360275964,697347428,2,123,61.5,1360275935863,1360275935927,697319291,697319355,64
1360275964,697347684,3,492,164,1360275939446,1360275939574,697323130,697323258,128
1360275964,697347768,3,138,46,1360275959394,1360275959458,697343162,697343226,64
1360275964,697347852,2,92,46,1360275959311,1360275959311,697343163,697343163,0
1360275964,697347856,3,138,46,1360275959308,1360275959372,697343164,697343228,64
1360275968,697351520,1,137,137,1360275943834,1360275943834,697327354,697327354,0
1360275968,697351560,1,46,46,1360275940917,1360275940917,697324477,697324477,0
1360275972,697355508,7,1447,206.7142857,1360275943846,1360275943974,697327354,697327482,128
1360275972,697355516,6,3495,582.5,1360275944289,1360275944481,697327805,697327997,192
1360275972,697355744,6,461,76.83333333,1360275969978,1360275970170,697353722,697353914,192
1360275972,697355748,4,190,47.5,1360275970105,1360275971193,697353853,697354941,1088
1360275972,697355828,4,205,51.25,1360275970278,1360275970278,697354106,697354106,0
1360275980,697363724,10,995,99.5,1360275971727,1360275972559,697355451,697356283,832
1360275980,697363732,2,98,49,1360275972421,1360275978373,697356153,697362105,5952
1360275980,697363732,2,98,49,1360275972425,1360275978377,697356157,697362109,5952
1360275980,697363732,8,501,62.625,1360275972489,1360275979081,697356221,697362813,6592
1360275980,697363732,4,190,47.5,1360275972552,1360275978376,697356284,697362108,5824
1360275980,697363732,2,98,49,1360275972616,1360275978376,697356348,697362108,5760
1360275980,697363736,11,4584,416.7272727,1360275972805,1360275978373,697356541,697362109,5568
1360275980,697363736,9,590,65.55555556,1360275973058,1360275979394,697356794,697363130,6336
1360275980,697363764,3,144,48,1360275971497,1360275977385,697355261,697361149,5888
1360275980,697363772,6,461,76.83333333,1360275974686,1360275974942,697358458,697358714,256
1360275980,697363776,2,98,49,1360275970460,1360275976348,697354236,697360124,5888
1360275980,697363884,10,2344,234.4,1360275970801,1360275976241,697354685,697360125,5440
1360275980,697363896,10,627,62.7,1360275971557,1360275977317,697355453,697361213,5760
1360275980,697363900,3,144,48,1360275972257,1360275978209,697356157,697362109,5952
1360275980,697363900,2,98,49,1360275972256,1360275978208,697356156,697362108,5952
1360275980,697363900,2,98,49,1360275972384,1360275978208,697356284,697362108,5824
1360275980,697363900,2,98,49,1360275972383,1360275978207,697356283,697362107,5824
1360275980,697363900,3,144,48,1360275972447,1360275978207,697356347,697362107,5760
1360275980,697363900,3,144,48,1360275972447,1360275978207,697356347,697362107,5760
1360275980,697363904,3,144,48,1360275972573,1360275978205,697356477,697362109,5632
1360275980,697363968,3,144,48,1360275970269,1360275976157,697354237,697360125,5888
1360275980,697363968,2,98,49,1360275970269,1360275976157,697354237,697360125,5888
1360275980,697363968,2,98,49,1360275970269,1360275976157,697354237,697360125,5888
1360275980,697363972,7,412,58.85714286,1360275979286,1360275979350,697363258,697363322,64
1360275981,3630644732,2,98,49,1360275970360,1360275975736,3630634092,3630639468,5376
1360275981,3630644732,2,98,49,1360275974135,1360275979767,3630637867,3630643499,5632
1360275987,3630650236,2,92,46,1360275959272,1360275959272,3630622508,3630622508,0
1360275987,3630650236,1,46,46,1360275959271,1360275959271,3630622507,3630622507,0
1360275988,697371448,2,92,46,1360275960674,1360275960674,697344122,697344122,0
1360275988,697371532,1,46,46,1360275963729,1360275963729,697347261,697347261,0
1360275988,697371616,1,46,46,1360275963641,1360275963641,697347257,697347257,0
1360275988,697371736,8,1987,248.375,1360275971714,1360275982786,697355450,697366522,11072
1360275988,697371824,7,412,58.85714286,1360275980459,1360275980523,697364283,697364347,64
1360275988,697371868,26,20802,800.0769231,1360275969793,1360275981697,697353661,697365565,11904
1360275988,697371868,8,501,62.625,1360275974785,1360275980225,697358653,697364093,5440
1360275988,697371896,139,142792,1027.280576,1360275970981,1360275987365,697354877,697371261,16384
1360275991,3630654276,2,92,46,1360275965246,1360275965246,3630628522,3630628522,0
1360275992,697375452,1,46,46,1360275964576,1360275964576,697348028,697348028,0
1360275992,697375460,3,1393,464.3333333,1360275965400,1360275965528,697348860,697348988,128
1360275992,697375480,1,46,46,1360275965826,1360275965826,697349306,697349306,0
1360275992,697375528,1,46,46,1360275964178,1360275964178,697347706,697347706,0
1360275992,697375576,2,92,46,1360275965537,1360275965537,697349113,697349113,0
1360275992,697375616,1,46,46,1360275967417,1360275967417,697351033,697351033,0
1360275995,3630658256,1,46,46,1360275970258,1360275970258,3630633514,3630633514,0
1360275995,3630658292,2,92,46,1360275970225,1360275970225,3630633517,3630633517,0
1360275996,697379468,10,9158,915.8,1360275971855,1360275972495,697355323,697355963,640
1360275996,697379520,1,46,46,1360275970587,1360275970587,697354107,697354107,0
1360275996,697379520,1,46,46,1360275970587,1360275970587,697354107,697354107,0
1360275996,697379520,33,34165,1035.30303,1360275970778,1360275976602,697354298,697360122,5824
1360275996,697379544,2,461,230.5,1360275971138,1360275971202,697354682,697354746,64
1360275996,697379604,2,92,46,1360275970056,1360275970120,697353660,697353724,64
1360275996,697379632,23,18710,813.4782609,1360275970666,1360275976874,697354298,697360506,6208
1360275996,697379636,45,48700,1082.222222,1360275970601,1360275974761,697354237,697358397,4160
1360275996,697379640,11,9056,823.2727273,1360275971107,1360275972451,697354747,697356091,1344
1360275999,3630662516,5,280,56,1360275972497,1360275980177,3630636013,3630643693,7680
1360276000,697383472,8,3550,443.75,1360275971978,1360275972362,697355450,697355834,384
1360276000,697383472,16,14289,893.0625,1360275971978,1360275977034,697355450,697360506,5056
1360276000,697383472,9,1278,142,1360275971978,1360275972554,697355450,697356026,576
1360276000,697383476,10,9919,991.9,1360275972422,1360275973062,697355898,697356538,640
1360276000,697383480,10,560,56,1360275972547,1360275982019,697356027,697365499,9472
1360276000,697383524,2,92,46,1360275973848,1360275973848,697357372,697357372,0
1360276000,697383568,13,12013,924.0769231,1360275971884,1360275976556,697355452,697360124,4672
1360276000,697383568,24,17369,723.7083333,1360275971883,1360275977195,697355451,697360763,5312
1360276000,697383596,10,560,56,1360275972558,1360275982926,697356154,697366522,10368
1360276000,697383596,24,26977,1124.041667,1360275972558,1360275972878,697356154,697356474,320
1360276000,697383600,5,280,56,1360275972684,1360275980492,697356284,697364092,7808
1360276000,697383612,5,280,56,1360275973501,1360275986429,697357113,697370041,12928
1360276000,697383612,5,480,96,1360275973695,1360275987647,697357307,697371259,13952
1360276004,697387860,5,675,135,1360276001224,1360276001416,697385084,697385276,192
1360276004,697387860,6,689,114.8333333,1360276001288,1360276001416,697385148,697385276,128
1360276007,3630670488,2,92,46,1360275980012,1360275980012,3630643500,3630643500,0
1360276008,697391572,1,46,46,1360275980005,1360275980005,697363577,697363577,0
1360276012,697395644,1,137,137,1360275986462,1360275986462,697370106,697370106,0
1360276012,697395832,3,325,108.3333333,1360276001316,1360276007332,697385148,697391164,6016
1360276012,697395880,6,461,76.83333333,1360276004596,1360276004724,697388476,697388604,128
1360276028,697412100,2,92,46,1360276023062,1360276023062,697407162,697407162,0
1360276032,697415808,6,1098,183,1360276005241,1360276017145,697389049,697400953,11904
1360276036,697420184,3,144,48,1360276024003,1360276029059,697408187,697413243,5056
1360276040,697423852,3,138,46,1360276015503,1360276015503,697399355,697399355,0
1360276044,697427868,7,1024,146.2857143,1360276017406,1360276043710,697401274,697427578,26304
1360276044,697427868,5,3358,671.6,1360276017469,1360276017597,697401337,697401465,128
1360276047,3630710476,2,92,46,1360276018998,1360276018998,3630682474,3630682474,0
1360276047,3630710556,2,92,46,1360276021929,1360276021929,3630685485,3630685485,0
1360276048,697431704,2,92,46,1360276020388,1360276020388,697404092,697404092,0
1360276051,3630714512,2,92,46,1360276022996,1360276022996,3630686508,3630686508,0
1360276052,697436052,6,461,76.83333333,1360276049412,1360276049540,697433464,697433592,128
1360276056,697439760,1,137,137,1360276030249,1360276030249,697414009,697414009,0
1360276068,697452020,3,325,108.3333333,1360276061157,1360276067109,697445177,697451129,5952
1360276068,697452020,5,643,128.6,1360276061157,1360276061285,697445177,697445305,128
1360276068,697452092,5,675,135,1360276060960,1360276061216,697445052,697445308,256
1360276072,697455720,5,1341,268.2,1360276043921,1360276043985,697427641,697427705,64
1360276072,697455912,6,3508,584.6666667,1360276044113,1360276044241,697428025,697428153,128
1360276072,697455912,3,2920,973.3333333,1360276044176,1360276044240,697428088,697428152,64
1360276084,697467760,3,492,164,1360276057450,1360276057514,697441210,697441274,64
1360276092,697476116,4,205,51.25,1360276086981,1360276086981,697471097,697471097,0
1360276092,697476200,2,92,46,1360276086899,1360276086899,697471099,697471099,0
1360276092,697476204,3,138,46,1360276090927,1360276090927,697475131,697475131,0
1360276096,697479772,1,137,137,1360276068383,1360276068383,697452155,697452155,0
1360276100,697483820,3,138,46,1360276074542,1360276074542,697458362,697458362,0
1360276100,697483892,3,138,46,1360276073445,1360276073509,697457337,697457401,64
1360276100,697484048,2,92,46,1360276092039,1360276092039,697476087,697476087,0
1360276100,697484048,2,92,46,1360276092043,1360276092043,697476091,697476091,0
1360276100,697484100,3,138,46,1360276091991,1360276092055,697476091,697476155,64
1360276100,697484100,2,92,46,1360276091991,1360276091991,697476091,697476091,0
1360276100,697484124,25,29283,1171.32,1360276092349,1360276095293,697476473,697479417,2944
1360276100,697484140,6,461,76.83333333,1360276094318,1360276094638,697478458,697478778,320
1360276108,697491860,1,46,46,1360276083655,1360276083655,697467515,697467515,0
1360276112,697495904,2,92,46,1360276086168,1360276086232,697470072,697470136,64
1360276112,697495936,2,92,46,1360276087160,1360276087160,697471096,697471096,0
1360276112,697495936,1,46,46,1360276087160,1360276087160,697471096,697471096,0
1360276116,697499844,2,92,46,1360276088276,1360276088276,697472120,697472120,0
1360276116,697499912,2,92,46,1360276090515,1360276090515,697474427,697474427,0
1360276116,697500048,3,144,48,1360276108747,1360276113803,697492795,697497851,5056
1360276116,697500128,6,461,76.83333333,1360276109368,1360276109496,697493496,697493624,128
1360276124,697507784,9,2550,283.3333333,1360276097298,1360276108626,697481082,697492410,11328
1360276124,697508156,5,675,135,1360276120925,1360276121117,697505081,697505273,192
1360276124,697508156,5,643,128.6,1360276120988,1360276121180,697505144,697505336,192
1360276132,697516164,3,325,108.3333333,1360276120980,1360276126996,697505144,697511160,6016
1360276132,697516204,5,575,115,1360276113838,1360276129966,697498042,697514170,16128
1360276136,697519812,6,974,162.3333333,1360276108916,1360276108980,697492728,697492792,64
1360276136,697519876,1,137,137,1360276111222,1360276111222,697495098,697495098,0
1360276140,697524240,6,461,76.83333333,1360276139272,1360276139400,697523512,697523640,128
1360276148,697532188,1603,2214177,1381.270742,1360276133117,1360276142973,697517305,697527161,9856
1360276152,697535808,4,192,48,1360276124026,1360276126202,697507834,697510010,2176
1360276156,697540096,3,144,48,1360276144088,1360276149464,697528184,697533560,5376
1360276156,697540180,2,98,49,1360276144006,1360276149318,697528186,697533498,5312
1360276159,3630822560,9,504,56,1360276134054,1360276144358,3630797614,3630807918,10304
1360276160,697543856,18,1008,56,1360276134025,1360276144841,697517881,697528697,10816
1360276160,697543860,4,2423,605.75,1360276134596,1360276134852,697518456,697518712,256
1360276160,697543948,18,1008,56,1360276134060,1360276144812,697518008,697528760,10752
1360276160,697543948,9,504,56,1360276134123,1360276144491,697518071,697528439,10368
1360276160,697543976,9,504,56,1360276134738,1360276145490,697518714,697529466,10752
1360276160,697543976,9,864,96,1360276134927,1360276149519,697518903,697533495,14592
1360276168,697551868,1,137,137,1360276142714,1360276142714,697526582,697526582,0
1360276172,697556208,3,606,202,1360276143976,1360276144168,697528184,697528376,192
1360276172,697556284,13,2530,194.6153846,1360276143451,1360276144475,697527735,697528759,1024
1360276172,697556292,6,3306,551,1360276143892,1360276144020,697528184,697528312,128
1360276180,697564216,12,3499,291.5833333,1360276176863,1360276177183,697561079,697561399,320
1360276180,697564320,6,461,76.83333333,1360276177977,1360276178105,697562297,697562425,128
1360276188,697572228,8,2252,281.5,1360276176146,1360276181778,697560374,697566006,5632
1360276188,697572228,2,98,49,1360276176467,1360276181779,697560695,697566007,5312
1360276188,697572228,2,98,49,1360276176467,1360276181779,697560695,697566007,5312
1360276188,697572232,2,98,49,1360276176462,1360276181774,697560694,697566006,5312
1360276188,697572232,9,581,64.55555556,1360276176466,1360276181842,697560698,697566074,5376
1360276188,697572232,5,643,128.6,1360276180946,1360276181074,697565178,697565306,128
1360276188,697572236,2,98,49,1360276176714,1360276182730,697560950,697566966,6016
1360276188,697572236,7,2861,408.7142857,1360276176846,1360276182798,697561082,697567034,5952
1360276188,697572268,3,144,48,1360276175275,1360276180779,697559543,697565047,5504
1360276188,697572268,12,4630,385.8333333,1360276177899,1360276183723,697562167,697567991,5824
1360276188,697572268,2,98,49,1360276175275,1360276180715,697559543,697564983,5440
1360276188,697572304,3,144,48,1360276180359,1360276185735,697564663,697570039,5376
1360276188,697572308,7,1326,189.4285714,1360276176388,1360276186820,697560696,697571128,10432
1360276188,697572308,5,675,135,1360276180740,1360276180996,697565048,697565304,256
1360276188,697572308,3,325,108.3333333,1360276180867,1360276186691,697565175,697570999,5824
1360276188,697572312,2,98,49,1360276176642,1360276182658,697560954,697566970,6016
1360276188,697572312,3,144,48,1360276176832,1360276182720,697561144,697567032,5888
1360276188,697572340,27,21293,788.6296296,1360276174630,1360276187750,697558970,697572090,13120
1360276188,697572344,2,98,49,1360276175199,1360276180639,697559543,697564983,5440
1360276188,697572348,2,98,49,1360276175194,1360276180634,697559542,697564982,5440
1360276190,3630852820,3,144,48,1360276178826,1360276184586,3630841646,3630847406,5760
1360276190,3630852836,3,144,48,1360276176891,1360276182587,3630839727,3630845423,5696
1360276196,697580312,111,141394,1273.81982,1360276176386,1360276190018,697560698,697574330,13632
1360276200,697583920,24,20095,837.2916667,1360276175625,1360276180041,697559545,697563961,4416
1360276200,697583920,19,13376,704,1360276175625,1360276179593,697559545,697563513,3968
1360276200,697583920,37,34594,934.972973,1360276175625,1360276179593,697559545,697563513,3968
1360276200,697583920,25,22898,915.92,1360276175625,1360276179593,697559545,697563513,3968
1360276200,697583920,18,21079,1171.055556,1360276175624,1360276177608,697559544,697561528,1984
1360276200,697584000,16,12469,779.3125,1360276175542,1360276179510,697559542,697563510,3968
1360276200,697584000,6,1086,181,1360276175542,1360276177398,697559542,697561398,1856
1360276200,697584004,4,559,139.75,1360276175540,1360276176308,697559544,697560312,768
1360276200,697584004,6,483,80.5,1360276175540,1360276176308,697559544,697560312,768
1360276203,3630866716,6,336,56,1360276176523,1360276195211,3630840239,3630858927,18688
1360276204,697587872,10,9123,912.3,1360276176505,1360276177209,697560377,697561081,704
1360276204,697587876,12,672,56,1360276176818,1360276196018,697560694,697579894,19200
1360276204,697587876,13,728,56,1360276176758,1360276197622,697560634,697581498,20864
1360276204,697587876,12,11761,980.0833333,1360276176821,1360276177077,697560697,697560953,256
1360276204,697587876,11,1370,124.5454545,1360276176821,1360276177269,697560697,697561145,448
1360276204,697587876,6,336,56,1360276176884,1360276195508,697560760,697579384,18624
1360276204,697587880,9,9942,1104.666667,1360276177073,1360276177521,697560953,697561401,448
1360276204,697587900,6,336,56,1360276177883,1360276197339,697561783,697581239,19456
1360276204,697587904,23,26931,1170.913043,1360276178072,1360276178264,697561976,697562168,192
1360276204,697587960,9,9100,1011.111111,1360276176737,1360276177377,697560697,697561337,640
1360276204,697587996,6,576,96,1360276177853,1360276197373,697561849,697581369,19520
1360276212,697595868,18,3527,195.9444444,1360276184189,1360276210429,697568057,697594297,26240
1360276212,697595912,3,138,46,1360276186448,1360276186448,697570360,697570360,0
1360276212,697595980,1,137,137,1360276185100,1360276185100,697569080,697569080,0
1360276212,697596316,6,461,76.83333333,1360276207930,1360276208058,697592246,697592374,128
1360276220,697603988,1,46,46,1360276193925,1360276193925,697577913,697577913,0
1360276220,697604028,6,980,163.3333333,1360276195229,1360276195293,697579257,697579321,64
1360276220,697604028,6,3276,546,1360276195291,1360276195547,697579319,697579575,256
1360276231,3630894768,1,56,56,1360276203927,1360276203927,3630867695,3630867695,0
1360276232,697615876,1,56,56,1360276204275,1360276204275,697588151,697588151,0
1360276232,697615980,2,112,56,1360276203980,1360276208332,697587960,697592312,4352
1360276236,697619964,2,112,56,1360276208284,1360276210460,697592248,697594424,2176
1360276236,697620012,1,56,56,1360276210156,1360276210156,697594168,697594168,0
1360276236,697620012,1,96,96,1360276210283,1360276210283,697594295,697594295,0
1360276244,697628008,3,606,202,1360276219438,1360276219566,697603446,697603574,128
1360276244,697628268,5,675,135,1360276240812,1360276241004,697625080,697625272,192
1360276244,697628336,5,643,128.6,1360276240806,1360276240998,697625142,697625334,192
1360276248,697631984,3,169,56.33333333,1360276220425,1360276220489,697604409,697604473,64
1360276252,697636060,1,137,137,1360276227516,1360276227516,697611576,697611576,0
1360276252,697636296,2,92,46,1360276249869,1360276249869,697634165,697634165,0
1360276252,697636344,4,371,92.75,1360276240799,1360276246879,697625143,697631223,6080
1360276261,697644432,6,461,76.83333333,1360276253872,1360276254000,697637304,697637432,128
1360276272,697655956,8,1937,242.125,1360276243937,1360276244065,697627893,697628021,128
1360276272,697655960,5,4042,808.4,1360276244449,1360276244577,697628409,697628537,128
1360276276,697660040,3,138,46,1360276249294,1360276249358,697633334,697633398,64
1360276277,697660488,6,461,76.83333333,1360276268792,1360276268920,697652280,697652408,128
1360276284,697668064,4,192,48,1360276257592,1360276259896,697641656,697643960,2304
1360276284,697668076,1,137,137,1360276258665,1360276258665,697642741,697642741,0
1360276284,697668100,6,1097,182.8333333,1360276259603,1360276279059,697643703,697663159,19456
1360276284,697668344,6,461,76.83333333,1360276282910,1360276283038,697667254,697667382,128
1360276292,697676148,2,123,61.5,1360276265249,1360276265313,697649397,697649461,64
1360276293,697676416,3,144,48,1360276279744,1360276284864,697663160,697668280,5120
1360276300,697684316,5,251,50.2,1360276291898,1360276291962,697676214,697676278,64
1360276300,697684352,6,461,76.83333333,1360276297941,1360276298069,697682293,697682421,128
1360276300,697684356,3,138,46,1360276294867,1360276294931,697679223,697679287,64
1360276300,697684356,2,92,46,1360276294867,1360276294867,697679223,697679223,0
1360276301,697684396,3,138,46,1360276293842,1360276293842,697677238,697677238,0
1360276301,697684412,2,92,46,1360276295809,1360276295809,697679221,697679221,0
1360276301,697684432,2,92,46,1360276295789,1360276295789,697679221,697679221,0
1360276301,697684432,2,92,46,1360276295789,1360276295789,697679221,697679221,0
1360276304,697688208,6,971,161.8333333,1360276279271,1360276279399,697663479,697663607,128
1360276304,697688208,4,2488,622,1360276279397,1360276279461,697663605,697663669,64
1360276309,697692424,5,675,135,1360276301624,1360276301880,697685048,697685304,256
1360276309,697692424,3,325,108.3333333,1360276301751,1360276306935,697685175,697690359,5184
1360276309,697692496,5,643,128.6,1360276301677,1360276301805,697685173,697685301,128
1360276316,697700352,7,412,58.85714286,1360276309141,1360276309141,697693493,697693493,0
1360276320,697704076,1,46,46,1360276293162,1360276293162,697677238,697677238,0
1360276320,697704148,2,92,46,1360276292068,1360276292068,697676216,697676216,0
1360276320,697704148,1,46,46,1360276292068,1360276292068,697676216,697676216,0
1360276320,697704148,2,92,46,1360276292068,1360276292132,697676216,697676280,64
1360276320,697704184,2,92,46,1360276293054,1360276293054,697677238,697677238,0
1360276320,697704184,1,46,46,1360276293054,1360276293054,697677238,697677238,0
1360276324,697708060,1,137,137,1360276296184,1360276296184,697680244,697680244,0
1360276328,697712100,3,1504,501.3333333,1360276301585,1360276301649,697685685,697685749,64
1360276333,697716556,6,461,76.83333333,1360276328753,1360276328881,697712309,697712437,128
1360276349,697732472,6,498,83,1360276337927,1360276340935,697721399,697724407,3008
1360276352,697736212,3,138,46,1360276325155,1360276325155,697709367,697709367,0
1360276364,697748328,1,46,46,1360276337068,1360276337068,697721396,697721396,0
1360276365,697748504,5,675,135,1360276361575,1360276361767,697745079,697745271,192
1360276365,697748504,5,643,128.6,1360276361702,1360276361830,697745206,697745334,128
1360276365,697748588,6,461,76.83333333,1360276358674,1360276358802,697742262,697742390,128
1360276368,697752328,1,137,137,1360276339950,1360276339950,697724278,697724278,0
1360276369,697752440,3,492,164,1360276341795,1360276341923,697725235,697725363,128
1360276369,697752460,3,604,201.3333333,1360276343567,1360276343631,697727027,697727091,64
1360276373,697756584,3,325,108.3333333,1360276361623,1360276366743,697745207,697750327,5120
1360276381,697764640,6,461,76.83333333,1360276373660,1360276373788,697757300,697757428,128
1360276404,697788272,1,137,137,1360276377637,1360276377637,697761909,697761909,0
1360276405,697788600,5,415,83,1360276403652,1360276403844,697787252,697787444,192
1360276408,697792248,6,1100,183.3333333,1360276380797,1360276389501,697765045,697773749,8704
1360276413,697796588,1139,1505106,1321.427568,1360276400209,1360276405265,697783797,697788853,5056
1360276425,697808416,5,2508,501.6,1360276399741,1360276414781,697783157,697798197,15040
1360276428,3631090984,2,112,56,1360276402021,1360276404133,3631065005,3631067117,2112
1360276428,697812252,4,224,56,1360276401079,1360276404023,697785331,697788275,2944
1360276428,697812256,2,112,56,1360276401206,1360276403318,697785462,697787574,2112
1360276428,697812288,2,112,56,1360276402004,1360276404052,697786292,697788340,2048
1360276428,697812292,2,192,96,1360276402321,1360276404305,697786613,697788597,1984
1360276428,697812368,4,224,56,1360276401669,1360276404357,697786037,697788725,2688
1360276429,697812556,5,643,128.6,1360276421617,1360276421745,697805173,697805301,128
1360276429,697812556,5,675,135,1360276421489,1360276421745,697805045,697805301,256
1360276429,697812644,3,325,108.3333333,1360276421527,1360276427479,697805171,697811123,5952
1360276437,697820632,6,461,76.83333333,1360276433635,1360276433763,697817267,697817395,128
1360276437,697820656,2,92,46,1360276430474,1360276430474,697814130,697814130,0
1360276440,697824284,1,137,137,1360276414106,1360276414106,697798390,697798390,0
1360276445,697828540,3,144,48,1360276436544,1360276441792,697820084,697825332,5248
1360276445,697828544,9,2298,255.3333333,1360276436859,1360276442747,697820403,697826291,5888
1360276445,697828548,2,98,49,1360276437305,1360276442745,697820853,697826293,5440
1360276445,697828548,2,98,49,1360276437369,1360276442745,697820917,697826293,5376
1360276445,697828548,9,541,60.11111111,1360276437496,1360276443000,697821044,697826548,5504
1360276445,697828552,2,98,49,1360276437750,1360276443766,697821302,697827318,6016
1360276445,697828552,6,550,91.66666667,1360276438131,1360276438451,697821683,697822003,320
1360276445,697828556,3,140,46.66666667,1360276438130,1360276443762,697821686,697827318,5632
1360276445,697828556,2,98,49,1360276438512,1360276443760,697822068,697827316,5248
1360276445,697828624,11,1041,94.63636364,1360276437356,1360276437676,697820980,697821300,320
1360276445,697828624,8,535,66.875,1360276437356,1360276442732,697820980,697826356,5376
1360276445,697828628,2,98,49,1360276437673,1360276443689,697821301,697827317,6016
1360276445,697828628,2,98,49,1360276437673,1360276443689,697821301,697827317,6016
1360276445,697828632,2,98,49,1360276437734,1360276443686,697821366,697827318,5952
1360276445,697828632,3,144,48,1360276438180,1360276443748,697821812,697827380,5568
1360276445,697828632,4,467,116.75,1360276438051,1360276438307,697821683,697821939,256
1360276445,697828764,11,4584,416.7272727,1360276438242,1360276443554,697822006,697827318,5312
1360276445,697828768,6,461,76.83333333,1360276438686,1360276438878,697822454,697822646,192
1360276445,697828808,2,98,49,1360276435893,1360276441525,697819701,697825333,5632
1360276445,697828808,3,144,48,1360276435892,1360276441524,697819700,697825332,5632
1360276446,3631108812,3,144,48,1360276436948,1360276442900,3631099760,3631105712,5952
1360276446,3631108812,2,98,49,1360276438291,1360276443859,3631101103,3631106671,5568
1360276446,3631108812,3,144,48,1360276438291,1360276443923,3631101103,3631106735,5632
1360276446,3631108812,4,190,47.5,1360276438993,1360276444881,3631101805,3631107693,5888
1360276453,697836544,6,1296,216,1360276437181,1360276448893,697820725,697832437,11712
1360276453,697836544,113,141525,1252.433628,1360276437371,1360276448891,697820915,697832435,11520
1360276453,697836552,9,2200,244.4444444,1360276438196,1360276449588,697821748,697833140,11392
1360276453,697836620,27,21333,790.1111111,1360276435633,1360276448817,697819253,697832437,13184
1360276453,697836708,6,539,89.83333333,1360276435994,1360276450650,697819702,697834358,14656
1360276456,697840356,6,1099,183.1666667,1360276429201,1360276447761,697813557,697832117,18560
1360276460,697844304,20,19361,968.05,1360276435396,1360276438788,697819700,697823092,3392
1360276460,697844304,7,576,82.28571429,1360276435395,1360276435779,697819699,697820083,384
1360276460,697844304,4,559,139.75,1360276435395,1360276435843,697819699,697820147,448
1360276460,697844328,36,38135,1059.305556,1360276435370,1360276438698,697819698,697823026,3328
1360276460,697844328,23,23114,1004.956522,1360276435370,1360276438762,697819698,697823090,3392
1360276460,697844332,4,224,56,1360276435688,1360276447976,697820020,697832308,12288
1360276461,697844412,29,26894,927.3793103,1360276436288,1360276439936,697819700,697823348,3648
1360276461,697844412,20,19315,965.75,1360276436288,1360276439616,697819700,697823028,3328
1360276461,697844412,4,498,124.5,1360276436288,1360276436672,697819700,697820084,384
1360276461,697844416,25,26297,1051.88,1360276436284,1360276440060,697819700,697823476,3776
1360276461,697844416,8,448,56,1360276436475,1360276450939,697819891,697834355,14464
1360276461,697844548,6,461,76.83333333,1360276453880,1360276454008,697837428,697837556,128
1360276461,697844588,3,138,46,1360276458769,1360276458833,697842357,697842421,64
1360276464,3631127028,4,224,56,1360276436731,1360276448827,3631099759,3631111855,12096
1360276464,697848256,16,11907,744.1875,1360276436148,1360276437556,697820404,697821812,1408
1360276464,697848256,8,448,56,1360276436147,1360276458099,697820403,697842355,21952
1360276464,697848256,9,8974,997.1111111,1360276436594,1360276437170,697820850,697821426,576
1360276464,697848256,4,224,56,1360276436594,1360276453170,697820850,697837426,16576
1360276464,697848260,9,1259,139.8888889,1360276436721,1360276437105,697820981,697821365,384
1360276464,697848292,6,1759,293.1666667,1360276437649,1360276437841,697821941,697822133,192
1360276464,697848348,4,384,96,1360276436567,1360276453143,697820915,697837491,16576
1360276464,697848380,23,26931,1170.913043,1360276437110,1360276437302,697821490,697821682,192
1360276464,697848384,42,51680,1230.47619,1360276437748,1360276438004,697822132,697822388,256
1360276472,697856372,1,137,137,1360276445311,1360276445311,697829683,697829683,0
1360276477,697860560,6,461,76.83333333,1360276468908,1360276469036,697852468,697852596,128
1360276485,697868628,5,675,135,1360276481446,1360276481638,697865074,697865266,192
1360276485,697868716,5,643,128.6,1360276481488,1360276481616,697865204,697865332,128
1360276493,697876628,3,325,108.3333333,1360276481576,1360276487528,697865204,697871156,5952
1360276501,697884760,6,461,76.83333333,1360276498725,1360276498853,697882485,697882613,128
1360276504,697888368,1,137,137,1360276479107,1360276479107,697863475,697863475,0
1360276509,697892396,3,169,56.33333333,1360276481230,1360276481230,697864626,697864626,0
1360276513,697896496,6,2007,334.5,1360276488492,1360276511852,697871988,697895348,23360
1360276517,697900556,3,138,46,1360276492781,1360276492845,697876337,697876401,64
1360276525,697908908,3,144,48,1360276519312,1360276524368,697903220,697908276,5056
1360276537,697920684,6,3536,589.3333333,1360276511534,1360276511790,697895218,697895474,256
1360276549,697932812,1,137,137,1360276521006,1360276521006,697904818,697904818,0
1360276549,697932944,5,675,135,1360276541163,1360276541355,697925107,697925299,192
1360276549,697932944,3,325,108.3333333,1360276541226,1360276547178,697925170,697931122,5952
1360276549,697933020,5,643,128.6,1360276541150,1360276541278,697925170,697925298,128
1360276549,697933064,6,461,76.83333333,1360276543409,1360276543537,697927473,697927601,128
1360276553,697936664,2,123,61.5,1360276525956,1360276526020,697909620,697909684,64
1360276557,697941032,5,251,50.2,1360276553107,1360276553171,697937139,697937203,64
1360276557,697941040,2,92,46,1360276554060,1360276554060,697938100,697938100,0
1360276557,697941040,2,92,46,1360276554060,1360276554060,697938100,697938100,0
1360276557,697941068,3,138,46,1360276555054,1360276555118,697939122,697939186,64
1360276557,697941120,3,138,46,1360276553977,1360276554041,697938097,697938161,64
1360276557,697941120,2,92,46,1360276553977,1360276553977,697938097,697938097,0
1360276557,697941152,3,138,46,1360276554968,1360276554968,697939120,697939120,0
1360276569,697952840,8,1432,179,1360276544276,1360276544468,697928116,697928308,192
1360276573,697956668,5,3141,628.2,1360276545022,1360276545022,697928690,697928690,0
1360276573,697957028,8,458,57.25,1360276569622,1360276569686,697953650,697953714,64
1360276579,697963156,2,92,46,1360276550934,1360276550998,697935090,697935154,64
1360276579,697963160,1,48,48,1360276550993,1360276550993,697935153,697935153,0
1360276580,697963384,2,92,46,1360276552729,1360276552729,697936113,697936113,0
1360276581,697964672,6,1934,322.3333333,1360276552187,1360276557435,697935859,697941107,5248
1360276581,697964808,2,92,46,1360276553266,1360276553330,697937074,697937138,64
1360276581,697964888,1,46,46,1360276553186,1360276553186,697937074,697937074,0
1360276581,697964900,1,46,46,1360276554198,1360276554198,697938098,697938098,0
1360276581,697964900,2,92,46,1360276554198,1360276554198,697938098,697938098,0
1360276589,697972688,1,137,137,1360276563240,1360276563240,697946928,697946928,0
1360276589,697972916,1115,1575169,1412.707623,1360276581253,1360276587013,697965169,697970929,5760
1360276589,697973000,6,497,82.83333333,1360276578417,1360276581425,697962417,697965425,3008
1360276597,697980808,11,5107,464.2727273,1360276571249,1360276582641,697955057,697966449,11392
1360276605,697988724,1,46,46,1360276578695,1360276578695,697962419,697962419,0
1360276605,697988832,3,138,46,1360276577498,1360276577562,697961330,697961394,64
1360276605,697988944,10,2344,234.4,1360276596649,1360276602601,697980593,697986545,5952
1360276605,697988956,3,144,48,1360276597855,1360276603551,697981811,697987507,5696
1360276605,697988956,11,3453,313.9090909,1360276597855,1360276598111,697981811,697982067,256
1360276605,697988956,10,627,62.7,1360276597918,1360276603678,697981874,697987634,5760
1360276605,697988956,11,4584,416.7272727,1360276598172,1360276603548,697982128,697987504,5376
1360276605,697988980,3,144,48,1360276598981,1360276604549,697982961,697988529,5568
1360276605,697988984,3,144,48,1360276599233,1360276604545,697983217,697988529,5312
1360276605,697988996,3,144,48,1360276595956,1360276601524,697979952,697985520,5568
1360276605,697989000,2,98,49,1360276595951,1360276601519,697979951,697985519,5568
1360276605,697989028,5,675,135,1360276601044,1360276601300,697985072,697985328,256
1360276605,697989028,4,597,149.25,1360276601175,1360276601303,697985203,697985331,128
1360276605,697989032,2,98,49,1360276597779,1360276603475,697981811,697987507,5696
1360276605,697989032,7,2861,408.7142857,1360276597779,1360276603539,697981811,697987571,5760
1360276605,697989040,5,415,83,1360276598599,1360276598727,697982639,697982767,128
1360276605,697989040,2,98,49,1360276598857,1360276604489,697982897,697988529,5632
1360276605,697989040,3,144,48,1360276598921,1360276604489,697982961,697988529,5568
1360276605,697989068,49,56505,1153.163265,1360276599788,1360276601004,697983856,697985072,1216
1360276605,697989072,72,89836,1247.722222,1360276599787,1360276600491,697983859,697984563,704
1360276605,697989072,41,47235,1152.073171,1360276599787,1360276600747,697983859,697984819,960
1360276605,697989072,54,68505,1268.611111,1360276599851,1360276601259,697983923,697985331,1408
1360276605,697989076,2,98,49,1360276595941,1360276601445,697980017,697985521,5504
1360276605,697989076,3,144,48,1360276595940,1360276601444,697980016,697985520,5504
1360276606,3631268880,3,144,48,1360276599119,1360276605007,3631261999,3631267887,5888
1360276606,3631268884,4,190,47.5,1360276597068,1360276603020,3631259952,3631265904,5952
1360276608,3631271288,13,728,56,1360276582072,1360276607224,3631245360,3631270512,25152
1360276609,697992740,27,1512,56,1360276581940,1360276608564,697965680,697992304,26624
1360276609,697992748,26,1456,56,1360276582316,1360276608364,697966064,697992112,26048
1360276609,697992768,13,1248,96,1360276582554,1360276608154,697966322,697991922,25600
1360276609,697992848,14,784,56,1360276581963,1360276608715,697965811,697992563,26752
1360276609,697992852,13,728,56,1360276582404,1360276607812,697966256,697991664,25408
1360276613,697996980,3,325,108.3333333,1360276601219,1360276606531,697985199,697990511,5312
1360276613,697997016,4,602,150.5,1360276598815,1360276611743,697982831,697995759,12928
1360276613,697997024,3,144,48,1360276599771,1360276605531,697983795,697989555,5760
1360276613,697997024,2,98,49,1360276599833,1360276605465,697983857,697989489,5632
1360276613,697997028,1442,2011352,1394.834951,1360276600279,1360276608727,697984307,697992755,8448
1360276613,697997028,134,161801,1207.470149,1360276595414,1360276612374,697979442,697996402,16960
1360276613,697997052,2,92,46,1360276601084,1360276606460,697985136,697990512,5376
1360276613,697997052,8,1968,246,1360276597116,1360276611260,697981168,697995312,14144
1360276613,697997100,2,98,49,1360276599755,1360276605387,697983855,697989487,5632
1360276613,697997100,3,144,48,1360276599823,1360276605519,697983923,697989619,5696
1360276613,697997100,2,98,49,1360276599759,1360276605391,697983859,697989491,5632
1360276613,697997100,2,98,49,1360276600204,1360276606412,697984304,697990512,6208
1360276613,697997100,3,144,48,1360276600204,1360276606540,697984304,697990640,6336
1360276613,697997100,2,98,49,1360276600396,1360276606412,697984496,697990512,6016
1360276621,698004760,5,974,194.8,1360276596194,1360276599074,697979954,697982834,2880
1360276621,698004760,4,462,115.5,1360276596194,1360276597154,697979954,697980914,960
1360276621,698004940,35,32524,929.2571429,1360276595883,1360276599531,697979823,697983471,3648
1360276621,698004944,7,529,75.57142857,1360276596010,1360276596202,697979954,697980146,192
1360276621,698004944,28,24343,869.3928571,1360276596136,1360276599528,697980080,697983472,3392
1360276621,698004988,6,461,76.83333333,1360276613629,1360276613757,697997617,697997745,128
1360276621,698005024,6,574,95.66666667,1360276598873,1360276619289,697982897,698003313,20416
1360276621,698005080,6,574,95.66666667,1360276598816,1360276619808,697982896,698003888,20992
1360276621,698005108,5,1455,291,1360276599428,1360276615428,697983536,697999536,16000
1360276624,3631287348,4,796,199,1360276598907,1360276602107,3631262255,3631265455,3200
1360276624,3631287348,4,432,108,1360276598910,1360276599038,3631262258,3631262386,128
1360276625,698008712,9,9164,1018.222222,1360276597456,1360276598544,697981168,697982256,1088
1360276625,698008716,21,15900,757.1428571,1360276597583,1360276599759,697981299,697983475,2176
1360276625,698008720,23,26931,1170.913043,1360276598152,1360276598408,697981872,697982128,256
1360276625,698008760,15,12139,809.2666667,1360276599648,1360276599968,697983408,697983728,320
1360276625,698008796,17,18493,1087.823529,1360276596797,1360276598461,697980593,697982257,1664
1360276625,698008800,12,11761,980.0833333,1360276597368,1360276597560,697981168,697981360,192
1360276625,698008800,17,12546,738,1360276597496,1360276599672,697981296,697983472,2176
1360276625,698008804,3,493,164.3333333,1360276597686,1360276598006,697981490,697981810,320
1360276625,698008828,10,1305,130.5,1360276598043,1360276598555,697981871,697982383,512
1360276625,698008844,13,10089,776.0769231,1360276599054,1360276602382,697982898,697986226,3328
1360276625,698008872,8,4179,522.375,1360276599856,1360276600368,697983728,697984240,512
1360276625,698008876,45,53706,1193.466667,1360276600364,1360276601260,697984240,697985136,896
1360276628,3631291288,14,15271,1090.785714,1360276600374,1360276600758,3631263662,3631264046,384
1360276629,698012720,1,137,137,1360276601930,1360276601930,697985650,697985650,0
1360276629,698012796,7,1169,167,1360276601086,1360276606334,697984882,697990130,5248
1360276629,698013136,6,461,76.83333333,1360276628456,1360276628648,698012592,698012784,192
1360276629,698013148,3,144,48,1360276621662,1360276626718,698005810,698010866,5056
1360276629,698013148,3,144,48,1360276621915,1360276627675,698006063,698011823,5760
1360276636,3631299328,2,112,56,1360276608721,1360276613777,3631272049,3631277105,5056
1360276637,698020712,3,168,56,1360276609103,1360276615759,697992815,697999471,6656
1360276637,698020724,1,56,56,1360276610373,1360276610373,697994097,697994097,0
1360276637,698020760,1,96,96,1360276611488,1360276611488,697995248,697995248,0
1360276637,698020808,2,112,56,1360276610031,1360276612591,697993839,697996399,2560
1360276641,698024820,1,56,56,1360276613798,1360276613798,697997618,697997618,0
1360276661,698044768,5,1709,341.8,1360276633690,1360276633754,698017458,698017522,64
1360276661,698044884,23,19038,827.7391304,1360276633636,1360276633828,698017520,698017712,192
1360276661,698044996,3,138,46,1360276636147,1360276636147,698020143,698020143,0
1360276661,698045064,6,461,76.83333333,1360276658546,1360276658738,698042610,698042802,192
1360276661,698045072,3,138,46,1360276659624,1360276659624,698043696,698043696,0
1360276665,698048772,6,1948,324.6666667,1360276637779,1360276659411,698021551,698043183,21632
1360276669,698052768,3,169,56.33333333,1360276640920,1360276640984,698024688,698024752,64
1360276669,698052960,1,137,137,1360276643479,1360276643479,698027439,698027439,0
1360276669,698053036,5,675,135,1360276661069,1360276661261,698045105,698045297,192
1360276669,698053036,5,643,128.6,1360276661132,1360276661260,698045168,698045296,128
1360276669,698053036,3,325,108.3333333,1360276661132,1360276667084,698045168,698051120,5952
1360276681,698065124,3,138,46,1360276654261,1360276654261,698038385,698038385,0
1360276681,698065216,1,46,46,1360276654614,1360276654614,698038830,698038830,0
1360276686,698069484,13,7764,597.2307692,1360276659636,1360276666356,698043120,698049840,6720
1360276686,698069508,1,46,46,1360276659867,1360276659867,698043375,698043375,0
1360276686,698069516,1,46,46,1360276660498,1360276660498,698044014,698044014,0
1360276689,698073228,1,46,46,1360276661709,1360276661709,698045937,698045937,0
1360276693,698077184,10,2344,234.4,1360276685047,1360276690999,698069231,698075183,5952
1360276693,698077192,11,1041,94.63636364,1360276685743,1360276685999,698069935,698070191,256
1360276693,698077196,2,98,49,1360276685997,1360276692013,698070193,698076209,6016
1360276693,698077200,11,4584,416.7272727,1360276686822,1360276692006,698071022,698076206,5184
1360276693,698077224,6,461,76.83333333,1360276686862,1360276687054,698071086,698071278,192
1360276693,698077264,3,144,48,1360276684520,1360276689960,698068784,698074224,5440
1360276693,698077276,8,501,62.625,1360276685790,1360276690974,698070066,698075250,5184
1360276693,698077276,2,98,49,1360276685916,1360276691932,698070192,698076208,6016
1360276693,698077280,3,144,48,1360276686170,1360276691930,698070450,698076210,5760
1360276693,698077280,2,98,49,1360276686361,1360276691929,698070641,698076209,5568
1360276693,698077348,2,98,49,1360276684438,1360276689878,698068786,698074226,5440
1360276693,698077348,2,98,49,1360276684438,1360276689878,698068786,698074226,5440
1360276693,698077348,2,98,49,1360276684438,1360276689878,698068786,698074226,5440
1360276694,3631356888,4,190,47.5,1360276687562,1360276692746,3631350450,3631355634,5184
1360276694,3631356892,3,144,48,1360276685701,1360276691717,3631348593,3631354609,6016
1360276694,698077476,3,1452,484,1360276666298,1360276666426,698049774,698049902,128
1360276701,698085228,7,1368,195.4285714,1360276685450,1360276697354,698069678,698081582,11904
1360276701,698085312,111,141432,1274.162162,1360276685622,1360276698294,698069934,698082606,12672
1360276701,698085364,27,21645,801.6666667,1360276683846,1360276697222,698068210,698081586,13376
1360276709,698093272,4,215,53.75,1360276706080,1360276706144,698090352,698090416,64
1360276710,698093428,36,38199,1061.083333,1360276685419,1360276689067,698068847,698072495,3648
1360276710,698093440,1,137,137,1360276682463,1360276682463,698065903,698065903,0
1360276710,698093512,18,16065,892.5,1360276685334,1360276688918,698068846,698072430,3584
1360276713,698097128,2,461,230.5,1360276685102,1360276685102,698069230,698069230,0
1360276713,698097132,2,123,61.5,1360276685483,1360276685547,698069615,698069679,64
1360276713,698097136,5,948,189.6,1360276685863,1360276686055,698069999,698070191,192
1360276713,698097140,15,16294,1086.266667,1360276686180,1360276688356,698070320,698072496,2176
1360276713,698097140,12,11322,943.5,1360276686180,1360276688292,698070320,698072432,2112
1360276713,698097140,18,19015,1056.388889,1360276686499,1360276687331,698070639,698071471,832
1360276713,698097140,23,26931,1170.913043,1360276686499,1360276686691,698070639,698070831,192
1360276713,698097144,2,112,56,1360276686625,1360276688673,698070769,698072817,2048
1360276713,698097216,11,10057,914.2727273,1360276685463,1360276686423,698069679,698070639,960
1360276713,698097220,9,11301,1255.666667,1360276685906,1360276686226,698070126,698070446,320
1360276713,698097224,69,90538,1312.144928,1360276686096,1360276686928,698070320,698071152,832
1360276713,698097224,26,26022,1000.846154,1360276686096,1360276688784,698070320,698073008,2688
1360276713,698097248,4,224,56,1360276686326,1360276689910,698070574,698074158,3584
1360276713,698097248,2,192,96,1360276686710,1360276688694,698070958,698072942,1984
1360276713,698097252,3,168,56,1360276687154,1360276688946,698071406,698073198,1792
1360276713,698097256,2,112,56,1360276687599,1360276690927,698071855,698075183,3328
1360276716,3631379376,2,112,56,1360276688416,1360276692192,3631351792,3631355568,3776
1360276725,698109208,5,643,128.6,1360276720992,1360276721120,698105200,698105328,128
1360276725,698109284,5,675,135,1360276720787,1360276720979,698105071,698105263,192
1360276725,698109284,5,415,83,1360276716819,1360276716947,698101103,698101231,128
1360276726,698109480,5,1194,238.8,1360276697526,1360276707574,698081006,698091054,10048
1360276733,698117212,7,2648,378.2857143,1360276714010,1360276729946,698098222,698114158,15936
1360276733,698117284,3,325,108.3333333,1360276720915,1360276726867,698105199,698111151,5952
1360276733,698117300,7,412,58.85714286,1360276730306,1360276730370,698114606,698114670,64
1360276734,698117456,3,493,164.3333333,1360276705806,1360276705870,698089262,698089326,64
1360276737,698121212,2,92,46,1360276711962,1360276712026,698096174,698096238,64
1360276740,3631403468,2,92,46,1360276714115,1360276714115,3631377583,3631377583,0
1360276742,698125456,2,92,46,1360276713744,1360276713808,698097200,698097264,64
1360276744,3631407464,2,92,46,1360276716104,1360276716168,3631379568,3631379632,64
1360276744,3631407476,2,92,46,1360276717117,1360276717117,3631380593,3631380593,0
1360276753,698137136,1,137,137,1360276725992,1360276725992,698110128,698110128,0
1360276761,698145204,3,138,46,1360276736161,1360276736161,698120365,698120365,0
1360276762,698145428,2,574,287,1360276737641,1360276737641,698121069,698121069,0
1360276765,698149284,6,461,76.83333333,1360276761810,1360276761938,698146094,698146222,128
1360276773,698157276,3,144,48,1360276759002,1360276765082,698143278,698149358,6080
1360276774,698157436,3,493,164.3333333,1360276745633,1360276745761,698129069,698129197,128
1360276774,698157536,2,92,46,1360276749567,1360276749567,698133103,698133103,0
1360276777,698161140,1,46,46,1360276748963,1360276748963,698133103,698133103,0
1360276789,698173224,5,675,135,1360276780880,1360276781072,698165104,698165296,192
1360276789,698173280,4,371,92.75,1360276780886,1360276787286,698165166,698171566,6400
1360276789,698173280,5,643,128.6,1360276780885,1360276781013,698165165,698165293,128
1360276793,698177204,1,137,137,1360276765539,1360276765539,698149743,698149743,0
1360276805,698189272,2,92,46,1360276803807,1360276803871,698188079,698188143,64
1360276805,698189308,5,257,51.4,1360276801852,1360276802108,698186160,698186416,256
1360276805,698189348,2,92,46,1360276803731,1360276803731,698188079,698188079,0
1360276805,698189348,3,138,46,1360276803730,1360276803794,698188078,698188142,64
1360276805,698189348,2,92,46,1360276803730,1360276803730,698188078,698188078,0
1360276805,698189348,2,92,46,1360276803730,1360276803794,698188078,698188142,64
1360276809,698193276,3,493,164.3333333,1360276784796,1360276784924,698169072,698169200,128
1360276813,698197240,6,461,76.83333333,1360276806845,1360276806973,698191085,698191213,128
1360276825,698209372,2,92,46,1360276800698,1360276800762,698185070,698185134,64
1360276830,698213648,6,461,76.83333333,1360276822414,1360276822542,698206062,698206190,128
1360276830,698213680,6,496,82.66666667,1360276819692,1360276822764,698203372,698206444,3072
1360276830,698213840,2,92,46,1360276803279,1360276803279,698187119,698187119,0
1360276830,698213916,2,92,46,1360276802176,1360276802176,698186092,698186092,0
1360276830,698213916,2,92,46,1360276802176,1360276802240,698186092,698186156,64
1360276830,698213924,1,46,46,1360276803193,1360276803193,698187117,698187117,0
1360276834,698217752,2,574,287,1360276807271,1360276807335,698191023,698191087,64
1360276834,698217788,1,137,137,1360276809155,1360276809155,698192943,698192943,0
1360276845,698229228,5,643,128.6,1360276840972,1360276841100,698225200,698225328,128
1360276845,698229228,5,675,135,1360276840843,1360276841035,698225071,698225263,192
1360276845,698229256,6,461,76.83333333,1360276836846,1360276836974,698221102,698221230,128
1360276846,698229692,1,46,46,1360276819683,1360276819683,698203375,698203375,0
1360276850,698233700,11,2944,267.6363636,1360276823514,1360276845082,698207214,698228782,21568
1360276850,698233856,3,493,164.3333333,1360276825213,1360276825341,698209069,698209197,128
1360276853,698237212,1200,1658037,1381.6975,1360276843034,1360276848154,698227246,698232366,5120
1360276853,698237232,3,144,48,1360276844935,1360276850887,698229167,698235119,5952
1360276853,698237308,3,325,108.3333333,1360276840890,1360276846842,698225198,698231150,5952
1360276869,698253252,6,461,76.83333333,1360276866803,1360276866995,698251055,698251247,192
1360276870,698253692,5,2976,595.2,1360276845473,1360276845601,698229165,698229293,128
1360276870,698253740,1,137,137,1360276843698,1360276843698,698227438,698227438,0
1360276870,698253740,3,168,56,1360276843888,1360276848560,698227628,698232300,4672
1360276870,698253768,4,1817,454.25,1360276844628,1360276844884,698228396,698228652,256
1360276870,698253772,3,168,56,1360276844882,1360276851282,698228654,698235054,6400
1360276870,698253776,1,56,56,1360276845198,1360276845198,698228974,698228974,0
1360276874,698257840,1,96,96,1360276847948,1360276847948,698231788,698231788,0
1360276874,698257844,1,56,56,1360276848265,1360276848265,698232109,698232109,0
1360276876,3631539504,1,56,56,1360276848099,1360276848099,3631511603,3631511603,0
1360276890,698273864,3,493,164.3333333,1360276865398,1360276865526,698249262,698249390,128
1360276901,698285360,6,461,76.83333333,1360276896709,1360276896837,698281069,698281197,128
1360276906,698289772,3,138,46,1360276879567,1360276879631,698263339,698263403,64
1360276909,698293216,5,643,128.6,1360276900947,1360276901075,698285163,698285291,128
1360276909,698293272,3,325,108.3333333,1360276900891,1360276906843,698285163,698291115,5952
1360276910,698293656,5,675,135,1360276901444,1360276901636,698285100,698285292,192
1360276910,698293872,1,137,137,1360276883180,1360276883180,698267052,698267052,0
1360276914,698297892,5,654,130.8,1360276888217,1360276888345,698272109,698272237,128
1360276917,698301276,6,461,76.83333333,1360276911833,1360276911961,698296109,698296237,128
1360276926,698309900,1,46,46,1360276899985,1360276899985,698283885,698283885,0
1360276930,698313920,3,493,164.3333333,1360276905467,1360276905531,698289387,698289451,64
1360276933,698317276,6,461,76.83333333,1360276926807,1360276926935,698311083,698311211,128
1360276933,698317276,4,190,47.5,1360276926807,1360276927895,698311083,698312171,1088
1360276942,698325780,1,137,137,1360276917831,1360276917831,698301611,698301611,0
1360276950,698333936,2,92,46,1360276922157,1360276922157,698306093,698306093,0
1360276954,698337820,4,672,168,1360276927136,1360276927264,698310956,698311084,128
1360276965,698349296,2,92,46,1360276959939,1360276959939,698344235,698344235,0
1360276965,698349376,2,92,46,1360276959860,1360276959860,698344236,698344236,0
1360276966,698349384,5,675,135,1360276961684,1360276961876,698345068,698345260,192
1360276966,698349388,6,473,78.83333333,1360276957712,1360276958160,698341100,698341548,448
1360276966,698349388,5,643,128.6,1360276961808,1360276961936,698345196,698345324,128
1360276970,698353992,3,493,164.3333333,1360276945330,1360276945394,698329322,698329386,64
1360276973,698357300,3,325,108.3333333,1360276960897,1360276966849,698345197,698351149,5952
1360276986,698370220,1,137,137,1360276960400,1360276960400,698344620,698344620,0
1360277005,698389336,6,461,76.83333333,1360277001754,1360277001882,698386090,698386218,128
1360277010,698394124,3,493,164.3333333,1360276984880,1360276985008,698369004,698369132,128
1360277018,698402188,1,137,137,1360276991857,1360276991857,698376045,698376045,0
1360277021,698405328,3,144,48,1360277013988,1360277019876,698398316,698404204,5888
1360277029,698413296,4,371,92.75,1360277020933,1360277026885,698405229,698411181,5952
1360277029,698413340,5,675,135,1360277020757,1360277020949,698405097,698405289,192
1360277029,698413344,5,643,128.6,1360277020820,1360277021012,698405164,698405356,192
1360277030,698414108,2,92,46,1360277003968,1360277004032,698388076,698388140,64
1360277037,698421320,3,144,48,1360277033260,1360277033324,698417580,698417644,64
1360277037,698421324,5,575,115,1360277013861,1360277029797,698398185,698414121,15936
1360277037,698421352,6,700,116.6666667,1360277031178,1360277033290,698415530,698417642,2112
1360277037,698421356,6,461,76.83333333,1360277031750,1360277031878,698416106,698416234,128
1360277050,698434252,4,539,134.75,1360277025519,1360277032687,698409771,698416939,7168
1360277054,698438120,1,137,137,1360277029748,1360277029748,698413868,698413868,0
1360277058,698442240,1,46,46,1360277033402,1360277033402,698417642,698417642,0
1360277069,698453344,6,2051,341.8333333,1360277064723,1360277068563,698449067,698452907,3840
1360277098,698482332,3,1203,401,1360277072671,1360277097183,698457003,698481515,24512
1360277118,698501600,1,46,46,1360277089145,1360277089145,698472745,698472745,0
1360277155,698538584,1,401,401,1360277130634,1360277130634,698514218,698514218,0
1360277367,698750772,1,445,445,1360277341835,1360277341835,698725607,698725607,0
1360277446,698830264,1,48,48,1360277416926,1360277416926,698801190,698801190,0
1360277627,699011328,1,46,46,1360277602011,1360277602011,698986339,698986339,0
1360277752,699135496,2,122,61,1360277726742,1360277729046,699110238,699112542,2304
1360279633,701017368,1,48,48,1360279606291,1360279606291,700990659,700990659,0
1360280923,702307040,2,96,48,1360280897927,1360280900935,702281967,702284975,3008
1360281323,702706812,2,98,49,1360281316071,1360281321575,702699883,702705387,5504
1360281323,702706812,2,98,49,1360281316006,1360281321574,702699818,702705386,5568
1360281323,702706812,3,144,48,1360281316006,1360281321574,702699818,702705386,5568
1360281323,702706812,2,98,49,1360281316006,1360281321574,702699818,702705386,5568
1360281323,702706820,7,498,71.14285714,1360281312605,1360281316509,702696425,702700329,3904
1360281323,702706824,3,138,46,1360281321113,1360281322137,702704937,702705961,1024
1360281323,702706844,2,92,46,1360281321924,1360281322500,702705768,702706344,576
1360281323,702706844,5,437,87.4,1360281319235,1360281319683,702703079,702703527,448
1360281323,702706852,3,144,48,1360281315966,1360281321534,702699818,702705386,5568
1360281323,702706852,3,144,48,1360281315965,1360281321597,702699817,702705449,5632
1360281323,702706852,2,98,49,1360281315965,1360281321533,702699817,702705385,5568
1360281323,702706896,3,138,46,1360281320784,1360281321808,702704680,702705704,1024
1360281323,702706908,16,5553,347.0625,1360281319174,1360281320646,702703082,702704554,1472
1360281323,702706908,2,92,46,1360281322118,1360281322630,702706026,702706538,512
1360281326,3635989536,3,144,48,1360281314592,1360281320224,3635978128,3635983760,5632
1360281326,3635989536,3,144,48,1360281319453,1360281325277,3635982989,3635988813,5824
1360281326,3635989540,2,98,49,1360281316123,1360281322267,3635979663,3635985807,6144
1360281326,3635989540,3,144,48,1360281316123,1360281322267,3635979663,3635985807,6144
1360281326,3635989544,4,190,47.5,1360281317399,1360281323287,3635980943,3635986831,5888
1360281326,3635989544,3,144,48,1360281314582,1360281320278,3635978126,3635983822,5696
1360281326,3635989544,4,190,47.5,1360281314582,1360281320278,3635978126,3635983822,5696
1360281326,3635989548,3,144,48,1360281316114,1360281322258,3635979662,3635985806,6144
1360281326,3635989560,3,144,48,1360281316935,1360281322247,3635980495,3635985807,5312
1360281326,3635989560,3,144,48,1360281317382,1360281323206,3635980942,3635986766,5824
1360281331,702714912,2,98,49,1360281319681,1360281325441,702703593,702709353,5760
1360281331,702714916,3,138,46,1360281327996,1360281329084,702711912,702713000,1088
1360281331,702714920,3,138,46,1360281324345,1360281325433,702708265,702709353,1088
1360281331,702714932,3,144,48,1360281317675,1360281323499,702701607,702707431,5824
1360281331,702714932,4,190,47.5,1360281317611,1360281328427,702701543,702712359,10816
1360281331,702714932,3,138,46,1360281329131,1360281330219,702713063,702714151,1088
1360281331,702714932,4,190,47.5,1360281317615,1360281323567,702701547,702707499,5952
1360281331,702714960,3,138,46,1360281326865,1360281327953,702710825,702711913,1088
1360281331,702714960,2,94,47,1360281319119,1360281324431,702703079,702708391,5312
1360281331,702714960,3,144,48,1360281319183,1360281325455,702703143,702709415,6272
1360281331,702714964,3,144,48,1360281319179,1360281324491,702703143,702708455,5312
1360281331,702714964,4,190,47.5,1360281319183,1360281324559,702703147,702708523,5376
1360281331,702714968,3,138,46,1360281323144,1360281324232,702707112,702708200,1088
1360281331,702715004,3,138,46,1360281325415,1360281326503,702709419,702710507,1088
1360281331,702715004,3,144,48,1360281317605,1360281323429,702701609,702707433,5824
1360281331,702715004,3,144,48,1360281317541,1360281323365,702701545,702707369,5824
1360281331,702715004,3,138,46,1360281325668,1360281326756,702709672,702710760,1088
1360281331,702715028,3,138,46,1360281326475,1360281327691,702710503,702711719,1216
1360281331,702715028,3,144,48,1360281319053,1360281324365,702703081,702708393,5312
1360281331,702715028,3,144,48,1360281319117,1360281324429,702703145,702708457,5312
1360281336,702720128,1,137,137,1360281311403,1360281311403,702695531,702695531,0
1360281336,702720128,1,137,137,1360281311466,1360281311466,702695594,702695594,0
1360281339,3636002044,10,1348,134.8,1360281312393,1360281312713,3635975437,3635975757,320
1360281340,702723932,8,2954,369.25,1360281314797,1360281314925,702698729,702698857,128
1360281340,702723932,9,2632,292.4444444,1360281314923,1360281315179,702698855,702699111,256
1360281340,702723940,27,18318,678.4444444,1360281315300,1360281335780,702699240,702719720,20480
1360281340,702723976,4,658,164.5,1360281314304,1360281314432,702698280,702698408,128
1360281340,702723976,46,37179,808.2391304,1360281314431,1360281316735,702698407,702700711,2304
1360281340,702723980,22,1232,56,1360281315517,1360281339197,702699497,702723177,23680
1360281340,702724012,11,616,56,1360281315549,1360281338205,702699561,702722217,22656
1360281340,702724016,12,672,56,1360281315032,1360281339416,702699048,702723432,24384
1360281340,702724020,12,1152,96,1360281315156,1360281339476,702699176,702723496,24320
1360281340,702724020,22,1232,56,1360281315283,1360281339091,702699303,702723111,23808
1360281340,702724068,14,2660,190,1360281314342,1360281318694,702698410,702702762,4352
1360281343,3636006024,24,26623,1109.291667,1360281315103,1360281341407,3635978127,3636004431,26304
1360281343,3636006032,15,15370,1024.666667,1360281316119,1360281317143,3635979151,3635980175,1024
1360281343,3636006032,14,13888,992,1360281316629,1360281316949,3635979661,3635979981,320
1360281343,3636006060,20,15154,757.7,1360281316090,1360281317242,3635979150,3635980302,1152
1360281343,3636006060,13,728,56,1360281316092,1360281342716,3635979152,3636005776,26624
1360281343,3636006072,9,6350,705.5555556,1360281316590,1360281317102,3635979662,3635980174,512
1360281343,3636006076,7,5273,753.2857143,1360281317163,1360281317547,3635980239,3635980623,384
1360281344,702727948,21,15690,747.1428571,1360281316830,1360281335902,702700778,702719850,19072
1360281344,702727948,14,10175,726.7857143,1360281316829,1360281318557,702700777,702702505,1728
1360281344,702727976,11,6793,617.5454545,1360281317442,1360281336002,702701418,702719978,18560
1360281344,702727976,50,62197,1243.94,1360281317506,1360281335554,702701482,702719530,18048
1360281344,702727976,5,2980,596,1360281317506,1360281319042,702701482,702703018,1536
1360281344,702727976,79,99399,1258.21519,1360281317570,1360281335874,702701546,702719850,18304
1360281344,702727976,5,3162,632.4,1360281317633,1360281318145,702701609,702702121,512
1360281344,702727976,45,58550,1301.111111,1360281317632,1360281317952,702701608,702701928,320
1360281344,702727976,18,12702,705.6666667,1360281317632,1360281343808,702701608,702727784,26176
1360281344,702727984,8,1199,149.875,1360281318393,1360281318969,702702377,702702953,576
1360281344,702727984,7,3465,495,1360281318648,1360281319096,702702632,702703080,448
1360281344,702727988,6,522,87,1360281319092,1360281319348,702703080,702703336,256
1360281344,702727988,23,12138,527.7391304,1360281319092,1360281320180,702703080,702704168,1088
1360281344,702727988,12,3609,300.75,1360281319092,1360281320116,702703080,702704104,1024
1360281344,702727988,7,681,97.28571429,1360281319156,1360281319924,702703144,702703912,768
1360281344,702728028,15,10199,679.9333333,1360281316748,1360281318540,702700776,702702568,1792
1360281344,702728092,46,45795,995.5434783,1360281318990,1360281340878,702703082,702724970,21888
1360281347,702730852,3,150,50,1360281340157,1360281345853,702724009,702729705,5696
1360281347,702730852,2,98,49,1360281340221,1360281345853,702724073,702729705,5632
1360281347,702730852,2,98,49,1360281340221,1360281345853,702724073,702729705,5632
1360281347,702730856,7,1393,199,1360281344377,1360281345785,702728233,702729641,1408
1360281347,702730856,3,344,114.6666667,1360281344440,1360281346680,702728296,702730536,2240
1360281347,702730856,2,98,49,1360281339320,1360281345848,702723176,702729704,6528
1360281347,702730856,6,1523,253.8333333,1360281344504,1360281345912,702728360,702729768,1408
1360281347,702730856,17,3759,221.1176471,1360281344439,1360281346807,702728295,702730663,2368
1360281347,702730860,11,6283,571.1818182,1360281344502,1360281345910,702728362,702729770,1408
1360281347,702730860,7,1555,222.1428571,1360281344502,1360281345910,702728362,702729770,1408
1360281347,702730860,4,467,116.75,1360281340981,1360281342965,702724841,702726825,1984
1360281347,702730860,11,9532,866.5454545,1360281341109,1360281343285,702724969,702727145,2176
1360281347,702730860,4,186,46.5,1360281339700,1360281345844,702723560,702729704,6144
1360281347,702730860,2,98,49,1360281339636,1360281345844,702723496,702729704,6208
1360281347,702730860,4,196,49,1360281339764,1360281345844,702723624,702729704,6080
1360281347,702730860,2,98,49,1360281339700,1360281345844,702723560,702729704,6144
1360281347,702730864,9,2298,255.3333333,1360281341615,1360281346863,702725479,702730727,5248
1360281347,702730888,6,1134,189,1360281345818,1360281346266,702729706,702730154,448
1360281347,702730888,6,1372,228.6666667,1360281345880,1360281346328,702729768,702730216,448
1360281347,702730892,14,11099,792.7857143,1360281342550,1360281343830,702726442,702727722,1280
1360281347,702730892,6,1085,180.8333333,1360281342549,1360281343893,702726441,702727785,1344
1360281347,702730892,9,4554,506,1360281342485,1360281345621,702726377,702729513,3136
1360281347,702730892,6,1515,252.5,1360281342549,1360281343893,702726441,702727785,1344
1360281347,702730892,6,513,85.5,1360281342613,1360281343893,702726505,702727785,1280
1360281347,702730900,2,98,49,1360281340171,1360281345803,702724071,702729703,5632
1360281347,702730900,2,98,49,1360281340171,1360281345803,702724071,702729703,5632
1360281347,702730904,4,190,47.5,1360281336071,1360281342535,702719975,702726439,6464
1360281347,702730904,2,98,49,1360281339272,1360281345800,702723176,702729704,6528
1360281347,702730904,12,5029,419.0833333,1360281344327,1360281346567,702728231,702730471,2240
1360281347,702730908,6,1464,244,1360281344451,1360281345859,702728359,702729767,1408
1360281347,702730908,4,325,81.25,1360281344387,1360281345795,702728295,702729703,1408
1360281347,702730908,28,31672,1131.142857,1360281344454,1360281345862,702728362,702729770,1408
1360281347,702730932,3,140,46.66666667,1360281340907,1360281346731,702724839,702730663,5824
1360281347,702730932,2,98,49,1360281339565,1360281345773,702723497,702729705,6208
1360281347,702730932,13,13989,1076.076923,1360281341036,1360281342444,702724968,702726376,1408
1360281347,702730932,5,2965,593,1360281339628,1360281340140,702723560,702724072,512
1360281347,702730932,5,459,91.8,1360281339691,1360281340779,702723623,702724711,1088
1360281347,702730944,7,2484,354.8571429,1360281345827,1360281346275,702729771,702730219,448
1360281347,702730944,7,1469,209.8571429,1360281345826,1360281346402,702729770,702730346,576
1360281347,702730944,12,8094,674.5,1360281337826,1360281342434,702721770,702726378,4608
1360281347,702730944,5,1067,213.4,1360281342496,1360281343776,702726440,702727720,1280
1360281347,702730944,4,190,47.5,1360281342496,1360281345568,702726440,702729512,3072
1360281347,702730944,8,5884,735.5,1360281342431,1360281343775,702726375,702727719,1344
1360281347,702730944,7,1504,214.8571429,1360281342495,1360281343839,702726439,702727783,1344
1360281347,702730944,12,6649,554.0833333,1360281342495,1360281344031,702726439,702727975,1536
1360281347,702730948,8,2418,302.25,1360281346333,1360281346461,702730281,702730409,128
1360281347,702730948,5,376,75.2,1360281346460,1360281346588,702730408,702730536,128
1360281347,702730972,5,1074,214.8,1360281343812,1360281344388,702727784,702728360,576
1360281348,702731932,1,46,46,1360281323182,1360281323182,702707114,702707114,0
1360281348,702732008,1,46,46,1360281322849,1360281322849,702706857,702706857,0
1360281348,702732084,2,98,49,1360281322452,1360281322580,702706536,702706664,128
1360281350,3636013536,2,98,49,1360281339039,1360281345567,3636002575,3636009103,6528
1360281350,3636013536,2,98,49,1360281339934,1360281345566,3636003470,3636009102,5632
1360281350,3636013540,3,144,48,1360281341338,1360281346586,3636004878,3636010126,5248
1360281350,3636013544,3,144,48,1360281342103,1360281347607,3636005647,3636011151,5504
1360281355,702738844,28,28612,1021.857143,1360281340165,1360281349573,702724009,702733417,9408
1360281355,702738856,73,84898,1162.986301,1360281337338,1360281352570,702721194,702736426,15232
1360281355,702738888,7,1884,269.1428571,1360281337818,1360281350554,702721706,702734442,12736
1360281355,702738888,3,138,46,1360281345818,1360281351834,702729706,702735722,6016
1360281355,702738888,2,92,46,1360281345944,1360281351960,702729832,702735848,6016
1360281355,702738892,3,144,48,1360281342549,1360281348821,702726441,702732713,6272
1360281355,702738892,2,92,46,1360281346388,1360281351956,702730280,702735848,5568
1360281355,702738896,3,138,46,1360281346383,1360281351823,702730279,702735719,5440
1360281355,702738900,93,110317,1186.204301,1360281340107,1360281350475,702724007,702734375,10368
1360281355,702738904,3,138,46,1360281344391,1360281349767,702728295,702733671,5376
1360281355,702738904,3,144,48,1360281344391,1360281350919,702728295,702734823,6528
1360281355,702738904,4,190,47.5,1360281344391,1360281349831,702728295,702733735,5440
1360281355,702738908,2,98,49,1360281344454,1360281350790,702728362,702734698,6336
1360281355,702738936,155,187606,1210.36129,1360281337513,1360281352489,702721449,702736425,14976
1360281355,702738936,4,190,47.5,1360281345577,1360281351081,702729513,702735017,5504
1360281355,702738936,69,81673,1183.666667,1360281337640,1360281352488,702721576,702736424,14848
1360281355,702738936,4,196,49,1360281345767,1360281351847,702729703,702735783,6080
1360281355,702738940,39,37354,957.7948718,1360281337765,1360281352485,702721705,702736425,14720
1360281355,702738940,3,144,48,1360281342563,1360281348899,702726503,702732839,6336
1360281355,702738944,9,2687,298.5555556,1360281342494,1360281348446,702726438,702732390,5952
1360281356,702740024,1,46,46,1360281331599,1360281331599,702715623,702715623,0
1360281360,702744000,1,46,46,1360281334248,1360281334248,702718248,702718248,0
1360281360,702744072,1,46,46,1360281334175,1360281334175,702718247,702718247,0
1360281360,702744076,1,46,46,1360281334173,1360281334173,702718249,702718249,0
1360281363,3636026072,6,3923,653.8333333,1360281338093,1360281338797,3636001165,3636001869,704
1360281363,702746948,133,160540,1207.067669,1360281337756,1360281355804,702721704,702739752,18048
1360281364,702747992,38,43015,1131.973684,1360281337774,1360281342126,702721766,702726118,4352
1360281364,702748032,40,43945,1098.625,1360281339144,1360281342088,702723176,702726120,2944
1360281364,702748040,3,512,170.6666667,1360281339522,1360281343938,702723562,702727978,4416
1360281364,702748040,5,972,194.4,1360281339522,1360281343106,702723562,702727146,3584
1360281364,702748064,6,3295,549.1666667,1360281337704,1360281338344,702721768,702722408,640
1360281364,702748064,9,8517,946.3333333,1360281337703,1360281338919,702721767,702722983,1216
1360281364,702748072,9,3187,354.1111111,1360281338401,1360281339169,702722473,702723241,768
1360281367,3636030032,8,2343,292.875,1360281341208,1360281344088,3636004240,3636007120,2880
1360281367,3636030068,6,3780,630,1360281340403,1360281342451,3636003471,3636005519,2048
1360281367,3636030072,32,37694,1177.9375,1360281341167,1360281341743,3636004239,3636004815,576
1360281368,702751948,15,840,56,1360281339996,1360281367580,702723944,702751528,27584
1360281368,702751948,12,10217,851.4166667,1360281340123,1360281342171,702724071,702726119,2048
1360281368,702751952,14,784,56,1360281340376,1360281367448,702724328,702751400,27072
1360281368,702751956,78,73476,942,1360281340884,1360281344084,702724840,702728040,3200
1360281368,702751984,23,24568,1068.173913,1360281341689,1360281341817,702725673,702725801,128
1360281368,702752024,42,51023,1214.833333,1360281339985,1360281343825,702724009,702727849,3840
1360281368,702752024,3,401,133.6666667,1360281339985,1360281340561,702724009,702724585,576
1360281368,702752024,7,392,56,1360281339985,1360281362065,702724009,702746089,22080
1360281368,702752024,6,4536,756,1360281339985,1360281340433,702724009,702724457,448
1360281368,702752024,4,553,138.25,1360281339985,1360281343825,702724009,702727849,3840
1360281368,702752024,14,12346,881.8571429,1360281340048,1360281341904,702724072,702725928,1856
1360281368,702752032,7,392,56,1360281340809,1360281364681,702724841,702748713,23872
1360281368,702752036,7,672,96,1360281341188,1360281367172,702725224,702751208,25984
1360281368,702752064,4,590,147.5,1360281342376,1360281343208,702726440,702727272,832
1360281371,3636034024,36,42525,1181.25,1360281344544,1360281369760,3636007568,3636032784,25216
1360281371,3636034024,43,50713,1179.372093,1360281344608,1360281346208,3636007632,3636009232,1600
1360281371,3636034024,6,336,56,1360281344926,1360281369246,3636007950,3636032270,24320
1360281371,3636034052,43,46754,1087.302326,1360281344579,1360281345987,3636007631,3636009039,1408
1360281372,702755952,3,2801,933.6666667,1360281344150,1360281344150,702728102,702728102,0
1360281372,702755956,4,583,145.75,1360281344339,1360281344915,702728295,702728871,576
1360281372,702755956,4,629,157.25,1360281344339,1360281345043,702728295,702728999,704
1360281372,702755992,1,137,137,1360281345519,1360281345519,702729511,702729511,0
1360281372,702756032,5,1701,340.2,1360281344263,1360281344775,702728295,702728807,512
1360281372,702756032,4,834,208.5,1360281344263,1360281344839,702728295,702728871,576
1360281372,702756036,4,629,157.25,1360281344258,1360281344898,702728294,702728934,640
1360281372,702756036,5,641,128.2,1360281344262,1360281345030,702728298,702729066,768
1360281372,702756068,6,2425,404.1666667,1360281345764,1360281346212,702729832,702730280,448
1360281380,702764012,1,46,46,1360281353434,1360281353434,702737446,702737446,0
1360281384,702768020,3,169,56.33333333,1360281359445,1360281359509,702743465,702743529,64
1360281387,702770868,3,144,48,1360281380843,1360281386411,702764711,702770279,5568
1360281387,702770868,2,98,49,1360281380843,1360281386347,702764711,702770215,5504
1360281388,702772036,2,123,61.5,1360281361477,1360281361477,702745513,702745513,0
1360281388,702772120,14,3496,249.7142857,1360281361970,1360281381938,702746090,702766058,19968
1360281390,3636053544,3,144,48,1360281380056,1360281386136,3636043600,3636049680,6080
1360281390,3636053552,4,190,47.5,1360281383440,1360281389200,3636046992,3636052752,5760
1360281392,702776000,2,123,61.5,1360281364457,1360281364521,702748457,702748521,64
1360281392,702776080,2,123,61.5,1360281364375,1360281364375,702748455,702748455,0
1360281396,702780056,4,224,56,1360281369263,1360281389295,702753319,702773351,20032
1360281396,702780060,4,384,96,1360281369453,1360281392301,702753513,702776361,22848
1360281396,702780060,5,4659,931.8,1360281369516,1360281369516,702753576,702753576,0
1360281396,702780060,6,938,156.3333333,1360281369643,1360281369899,702753703,702753959,256
1360281396,702780096,3,138,46,1360281368263,1360281368263,702752359,702752359,0
1360281396,702780096,4,224,56,1360281368263,1360281388231,702752359,702772327,19968
1360281396,702780132,7,392,56,1360281368933,1360281388645,702753065,702772777,19712
1360281396,702780132,7,392,56,1360281369123,1360281389091,702753255,702773223,19968
1360281404,702788044,3,138,46,1360281379772,1360281379836,702763816,702763880,64
1360281407,3636070040,11,11571,1051.909091,1360281380304,1360281380560,3636043344,3636043600,256
1360281407,3636070040,9,9807,1089.666667,1360281380368,1360281380432,3636043408,3636043472,64
1360281407,3636070084,3,2646,882,1360281380197,1360281380197,3636043281,3636043281,0
1360281408,702792016,6,522,87,1360281380504,1360281380568,702764520,702764584,64
1360281408,702792092,7,687,98.14285714,1360281380365,1360281380557,702764457,702764649,192
1360281408,702792144,3,169,56.33333333,1360281383320,1360281383320,702767464,702767464,0
1360281411,3636074032,10,7088,708.8,1360281383959,1360281384599,3636046991,3636047631,640
1360281411,3636074064,13,13015,1001.153846,1360281383926,1360281384118,3636046990,3636047182,192
1360281411,3636074076,3,168,56,1360281384617,1360281388777,3636047693,3636051853,4160
1360281412,702796000,1,137,137,1360281383977,1360281383977,702767977,702767977,0
1360281412,702796008,6,2130,355,1360281384352,1360281384544,702768360,702768552,192
1360281412,702796012,28,19639,701.3928571,1360281384540,1360281385116,702768552,702769128,576
1360281412,702796044,2,123,61.5,1360281385341,1360281385405,702769385,702769449,64
1360281412,702796080,7,5047,721,1360281384022,1360281384214,702768102,702768294,192
1360281412,702796132,2,123,61.5,1360281386274,1360281386274,702770406,702770406,0
1360281416,702800020,2,92,46,1360281388308,1360281388372,702772328,702772392,64
1360281416,702800020,3,138,46,1360281388308,1360281388372,702772328,702772392,64
1360281416,702800020,2,123,61.5,1360281388435,1360281388435,702772455,702772455,0
1360281419,702802888,3,144,48,1360281408215,1360281413527,702792103,702797415,5312
1360281419,702802984,3,144,48,1360281407225,1360281412473,702791209,702796457,5248
1360281420,702804032,3,138,46,1360281392329,1360281392329,702776361,702776361,0
1360281424,702808148,3,138,46,1360281398674,1360281398738,702782822,702782886,64
1360281427,702810992,5,437,87.4,1360281422193,1360281422449,702806185,702806441,256
1360281428,702812100,6,1382,230.3333333,1360281402947,1360281406083,702787047,702790183,3136
1360281428,702812152,3,138,46,1360281402318,1360281402382,702786470,702786534,64
1360281430,3636093536,3,144,48,1360281422302,1360281428190,3636085838,3636091726,5888
1360281432,702816076,15,12216,814.4,1360281407260,1360281421468,702791336,702805544,14208
1360281432,702816076,6,5240,873.3333333,1360281407451,1360281407899,702791527,702791975,448
1360281432,702816080,8,5785,723.125,1360281407641,1360281408089,702791721,702792169,448
1360281432,702816108,2,123,61.5,1360281404285,1360281404349,702788393,702788457,64
1360281432,702816144,2,123,61.5,1360281406297,1360281406297,702790441,702790441,0
1360281432,702816156,5,3276,655.2,1360281407305,1360281407433,702791461,702791589,128
1360281432,702816156,11,7384,671.2727273,1360281407309,1360281421389,702791465,702805545,14080
1360281432,702816156,8,6450,806.25,1360281407500,1360281407948,702791656,702792104,448
1360281435,702818916,2,98,49,1360281422525,1360281428413,702806441,702812329,5888
1360281435,702818984,3,138,46,1360281433399,1360281433463,702817383,702817447,64
1360281436,702820040,3,138,46,1360281408321,1360281408321,702792361,702792361,0
1360281436,702820048,1,77,77,1360281408632,1360281408632,702792680,702792680,0
1360281436,702820128,2,123,61.5,1360281408551,1360281408615,702792679,702792743,64
1360281443,702826900,2,98,49,1360281432205,1360281437453,702816105,702821353,5248
1360281443,702826904,36,41436,1151,1360281436613,1360281437125,702820517,702821029,512
1360281443,702826904,38,44868,1180.736842,1360281436613,1360281437381,702820517,702821285,768
1360281443,702826904,44,51517,1170.840909,1360281436677,1360281437573,702820581,702821477,896
1360281443,702826908,1284,1813160,1412.11838,1360281437188,1360281441092,702821096,702825000,3904
1360281443,702826908,4,196,49,1360281437188,1360281442884,702821096,702826792,5696
1360281443,702826908,8,535,66.875,1360281437187,1360281442435,702821095,702826343,5248
1360281443,702826908,10,2344,234.4,1360281437187,1360281442435,702821095,702826343,5248
1360281443,702826908,3,144,48,1360281435714,1360281441410,702819622,702825318,5696
1360281443,702826908,3,144,48,1360281435714,1360281441474,702819622,702825382,5760
1360281443,702826912,4,629,157.25,1360281437504,1360281437696,702821416,702821608,192
1360281443,702826916,5,907,181.4,1360281437693,1360281438077,702821609,702821993,384
1360281443,702826936,14,5768,412,1360281438566,1360281439206,702822502,702823142,640
1360281443,702826940,20,12285,614.25,1360281439202,1360281440162,702823142,702824102,960
1360281443,702826944,2,98,49,1360281431328,1360281437408,702815272,702821352,6080
1360281443,702826948,16,7756,484.75,1360281440219,1360281441051,702824167,702824999,832
1360281443,702826952,56,66728,1191.571429,1360281436569,1360281437529,702820521,702821481,960
1360281443,702826976,2,98,49,1360281437120,1360281442368,702821096,702826344,5248
1360281443,702826976,3,144,48,1360281437119,1360281442559,702821095,702826535,5440
1360281443,702826980,4,190,47.5,1360281435645,1360281441341,702819625,702825321,5696
1360281446,3636109548,3,144,48,1360281436883,1360281442195,3636100431,3636105743,5312
1360281447,3636110016,12,672,56,1360281422633,1360281446889,3636085649,3636109905,24256
1360281447,3636110024,3,2163,721,1360281421408,1360281421408,3636084432,3636084432,0
1360281448,702832108,3,138,46,1360281421243,1360281421307,702805351,702805415,64
1360281448,702832216,6,1423,237.1666667,1360281421520,1360281421840,702805736,702806056,320
1360281448,702832216,25,1400,56,1360281421839,1360281447503,702806055,702831719,25664
1360281448,702832216,24,1344,56,1360281421646,1360281447246,702805862,702831462,25600
1360281448,702832220,6,870,145,1360281422092,1360281437708,702806312,702821928,15616
1360281448,702832220,26,16648,640.3076923,1360281422027,1360281437899,702806247,702822119,15872
1360281448,702832268,4,679,169.75,1360281421148,1360281421468,702805416,702805736,320
1360281448,702832284,12,672,56,1360281421898,1360281445706,702806182,702829990,23808
1360281451,702834904,11,4973,452.0909091,1360281440327,1360281446407,702824231,702830311,6080
1360281451,702834912,2,92,46,1360281437504,1360281443392,702821416,702827304,5888
1360281451,702834912,3,325,108.3333333,1360281437693,1360281443453,702821605,702827365,5760
1360281451,702834916,7,412,58.85714286,1360281449276,1360281449340,702833192,702833256,64
1360281451,702834944,13,6505,500.3846154,1360281433825,1360281449441,702817769,702833385,15616
1360281451,702834944,5,465,93,1360281431007,1360281447327,702814951,702831271,16320
1360281451,702834976,9,2310,256.6666667,1360281443520,1360281449344,702827496,702833320,5824
1360281451,702834976,9,2292,254.6666667,1360281443583,1360281449279,702827559,702833255,5696
1360281451,702834976,5,648,129.6,1360281435582,1360281446846,702819558,702830822,11264
1360281451,702834980,3,138,46,1360281437435,1360281446267,702821415,702830247,8832
1360281451,702834980,2,279,139.5,1360281437626,1360281443322,702821606,702827302,5696
1360281451,702834980,10,4897,489.7,1360281441082,1360281446330,702825062,702830310,5248
1360281451,702834980,10,4897,489.7,1360281441082,1360281446330,702825062,702830310,5248
1360281451,702834984,3,144,48,1360281437944,1360281443320,702821928,702827304,5376
1360281451,702834984,2,98,49,1360281438008,1360281443320,702821992,702827304,5312
1360281451,702834984,10,5729,572.9,1360281438134,1360281443318,702822118,702827302,5184
1360281451,702834984,2,92,46,1360281438005,1360281443317,702821989,702827301,5312
1360281451,702834988,8,612,76.5,1360281441778,1360281450290,702825766,702834278,8512
1360281451,702834992,5,462,92.4,1360281430959,1360281448303,702814951,702832295,17344
1360281451,702834992,5,463,92.6,1360281430959,1360281450287,702814951,702834279,19328
1360281452,702836172,2,123,61.5,1360281427581,1360281427581,702811753,702811753,0
1360281456,702840124,2,123,61.5,1360281429611,1360281429611,702813735,702813735,0
1360281456,702840136,6,1115,185.8333333,1360281430815,1360281451359,702814951,702835495,20544
1360281456,702840136,39,38214,979.8461538,1360281430814,1360281451358,702814950,702835494,20544
1360281456,702840176,1,137,137,1360281428471,1360281428471,702812647,702812647,0
1360281456,702840212,2,92,46,1360281430097,1360281430161,702814309,702814373,64
1360281456,702840220,83,68753,828.3493976,1360281430473,1360281453513,702814693,702837733,23040
1360281456,702840220,2,123,61.5,1360281430540,1360281430540,702814760,702814760,0
1360281456,702840244,15,840,56,1360281431667,1360281454259,702815911,702838503,22592
1360281459,3636122076,1,46,46,1360281432683,1360281432683,3636095759,3636095759,0
1360281459,702842900,62,77855,1255.725806,1360281452042,1360281452490,702835942,702836390,448
1360281459,702842900,33,37557,1138.090909,1360281452042,1360281452490,702835942,702836390,448
1360281459,702842904,3,144,48,1360281452295,1360281457543,702836199,702841447,5248
1360281459,702842904,2,98,49,1360281452358,1360281457542,702836262,702841446,5184
1360281459,702842908,2,98,49,1360281451268,1360281456516,702835176,702840424,5248
1360281459,702842908,6,366,61,1360281451395,1360281451459,702835303,702835367,64
1360281459,702842908,3,138,46,1360281451521,1360281451521,702835429,702835429,0
1360281459,702842912,3,138,46,1360281451585,1360281458369,702835497,702842281,6784
1360281459,702842912,8,458,57.25,1360281453374,1360281453438,702837286,702837350,64
1360281459,702842912,45,54085,1201.888889,1360281451838,1360281452350,702835750,702836262,512
1360281459,702842952,2,98,49,1360281452246,1360281457494,702836198,702841446,5248
1360281459,702842952,3,144,48,1360281452310,1360281457558,702836262,702841510,5248
1360281459,702842952,1128,1593381,1412.571809,1360281452310,1360281455190,702836262,702839142,2880
1360281459,702842976,8,458,57.25,1360281453312,1360281453376,702837288,702837352,64
1360281459,702842976,29,32030,1104.482759,1360281451774,1360281452350,702835750,702836326,576
1360281459,3636122404,6,827,137.8333333,1360281432099,1360281451107,3636095503,3636114511,19008
1360281459,3636122404,2,92,46,1360281432354,1360281432354,3636095758,3636095758,0
1360281460,702844088,8,1542,192.75,1360281435470,1360281451854,702819558,702835942,16384
1360281460,702844092,7,1204,172,1360281435533,1360281451469,702819625,702835561,15936
1360281460,702844156,17,1632,96,1360281431817,1360281457225,702815973,702841381,25408
1360281460,702844172,2,460,230,1360281432508,1360281432572,702816680,702816744,64
1360281460,702844172,2,123,61.5,1360281432571,1360281432571,702816743,702816743,0
1360281460,702844200,3,138,46,1360281433119,1360281433183,702817319,702817383,64
1360281460,702844212,6,2207,367.8333333,1360281434002,1360281434194,702818214,702818406,192
1360281464,702848100,35,37709,1077.4,1360281437505,1360281437953,702821605,702822053,448
1360281464,702848128,7,2966,423.7142857,1360281437863,1360281452455,702821991,702836583,14592
1360281464,702848136,19,7648,402.5263158,1360281438621,1360281439709,702822757,702823845,1088
1360281464,702848140,1,46,46,1360281438875,1360281438875,702823015,702823015,0
1360281464,702848176,9,1357,150.7777778,1360281436919,1360281437623,702821095,702821799,704
1360281464,702848204,19,10182,535.8947368,1360281437915,1360281441051,702822119,702825255,3136
1360281464,702848216,7,2656,379.4285714,1360281439439,1360281439567,702823655,702823783,128
1360281467,702850928,5,648,129.6,1360281451246,1360281462766,702835174,702846694,11520
1360281467,702850972,5,460,92,1360281462788,1360281462980,702846760,702846952,192
1360281468,702852112,14,5702,407.2857143,1360281443383,1360281446199,702827495,702830311,2816
1360281468,702852140,14,9302,664.4285714,1360281441116,1360281441564,702825256,702825704,448
1360281468,702852148,41,38908,948.9756098,1360281442001,1360281446097,702826149,702830245,4096
1360281470,3636133544,6,288,48,1360281462807,1360281469655,3636126351,3636133199,6848
1360281472,702856164,2,92,46,1360281445188,1360281445252,702829352,702829416,64
1360281472,702856164,8,3371,421.375,1360281445124,1360281445892,702829288,702830056,768
1360281472,702856208,7,1922,274.5714286,1360281445720,1360281446040,702829928,702830248,320
1360281472,702856212,6,1947,324.5,1360281446291,1360281452563,702830503,702836775,6272
1360281472,702856308,86,82720,961.8604651,1360281445617,1360281447601,702829925,702831909,1984
1360281475,3636138080,8,448,56,1360281448552,1360281463848,3636111632,3636126928,15296
1360281475,702858924,7,412,58.85714286,1360281472625,1360281472881,702856549,702856805,256
1360281475,702858924,5,1455,291,1360281451633,1360281467825,702835557,702851749,16192
1360281475,702858992,4,184,46,1360281472430,1360281473710,702856422,702857702,1280
1360281475,702859004,3,144,48,1360281461667,1360281467747,702845671,702851751,6080
1360281476,702860192,16,896,56,1360281449000,1360281474408,702833192,702858600,25408
1360281476,702860192,16,896,56,1360281449127,1360281474855,702833319,702859047,25728
1360281476,702860224,9,504,56,1360281447880,1360281474952,702832104,702859176,27072
1360281476,702860228,2,460,230,1360281450945,1360281450945,702835173,702835173,0
1360281479,3636142052,2,92,46,1360281454787,1360281454787,3636117839,3636117839,0
1360281480,702864136,25,15046,601.84,1360281451871,1360281475231,702836007,702859367,23360
1360281480,702864184,2,92,46,1360281454256,1360281454256,702838440,702838440,0
1360281480,702864224,6,870,145,1360281452423,1360281475207,702836647,702859431,22784
1360281483,3636146096,1,46,46,1360281457750,1360281457750,3636120846,3636120846,0
1360281483,3636146096,1,46,46,1360281457750,1360281457750,3636120846,3636120846,0
1360281483,702866920,6,366,61,1360281475000,1360281475000,702858920,702858920,0
1360281483,702866924,5,460,92,1360281475315,1360281475635,702859239,702859559,320
1360281483,702866928,8,458,57.25,1360281476912,1360281476976,702860840,702860904,64
1360281483,702866972,7,412,58.85714286,1360281474948,1360281474948,702858920,702858920,0
1360281484,702868160,7,392,56,1360281456261,1360281479877,702840421,702864037,23616
1360281484,702868164,2,92,46,1360281456260,1360281456260,702840424,702840424,0
1360281484,702868164,1,46,46,1360281456323,1360281456323,702840487,702840487,0
1360281484,702868200,1,46,46,1360281457246,1360281457246,702841446,702841446,0
1360281484,702868200,2,92,46,1360281457246,1360281457246,702841446,702841446,0
1360281484,702868280,1,46,46,1360281457165,1360281457165,702841445,702841445,0
1360281484,702868284,1,46,46,1360281457163,1360281457163,702841447,702841447,0
1360281486,3636149532,3,144,48,1360281475428,1360281481252,3636138960,3636144784,5824
1360281487,3636150032,4,2764,691,1360281462615,1360281462743,3636125647,3636125775,128
1360281487,3636150036,2,92,46,1360281459796,1360281459796,3636122832,3636122832,0
1360281487,3636150056,6,3793,632.1666667,1360281461440,1360281462848,3636124496,3636125904,1408
1360281487,3636150056,1,46,46,1360281462014,1360281462014,3636125070,3636125070,0
1360281487,3636150064,4,3792,948,1360281462647,1360281462647,3636125711,3636125711,0
1360281487,3636150068,3,1810,603.3333333,1360281462900,1360281462900,3636125968,3636125968,0
1360281487,3636150088,1,46,46,1360281461985,1360281461985,3636125073,3636125073,0
1360281488,702872152,2,92,46,1360281460303,1360281460303,702844455,702844455,0
1360281488,702872160,6,576,96,1360281460870,1360281480134,702845030,702864294,19264
1360281488,702872164,8,3703,462.875,1360281461059,1360281474691,702845223,702858855,13632
1360281488,702872164,3,1724,574.6666667,1360281461185,1360281461249,702845349,702845413,64
1360281488,702872192,31,29747,959.5806452,1360281461733,1360281474533,702845925,702858725,12800
1360281488,702872240,2,92,46,1360281460214,1360281460214,702844454,702844454,0
1360281488,702872240,1,46,46,1360281460341,1360281460341,702844581,702844581,0
1360281488,702872272,25,15727,629.08,1360281460823,1360281480023,702845095,702864295,19200
1360281488,702872272,16,11759,734.9375,1360281461013,1360281474453,702845285,702858725,13440
1360281488,702872276,3,1551,517,1360281461137,1360281461201,702845413,702845477,64
1360281488,702872312,17,3760,221.1764706,1360281462512,1360281474928,702846824,702859240,12416
1360281491,702874936,3,138,46,1360281485544,1360281485608,702869480,702869544,64
1360281491,702874936,6,370,61.66666667,1360281486181,1360281490853,702870117,702874789,4672
1360281491,702875040,3,144,48,1360281490622,1360281490686,702874662,702874726,64
1360281493,702876468,1,137,137,1360281465212,1360281465212,702848680,702848680,0
1360281497,702880420,3,138,46,1360281472427,1360281472491,702855847,702855911,64
1360281499,702882932,4,190,47.5,1360281493353,1360281494121,702877285,702878053,768
1360281499,702883016,3,144,48,1360281494422,1360281494486,702878438,702878502,64
1360281501,702884388,3,603,201,1360281475596,1360281475852,702858984,702859240,256
1360281501,702884388,2,712,356,1360281475722,1360281475786,702859110,702859174,64
1360281503,3636166064,9,504,56,1360281475961,1360281501689,3636139025,3636164753,25728
1360281505,702888396,17,952,56,1360281476866,1360281504450,702860262,702887846,27584
1360281505,702888480,17,952,56,1360281476847,1360281503663,702860327,702887143,26816
1360281505,702888488,8,448,56,1360281477671,1360281501735,702861159,702885223,24064
1360281507,702890916,3,138,46,1360281500409,1360281500665,702884325,702884581,256
1360281507,702890928,5,675,135,1360281499440,1360281499824,702883368,702883752,384
1360281507,702890928,5,643,128.6,1360281499503,1360281499887,702883431,702883815,384
1360281507,702891000,3,325,108.3333333,1360281499749,1360281505381,702883749,702889381,5632
1360281507,702891004,2,279,139.5,1360281499748,1360281505316,702883752,702889320,5568
1360281507,702891012,10,3136,313.6,1360281503258,1360281503386,702887270,702887398,128
1360281513,702896452,7,392,56,1360281488137,1360281506377,702871589,702889829,18240
1360281513,702896456,1,46,46,1360281488072,1360281488072,702871528,702871528,0
1360281517,702900420,1,46,46,1360281492587,1360281492587,702876007,702876007,0
1360281517,702900424,8,768,96,1360281490341,1360281514469,702873765,702897893,24128
1360281517,702900504,1,46,46,1360281490262,1360281490262,702873766,702873766,0
1360281521,702904404,1,46,46,1360281493243,1360281493243,702876647,702876647,0
1360281521,702904412,1,46,46,1360281494067,1360281494067,702877479,702877479,0
1360281521,702904412,20,10590,529.5,1360281494449,1360281503921,702877861,702887333,9472
1360281521,702904440,26,20023,770.1153846,1360281494997,1360281500821,702878437,702884261,5824
1360281521,702904440,16,4339,271.1875,1360281495124,1360281500884,702878564,702884324,5760
1360281521,702904488,47,37370,795.106383,1360281493861,1360281500005,702877349,702883493,6144
1360281521,702904492,1,46,46,1360281494241,1360281494241,702877733,702877733,0
1360281523,3636186060,2,92,46,1360281495741,1360281495741,3636158801,3636158801,0
1360281525,702908420,12,3619,301.5833333,1360281499944,1360281500456,702883364,702883876,512
1360281525,702908448,8,3205,400.625,1360281500302,1360281500494,702883750,702883942,192
1360281525,702908452,1,46,46,1360281498056,1360281498056,702881508,702881508,0
1360281525,702908480,53,26621,502.2830189,1360281499309,1360281521133,702882789,702904613,21824
1360281525,702908524,12,3078,256.5,1360281500482,1360281501058,702884006,702884582,576
1360281525,702908532,2,92,46,1360281500729,1360281500921,702884261,702884453,192
1360281525,702908532,1,46,46,1360281500729,1360281500729,702884261,702884261,0
1360281529,702912452,10,3125,312.5,1360281504395,1360281504523,702887847,702887975,128
1360281529,702912452,1,46,46,1360281504394,1360281504394,702887846,702887846,0
1360281529,702912484,10,2262,226.2,1360281502249,1360281519977,702885733,702903461,17728
1360281531,3636194044,5,280,56,1360281505227,1360281528267,3636168271,3636191311,23040
1360281531,702914960,50,32066,641.32,1360281523661,1360281527629,702907621,702911589,3968
1360281531,702915004,4,184,46,1360281523107,1360281527907,702907111,702911911,4800
1360281533,702916424,8,448,56,1360281505829,1360281527973,702889253,702911397,22144
1360281533,702916428,1,46,46,1360281506017,1360281506017,702889445,702889445,0
1360281533,702916436,1,137,137,1360281508696,1360281508696,702892132,702892132,0
1360281533,702916464,9,504,56,1360281504895,1360281528127,702888359,702911591,23232
1360281533,702916468,5,280,56,1360281505146,1360281528250,702888614,702911718,23104
1360281537,702920420,1,46,46,1360281511017,1360281511017,702894437,702894437,0
1360281537,702920472,1,46,46,1360281510966,1360281510966,702894438,702894438,0
1360281539,702922964,112,133221,1189.473214,1360281317514,1360281537098,702701478,702921062,219584
1360281539,702923028,3,138,46,1360281537099,1360281537163,702921127,702921191,64
1360281541,702924404,3,138,46,1360281513145,1360281513145,702896549,702896549,0
1360281541,702924448,12,2946,245.5,1360281514509,1360281514765,702897957,702898213,256
1360281541,702924488,1,46,46,1360281513444,1360281513444,702896932,702896932,0
1360281541,702924492,4,224,56,1360281513440,1360281535328,702896932,702918820,21888
1360281545,702928452,5,3427,685.4,1360281520586,1360281520650,702904038,702904102,64
1360281549,702932472,3,288,96,1360281521589,1360281537589,702905061,702921061,16000
1360281555,702939020,5,251,50.2,1360281553107,1360281553171,702937127,702937191,64
1360281555,702939032,125,155988,1247.904,1360281431236,1360281547076,702815268,702931108,115840
1360281561,702944424,8,448,56,1360281533156,1360281558884,702916580,702942308,25728
1360281561,702944500,9,504,56,1360281532825,1360281559641,702916325,702943141,26816
1360281561,702944552,3,138,46,1360281535271,1360281535335,702918823,702918887,64
1360281563,702946940,3,138,46,1360281557154,1360281557154,702941094,702941094,0
1360281563,702946940,2,92,46,1360281561120,1360281561120,702945060,702945060,0
1360281563,702946948,5,675,135,1360281558425,1360281558617,702942373,702942565,192
1360281563,702946972,2,92,46,1360281562112,1360281562112,702946084,702946084,0
1360281563,702946988,3,138,46,1360281557106,1360281557170,702941094,702941158,64
1360281563,702947020,5,643,128.6,1360281558417,1360281558609,702942437,702942629,192
1360281563,702947020,10,1018,101.8,1360281561616,1360281562000,702945636,702946020,384
1360281563,702947024,2,92,46,1360281562063,1360281562063,702946087,702946087,0
1360281569,702952504,2,123,61.5,1360281544339,1360281544339,702927843,702927843,0
1360281569,702952572,1,46,46,1360281543250,1360281543250,702926822,702926822,0
1360281571,702954964,2,98,49,1360281564616,1360281570760,702948580,702954724,6144
1360281571,702955004,2,279,139.5,1360281558434,1360281564130,702942438,702948134,5696
1360281571,702955016,38,46249,1217.078947,1360281562964,1360281567444,702946980,702951460,4480
1360281571,702955048,8,1870,233.75,1360281565623,1360281567415,702949671,702951463,1792
1360281571,702955048,6,576,96,1360281565622,1360281565878,702949670,702949926,256
1360281571,702955048,4,531,132.75,1360281553269,1360281568693,702937317,702952741,15424
1360281571,702955088,7,851,121.5714286,1360281567693,1360281567885,702951781,702951973,192
1360281573,702956492,1,77,77,1360281545312,1360281545312,702928804,702928804,0
1360281573,702956496,1,77,77,1360281545311,1360281545311,702928807,702928807,0
1360281573,702956520,2,123,61.5,1360281548295,1360281548359,702931815,702931879,64
1360281573,702956524,2,92,46,1360281548543,1360281548543,702932067,702932067,0
1360281573,702956528,24,15049,627.0416667,1360281546174,1360281546558,702929702,702930086,384
1360281573,702956572,2,123,61.5,1360281545232,1360281545296,702928804,702928868,64
1360281573,702956572,9,504,56,1360281547664,1360281571024,702931236,702954596,23360
1360281573,702956572,1,77,77,1360281545232,1360281545232,702928804,702928804,0
1360281573,702956576,2,123,61.5,1360281545231,1360281545231,702928807,702928807,0
1360281573,702956604,1,137,137,1360281546416,1360281546416,702930020,702930020,0
1360281574,3636237536,3,144,48,1360281567137,1360281572577,3636230673,3636236113,5440
1360281574,3636237548,3,144,48,1360281564374,1360281569558,3636227922,3636233106,5184
1360281575,3636238112,9,504,56,1360281548106,1360281570826,3636211218,3636233938,22720
1360281577,702960496,11,5655,514.0909091,1360281549471,1360281566431,702932967,702949927,16960
1360281577,702960496,9,504,56,1360281549597,1360281571677,702933093,702955173,22080
1360281577,702960528,1,46,46,1360281550653,1360281550653,702934181,702934181,0
1360281577,702960572,2,123,61.5,1360281549265,1360281549265,702932837,702932837,0
1360281577,702960576,9,864,96,1360281549581,1360281573133,702933157,702956709,23552
1360281579,702962984,2,94,47,1360281567158,1360281572790,702951142,702956774,5632
1360281579,702963060,6,2125,354.1666667,1360281567591,1360281576423,702951651,702960483,8832
1360281579,702963060,3,138,46,1360281567723,1360281573739,702951783,702957799,6016
1360281579,702963060,5,932,186.4,1360281567785,1360281576745,702951845,702960805,8960
1360281581,702964472,1,46,46,1360281555575,1360281555575,702939047,702939047,0
1360281581,702964540,1,46,46,1360281555505,1360281555505,702939045,702939045,0
1360281581,702964596,2,92,46,1360281554427,1360281554491,702938023,702938087,64
1360281585,702968604,2,123,61.5,1360281559280,1360281559280,702942884,702942884,0
1360281589,702972480,22,16352,743.2727273,1360281563374,1360281568046,702946854,702951526,4672
1360281589,702972480,33,33463,1014.030303,1360281563373,1360281567725,702946853,702951205,4352
1360281589,702972480,28,21319,761.3928571,1360281563373,1360281568109,702946853,702951589,4736
1360281589,702972484,10,9844,984.4,1360281563498,1360281564394,702946982,702947878,896
1360281589,702972496,18,1008,56,1360281561502,1360281588510,702944998,702972006,27008
1360281589,702972560,66,73356,1111.454545,1360281563293,1360281568157,702946853,702951717,4864
1360281589,702972560,26,25643,986.2692308,1360281563293,1360281568029,702946853,702951589,4736
1360281589,702972604,17,952,56,1360281564464,1360281588144,702948068,702971748,23680
1360281591,3636254300,12,11373,947.75,1360281563534,1360281567310,3636226834,3636230610,3776
1360281593,702976532,3,424,141.3333333,1360281567546,1360281567866,702951078,702951398,320
1360281593,702976532,2,595,297.5,1360281568440,1360281568632,702951972,702952164,192
1360281593,702976568,7,1196,170.8571429,1360281565780,1360281566100,702949348,702949668,320
1360281593,702976600,8,5440,680,1360281566836,1360281569140,702950436,702952740,2304
1360281593,702976612,1,46,46,1360281567977,1360281567977,702951589,702951589,0
1360281593,702976616,2,726,363,1360281568357,1360281568933,702951973,702952549,576
1360281595,3636258296,2,92,46,1360281567698,1360281567698,3636230994,3636230994,0
1360281595,702978944,2,706,353,1360281568347,1360281568475,702952291,702952419,128
1360281595,702979048,2,92,46,1360281590710,1360281590710,702974758,702974758,0
1360281595,702979048,3,138,46,1360281590708,1360281591860,702974756,702975908,1152
1360281597,702980520,42,47166,1123,1360281569222,1360281571142,702952742,702954662,1920
1360281597,702980636,42,28757,684.6904762,1360281570063,1360281591375,702953699,702975011,21312
1360281603,3636266304,2,92,46,1360281577802,1360281577802,3636241106,3636241106,0
1360281603,3636266304,1,46,46,1360281577802,1360281577802,3636241106,3636241106,0
1360281603,3636266328,5,280,56,1360281576753,1360281592049,3636240081,3636255377,15296
1360281603,3636266332,1,46,46,1360281577772,1360281577772,3636241104,3636241104,0
1360281603,3636266332,1,46,46,1360281577772,1360281577772,3636241104,3636241104,0
1360281605,702988536,17,5009,294.6470588,1360281580854,1360281604726,702964390,702988262,23872
1360281605,702988540,2,92,46,1360281577136,1360281577200,702960676,702960740,64
1360281605,702988540,1,46,46,1360281577136,1360281577136,702960676,702960676,0
1360281605,702988612,6,336,56,1360281576873,1360281601257,702960485,702984869,24384
1360281605,702988660,5,280,56,1360281580729,1360281594041,702964389,702977701,13312
1360281609,702992540,5,480,96,1360281580978,1360281594482,702964518,702978022,13504
1360281611,3636274280,4,875,218.75,1360281585121,1360281585249,3636248401,3636248529,128
1360281613,702996580,3,138,46,1360281588745,1360281588809,702972325,702972389,64
1360281613,702996584,3,138,46,1360281586757,1360281586757,702970341,702970341,0
1360281613,702996584,2,274,137,1360281587076,1360281588036,702970660,702971620,960
1360281617,703000552,4,224,56,1360281589155,1360281598499,702972707,702982051,9344
1360281617,703000556,2,123,61.5,1360281589218,1360281589282,702972774,702972838,64
1360281617,703000564,2,123,61.5,1360281590167,1360281590231,702973731,702973795,64
1360281617,703000564,1,77,77,1360281590167,1360281590167,702973731,702973731,0
1360281617,703000568,1,77,77,1360281590163,1360281590163,702973731,702973731,0
1360281617,703000636,4,224,56,1360281589393,1360281601105,702973029,702984741,11712
1360281617,703000640,1,77,77,1360281590091,1360281590091,702973731,702973731,0
1360281617,703000640,1,77,77,1360281590091,1360281590091,702973731,702973731,0
1360281617,703000676,2,92,46,1360281591017,1360281591017,702974693,702974693,0
1360281617,703000676,3,169,56.33333333,1360281591080,1360281591080,702974756,702974756,0
1360281619,703003036,5,675,135,1360281618303,1360281618687,703002339,703002723,384
1360281619,703003040,5,643,128.6,1360281618429,1360281618685,703002469,703002725,256
1360281621,703004644,2,123,61.5,1360281593098,1360281593098,702976742,702976742,0
1360281621,703004676,2,123,61.5,1360281594088,1360281594088,702977764,702977764,0
1360281625,703008648,1,46,46,1360281598406,1360281598406,702982054,702982054,0
1360281627,703011104,3,325,108.3333333,1360281618364,1360281624316,703002468,703008420,5952
1360281629,703012576,8,1652,206.5,1360281601485,1360281611725,702985061,702995301,10240
1360281629,703012680,2,123,61.5,1360281604067,1360281604131,702987747,702987811,64
1360281635,703018996,7,412,58.85714286,1360281633062,1360281633062,703017058,703017058,0
1360281635,703019024,7,412,58.85714286,1360281633995,1360281633995,703018019,703018019,0
1360281635,703019028,6,366,61,1360281633993,1360281633993,703018021,703018021,0
1360281635,703019028,6,366,61,1360281633993,1360281634057,703018021,703018085,64
1360281635,703019032,9,590,65.55555556,1360281626052,1360281632004,703010084,703016036,5952
1360281635,703019032,7,498,71.14285714,1360281626052,1360281632004,703010084,703016036,5952
1360281635,703019032,8,2264,283,1360281626052,1360281632004,703010084,703016036,5952
1360281635,703019032,7,498,71.14285714,1360281626052,1360281632004,703010084,703016036,5952
1360281635,703019076,4,190,47.5,1360281621528,1360281627096,703005604,703011172,5568
1360281635,703019080,6,366,61,1360281633940,1360281633940,703018020,703018020,0
1360281635,703019080,6,366,61,1360281633940,1360281633940,703018020,703018020,0
1360281635,703019108,8,544,68,1360281625978,1360281631930,703010086,703016038,5952
1360281635,703019108,7,498,71.14285714,1360281625975,1360281631927,703010083,703016035,5952
1360281635,703019108,7,498,71.14285714,1360281625975,1360281631927,703010083,703016035,5952
1360281635,703019116,11,5775,525,1360281624111,1360281629935,703008227,703014051,5824
1360281637,703020524,10,5761,576.1,1360281624831,1360281630527,703008355,703014051,5696
1360281643,703026976,8,458,57.25,1360281637052,1360281637052,703021028,703021028,0
1360281643,703026988,8,458,57.25,1360281638001,1360281638065,703021989,703022053,64
1360281649,703032856,5,3440,688,1360281621747,1360281621811,703005603,703005667,64
1360281649,703033008,13,2325,178.8461538,1360281624350,1360281624798,703008358,703008806,448
1360281651,3636314308,9,504,56,1360281626115,1360281646403,3636289423,3636309711,20288
1360281651,703034980,1309,1799479,1374.697479,1360281641399,1360281644279,703025379,703028259,2880
1360281651,703034984,3,144,48,1360281641715,1360281646835,703025699,703030819,5120
1360281651,703035052,3,144,48,1360281641649,1360281646769,703025701,703030821,5120
1360281651,703035092,7,412,58.85714286,1360281647879,1360281648007,703031971,703032099,128
1360281653,703036828,8,1962,245.25,1360281628687,1360281629711,703012515,703013539,1024
1360281653,703036836,11,2277,207,1360281624905,1360281625353,703008741,703009189,448
1360281653,703036844,10,4056,405.6,1360281627712,1360281629760,703011556,703013604,2048
1360281653,703036876,17,952,56,1360281626209,1360281646881,703010085,703030757,20672
1360281653,703036876,17,952,56,1360281626463,1360281646943,703010339,703030819,20480
1360281653,703036992,94,88343,939.8191489,1360281628524,1360281640044,703012516,703024036,11520
1360281653,703037008,50,38812,776.24,1360281625244,1360281639772,703009252,703023780,14528
1360281653,703037008,10,3506,350.6,1360281627739,1360281633051,703011747,703017059,5312
1360281653,703037036,9,3413,379.2222222,1360281627968,1360281629696,703012004,703013732,1728
1360281653,703037040,1,137,137,1360281628093,1360281628093,703012133,703012133,0
1360281653,703037044,8,448,56,1360281626808,1360281646008,703010852,703030052,19200
1360281653,703037048,9,504,56,1360281626355,1360281647923,703010403,703031971,21568
1360281653,703037048,9,864,96,1360281626418,1360281648050,703010466,703032098,21632
1360281655,3636318284,4,486,121.5,1360281628382,1360281628510,3636291666,3636291794,128
1360281657,703040888,2,627,313.5,1360281631317,1360281631381,703015205,703015269,64
1360281657,703040892,33,37206,1127.454545,1360281631630,1360281631886,703015522,703015778,256
1360281657,703040968,22,2098,95.36363636,1360281631554,1360281632514,703015522,703016482,960
1360281661,703044912,1,77,77,1360281635134,1360281635134,703019046,703019046,0
1360281661,703044960,1,46,46,1360281636429,1360281636429,703020389,703020389,0
1360281665,703048888,9,4956,550.6666667,1360281639701,1360281639957,703023589,703023845,256
1360281667,703051004,6,574,95.66666667,1360281641376,1360281662048,703025380,703046052,20672
1360281667,703051004,5,528,105.6,1360281641374,1360281662686,703025378,703046690,21312
1360281669,703052976,3,492,164,1360281644477,1360281644605,703028453,703028581,128
1360281669,703052980,5,1795,359,1360281642678,1360281642998,703026658,703026978,320
1360281683,703067008,3,138,46,1360281680796,1360281680924,703064804,703064932,128
1360281683,703067020,145,110960,765.2413793,1360281493838,1360281679950,702877858,703063970,186112
1360281683,703067056,106,113195,1067.877358,1360281562218,1360281682730,702946274,703066786,120512
1360281683,703067140,5,675,135,1360281679191,1360281679447,703063331,703063587,256
1360281683,703067144,5,643,128.6,1360281679315,1360281679443,703063459,703063587,128
1360281683,703067168,7,412,58.85714286,1360281679805,1360281679805,703063973,703063973,0
1360281685,703068920,15,9115,607.6666667,1360281657589,1360281674293,703041509,703058213,16704
1360281689,703072996,11,3727,338.8181818,1360281664486,1360281686310,703048482,703070306,21824
1360281691,703075036,4,579,144.75,1360281674174,1360281689790,703058210,703073826,15616
1360281691,703075044,3,138,46,1360281682745,1360281683129,703066789,703067173,384
1360281691,703075044,2,92,46,1360281682745,1360281683001,703066789,703067045,256
1360281691,703075044,3,138,46,1360281682745,1360281683065,703066789,703067109,320
1360281691,703075044,3,325,108.3333333,1360281679416,1360281684792,703063460,703068836,5376
1360281691,703075124,3,138,46,1360281682663,1360281682919,703066787,703067043,256
1360281697,703081084,1,137,137,1360281672016,1360281672016,703056100,703056100,0
1360281699,703083184,184,151848,825.2608696,1360281494251,1360281690795,702878435,703074979,196544
1360281705,703088984,13,4920,378.4615385,1360281678322,1360281700466,703062306,703084450,22144
1360281705,703089024,1,46,46,1360281679756,1360281679756,703063780,703063780,0
1360281707,3636370336,2,92,46,1360281682857,1360281682857,3636346193,3636346193,0
1360281709,703092964,1,46,46,1360281683849,1360281683849,703067813,703067813,0
1360281709,703093004,1,46,46,1360281684833,1360281684833,703068837,703068837,0
1360281709,703093036,1,46,46,1360281683710,1360281683710,703067746,703067746,0
1360281709,703093040,1,46,46,1360281683773,1360281683773,703067813,703067813,0
1360281709,703093040,1,46,46,1360281683770,1360281683770,703067810,703067810,0
1360281709,703093076,2,92,46,1360281682709,1360281682965,703066785,703067041,256
1360281713,703097048,2,92,46,1360281685749,1360281685813,703069797,703069861,64
1360281723,703106996,207,268169,1295.502415,1360281568742,1360281716902,702952738,703100898,148160
1360281727,3636390280,2,92,46,1360281700896,1360281700896,3636364176,3636364176,0
1360281737,703121076,1,137,137,1360281711126,1360281711126,703095202,703095202,0
1360281747,703131028,5,643,128.6,1360281739461,1360281739589,703123489,703123617,128
1360281747,703131032,3,138,46,1360281739777,1360281739841,703123809,703123873,64
1360281747,703131072,2,92,46,1360281744730,1360281744730,703128802,703128802,0
1360281747,703131080,5,675,135,1360281739282,1360281739538,703123362,703123618,256
1360281747,703131100,3,325,108.3333333,1360281739390,1360281744702,703123490,703128802,5312
1360281747,703131116,3,138,46,1360281740655,1360281740719,703124771,703124835,64
1360281747,703131156,3,138,46,1360281744646,1360281745862,703128802,703130018,1216
1360281749,703132928,2,92,46,1360281744873,1360281744873,703128801,703128801,0
1360281749,703133104,3,2669,889.6666667,1360281722300,1360281722300,703106404,703106404,0
1360281753,703137064,2,180,90,1360281726180,1360281726244,703110244,703110308,64
1360281753,703137144,1,46,46,1360281726675,1360281726675,703110819,703110819,0
1360281755,703139096,5,575,115,1360281733507,1360281749699,703117603,703133795,16192
1360281755,703139220,3,138,46,1360281748549,1360281752773,703132769,703136993,4224
1360281761,703145076,6,1213,202.1666667,1360281734295,1360281753303,703118371,703137379,19008
1360281763,703147088,1624,1730072,1065.315271,1360281496137,1360281761097,702880225,703145185,264960
1360281763,703147124,3,169,56.33333333,1360281755624,1360281755624,703139748,703139748,0
1360281773,703157204,1,137,137,1360281745557,1360281745557,703129761,703129761,0
1360281779,703163124,40,26109,652.725,1360281769894,1360281773542,703154018,703157666,3648
1360281783,3636446564,1,204,204,1360281757637,1360281757637,3636421201,3636421201,0
1360281785,703169284,1,137,137,1360281760071,1360281760071,703144355,703144355,0
1360281785,703169284,1,137,137,1360281760071,1360281760071,703144355,703144355,0
1360281793,703177168,2,180,90,1360281766073,1360281766137,703150241,703150305,64
1360281795,703179128,2,92,46,1360281789664,1360281789664,703173792,703173792,0
1360281803,703187132,6,721,120.1666667,1360281799199,1360281799775,703183331,703183907,576
1360281803,703187184,5,643,128.6,1360281799209,1360281799657,703183393,703183841,448
1360281811,703195112,4,371,92.75,1360281799537,1360281805425,703183649,703189537,5888
1360281817,703201340,31,8418,271.5483871,1360281789069,1360281816717,703173409,703201057,27648
1360281827,703211188,5,653,130.6,1360281808547,1360281824611,703192735,703208799,16064
1360281833,703217284,2,180,90,1360281805958,1360281806022,703190242,703190306,64
1360281845,703229268,6,1320,220,1360281817109,1360281818389,703201377,703202657,1280
1360281865,703249356,2,92,46,1360281837371,1360281837435,703221727,703221791,64
1360281867,703251068,5,643,128.6,1360281859355,1360281859547,703243423,703243615,192
1360281867,703251072,3,144,48,1360281857690,1360281863450,703241762,703247522,5760
1360281867,703251112,1173,1542755,1315.221654,1360281857392,1360281866480,703241504,703250592,9088
1360281867,703251112,5,675,135,1360281859247,1360281859439,703243359,703243551,192
1360281867,703251116,3,325,108.3333333,1360281859371,1360281865451,703243487,703249567,6080
1360281867,703251116,2,98,49,1360281857646,1360281863406,703241762,703247522,5760
1360281873,703257352,2,180,90,1360281845889,1360281845953,703230241,703230305,64
1360281883,703267152,6,288,48,1360281880521,1360281881481,703264673,703265633,960
1360281883,703267152,5,242,48.4,1360281880456,1360281881096,703264608,703265248,640
1360281883,703267180,6,574,95.66666667,1360281857325,1360281877741,703241505,703261921,20416
1360281883,703267180,6,574,95.66666667,1360281857261,1360281878317,703241441,703262497,21056
1360281885,703269296,10,560,56,1360281858810,1360281882618,703243106,703266914,23808
1360281885,703269296,2,1028,514,1360281858873,1360281859065,703243169,703243361,192
1360281885,703269332,11,1056,96,1360281859859,1360281884755,703244191,703269087,24896
1360281885,703269332,11,616,56,1360281859859,1360281884627,703244191,703268959,24768
1360281885,703269344,22,1232,56,1360281858504,1360281884552,703242848,703268896,26048
1360281885,703269344,4,538,134.5,1360281858567,1360281858951,703242911,703243295,384
1360281886,703269428,22,1232,56,1360281859354,1360281885338,703242782,703268766,25984
1360281887,3636550540,12,672,56,1360281859550,1360281886494,3636523090,3636550034,26944
1360281891,703275104,3,140,46.66666667,1360281883895,1360281890039,703267999,703274143,6144
1360281891,703275112,4,467,116.75,1360281884146,1360281890034,703268258,703274146,5888
1360281891,703275148,22,27203,1236.5,1360281883018,1360281884106,703267166,703268254,1088
1360281891,703275180,4,826,206.5,1360281883819,1360281884075,703267999,703268255,256
1360281891,703275188,3,144,48,1360281890340,1360281890724,703274528,703274912,384
1360281894,703277440,8,1960,245,1360281869392,1360281869584,703252832,703253024,192
1360281899,703283104,4,586,146.5,1360281897271,1360281898423,703281375,703282527,1152
1360281899,703283108,12,5577,464.75,1360281897334,1360281898870,703281442,703282978,1536
1360281899,703283108,5,455,91,1360281897333,1360281898421,703281441,703282529,1088
1360281899,703283108,2,98,49,1360281893557,1360281898805,703277665,703282913,5248
1360281899,703283108,2,98,49,1360281891315,1360281897011,703275423,703281119,5696
1360281899,703283116,5,3087,617.4,1360281894381,1360281894765,703278497,703278881,384
1360281899,703283116,5,819,163.8,1360281894445,1360281894765,703278561,703278881,320
1360281899,703283120,44,33139,753.1590909,1360281884138,1360281897258,703268258,703281378,13120
1360281899,703283120,14,9243,660.2142857,1360281884138,1360281895082,703268258,703279202,10944
1360281899,703283120,45,40126,891.6888889,1360281884138,1360281897258,703268258,703281378,13120
1360281899,703283120,21,11300,538.0952381,1360281884138,1360281894122,703268258,703278242,9984
1360281899,703283120,9,2730,303.3333333,1360281884138,1360281892074,703268258,703276194,7936
1360281899,703283120,4,190,47.5,1360281884138,1360281891306,703268258,703275426,7168
1360281899,703283120,10,3038,303.8,1360281884138,1360281893098,703268258,703277218,8960
1360281899,703283120,15,10106,673.7333333,1360281884137,1360281893993,703268257,703278113,9856
1360281899,703283120,13,5552,427.0769231,1360281884137,1360281895145,703268257,703279265,11008
1360281899,703283120,86,99266,1154.255814,1360281884137,1360281897257,703268257,703281377,13120
1360281899,703283120,15,6581,438.7333333,1360281886696,1360281896104,703270816,703280224,9408
1360281899,703283120,16,8287,517.9375,1360281886696,1360281896104,703270816,703280224,9408
1360281899,703283120,15,4869,324.6,1360281884136,1360281893928,703268256,703278048,9792
1360281899,703283120,3,144,48,1360281884136,1360281892264,703268256,703276384,8128
1360281899,703283120,28,21738,776.3571429,1360281884136,1360281894888,703268256,703279008,10752
1360281899,703283120,26,24254,932.8461538,1360281884136,1360281894888,703268256,703279008,10752
1360281899,703283120,11,3693,335.7272727,1360281884136,1360281893096,703268256,703277216,8960
1360281899,703283120,14,8009,572.0714286,1360281884136,1360281893096,703268256,703277216,8960
1360281899,703283120,2,98,49,1360281884136,1360281891304,703268256,703275424,7168
1360281899,703283120,2,98,49,1360281884136,1360281891304,703268256,703275424,7168
1360281899,703283120,28,26343,940.8214286,1360281884135,1360281895143,703268255,703279263,11008
1360281899,703283120,16,9166,572.875,1360281886695,1360281896103,703270815,703280223,9408
1360281899,703283144,6,968,161.3333333,1360281890641,1360281897297,703274785,703281441,6656
1360281899,703283144,2,98,49,1360281890641,1360281896913,703274785,703281057,6272
1360281899,703283144,2,98,49,1360281890640,1360281896976,703274784,703281120,6336
1360281899,703283144,3,150,50,1360281890640,1360281896976,703274784,703281120,6336
1360281899,703283144,2,98,49,1360281890640,1360281896976,703274784,703281120,6336
1360281899,703283144,12,2792,232.6666667,1360281890703,1360281897103,703274847,703281247,6400
1360281899,703283148,3,144,48,1360281892619,1360281898827,703276767,703282975,6208
1360281899,703283156,3,150,50,1360281888390,1360281894406,703272546,703278562,6016
1360281899,703283156,3,144,48,1360281888389,1360281894405,703272545,703278561,6016
1360281899,703283160,4,467,116.75,1360281897281,1360281898753,703281441,703282913,1472
1360281899,703283160,5,502,100.4,1360281897280,1360281898432,703281440,703282592,1152
1360281899,703283160,6,2518,419.6666667,1360281897343,1360281898815,703281503,703282975,1472
1360281899,703283184,2,98,49,1360281891242,1360281896874,703275426,703281058,5632
1360281899,703283188,2,98,49,1360281889955,1360281895395,703274143,703279583,5440
1360281899,703283188,2,98,49,1360281889955,1360281895395,703274143,703279583,5440
1360281899,703283188,4,196,49,1360281889955,1360281895459,703274143,703279647,5504
1360281899,703283192,86,90962,1057.697674,1360281884066,1360281897186,703268258,703281378,13120
1360281899,703283192,23,15122,657.4782609,1360281884066,1360281893858,703268258,703278050,9792
1360281899,703283192,17,7449,438.1764706,1360281884066,1360281893858,703268258,703278050,9792
1360281899,703283192,63,64629,1025.857143,1360281884066,1360281897186,703268258,703281378,13120
1360281899,703283192,155,186621,1204.006452,1360281884066,1360281897186,703268258,703281378,13120
1360281899,703283192,10,2754,275.4,1360281886625,1360281893921,703270817,703278113,7296
1360281899,703283192,11,4403,400.2727273,1360281884065,1360281893025,703268257,703277217,8960
1360281899,703283192,3,144,48,1360281884065,1360281892257,703268257,703276449,8192
1360281899,703283192,18,11533,640.7222222,1360281884065,1360281895073,703268257,703279265,11008
1360281899,703283192,10,2899,289.9,1360281886625,1360281893921,703270817,703278113,7296
1360281899,703283192,16,6464,404,1360281886625,1360281896033,703270817,703280225,9408
1360281899,703283192,16,6799,424.9375,1360281884065,1360281894817,703268257,703279009,10752
1360281899,703283192,2,98,49,1360281884065,1360281891233,703268257,703275425,7168
1360281899,703283192,11,3783,343.9090909,1360281884065,1360281892001,703268257,703276193,7936
1360281899,703283192,14,6660,475.7142857,1360281884064,1360281895072,703268256,703279264,11008
1360281899,703283192,24,21157,881.5416667,1360281884192,1360281893920,703268384,703278112,9728
1360281899,703283196,3,144,48,1360281890589,1360281896925,703274785,703281121,6336
1360281899,703283196,2,98,49,1360281890589,1360281896925,703274785,703281121,6336
1360281899,703283196,7,2206,315.1428571,1360281890333,1360281896925,703274529,703281121,6592
1360281899,703283224,2,98,49,1360281890562,1360281896834,703274786,703281058,6272
1360281899,703283224,2,98,49,1360281890562,1360281896898,703274786,703281122,6336
1360281899,703283232,2,98,49,1360281888250,1360281894266,703272482,703278498,6016
1360281899,703283232,3,144,48,1360281888314,1360281894330,703272546,703278562,6016
1360281901,703285328,72,70649,981.2361111,1360281874966,1360281880278,703259294,703264606,5312
1360281902,3636565612,3,144,48,1360281895000,1360281900376,3636558612,3636563988,5376
1360281902,3636565612,2,98,49,1360281891160,1360281896856,3636554772,3636560468,5696
1360281902,3636565616,2,98,49,1360281894674,1360281900370,3636558290,3636563986,5696
1360281902,3636565616,3,144,48,1360281889937,1360281895377,3636553553,3636558993,5440
1360281902,3636565616,2,98,49,1360281890320,1360281896848,3636553936,3636560464,6528
1360281902,3636565616,3,144,48,1360281893460,1360281898772,3636557076,3636562388,5312
1360281902,3636565620,2,98,49,1360281893520,1360281900368,3636557140,3636563988,6848
1360281902,3636565620,3,144,48,1360281891151,1360281896911,3636554771,3636560531,5760
1360281902,3636565620,3,144,48,1360281894286,1360281900494,3636557906,3636564114,6208
1360281902,3636565636,2,98,49,1360281890304,1360281896832,3636553940,3636560468,6528
1360281906,703289380,11,3339,303.5454545,1360281881229,1360281882253,703264609,703265633,1024
1360281906,703289380,12,3607,300.5833333,1360281881419,1360281881803,703264799,703265183,384
1360281906,703289404,24,13108,546.1666667,1360281881587,1360281882227,703264991,703265631,640
1360281906,703289456,9,3000,333.3333333,1360281880384,1360281880512,703263840,703263968,128
1360281906,703289456,11,4025,365.9090909,1360281880383,1360281902975,703263839,703286431,22592
1360281906,703289484,10,4449,444.9,1360281881123,1360281881379,703264607,703264863,256
1360281907,703291100,4,186,46.5,1360281897342,1360281903870,703281442,703287970,6528
1360281907,703291100,2,92,46,1360281897341,1360281903869,703281441,703287969,6528
1360281907,703291100,3,140,46.66666667,1360281897277,1360281903805,703281377,703287905,6528
1360281907,703291100,2,98,49,1360281899197,1360281905341,703283297,703289441,6144
1360281907,703291100,4,190,47.5,1360281899260,1360281905532,703283360,703289632,6272
1360281907,703291100,3,144,48,1360281897340,1360281903868,703281440,703287968,6528
1360281907,703291100,2,94,47,1360281897340,1360281903868,703281440,703287968,6528
1360281907,703291100,4,196,49,1360281899387,1360281905467,703283487,703289567,6080
1360281907,703291100,2,98,49,1360281899387,1360281905339,703283487,703289439,5952
1360281907,703291100,2,98,49,1360281899387,1360281905339,703283487,703289439,5952
1360281907,703291100,7,764,109.1428571,1360281901690,1360281902522,703285790,703286622,832
1360281907,703291108,2,94,47,1360281894389,1360281900469,703278497,703284577,6080
1360281907,703291108,7,1975,282.1428571,1360281902580,1360281903284,703286688,703287392,704
1360281907,703291112,2,98,49,1360281894770,1360281900466,703278882,703284578,5696
1360281907,703291144,3,144,48,1360281900686,1360281906382,703284830,703290526,5696
1360281907,703291152,6,737,122.8333333,1360281896648,1360281901960,703280800,703286112,5312
1360281907,703291152,2,98,49,1360281896968,1360281903752,703281120,703287904,6784
1360281907,703291152,2,92,46,1360281896967,1360281903751,703281119,703287903,6784
1360281907,703291156,3,140,46.66666667,1360281897285,1360281903749,703281441,703287905,6464
1360281907,703291156,2,98,49,1360281897285,1360281903749,703281441,703287905,6464
1360281907,703291156,5,497,99.4,1360281905349,1360281905733,703289505,703289889,384
1360281907,703291156,2,98,49,1360281899332,1360281905284,703283488,703289440,5952
1360281907,703291156,2,98,49,1360281899331,1360281905283,703283487,703289439,5952
1360281907,703291180,8,2110,263.75,1360281894123,1360281900779,703278303,703284959,6656
1360281907,703291180,11,2814,255.8181818,1360281902123,1360281902699,703286303,703286879,576
1360281907,703291184,6,500,83.33333333,1360281902122,1360281903402,703286306,703287586,1280
1360281907,703291184,2,279,139.5,1360281894377,1360281900393,703278561,703284577,6016
1360281907,703291188,11,5773,524.8181818,1360281884066,1360281901026,703268254,703285214,16960
1360281907,703291188,6,1821,303.5,1360281894694,1360281906470,703278882,703290658,11776
1360281907,703291216,3,138,46,1360281896646,1360281902150,703280862,703286366,5504
1360281907,703291220,2,98,49,1360281896582,1360281902086,703280802,703286306,5504
1360281907,703291220,2,98,49,1360281896838,1360281903686,703281058,703287906,6848
1360281909,703293332,1,46,46,1360281882838,1360281882838,703267170,703267170,0
1360281909,703293344,5,1874,374.8,1360281883655,1360281884103,703267999,703268447,448
1360281910,703293372,4,627,156.75,1360281884949,1360281887573,703268321,703270945,2624
1360281910,703293376,14,8742,624.4285714,1360281883345,1360281883793,703266721,703267169,448
1360281910,703293424,30,35301,1176.7,1360281884512,1360281884768,703267936,703268192,256
1360281910,703293452,10,10362,1036.2,1360281884805,1360281885573,703268257,703269025,768
1360281910,703293452,13,6933,533.3076923,1360281884804,1360281890052,703268256,703273504,5248
1360281910,703293452,4,635,158.75,1360281884867,1360281887619,703268319,703271071,2752
1360281910,3636573612,2,98,49,1360281896277,1360281902101,3636559889,3636565713,5824
1360281910,3636573612,2,98,49,1360281897176,1360281903704,3636560788,3636567316,6528
1360281910,3636573616,2,98,49,1360281901522,1360281907282,3636565138,3636570898,5760
1360281910,3636573624,2,98,49,1360281901514,1360281907274,3636565138,3636570898,5760
1360281910,3636573624,3,144,48,1360281901514,1360281907274,3636565138,3636570898,5760
1360281913,703297352,28,1568,56,1360281885569,1360281911809,703269921,703296161,26240
1360281913,703297356,14,784,56,1360281886011,1360281911291,703270367,703295647,25280
1360281914,703297384,14,784,56,1360281887686,1360281913094,703271070,703296478,25408
1360281914,703297432,29,1624,56,1360281886358,1360281913494,703269790,703296926,27136
1360281914,703297460,2,180,90,1360281886845,1360281886845,703270305,703270305,0
1360281914,703297472,14,1344,96,1360281887983,1360281913199,703271455,703296671,25216
1360281915,703299120,3,144,48,1360281905318,1360281911462,703289438,703295582,6144
1360281915,703299128,3,144,48,1360281902110,1360281908382,703286238,703292510,6272
1360281915,703299132,4,196,49,1360281905949,1360281911837,703290081,703295969,5888
1360281915,703299136,2,98,49,1360281902745,1360281908377,703286881,703292513,5632
1360281915,703299136,4,190,47.5,1360281906390,1360281912534,703290526,703296670,6144
1360281915,703299160,3,144,48,1360281903742,1360281909374,703287902,703293534,5632
1360281915,703299160,8,747,93.375,1360281903742,1360281910718,703287902,703294878,6976
1360281915,703299164,5,242,48.4,1360281903994,1360281909370,703288158,703293534,5376
1360281915,703299164,4,867,216.75,1360281903997,1360281910717,703288161,703294881,6720
1360281915,703299164,3,144,48,1360281906620,1360281912380,703290784,703296544,5760
1360281915,3636578580,13,728,56,1360281888184,1360281913976,3636551764,3636577556,25792
1360281915,703299172,9,898,99.77777778,1360281897268,1360281912564,703281440,703296736,15296
1360281915,703299172,3,144,48,1360281905331,1360281911347,703289503,703295519,6016
1360281915,703299172,4,196,49,1360281905331,1360281912051,703289503,703296223,6720
1360281915,703299172,22,10541,479.1363636,1360281899314,1360281910450,703283486,703294622,11136
1360281915,703299172,18,9507,528.1666667,1360281899314,1360281910450,703283486,703294622,11136
1360281915,3636578588,9,1571,174.5555556,1360281889968,1360281898544,3636553556,3636562132,8576
1360281915,703299208,4,190,47.5,1360281902094,1360281908302,703286302,703292510,6208
1360281915,703299208,4,196,49,1360281905873,1360281911441,703290081,703295649,5568
1360281915,3636578628,5,2517,503.4,1360281889926,1360281890310,3636553554,3636553938,384
1360281915,703299212,29,10820,373.1034483,1360281894668,1360281910604,703278880,703294816,15936
1360281915,703299220,10,1212,121.2,1360281903490,1360281910658,703287710,703294878,7168
1360281915,703299220,3,144,48,1360281903685,1360281909317,703287905,703293537,5632
1360281915,703299220,2,98,49,1360281903940,1360281909316,703288160,703293536,5376
1360281917,703301352,45,36718,815.9555556,1360281891070,1360281891646,703275422,703275998,576
1360281917,703301352,18,20998,1166.555556,1360281891070,1360281891262,703275422,703275614,192
1360281918,703301396,3,513,171,1360281891133,1360281891325,703274529,703274721,192
1360281918,703301396,8,6080,760,1360281891386,1360281905914,703274782,703289310,14528
1360281918,703301400,10,6475,647.5,1360281891386,1360281905850,703274786,703289250,14464
1360281918,703301436,5,2282,456.4,1360281891989,1360281892309,703275425,703275745,320
1360281918,703301464,12,12556,1046.333333,1360281890681,1360281890937,703274145,703274401,256
1360281918,703301464,13,7661,589.3076923,1360281890680,1360281892536,703274144,703276000,1856
1360281918,703301472,3,600,200,1360281891312,1360281891952,703274784,703275424,640
1360281918,703301472,3,560,186.6666667,1360281891120,1360281891376,703274592,703274848,256
1360281918,703301472,9,3247,360.7777778,1360281891375,1360281892271,703274847,703275743,896
1360281918,703301476,25,8388,335.52,1360281893292,1360281896748,703276768,703280224,3456
1360281918,703301476,5,641,128.2,1360281891308,1360281891884,703274784,703275360,576
1360281919,3636582576,4,1006,251.5,1360281894713,1360281894969,3636558289,3636558545,256
1360281919,3636582608,38,46603,1226.394737,1360281894682,1360281894874,3636558290,3636558482,192
1360281919,3636582624,5,2819,563.8,1360281893514,1360281894026,3636557138,3636557650,512
1360281921,703305352,10,2456,245.6,1360281894271,1360281899327,703278623,703283679,5056
1360281921,703305356,14,9739,695.6428571,1360281894524,1360281895932,703278880,703280288,1408
1360281922,703305380,39,32349,829.4615385,1360281896075,1360281906635,703279455,703290015,10560
1360281922,703305384,14,5841,417.2142857,1360281896392,1360281905544,703279776,703288928,9152
1360281922,703305388,11,3983,362.0909091,1360281896708,1360281906820,703280096,703290208,10112
1360281922,703305392,17,8287,487.4705882,1360281897086,1360281905406,703280478,703288798,8320
1360281922,703305396,73,92506,1267.205479,1360281897404,1360281902972,703280800,703286368,5568
1360281922,703305396,11,1982,180.1818182,1360281897723,1360281917627,703281119,703301023,19904
1360281922,703305428,14,5208,372,1360281895197,1360281899933,703278625,703283361,4736
1360281922,703305432,7,4999,714.1428571,1360281895450,1360281895834,703278882,703279266,384
1360281922,703305460,7,2253,321.8571429,1360281895995,1360281896379,703279455,703279839,384
1360281922,703305464,14,8063,575.9285714,1360281896118,1360281901622,703279582,703285086,5504
1360281922,703305464,3,804,268,1360281896118,1360281896502,703279582,703279966,384
1360281922,703305496,10,1642,164.2,1360281897622,1360281911958,703281118,703295454,14336
1360281923,703307108,5,675,135,1360281921204,1360281922868,703305312,703306976,1664
1360281923,703307112,5,820,164,1360281917553,1360281917873,703301665,703301985,320
1360281923,703307112,10,944,94.4,1360281897329,1360281915249,703281441,703299361,17920
1360281923,703307144,3,138,46,1360281919182,1360281919310,703303326,703303454,128
1360281923,703307160,4,597,149.25,1360281921151,1360281922623,703305311,703306783,1472
1360281923,3636586580,15,15436,1029.066667,1360281897206,1360281897398,3636560786,3636560978,192
1360281923,3636586604,13,12018,924.4615385,1360281895520,1360281895904,3636559124,3636559508,384
1360281923,703307264,4,408,102,1360281917145,1360281917401,703301409,703301665,256
1360281923,703307272,14,15620,1115.714286,1360281917712,1360281918160,703301984,703302432,448
1360281923,703307280,3,421,140.3333333,1360281918281,1360281921737,703302561,703306017,3456
1360281923,703307280,6,500,83.33333333,1360281915849,1360281916041,703300129,703300321,192
1360281923,703307316,6,500,83.33333333,1360281916835,1360281917091,703301151,703301407,256
1360281925,703309356,18,7691,427.2777778,1360281897082,1360281902650,703281438,703287006,5568
1360281925,703309356,11,5320,483.6363636,1360281897082,1360281901306,703281438,703285662,4224
1360281925,703309360,6,770,128.3333333,1360281897080,1360281897336,703281440,703281696,256
1360281925,703309360,30,17469,582.3,1360281897080,1360281904440,703281440,703288800,7360
1360281925,703309364,4,379,94.75,1360281899122,1360281900338,703283486,703284702,1216
1360281925,703309364,13,10286,791.2307692,1360281899125,1360281901301,703283489,703285665,2176
1360281926,703309404,9,2068,229.7777778,1360281899571,1360281918003,703282975,703301407,18432
1360281926,703309404,5,320,64,1360281901427,1360281905715,703284831,703289119,4288
1360281926,703309436,6,787,131.1666667,1360281898006,1360281906646,703281442,703290082,8640
1360281926,703309440,30,29377,979.2333333,1360281900049,1360281918033,703283489,703301473,17984
1360281926,703309440,6,2951,491.8333333,1360281900049,1360281902289,703283489,703285729,2240
1360281926,703309480,7,457,65.28571429,1360281901094,1360281905958,703284574,703289438,4864
1360281926,703309484,7,4596,656.5714286,1360281899490,1360281899810,703282974,703283294,320
1360281926,703309488,9,7112,790.2222222,1360281901344,1360281905824,703284832,703289312,4480
1360281927,3636590568,35,36609,1045.971429,1360281899331,1360281901699,3636562899,3636565267,2368
1360281927,3636590592,4,1078,269.5,1360281901547,1360281901867,3636565139,3636565459,320
1360281927,3636590596,92,109662,1191.978261,1360281899303,1360281901735,3636562899,3636565331,2432
1360281929,703313364,4,740,185,1360281901875,1360281902259,703286239,703286623,384
1360281929,703313364,6,522,87,1360281901938,1360281902194,703286302,703286558,256
1360281930,703313448,20,11107,555.35,1360281902727,1360281918087,703286175,703301535,15360
1360281930,703313452,4,740,185,1360281902853,1360281904517,703286305,703287969,1664
1360281931,703315100,6,560,93.33333333,1360281929147,1360281929467,703313247,703313567,320
1360281931,703315104,3,144,48,1360281925305,1360281930809,703309409,703314913,5504
1360281931,703315104,3,144,48,1360281925304,1360281930808,703309408,703314912,5504
1360281931,703315108,8,522,65.25,1360281921523,1360281927283,703305631,703311391,5760
1360281931,703315108,2,92,46,1360281921587,1360281927283,703305695,703311391,5696
1360281931,703315116,8,2508,313.5,1360281918380,1360281925612,703302496,703309728,7232
1360281931,703315116,108,134382,1244.277778,1360281918380,1360281928684,703302496,703312800,10304
1360281931,703315116,3,140,46.66666667,1360281918443,1360281926059,703302559,703310175,7616
1360281931,703315116,3,144,48,1360281923947,1360281929707,703308063,703313823,5760
1360281931,703315116,6,3106,517.6666667,1360281926634,1360281927274,703310750,703311390,640
1360281931,703315144,18,14502,805.6666667,1360281927760,1360281928144,703311904,703312288,384
1360281931,703315148,3,144,48,1360281920140,1360281926028,703304288,703310176,5888
1360281931,703315148,3,144,48,1360281920203,1360281926091,703304351,703310239,5888
1360281931,703315152,2,98,49,1360281925193,1360281930697,703309345,703314849,5504
1360281931,703315152,2,98,49,1360281925193,1360281930697,703309345,703314849,5504
1360281931,703315184,2,279,139.5,1360281921511,1360281927207,703305695,703311391,5696
1360281931,703315192,2,98,49,1360281923872,1360281930720,703308064,703314912,6848
1360281931,703315192,3,144,48,1360281923936,1360281930720,703308128,703314912,6784
1360281931,703315192,3,144,48,1360281918366,1360281925982,703302558,703310174,7616
1360281931,703315196,3,144,48,1360281918365,1360281925981,703302561,703310177,7616
1360281931,703315200,6,664,110.6666667,1360281930201,1360281930585,703314401,703314785,384
1360281931,703315200,3,144,48,1360281922392,1360281928664,703306592,703312864,6272
1360281931,703315200,3,144,48,1360281922392,1360281928664,703306592,703312864,6272
1360281931,703315228,4,409,102.25,1360281927676,1360281928060,703311904,703312288,384
1360281931,703315228,5,654,130.8,1360281927676,1360281928060,703311904,703312288,384
1360281931,703315232,5,938,187.6,1360281919800,1360281922808,703304032,703307040,3008
1360281931,703315232,3,150,50,1360281920119,1360281925943,703304351,703310175,5824
1360281931,703315236,5,514,102.8,1360281929010,1360281929586,703313246,703313822,576
1360281933,703317356,6,1512,252,1360281905084,1360281906684,703289440,703291040,1600
1360281933,703317360,4,1094,273.5,1360281905142,1360281905590,703289502,703289950,448
1360281934,703317396,7,4488,641.1428571,1360281906683,1360281907259,703290079,703290655,576
1360281934,703317396,3,1497,499,1360281906682,1360281907002,703290078,703290398,320
1360281934,703317528,4,783,195.75,1360281905912,1360281907128,703289440,703290656,1216
1360281934,703317564,4,434,108.5,1360281906579,1360281907219,703290143,703290783,640
1360281934,703317600,4,676,169,1360281907183,1360281907311,703290783,703290911,128
1360281934,3636597604,3,144,48,1360281926560,1360281932000,3636590164,3636595604,5440
1360281934,3636597604,2,98,49,1360281921439,1360281927135,3636585043,3636590739,5696
1360281934,3636597604,2,98,49,1360281925982,1360281931998,3636589586,3636595602,6016
1360281934,3636597608,2,98,49,1360281926553,1360281931993,3636590161,3636595601,5440
1360281934,3636597612,3,144,48,1360281922648,1360281928600,3636586260,3636592212,5952
1360281934,3636597612,2,98,49,1360281925848,1360281931992,3636589460,3636595604,6144
1360281939,703323100,2,92,46,1360281937148,1360281937596,703321248,703321696,448
1360281939,703323100,6,687,114.5,1360281933244,1360281933628,703317344,703317728,384
1360281939,703323100,3,346,115.3333333,1360281933243,1360281938299,703317343,703322399,5056
1360281939,703323100,2,98,49,1360281933243,1360281938683,703317343,703322783,5440
1360281939,703323100,5,707,141.4,1360281933243,1360281933819,703317343,703317919,576
1360281939,703323112,401,514685,1283.503741,1360281918446,1360281934318,703302558,703318430,15872
1360281939,703323112,373,466325,1250.201072,1360281918446,1360281934510,703302558,703318622,16064
1360281939,703323112,330,406842,1232.854545,1360281918446,1360281934446,703302558,703318558,16000
1360281939,703323112,383,484514,1265.049608,1360281918446,1360281934574,703302558,703318686,16128
1360281939,703323116,12,5000,416.6666667,1360281926634,1360281937130,703310750,703321246,10496
1360281939,703323116,3,144,48,1360281926634,1360281932138,703310750,703316254,5504
1360281939,703323116,3,144,48,1360281926637,1360281932141,703310753,703316257,5504
1360281939,703323116,6,500,83.33333333,1360281932140,1360281932460,703316256,703316576,320
1360281939,703323116,6,282,47,1360281932139,1360281938219,703316255,703322335,6080
1360281939,703323140,4,190,47.5,1360281927252,1360281933140,703311392,703317280,5888
1360281939,703323140,5,1455,291,1360281922450,1360281938130,703306590,703322270,15680
1360281939,703323144,2,92,46,1360281927759,1360281933071,703311903,703317215,5312
1360281939,703323148,3,144,48,1360281927947,1360281934091,703312095,703318239,6144
1360281939,703323180,2,94,47,1360281926571,1360281932011,703310751,703316191,5440
1360281939,703323180,367,456415,1243.637602,1360281918379,1360281938027,703302559,703322207,19648
1360281939,703323180,2,92,46,1360281926571,1360281932075,703310751,703316255,5504
1360281939,703323180,398,505783,1270.811558,1360281918378,1360281934634,703302558,703318814,16256
1360281939,703323184,14,3886,277.5714286,1360281927207,1360281934439,703311391,703318623,7232
1360281939,703323184,3,144,48,1360281927270,1360281933158,703311454,703317342,5888
1360281939,703323188,2,98,49,1360281927716,1360281933028,703311904,703317216,5312
1360281939,703323188,3,144,48,1360281927716,1360281933028,703311904,703317216,5312
1360281939,703323188,5,946,189.2,1360281932899,1360281938595,703317087,703322783,5696
1360281939,703323188,87,107846,1239.609195,1360281927843,1360281934179,703312031,703318367,6336
1360281941,703325356,2,92,46,1360281936890,1360281937146,703321246,703321502,256
1360281942,703325368,13,728,56,1360281914647,1360281939735,703298015,703323103,25088
1360281942,703325400,13,728,56,1360281916728,1360281940536,703300128,703323936,23808
1360281942,703325404,13,1248,96,1360281916853,1360281940917,703300257,703324321,24064
1360281942,703325404,1,46,46,1360281916915,1360281916915,703300319,703300319,0
1360281942,703325444,26,1456,56,1360281914314,1360281941322,703297758,703324766,27008
1360281942,703325484,26,1456,56,1360281914917,1360281941157,703298401,703324641,26240
1360281942,703325516,4,538,134.5,1360281917442,1360281917634,703300958,703301150,192
1360281942,3636605604,4,190,47.5,1360281928862,1360281935134,3636592466,3636598738,6272
1360281946,703329400,9,7227,803,1360281919414,1360281919478,703302814,703302878,64
1360281946,703329408,24,11093,462.2083333,1360281920111,1360281944303,703303519,703327711,24192
1360281946,703329416,2,92,46,1360281920935,1360281920999,703304351,703304415,64
1360281946,703329444,12,7583,631.9166667,1360281921483,1360281944779,703304927,703328223,23296
1360281946,703329496,6,1106,184.3333333,1360281920281,1360281940889,703303777,703324385,20608
1360281947,703331136,3,368,122.6666667,1360281939417,1360281939737,703323553,703323873,320
1360281947,703331140,4,205,51.25,1360281939669,1360281940053,703323809,703324193,384
1360281947,703331140,3,144,48,1360281939733,1360281945109,703323873,703329249,5376
1360281947,703331164,3,138,46,1360281939963,1360281940027,703324127,703324191,64
1360281947,703331180,3,144,48,1360281933162,1360281939050,703317342,703323230,5888
1360281947,703331216,2,98,49,1360281939655,1360281944903,703323871,703329119,5248
1360281947,703331220,2,98,49,1360281939714,1360281944898,703323934,703329118,5184
1360281947,703331220,6,574,95.66666667,1360281922052,1360281943300,703306272,703327520,21248
1360281947,703331248,3,138,46,1360281940390,1360281940454,703324638,703324702,64
1360281947,703331252,3,150,50,1360281932834,1360281940834,703317086,703325086,8000
1360281948,3636610828,5,2272,454.4,1360281923112,1360281923368,3636585940,3636586196,256
1360281948,3636610848,17,952,56,1360281920596,1360281946964,3636583444,3636609812,26368
1360281948,3636610864,4,729,182.25,1360281921667,1360281927299,3636584531,3636590163,5632
1360281949,703333360,1,46,46,1360281922681,1360281922681,703307041,703307041,0
1360281950,703333404,3,711,237,1360281924657,1360281925169,703308061,703308573,512
1360281950,703333404,3,846,282,1360281924660,1360281924916,703308064,703308320,256
1360281950,703333404,6,1146,191,1360281924660,1360281929524,703308064,703312928,4864
1360281950,703333408,2,705,352.5,1360281922927,1360281923183,703306335,703306591,256
1360281950,703333412,3,876,292,1360281923116,1360281933356,703306528,703316768,10240
1360281950,703333440,2,123,61.5,1360281925647,1360281925647,703309087,703309087,0
1360281950,703333444,1,46,46,1360281923596,1360281923596,703307040,703307040,0
1360281950,703333452,29,22811,786.5862069,1360281923972,1360281932996,703307424,703316448,9024
1360281950,703333484,4,758,189.5,1360281924580,1360281925028,703308064,703308512,448
1360281950,703333484,34,37129,1092.029412,1360281924580,1360281931044,703308064,703314528,6464
1360281950,703333484,4,1586,396.5,1360281924580,1360281924900,703308064,703308384,320
1360281950,703333484,4,993,248.25,1360281924580,1360281925156,703308064,703308640,576
1360281950,703333484,4,659,164.75,1360281924580,1360281925540,703308064,703309024,960
1360281950,703333484,20,24366,1218.3,1360281924580,1360281927972,703308064,703311456,3392
1360281950,703333496,2,491,245.5,1360281923160,1360281923224,703306656,703306720,64
1360281950,703333524,2,123,61.5,1360281925563,1360281925563,703309087,703309087,0
1360281950,703333528,1,77,77,1360281925561,1360281925561,703309089,703309089,0
1360281952,3636614788,4,2524,631,1360281925455,1360281925583,3636588243,3636588371,128
1360281952,3636614804,10,6873,687.3,1360281927360,1360281927488,3636590164,3636590292,128
1360281953,703337352,17,16472,968.9411765,1360281924926,1360281933374,703309278,703317726,8448
1360281953,703337356,4,3352,838,1360281925242,1360281925242,703309598,703309598,0
1360281953,703337364,1,134,134,1360281925939,1360281925939,703310303,703310303,0
1360281954,703337368,2,123,61.5,1360281927193,1360281927193,703310561,703310561,0
1360281954,703337368,5,2002,400.4,1360281927383,1360281929111,703310751,703312479,1728
1360281954,703337396,6,3268,544.6666667,1360281928060,1360281928316,703311456,703311712,256
1360281954,703337396,5,4901,980.2,1360281928314,1360281928314,703311710,703311710,0
1360281954,703337396,5,4803,960.6,1360281928186,1360281928250,703311582,703311646,64
1360281954,703337412,19,17721,932.6842105,1360281929707,1360281934571,703313119,703317983,4864
1360281954,703337436,2,92,46,1360281926101,1360281926101,703309537,703309537,0
1360281954,703337440,1,77,77,1360281927118,1360281927118,703310558,703310558,0
1360281954,703337444,2,123,61.5,1360281927117,1360281927117,703310561,703310561,0
1360281954,703337444,3,1514,504.6666667,1360281927307,1360281927947,703310751,703311391,640
1360281954,703337492,12,11481,956.75,1360281929757,1360281934301,703313249,703317793,4544
1360281955,703339148,6,500,83.33333333,1360281946828,1360281946956,703330976,703331104,128
1360281955,3636618760,35,46398,1325.657143,1360281927425,1360281927425,3636591185,3636591185,0
1360281956,3636618784,14,13463,961.6428571,1360281931666,1360281932690,3636594450,3636595474,1024
1360281956,3636618784,11,7930,720.9090909,1360281931665,1360281932561,3636594449,3636595345,896
1360281956,3636618792,18,18321,1017.833333,1360281929035,1360281929419,3636591827,3636592211,384
1360281956,3636618808,11,6629,602.6363636,1360281930556,1360281931260,3636593364,3636594068,704
1360281956,3636618812,44,51901,1179.568182,1360281931639,1360281932407,3636594451,3636595219,768
1360281958,703341384,1,46,46,1360281931654,1360281931654,703315038,703315038,0
1360281958,703341436,2,1476,738,1360281932756,1360281932756,703316192,703316192,0
1360281958,703341444,2,642,321,1360281933131,1360281933131,703316575,703316575,0
1360281958,703341524,4,1090,272.5,1360281932988,1360281934460,703316512,703317984,1472
1360281958,703341548,7,4720,674.2857143,1360281933220,1360281933476,703316768,703317024,256
1360281956,3636618812,19,16521,869.5263158,1360281931638,1360281932790,3636594450,3636595602,1152
1360281956,3636618812,18,17465,970.2777778,1360281931638,1360281932086,3636594450,3636594898,448
1360281962,703345688,2,137,68.5,1360281934359,1360281934423,703318047,703318111,64
1360281962,703345764,2,123,61.5,1360281937421,1360281937421,703321185,703321185,0
1360281962,703345804,4,1396,349,1360281934820,1360281934948,703318624,703318752,128
1360281962,703345836,7,3156,450.8571429,1360281936772,1360281946052,703320608,703329888,9280
1360281963,703347124,8,368,46,1360281955874,1360281959906,703339998,703344030,4032
1360281963,703347196,6,500,83.33333333,1360281961753,1360281962073,703345949,703346269,320
1360281963,703347212,4,184,46,1360281962637,1360281962829,703346849,703347041,192
1360281966,703349400,3,138,46,1360281938295,1360281938359,703321695,703321759,64
1360281966,703349512,4,596,149,1360281940168,1360281940360,703323680,703323872,192
1360281970,703353384,22,1232,56,1360281942023,1360281966535,703325407,703349919,24512
1360281970,703353424,43,2408,56,1360281943648,1360281969760,703327072,703353184,26112
1360281970,703353424,21,2016,96,1360281943838,1360281965854,703327262,703349278,22016
1360281970,703353508,43,2408,56,1360281943501,1360281967693,703327009,703351201,24192
1360281970,703353508,21,1176,56,1360281943627,1360281965451,703327135,703348959,21824
1360281971,703355188,6,454,75.66666667,1360281966116,1360281966180,703350304,703350368,64
1360281971,703355204,5839,8010756,1371.939716,1360281935828,1360281967188,703320032,703351392,31360
1360281974,703357408,2,123,61.5,1360281947759,1360281947823,703331167,703331231,64
1360281974,703357408,1,46,46,1360281945967,1360281945967,703329375,703329375,0
1360281976,3636638956,23,1288,56,1360281947942,1360281975782,3636610898,3636638738,27840
1360281978,703361416,3,138,46,1360281951077,1360281951141,703334493,703334557,64
1360281978,703361444,3,138,46,1360281951883,1360281951947,703335327,703335391,64
1360281979,703363136,4,196,49,1360281970073,1360281978521,703354209,703362657,8448
1360281979,703363140,2,92,46,1360281964178,1360281972754,703348318,703356894,8576
1360281979,703363172,6,500,83.33333333,1360281976754,1360281977202,703360926,703361374,448
1360281979,703363208,3,144,48,1360281970320,1360281975312,703354528,703359520,4992
1360281982,703365488,6,1722,287,1360281956384,1360281970720,703339872,703354208,14336
1360281982,703365528,3,138,46,1360281957302,1360281957366,703340830,703340894,64
1360281986,703369436,3,138,46,1360281959698,1360281959826,703343134,703343262,128
1360281986,703369456,6,1266,211,1360281961344,1360281961536,703344800,703344992,192
1360281986,703369536,3,138,46,1360281960815,1360281960943,703344351,703344479,128
1360281990,703373400,3,138,46,1360281962616,1360281962808,703346016,703346208,192
1360281994,703377380,3,138,46,1360281965898,1360281965962,703349278,703349342,64
1360281994,703377388,2,92,46,1360281966341,1360281966341,703349729,703349729,0
1360281994,703377388,2,92,46,1360281966404,1360281966468,703349792,703349856,64
1360281994,703377392,5,1437,287.4,1360281966974,1360281967166,703350366,703350558,192
1360281994,703377396,3,138,46,1360281967418,1360281967418,703350814,703350814,0
1360281994,703377440,2,123,61.5,1360281969741,1360281969805,703353181,703353245,64
1360281994,703377464,1,77,77,1360281969720,1360281969720,703353184,703353184,0
1360281994,703377472,3,138,46,1360281966639,1360281966703,703350111,703350175,64
1360281994,703377548,2,123,61.5,1360281969636,1360281969636,703353184,703353184,0
1360281995,703379164,3,169,56.33333333,1360281986682,1360281991674,703370846,703375838,4992
1360281995,703379168,6,500,83.33333333,1360281991799,1360281991927,703375967,703376095,128
1360281995,703379248,3,138,46,1360281992616,1360281993064,703376864,703377312,448
1360281998,703381384,1,77,77,1360281971845,1360281971845,703355229,703355229,0
1360281998,703381396,25,2400,96,1360281970748,1360281997052,703354144,703380448,26304
1360281998,703381432,49,2744,56,1360281971031,1360281997335,703354463,703380767,26304
1360281998,703381436,25,1400,56,1360281971283,1360281997587,703354719,703381023,26304
1360281998,703381476,25,1400,56,1360281969963,1360281996843,703353439,703380319,26880
1360281998,703381480,1,77,77,1360281971752,1360281971752,703355232,703355232,0
1360281998,703381480,1,77,77,1360281971751,1360281971751,703355231,703355231,0
1360281998,703381516,50,2800,56,1360281970817,1360281997697,703354333,703381213,26880
1360282002,703385440,3,138,46,1360281976975,1360281977039,703360415,703360479,64
1360282003,703387148,3,138,46,1360282001929,1360282001993,703386077,703386141,64
1360282003,703387256,2,92,46,1360282002784,1360282002784,703387040,703387040,0
1360282004,3636666952,23,1288,56,1360281976492,1360282003500,3636639444,3636666452,27008
1360282006,703389400,3,138,46,1360281977911,1360281977975,703361311,703361375,64
1360282006,703389448,3,138,46,1360281979399,1360281979463,703362847,703362911,64
1360282006,703389452,2,123,61.5,1360281981763,1360281981891,703365215,703365343,128
1360282010,703393424,2,92,46,1360281982685,1360281982685,703366109,703366109,0
1360282010,703393424,3,138,46,1360281982942,1360281983006,703366366,703366430,64
1360282010,703393500,2,92,46,1360281982481,1360281982481,703365981,703365981,0
1360282010,703393544,8,1209,151.125,1360281985703,1360281998823,703369247,703382367,13120
1360282011,703395176,6,718,119.6666667,1360282006768,1360282007152,703390944,703391328,384
1360282018,703401424,2,92,46,1360281993887,1360281993887,703377311,703377311,0
1360282018,703401432,1,46,46,1360281990678,1360281990678,703374110,703374110,0
1360282018,703401480,2,123,61.5,1360281992744,1360281992808,703376224,703376288,64
1360282019,703403192,6,366,61,1360282016031,1360282016095,703400223,703400287,64
1360282019,703403192,6,366,61,1360282013022,1360282013086,703397214,703397278,64
1360282019,703403232,5,450,90,1360282015670,1360282018102,703399902,703402334,2432
1360282019,703403236,6,366,61,1360282015987,1360282016051,703400223,703400287,64
1360282019,703403236,7,412,58.85714286,1360282012978,1360282013042,703397214,703397278,64
1360282019,703403236,7,412,58.85714286,1360282013041,1360282013041,703397277,703397277,0
1360282019,703403236,7,412,58.85714286,1360282015984,1360282016048,703400220,703400284,64
1360282022,703405524,3,138,46,1360281994297,1360281995449,703377821,703378973,1152
1360282022,703405568,1,46,46,1360281997453,1360281997453,703381021,703381021,0
1360282026,703409452,45,2520,56,1360281999171,1360282025539,703382623,703408991,26368
1360282026,703409516,47,2632,56,1360281997890,1360282025538,703381406,703409054,27648
1360282026,703409520,24,1344,56,1360281998206,1360282025662,703381726,703409182,27456
1360282026,703409520,23,2208,96,1360281998269,1360282024573,703381789,703408093,26304
1360282026,703409528,23,1288,56,1360281998712,1360282025208,703382240,703408736,26496
1360282026,703409552,1,46,46,1360281999583,1360281999583,703383135,703383135,0
1360282026,703409564,2,92,46,1360282000403,1360282000531,703383967,703384095,128
1360282027,703411152,2,92,46,1360282021894,1360282021894,703406046,703406046,0
1360282027,703411156,7,412,58.85714286,1360282026050,1360282026114,703410206,703410270,64
1360282027,703411196,6,500,83.33333333,1360282021785,1360282021977,703405981,703406173,192
1360282030,703413448,1,46,46,1360282003654,1360282003654,703387102,703387102,0
1360282030,703413536,2,92,46,1360282002478,1360282002542,703386014,703386078,64
1360282032,3636694964,2,92,46,1360282006433,1360282006433,3636669397,3636669397,0
1360282032,3636694972,25,1400,56,1360282004633,1360282031833,3636667605,3636694805,27200
1360282034,703417472,2,180,90,1360282006831,1360282006895,703390303,703390367,64
1360282034,703417552,1,46,46,1360282006428,1360282006428,703389980,703389980,0
1360282034,703417584,2,92,46,1360282007421,1360282007421,703391005,703391005,0
1360282036,3636698948,2,92,46,1360282011439,1360282011439,3636674387,3636674387,0
1360282038,703421472,1,46,46,1360282012525,1360282012525,703395997,703395997,0
1360282038,703421544,1,46,46,1360282011558,1360282011558,703395102,703395102,0
1360282040,3636702952,1,46,46,1360282012459,1360282012459,3636675411,3636675411,0
1360282040,3636702972,2,92,46,1360282014425,1360282014425,3636677397,3636677397,0
1360282042,703425492,3,138,46,1360282015833,1360282015897,703399325,703399389,64
1360282042,703425496,1,46,46,1360282016405,1360282016405,703399901,703399901,0
1360282042,703425544,1,46,46,1360282015463,1360282015463,703399007,703399007,0
1360282042,703425544,2,92,46,1360282015461,1360282015461,703399005,703399005,0
1360282042,703425580,3,138,46,1360282016769,1360282016833,703400349,703400413,64
1360282043,703427184,4,205,51.25,1360282037925,1360282037925,703422109,703422109,0
1360282043,703427220,6,500,83.33333333,1360282036738,1360282036930,703420958,703421150,192
1360282043,703427224,7,412,58.85714286,1360282036988,1360282037052,703421212,703421276,64
1360282044,3636706984,2,92,46,1360282017421,1360282017421,3636680405,3636680405,0
1360282044,3636707024,1,46,46,1360282018340,1360282018340,3636681364,3636681364,0
1360282044,3636707024,2,92,46,1360282018340,1360282018468,3636681364,3636681492,128
1360282046,703429580,2,92,46,1360282020418,1360282020418,703403998,703403998,0
1360282046,703429580,1,46,46,1360282020418,1360282020418,703403998,703403998,0
1360282046,703429580,1,46,46,1360282020417,1360282020417,703403997,703403997,0
1360282050,703433580,1,46,46,1360282024962,1360282024962,703408542,703408542,0
1360282051,703435160,3,138,46,1360282042880,1360282043200,703427040,703427360,320
1360282051,703435204,9,4630,514.4444444,1360282045074,1360282045650,703429278,703429854,576
1360282051,703435204,290,396251,1366.382759,1360281924752,1360282046864,703308956,703431068,122112
1360282051,703435212,2,92,46,1360282042890,1360282042890,703427102,703427102,0
1360282051,703435212,215,293245,1363.930233,1360281933066,1360282048970,703317278,703433182,115904
1360282051,703435212,3,138,46,1360282042954,1360282043466,703427166,703427678,512
1360282051,703435240,3,138,46,1360282043823,1360282044079,703428063,703428319,256
1360282054,703437496,25,1400,56,1360282026389,1360282052821,703409885,703436317,26432
1360282054,703437524,25,1400,56,1360282026811,1360282053499,703410335,703437023,26688
1360282054,703437564,26,2496,96,1360282025875,1360282053587,703409439,703437151,27712
1360282054,703437564,51,2856,56,1360282026000,1360282053776,703409564,703437340,27776
1360282054,703437568,50,2800,56,1360282026125,1360282053133,703409693,703436701,27008
1360282054,3636717608,3,138,46,1360282047837,1360282048349,3636711445,3636711957,512
1360282054,3636717608,113,142862,1264.265487,1360281928219,1360282046875,3636591827,3636710483,118656
1360282059,703443156,5,236,47.2,1360282045185,1360282057793,703429341,703441949,12608
1360282059,703443160,4,190,47.5,1360282045374,1360282050942,703429534,703435102,5568
1360282059,703443172,6,500,83.33333333,1360282051760,1360282051952,703435932,703436124,192
1360282060,3636723004,24,1344,56,1360282033272,1360282059320,3636696276,3636722324,26048
1360282062,703445536,5,942,188.4,1360282034285,1360282049517,703417821,703433053,15232
1360282064,3636727044,2,92,46,1360282038414,1360282038478,3636701458,3636701522,64
1360282066,703449540,1,46,46,1360282040488,1360282040488,703424028,703424028,0
1360282066,703449544,1,46,46,1360282040487,1360282040487,703424031,703424031,0
1360282066,703449544,1,46,46,1360282040487,1360282040487,703424031,703424031,0
1360282066,703449572,10,2604,260.4,1360282038089,1360282049929,703421661,703433501,11840
1360282066,703449620,2,92,46,1360282040409,1360282040473,703424029,703424093,64
1360282066,703449620,1,46,46,1360282040408,1360282040408,703424028,703424028,0
1360282067,703451228,2,92,46,1360282063866,1360282063866,703448094,703448094,0
1360282068,3636730980,2,92,46,1360282041486,1360282041486,3636704466,3636704466,0
1360282068,3636730988,1,46,46,1360282042505,1360282042505,3636705493,3636705493,0
1360282068,3636731004,2,92,46,1360282043448,1360282043448,3636706452,3636706452,0
1360282068,3636731016,2,92,46,1360282042475,1360282042475,3636705491,3636705491,0
1360282070,703453508,2,92,46,1360282043595,1360282043595,703427103,703427103,0
1360282070,703453548,2,92,46,1360282044514,1360282044706,703428062,703428254,192
1360282070,703453668,11,6847,622.4545455,1360282045611,1360282046059,703429279,703429727,448
1360282072,3636734984,2,92,46,1360282044491,1360282044491,3636707475,3636707475,0
1360282072,3636735008,1,46,46,1360282047476,1360282047476,3636710484,3636710484,0
1360282072,3636735012,2,92,46,1360282046448,1360282046512,3636709460,3636709524,64
1360282072,3636735040,1,46,46,1360282047443,1360282047443,3636710483,3636710483,0
1360282072,3636735040,1,46,46,1360282047443,1360282047443,3636710483,3636710483,0
1360282074,703457508,1,46,46,1360282046537,1360282046537,703430045,703430045,0
1360282074,703457512,2,180,90,1360282046790,1360282046854,703430302,703430366,64
1360282074,703457544,1,46,46,1360282048484,1360282048484,703432028,703432028,0
1360282074,703457544,1,46,46,1360282048484,1360282048484,703432028,703432028,0
1360282074,703457544,1,46,46,1360282048548,1360282048548,703432092,703432092,0
1360282074,703457632,1,46,46,1360282048462,1360282048462,703432094,703432094,0
1360282074,703457660,1,46,46,1360282049393,1360282049393,703433053,703433053,0
1360282074,703457664,1,46,46,1360282049391,1360282049391,703433055,703433055,0
1360282075,703459204,6,500,83.33333333,1360282066768,1360282066896,703450972,703451100,128
1360282076,3636739016,2,92,46,1360282048428,1360282048556,3636711444,3636711572,128
1360282078,703461520,2,92,46,1360282050557,1360282050557,703434077,703434077,0
1360282082,703465504,24,1344,56,1360282054156,1360282080780,703437660,703464284,26624
1360282082,703465508,48,2688,56,1360282054536,1360282081672,703438044,703465180,27136
1360282082,703465512,24,2304,96,1360282054917,1360282081541,703438429,703465053,26624
1360282082,703465520,2,92,46,1360282055547,1360282055547,703439067,703439067,0
1360282082,703465588,49,2744,56,1360282053947,1360282081723,703437535,703465311,27776
1360282082,703465592,24,1344,56,1360282054773,1360282081333,703438365,703464925,26560
1360282083,703467196,6,500,83.33333333,1360282081754,1360282081946,703465950,703466142,192
1360282088,3636750984,25,1400,56,1360282060493,1360282087565,3636723477,3636750549,27072
1360282091,703475248,228,289123,1268.083333,1360281923300,1360282085732,703307548,703469980,162432
1360282099,703483228,13720,18337786,1336.573324,1360281969976,1360282095992,703354204,703480220,126016
1360282102,703485664,2,92,46,1360282077294,1360282077358,703460958,703461022,64
1360282110,703493568,13,728,56,1360282082317,1360282089037,703465885,703472605,6720
1360282110,703493632,7,392,56,1360282081803,1360282088523,703465435,703472155,6720
1360282110,703493644,13,728,56,1360282082178,1360282088834,703465822,703472478,6656
1360282110,703493648,6,336,56,1360282082366,1360282087998,703466014,703471646,5632
1360282110,703493648,6,576,96,1360282082492,1360282088124,703466140,703471772,5632
1360282114,703497544,2,180,90,1360282086820,1360282086884,703470364,703470428,64
1360282114,703497628,2,92,46,1360282086354,1360282086354,703469982,703469982,0
1360282114,703497692,3,606,202,1360282088655,1360282088847,703472347,703472539,192
1360282116,3636779300,1,56,56,1360282088464,1360282088464,3636751764,3636751764,0
1360282134,703517616,3,138,46,1360282107739,1360282107739,703491355,703491355,0
1360282154,703537540,4,272,68,1360282126822,1360282152742,703510362,703536282,25920
1360282154,703537660,4,538,134.5,1360282129137,1360282152689,703512797,703536349,23552
1360282155,703539228,4,306,76.5,1360282150713,1360282152185,703534941,703536413,1472
1360282155,703539268,772,567635,735.2784974,1360281314066,1360282152146,702698334,703536414,838080
1360282155,703539272,7,3266,466.5714286,1360282145420,1360282152076,703529692,703536348,6656
1360282155,703539300,6,832,138.6666667,1360282150514,1360282152242,703534814,703536542,1728
1360282155,703539300,8,490,61.25,1360282150577,1360282151985,703534877,703536285,1408
1360282155,703539300,4,306,76.5,1360282150640,1360282151984,703534940,703536284,1344
1360282171,703555284,4,1246,311.5,1360282169024,1360282169856,703553308,703554140,832
1360282178,703561588,2,214,107,1360282151290,1360282151354,703534878,703534942,64
1360282178,703561620,1,52,52,1360282152664,1360282152664,703536284,703536284,0
1360282198,703581652,4,1600,400,1360282171513,1360282186425,703555165,703570077,14912
1360282230,703613756,1,400,400,1360282203279,1360282203279,703587035,703587035,0
1360282262,703645808,1,400,400,1360282237276,1360282237276,703621084,703621084,0
1360282476,703860232,1,46,46,1360282449967,1360282449967,703834199,703834199,0
1360283973,705356716,1,46,46,1360283945885,1360283945885,705329601,705329601,0
1360285300,706683860,1,48,48,1360285274362,1360285274362,706658222,706658222,0
1360285328,706711932,1,46,46,1360285301678,1360285301678,706685610,706685610,0
1360285328,706711956,1,46,46,1360285301656,1360285301656,706685612,706685612,0
1360285328,706711972,1,46,46,1360285301706,1360285301706,706685678,706685678,0
1360285328,706712004,1,46,46,1360285301673,1360285301673,706685677,706685677,0
1360285328,706712048,1,46,46,1360285301693,1360285301693,706685741,706685741,0
1360285328,706712156,1,46,46,1360285301649,1360285301649,706685805,706685805,0
1360285329,706712772,1,46,46,1360285301776,1360285301776,706685548,706685548,0
1360285329,706712804,1,46,46,1360285301742,1360285301742,706685546,706685546,0
1360285329,706712844,1,46,46,1360285301769,1360285301769,706685613,706685613,0
1360285329,706712988,1,46,46,1360285301751,1360285301751,706685739,706685739,0
1360285329,706713020,1,46,46,1360285301719,1360285301719,706685739,706685739,0
1360285329,706713092,1,46,46,1360285301711,1360285301711,706685803,706685803,0
1360287155,708538936,1,46,46,1360287127184,1360287127184,708511120,708511120,0
1360287346,708730188,1,48,48,1360287315922,1360287315922,708700110,708700110,0
1360288262,709646040,1,46,46,1360288233688,1360288233688,709617728,709617728,0
1360288758,710142048,1,48,48,1360288732488,1360288732488,710116536,710116536,0
1360290651,712035016,1,46,46,1360290624651,1360290624651,712008667,712008667,0
1360290711,712094572,1,58,58,1360290685957,1360290685957,712069529,712069529,0
1360292632,714015980,1,46,46,1360292604627,1360292604627,713988607,713988607,0
1360292723,714107312,1,447,447,1360292696002,1360292696002,714080314,714080314,0
1360293088,714471888,1,46,46,1360293061158,1360293061158,714445046,714445046,0
1360294856,716239828,1,46,46,1360294827593,1360294827593,716211421,716211421,0
1360295397,716781292,1,46,46,1360295369904,1360295369904,716754196,716754196,0
1360297127,718510908,1,46,46,1360297101267,1360297101267,718485175,718485175,0
1360297127,718510976,1,46,46,1360297101263,1360297101263,718485239,718485239,0
1360297128,718511992,1,46,46,1360297101250,1360297101250,718485242,718485242,0
1360297128,718512072,1,46,46,1360297101232,1360297101232,718485304,718485304,0
1360298052,719435784,1,46,46,1360298025283,1360298025283,719409067,719409067,0
1360299190,720573568,1,46,46,1360299165001,1360299165001,720548569,720548569,0
1360299479,720862408,1,46,46,1360299451751,1360299451751,720835159,720835159,0
1360299932,721315584,1,46,46,1360299904048,1360299904048,721287632,721287632,0
1360301531,722915184,1,46,46,1360301504766,1360301504766,722888950,722888950,0
1360301539,722923244,1,48,48,1360301514754,1360301514754,722898998,722898998,0
1360303389,724772708,1,48,48,1360303361471,1360303361471,724745179,724745179,0
1360304857,726240488,1,48,48,1360304829379,1360304829379,726212867,726212867,0
1360306511,727895272,1,46,46,1360306486621,1360306486621,727870893,727870893,0
1360307093,728476668,2,120,60,1360307066094,1360307066094,728449762,728449762,0
1360307650,729033344,1,46,46,1360307623465,1360307623465,729006809,729006809,0
1360308383,729767196,1,48,48,1360308357195,1360308357195,729741391,729741391,0
1360308637,730021256,1,46,46,1360308611018,1360308611018,729995274,729995274,0
1360308638,730022052,1,46,46,1360308611094,1360308611094,729995146,729995146,0
1360308638,730022068,1,46,46,1360308611080,1360308611080,729995148,729995148,0
1360308638,730022112,1,46,46,1360308611100,1360308611100,729995212,729995212,0
1360308638,730022144,1,46,46,1360308611066,1360308611066,729995210,729995210,0
1360309731,731114356,1,46,46,1360309704255,1360309704255,731087611,731087611,0
1360310058,731441524,1,46,46,1360310031057,1360310031057,731414581,731414581,0
1360310783,732167256,2,120,60,1360310758188,1360310761196,732142444,732145452,3008
1360311585,732968932,1,60,60,1360311560609,1360311560609,732944541,732944541,0
1360311673,733057184,1,46,46,1360311646820,1360311646820,733031004,733031004,0
1360311978,733362124,2,122,61,1360311953372,1360311955804,733337496,733339928,2432
1360316219,737603000,3,144,48,1360316192025,1360316200921,737576025,737584921,8896
1360316360,737743504,1,48,48,1360316335305,1360316335305,737718809,737718809,0
1360319639,741022484,1,48,48,1360319613224,1360319613224,740996708,740996708,0
1360319772,741155516,1,46,46,1360319745287,1360319745287,741128803,741128803,0
1360319772,741155552,1,46,46,1360319745250,1360319745250,741128802,741128802,0
1360319772,741155592,1,46,46,1360319745210,1360319745210,741128802,741128802,0
1360319772,741155604,1,46,46,1360319745262,1360319745262,741128866,741128866,0
1360319772,741155676,1,46,46,1360319745254,1360319745254,741128930,741128930,0
1360319773,741156324,1,46,46,1360319745414,1360319745414,741128738,741128738,0
1360319773,741156336,1,46,46,1360319745402,1360319745402,741128738,741128738,0
1360319773,741156528,1,46,46,1360319745341,1360319745341,741128869,741128869,0
1360320052,741435744,1,46,46,1360320024481,1360320024481,741408225,741408225,0
1360320777,742160296,1,46,46,1360320749844,1360320749844,742133140,742133140,0
1360323680,745063344,1,46,46,1360323653431,1360323653431,745036775,745036775,0
1360328820,750204112,1,48,48,1360328790889,1360328790889,750175001,750175001,0
1360330476,751859440,1,46,46,1360330450033,1360330450033,751833473,751833473,0
1360330476,751859528,1,46,46,1360330450008,1360330450008,751833536,751833536,0
1360330476,751859560,1,46,46,1360330449976,1360330449976,751833536,751833536,0
1360330477,751860208,1,46,46,1360330450265,1360330450265,751833473,751833473,0
1360330477,751860240,1,46,46,1360330450296,1360330450296,751833536,751833536,0
1360330477,751860328,1,46,46,1360330450273,1360330450273,751833601,751833601,0
1360330477,751860372,1,46,46,1360330450230,1360330450230,751833602,751833602,0
1360330477,751860408,1,46,46,1360330450259,1360330450259,751833667,751833667,0
1360330575,751958512,1,48,48,1360330548455,1360330548455,751931967,751931967,0
1360331344,752728172,1,48,48,1360331318155,1360331318155,752702327,752702327,0
1360332659,754043124,1,46,46,1360332633125,1360332633125,754017249,754017249,0
1360333045,754428396,2,122,61,1360333020791,1360333022967,754404187,754406363,2176
1360333073,754456888,1,46,46,1360333045322,1360333045322,754429210,754429210,0
1360333105,754488416,1,46,46,1360333077410,1360333077410,754460826,754460826,0
1360333442,754825400,1,46,46,1360333415534,1360333415534,754798934,754798934,0
1360334421,755804252,1,78,78,1360334394480,1360334394480,755777732,755777732,0
1360335896,757280036,1,46,46,1360335869772,1360335869772,757253808,757253808,0
1360335928,757312080,1,46,46,1360335901023,1360335901023,757285103,757285103,0
1360337556,758939856,1,60,60,1360337530280,1360337530280,758914136,758914136,0
1360337644,759027976,6,298,49.66666667,1360337617519,1360337638639,759001495,759022615,21120
1360338222,759605392,1,46,46,1360338194156,1360338194156,759577548,759577548,0
1360338305,759688920,1,46,46,1360338276572,1360338276572,759660492,759660492,0
1360338923,760306516,1,48,48,1360338898406,1360338898406,760281922,760281922,0
1360338983,760366920,1,46,46,1360338955603,1360338955603,760339523,760339523,0
1360338999,760382340,1,48,48,1360338969877,1360338969877,760353217,760353217,0
1360339132,760515416,1,48,48,1360339104201,1360339104201,760487617,760487617,0
1360340944,762327504,1,46,46,1360340919442,1360340919442,762302946,762302946,0
1360341138,762521468,1,46,46,1360341109812,1360341109812,762493280,762493280,0
1360341139,762522416,1,46,46,1360341109866,1360341109866,762493282,762493282,0
1360341139,762522416,1,46,46,1360341109864,1360341109864,762493280,762493280,0
1360341297,762680260,1,46,46,1360341272003,1360341272003,762655263,762655263,0
1360341369,762752304,1,46,46,1360341344149,1360341344149,762727453,762727453,0
1360341521,762904540,1,46,46,1360341493031,1360341493031,762876571,762876571,0
1360341813,763197044,1,46,46,1360341786281,1360341786281,763170325,763170325,0
1360342836,764219404,1,46,46,1360342808412,1360342808412,764191816,764191816,0
1360342968,764351788,1,46,46,1360342942618,1360342942618,764326406,764326406,0
1360343141,764524460,4,192,48,1360343113438,1360343115614,764496898,764499074,2176
1360343466,764849264,1,46,46,1360343438239,1360343438239,764821503,764821503,0
1360344633,766016344,1,125,125,1360344604798,1360344604798,765988142,765988142,0
1360348288,769671388,1,46,46,1360348260313,1360348260313,769643701,769643701,0
1360348560,769944116,1,48,48,1360348532221,1360348532221,769916337,769916337,0
1360348813,770196476,1,46,46,1360348785143,1360348785143,770168619,770168619,0
1360349086,770469244,1,46,46,1360349061406,1360349061406,770444650,770444650,0
1360350039,771422908,1,46,46,1360350012916,1360350012916,771396824,771396824,0
1360351806,773189680,1,46,46,1360351777408,1360351777408,773161088,773161088,0
1360351806,773189780,1,46,46,1360351777371,1360351777371,773161151,773161151,0
1360351806,773189864,1,46,46,1360351777350,1360351777350,773161214,773161214,0
1360351807,773191068,1,46,46,1360351777020,1360351777020,773161088,773161088,0
1360351807,773191112,1,46,46,1360351777038,1360351777038,773161150,773161150,0
1360351808,773191192,1,46,46,1360351777959,1360351777959,773161151,773161151,0
1360351808,773191232,1,46,46,1360351777983,1360351777983,773161215,773161215,0
1360351808,773191280,1,46,46,1360351777935,1360351777935,773161215,773161215,0
1360351808,773191320,1,46,46,1360351777960,1360351777960,773161280,773161280,0
1360351991,773374940,1,46,46,1360351963257,1360351963257,773347197,773347197,0
1360352329,773712988,1,46,46,1360352302659,1360352302659,773686647,773686647,0
1360353376,774759236,3,144,48,1360353351074,1360353360162,774734310,774743398,9088
1360354245,775628876,1,46,46,1360354216855,1360354216855,775600731,775600731,0
1360356345,777728596,1,48,48,1360356317070,1360356317070,777700666,777700666,0
1360356571,777954576,1,48,48,1360356543774,1360356543774,777927350,777927350,0
1361553738,1975117736,1,60,60,1361553711082,1361553711082,1975090818,1975090818,0
1361554335,1975714764,1,52,52,1361554308163,1361554308163,1975687927,1975687927,0
1361554335,1975714800,1,52,52,1361554309151,1361554309151,1975688951,1975688951,0
1361555253,1976632980,1,447,447,1361555226014,1361555226014,1976605994,1976605994,0
1361555313,1976692756,1,46,46,1361555286720,1361555286720,1976666476,1976666476,0
1361555491,1976871268,1,48,48,1361555463166,1361555463166,1976843434,1976843434,0
1361555562,1976941912,1,46,46,1361555534111,1361555534111,1976914023,1976914023,0
1361555979,1977358812,1,46,46,1361555951998,1361555951998,1977331810,1977331810,0
1361556023,615716268,6,455,75.83333333,1361556018280,1361556018408,615711548,615711676,128
1361556023,1977402584,8,4014,501.75,1361556015265,1361556021857,1977394849,1977401441,6592
1361556023,1977402584,7,712,101.7142857,1361556015135,1361556021919,1977394719,1977401503,6784
1361556031,1977410588,2,92,46,1361556023900,1361556027996,1977403488,1977407584,4096
1361556031,1977410632,3,138,46,1361556022959,1361556029295,1977402591,1977408927,6336
1361556031,1977410664,2,98,49,1361556024274,1361556030098,1977403938,1977409762,5824
1361556031,1977410676,5,460,92,1361556029508,1361556030340,1977409184,1977410016,832
1361556039,615732268,2,98,49,1361556031463,1361556037287,615724731,615730555,5824
1361556039,615732268,2,98,49,1361556031463,1361556037287,615724731,615730555,5824
1361556039,615732268,3,144,48,1361556031463,1361556037287,615724731,615730555,5824
1361556039,615732272,3,144,48,1361556025570,1361556031330,615718842,615724602,5760
1361556039,615732272,3,144,48,1361556025570,1361556031330,615718842,615724602,5760
1361556039,615732276,3,144,48,1361556030686,1361556036318,615723962,615729594,5632
1361556039,615732276,3,144,48,1361556031454,1361556037278,615724730,615730554,5824
1361556039,615732276,2,98,49,1361556031453,1361556037277,615724729,615730553,5824
1361556039,615732276,2,98,49,1361556031457,1361556037281,615724733,615730557,5824
1361556039,615732276,3,144,48,1361556027169,1361556032289,615720445,615725565,5120
1361556039,615732292,2,98,49,1361556025551,1361556031247,615718843,615724539,5696
1361556039,615732292,3,144,48,1361556025551,1361556031247,615718843,615724539,5696
1361556039,1977418632,2,98,49,1361556026993,1361556032113,1977406625,1977411745,5120
1361556039,1977418632,2,98,49,1361556026993,1361556032113,1977406625,1977411745,5120
1361556039,1977418632,2,98,49,1361556026993,1361556032113,1977406625,1977411745,5120
1361556039,1977418632,3,144,48,1361556026993,1361556032177,1977406625,1977411809,5184
1361556039,1977418680,2,94,47,1361556029503,1361556035071,1977409183,1977414751,5568
1361556039,1977418680,4,190,47.5,1361556029567,1361556035071,1977409247,1977414751,5504
1361556039,1977418680,4,190,47.5,1361556029502,1361556035134,1977409182,1977414814,5632
1361556039,1977418704,2,98,49,1361556026920,1361556032040,1977406624,1977411744,5120
1361556039,1977418704,3,150,50,1361556026918,1361556032038,1977406622,1977411742,5120
1361556039,1977418912,11,2933,266.6363636,1361556030488,1361556030872,1977410400,1977410784,384
1361556051,1977430932,6,1614,269,1361556023492,1361556023748,1977403424,1977403680,256
1361556051,1977430940,10,3093,309.3,1361556024252,1361556024508,1977404192,1977404448,256
1361556051,1977430980,33,13297,402.9393939,1361556026322,1361556029266,1977406302,1977409246,2944
1361556051,1977431044,9,2632,292.4444444,1361556024338,1361556024722,1977404382,1977404766,384
1361556051,1977431044,8,4246,530.75,1361556024403,1361556029651,1977404447,1977409695,5248
1361556051,1977431052,18,13774,765.2222222,1361556025100,1361556031372,1977405152,1977411424,6272
1361556054,615747432,20,23110,1155.5,1361556027013,1361556027397,615720445,615720829,384
1361556054,615747432,13,12594,968.7692308,1361556027013,1361556027589,615720445,615721021,576
1361556054,615747432,23,25026,1088.086957,1361556027076,1361556028100,615720508,615721532,1024
1361556054,615747436,9,8310,923.3333333,1361556027712,1361556028416,615721148,615721852,704
1361556054,615747476,15,15650,1043.333333,1361556026968,1361556027224,615720444,615720700,256
1361556054,615747476,20,22536,1126.8,1361556026968,1361556027480,615720444,615720956,512
1361556054,615747476,14,12533,895.2142857,1361556027031,1361556028375,615720507,615721851,1344
1361556055,1977434684,2,92,46,1361556036026,1361556052282,1977415710,1977431966,16256
1361556055,1977434696,2,92,46,1361556037680,1361556054576,1977417376,1977434272,16896
1361556055,1977434956,66,86700,1313.636364,1361556027373,1361556031405,1977407329,1977411361,4032
1361556055,1977434996,11,7228,657.0909091,1361556029188,1361556030084,1977409184,1977410080,896
1361556055,1977434996,26,4945,190.1923077,1361556029188,1361556030468,1977409184,1977410464,1280
1361556055,1977435000,4,1247,311.75,1361556029185,1361556029889,1977409185,1977409889,704
1361556055,1977435040,10,4405,440.5,1361556027288,1361556027544,1977407328,1977407584,256
1361556055,1977435068,14,3700,264.2857143,1361556027837,1361556030077,1977407905,1977410145,2240
1361556055,1977435076,7,1043,149,1361556028723,1361556029491,1977408799,1977409567,768
1361556059,1977438988,4,659,164.75,1361556033229,1361556058829,1977413217,1977438817,25600
1361556071,1977451056,1,46,46,1361556044231,1361556044231,1977424287,1977424287,0
1361556079,615772464,4,190,47.5,1361556069027,1361556074275,615762491,615767739,5248
1361556079,1977458684,4,190,47.5,1361556070265,1361556076089,1977449949,1977455773,5824
1361556079,1977458940,1,72,72,1361556054522,1361556054522,1977434462,1977434462,0
1361556079,1977458940,1,72,72,1361556054585,1361556054585,1977434525,1977434525,0
1361556079,1977458944,1,72,72,1361556054585,1361556054585,1977434529,1977434529,0
1361556079,1977458944,1,72,72,1361556054646,1361556054646,1977434590,1977434590,0
1361556079,1977458996,1,72,72,1361556053699,1361556053699,1977433695,1977433695,0
1361556079,1977459000,1,72,72,1361556053825,1361556053825,1977433825,1977433825,0
1361556079,1977459000,1,72,72,1361556053761,1361556053761,1977433761,1977433761,0
1361556079,1977459000,1,72,72,1361556053761,1361556053761,1977433761,1977433761,0
1361556079,1977459000,1,72,72,1361556054016,1361556054016,1977434016,1977434016,0
1361556079,1977459000,1,72,72,1361556054016,1361556054016,1977434016,1977434016,0
1361556079,1977459000,1,72,72,1361556054079,1361556054079,1977434079,1977434079,0
1361556079,1977459000,1,72,72,1361556054079,1361556054079,1977434079,1977434079,0
1361556079,1977459024,1,72,72,1361556054183,1361556054183,1977434207,1977434207,0
1361556079,1977459024,1,72,72,1361556054183,1361556054183,1977434207,1977434207,0
1361556079,1977459024,1,72,72,1361556054312,1361556054312,1977434336,1977434336,0
1361556079,1977459024,1,72,72,1361556054376,1361556054376,1977434400,1977434400,0
1361556079,1977459024,1,72,72,1361556054375,1361556054375,1977434399,1977434399,0
1361556079,1977459024,1,72,72,1361556054439,1361556054439,1977434463,1977434463,0
1361556079,1977459024,1,72,72,1361556054439,1361556054439,1977434463,1977434463,0
1361556079,1977459024,17,4044,237.8823529,1361556054055,1361556078567,1977434079,1977458591,24512
1361556079,1977459024,1,72,72,1361556054054,1361556054054,1977434078,1977434078,0
1361556079,1977459024,1,72,72,1361556054182,1361556054182,1977434206,1977434206,0
1361556079,1977459024,1,72,72,1361556054246,1361556054246,1977434270,1977434270,0
1361556079,1977459028,1,72,72,1361556054241,1361556054241,1977434269,1977434269,0
1361556079,1977459028,1,72,72,1361556054241,1361556054241,1977434269,1977434269,0
1361556079,1977459028,1,72,72,1361556054309,1361556054309,1977434337,1977434337,0
1361556079,1977459028,1,72,72,1361556054373,1361556054373,1977434401,1977434401,0
1361556079,1977459028,1,72,72,1361556054499,1361556054499,1977434527,1977434527,0
1361556079,1977459076,1,72,72,1361556053619,1361556053619,1977433695,1977433695,0
1361556079,1977459076,1,72,72,1361556053619,1361556053619,1977433695,1977433695,0
1361556079,1977459080,1,72,72,1361556053613,1361556053613,1977433693,1977433693,0
1361556079,1977459080,1,72,72,1361556053613,1361556053613,1977433693,1977433693,0
1361556079,1977459080,1,72,72,1361556053677,1361556053677,1977433757,1977433757,0
1361556079,1977459100,1,72,72,1361556053661,1361556053661,1977433761,1977433761,0
1361556079,1977459100,1,72,72,1361556053657,1361556053657,1977433757,1977433757,0
1361556079,1977459100,1,72,72,1361556053721,1361556053721,1977433821,1977433821,0
1361556079,1977459100,1,72,72,1361556053721,1361556053721,1977433821,1977433821,0
1361556079,1977459104,1,72,72,1361556053721,1361556053721,1977433825,1977433825,0
1361556079,1977459104,1,72,72,1361556053721,1361556053721,1977433825,1977433825,0
1361556079,1977459104,1,72,72,1361556053785,1361556053785,1977433889,1977433889,0
1361556079,1977459104,1,72,72,1361556053785,1361556053785,1977433889,1977433889,0
1361556079,1977459104,1,72,72,1361556053720,1361556053720,1977433824,1977433824,0
1361556079,1977459104,1,72,72,1361556053848,1361556053848,1977433952,1977433952,0
1361556079,1977459104,1,72,72,1361556053848,1361556053848,1977433952,1977433952,0
1361556079,1977459104,1,72,72,1361556053911,1361556053911,1977434015,1977434015,0
1361556079,1977459104,1,72,72,1361556053783,1361556053783,1977433887,1977433887,0
1361556079,1977459104,1,72,72,1361556053783,1361556053783,1977433887,1977433887,0
1361556079,1977459104,1,72,72,1361556053975,1361556053975,1977434079,1977434079,0
1361556079,1977459104,1,72,72,1361556053910,1361556053910,1977434014,1977434014,0
1361556079,1977459104,1,72,72,1361556053974,1361556053974,1977434078,1977434078,0
1361556079,1977459104,1,72,72,1361556053910,1361556053910,1977434014,1977434014,0
1361556079,1977459108,1,72,72,1361556053969,1361556053969,1977434077,1977434077,0
1361556079,1977459108,1,72,72,1361556054033,1361556054033,1977434141,1977434141,0
1361556079,1977459108,1,72,72,1361556054033,1361556054033,1977434141,1977434141,0
1361556079,1977459108,1,72,72,1361556054033,1361556054033,1977434141,1977434141,0
1361556079,1977459108,1,72,72,1361556054033,1361556054033,1977434141,1977434141,0
1361556079,1977459108,1,72,72,1361556054037,1361556054037,1977434145,1977434145,0
1361556079,1977459108,1,72,72,1361556054101,1361556054101,1977434209,1977434209,0
1361556079,1977459108,1,72,72,1361556054100,1361556054100,1977434208,1977434208,0
1361556079,1977459108,1,72,72,1361556054164,1361556054164,1977434272,1977434272,0
1361556079,1977459108,1,72,72,1361556054163,1361556054163,1977434271,1977434271,0
1361556079,1977459108,1,72,72,1361556054163,1361556054163,1977434271,1977434271,0
1361556079,1977459108,1,72,72,1361556054227,1361556054227,1977434335,1977434335,0
1361556079,1977459108,1,72,72,1361556054226,1361556054226,1977434334,1977434334,0
1361556079,1977459108,1,72,72,1361556054289,1361556054289,1977434397,1977434397,0
1361556079,1977459112,1,72,72,1361556054353,1361556054353,1977434465,1977434465,0
1361556079,1977459112,1,72,72,1361556054353,1361556054353,1977434465,1977434465,0
1361556087,1977467016,7,1636,233.7142857,1361556058927,1361556069551,1977438943,1977449567,10624
1361556095,1977475104,44,57908,1316.090909,1361556069845,1361556070037,1977449949,1977450141,192
1361556095,1977475104,4,4079,1019.75,1361556069784,1361556069848,1977449888,1977449952,64
1361556103,1977482656,3,144,48,1361556095958,1361556101974,1977475614,1977481630,6016
1361556103,1977482660,3,144,48,1361556096468,1361556101524,1977476128,1977481184,5056
1361556103,1977482736,2,98,49,1361556096389,1361556101381,1977476125,1977481117,4992
1361556103,1977483048,1,46,46,1361556075789,1361556075789,1977455837,1977455837,0
1361556103,1977483096,1,46,46,1361556077087,1361556077087,1977457183,1977457183,0
1361556103,1977483124,1,46,46,1361556078273,1361556078273,1977458397,1977458397,0
1361556107,1977486968,1,46,46,1361556079648,1361556079648,1977459616,1977459616,0
1361556107,1977487008,1,46,46,1361556081143,1361556081143,1977461151,1977461151,0
1361556107,1977487040,1,46,46,1361556082647,1361556082647,1977462687,1977462687,0
1361556107,1977487092,1,46,46,1361556080673,1361556080673,1977460765,1977460765,0
1361556107,1977487128,3,169,56.33333333,1361556082557,1361556082557,1977462685,1977462685,0
1361556111,1977490656,12,3389,282.4166667,1361556107734,1361556109462,1977487390,1977489118,1728
1361556111,1977490656,11,2724,247.6363636,1361556107798,1361556109782,1977487454,1977489438,1984
1361556111,1977490688,3,144,48,1361556105079,1361556110839,1977484767,1977490527,5760
1361556111,1977490688,11,3327,302.4545455,1361556105206,1361556105462,1977484894,1977485150,256
1361556111,1977490696,13,3419,263,1361556106413,1361556107693,1977486109,1977487389,1280
1361556111,1977490700,3,144,48,1361556101676,1361556107628,1977481376,1977487328,5952
1361556111,1977490728,11,2724,247.6363636,1361556107533,1361556109261,1977487261,1977488989,1728
1361556111,1977490732,9,3251,361.2222222,1361556107787,1361556108683,1977487519,1977488415,896
1361556111,1977490740,3,144,48,1361556104900,1361556110724,1977484640,1977490464,5824
1361556111,1977490764,10,3281,328.1,1361556106346,1361556107370,1977486110,1977487134,1024
1361556111,1977490764,10,3281,328.1,1361556106346,1361556107242,1977486110,1977487006,896
1361556111,1977490764,10,3919,391.9,1361556106346,1361556107370,1977486110,1977487134,1024
1361556111,1977490976,1,46,46,1361556082904,1361556082904,1977462880,1977462880,0
1361556111,1977490988,20,1920,96,1361556083658,1361556110794,1977463646,1977490782,27136
1361556111,1977490992,1,46,46,1361556084039,1361556084039,1977464031,1977464031,0
1361556111,1977491020,9,504,56,1361556084843,1361556109611,1977464863,1977489631,24768
1361556111,1977491028,1,46,46,1361556085605,1361556085605,1977465633,1977465633,0
1361556111,1977491092,18,1008,56,1361556083938,1361556110562,1977464030,1977490654,26624
1361556111,1977491096,1,46,46,1361556084191,1361556084191,1977464287,1977464287,0
1361556111,1977491096,1,46,46,1361556084381,1361556084381,1977464477,1977464477,0
1361556111,1977491108,3,169,56.33333333,1361556085585,1361556085585,1977465693,1977465693,0
1361556115,1977495024,1,46,46,1361556087525,1361556087525,1977467549,1977467549,0
1361556115,1977495028,5,394,78.8,1361556087652,1361556107684,1977467680,1977487712,20032
1361556115,1977495052,1,77,77,1361556088651,1361556088651,1977468703,1977468703,0
1361556115,1977495060,1,46,46,1361556089348,1361556089348,1977469408,1977469408,0
1361556115,1977495064,1,46,46,1361556090174,1361556090174,1977470238,1977470238,0
1361556115,1977495096,1,46,46,1361556090781,1361556090781,1977470877,1977470877,0
1361556115,1977495112,1,46,46,1361556087952,1361556087952,1977468064,1977468064,0
1361556115,1977495144,8,448,56,1361556089262,1361556111918,1977469406,1977492062,22656
1361556119,1977498744,3,144,48,1361556111934,1361556117758,1977491678,1977497502,5824
1361556119,1977498748,3,144,48,1361556107836,1361556113980,1977487584,1977493728,6144
1361556119,1977498752,3,144,48,1361556108088,1361556114040,1977487840,1977493792,5952
1361556119,1977498752,3,144,48,1361556108088,1361556115576,1977487840,1977495328,7488
1361556119,1977498752,2,98,49,1361556108406,1361556113910,1977488158,1977493662,5504
1361556119,1977498756,3,144,48,1361556109041,1361556115377,1977488797,1977495133,6336
1361556119,1977498796,545,725347,1330.911927,1361556112396,1361556115404,1977492192,1977495200,3008
1361556119,1977498820,2,98,49,1361556108340,1361556113844,1977488160,1977493664,5504
1361556119,1977499016,1,46,46,1361556091952,1361556091952,1977471968,1977471968,0
1361556119,1977499124,1,46,46,1361556093057,1361556093057,1977473181,1977473181,0
1361556122,615815416,7,8064,1152,1361556095892,1361556095892,615789308,615789308,0
1361556123,1977503008,1,46,46,1361556095030,1361556095030,1977475038,1977475038,0
1361556123,1977503012,21,16536,787.4285714,1361556095345,1361556101425,1977475357,1977481437,6080
1361556123,1977503016,38,48094,1265.631579,1361556095853,1361556096365,1977475869,1977476381,512
1361556123,1977503048,1,46,46,1361556096973,1361556096973,1977477021,1977477021,0
1361556123,1977503096,11,8814,801.2727273,1361556095453,1361556101021,1977475549,1977481117,5568
1361556123,1977503144,1,46,46,1361556098286,1361556098286,1977478430,1977478430,0
1361556123,1977503168,1,46,46,1361556098711,1361556098711,1977478879,1977478879,0
1361556126,615819436,4,591,147.75,1361556100800,1361556100864,615794236,615794300,64
1361556126,615819440,3,2607,869,1361556101626,1361556101626,615795066,615795066,0
1361556126,615819468,16,17157,1072.3125,1361556100130,1361556100642,615793598,615794110,512
1361556127,1977506660,4,190,47.5,1361556115412,1361556121556,1977495072,1977501216,6144
1361556127,1977506660,2,98,49,1361556115412,1361556120788,1977495072,1977500448,5376
1361556127,1977506696,4,196,49,1361556114543,1361556119791,1977494239,1977499487,5248
1361556127,1977506708,2,98,49,1361556115300,1361556120740,1977495008,1977500448,5440
1361556127,1977506708,2,98,49,1361556115363,1361556120739,1977495071,1977500447,5376
1361556127,1977506744,3,150,50,1361556114750,1361556120702,1977494494,1977500446,5952
1361556127,1977506744,3,150,50,1361556114749,1361556120701,1977494493,1977500445,5952
1361556127,1977506748,3,150,50,1361556114876,1361556120700,1977494624,1977500448,5824
1361556127,1977506748,3,144,48,1361556114940,1361556120700,1977494688,1977500448,5760
1361556127,1977506748,3,144,48,1361556115131,1361556120763,1977494879,1977500511,5632
1361556127,1977507016,1,46,46,1361556100333,1361556100333,1977480349,1977480349,0
1361556127,1977507048,7,2513,359,1361556101775,1361556101967,1977481823,1977482015,192
1361556127,1977507080,1,46,46,1361556102256,1361556102256,1977482336,1977482336,0
1361556127,1977507128,61,51506,844.3606557,1361556100480,1361556125888,1977480608,1977506016,25408
1361556127,1977507136,49,56988,1163.020408,1361556101240,1361556104312,1977481376,1977484448,3072
1361556127,1977507136,14,5725,408.9285714,1361556101495,1361556101879,1977481631,1977482015,384
1361556131,1977511012,1,46,46,1361556103921,1361556103921,1977483933,1977483933,0
1361556131,1977511020,13,2815,216.5384615,1361556104617,1361556129769,1977484637,1977509789,25152
1361556131,1977511040,1,46,46,1361556104725,1361556104725,1977484765,1977484765,0
1361556131,1977511048,6,4187,697.8333333,1361556105615,1361556105935,1977485663,1977485983,320
1361556131,1977511048,18,9254,514.1111111,1361556105421,1361556105677,1977485469,1977485725,256
1361556131,1977511052,2,304,152,1361556105548,1361556115852,1977485600,1977495904,10304
1361556131,1977511052,7,2545,363.5714286,1361556105611,1361556105867,1977485663,1977485919,256
1361556131,1977511052,86,95415,1109.476744,1361556106059,1361556107531,1977486111,1977487583,1472
1361556131,1977511052,54,44831,830.2037037,1361556106059,1361556111691,1977486111,1977491743,5632
1361556131,1977511052,1,46,46,1361556105674,1361556105674,1977485726,1977485726,0
1361556131,1977511136,13,3678,282.9230769,1361556105527,1361556107063,1977485663,1977487199,1536
1361556135,1977514996,1,46,46,1361556106948,1361556106948,1977486944,1977486944,0
1361556135,1977515004,18,13539,752.1666667,1361556107515,1361556108667,1977487519,1977488671,1152
1361556135,1977515004,4,602,150.5,1361556107515,1361556107963,1977487519,1977487967,448
1361556135,1977515004,4,602,150.5,1361556107642,1361556108730,1977487646,1977488734,1088
1361556135,1977515040,4,544,136,1361556108760,1361556108952,1977488800,1977488992,192
1361556135,1977515040,1,46,46,1361556108824,1361556108824,1977488864,1977488864,0
1361556135,1977515044,9,1707,189.6666667,1361556109264,1361556128464,1977489308,1977508508,19200
1361556135,1977515044,14,4210,300.7142857,1361556109585,1361556110801,1977489629,1977490845,1216
1361556135,1977515052,1,46,46,1361556110026,1361556110026,1977490078,1977490078,0
1361556135,1977515080,3,616,205.3333333,1361556110511,1361556110703,1977490591,1977490783,192
1361556135,1977515088,1,46,46,1361556107176,1361556107176,1977487264,1977487264,0
1361556135,1977515092,1,46,46,1361556107620,1361556107620,1977487712,1977487712,0
1361556135,1977515124,19,6487,341.4210526,1361556108420,1361556128836,1977488544,1977508960,20416
1361556139,1977519016,12,672,56,1361556110956,1361556138412,1977490972,1977518428,27456
1361556139,1977519032,1,46,46,1361556112606,1361556112606,1977492638,1977492638,0
1361556139,1977519072,9,1238,137.5555556,1361556114294,1361556130998,1977494366,1977511070,16704
1361556139,1977519072,12,1965,163.75,1361556114613,1361556130997,1977494685,1977511069,16384
1361556139,1977519100,1,46,46,1361556111195,1361556111195,1977491295,1977491295,0
1361556139,1977519100,23,1288,56,1361556111259,1361556138459,1977491359,1977518559,27200
1361556139,1977519100,23,2208,96,1361556111449,1361556138521,1977491549,1977518621,27072
1361556139,1977519228,1,46,46,1361556112988,1361556112988,1977493216,1977493216,0
1361556139,1977519228,16,3966,247.875,1361556113052,1361556123100,1977493280,1977503328,10048
1361556139,1977519236,5,485,97,1361556113811,1361556114643,1977494047,1977494879,832
1361556139,1977519236,1,46,46,1361556113938,1361556113938,1977494174,1977494174,0
1361556139,1977519236,5,724,144.8,1361556113938,1361556114706,1977494174,1977494942,768
1361556143,1977522740,3,144,48,1361556130051,1361556135107,1977509791,1977514847,5056
1361556143,1977523004,1,46,46,1361556118713,1361556118713,1977498717,1977498717,0
1361556143,1977523088,1,46,46,1361556118500,1361556118500,1977498588,1977498588,0
1361556143,1977523092,1,46,46,1361556115169,1361556115169,1977495261,1977495261,0
1361556143,1977523092,11,616,56,1361556115360,1361556139104,1977495452,1977519196,23744
1361556143,1977523132,1,46,46,1361556116667,1361556116667,1977496799,1977496799,0
1361556147,1977527024,1,46,46,1361556120614,1361556120614,1977500638,1977500638,0
1361556147,1977527056,1,46,46,1361556121797,1361556121797,1977501853,1977501853,0
1361556151,1977530664,892,1284574,1440.105381,1361556112014,1361556145934,1977491678,1977525598,33920
1361556151,1977530676,2,92,46,1361556145219,1361556145219,1977524895,1977524895,0
1361556151,1977530704,3,138,46,1361556146790,1361556146854,1977526494,1977526558,64
1361556151,1977530704,3,138,46,1361556147174,1361556147174,1977526878,1977526878,0
1361556151,1977530744,3,138,46,1361556145149,1361556145149,1977524893,1977524893,0
1361556151,1977530756,3,138,46,1361556146675,1361556146739,1977526431,1977526495,64
1361556155,1977535044,6,1319,219.8333333,1361556129619,1361556129875,1977509663,1977509919,256
1361556159,1977539124,1,64,64,1361556132546,1361556132546,1977512670,1977512670,0
1361556163,1977543052,1,46,46,1361556138826,1361556138826,1977518878,1977518878,0
1361556168,1977547352,9,1632,181.3333333,1361556141383,1361556161671,1977520735,1977541023,20288
1361556168,1977547432,2,123,61.5,1361556141367,1361556141431,1977520799,1977520863,64
1361556168,1977547432,14,784,56,1361556141302,1361556166454,1977520734,1977545886,25152
1361556168,1977547436,14,1344,96,1361556141618,1361556166706,1977521054,1977546142,25088
1361556168,1977547440,7,392,56,1361556141804,1361556161900,1977521244,1977541340,20096
1361556170,615863644,1,46,46,1361556143026,1361556143026,615836670,615836670,0
1361556170,615863660,1,46,46,1361556144033,1361556144033,615837693,615837693,0
1361556170,615863688,2,92,46,1361556142982,1361556142982,615836670,615836670,0
1361556170,615863688,1,46,46,1361556142981,1361556142981,615836669,615836669,0
1361556170,615863696,1,46,46,1361556143998,1361556143998,615837694,615837694,0
1361556171,1977551048,1,46,46,1361556145423,1361556145423,1977525471,1977525471,0
1361556171,1977551060,2,123,61.5,1361556146755,1361556146755,1977526815,1977526815,0
1361556171,1977551088,3,606,202,1361556143460,1361556143588,1977523548,1977523676,128
1361556171,1977551088,8,448,56,1361556143718,1361556170086,1977523806,1977550174,26368
1361556171,1977551088,2,123,61.5,1361556143718,1361556143782,1977523806,1977523870,64
1361556175,1977555032,7,1140,162.8571429,1361556150814,1361556160798,1977530846,1977540830,9984
1361556175,1977555044,3,138,46,1361556148240,1361556148240,1977528284,1977528284,0
1361556175,1977555156,3,138,46,1361556149090,1361556149154,1977529246,1977529310,64
1361556179,1977559188,1,46,46,1361556154307,1361556154307,1977534495,1977534495,0
1361556187,1977567064,2,128,64,1361556159678,1361556186750,1977539742,1977566814,27072
1361556191,1977570732,3954,5753004,1454.983308,1361556130058,1361556183562,1977509790,1977563294,53504
1361556191,1977571112,1,77,77,1361556165773,1361556165773,1977545885,1977545885,0
1361556191,1977571112,1,77,77,1361556165773,1361556165773,1977545885,1977545885,0
1361556191,1977571160,2,123,61.5,1361556163743,1361556163743,1977543903,1977543903,0
1361556191,1977571172,3,169,56.33333333,1361556164691,1361556164755,1977544863,1977544927,64
1361556191,1977571204,2,123,61.5,1361556165681,1361556165681,1977545885,1977545885,0
1361556195,1977575080,6,336,56,1361556169261,1361556191469,1977549341,1977571549,22208
1361556195,1977575084,5,480,96,1361556169578,1361556189738,1977549662,1977569822,20160
1361556195,1977575120,3,168,56,1361556167045,1361556189253,1977547165,1977569373,22208
1361556195,1977575252,2,123,61.5,1361556169666,1361556169666,1977549918,1977549918,0
1361556207,1977586716,7,412,58.85714286,1361556199192,1361556199192,1977578908,1977578908,0
1361556207,1977586748,8,458,57.25,1361556202168,1361556202168,1977581916,1977581916,0
1361556207,1977586832,7,412,58.85714286,1361556205156,1361556205156,1977584988,1977584988,0
1361556207,1977587220,2,123,61.5,1361556181665,1361556181665,1977561885,1977561885,0
1361556211,1977591072,3,492,164,1361556182902,1361556183030,1977562974,1977563102,128
1361556211,1977591076,3,168,56,1361556183154,1361556203058,1977563230,1977583134,19904
1361556215,1977594796,3,138,46,1361556212039,1361556212103,1977591835,1977591899,64
1361556223,1977602792,3,138,46,1361556218062,1361556218126,1977597854,1977597918,64
1361556223,1977602836,136,127728,939.1764706,1361556024608,1361556217120,1977404444,1977596956,192512
1361556223,1977602872,339,437651,1291.0059,1361556101499,1361556220027,1977481371,1977599899,118528
1361556223,1977603064,5,480,96,1361556195260,1361556221756,1977575324,1977601820,26496
1361556223,1977603148,3,168,56,1361556198761,1361556221801,1977578909,1977601949,23040
1361556227,1977607116,7,392,56,1361556201353,1361556224713,1977581469,1977604829,23360
1361556227,1977607188,3,544,181.3333333,1361556200896,1361556200896,1977581084,1977581084,0
1361556231,1977611128,1,46,46,1361556206270,1361556206270,1977586398,1977586398,0
1361556235,1977615144,3,544,181.3333333,1361556209387,1361556226027,1977589531,1977606171,16640
1361556238,615931704,2,92,46,1361556210996,1361556210996,615904700,615904700,0
1361556239,1977618720,2,98,49,1361556232150,1361556237206,1977611870,1977616926,5056
1361556239,1977618768,3,144,48,1361556232101,1361556237157,1977611869,1977616925,5056
1361556239,1977618796,248,314387,1267.689516,1361556104968,1361556231048,1977484764,1977610844,126080
1361556242,615935732,2,92,46,1361556215960,1361556215960,615909692,615909692,0
1361556242,615935776,1,46,46,1361556215917,1361556215917,615909693,615909693,0
1361556242,615935784,2,92,46,1361556216933,1361556216933,615910717,615910717,0
1361556243,1977623232,1,46,46,1361556217686,1361556217686,1977597918,1977597918,0
1361556247,1977627108,9,864,96,1361556222866,1361556245778,1977602974,1977625886,22912
1361556247,1977627156,5,280,56,1361556221026,1361556240994,1977601182,1977621150,19968
1361556247,1977627160,2,92,46,1361556221660,1361556221724,1977601820,1977601884,64
1361556247,1977627164,2,123,61.5,1361556221785,1361556221849,1977601949,1977602013,64
1361556247,1977627184,1,46,46,1361556221829,1361556221829,1977602013,1977602013,0
1361556247,1977627200,1,46,46,1361556219636,1361556219636,1977599836,1977599836,0
1361556251,1977631132,2,123,61.5,1361556222842,1361556222842,1977602974,1977602974,0
1361556251,1977631132,6,1099,183.1666667,1361556222968,1361556242040,1977603100,1977622172,19072
1361556251,1977631140,1,46,46,1361556223728,1361556223728,1977603868,1977603868,0
1361556251,1977631144,1,46,46,1361556223723,1361556223723,1977603867,1977603867,0
1361556251,1977631144,1,77,77,1361556223854,1361556223854,1977603998,1977603998,0
1361556251,1977631180,2,92,46,1361556225671,1361556225671,1977605851,1977605851,0
1361556251,1977631224,2,92,46,1361556223645,1361556223645,1977603869,1977603869,0
1361556251,1977631228,4,224,56,1361556223834,1361556241946,1977604062,1977622174,18112
1361556251,1977631228,2,123,61.5,1361556223770,1361556223770,1977603998,1977603998,0
1361556251,1977631228,1,77,77,1361556223770,1361556223770,1977603998,1977603998,0
1361556251,1977631256,2,92,46,1361556224574,1361556224638,1977604830,1977604894,64
1361556251,1977631264,1,46,46,1361556225589,1361556225589,1977605853,1977605853,0
1361556255,1977634720,57,39101,685.9824561,1361556247574,1361556250838,1977627294,1977630558,3264
1361556255,1977635120,1,46,46,1361556230724,1361556230724,1977610844,1977610844,0
1361556255,1977635120,1,46,46,1361556230724,1361556230724,1977610844,1977610844,0
1361556255,1977635128,2,123,61.5,1361556227837,1361556227901,1977607965,1977608029,64
1361556255,1977635128,7,392,56,1361556227836,1361556247484,1977607964,1977627612,19648
1361556267,1977647188,1,64,64,1361556240702,1361556240702,1977620890,1977620890,0
1361556267,1977647244,1,77,77,1361556239753,1361556239753,1977619997,1977619997,0
1361556267,1977647276,3,544,181.3333333,1361556240873,1361556240937,1977621149,1977621213,64
1361556271,1977651192,2,92,46,1361556244667,1361556244731,1977624859,1977624923,64
1361556271,1977651204,2,92,46,1361556245682,1361556245682,1977625886,1977625886,0
1361556271,1977651276,1,46,46,1361556244582,1361556244582,1977624858,1977624858,0
1361556275,1977655232,4,224,56,1361556247124,1361556261140,1977627356,1977641372,14016
1361556283,1977663192,12,672,56,1361556257086,1361556281918,1977637278,1977662110,24832
1361556283,1977663268,13,1248,96,1361556256751,1361556281967,1977637019,1977662235,25216
1361556283,1977663272,7,392,56,1361556256813,1361556282029,1977637085,1977662301,25216
1361556287,1977666748,136,127873,940.2426471,1361556023929,1361556282297,1977403677,1977662045,258368
1361556287,1977666756,7,412,58.85714286,1361556282223,1361556282287,1977661979,1977662043,64
1361556287,1977666756,6,366,61,1361556282223,1361556282287,1977661979,1977662043,64
1361556287,1977666788,7,412,58.85714286,1361556286222,1361556286222,1977666010,1977666010,0
1361556287,1977666796,8,458,57.25,1361556280198,1361556280262,1977659994,1977660058,64
1361556287,1977666824,7,412,58.85714286,1361556281197,1361556281261,1977661021,1977661085,64
1361556287,1977666828,7,412,58.85714286,1361556282152,1361556282216,1977661980,1977662044,64
1361556288,1977667308,4,1590,397.5,1361556262062,1361556262126,1977641370,1977641434,64
1361556288,1977667312,27,25266,935.7777778,1361556262124,1361556262380,1977641436,1977641692,256
1361556295,1977674804,4,414,103.5,1361556294719,1361556294847,1977674523,1977674651,128
1361556295,1977674812,147,169870,1155.578231,1361556083832,1361556288248,1977463644,1977668060,204416
1361556295,1977675136,1,46,46,1361556267252,1361556267252,1977647388,1977647388,0
1361556295,1977675140,2,128,64,1361556267758,1361556294830,1977647898,1977674970,27072
1361556303,615996436,2,98,49,1361556294593,1361556299777,615988029,615993213,5184
1361556303,615996436,3,144,48,1361556294592,1361556299840,615988028,615993276,5248
1361556303,615996444,2,98,49,1361556294587,1361556299771,615988031,615993215,5184
1361556303,615996448,2,98,49,1361556294582,1361556299766,615988030,615993214,5184
1361556303,615996448,2,98,49,1361556294582,1361556299766,615988030,615993214,5184
1361556303,615996448,3,144,48,1361556295158,1361556300790,615988606,615994238,5632
1361556303,1977682808,11,4663,423.9090909,1361556294843,1361556300667,1977674651,1977680475,5824
1361556303,1977682840,5,363,72.6,1361556300443,1361556300507,1977680283,1977680347,64
1361556303,1977682844,4,317,79.25,1361556297241,1361556297241,1977677085,1977677085,0
1361556303,1977682856,7,412,58.85714286,1361556298317,1361556298317,1977678173,1977678173,0
1361556303,1977682856,4,190,47.5,1361556293645,1361556299597,1977673501,1977679453,5952
1361556303,1977683240,2,92,46,1361556276171,1361556276171,1977656411,1977656411,0
1361556303,1977683280,8,448,56,1361556278307,1361556299107,1977658587,1977679387,20800
1361556307,1977687188,3,544,181.3333333,1361556280960,1361556281152,1977661148,1977661340,192
1361556307,1977687196,3,492,164,1361556281849,1361556281977,1977662045,1977662173,128
1361556311,1977690800,5,2757,551.4,1361556306437,1361556306565,1977686237,1977686365,128
1361556311,1977691156,13,1248,96,1361556286814,1361556305886,1977666970,1977686042,19072
1361556311,1977691276,13,728,56,1361556285735,1361556305383,1977666011,1977685659,19648
1361556315,1977695232,14,8319,594.2142857,1361556290133,1361556293845,1977670365,1977674077,3712
1361556316,1977695304,6,336,56,1361556290868,1361556306292,1977670172,1977685596,15424
1361556318,616011880,5,3002,600.4,1361556293445,1361556293701,615987325,615987581,256
1361556319,1977698860,11823,16953814,1433.968874,1361556129928,1361556317128,1977509788,1977696988,187200
1361556319,1977699228,5,2888,577.6,1361556293206,1361556293590,1977673434,1977673818,384
1361556319,1977699228,6,3557,592.8333333,1361556293206,1361556293654,1977673434,1977673882,448
1361556319,1977699228,6,3873,645.5,1361556293206,1361556293910,1977673434,1977674138,704
1361556319,1977699260,1,46,46,1361556294520,1361556294520,1977674780,1977674780,0
1361556320,1977699308,24,29849,1243.708333,1361556293745,1361556294001,1977673053,1977673309,256
1361556320,1977699308,11,1808,164.3636364,1361556293809,1361556295025,1977673117,1977674333,1216
1361556320,1977699308,6,3267,544.5,1361556294063,1361556294319,1977673371,1977673627,256
1361556320,1977699308,5,3732,746.4,1361556294127,1361556294447,1977673435,1977673755,320
1361556320,1977699308,5,2995,599,1361556294127,1361556294639,1977673435,1977673947,512
1361556320,1977699348,13,1163,89.46153846,1361556295174,1361556295430,1977674522,1977674778,256
1361556322,616015888,5,4367,873.4,1361556294143,1361556294207,615988031,615988095,64
1361556323,1977703204,65,67318,1035.661538,1361556296623,1361556305647,1977676827,1977685851,9024
1361556323,1977703264,65,72968,1122.584615,1361556295989,1361556305333,1977676253,1977685597,9344
1361556324,1977703300,14,3700,264.2857143,1361556297785,1361556306617,1977677085,1977685917,8832
1361556327,1977707264,24,15889,662.0416667,1361556300082,1361556305458,1977680346,1977685722,5376
1361556331,1977711188,2,112,56,1361556304125,1361556329853,1977684313,1977710041,25728
1361556331,1977711220,16,3937,246.0625,1361556306142,1361556316126,1977686362,1977696346,9984
1361556335,1977715272,1,46,46,1361556307881,1361556307881,1977688153,1977688153,0
1361556343,1977722788,1340,1868874,1394.68209,1361556305358,1361556337934,1977685146,1977717722,32576
1361556348,1977727328,9,2569,285.4444444,1361556322777,1361556344601,1977702105,1977723929,21824
1361556348,1977727328,1,64,64,1361556322717,1361556322717,1977702045,1977702045,0
1361556356,1977735320,24,2304,96,1361556329889,1361556344737,1977709209,1977724057,14848
1361556356,1977735356,11,616,56,1361556331775,1361556345599,1977711131,1977724955,13824
1361556356,1977735368,1,46,46,1361556328945,1361556328945,1977708313,1977708313,0
1361556356,1977735400,12,672,56,1361556329937,1361556344017,1977709337,1977723417,14080
1361556356,1977735404,23,1288,56,1361556330127,1361556344335,1977709531,1977723739,14208
1361556364,1977743388,7,501,71.57142857,1361556336993,1361556337377,1977716381,1977716765,384
1361556380,1977759468,8,1024,128,1361556355535,1361556376527,1977735003,1977755995,20992
1361556384,1977763440,7,3598,514,1361556357354,1361556374442,1977736794,1977753882,17088
1361556391,1977770836,7,328,46.85714286,1361556386014,1361556386910,1977765850,1977766746,896
1361556399,1977778884,3,144,48,1361556391151,1361556396527,1977771035,1977776411,5376
1361556399,1977778924,3,144,48,1361556387270,1361556392518,1977767194,1977772442,5248
1361556399,1977778928,3,144,48,1361556390532,1361556396484,1977770460,1977776412,5952
1361556412,1977791420,37,2072,56,1361556385916,1361556411836,1977765336,1977791256,25920
1361556412,1977791504,36,3456,96,1361556385896,1361556411112,1977765400,1977790616,25216
1361556412,1977791504,18,1008,56,1361556386155,1361556410795,1977765659,1977790299,24640
1361556412,1977791508,8,532,66.5,1361556386280,1361556387816,1977765788,1977767324,1536
1361556412,1977791508,18,1008,56,1361556386343,1361556411239,1977765851,1977790747,24896
1361556412,1977791536,2,92,46,1361556387338,1361556387402,1977766874,1977766938,64
1361556415,1977794844,4,184,46,1361556409495,1361556410199,1977789339,1977790043,704
1361556415,1977794868,3,138,46,1361556410494,1361556410558,1977790362,1977790426,64
1361556415,1977794908,4,184,46,1361556409494,1361556410134,1977789402,1977790042,640
1361556415,1977794908,4,184,46,1361556409493,1361556410133,1977789401,1977790041,640
1361556415,1977794908,5,230,46,1361556409492,1361556410196,1977789400,1977790104,704
1361556415,1977794916,118,158831,1346.025424,1361556293135,1361556409743,1977673051,1977789659,116608
1361556416,1977795372,1,514,514,1361556391791,1361556391791,1977771163,1977771163,0
1361556416,1977795376,8,968,121,1361556387947,1361556404587,1977767323,1977783963,16640
1361556416,1977795380,9,3235,359.4444444,1361556391527,1361556391719,1977770907,1977771099,192
1361556416,1977795380,6,678,113,1361556388197,1361556404965,1977767577,1977784345,16768
1361556416,1977795500,1,46,46,1361556389804,1361556389804,1977769304,1977769304,0
1361556424,1977803400,1,72,72,1361556399316,1361556399316,1977778716,1977778716,0
1361556424,1977803400,1,72,72,1361556399316,1361556399316,1977778716,1977778716,0
1361556424,1977803400,1,72,72,1361556399315,1361556399315,1977778715,1977778715,0
1361556424,1977803400,1,72,72,1361556399379,1361556399379,1977778779,1977778779,0
1361556424,1977803400,1,72,72,1361556399378,1361556399378,1977778778,1977778778,0
1361556424,1977803400,1,72,72,1361556399377,1361556399377,1977778777,1977778777,0
1361556424,1977803400,1,72,72,1361556399441,1361556399441,1977778841,1977778841,0
1361556424,1977803400,1,72,72,1361556399441,1361556399441,1977778841,1977778841,0
1361556424,1977803400,1,72,72,1361556399441,1361556399441,1977778841,1977778841,0
1361556424,1977803404,1,72,72,1361556399504,1361556399504,1977778908,1977778908,0
1361556424,1977803404,1,72,72,1361556399503,1361556399503,1977778907,1977778907,0
1361556424,1977803404,1,72,72,1361556399503,1361556399503,1977778907,1977778907,0
1361556424,1977803416,2,92,46,1361556396868,1361556396868,1977776284,1977776284,0
1361556424,1977803448,1,72,72,1361556398627,1361556398627,1977778075,1977778075,0
1361556424,1977803448,14,3932,280.8571429,1361556398626,1361556405858,1977778074,1977785306,7232
1361556424,1977803448,1,72,72,1361556398690,1361556398690,1977778138,1977778138,0
1361556424,1977803448,1,72,72,1361556398753,1361556398753,1977778201,1977778201,0
1361556424,1977803448,1,72,72,1361556398817,1361556398817,1977778265,1977778265,0
1361556424,1977803448,1,72,72,1361556398753,1361556398753,1977778201,1977778201,0
1361556424,1977803448,1,72,72,1361556398817,1361556398817,1977778265,1977778265,0
1361556424,1977803452,1,72,72,1361556398880,1361556398880,1977778332,1977778332,0
1361556424,1977803452,1,72,72,1361556398880,1361556398880,1977778332,1977778332,0
1361556424,1977803476,1,72,72,1361556398983,1361556398983,1977778459,1977778459,0
1361556424,1977803476,1,72,72,1361556398982,1361556398982,1977778458,1977778458,0
1361556424,1977803476,1,72,72,1361556398982,1361556398982,1977778458,1977778458,0
1361556424,1977803476,1,72,72,1361556398918,1361556398918,1977778394,1977778394,0
1361556424,1977803476,1,72,72,1361556398918,1361556398918,1977778394,1977778394,0
1361556424,1977803476,1,72,72,1361556398981,1361556398981,1977778457,1977778457,0
1361556424,1977803476,1,72,72,1361556399109,1361556399109,1977778585,1977778585,0
1361556424,1977803476,1,72,72,1361556399045,1361556399045,1977778521,1977778521,0
1361556424,1977803476,1,72,72,1361556399045,1361556399045,1977778521,1977778521,0
1361556424,1977803476,1,72,72,1361556399173,1361556399173,1977778649,1977778649,0
1361556424,1977803480,1,72,72,1361556399108,1361556399108,1977778588,1977778588,0
1361556424,1977803480,1,72,72,1361556399172,1361556399172,1977778652,1977778652,0
1361556424,1977803480,1,72,72,1361556399235,1361556399235,1977778715,1977778715,0
1361556424,1977803480,1,72,72,1361556399299,1361556399299,1977778779,1977778779,0
1361556424,1977803480,1,72,72,1361556399362,1361556399362,1977778842,1977778842,0
1361556424,1977803480,1,72,72,1361556399298,1361556399298,1977778778,1977778778,0
1361556424,1977803480,1,72,72,1361556399361,1361556399361,1977778841,1977778841,0
1361556424,1977803484,1,72,72,1361556399424,1361556399424,1977778908,1977778908,0
1361556424,1977803484,1,72,72,1361556399550,1361556399550,1977779034,1977779034,0
1361556424,1977803516,3,138,46,1361556396767,1361556396767,1977776283,1977776283,0
1361556424,1977803516,1,46,46,1361556396830,1361556396830,1977776346,1977776346,0
1361556424,1977803552,1,72,72,1361556398586,1361556398586,1977778138,1977778138,0
1361556424,1977803556,1,72,72,1361556398520,1361556398520,1977778076,1977778076,0
1361556424,1977803556,1,72,72,1361556398583,1361556398583,1977778139,1977778139,0
1361556424,1977803556,1,72,72,1361556398646,1361556398646,1977778202,1977778202,0
1361556424,1977803556,1,72,72,1361556398646,1361556398646,1977778202,1977778202,0
1361556424,1977803556,1,72,72,1361556398710,1361556398710,1977778266,1977778266,0
1361556424,1977803556,1,72,72,1361556398709,1361556398709,1977778265,1977778265,0
1361556424,1977803556,1,72,72,1361556398709,1361556398709,1977778265,1977778265,0
1361556424,1977803556,1,72,72,1361556398709,1361556398709,1977778265,1977778265,0
1361556424,1977803556,1,72,72,1361556398709,1361556398709,1977778265,1977778265,0
1361556424,1977803556,1,72,72,1361556398773,1361556398773,1977778329,1977778329,0
1361556424,1977803556,1,72,72,1361556398836,1361556398836,1977778392,1977778392,0
1361556424,1977803556,1,72,72,1361556398836,1361556398836,1977778392,1977778392,0
1361556424,1977803560,1,72,72,1361556398899,1361556398899,1977778459,1977778459,0
1361556424,1977803560,1,72,72,1361556398963,1361556398963,1977778523,1977778523,0
1361556424,1977803560,1,72,72,1361556399090,1361556399090,1977778650,1977778650,0
1361556424,1977803560,1,72,72,1361556399154,1361556399154,1977778714,1977778714,0
1361556424,1977803560,1,72,72,1361556399154,1361556399154,1977778714,1977778714,0
1361556424,1977803560,1,72,72,1361556399154,1361556399154,1977778714,1977778714,0
1361556424,1977803560,1,72,72,1361556398897,1361556398897,1977778457,1977778457,0
1361556424,1977803560,1,72,72,1361556398961,1361556398961,1977778521,1977778521,0
1361556424,1977803560,1,72,72,1361556398961,1361556398961,1977778521,1977778521,0
1361556424,1977803560,1,72,72,1361556398961,1361556398961,1977778521,1977778521,0
1361556424,1977803560,1,72,72,1361556399025,1361556399025,1977778585,1977778585,0
1361556424,1977803564,1,72,72,1361556399084,1361556399084,1977778648,1977778648,0
1361556434,616127948,2,92,46,1361556409281,1361556409281,616103229,616103229,0
1361556434,616127992,1,46,46,1361556409237,1361556409237,616103229,616103229,0
1361556436,1977815452,1,46,46,1361556409886,1361556409886,1977789338,1977789338,0
1361556436,1977815452,1,46,46,1361556409886,1361556409886,1977789338,1977789338,0
1361556436,1977815532,1,46,46,1361556409805,1361556409805,1977789337,1977789337,0
1361556440,1977819408,25,2400,96,1361556412491,1361556439627,1977791899,1977819035,27136
1361556440,1977819488,13,728,56,1361556412603,1361556439739,1977792091,1977819227,27136
1361556440,1977819488,24,1344,56,1361556412856,1361556439864,1977792344,1977819352,27008
1361556440,1977819520,12,672,56,1361556413595,1361556438427,1977793115,1977817947,24832
1361556444,1977823416,4,257,64.25,1361556417028,1361556417092,1977796444,1977796508,64
1361556444,1977823492,1,46,46,1361556416628,1361556416628,1977796120,1977796120,0
1361556448,1977827412,1,46,46,1361556420357,1361556420357,1977799769,1977799769,0
1361556448,1977827416,1,46,46,1361556420483,1361556420483,1977799899,1977799899,0
1361556452,1977831508,2,128,64,1361556424039,1361556451047,1977803547,1977830555,27008
1361556456,1977835428,5,626,125.2,1361556428405,1361556452469,1977807833,1977831897,24064
1361556456,1977835512,6,672,112,1361556428514,1361556452962,1977808026,1977832474,24448
1361556468,1977847468,24,2304,96,1361556440139,1361556466827,1977819607,1977846295,26688
1361556468,1977847472,12,672,56,1361556440712,1361556465736,1977820184,1977845208,25024
1361556468,1977847560,23,1288,56,1361556440818,1361556466546,1977820378,1977846106,25728
1361556468,1977847588,12,672,56,1361556441557,1361556467733,1977821145,1977847321,26176
1361556471,1977850892,4125,5649565,1369.591515,1361556391014,1361556470182,1977770906,1977850074,79168
1361556476,1977855508,3,169,56.33333333,1361556449700,1361556449700,1977829208,1977829208,0
1361556476,1977855520,1,46,46,1361556450715,1361556450715,1977830235,1977830235,0
1361556484,1977863560,4,258,64.5,1361556457011,1361556457011,1977836571,1977836571,0
1361556495,1977874852,6,499,83.16666667,1361556489293,1361556491469,1977869145,1977871321,2176
1361556495,1977874928,4,317,79.25,1361556489410,1361556489474,1977869338,1977869402,64
1361556496,1977875504,3,168,56,1361556468330,1361556491626,1977847834,1977871130,23296
1361556496,1977875572,6,336,56,1361556467875,1361556491875,1977847447,1977871447,24000
1361556496,1977875576,6,576,96,1361556468000,1361556492000,1977847576,1977871576,24000
1361556496,1977875616,2,112,56,1361556469432,1361556490744,1977849048,1977870360,21312
1361556503,1977882896,3,144,48,1361556491617,1361556496737,1977871513,1977876633,5120
1361556504,1977883632,1,64,64,1361556477991,1361556477991,1977857623,1977857623,0
1361556512,1977891664,6,672,112,1361556483847,1361556510343,1977863511,1977890007,26496
1361556512,1977891780,5,626,125.2,1361556484054,1361556510358,1977863834,1977890138,26304
1361556516,1977895776,38,36432,958.7368421,1361556489623,1361556490263,1977869399,1977870039,640
1361556524,1977903660,1,56,56,1361556495885,1361556495885,1977875545,1977875545,0
1361556524,1977903672,1,96,96,1361556496897,1361556496897,1977876569,1977876569,0
1361556524,1977903672,8,517,64.625,1361556496960,1361556519872,1977876632,1977899544,22912
1361556524,1977903744,1,56,56,1361556496121,1361556496121,1977875865,1977875865,0
1361556524,1977903752,1,56,56,1361556496945,1361556496945,1977876697,1977876697,0
1361556532,1977911700,1,64,64,1361556504932,1361556504932,1977884632,1977884632,0
1361556535,1977914912,4,317,79.25,1361556527953,1361556527953,1977907865,1977907865,0
1361556536,1977915692,1,46,46,1361556511534,1361556511534,1977891226,1977891226,0
1361556536,1977915696,2,123,61.5,1361556508520,1361556508520,1977888216,1977888216,0
1361556543,1977922924,11,2788,253.4545455,1361556537667,1361556537923,1977917591,1977917847,256
1361556543,1977923000,251,279356,1112.972112,1361556088697,1361556540985,1977468697,1977920985,452288
1361556543,1977923004,13,3732,287.0769231,1361556537973,1361556542837,1977917977,1977922841,4864
1361556552,1977931836,19,4296,226.1052632,1361556527582,1361556528478,1977907418,1977908314,896
1361556552,1977931960,18,4783,265.7222222,1361556526559,1361556538207,1977906519,1977918167,11648
1361556556,1977935740,11,3488,317.0909091,1361556528125,1361556528317,1977907865,1977908057,192
1361556556,1977935744,15,840,56,1361556528570,1361556541306,1977908314,1977921050,12736
1361556556,1977935836,10,681,68.1,1361556528350,1361556548510,1977908186,1977928346,20160
1361556556,1977935852,15,1440,96,1361556528522,1361556542986,1977908374,1977922838,14464
1361556556,1977935860,7,392,56,1361556529347,1361556539587,1977909207,1977919447,10240
1361556556,1977935864,7,392,56,1361556529791,1361556540351,1977909655,1977920215,10560
1361556560,1977939708,2,128,64,1361556531994,1361556559066,1977911702,1977938774,27072
1361556564,1977943724,8,1544,193,1361556536909,1361556563469,1977916633,1977943193,26560
1361556564,1977943808,2,290,145,1361556537078,1361556537142,1977916886,1977916950,64
1361556575,1977954928,7,529,75.57142857,1361556571841,1361556572033,1977951769,1977951961,192
1361556575,1977954932,7,412,58.85714286,1361556567229,1361556567229,1977947161,1977947161,0
1361556575,1977954964,525,719741,1370.935238,1361556533148,1361556569180,1977913112,1977949144,36032
1361556575,1977954976,4,317,79.25,1361556571728,1361556571792,1977951704,1977951768,64
1361556575,1977954980,11,2788,253.4545455,1361556567242,1361556567370,1977947222,1977947350,128
1361556575,1977954984,1375,1838497,1337.088727,1361556527238,1361556569030,1977907222,1977949014,41792
1361556576,1977955724,15,13427,895.1333333,1361556548429,1361556572301,1977928153,1977952025,23872
1361556584,1977963860,8,515,64.375,1361556558595,1361556564611,1977938455,1977944471,6016
1361556588,1977967732,1,46,46,1361556560770,1361556560770,1977940502,1977940502,0
1361556588,1977967772,1,46,46,1361556562012,1361556562012,1977941784,1977941784,0
1361556588,1977967888,1,46,46,1361556563176,1361556563176,1977943064,1977943064,0
1361556591,1977970932,11,3343,303.9090909,1361556588477,1361556589117,1977968409,1977969049,640
1361556591,1977971020,17,3501,205.9411765,1361556588963,1361556589731,1977968983,1977969751,768
1361556592,1977971840,5,1530,306,1361556567446,1361556589206,1977947286,1977969046,21760
1361556592,1977971872,1,46,46,1361556564985,1361556564985,1977944857,1977944857,0
1361556592,1977971912,1,46,46,1361556566926,1361556566926,1977946838,1977946838,0
1361556596,1977975744,1,46,46,1361556568376,1361556568376,1977948120,1977948120,0
1361556596,1977975756,1,46,46,1361556569706,1361556569706,1977949462,1977949462,0
1361556596,1977975796,7,529,75.57142857,1361556571205,1361556571333,1977951001,1977951129,128
1361556596,1977975864,1,46,46,1361556569854,1361556569854,1977949718,1977949718,0
1361556596,1977975896,58,46676,804.7586207,1361556571489,1361556595233,1977951385,1977975129,23744
1361556596,1977975896,6,483,80.5,1361556571615,1361556571743,1977951511,1977951639,128
1361556599,1977978956,13,3090,237.6923077,1361556592865,1361556596385,1977972821,1977976341,3520
1361556599,1977978956,3,144,48,1361556592929,1361556598817,1977972885,1977978773,5888
1361556599,1977978960,11,2898,263.4545455,1361556593120,1361556593440,1977973080,1977973400,320
1361556599,1977979028,3,150,50,1361556592474,1361556598746,1977972502,1977978774,6272
1361556600,1977979640,5,242,48.4,1361556591198,1361556597214,1977970838,1977976854,6016
1361556600,1977979748,1,46,46,1361556571890,1361556571890,1977951638,1977951638,0
1361556600,1977979752,1,46,46,1361556575279,1361556575279,1977955031,1977955031,0
1361556600,1977979756,3,138,46,1361556572140,1361556572204,1977951896,1977951960,64
1361556600,1977979760,13,926,71.23076923,1361556572328,1361556590824,1977952088,1977970584,18496
1361556600,1977979760,1,46,46,1361556572391,1361556572391,1977952151,1977952151,0
1361556600,1977979760,68,15648,230.1176471,1361556572454,1361556598374,1977952214,1977978134,25920
1361556600,1977979764,29,1624,56,1361556572644,1361556599396,1977952408,1977979160,26752
1361556600,1977979788,1,46,46,1361556573004,1361556573004,1977952792,1977952792,0
1361556600,1977979828,7,529,75.57142857,1361556571938,1361556572130,1977951766,1977951958,192
1361556600,1977979828,27,17894,662.7407407,1361556571938,1361556590562,1977951766,1977970390,18624
1361556600,1977979840,15,840,56,1361556572377,1361556598617,1977952217,1977978457,26240
1361556600,1977979844,29,2784,96,1361556572692,1361556599380,1977952536,1977979224,26688
1361556600,1977979844,15,840,56,1361556572819,1361556599699,1977952663,1977979543,26880
1361556600,1977979876,1,46,46,1361556573812,1361556573812,1977953688,1977953688,0
1361556604,1977983768,1,46,46,1361556577245,1361556577245,1977957013,1977957013,0
1361556604,1977983796,1,46,46,1361556577733,1361556577733,1977957529,1977957529,0
1361556604,1977983812,1,46,46,1361556579380,1361556579380,1977959192,1977959192,0
1361556604,1977983840,1,46,46,1361556576088,1361556576088,1977955928,1977955928,0
1361556607,1977986948,12,3379,281.5833333,1361556603882,1361556605226,1977983830,1977985174,1344
1361556607,1977986952,3,144,48,1361556596263,1361556602087,1977976215,1977982039,5824
1361556607,1977986956,9,2696,299.5555556,1361556599460,1361556599716,1977979416,1977979672,256
1361556607,1977986988,3,150,50,1361556594241,1361556600769,1977974229,1977980757,6528
1361556607,1977986992,12,3385,282.0833333,1361556603649,1361556605185,1977983641,1977985177,1536
1361556607,1977987036,12,4397,366.4166667,1361556599380,1361556603796,1977979416,1977983832,4416
1361556607,1977987036,3,150,50,1361556596561,1361556603217,1977976597,1977983253,6656
1361556607,1977987040,4,202,50.5,1361556596560,1361556603280,1977976600,1977983320,6720
1361556607,1977987044,4,196,49,1361556596809,1361556603529,1977976853,1977983573,6720
1361556607,1977987044,2,98,49,1361556593740,1361556599692,1977973784,1977979736,5952
1361556607,1977987068,4,196,49,1361556594161,1361556600753,1977974229,1977980821,6592
1361556608,1977987800,1,46,46,1361556581696,1361556581696,1977961496,1977961496,0
1361556608,1977987808,1,46,46,1361556582712,1361556582712,1977962520,1977962520,0
1361556608,1977987832,1,46,46,1361556582945,1361556582945,1977962777,1977962777,0
1361556608,1977987832,1,46,46,1361556579934,1361556579934,1977959766,1977959766,0
1361556608,1977987844,1,46,46,1361556580563,1361556580563,1977960407,1977960407,0
1361556608,1977987876,1,46,46,1361556581043,1361556581043,1977960919,1977960919,0
1361556612,1977991748,1,46,46,1361556584370,1361556584370,1977964118,1977964118,0
1361556612,1977991784,1,46,46,1361556585935,1361556585935,1977965719,1977965719,0
1361556612,1977991784,1,64,64,1361556586062,1361556586062,1977965846,1977965846,0
1361556612,1977991796,1,46,46,1361556586692,1361556586692,1977966488,1977966488,0
1361556612,1977991832,1,46,46,1361556584478,1361556584478,1977964310,1977964310,0
1361556615,1977994944,6,440,73.33333333,1361556607982,1361556611054,1977987926,1977990998,3072
1361556616,1977995772,10,2858,285.8,1361556591769,1361556592537,1977971541,1977972309,768
1361556616,1977995772,1,46,46,1361556588505,1361556588505,1977968277,1977968277,0
1361556616,1977995804,1,46,46,1361556589753,1361556589753,1977969557,1977969557,0
1361556616,1977995816,23,4171,181.3478261,1361556590830,1361556598190,1977970646,1977978006,7360
1361556616,1977995856,35,2622,74.91428571,1361556588616,1361556609736,1977968472,1977989592,21120
1361556616,1977995880,1,46,46,1361556589105,1361556589105,1977968985,1977968985,0
1361556616,1977995884,38,30278,796.7894737,1361556589801,1361556604969,1977969685,1977984853,15168
1361556616,1977995892,12,3701,308.4166667,1361556590308,1361556597220,1977970200,1977977112,6912
1361556620,1977999816,35,44661,1276.028571,1361556593902,1361556595694,1977973718,1977975510,1792
1361556620,1977999900,38,10440,274.7368421,1361556593818,1361556597146,1977973718,1977977046,3328
1361556620,1977999908,10,3309,330.9,1361556594324,1361556595860,1977974232,1977975768,1536
1361556623,1978002940,2,98,49,1361556615986,1361556621618,1977995926,1978001558,5632
1361556623,1978002948,2,98,49,1361556615468,1361556621676,1977995416,1978001624,6208
1361556623,1978002984,67,83473,1245.865672,1361556613893,1361556622021,1977993877,1978002005,8128
1361556623,1978002984,28,29451,1051.821429,1361556614215,1361556618375,1977994199,1977998359,4160
1361556623,1978002984,40,43093,1077.325,1361556614214,1361556617222,1977994198,1977997206,3008
1361556623,1978002988,34,38440,1130.588235,1361556614786,1361556621762,1977994774,1978001750,6976
1361556623,1978002988,35,41662,1190.342857,1361556614721,1361556621825,1977994709,1978001813,7104
1361556623,1978002988,2,98,49,1361556614785,1361556621633,1977994773,1978001621,6848
1361556623,1978002992,7,1346,192.2857143,1361556615934,1361556622654,1977995926,1978002646,6720
1361556623,1978002996,8,3660,457.5,1361556615164,1361556621756,1977995160,1978001752,6592
1361556623,1978003012,3,144,48,1361556615403,1361556621931,1977995415,1978001943,6528
1361556623,1978003020,6,1494,249,1361556617316,1361556621604,1977997336,1978001624,4288
1361556623,1978003020,2,92,46,1361556609699,1361556616867,1977989719,1977996887,7168
1361556623,1978003024,34,37988,1117.294118,1361556613853,1361556621533,1977993877,1978001557,7680
1361556623,1978003028,57,61194,1073.578947,1361556614170,1361556621722,1977994198,1978001750,7552
1361556624,1978003768,24,21373,890.5416667,1361556595933,1361556597597,1977975701,1977977365,1664
1361556624,1978003780,7,599,85.57142857,1361556599697,1361556599825,1977979477,1977979605,128
1361556624,1978003900,9,2868,318.6666667,1361556597722,1361556622810,1977977622,1978002710,25088
1361556628,1978007756,44,2464,56,1361556600300,1361556626668,1977980056,1978006424,26368
1361556628,1978007756,11,7752,704.7272727,1361556600490,1361556600554,1977980246,1977980310,64
1361556628,1978007760,44,4224,96,1361556600616,1361556627112,1977980376,1978006872,26496
1361556628,1978007760,22,1232,56,1361556600806,1361556626214,1977980566,1978005974,25408
1361556628,1978007796,19,1064,56,1361556601539,1361556627651,1977981335,1978007447,26112
1361556628,1978007840,17,1553,91.35294118,1361556603800,1361556609304,1977983640,1977989144,5504
1361556628,1978007848,5,2702,540.4,1361556600400,1361556600464,1977980248,1977980312,64
1361556628,1978007848,1,93,93,1361556600589,1361556600589,1977980437,1977980437,0
1361556631,616324540,3,144,48,1361556616155,1361556629211,616309695,616322751,13056
1361556631,616324540,4,190,47.5,1361556616794,1361556629914,616310334,616323454,13120
1361556631,616324540,5,242,48.4,1361556617114,1361556629978,616310654,616323518,12864
1361556631,616324540,4,190,47.5,1361556616794,1361556629914,616310334,616323454,13120
1361556631,616324540,3,144,48,1361556617113,1361556629209,616310653,616322749,12096
1361556631,616324544,3,150,50,1361556621975,1361556630871,616315519,616324415,8896
1361556631,616324548,4,190,47.5,1361556615443,1361556629267,616308991,616322815,13824
1361556631,616324548,5,242,48.4,1361556616146,1361556630354,616309694,616323902,14208
1361556631,616324548,4,190,47.5,1361556617045,1361556629589,616310593,616323137,12544
1361556631,616324552,3,144,48,1361556617105,1361556629201,616310657,616322753,12096
1361556631,616324552,4,190,47.5,1361556617999,1361556630031,616311551,616323583,12032
1361556631,616324564,3,150,50,1361556621957,1361556630853,616315521,616324417,8896
1361556631,1978010948,3,144,48,1361556612970,1361556629546,1977992918,1978009494,16576
1361556631,1978010972,3,150,50,1361556613394,1361556628114,1977993366,1978008086,14720
1361556631,1978010976,5,236,47.2,1361556613709,1361556630093,1977993685,1978010069,16384
1361556631,1978010976,2,98,49,1361556621712,1361556630608,1978001688,1978010584,8896
1361556631,1978011016,4,202,50.5,1361556615463,1361556628135,1977995479,1978008151,12672
1361556631,1978011020,2,92,46,1361556623653,1361556624229,1978003673,1978004249,576
1361556631,1978011024,4,190,47.5,1361556613341,1361556630813,1977993365,1978010837,17472
1361556631,1978011028,2,98,49,1361556621659,1361556630555,1978001687,1978010583,8896
1361556631,1978011056,5,248,49.6,1361556614782,1361556628094,1977994838,1978008150,13312
1361556632,1978011764,2,2940,1470,1361556607843,1361556613475,1977987607,1977993239,5632
1361556632,1978011772,2,2340,1170,1361556607708,1361556613468,1977987480,1977993240,5760
1361556636,1978015888,1,46,46,1361556611752,1361556611752,1977991640,1977991640,0
1361556639,616332540,2,92,46,1361556631260,1361556632284,616324800,616325824,1024
1361556639,616332540,2,92,46,1361556631260,1361556632284,616324800,616325824,1024
1361556639,616332540,2,92,46,1361556631260,1361556632284,616324800,616325824,1024
1361556639,616332540,2,92,46,1361556631260,1361556632284,616324800,616325824,1024
1361556639,616332540,2,92,46,1361556631898,1361556634586,616325438,616328126,2688
1361556639,616332540,2,92,46,1361556632282,1361556633690,616325822,616327230,1408
1361556639,616332540,2,92,46,1361556632282,1361556633690,616325822,616327230,1408
1361556639,616332540,2,92,46,1361556632282,1361556633690,616325822,616327230,1408
1361556639,616332544,25,27211,1088.44,1361556618008,1361556635608,616311552,616329152,17600
1361556639,616332544,33,35342,1070.969697,1361556618008,1361556636248,616311552,616329792,18240
1361556639,616332544,41,46526,1134.780488,1361556618007,1361556635607,616311551,616329151,17600
1361556639,616332544,21,21179,1008.52381,1361556621974,1361556636182,616315518,616329726,14208
1361556639,616332544,20,18964,948.2,1361556622038,1361556635606,616315582,616329150,13568
1361556639,616332548,27,25533,945.6666667,1361556622037,1361556636693,616315585,616330241,14656
1361556639,616332548,24,22074,919.75,1361556622037,1361556636693,616315585,616330241,14656
1361556639,616332548,23,21392,930.0869565,1361556622037,1361556635605,616315585,616329153,13568
1361556639,616332548,3,138,46,1361556631251,1361556633683,616324799,616327231,2432
1361556639,616332548,2,92,46,1361556631507,1361556633555,616325055,616327103,2048
1361556639,616332548,2,92,46,1361556632277,1361556633685,616325825,616327233,1408
1361556639,616332548,2,92,46,1361556632277,1361556633685,616325825,616327233,1408
1361556639,616332552,18,18822,1045.666667,1361556617999,1361556635599,616311551,616329151,17600
1361556639,616332552,23,20786,903.7391304,1361556617998,1361556635790,616311550,616329342,17792
1361556639,616332564,26,24486,941.7692308,1361556621957,1361556636677,616315521,616330241,14720
1361556639,616332564,21,20555,978.8095238,1361556621956,1361556636228,616315520,616329792,14272
1361556639,616332564,5,242,48.4,1361556621956,1361556636420,616315520,616329984,14464
1361556639,616332564,19,18721,985.3157895,1361556621956,1361556635588,616315520,616329152,13632
1361556639,616332564,25,20246,809.84,1361556622020,1361556636484,616315584,616330048,14464
1361556639,616332564,20,19585,979.25,1361556621956,1361556635844,616315520,616329408,13888
1361556639,616332564,18,18840,1046.666667,1361556621956,1361556635588,616315520,616329152,13632
1361556639,616332564,19,18733,985.9473684,1361556621956,1361556635908,616315520,616329472,13952
1361556639,616332564,20,20715,1035.75,1361556622020,1361556635588,616315584,616329152,13568
1361556639,616332564,4,196,49,1361556630275,1361556637123,616323839,616330687,6848
1361556639,616332564,4,196,49,1361556630339,1361556637123,616323903,616330687,6784
1361556639,1978018956,173,214200,1238.150289,1361556596260,1361556632548,1977976216,1978012504,36288
1361556639,1978018956,2,98,49,1361556628131,1361556636771,1978008087,1978016727,8640
1361556639,1978018956,5,532,106.4,1361556631267,1361556638563,1978011223,1978018519,7296
1361556639,1978018960,12,6589,549.0833333,1361556631454,1361556638878,1978011414,1978018838,7424
1361556639,1978019028,3,144,48,1361556629147,1361556636763,1978009175,1978016791,7616
1361556639,1978019032,4,202,50.5,1361556621653,1361556631573,1978001685,1978011605,9920
1361556639,1978019036,4,202,50.5,1361556630034,1361556636690,1978010070,1978016726,6656
1361556639,1978019036,9,5556,617.3333333,1361556630034,1361556633362,1978010070,1978013398,3328
1361556639,1978019036,5,248,49.6,1361556630034,1361556636690,1978010070,1978016726,6656
1361556639,1978019036,3,140,46.66666667,1361556630034,1361556636690,1978010070,1978016726,6656
1361556639,1978019036,3,144,48,1361556630097,1361556636753,1978010133,1978016789,6656
1361556639,1978019036,2,92,46,1361556630097,1361556636689,1978010133,1978016725,6592
1361556639,1978019040,3,138,46,1361556630735,1361556637839,1978010775,1978017879,7104
1361556639,1978019068,3,138,46,1361556631921,1361556635185,1978011989,1978015253,3264
1361556639,1978019068,2,92,46,1361556631921,1361556633393,1978011989,1978013461,1472
1361556639,1978019068,3,144,48,1361556628018,1361556636658,1978008086,1978016726,8640
1361556639,1978019076,6,3436,572.6666667,1361556631340,1361556638124,1978011416,1978018200,6784
1361556639,1978019108,4,186,46.5,1361556621577,1361556632521,1978001685,1978012629,10944
1361556639,1978019112,3,144,48,1361556621639,1361556631495,1978001751,1978011607,9856
1361556639,1978019120,3,144,48,1361556629949,1361556636669,1978010069,1978016789,6720
1361556639,1978019120,3,325,108.3333333,1361556630016,1361556636800,1978010136,1978016920,6784
1361556639,1978019120,4,202,50.5,1361556629952,1361556636608,1978010072,1978016728,6656
1361556639,1978019120,6,294,49,1361556629952,1361556636800,1978010072,1978016920,6848
1361556639,1978019120,8,1096,137,1361556629951,1361556635839,1978010071,1978015959,5888
1361556639,1978019120,8,761,95.125,1361556630079,1361556633535,1978010199,1978013655,3456
1361556639,1978019120,2,92,46,1361556630015,1361556636607,1978010135,1978016727,6592
1361556639,1978019120,15,11722,781.4666667,1361556630015,1361556637119,1978010135,1978017239,7104
1361556639,1978019120,3,138,46,1361556630653,1361556637693,1978010773,1978017813,7040
1361556640,1978019756,14,4318,308.4285714,1361556615402,1361556638954,1977995158,1978018710,23552
1361556640,1978019804,60,65688,1094.8,1361556613690,1361556635450,1977993494,1978015254,21760
1361556640,1978019808,70,76810,1097.285714,1361556614390,1361556622518,1977994198,1978002326,8128
1361556640,1978019856,1,64,64,1361556612999,1361556612999,1977992855,1977992855,0
1361556640,1978019876,5,1517,303.4,1361556613043,1361556613619,1977992919,1977993495,576
1361556643,616336260,10,8380,838,1361556615732,1361556617140,616308992,616310400,1408
1361556643,616336268,3,1194,398,1361556616938,1361556617322,616310206,616310590,384
1361556643,616336284,55,56848,1033.6,1361556618268,1361556639260,616311552,616332544,20992
1361556643,616336284,30,27023,900.7666667,1361556618268,1361556636124,616311552,616329408,17856
1361556643,616336284,23,21209,922.1304348,1361556618268,1361556630812,616311552,616324096,12544
1361556643,616336284,32,34102,1065.6875,1361556618268,1361556635868,616311552,616329152,17600
1361556643,616336284,28,30290,1081.785714,1361556618268,1361556634716,616311552,616328000,16448
1361556643,616336284,29,30515,1052.241379,1361556618268,1361556635868,616311552,616329152,17600
1361556643,616336284,26,27047,1040.269231,1361556618268,1361556634332,616311552,616327616,16064
1361556643,616336284,20,20688,1034.4,1361556618268,1361556627420,616311552,616320704,9152
1361556643,616336284,31,32759,1056.741935,1361556618267,1361556624347,616311551,616317631,6080
1361556643,616336284,26,25319,973.8076923,1361556618267,1361556632539,616311551,616325823,14272
1361556643,616336284,25,26441,1057.64,1361556618267,1361556624603,616311551,616317887,6336
1361556643,616336284,27,24465,906.1111111,1361556618267,1361556635867,616311551,616329151,17600
1361556643,616336284,30,29747,991.5666667,1361556618267,1361556632219,616311551,616325503,13952
1361556643,616336284,35,35412,1011.771429,1361556618267,1361556630811,616311551,616324095,12544
1361556643,616336284,33,32204,975.8787879,1361556618267,1361556636635,616311551,616329919,18368
1361556643,616336284,29,32264,1112.551724,1361556618267,1361556636571,616311551,616329855,18304
1361556643,616336284,28,30224,1079.428571,1361556618267,1361556634203,616311551,616327487,15936
1361556643,616336284,24,27960,1165,1361556618267,1361556631771,616311551,616325055,13504
1361556643,616336312,11,10586,962.3636364,1361556616897,1361556617985,616310209,616311297,1088
1361556643,616336316,13,12201,938.5384615,1361556618234,1361556623994,616311550,616317310,5760
1361556643,616336316,36,38306,1064.055556,1361556618234,1361556632698,616311550,616326014,14464
1361556643,616336316,26,23048,886.4615385,1361556618234,1361556633146,616311550,616326462,14912
1361556643,616336316,26,22279,856.8846154,1361556618234,1361556633530,616311550,616326846,15296
1361556643,616336316,43,43504,1011.72093,1361556618234,1361556636986,616311550,616330302,18752
1361556643,616336316,29,30674,1057.724138,1361556618234,1361556631226,616311550,616324542,12992
1361556643,616336328,30,29015,967.1666667,1361556618225,1361556635825,616311553,616329153,17600
1361556643,616336328,24,23660,985.8333333,1361556618225,1361556635825,616311553,616329153,17600
1361556643,616336328,31,35664,1150.451613,1361556618225,1361556636337,616311553,616329665,18112
1361556643,616336328,85,92169,1084.341176,1361556618225,1361556641713,616311553,616335041,23488
1361556643,616336328,42,44190,1052.142857,1361556618224,1361556636976,616311552,616330304,18752
1361556643,616336328,25,23820,952.8,1361556618224,1361556635888,616311552,616329216,17664
1361556643,616336328,23,21674,942.3478261,1361556618224,1361556634608,616311552,616327936,16384
1361556643,616336328,25,23811,952.44,1361556618224,1361556635824,616311552,616329152,17600
1361556643,616336328,15,15702,1046.8,1361556618224,1361556624368,616311552,616317696,6144
1361556643,616336328,27,27590,1021.851852,1361556618224,1361556636144,616311552,616329472,17920
1361556643,616336328,30,30183,1006.1,1361556618224,1361556636720,616311552,616330048,18496
1361556643,616336328,32,33453,1045.40625,1361556618224,1361556635824,616311552,616329152,17600
1361556643,616336328,27,28680,1062.222222,1361556618224,1361556623920,616311552,616317248,5696
1361556643,616336328,31,32020,1032.903226,1361556618224,1361556631664,616311552,616324992,13440
1361556647,616340284,32,32226,1007.0625,1361556622236,1361556636508,616315520,616329792,14272
1361556647,616340284,24,24865,1036.041667,1361556622236,1361556635932,616315520,616329216,13696
1361556647,616340284,26,27217,1046.807692,1361556622236,1361556635868,616315520,616329152,13632
1361556647,616340284,26,25406,977.1538462,1361556622236,1361556635868,616315520,616329152,13632
1361556647,616340284,23,21812,948.3478261,1361556622236,1361556635868,616315520,616329152,13632
1361556647,616340284,17,16152,950.1176471,1361556622236,1361556633884,616315520,616327168,11648
1361556647,616340284,14,12961,925.7857143,1361556622236,1361556631708,616315520,616324992,9472
1361556647,616340284,19,19794,1041.789474,1361556622236,1361556636188,616315520,616329472,13952
1361556647,616340284,21,18811,895.7619048,1361556622236,1361556636188,616315520,616329472,13952
1361556647,616340284,28,28279,1009.964286,1361556622236,1361556636892,616315520,616330176,14656
1361556647,616340284,23,19968,868.173913,1361556622236,1361556637084,616315520,616330368,14848
1361556647,616340284,28,25799,921.3928571,1361556622236,1361556636444,616315520,616329728,14208
1361556647,616340284,22,21386,972.0909091,1361556622236,1361556636636,616315520,616329920,14400
1361556647,616340284,14,13694,978.1428571,1361556622236,1361556631836,616315520,616325120,9600
1361556647,616340284,17,18081,1063.588235,1361556622299,1361556633179,616315583,616326463,10880
1361556647,616340284,27,26675,987.962963,1361556622299,1361556636763,616315583,616330047,14464
1361556647,616340284,24,24878,1036.583333,1361556622299,1361556636763,616315583,616330047,14464
1361556647,616340284,14,15564,1111.714286,1361556622299,1361556632155,616315583,616325439,9856
1361556647,616340284,15,15329,1021.933333,1361556622235,1361556631835,616315519,616325119,9600
1361556647,616340284,16,16701,1043.8125,1361556622235,1361556631835,616315519,616325119,9600
1361556647,616340284,20,19890,994.5,1361556622299,1361556635099,616315583,616328383,12800
1361556647,616340284,23,24334,1058,1361556622363,1361556635867,616315647,616329151,13504
1361556647,616340284,18,17657,980.9444444,1361556622298,1361556634842,616315582,616328126,12544
1361556647,616340284,13,11450,880.7692308,1361556622298,1361556631386,616315582,616324670,9088
1361556647,616340316,28,25732,919,1361556622203,1361556636923,616315519,616330239,14720
1361556647,616340316,27,25446,942.4444444,1361556622203,1361556635835,616315519,616329151,13632
1361556647,616340316,20,19840,992,1361556622203,1361556636091,616315519,616329407,13888
1361556647,616340316,24,21543,897.625,1361556622203,1361556637243,616315519,616330559,15040
1361556647,616340316,26,23560,906.1538462,1361556622203,1361556636667,616315519,616329983,14464
1361556647,616340316,13,13178,1013.692308,1361556622267,1361556630331,616315583,616323647,8064
1361556647,616340316,33,34013,1030.69697,1361556622203,1361556636667,616315519,616329983,14464
1361556647,616340316,16,15413,963.3125,1361556622267,1361556631931,616315583,616325247,9664
1361556647,616340316,22,19498,886.2727273,1361556622267,1361556635003,616315583,616328319,12736
1361556647,616340316,19,18791,989,1361556622267,1361556634747,616315583,616328063,12480
1361556647,616340316,16,13367,835.4375,1361556622331,1361556634107,616315647,616327423,11776
1361556647,616340316,25,22909,916.36,1361556622331,1361556636347,616315647,616329663,14016
1361556647,616340316,27,25978,962.1481481,1361556622203,1361556635835,616315519,616329151,13632
1361556647,616340316,27,25659,950.3333333,1361556622203,1361556635835,616315519,616329151,13632
1361556647,616340316,18,18957,1053.166667,1361556622203,1361556634299,616315519,616327615,12096
1361556647,616340316,23,23460,1020,1361556622202,1361556636218,616315518,616329534,14016
1361556647,616340316,22,19932,906,1361556622202,1361556636282,616315518,616329598,14080
1361556647,616340316,13,13006,1000.461538,1361556622202,1361556630202,616315518,616323518,8000
1361556647,616340316,18,17074,948.5555556,1361556622202,1361556633082,616315518,616326398,10880
1361556647,616340328,20,18258,912.9,1361556622257,1361556634353,616315585,616327681,12096
1361556647,616340328,19,17851,939.5263158,1361556622257,1361556635761,616315585,616329089,13504
1361556647,616340328,17,17750,1044.117647,1361556622256,1361556633840,616315584,616327168,11584
1361556647,616340328,19,18509,974.1578947,1361556622256,1361556634224,616315584,616327552,11968
1361556647,616340544,7,334,47.71428571,1361556638808,1361556645400,616332352,616338944,6592
1361556647,1978026944,4,458,114.5,1361556641263,1361556642735,1978021207,1978022679,1472
1361556647,1978026948,6,640,106.6666667,1361556639916,1361556643500,1978019864,1978023448,3584
1361556647,1978026948,5,248,49.6,1361556639916,1361556646700,1978019864,1978026648,6784
1361556647,1978026948,3,144,48,1361556639148,1361556645164,1978019096,1978025112,6016
1361556647,1978026948,5,242,48.4,1361556639338,1361556646570,1978019286,1978026518,7232
1361556647,1978026948,4,196,49,1361556636009,1361556643561,1978015957,1978023509,7552
1361556647,1978026948,5,242,48.4,1361556636009,1361556643881,1978015957,1978023829,7872
1361556647,1978026948,4,665,166.25,1361556639337,1361556639977,1978019285,1978019925,640
1361556647,1978026952,3,150,50,1361556639272,1361556645416,1978019224,1978025368,6144
1361556647,1978026952,7,3373,481.8571429,1361556640296,1361556641320,1978020248,1978021272,1024
1361556647,1978026952,7,1861,265.8571429,1361556639271,1361556640743,1978019223,1978020695,1472
1361556647,1978026952,6,2892,482,1361556639335,1361556639975,1978019287,1978019927,640
1361556647,1978026956,6,1739,289.8333333,1361556640548,1361556642980,1978020504,1978022936,2432
1361556647,1978026956,7,2396,342.2857143,1361556631459,1361556639267,1978011415,1978019223,7808
1361556647,1978026956,5,594,118.8,1361556631458,1361556639266,1978011414,1978019222,7808
1361556647,1978026960,4,467,116.75,1361556641248,1361556642720,1978021208,1978022680,1472
1361556647,1978026960,15,13128,875.2,1361556636831,1361556646879,1978016791,1978026839,10048
1361556647,1978026960,3,421,140.3333333,1361556641374,1361556646430,1978021334,1978026390,5056
1361556647,1978026984,15,7487,499.1333333,1361556642120,1361556644808,1978022104,1978024792,2688
1361556647,1978026988,7,2938,419.7142857,1361556642818,1361556645826,1978022806,1978025814,3008
1361556647,1978026988,3,150,50,1361556634306,1361556642882,1978014294,1978022870,8576
1361556647,1978026992,9,5931,659,1361556634879,1361556639871,1978014871,1978019863,4992
1361556647,1978026996,2,98,49,1361556635386,1361556642810,1978015382,1978022806,7424
1361556647,1978026996,2,98,49,1361556635450,1361556642810,1978015446,1978022806,7360
1361556647,1978026996,5,242,48.4,1361556638521,1361556645881,1978018517,1978025877,7360
1361556647,1978026996,3,144,48,1361556638521,1361556645049,1978018517,1978025045,6528
1361556647,1978026996,4,2919,729.75,1361556638521,1361556639289,1978018517,1978019285,768
1361556647,1978027000,20,18629,931.45,1361556639863,1361556646839,1978019863,1978026839,6976
1361556647,1978027000,13,10687,822.0769231,1361556639862,1361556641142,1978019862,1978021142,1280
1361556647,1978027000,5,486,97.2,1361556639094,1361556639926,1978019094,1978019926,832
1361556647,1978027004,2,98,49,1361556635956,1361556642804,1978015960,1978022808,6848
1361556647,1978027004,5,242,48.4,1361556635956,1361556643828,1978015960,1978023832,7872
1361556647,1978027020,2,94,47,1361556640097,1361556646305,1978020117,1978026325,6208
1361556647,1978027024,3,421,140.3333333,1361556639264,1361556641120,1978019288,1978021144,1856
1361556647,1978027024,5,594,118.8,1361556639200,1361556639904,1978019224,1978019928,704
1361556647,1978027024,6,282,47,1361556640349,1361556644061,1978020373,1978024085,3712
1361556647,1978027024,6,294,49,1361556640349,1361556646493,1978020373,1978026517,6144
1361556647,1978027024,8,3638,454.75,1361556640349,1361556641117,1978020373,1978021141,768
1361556647,1978027028,5,1762,352.4,1361556640412,1361556641692,1978020440,1978021720,1280
1361556647,1978027028,6,1735,289.1666667,1361556640476,1361556641180,1978020504,1978021208,704
1361556647,1978027028,130,149046,1146.507692,1361556631387,1361556644763,1978011415,1978024791,13376
1361556647,1978027028,4,377,94.25,1361556631386,1361556639130,1978011414,1978019158,7744
1361556647,1978027032,6,640,106.6666667,1361556641112,1361556642648,1978021144,1978022680,1536
1361556647,1978027032,5,594,118.8,1361556641111,1361556643415,1978021143,1978023447,2304
1361556647,1978027032,3,421,140.3333333,1361556641111,1361556642647,1978021143,1978022679,1536
1361556647,1978027036,8,3616,452,1361556642065,1361556646609,1978022101,1978026645,4544
1361556647,1978027036,9,5168,574.2222222,1361556642065,1361556643473,1978022101,1978023509,1408
1361556647,1978027040,3,150,50,1361556633998,1361556642766,1978014038,1978022806,8768
1361556647,1978027064,7,2944,420.5714286,1361556642743,1361556644727,1978022807,1978024791,1984
1361556647,1978027068,7,882,126,1361556643124,1361556645428,1978023192,1978025496,2304
1361556647,1978027068,2,98,49,1361556634803,1361556642739,1978014871,1978022807,7936
1361556647,1978027072,4,196,49,1361556638447,1361556645871,1978018519,1978025943,7424
1361556647,1978027072,4,196,49,1361556635311,1361556643759,1978015383,1978023831,8448
1361556647,1978027072,5,232,46.4,1361556638446,1361556645870,1978018518,1978025942,7424
1361556647,1978027072,2,98,49,1361556635374,1361556642734,1978015446,1978022806,7360
1361556655,616348544,3,150,50,1361556641495,1361556648407,616335039,616341951,6912
1361556655,616348544,3,144,48,1361556645079,1361556651287,616338623,616344831,6208
1361556655,616348548,2,98,49,1361556643092,1361556650004,616336640,616343552,6912
1361556655,616348552,3,144,48,1361556645071,1361556651279,616338623,616344831,6208
1361556655,616348552,5,242,48.4,1361556641487,1361556648783,616335039,616342335,7296
1361556655,1978034948,5,1075,215,1361556647785,1361556650025,1978027733,1978029973,2240
1361556655,1978034948,6,3506,584.3333333,1361556646953,1361556647785,1978026901,1978027733,832
1361556655,1978034952,4,467,116.75,1361556647016,1361556648680,1978026968,1978028632,1664
1361556655,1978034964,2,98,49,1361556644828,1361556650844,1978024792,1978030808,6016
1361556655,1978034964,2,98,49,1361556644828,1361556650844,1978024792,1978030808,6016
1361556655,1978034964,2,98,49,1361556644828,1361556650844,1978024792,1978030808,6016
1361556655,1978034964,2,98,49,1361556644828,1361556650844,1978024792,1978030808,6016
1361556655,1978034964,3,140,46.66666667,1361556641179,1361556648155,1978021143,1978028119,6976
1361556655,1978034964,4,184,46,1361556641179,1361556648539,1978021143,1978028503,7360
1361556655,1978034964,4,186,46.5,1361556641179,1361556647451,1978021143,1978027415,6272
1361556655,1978034968,38,31943,840.6052632,1361556637076,1361556649364,1978017044,1978029332,12288
1361556655,1978034968,3,138,46,1361556642135,1361556648087,1978022103,1978028055,5952
1361556655,1978034968,5,242,48.4,1361556642135,1361556649239,1978022103,1978029207,7104
1361556655,1978034992,3,138,46,1361556642111,1361556648191,1978022103,1978028183,6080
1361556655,1978034996,24,25976,1082.333333,1361556642748,1361556649852,1978022744,1978029848,7104
1361556655,1978034996,2,98,49,1361556643003,1361556649723,1978022999,1978029719,6720
1361556655,1978034996,2,98,49,1361556643003,1361556649723,1978022999,1978029719,6720
1361556655,1978034996,3,331,110.3333333,1361556643003,1361556649723,1978022999,1978029719,6720
1361556655,1978034996,4,196,49,1361556642682,1361556649466,1978022678,1978029462,6784
1361556655,1978034996,4,190,47.5,1361556643066,1361556650106,1978023062,1978030102,7040
1361556655,1978034996,3,144,48,1361556643066,1361556650554,1978023062,1978030550,7488
1361556655,1978034996,4,202,50.5,1361556642809,1361556649721,1978022805,1978029717,6912
1361556655,1978035000,2,98,49,1361556642932,1361556649716,1978022932,1978029716,6784
1361556655,1978035000,4,904,226,1361556646519,1361556647991,1978026519,1978027991,1472
1361556655,1978035000,4,190,47.5,1361556646646,1361556650102,1978026646,1978030102,3456
1361556655,1978035000,20,8442,422.1,1361556635190,1361556654710,1978015190,1978034710,19520
1361556655,1978035000,9,3449,383.2222222,1361556646645,1361556648437,1978026645,1978028437,1792
1361556655,1978035004,4,190,47.5,1361556647732,1361556650868,1978027736,1978030872,3136
1361556655,1978035004,3,144,48,1361556647732,1361556650804,1978027736,1978030808,3072
1361556655,1978035004,7,3444,492,1361556646963,1361556649075,1978026967,1978029079,2112
1361556655,1978035008,52,40985,788.1730769,1361556640366,1361556654702,1978020374,1978034710,14336
1361556655,1978035032,6,501,83.5,1361556649110,1361556650326,1978029142,1978030358,1216
1361556655,1978035032,7,783,111.8571429,1361556641109,1361556647765,1978021141,1978027797,6656
1361556655,1978035032,3,144,48,1361556644757,1361556650773,1978024789,1978030805,6016
1361556655,1978035032,3,144,48,1361556644757,1361556650773,1978024789,1978030805,6016
1361556655,1978035032,4,186,46.5,1361556641173,1361556648149,1978021205,1978028181,6976
1361556655,1978035036,5,236,47.2,1361556641108,1361556648532,1978021144,1978028568,7424
1361556655,1978035036,3,138,46,1361556641108,1361556648340,1978021144,1978028376,7232
1361556655,1978035036,2,98,49,1361556644756,1361556650772,1978024792,1978030808,6016
1361556655,1978035036,2,98,49,1361556644756,1361556650772,1978024792,1978030808,6016
1361556655,1978035036,3,144,48,1361556644756,1361556650772,1978024792,1978030808,6016
1361556655,1978035036,3,144,48,1361556644756,1361556651028,1978024792,1978031064,6272
1361556655,1978035040,17,12511,735.9411765,1361556649935,1361556653455,1978029975,1978033495,3520
1361556655,1978035044,3,138,46,1361556642634,1361556649482,1978022678,1978029526,6848
1361556655,1978035044,2,98,49,1361556642698,1361556649674,1978022742,1978029718,6976
1361556655,1978035044,3,144,48,1361556642762,1361556649674,1978022806,1978029718,6912
1361556655,1978035044,3,150,50,1361556642761,1361556649673,1978022805,1978029717,6912
1361556655,1978035044,9,2529,281,1361556642889,1361556647625,1978022933,1978027669,4736
1361556655,1978035044,3,144,48,1361556642889,1361556649673,1978022933,1978029717,6784
1361556655,1978035048,2,279,139.5,1361556643013,1361556649669,1978023061,1978029717,6656
1361556655,1978035048,2,279,139.5,1361556643143,1361556650759,1978023191,1978030807,7616
1361556655,1978035048,3,325,108.3333333,1361556643207,1361556651079,1978023255,1978031127,7872
1361556655,1978035064,2,92,46,1361556643445,1361556650805,1978023509,1978030869,7360
1361556655,1978035068,5,1082,216.4,1361556646452,1361556648180,1978026520,1978028248,1728
1361556656,1978035824,33,1848,56,1361556628198,1361556650982,1978008022,1978030806,22784
1361556656,1978035832,6,669,111.5,1361556631583,1361556638239,1978011415,1978018071,6656
1361556656,1978035832,6,669,111.5,1361556631582,1361556638174,1978011414,1978018006,6592
1361556656,1978035864,16,896,56,1361556629822,1361556650814,1978009686,1978030678,20992
1361556656,1978035872,5,323,64.6,1361556630519,1361556631159,1978010391,1978011031,640
1361556656,1978035912,31,2976,96,1361556628367,1361556651215,1978008279,1978031127,22848
1361556656,1978035912,4,879,219.75,1361556631501,1361556637837,1978011413,1978017749,6336
1361556656,1978035940,8,2328,291,1361556628785,1361556650673,1978008725,1978030613,21888
1361556656,1978035944,16,896,56,1361556628976,1361556650288,1978008920,1978030232,21312
1361556659,616352260,13,2015,155,1361556631925,1361556648181,616325185,616341441,16256
1361556660,1978039824,1,46,46,1361556632165,1361556632165,1978011989,1978011989,0
1361556660,1978039872,1,46,46,1361556634868,1361556634868,1978014740,1978014740,0
1361556663,1978042960,8,1802,225.25,1361556641182,1361556659870,1978021142,1978039830,18688
1361556663,1978042964,2,98,49,1361556645144,1361556661016,1978025108,1978040980,15872
1361556663,1978042964,2,92,46,1361556657435,1361556662811,1978037399,1978042775,5376
1361556663,1978042984,6,760,126.6666667,1361556642948,1361556661764,1978022932,1978041748,18816
1361556663,1978042992,3,140,46.66666667,1361556647934,1361556662270,1978027926,1978042262,14336
1361556663,1978042992,4,196,49,1361556647229,1361556661821,1978027221,1978041813,14592
1361556663,1978043032,2,98,49,1361556645080,1361556661016,1978025112,1978041048,15936
1361556663,1978043032,2,304,152,1361556649942,1361556660630,1978029974,1978040662,10688
1361556663,1978043036,2,304,152,1361556650324,1361556660692,1978030360,1978040728,10368
1361556663,1978043036,2,304,152,1361556650323,1361556660691,1978030359,1978040727,10368
1361556663,1978043036,4,196,49,1361556645778,1361556659794,1978025814,1978039830,14016
1361556663,1978043040,6,822,137,1361556643024,1361556662032,1978023064,1978042072,19008
1361556664,1978043968,16,12221,763.8125,1361556639319,1361556640471,1978019287,1978020439,1152
1361556664,1978044116,3,1328,442.6666667,1361556638403,1361556638979,1978018519,1978019095,576
1361556664,1978044116,2,1498,749,1361556638402,1361556638914,1978018518,1978019030,512
1361556667,616360288,4,993,248.25,1361556641752,1361556642712,616335040,616336000,960
1361556667,616360320,5,2316,463.2,1361556641719,1361556642231,616335039,616335551,512
1361556668,1978048088,3,368,122.6666667,1361556639839,1361556666911,1978019927,1978046999,27072
1361556668,1978048092,9,1612,179.1111111,1361556640281,1361556665689,1978020373,1978045781,25408
1361556668,1978048100,10,4370,437,1361556641042,1361556646290,1978021142,1978026390,5248
1361556668,1978048120,13,7340,564.6153846,1361556641022,1361556645374,1978021142,1978025494,4352
1361556668,1978048128,23,14683,638.3913043,1361556641974,1361556646454,1978022102,1978026582,4480
1361556668,1978048128,17,5328,313.4117647,1361556641974,1361556649014,1978022102,1978029142,7040
1361556668,1978048132,6,1226,204.3333333,1361556642672,1361556644848,1978022804,1978024980,2176
1361556668,1978048156,7,2513,359,1361556643098,1361556645658,1978023254,1978025814,2560
1361556668,1978048172,40,30239,755.975,1361556640204,1361556666060,1978020376,1978046232,25856
1361556668,1978048240,7,5055,722.1428571,1361556642567,1361556644679,1978022807,1978024919,2112
1361556668,1978048240,4,354,88.5,1361556642758,1361556644870,1978022998,1978025110,2112
1361556668,1978048240,10,644,64.4,1361556642821,1361556667077,1978023061,1978047317,24256
1361556668,1978048244,5,638,127.6,1361556642947,1361556646211,1978023191,1978026455,3264
1361556671,616364276,1,1500,1500,1361556644773,1361556644773,616338049,616338049,0
1361556671,616364312,34,41476,1219.882353,1361556643327,1361556646591,616336639,616339903,3264
1361556671,616364344,12,7572,631,1361556646817,1361556650785,616340161,616344129,3968
1361556671,616364344,2,98,49,1361556650849,1361556665825,616344193,616359169,14976
1361556671,616364552,2,98,49,1361556650705,1361556665617,616344257,616359169,14912
1361556671,616364552,3,552,184,1361556646993,1361556667793,616340545,616361345,20800
1361556671,616364552,3,552,184,1361556647248,1361556668048,616340800,616361600,20800
1361556671,616364552,3,552,184,1361556647248,1361556668048,616340800,616361600,20800
1361556671,616364552,3,552,184,1361556647503,1361556668303,616341055,616361855,20800
1361556671,616364552,3,552,184,1361556647695,1361556668367,616341247,616361919,20672
1361556671,616364552,3,552,184,1361556648014,1361556668942,616341566,616362494,20928
1361556671,616364564,2,98,49,1361556650627,1361556665603,616344191,616359167,14976
1361556671,616364564,3,144,48,1361556650627,1361556665603,616344191,616359167,14976
1361556671,616364576,3,144,48,1361556651065,1361556669433,616344641,616363009,18368
1361556671,616364576,3,552,184,1361556647672,1361556668344,616341248,616361920,20672
1361556671,616364576,3,552,184,1361556647800,1361556668600,616341376,616362176,20800
1361556671,616364576,3,552,184,1361556647991,1361556668919,616341567,616362495,20928
1361556671,1978050964,5,642,128.4,1361556663772,1361556669788,1978043736,1978049752,6016
1361556671,1978050964,6,6157,1026.166667,1361556655834,1361556666266,1978035798,1978046230,10432
1361556671,1978050964,2,304,152,1361556647833,1361556668761,1978027797,1978048725,20928
1361556671,1978050968,2,92,46,1361556664024,1361556670040,1978043992,1978050008,6016
1361556671,1978050968,2,92,46,1361556664024,1361556670040,1978043992,1978050008,6016
1361556671,1978050968,2,279,139.5,1361556648023,1361556666199,1978027991,1978046167,18176
1361556671,1978050976,2,504,252,1361556663693,1361556669709,1978043669,1978049685,6016
1361556671,1978050976,3,552,184,1361556645069,1361556665933,1978025045,1978045909,20864
1361556671,1978051000,4,184,46,1361556658613,1361556666485,1978038613,1978046485,7872
1361556671,1978051012,2,304,152,1361556646954,1361556667882,1978026966,1978047894,20928
1361556671,1978051016,3,325,108.3333333,1361556647976,1361556666216,1978027992,1978046232,18240
1361556671,1978051016,2,92,46,1361556664103,1361556668071,1978044119,1978048087,3968
1361556671,1978051048,3,550,183.3333333,1361556663686,1361556669702,1978043734,1978049750,6016
1361556671,1978051052,4,604,151,1361556645056,1361556665984,1978025108,1978046036,20928
1361556671,1978051052,4,604,151,1361556644996,1361556665860,1978025048,1978045912,20864
1361556671,1978051052,4,604,151,1361556645059,1361556665987,1978025111,1978046039,20928
1361556671,1978051052,5,273,54.6,1361556665729,1361556665793,1978045781,1978045845,64
1361556671,1978051052,5,267,53.4,1361556665793,1361556665857,1978045845,1978045909,64
1361556671,1978051056,4,184,46,1361556665788,1361556668220,1978045844,1978048276,2432
1361556671,1978051060,9,7972,885.7777778,1361556651067,1361556666107,1978031127,1978046167,15040
1361556671,1978051060,3,144,48,1361556651067,1361556670011,1978031127,1978050071,18944
1361556671,1978051060,12,9761,813.4166667,1361556651066,1361556666234,1978031126,1978046294,15168
1361556672,1978052100,1,46,46,1361556647121,1361556647121,1978027221,1978027221,0
1361556672,1978052136,1,52,52,1361556644975,1361556644975,1978025111,1978025111,0
1361556672,1978052136,1,52,52,1361556644910,1361556644910,1978025046,1978025046,0
1361556672,1978052136,1,52,52,1361556644974,1361556644974,1978025110,1978025110,0
1361556672,1978052136,1,46,46,1361556645101,1361556645101,1978025237,1978025237,0
1361556672,1978052180,1,46,46,1361556646723,1361556646723,1978026903,1978026903,0
1361556672,1978052180,3,138,46,1361556646786,1361556647362,1978026966,1978027542,576
1361556672,1978052216,2,92,46,1361556647391,1361556647455,1978027607,1978027671,64
1361556672,1978052216,2,92,46,1361556647453,1361556647837,1978027669,1978028053,384
1361556672,1978052224,1,52,52,1361556644822,1361556644822,1978025046,1978025046,0
1361556672,1978052224,1,46,46,1361556645013,1361556645013,1978025237,1978025237,0
1361556675,616368256,9,4886,542.8888889,1361556646967,1361556650551,616340223,616343807,3584
1361556675,616368256,9,7176,797.3333333,1361556647286,1361556651190,616340542,616344446,3904
1361556675,616368292,7,4642,663.1428571,1361556650516,1361556651476,616343808,616344768,960
1361556675,616368332,3,552,184,1361556650474,1361556671210,616343806,616364542,20736
1361556675,616368336,3,552,184,1361556650471,1361556671207,616343807,616364543,20736
1361556676,1978056096,6,381,63.5,1361556648727,1361556649367,1978028823,1978029463,640
1361556676,1978056096,6,381,63.5,1361556648727,1361556649239,1978028823,1978029335,512
1361556676,1978056128,2,92,46,1361556649848,1361556675512,1978029976,1978055640,25664
1361556676,1978056204,2,92,46,1361556648873,1361556672169,1978029077,1978052373,23296
1361556676,1978056212,2,92,46,1361556649762,1361556675426,1978029974,1978055638,25664
1361556676,1978056224,3,175,58.33333333,1361556650648,1361556650968,1978030872,1978031192,320
1361556679,1978058956,3,144,48,1361556672099,1361556677795,1978052055,1978057751,5696
1361556679,1978058956,3,144,48,1361556672099,1361556677731,1978052055,1978057687,5632
1361556679,1978058956,3,144,48,1361556672163,1361556677667,1978052119,1978057623,5504
1361556679,1978058960,2,98,49,1361556672542,1361556677662,1978052502,1978057622,5120
1361556679,1978058960,4,190,47.5,1361556672542,1361556678814,1978052502,1978058774,6272
1361556679,1978059008,2,98,49,1361556672045,1361556677613,1978052053,1978057621,5568
1361556679,1978059008,3,144,48,1361556672045,1361556677677,1978052053,1978057685,5632
1361556679,1978059008,2,98,49,1361556672045,1361556677613,1978052053,1978057621,5568
1361556679,1978059008,2,98,49,1361556672045,1361556677613,1978052053,1978057621,5568
1361556679,1978059012,2,123,61.5,1361556671209,1361556671209,1978051221,1978051221,0
1361556679,1978059012,5,236,47.2,1361556672489,1361556678761,1978052501,1978058773,6272
1361556679,1978059012,4,190,47.5,1361556672553,1361556678761,1978052565,1978058773,6208
1361556679,1978059084,645,879980,1364.310078,1361556635299,1361556672355,1978015383,1978052439,37056
1361556692,1978072000,948,1329291,1402.205696,1361556340469,1361556390901,1977720469,1977770901,50432
1361556692,1978072112,20,1120,56,1361556665157,1361556691589,1978045269,1978071701,26432
1361556692,1978072144,3,181,60.33333333,1361556666024,1361556666088,1978046168,1978046232,64
1361556692,1978072144,3,138,46,1361556666404,1361556666468,1978046548,1978046612,64
1361556692,1978072148,3,181,60.33333333,1361556666593,1361556666657,1978046741,1978046805,64
1361556692,1978072176,3,169,56.33333333,1361556667653,1361556667717,1978047829,1978047893,64
1361556692,1978072216,3,193,64.33333333,1361556665309,1361556665309,1978045525,1978045525,0
1361556692,1978072216,39,2184,56,1361556665436,1361556691612,1978045652,1978071828,26176
1361556692,1978072220,2,92,46,1361556665563,1361556668827,1978045783,1978049047,3264
1361556692,1978072220,39,3744,96,1361556665563,1361556691739,1978045783,1978071959,26176
1361556692,1978072220,2,123,61.5,1361556665689,1361556665689,1978045909,1978045909,0
1361556692,1978072228,3,181,60.33333333,1361556666513,1361556666577,1978046741,1978046805,64
1361556692,1978072232,3,138,46,1361556666958,1361556666958,1978047190,1978047190,0
1361556692,1978072260,2,92,46,1361556667569,1361556671921,1978047829,1978052181,4352
1361556696,1978076116,3,169,56.33333333,1361556668737,1361556668737,1978048853,1978048853,0
1361556700,1978080168,2,92,46,1361556673487,1361556673551,1978053655,1978053719,64
1361556700,1978080172,1,46,46,1361556674314,1361556674314,1978054486,1978054486,0
1361556700,1978080208,1,46,46,1361556675557,1361556675557,1978055765,1978055765,0
1361556700,1978080216,3,138,46,1361556672221,1361556672285,1978052437,1978052501,64
1361556700,1978080220,30,1680,56,1361556672282,1361556699226,1978052502,1978079446,26944
1361556700,1978080260,2,92,46,1361556673779,1361556673843,1978054039,1978054103,64
1361556700,1978080260,1,46,46,1361556674225,1361556674225,1978054485,1978054485,0
1361556700,1978080260,2,92,46,1361556674225,1361556674289,1978054485,1978054549,64
1361556700,1978080260,40,19224,480.6,1361556674225,1361556677361,1978054485,1978057621,3136
1361556700,1978080260,9,1284,142.6666667,1361556674032,1361556679216,1978054292,1978059476,5184
1361556700,1978080264,1,46,46,1361556674223,1361556674223,1978054487,1978054487,0
1361556700,1978080296,1,46,46,1361556675471,1361556675471,1978055767,1978055767,0
1361556703,1978083024,2,98,49,1361556693151,1361556698143,1978073175,1978078167,4992
1361556703,1978083024,3,144,48,1361556693151,1361556698207,1978073175,1978078231,5056
1361556703,1978083104,2,98,49,1361556693070,1361556698062,1978073174,1978078166,4992
1361556703,1978083104,2,98,49,1361556693070,1361556698062,1978073174,1978078166,4992
1361556703,1978083104,3,144,48,1361556693070,1361556699086,1978073174,1978079190,6016
1361556704,1978084116,30,32921,1097.366667,1361556675969,1361556683009,1978056085,1978063125,7040
1361556704,1978084128,1,46,46,1361556679412,1361556679412,1978059540,1978059540,0
1361556704,1978084208,29,32865,1133.275862,1361556675876,1361556687204,1978056084,1978067412,11328
1361556704,1978084212,1,1500,1500,1361556676195,1361556676195,1978056407,1978056407,0
1361556708,1978088112,1238,1684303,1360.503231,1361556331207,1361556405319,1977711319,1977785431,74112
1361556708,1978088160,1,46,46,1361556682391,1361556682391,1978062551,1978062551,0
1361556708,1978088216,1,46,46,1361556681310,1361556681310,1978061526,1978061526,0
1361556711,1978091044,3,138,46,1361556705227,1361556705291,1978085271,1978085335,64
1361556711,1978091120,4,215,53.75,1361556705533,1361556710589,1978085653,1978090709,5056
1361556712,1978092144,1,46,46,1361556684390,1361556684390,1978064534,1978064534,0
1361556712,1978092176,1,46,46,1361556685316,1361556685316,1978065492,1978065492,0
1361556712,1978092212,1,46,46,1361556686499,1361556686499,1978066711,1978066711,0
1361556712,1978092220,1,46,46,1361556684248,1361556684248,1978064468,1978064468,0
1361556712,1978092260,5,1208,241.6,1361556685170,1361556685426,1978065430,1978065686,256
1361556716,1978096132,1,46,46,1361556688048,1361556688048,1978068180,1978068180,0
1361556716,1978096140,2,123,61.5,1361556688808,1361556688872,1978068948,1978069012,64
1361556716,1978096212,1,46,46,1361556688416,1361556688416,1978068628,1978068628,0
1361556720,1978100152,75,7200,96,1361556692126,1361556719646,1978072278,1978099798,27520
1361556720,1978100228,75,4200,56,1361556691986,1361556719506,1978072214,1978099734,27520
1361556720,1978100232,38,2128,56,1361556692174,1361556719694,1978072406,1978099926,27520
1361556720,1978100276,2,192,96,1361556693791,1361556699743,1978074067,1978080019,5952
1361556724,1978104164,3,138,46,1361556697105,1361556697169,1978077269,1978077333,64
1361556728,1978108228,38,2128,56,1361556700049,1361556727505,1978080277,1978107733,27456
1361556728,1978108232,3,138,46,1361556703308,1361556703308,1978083540,1978083540,0
1361556732,1978112220,3,169,56.33333333,1361556707737,1361556707801,1978087957,1978088021,64
1361556733,1978112300,2,123,61.5,1361556708655,1361556708655,1978087955,1978087955,0
1361556735,1978115072,6,499,83.16666667,1361556730093,1361556732269,1978110165,1978112341,2176
1361556736,1978116152,2,92,46,1361556711005,1361556711069,1978091157,1978091221,64
1361556736,1978116156,1,46,46,1361556711067,1361556711067,1978091223,1978091223,0
1361556736,1978116192,3,169,56.33333333,1361556709749,1361556709941,1978089941,1978090133,192
1361556740,1978120232,2,92,46,1361556711947,1361556711947,1978092179,1978092179,0
1361556740,1978120280,5,1208,241.6,1361556714460,1361556714844,1978094740,1978095124,384
1361556748,1978128168,73,4088,56,1361556719886,1361556747662,1978100054,1978127830,27776
1361556748,1978128176,36,2016,56,1361556720390,1361556747462,1978100566,1978127638,27072
1361556748,1978128184,1,64,64,1361556720955,1361556720955,1978101139,1978101139,0
1361556748,1978128252,2,123,61.5,1361556723705,1361556723769,1978103957,1978104021,64
1361556748,1978128256,73,7008,96,1361556719859,1361556747699,1978100115,1978127955,27840
1361556748,1978128268,3,138,46,1361556721003,1361556721003,1978101271,1978101271,0
1361556751,1978131148,3,138,46,1361556747234,1361556747298,1978127382,1978127446,64
1361556751,1978131148,8,458,57.25,1361556747808,1361556747872,1978127956,1978128020,64
1361556752,1978132188,2,123,61.5,1361556726777,1361556726841,1978106965,1978107029,64
1361556752,1978132204,1,77,77,1361556724777,1361556724777,1978104981,1978104981,0
1361556753,1978132304,2,123,61.5,1361556725676,1361556725676,1978104980,1978104980,0
1361556753,1978132304,1,77,77,1361556725676,1361556725676,1978104980,1978104980,0
1361556753,1978132324,2,123,61.5,1361556726618,1361556726682,1978105942,1978106006,64
1361556756,1978136224,34,1904,56,1361556728213,1361556755285,1978108437,1978135509,27072
1361556757,1978136344,1,46,46,1361556730820,1361556730820,1978110164,1978110164,0
1361556759,616452684,2,92,46,1361556732364,1361556732364,616426048,616426048,0
1361556759,616452728,1,46,46,1361556732320,1361556732320,616426048,616426048,0
1361556759,616452732,2,92,46,1361556733278,1361556733342,616427010,616427074,64
1361556759,1978139196,2,92,46,1361556754097,1361556754097,1978134293,1978134293,0
1361556761,1978140376,13,3316,255.0769231,1361556735079,1361556738471,1978114455,1978117847,3392
1361556764,1978144280,3,138,46,1361556738587,1361556738651,1978118867,1978118931,64
1361556767,616460680,4,190,47.5,1361556751441,1361556761489,616445121,616455169,10048
1361556767,616460688,5,236,47.2,1361556751431,1361556766407,616445119,616460095,14976
1361556767,616460760,1,46,46,1361556742270,1361556742270,616436030,616436030,0
1361556767,616460764,1,46,46,1361556742268,1361556742268,616436032,616436032,0
1361556767,616460804,1,46,46,1361556742227,1361556742227,616436031,616436031,0
1361556767,616460804,1,46,46,1361556742227,1361556742227,616436031,616436031,0
1361556767,616460808,2,92,46,1361556742225,1361556742289,616436033,616436097,64
1361556767,1978147116,253,277773,1097.916996,1361556571521,1361556766017,1977951637,1978146133,194496
1361556767,1978147164,7,412,58.85714286,1361556765970,1361556766034,1978146134,1978146198,64
1361556767,1978147212,2,92,46,1361556762208,1361556765472,1978142420,1978145684,3264
1361556767,1978147240,7,412,58.85714286,1361556765891,1361556765891,1978146131,1978146131,0
1361556768,1978148216,3,138,46,1361556742939,1361556742939,1978123155,1978123155,0
1361556771,616464656,2,92,46,1361556743401,1361556743401,616437057,616437057,0
1361556771,616464676,1,46,46,1361556745364,1361556745364,616439040,616439040,0
1361556771,616464684,2,92,46,1361556746382,1361556746382,616440066,616440066,0
1361556771,616464684,1,46,46,1361556746381,1361556746381,616440065,616440065,0
1361556771,616464684,2,92,46,1361556746381,1361556746381,616440065,616440065,0
1361556771,616464688,2,92,46,1361556743368,1361556743368,616437056,616437056,0
1361556771,616464708,2,92,46,1361556745331,1361556745395,616439039,616439103,64
1361556771,616464724,1,46,46,1361556746339,1361556746339,616440063,616440063,0
1361556773,1978152360,12,2508,209,1361556747379,1361556771699,1978126739,1978151059,24320
1361556775,616468716,1,46,46,1361556747438,1361556747438,616441154,616441154,0
1361556775,616468720,1,46,46,1361556747434,1361556747434,616441154,616441154,0
1361556775,616468720,1,46,46,1361556747434,1361556747434,616441154,616441154,0
1361556775,616468724,1,46,46,1361556748387,1361556748387,616442111,616442111,0
1361556775,616468724,1,46,46,1361556748451,1361556748451,616442175,616442175,0
1361556775,616468724,2,92,46,1361556748386,1361556748450,616442110,616442174,64
1361556775,616468724,1,46,46,1361556748454,1361556748454,616442178,616442178,0
1361556775,616468740,2,92,46,1361556749396,1361556749460,616443136,616443200,64
1361556775,616468740,1,46,46,1361556749396,1361556749396,616443136,616443136,0
1361556775,616468740,1,46,46,1361556749396,1361556749396,616443136,616443136,0
1361556775,616468740,1,46,46,1361556749396,1361556749396,616443136,616443136,0
1361556775,616468740,1,46,46,1361556749396,1361556749396,616443136,616443136,0
1361556775,616468744,2,92,46,1361556750415,1361556750415,616444159,616444159,0
1361556775,616468744,1,46,46,1361556750415,1361556750415,616444159,616444159,0
1361556775,616468744,1,46,46,1361556750415,1361556750415,616444159,616444159,0
1361556775,616468744,1,46,46,1361556750418,1361556750418,616444162,616444162,0
1361556775,616468752,2,92,46,1361556747401,1361556747401,616441153,616441153,0
1361556775,616468752,2,92,46,1361556747401,1361556747401,616441153,616441153,0
1361556775,616468752,1,46,46,1361556747401,1361556747401,616441153,616441153,0
1361556775,616468768,1,46,46,1361556748408,1361556748408,616442176,616442176,0
1361556775,616468772,1,46,46,1361556749364,1361556749364,616443136,616443136,0
1361556775,616468772,1,46,46,1361556749364,1361556749364,616443136,616443136,0
1361556775,616468772,1,46,46,1361556749363,1361556749363,616443135,616443135,0
1361556775,616468772,1,46,46,1361556749363,1361556749363,616443135,616443135,0
1361556775,616468776,1,46,46,1361556750386,1361556750386,616444162,616444162,0
1361556775,616468776,1,46,46,1361556750386,1361556750386,616444162,616444162,0
1361556775,616468788,1,46,46,1361556750372,1361556750372,616444160,616444160,0
1361556775,616468788,1,46,46,1361556750372,1361556750372,616444160,616444160,0
1361556775,616468788,1,46,46,1361556750372,1361556750372,616444160,616444160,0
1361556775,1978155116,8,458,57.25,1361556769026,1361556769026,1978149142,1978149142,0
1361556776,1978156224,2,128,64,1361556747925,1361556774997,1978128149,1978155221,27072
1361556776,1978156228,72,4032,56,1361556748047,1361556775823,1978128275,1978156051,27776
1361556777,1978156304,71,6816,96,1361556749100,1361556776492,1978128404,1978155796,27392
1361556777,1978156308,36,2016,56,1361556749289,1361556776553,1978128597,1978155861,27264
1361556779,616472668,2,92,46,1361556752476,1361556752476,616446144,616446144,0
1361556779,616472668,2,92,46,1361556752475,1361556752475,616446143,616446143,0
1361556779,616472692,2,92,46,1361556751426,1361556751426,616445118,616445118,0
1361556780,1978160240,2,92,46,1361556753029,1361556753093,1978133269,1978133333,64
1361556780,1978160268,2,92,46,1361556754024,1361556754216,1978134292,1978134484,192
1361556781,1978160320,2,92,46,1361556753950,1361556754014,1978133270,1978133334,64
1361556781,1978160352,1,46,46,1361556754942,1361556754942,1978134294,1978134294,0
1361556783,616476752,2,92,46,1361556756425,1361556756553,616450177,616450305,128
1361556783,616476764,2,92,46,1361556757435,1361556757435,616451199,616451199,0
1361556783,616476812,1,46,46,1361556757388,1361556757388,616451200,616451200,0
1361556783,1978163120,3,138,46,1361556776316,1361556776316,1978156436,1978156436,0
1361556783,1978163136,374,444498,1188.497326,1361556329454,1361556782254,1977709590,1978162390,452800
1361556783,1978163164,4,184,46,1361556780241,1361556781137,1978160405,1978161301,896
1361556783,1978163172,1832,2044434,1115.957424,1361556103878,1361556782022,1977484050,1978162194,678144
1361556783,1978163208,7,412,58.85714286,1361556781987,1361556781987,1978162195,1978162195,0
1361556784,1978164232,38,2128,56,1361556756045,1361556783629,1978136277,1978163861,27584
1361556787,616480700,2,92,46,1361556762556,1361556762556,616456256,616456256,0
1361556788,1978168240,2,92,46,1361556760067,1361556760131,1978140307,1978140371,64
1361556788,1978168252,2,92,46,1361556761081,1361556761209,1978141333,1978141461,128
1361556788,1978168284,1,46,46,1361556762137,1361556762137,1978142421,1978142421,0
1361556789,1978168324,1,46,46,1361556761047,1361556761047,1978140371,1978140371,0
1361556789,1978168336,1,46,46,1361556762060,1361556762060,1978141396,1978141396,0
1361556789,1978168368,1,46,46,1361556763050,1361556763050,1978142418,1978142418,0
1361556791,616484740,2,92,46,1361556763542,1361556763542,616457282,616457282,0
1361556791,616484760,1,46,46,1361556765504,1361556765504,616459264,616459264,0
1361556791,616484788,2,92,46,1361556764451,1361556764515,616458239,616458303,64
1361556791,616484796,1,46,46,1361556765469,1361556765469,616459265,616459265,0
1361556791,616484812,2,92,46,1361556766413,1361556766477,616460225,616460289,64
1361556791,1978171156,8,458,57.25,1361556784025,1361556784025,1978164181,1978164181,0
1361556791,1978171240,8,458,57.25,1361556784898,1361556784962,1978165138,1978165202,64
1361556799,1978179244,9,445,49.44444444,1361556796800,1361556797760,1978177044,1978178004,960
1361556804,1978184244,37,2072,56,1361556776575,1361556803839,1978156819,1978184083,27264
1361556805,1978184292,76,7296,96,1361556776887,1361556804663,1978156179,1978183955,27776
1361556805,1978184320,75,4200,56,1361556777054,1361556804574,1978156374,1978183894,27520
1361556807,616500684,688,915857,1331.1875,1361556684110,1361556802574,616377794,616496258,118464
1361556808,1978188248,2,92,46,1361556780157,1361556780157,1978160405,1978160405,0
1361556808,1978188284,2,92,46,1361556781144,1361556781144,1978161428,1978161428,0
1361556812,1978192264,37,2072,56,1361556784364,1361556811052,1978164628,1978191316,26688
1361556815,1978195164,361,247850,686.565097,1361556024271,1361556808335,1977404435,1978188499,784064
1361556825,1978204696,10,2011,201.1,1361556798308,1361556798436,1978178004,1978178132,128
1361556829,1978208544,65,3640,56,1361556804730,1361556828666,1978184274,1978208210,23936
1361556829,1978208584,5,1208,241.6,1361556802517,1361556802773,1978182101,1978182357,256
1361556829,1978208588,1,64,64,1361556802702,1361556802702,1978182290,1978182290,0
1361556829,1978208624,66,6336,96,1361556804780,1361556828652,1978184404,1978208276,23872
1361556833,1978212668,38,2128,56,1361556805376,1361556832512,1978185044,1978212180,27136
1361556837,1978216536,34,1904,56,1361556812676,1361556836740,1978192212,1978216276,24064
1361556857,1978236560,64,3584,56,1361556829035,1361556856619,1978208595,1978236179,27584
1361556857,1978236600,4,1162,290.5,1361556829828,1361556830084,1978209428,1978209684,256
1361556857,1978236640,64,6144,96,1361556829019,1361556856603,1978208659,1978236243,27584
1361556857,1978236652,2,128,64,1361556829710,1361556856718,1978209362,1978236370,27008
1361556861,1978240616,30,1680,56,1361556833586,1361556860338,1978213202,1978239954,26752
1361556863,1978243196,7,353,50.42857143,1361556857841,1361556857969,1978238037,1978238165,128
1361556865,1978244608,28,1568,56,1361556837307,1361556864571,1978216915,1978244179,27264
1361556881,1978260620,32,1792,56,1361556856880,1361556880752,1978236500,1978260372,23872
1361556885,1978264624,39,3744,96,1361556856940,1361556884588,1978236564,1978264212,27648
1361556885,1978264632,8,2324,290.5,1361556858019,1361556883811,1978237651,1978263443,25792
1361556885,1978264636,10,2011,201.1,1361556858590,1361556858718,1978238226,1978238354,128
1361556889,1978268648,20,1120,56,1361556860946,1361556888658,1978240594,1978268306,27712
1361556893,1978272724,19,1064,56,1361556865158,1361556892742,1978244882,1978272466,27584
1361556909,1978288660,35,3360,96,1361556884872,1361556908744,1978264532,1978288404,23872
1361556909,1978288740,42,2352,56,1361556880950,1361556908470,1978260690,1978288210,27520
1361556909,1978288784,1,64,64,1361556883723,1361556883723,1978263507,1978263507,0
1361556917,1978296688,19,1064,56,1361556889448,1361556916392,1978269136,1978296080,26944
1361556919,1978299228,7,353,50.42857143,1361556917838,1361556918222,1978298066,1978298450,384
1361556921,1978300652,669,919497,1374.434978,1361556596558,1361556617294,1977976210,1977996946,20736
1361556921,1978300652,547,739376,1351.69287,1361556601294,1361556617358,1977980946,1977997010,16064
1361556921,1978300692,20,1120,56,1361556893862,1361556920102,1978273554,1978299794,26240
1361556933,1978312768,8,2324,290.5,1361556906648,1361556930136,1978286416,1978309904,23488
1361556937,1978316656,57,3192,56,1361556909130,1361556936522,1978288786,1978316178,27392
1361556937,1978316660,57,5472,96,1361556909317,1361556936645,1978288977,1978316305,27328
1361556937,1978316784,1,64,64,1361556910729,1361556910729,1978290513,1978290513,0
1361556945,1978324668,32,1792,56,1361556917246,1361556944254,1978296914,1978323922,27008
1361556945,1978324796,12,4602,383.5,1361556918717,1361556919101,1978298513,1978298897,384
1361556949,1978328788,33,1848,56,1361556920967,1361556948679,1978300755,1978328467,27712
1361556961,1978340780,54,3024,56,1361556936844,1361556960524,1978316624,1978340304,23680
1361556965,1978344684,62,5952,96,1361556937004,1361556964460,1978316688,1978344144,27456
1361556965,1978344696,2,304,152,1361556937889,1361556956961,1978317585,1978336657,19072
1361556973,1978352780,27,1512,56,1361556945100,1361556972492,1978324880,1978352272,27392
1361556977,1978356800,27,1512,56,1361556949624,1361556976248,1978329424,1978356048,26624
1361556983,1978363280,36,34238,951.0555556,1361556973977,1361556978137,1978354257,1978358417,4160
1361556984,1978363292,2,98,49,1361556975799,1361556981239,1978355091,1978360531,5440
1361556984,1978363292,4,190,47.5,1361556975799,1361556981431,1978355091,1978360723,5632
1361556984,1978363336,8,399,49.875,1361556978761,1361556979913,1978358097,1978359249,1152
1361556984,1978363372,2,98,49,1361556975719,1361556981159,1978355091,1978360531,5440
1361556984,1978363372,3,144,48,1361556975718,1361556981286,1978355090,1978360658,5568
1361556989,1978368976,53,2968,56,1361556960971,1361556988747,1978340947,1978368723,27776
1361556989,1978369048,44,4224,96,1361556964608,1361556988736,1978344656,1978368784,24128
1361556989,1978369048,2,288,144,1361556964608,1361556977280,1978344656,1978357328,12672
1361556989,1978369052,3,138,46,1361556964798,1361556964926,1978344850,1978344978,128
1361556991,1978371272,2,94,47,1361556975969,1361556985313,1978356241,1978365585,9344
1361556997,1978376984,5,502,100.4,1361556970495,1361556974463,1978350479,1978354447,3968
1361556997,1978377012,1,46,46,1361556971235,1361556971235,1978351247,1978351247,0
1361556997,1978377088,14,4265,304.6428571,1361556970584,1361556991576,1978350672,1978371664,20992
1361557001,1978380984,33,1848,56,1361556972994,1361557000450,1978352978,1978380434,27456
1361557001,1978381024,7,849,121.2857143,1361556974424,1361556975000,1978354448,1978355024,576
1361557005,1978384992,32,1792,56,1361556977146,1361557004730,1978357138,1978384722,27584
1361557005,1978385116,10,2011,201.1,1361556979134,1361556979710,1978359250,1978359826,576
1361557017,1978397084,67,3752,56,1361556989019,1361557016731,1978369103,1978396815,27712
1361557017,1978397088,64,6144,96,1361556989146,1361557016474,1978369234,1978396562,27328
1361557021,1978401092,2,192,96,1361556995542,1361556999958,1978375634,1978380050,4416
1361557029,1978409044,28,1568,56,1361557001157,1361557028741,1978381201,1978408785,27584
1361557033,1978413172,24,1344,56,1361557005253,1361557032005,1978385425,1978412177,26752
1361557040,1978419316,1040,1494968,1437.469231,1361556971547,1361557034715,1978350863,1978414031,63168
1361557041,1978421140,32,3072,96,1361557016804,1361557040484,1978396944,1978420624,23680
1361557041,1978421184,3,491,163.6666667,1361557013816,1361557014072,1978394000,1978394256,256
1361557045,1978425148,36,2016,56,1361557017116,1361557044508,1978397264,1978424656,27392
1361557049,1978429136,1,64,64,1361557022439,1361557022439,1978402575,1978402575,0
1361557057,1978437084,18,1008,56,1361557031068,1361557056796,1978411152,1978436880,25728
1361557057,1978437248,8,3086,385.75,1361557030649,1361557039929,1978410897,1978420177,9280
1361557061,1978441088,19,1064,56,1361557032984,1361557060760,1978413072,1978440848,27776
1361557069,1978449224,43,4128,96,1361557040786,1361557068498,1978421010,1978448722,27712
1361557073,1978453104,48,2688,56,1361557045000,1361557072584,1978425104,1978452688,27584
1361557077,1978457180,2,128,64,1361557049533,1361557076541,1978429713,1978456721,27008
1361557081,1978461204,3,491,163.6666667,1361557053925,1361557054053,1978434129,1978434257,128
1361557085,1978465176,27,1512,56,1361557058112,1361557084352,1978438288,1978464528,26240
1361557089,1978469120,25,1400,56,1361557061688,1361557088312,1978441808,1978468432,26624
1361557096,1978475444,3,138,46,1361557091163,1361557091227,1978470607,1978470671,64
1361557097,1978477176,49,4704,96,1361557068864,1361557096512,1978449040,1978476688,27648
1361557097,1978477256,38,2128,56,1361557072753,1361557096689,1978453009,1978476945,23936
1361557104,1978483468,8,399,49.875,1361557100611,1361557100995,1978480079,1978480463,384
1361557112,1978491388,3,138,46,1361557108181,1361557108309,1978487569,1978487697,128
1361557113,1978493240,27,1512,56,1361557085119,1361557112703,1978465359,1978492943,27584
1361557117,1978497140,31,1736,56,1361557089059,1361557116451,1978469199,1978496591,27392
1361557121,1978501196,3,491,163.6666667,1361557094123,1361557094315,1978474319,1978474511,192
1361557125,1978505184,64,6144,96,1361557096822,1361557124662,1978477006,1978504846,27840
1361557125,1978505276,61,3416,56,1361557097050,1361557124506,1978477326,1978504782,27456
1361557126,1978505356,10,4463,446.3,1361557101237,1361557101813,1978480593,1978481169,576
1361557129,1978509252,1,64,64,1361557103541,1361557103541,1978483793,1978483793,0
1361557142,1978521520,30,1680,56,1361557114446,1361557141262,1978493966,1978520782,26816
1361557146,1978525440,31,1736,56,1361557118048,1361557145888,1978497488,1978525328,27840
1361557150,1978529436,52,4992,96,1361557125794,1361557149666,1978505230,1978529102,23872
1361557150,1978529520,53,2968,56,1361557125647,1361557149455,1978505167,1978528975,23808
1361557158,1978537528,1,64,64,1361557131335,1361557131335,1978510863,1978510863,0
1361557162,1978541568,3,491,163.6666667,1361557134622,1361557134878,1978514190,1978514446,256
1361557168,1978547488,10,491,49.1,1361557161456,1361557162032,1978540944,1978541520,576
1361557170,1978549536,30,1680,56,1361557142013,1361557169533,1978521549,1978549069,27520
1361557174,1978553536,30,1680,56,1361557146687,1361557173247,1978526223,1978552783,26560
1361557178,1978557468,65,3640,56,1361557149892,1361557177604,1978529360,1978557072,27712
1361557178,1978557544,63,6048,96,1361557149878,1361557177590,1978529422,1978557134,27712
1361557186,1978565656,2,128,64,1361557158343,1361557185287,1978537999,1978564943,26944
1361557190,1978569516,9,1918,213.1111111,1361557162001,1361557162577,1978541517,1978542093,576
1361557198,1978577532,26,1456,56,1361557170369,1361557197121,1978549901,1978576653,26752
1361557202,1978581560,3,491,163.6666667,1361557174440,1361557174632,1978554000,1978554192,192
1361557202,1978581632,36,3456,96,1361557177824,1361557201568,1978557456,1978581200,23744
1361557202,1978581636,24,1344,56,1361557174105,1361557201689,1978553741,1978581325,27584
1361557202,1978581704,37,2072,56,1361557177621,1361557201685,1978557325,1978581389,24064
1361557224,1978603556,9,445,49.44444444,1361557221419,1361557222635,1978600975,1978602191,1216
1361557226,1978605620,19,1064,56,1361557197992,1361557225320,1978577612,1978604940,27328
1361557230,1978609564,39,3744,96,1361557201954,1361557229794,1978581518,1978609358,27840
1361557230,1978609648,37,2072,56,1361557202125,1361557229645,1978581773,1978609293,27520
1361557230,1978609696,19,1064,56,1361557204316,1361557229532,1978584012,1978609228,25216
1361557238,1978617656,1,64,64,1361557212422,1361557212422,1978592078,1978592078,0
1361557242,1978621692,3,491,163.6666667,1361557214242,1361557214370,1978593934,1978594062,128
1361557250,1978629680,12,4555,379.5833333,1361557222508,1361557222828,1978602188,1978602508,320
1361557254,1978633660,21,1176,56,1361557228355,1361557253763,1978608015,1978633423,25408
1361557258,1978637632,43,4128,96,1361557230046,1361557257310,1978609678,1978636942,27264
1361557258,1978637640,21,1176,56,1361557230230,1361557257110,1978609870,1978636750,26880
1361557258,1978637720,43,2408,56,1361557229893,1361557257605,1978609613,1978637325,27712
1361557266,1978645784,1,64,64,1361557239301,1361557239301,1978619085,1978619085,0
1361557282,1978661664,3,491,163.6666667,1361557254396,1361557254524,1978634060,1978634188,128
1361557282,1978661768,19,1064,56,1361557254358,1361557281302,1978634126,1978661070,26944
1361557286,1978665708,36,3456,96,1361557260435,1361557285139,1978640143,1978664847,24704
1361557286,1978665792,19,1064,56,1361557260604,1361557284924,1978640396,1978664716,24320
1361557286,1978665792,38,2128,56,1361557260667,1361557285499,1978640459,1978665291,24832
1361557288,1978667656,3,144,48,1361557275907,1361557281923,1978655563,1978661579,6016
1361557288,1978667660,2,98,49,1361557275907,1361557281859,1978655567,1978661519,5952
1361557288,1978667660,2,98,49,1361557275906,1361557281858,1978655566,1978661518,5952
1361557288,1978667668,10,491,49.1,1361557281786,1361557282938,1978661454,1978662606,1152
1361557294,1978673976,2,128,64,1361557266245,1361557293253,1978646221,1978673229,27008
1361557302,1978681892,7,1419,202.7142857,1361557274969,1361557275353,1978654861,1978655245,384
1361557310,1978689900,37,2072,56,1361557285840,1361557309328,1978665740,1978689228,23488
1361557310,1978689900,37,3552,96,1361557285839,1361557309455,1978665739,1978689355,23616
1361557310,1978689984,23,1288,56,1361557281851,1361557309115,1978661835,1978689099,27264
1361557310,1978689996,11,2057,187,1361557282610,1361557282802,1978662606,1978662798,192
1361557314,1978694032,21,1176,56,1361557286283,1361557313099,1978666315,1978693131,26816
1361557322,1978701936,3,491,163.6666667,1361557293998,1361557294126,1978673934,1978674062,128
1361557326,1978705964,2,192,96,1361557300047,1361557320335,1978680011,1978700299,20288
1361557338,1978717956,18,1008,56,1361557312151,1361557337559,1978692107,1978717515,25408
1361557338,1978718028,38,2128,56,1361557311887,1361557337615,1978691915,1978717643,25728
1361557338,1978718032,36,3456,96,1361557312011,1361557337675,1978692043,1978717707,25664
1361557342,1978722160,19,1064,56,1361557316620,1361557341004,1978696780,1978721164,24384
1361557344,1978723636,9,445,49.44444444,1361557342808,1361557343320,1978722444,1978722956,512
1361557362,1978742044,3,491,163.6666667,1361557334720,1361557334848,1978714764,1978714892,128
1361557366,1978746012,26,2496,96,1361557339935,1361557364575,1978719947,1978744587,24640
1361557366,1978746056,27,1512,56,1361557338099,1361557364915,1978718155,1978744971,26816
1361557366,1978746104,13,728,56,1361557340100,1361557364228,1978720204,1978744332,24128
1361557370,1978750032,10,2011,201.1,1361557342924,1361557343052,1978722956,1978723084,128
1361557370,1978750104,13,728,56,1361557342402,1361557368834,1978722506,1978748938,26432
1361557374,1978754092,1,64,64,1361557347217,1361557347217,1978727309,1978727309,0
1361557392,1978771776,3,138,46,1361557390796,1361557390924,1978770572,1978770700,128
1361557394,1978774140,28,2688,96,1361557366623,1361557393311,1978746763,1978773451,26688
1361557394,1978774144,14,784,56,1361557366812,1361557392924,1978746956,1978773068,26112
1361557394,1978774148,27,1512,56,1361557367126,1361557393046,1978747274,1978773194,25920
1361557398,1978778056,13,728,56,1361557372596,1361557396980,1978752652,1978777036,24384
1361557402,1978782028,2,128,64,1361557374415,1361557401423,1978754443,1978781451,27008
1361557402,1978782148,3,491,163.6666667,1361557374935,1361557375127,1978755083,1978755275,192
1361557408,1978787704,9,445,49.44444444,1361557402772,1361557403540,1978782476,1978783244,768
1361557422,1978802092,33,1848,56,1361557396369,1361557420753,1978776461,1978800845,24384
1361557422,1978802172,33,3168,96,1361557396351,1361557420735,1978776523,1978800907,24384
1361557422,1978802176,17,952,56,1361557396541,1361557420861,1978776717,1978801037,24320
1361557426,1978806172,17,952,56,1361557399168,1361557425344,1978779340,1978805516,26176
1361557430,1978810168,11,4509,409.9090909,1361557403075,1361557403267,1978783243,1978783435,192
1361557442,1978822196,3,491,163.6666667,1361557414760,1361557414888,1978794956,1978795084,128
1361557451,1978830344,32,1792,56,1361557424825,1361557449977,1978804169,1978829321,25152
1361557451,1978830416,14,784,56,1361557426802,1361557449842,1978806218,1978829258,23040
1361557451,1978830456,32,3072,96,1361557424844,1361557449932,1978804300,1978829388,25088
1361557451,1978830492,16,896,56,1361557425511,1361557449959,1978805003,1978829451,24448
1361557455,1978834452,1,64,64,1361557429133,1361557429133,1978808585,1978808585,0
1361557464,1978843756,7,353,50.42857143,1361557463071,1361557463711,1978842827,1978843467,640
1361557479,1978858356,44,2464,56,1361557451375,1361557477999,1978830731,1978857355,26624
1361557479,1978858388,22,1232,56,1361557453005,1361557478157,1978832393,1978857545,25152
1361557479,1978858444,44,4224,96,1361557451736,1361557477976,1978831180,1978857420,26240
1361557479,1978858472,22,1232,56,1361557452730,1361557477754,1978832202,1978857226,25024
1361557483,1978862424,1,64,64,1361557456172,1361557456172,1978835596,1978835596,0
1361557483,1978862496,3,491,163.6666667,1361557455522,1361557455650,1978835018,1978835146,128
1361557491,1978870516,9,1918,213.1111111,1361557464013,1361557464141,1978843529,1978843657,128
1361557499,1978878488,4,656,164,1361557472299,1361557472555,1978851787,1978852043,256
1361557507,1978886448,17,952,56,1361557481234,1361557505746,1978860682,1978885194,24512
1361557507,1978886496,35,1960,56,1361557479137,1361557505889,1978858633,1978885385,26752
1361557507,1978886500,35,3360,96,1361557479263,1361557505951,1978858763,1978885451,26688
1361557507,1978886520,17,952,56,1361557479627,1361557505419,1978859147,1978884939,25792
1361557511,1978890480,2,128,64,1361557483185,1361557510257,1978862665,1978889737,27072
1361557523,1978902452,3,491,163.6666667,1361557495822,1361557495950,1978875274,1978875402,128
1361557528,1978907824,7,353,50.42857143,1361557523032,1361557523928,1978902856,1978903752,896
1361557535,1978914428,24,1344,56,1361557508581,1361557534309,1978888009,1978913737,25728
1361557535,1978914536,48,2688,56,1361557508602,1361557534586,1978888138,1978914122,25984
1361557535,1978914536,48,4608,96,1361557508665,1361557534649,1978888201,1978914185,25984
1361557535,1978914536,24,1344,56,1361557508729,1361557534393,1978888265,1978913929,25664
1361557551,1978930460,11,2057,187,1361557524295,1361557524487,1978903755,1978903947,192
1361557559,1978938528,19,1064,56,1361557534786,1361557558402,1978914314,1978937930,23616
1361557563,1978942508,3,491,163.6666667,1361557535445,1361557535573,1978914953,1978915081,128
1361557563,1978942536,1,64,64,1361557537274,1361557537274,1978916810,1978916810,0
1361557563,1978942576,45,2520,56,1361557534867,1361557562387,1978914443,1978941963,27520
1361557563,1978942576,45,4320,96,1361557534929,1361557562769,1978914505,1978942345,27840
1361557563,1978942576,22,1232,56,1361557534992,1361557562000,1978914568,1978941576,27008
1361557584,1978963872,3,144,48,1361557576039,1361557581991,1978955911,1978961863,5952
1361557584,1978963872,2,98,49,1361557576039,1361557581991,1978955911,1978961863,5952
1361557584,1978963928,2,98,49,1361557575983,1361557581871,1978955911,1978961799,5888
1361557587,1978966524,22,1232,56,1361557559430,1361557586374,1978938954,1978965898,26944
1361557591,1978970548,1,64,64,1361557564270,1361557564270,1978943818,1978943818,0
1361557591,1978970572,41,3936,96,1361557564628,1361557590036,1978944200,1978969608,25408
1361557591,1978970624,21,1176,56,1361557563809,1361557589793,1978943433,1978969417,25984
1361557591,1978970652,41,2296,56,1361557564420,1361557589892,1978944072,1978969544,25472
1361557592,1978971972,9,445,49.44444444,1361557583875,1361557584067,1978963847,1978964039,192
1361557603,1978982548,11,7624,693.0909091,1361557576363,1361557576811,1978955911,1978956359,448
1361557603,1978982588,6,1558,259.6666667,1361557575811,1361557576003,1978955399,1978955591,192
1361557603,1978982624,11,6334,575.8181818,1361557576287,1361557576799,1978955911,1978956423,512
1361557603,1978982672,3,491,163.6666667,1361557575666,1361557575858,1978955338,1978955530,192
1361557611,1978990840,11,4509,409.9090909,1361557584200,1361557584392,1978964040,1978964232,192
1361557615,1978994864,32,1792,56,1361557590834,1361557614002,1978970698,1978993866,23168
1361557615,1978994900,18,1008,56,1361557588618,1361557613450,1978968518,1978993350,24832
1361557619,1978998904,19,1064,56,1361557591048,1361557618056,1978970952,1978997960,27008
1361557619,1978998988,39,3744,96,1361557590835,1361557618803,1978970823,1978998791,27968
1361557619,1978998988,3,256,85.33333333,1361557590898,1361557617970,1978970886,1978997958,27072
1361557643,1979022920,3,491,163.6666667,1361557615609,1361557615737,1978995529,1978995657,128
1361557643,1979022944,22,1232,56,1361557615839,1361557641759,1978995783,1979021703,25920
1361557643,1979022988,43,2408,56,1361557616180,1361557641844,1978996168,1979021832,25664
1361557647,1979027000,22,1232,56,1361557618919,1361557646375,1978998919,1979026375,27456
1361557647,1979027040,43,4128,96,1361557620544,1361557646528,1979000584,1979026568,25984
1361557648,1979027992,7,353,50.42857143,1361557643246,1361557644334,1979023238,1979024326,1088
1361557671,1979050980,9,1918,213.1111111,1361557644347,1361557644603,1979024327,1979024583,256
1361557671,1979051048,50,2800,56,1361557643447,1361557670519,1979023495,1979050567,27072
1361557671,1979051088,25,1400,56,1361557644560,1361557670352,1979024648,1979050440,25792
1361557671,1979051088,1,64,64,1361557644942,1361557644942,1979025030,1979025030,0
1361557675,1979055052,50,4800,96,1361557648308,1361557674228,1979028360,1979054280,25920
1361557675,1979055052,25,1400,56,1361557648434,1361557674034,1979028486,1979054086,25600
1361557683,1979063068,3,491,163.6666667,1361557654881,1361557655009,1979034949,1979035077,128
1361557696,1979076000,3,138,46,1361557690983,1361557691047,1979070983,1979071047,64
1361557699,1979079020,36,2016,56,1361557671761,1361557696529,1979051781,1979076549,24768
1361557699,1979079140,1,64,64,1361557671965,1361557671965,1979052105,1979052105,0
1361557699,1979079168,18,1008,56,1361557672384,1361557696320,1979052552,1979076488,23936
1361557703,1979083060,31,2976,96,1361557676457,1361557702569,1979056517,1979082629,26112
1361557703,1979083064,16,896,56,1361557676585,1361557700841,1979056649,1979080905,24256
1361557707,1979087080,3,138,46,1361557679193,1361557679193,1979059273,1979059273,0
1361557712,1979092036,8,399,49.875,1361557704195,1361557704707,1979084231,1979084743,512
1361557719,1979099276,2,92,46,1361557691604,1361557691668,1979071880,1979071944,64
1361557723,1979103088,3,491,163.6666667,1361557694800,1361557694992,1979074888,1979075080,192
1361557727,1979107012,2,128,64,1361557699161,1361557726169,1979079173,1979106181,27008
1361557727,1979107012,19,1064,56,1361557699161,1361557725593,1979079173,1979105605,26432
1361557727,1979107104,10,560,56,1361557700480,1361557726080,1979080584,1979106184,25600
1361557731,1979111012,8,448,56,1361557704473,1361557725401,1979084485,1979105413,20928
1361557731,1979111092,16,1536,96,1361557704138,1361557725706,1979084230,1979105798,21568
1361557731,1979111120,11,2010,182.7272727,1361557704622,1361557704942,1979084742,1979085062,320
1361557759,1979139188,1,56,56,1361557734636,1361557734636,1979114824,1979114824,0
1361557764,1979143348,1,96,96,1361557736176,1361557736176,1979115524,1979115524,0
1361557764,1979143352,1,56,56,1361557736300,1361557736300,1979115652,1979115652,0
1361557764,1979143444,3,491,163.6666667,1361557736084,1361557736212,1979115528,1979115656,128
1361557768,1979148040,6,307,51.16666667,1361557764158,1361557765118,1979144198,1979145158,960
1361557780,1979159376,1,64,64,1361557753879,1361557753879,1979133255,1979133255,0
1361557792,1979171452,11,4509,409.9090909,1361557765768,1361557765896,1979145220,1979145348,128
1361557792,1979172140,6,497,82.83333333,1361557788057,1361557790169,1979168197,1979170309,2112
1361557792,1979172184,201157,300466096,1493.689486,1361556675630,1361557784366,1978055814,1979164550,1108736
1361557800,1979179532,3,491,163.6666667,1361557775546,1361557775674,1979155078,1979155206,128
1361557808,1979187452,2,288,144,1361557780874,1361557789130,1979160326,1979168582,8256
1361557816,1979195388,1,46,46,1361557788807,1361557788807,1979168195,1979168195,0
1361557832,1979212104,7,353,50.42857143,1361557824443,1361557825339,1979204547,1979205443,896
1361557840,1979219504,3,491,163.6666667,1361557815507,1361557815635,1979195011,1979195139,128
1361557844,1979223564,2,128,64,1361557816281,1361557843289,1979195845,1979222853,27008
1361557852,1979231496,10,1964,196.4,1361557826014,1361557826142,1979205510,1979205638,128
1361557884,1979263504,3,491,163.6666667,1361557855829,1361557856021,1979235333,1979235525,192
1361557889,1979268568,2,98,49,1361557876949,1361557882325,1979256517,1979261893,5376
1361557889,1979268568,3,144,48,1361557876949,1361557882389,1979256517,1979261957,5440
1361557889,1979268568,2,98,49,1361557876947,1361557882387,1979256515,1979261955,5440
1361557889,1979268568,2,98,49,1361557876947,1361557882323,1979256515,1979261891,5376
1361557889,1979268596,9,445,49.44444444,1361557885945,1361557886201,1979265541,1979265797,256
1361557896,1979275612,1,64,64,1361557870377,1361557870377,1979249989,1979249989,0
1361557904,1979283496,8,1539,192.375,1361557876125,1361557876701,1979255621,1979256197,576
1361557912,1979291560,9,1918,213.1111111,1361557886236,1361557886364,1979265796,1979265924,128
1361557920,1979299812,3,491,163.6666667,1361557895584,1361557895712,1979275396,1979275524,128
1361557924,1979303940,2,192,96,1361557897057,1361557900065,1979276997,1979280005,3008
1361557943,617636920,3,144,48,1361557931049,1361557936617,617624969,617630537,5568
1361557945,1979324532,6,282,47,1361557939381,1361557944821,1979318913,1979324353,5440
1361557952,1979331856,2,128,64,1361557924212,1361557951284,1979304068,1979331140,27072
1361557952,1979331936,26,12224,470.1538462,1361557927714,1361557938146,1979307650,1979318082,10432
1361557956,1979335852,38,2128,56,1361557929014,1361557955638,1979308866,1979335490,26624
1361557956,1979335932,39,3744,96,1361557929063,1361557955623,1979308995,1979335555,26560
1361557956,1979335980,20,1120,56,1361557931127,1361557955767,1979311107,1979335747,24640
1361557960,1979340008,3,491,163.6666667,1361557934939,1361557935067,1979314947,1979315075,128
1361557960,1979340016,23,1288,56,1361557935188,1361557959316,1979315204,1979339332,24128
1361557961,1979340536,13,5722,440.1538462,1361557954676,1361557955572,1979334212,1979335108,896
1361557961,1979340544,19,12239,644.1578947,1361557955564,1361557956780,1979335108,1979336324,1216
1361557961,1979340580,17,7802,458.9411765,1361557956805,1361557957189,1979336385,1979336769,384
1361557961,1979340588,11,5775,525,1361557954366,1361557960446,1979333954,1979340034,6080
1361557964,1979343900,58,66964,1154.551724,1361557938824,1361557944392,1979318724,1979324292,5568
1361557964,1979343980,38,14580,383.6842105,1361557938040,1361557939896,1979318020,1979319876,1856
1361557965,617658188,46,60246,1309.695652,1361557937604,1361557937860,617630792,617631048,256
1361557968,1979347880,5,668,133.6,1361557940572,1361557940764,1979320452,1979320644,192
1361557969,1979348520,11,4969,451.7272727,1361557956866,1361557962434,1979336386,1979341954,5568
1361557969,1979348528,11,4943,449.3636364,1361557957308,1361557962428,1979336836,1979341956,5120
1361557969,1979348564,5,352,70.4,1361557959254,1361557964374,1979338818,1979343938,5120
1361557969,1979348596,10,4897,489.7,1361557957237,1361557962357,1979336833,1979341953,5120
1361557969,1979348644,9,2728,303.1111111,1361557959173,1361557964293,1979338817,1979343937,5120
1361557969,1979348644,5,352,70.4,1361557959173,1361557964293,1979338817,1979343937,5120
1361557969,1979348644,10,2356,235.6,1361557959237,1361557965317,1979338881,1979344961,6080
1361557969,1979348644,7,444,63.42857143,1361557959173,1361557965509,1979338817,1979345153,6336
1361557980,1979359924,19,10202,536.9473684,1361557954031,1361557957167,1979333955,1979337091,3136
1361557980,1979359964,7,2656,379.4285714,1361557955656,1361557956040,1979335620,1979336004,384
1361557980,1979359972,2,558,279,1361557952189,1361557952381,1979332161,1979332353,192
1361557980,1979360012,19,7648,402.5263158,1361557954518,1361557956246,1979334530,1979336258,1728
1361557984,1979363916,46,44032,957.2173913,1361557957496,1361557967608,1979337412,1979347524,10112
1361557984,1979363932,25,17136,685.44,1361557958887,1361557963111,1979338819,1979343043,4224
1361557984,1979364048,60,3360,56,1361557955892,1361557983156,1979335940,1979363204,27264
1361557984,1979364048,60,5760,96,1361557955956,1361557983540,1979336004,1979363588,27584
1361557984,1979364056,30,1680,56,1361557956842,1361557983082,1979336898,1979363138,26240
1361557984,1979364084,13,7894,607.2307692,1361557957068,1361557957260,1979337152,1979337344,192
1361557984,1979364100,95,78351,824.7473684,1361557958719,1361557967359,1979338819,1979347459,8640
1361557988,1979367996,32,1792,56,1361557960488,1361557987368,1979340484,1979367364,26880
1361558000,1979380000,3,491,163.6666667,1361557974944,1361557975072,1979354944,1979355072,128
1361558001,1979380648,8,399,49.875,1361557999875,1361558000323,1979379523,1979379971,448
1361558004,1979383988,1,64,64,1361557978224,1361557978224,1979358212,1979358212,0
1361558008,1979388048,17,16274,957.2941176,1361557983282,1361557983474,1979363330,1979363522,192
1361558008,1979388160,4,1413,353.25,1361557983105,1361557983169,1979363265,1979363329,64
1361558009,1979388532,4,184,46,1361558004790,1361558004854,1979384322,1979384386,64
1361558009,1979388624,4,215,53.75,1361557997721,1361558002777,1979377345,1979382401,5056
1361558012,1979391952,68,3808,56,1361557983827,1361558011731,1979363779,1979391683,27904
1361558012,1979392076,67,6432,96,1361557983832,1361558011672,1979363908,1979391748,27840
1361558012,1979392080,33,1848,56,1361557984020,1361558011476,1979364100,1979391556,27456
1361558016,1979395960,34,1904,56,1361557988233,1361558015817,1979368193,1979395777,27584
1361558028,1979408088,3,138,46,1361558000267,1361558000331,1979380355,1979380419,64
1361558028,1979408252,24,6560,273.3333333,1361557999784,1361558000680,1979380036,1979380932,896
1361558032,1979412088,1,64,64,1361558005130,1361558005130,1979385218,1979385218,0
1361558040,1979420044,74,7104,96,1361558012021,1361558039541,1979392065,1979419585,27520
1361558040,1979420284,3,491,163.6666667,1361558014791,1361558014983,1979395075,1979395267,192
1361558041,1979420336,74,4144,56,1361558012667,1361558040507,1979392003,1979419843,27840
1361558041,1979420360,37,2072,56,1361558012897,1361558040097,1979392257,1979419457,27200
1361558041,1979420640,6,498,83,1361558029576,1361558033672,1979409216,1979413312,4096
1361558044,1979424056,37,2072,56,1361558016552,1361558043240,1979396608,1979423296,26688
1361558047,617740940,148,198973,1344.412162,1361557928276,1361558044244,617622216,617738184,115968
1361558056,1979436084,1,46,46,1361558029134,1361558029134,1979409218,1979409218,0
1361558060,1979440244,2,128,64,1361558032108,1361558059116,1979412352,1979439360,27008
1361558068,1979448048,72,6912,96,1361558039922,1361558067570,1979419970,1979447618,27648
1361558068,1979448216,1,46,46,1361558043079,1361558043079,1979423295,1979423295,0
1361558068,1979448256,36,2016,56,1361558040031,1361558067231,1979420287,1979447487,27200
1361558068,1979448256,72,4032,56,1361558040095,1361558067615,1979420351,1979447871,27520
1361558071,617764944,661,901137,1363.293495,1361557950801,1361558068241,617644745,617762185,117440
1361558072,1979452252,36,2016,56,1361558043875,1361558071395,1979424127,1979451647,27520
1361558073,1979452416,2,120,60,1361558048488,1361558049448,1979427904,1979428864,960
1361558073,1979452576,3,138,46,1361558068746,1361558068810,1979448322,1979448386,64
1361558073,1979452580,3,138,46,1361558072707,1361558072771,1979452287,1979452351,64
1361558077,617770448,2,92,46,1361558052673,1361558052737,617746121,617746185,64
1361558081,1979460744,3,491,163.6666667,1361558055715,1361558055843,1979435459,1979435587,128
1361558081,1979460804,3,138,46,1361558073511,1361558073575,1979453315,1979453379,64
1361558081,1979460960,2,92,46,1361558078408,1361558078408,1979458368,1979458368,0
1361558089,1979468280,4,1543,385.75,1361558061168,1361558061232,1979440448,1979440512,64
1361558089,1979468644,2,92,46,1361558083718,1361558083718,1979463362,1979463362,0
1361558089,1979468692,2,92,46,1361558083668,1361558083668,1979463360,1979463360,0
1361558093,1979472400,63,6048,96,1361558068600,1361558092536,1979448000,1979471936,23936
1361558097,1979476336,37,2072,56,1361558068791,1361558096695,1979448127,1979476031,27904
1361558097,1979476432,1,46,46,1361558071960,1361558071960,1979451392,1979451392,0
1361558097,1979476464,73,4088,56,1361558068729,1361558096633,1979448193,1979476097,27904
1361558097,1979476632,1,46,46,1361558071761,1361558071761,1979451393,1979451393,0
1361558101,1979480380,35,1960,56,1361558073165,1361558100685,1979452545,1979480065,27520
1361558111,617804956,2,98,49,1361558099651,1361558104707,617793607,617798663,5056
1361558111,617804976,4,190,47.5,1361558099632,1361558104688,617793608,617798664,5056
1361558113,1979492848,3,144,48,1361558099898,1361558105978,1979479746,1979485826,6080
1361558117,1979496428,2,128,64,1361558090077,1361558114077,1979469505,1979493505,24000
1361558117,1979496564,58,5568,96,1361558092630,1361558116438,1979472194,1979496002,23808
1361558121,1979500476,34,37012,1088.588235,1361558095915,1361558099371,1979475391,1979478847,3456
1361558121,1979500584,3,491,163.6666667,1361558095298,1361558095426,1979474882,1979475010,128
1361558121,1979500860,7,353,50.42857143,1361558119726,1361558120750,1979499586,1979500610,1024
1361558125,1979504536,23,27280,1186.086957,1361558098415,1361558098927,1979477951,1979478463,512
1361558125,1979504540,15,10712,714.1333333,1361558098413,1361558100013,1979477953,1979479553,1600
1361558125,1979504540,28,35133,1254.75,1361558098413,1361558098733,1979477953,1979478273,320
1361558125,1979504600,1,46,46,1361558099824,1361558099824,1979479424,1979479424,0
1361558125,617818512,22,22848,1038.545455,1361558098303,1361558100159,617791815,617793671,1856
1361558125,1979504660,33,1848,56,1361558097011,1361558124147,1979476671,1979503807,27136
1361558125,1979504664,67,3752,56,1361558096754,1361558124530,1979476418,1979504194,27776
1361558125,1979504720,12,9219,768.25,1361558098233,1361558099897,1979477953,1979479617,1664
1361558125,1979504720,10,6474,647.4,1361558098232,1361558099576,1979477952,1979479296,1344
1361558125,1979504720,8,5828,728.5,1361558098232,1361558099640,1979477952,1979479360,1408
1361558125,1979504720,10,7333,733.3,1361558098232,1361558099768,1979477952,1979479488,1536
1361558125,1979504720,24,29640,1235,1361558098296,1361558099000,1979478016,1979478720,704
1361558125,1979504764,1,46,46,1361558099659,1361558099659,1979479423,1979479423,0
1361558129,1979508548,35,1960,56,1361558101348,1361558128164,1979480896,1979507712,26816
1361558129,1979508752,2,92,46,1361558120983,1361558120983,1979500735,1979500735,0
1361558145,1979524444,74,7104,96,1361558116938,1361558144586,1979496382,1979524030,27648
1361558149,1979528444,10,2011,201.1,1361558121292,1361558121676,1979500736,1979501120,384
1361558149,1979528456,1,74,74,1361558121984,1361558121984,1979501440,1979501440,0
1361558153,1979532448,76,4256,56,1361558125065,1361558152329,1979504513,1979531777,27264
1361558153,1979532560,39,2184,56,1361558124888,1361558152536,1979504448,1979532096,27648
1361558157,1979536528,38,2128,56,1361558128822,1361558156086,1979508350,1979535614,27264
1361558161,1979540536,4,543,135.75,1361558135790,1361558135918,1979515326,1979515454,128
1361558169,1979548608,3,368,122.6666667,1361558140969,1361558167977,1979520577,1979547585,27008
1361558169,1979548836,65,6240,96,1361558144451,1361558168515,1979524287,1979548351,24064
1361558177,1979556604,1,46,46,1361558149418,1361558149418,1979529022,1979529022,0
1361558181,1979560496,38,2128,56,1361558153625,1361558180761,1979533121,1979560257,27136
1361558181,1979560596,77,4312,56,1361558152821,1361558180725,1979532417,1979560321,27904
1361558185,1979564604,39,2184,56,1361558156842,1361558184554,1979536446,1979564158,27712
1361558185,1979564820,9,445,49.44444444,1361558180757,1361558181397,1979560577,1979561217,640
1361558197,1979576468,74,7104,96,1361558169269,1361558196853,1979548737,1979576321,27584
1361558201,1979580616,4,543,135.75,1361558175905,1361558176033,1979555521,1979555649,128
1361558205,1979584456,8,1638,204.75,1361558177277,1361558177533,1979556733,1979556989,256
1361558209,1979588476,73,4088,56,1361558181228,1361558208620,1979560704,1979588096,27392
1361558209,1979588476,36,2016,56,1361558181482,1361558208234,1979560958,1979587710,26752
1361558209,1979588480,12,4602,383.5,1361558181736,1361558181928,1979561216,1979561408,192
1361558213,1979592532,36,2016,56,1361558185267,1361558212275,1979564799,1979591807,27008
1361558217,1979596844,3,138,46,1361558213946,1361558214010,1979593790,1979593854,64
1361558217,1979596844,3,138,46,1361558214010,1361558214010,1979593854,1979593854,0
1361558217,1979596924,2,92,46,1361558213869,1361558213869,1979593793,1979593793,0
1361558221,1979600624,3,256,85.33333333,1361558195096,1361558200408,1979574720,1979580032,5312
1361558225,1979604464,76,7296,96,1361558197302,1361558224758,1979576766,1979604222,27456
1361558233,1979612692,32,1792,56,1361558208660,1361558232148,1979588352,1979611840,23488
1361558233,1979612692,63,3528,56,1361558208786,1361558232658,1979588478,1979612350,23872
1361558237,1979616708,33,1848,56,1361558212738,1361558236674,1979592446,1979616382,23936
1361558241,617934540,2,92,46,1361558216103,1361558216103,617909643,617909643,0
1361558241,1979620748,1,46,46,1361558215068,1361558215068,1979594816,1979594816,0
1361558241,1979620748,1,46,46,1361558215067,1361558215067,1979594815,1979594815,0
1361558241,1979620836,1,46,46,1361558214980,1361558214980,1979594816,1979594816,0
1361558241,1979620836,1,46,46,1361558214980,1361558214980,1979594816,1979594816,0
1361558241,1979620836,2,92,46,1361558214979,1361558214979,1979594815,1979594815,0
1361558241,1979620864,3,491,163.6666667,1361558215589,1361558215717,1979595453,1979595581,128
1361558245,1979624840,1,46,46,1361558219136,1361558219136,1979598976,1979598976,0
1361558249,1979628696,50,4800,96,1361558224845,1361558248717,1979604541,1979628413,23872
1361558249,1979628700,1,46,46,1361558221193,1361558221193,1979600893,1979600893,0
1361558249,1979628712,1,64,64,1361558222014,1361558222014,1979601726,1979601726,0
1361558249,1979628784,1,46,46,1361558224248,1361558224248,1979604032,1979604032,0
1361558249,1979629180,14,786,56.14285714,1361558240299,1361558242283,1979620479,1979622463,1984
1361558261,1979640700,29,1624,56,1361558232908,1361558260300,1979612608,1979640000,27392
1361558261,1979640784,57,3192,56,1361558232952,1361558260728,1979612736,1979640512,27776
1361558265,1979644784,27,1512,56,1361558237238,1361558264630,1979617022,1979644414,27392
1361558269,1979648824,9,1918,213.1111111,1361558242638,1361558242958,1979622462,1979622782,320
1361558277,1979656728,2,288,144,1361558249068,1361558270636,1979628796,1979650364,21568
1361558277,1979656732,66,6336,96,1361558249068,1361558276652,1979628800,1979656384,27584
1361558281,1979660820,6,1485,247.5,1361558255314,1361558266578,1979635134,1979646398,11264
1361558289,1979668728,65,3640,56,1361558261164,1361558288556,1979640892,1979668284,27392
1361558289,1979668816,34,1904,56,1361558260951,1361558288343,1979640767,1979668159,27392
1361558293,1979672732,33,1848,56,1361558265321,1361558292329,1979645053,1979672061,27008
1361558293,1979672768,6,968,161.3333333,1361558266760,1361558266888,1979646528,1979646656,128
1361558293,1979672772,5,2897,579.4,1361558266883,1361558267139,1979646655,1979646911,256
1361558305,1979684784,1,64,64,1361558279861,1361558279861,1979659645,1979659645,0
1361558305,1979684820,63,6048,96,1361558277011,1361558304787,1979656831,1979684607,27776
1361558305,1979685116,8,399,49.875,1361558302379,1361558302763,1979682495,1979682879,384
1361558317,1979696752,32,1792,56,1361558289236,1361558316372,1979668988,1979696124,27136
1361558317,1979696844,65,3640,56,1361558288890,1361558316794,1979668734,1979696638,27904
1361558321,1979700928,33,1848,56,1361558293158,1361558319910,1979673086,1979699838,26752
1361558329,1979708876,16,3646,227.875,1361558303000,1361558323672,1979682876,1979703548,20672
1361558333,1979712840,65,6240,96,1361558305213,1361558332669,1979685053,1979712509,27456
1361558333,1979712880,3,491,163.6666667,1361558306325,1361558306645,1979686205,1979686525,320
1361558333,1979712884,1,64,64,1361558306770,1361558306770,1979686654,1979686654,0
1361558345,1979724756,32,1792,56,1361558317138,1361558344722,1979696894,1979724478,27584
1361558345,1979724756,65,3640,56,1361558317264,1361558344784,1979697020,1979724540,27520
1361558349,1979728764,34,1904,56,1361558320906,1361558348170,1979700670,1979727934,27264
1361558361,1979740772,66,6336,96,1361558333055,1361558360575,1979712827,1979740347,27520
1361558361,1979740888,1,64,64,1361558333838,1361558333838,1979713726,1979713726,0
1361558373,1979752776,64,3584,56,1361558345150,1361558372606,1979724926,1979752382,27456
1361558373,1979752780,32,1792,56,1361558345400,1361558372536,1979725180,1979752316,27136
1361558373,1979752788,6,1435,239.1666667,1361558346671,1361558357935,1979726459,1979737723,11264
1361558377,1979756888,33,1848,56,1361558348813,1361558376845,1979728701,1979756733,28032
1361558385,1979764988,55,5280,96,1361558360681,1361558384617,1979740669,1979764605,23936
1361558385,1979765252,3,138,46,1361558381537,1361558381665,1979761789,1979761917,128
1361558389,1979769140,2,128,64,1361558360656,1361558387728,1979740796,1979767868,27072
1361558389,1979769192,5,1636,327.2,1361558363358,1361558363422,1979743550,1979743614,64
1361558398,1979777300,55,3080,56,1361558373529,1361558397785,1979752829,1979777085,24256
1361558398,1979777304,27,1512,56,1361558373780,1361558397332,1979753084,1979776636,23552
1361558405,1979785256,32,1792,56,1361558377306,1361558404698,1979757562,1979784954,27392
1361558410,1979789380,2,92,46,1361558383369,1361558383433,1979762749,1979762813,64
1361558414,1979793336,69,6624,96,1361558385846,1361558413302,1979765182,1979792638,27456
1361558422,1979801456,6,982,163.6666667,1361558397565,1361558398397,1979777021,1979777853,832
1361558425,1979805168,7,353,50.42857143,1361558423285,1361558423541,1979803453,1979803709,256
1361558426,1979805360,35,1960,56,1361558398044,1361558425116,1979777404,1979804476,27072
1361558426,1979805360,70,3920,56,1361558398108,1361558425564,1979777468,1979804924,27456
1361558434,1979813432,35,1960,56,1361558406166,1361558433430,1979785598,1979812862,27264
1361558438,1979817420,60,5760,96,1361558413792,1361558437728,1979793212,1979817148,23936
1361558442,1979821400,1,64,64,1361558415475,1361558415475,1979794875,1979794875,0
1361558450,1979829452,31,1736,56,1361558425793,1361558449665,1979805245,1979829117,23872
1361558450,1979829500,17,6191,364.1764706,1361558424271,1361558425871,1979803771,1979805371,1600
1361558454,1979833464,71,3976,56,1361558425971,1361558453683,1979805435,1979833147,27712
1361558458,1979837512,4,656,164,1361558433349,1361558433797,1979812861,1979813309,448
1361558462,1979841480,36,2016,56,1361558434339,1361558461667,1979813819,1979841147,27328
1361558466,1979845440,71,6816,96,1361558438027,1361558465547,1979817467,1979844987,27520
1361558466,1979845520,3,491,163.6666667,1361558438266,1361558438394,1979817786,1979817914,128
1361558470,1979849484,2,128,64,1361558442462,1361558469534,1979821946,1979849018,27072
1361558478,1979857508,36,2016,56,1361558450503,1361558477255,1979830011,1979856763,26752
1361558482,1979861408,69,3864,56,1361558454057,1361558481577,1979833465,1979860985,27520
1361558489,1979869164,4,190,47.5,1361558477624,1361558483704,1979857788,1979863868,6080
1361558489,1979869216,3,144,48,1361558477572,1361558483652,1979857788,1979863868,6080
1361558490,1979869404,31,1736,56,1361558462575,1361558489839,1979841979,1979869243,27264
1361558494,1979873496,56,5376,96,1361558465813,1361558491029,1979845309,1979870525,25216
1361558502,1979881508,7,1405,200.7142857,1361558477574,1361558477958,1979857082,1979857466,384
1361558506,1979885428,34,1904,56,1361558481880,1361558505752,1979861308,1979885180,23872
1361558506,1979885432,21,1176,56,1361558478036,1361558505620,1979857468,1979885052,27584
1361558506,1979885436,5,2829,565.8,1361558478352,1361558478544,1979857788,1979857980,192
1361558506,1979885436,3,491,163.6666667,1361558478542,1361558478734,1979857978,1979858170,192
1361558510,1979889556,5,1636,327.2,1361558484566,1361558484630,1979864122,1979864186,64
1361558518,1979897444,20,1120,56,1361558490504,1361558516680,1979869948,1979896124,26176
1361558522,1979901484,41,3936,96,1361558493856,1361558521696,1979873340,1979901180,27840
1361558522,1979901648,2,192,96,1361558496443,1361558500411,1979876091,1979880059,3968
1361558534,1979913452,18,1008,56,1361558506365,1361558532477,1979885817,1979911929,26112
1361558534,1979913536,36,2016,56,1361558506028,1361558532460,1979885564,1979911996,26432
1361558546,1979925692,9,445,49.44444444,1361558543693,1361558544653,1979923385,1979924345,960
1361558546,1979925760,2,445,222.5,1361558518601,1361558518857,1979898361,1979898617,256
1361558546,1979925840,16,896,56,1361558518074,1361558545210,1979897914,1979925050,27136
1361558550,1979929648,33,3168,96,1361558522043,1361558549819,1979901691,1979929467,27776
1361558550,1979929760,2,304,152,1361558523402,1361558526858,1979903162,1979906618,3456
1361558558,1979937796,27,1512,56,1361558533606,1361558557478,1979913402,1979937274,23872
1361558562,1979941660,15,840,56,1361558534127,1361558561199,1979913787,1979940859,27072
1361558570,1979949796,12,4602,383.5,1361558544549,1361558544741,1979924345,1979924537,192
1361558574,1979953772,14,784,56,1361558546109,1361558573181,1979925881,1979952953,27072
1361558578,1979957704,2,128,64,1361558550529,1361558577537,1979930233,1979957241,27008
1361558578,1979957784,28,2688,96,1361558550194,1361558577714,1979929978,1979957498,27520
1361558586,1979965820,40,2240,56,1361558557966,1361558585614,1979937786,1979965434,27648
1361558586,1979965820,3,491,163.6666667,1361558558156,1361558558348,1979937976,1979938168,192
1361558590,1979969808,23,1288,56,1361558562009,1361558589657,1979941817,1979969465,27648
1361558594,1979973508,3,138,46,1361558593414,1361558593606,1979972922,1979973114,192
1361558598,1979977748,3,138,46,1361558570519,1361558570519,1979950267,1979950267,0
1361558602,1979981832,28,1568,56,1361558573953,1361558601601,1979953785,1979981433,27648
1361558606,1979985776,56,5376,96,1361558578106,1361558605626,1979957882,1979985402,27520
1361558610,1979989416,9,445,49.44444444,1361558605026,1361558605218,1979984442,1979984634,192
1361558614,1979993772,49,2744,56,1361558586044,1361558613820,1979965816,1979993592,27776
1361558618,1979997788,22,1232,56,1361558590639,1361558617199,1979970427,1979996987,26560
1361558626,1980005864,3,491,163.6666667,1361558598178,1361558598306,1979978042,1979978170,128
1361558630,1980009828,1,64,64,1361558604486,1361558604486,1979984314,1979984314,0
1361558630,1980009868,18,1008,56,1361558602269,1361558628957,1979982137,1980008825,26688
1361558630,1980009916,10,1964,196.4,1361558604717,1361558604845,1979984633,1979984761,128
1361558634,1980013800,35,3360,96,1361558605923,1361558633507,1979985723,1980013307,27584
1361558642,1980021868,36,2016,56,1361558614109,1361558641693,1979993977,1980021561,27584
1361558646,1980025792,21,1176,56,1361558618282,1361558645354,1979998074,1980025146,27072
1361558658,1980037784,24,1344,56,1361558630129,1361558654833,1980009913,1980034617,24704
1361558658,1980037912,1,64,64,1361558631473,1361558631473,1980011385,1980011385,0
1361558662,1980041884,51,4896,96,1361558633932,1361558661580,1980013816,1980041464,27648
1361558666,1980045580,7,353,50.42857143,1361558664827,1361558665275,1980044407,1980044855,448
1361558666,1980045900,3,491,163.6666667,1361558638270,1361558638526,1980018170,1980018426,256
1361558670,1980049820,49,2744,56,1361558642126,1361558669774,1980021946,1980049594,27648
1361558674,1980053912,22,1232,56,1361558646064,1361558673072,1980025976,1980052984,27008
1361558686,1980065824,23,1288,56,1361558657929,1361558685705,1980037753,1980065529,27776
1361558686,1980065832,2,128,64,1361558658624,1361558685696,1980038456,1980065528,27072
1361558690,1980069836,44,4224,96,1361558662076,1361558688124,1980041912,1980067960,26048
1361558690,1980069992,12,4555,379.5833333,1361558664992,1361558665696,1980044984,1980045688,704
1361558698,1980077964,45,2520,56,1361558669884,1361558697532,1980049848,1980077496,27648
1361558698,1980077968,1,46,46,1361558673655,1361558673655,1980053623,1980053623,0
1361558702,1980082076,23,1288,56,1361558673802,1361558701642,1980053878,1980081718,27840
1361558706,1980086068,3,491,163.6666667,1361558678164,1361558678356,1980058232,1980058424,192
1361558714,1980094084,41,3936,96,1361558689669,1361558713861,1980069753,1980093945,24192
1361558714,1980094092,23,1288,56,1361558686330,1361558713594,1980066422,1980093686,27264
1361558722,1980102076,35,1960,56,1361558697803,1361558721739,1980077879,1980101815,23936
1361558730,1980109592,10,491,49.1,1361558725873,1361558726193,1980105465,1980105785,320
1361558730,1980110220,20,1120,56,1361558702458,1361558729530,1980082678,1980109750,27072
1361558738,1980118160,1,64,64,1361558712439,1361558712439,1980092599,1980092599,0
1361558742,1980122116,40,3840,96,1361558714149,1361558741669,1980094265,1980121785,27520
1361558742,1980122116,20,1120,56,1361558714275,1361558741475,1980094391,1980121591,27200
1361558746,1980126184,3,491,163.6666667,1361558717855,1361558717983,1980098039,1980098167,128
1361558750,1980130132,46,2576,56,1361558722003,1361558749843,1980102135,1980129975,27840
1361558750,1980130216,13,2161,166.2307692,1361558725569,1361558726273,1980105785,1980106489,704
1361558758,1980138128,25,1400,56,1361558730328,1361558757592,1980110456,1980137720,27264
1361558766,1980146140,1,64,64,1361558739532,1361558739532,1980119672,1980119672,0
1361558770,1980150232,53,5088,96,1361558741871,1361558769775,1980122103,1980150007,27904
1361558770,1980150232,26,1456,56,1361558741934,1361558769070,1980122166,1980149302,27136
1361558778,1980158252,54,3024,56,1361558750041,1361558777625,1980130293,1980157877,27584
1361558783,1980162360,3,491,163.6666667,1361558758550,1361558758806,1980137910,1980138166,256
1361558786,1980165504,2,98,49,1361558779077,1361558784389,1980158581,1980163893,5312
1361558786,1980165504,2,98,49,1361558779077,1361558784389,1980158581,1980163893,5312
1361558786,1980165556,4,190,47.5,1361558779025,1361558784465,1980158581,1980164021,5440
1361558786,1980166272,28,1568,56,1361558758216,1361558785288,1980138488,1980165560,27072
1361558794,1980173504,11,537,48.81818182,1361558785991,1361558787911,1980165495,1980167415,1920
1361558794,1980173596,39,38508,987.3846154,1361558784108,1361558791916,1980163704,1980171512,7808
1361558794,1980174272,2,288,144,1361558766406,1361558783878,1980146678,1980164150,17472
1361558798,1980178168,31,1736,56,1361558769901,1361558797805,1980150069,1980177973,27904
1361558798,1980178172,59,5664,96,1361558770153,1361558797673,1980150325,1980177845,27520
1361558802,1980182264,9,2503,278.1111111,1361558777232,1361558778000,1980157496,1980158264,768
1361558807,1980186284,64,3584,56,1361558778916,1361558806500,1980158200,1980185784,27584
1361558810,1980190240,1,46,46,1361558783461,1361558783461,1980163701,1980163701,0
1361558815,1980194304,34,1904,56,1361558786896,1361558814352,1980166200,1980193656,27456
1361558815,1980194336,15,2357,157.1333333,1361558788077,1361558789293,1980167413,1980168629,1216
1361558826,1980206252,2,192,96,1361558799833,1361558802073,1980180085,1980182325,2240
1361558827,1980206292,58,5568,96,1361558798940,1361558826524,1980178232,1980205816,27584
1361558827,1980206300,3,491,163.6666667,1361558799442,1361558799570,1980178742,1980178870,128
1361558827,1980206304,29,1624,56,1361558799567,1361558826767,1980178871,1980206071,27200
1361558831,1980210340,41,2296,56,1361558806825,1361558830441,1980186165,1980209781,23616
1361558843,1980222320,19,1064,56,1361558814972,1361558842492,1980194292,1980221812,27520
1361558850,1980229524,8,399,49.875,1361558847921,1361558849201,1980227445,1980228725,1280
1361558855,1980234348,33,1848,56,1361558830819,1361558854691,1980210167,1980234039,23872
1361558855,1980234348,36,3456,96,1361558826977,1361558854817,1980206325,1980234165,27840
1361558855,1980234356,18,1008,56,1361558827545,1361558854489,1980206901,1980233845,26944
1361558855,1980234480,2,304,152,1361558829916,1361558838684,1980209396,1980218164,8768
1361558867,1980246524,3,491,163.6666667,1361558839474,1361558839602,1980218998,1980219126,128
1361558871,1980250608,16,896,56,1361558843167,1361558870559,1980222775,1980250167,27392
1361558875,1980254664,11,4509,409.9090909,1361558849062,1361558849254,1980228726,1980228918,192
1361558883,1980262568,32,1792,56,1361558856902,1361558882822,1980236470,1980262390,25920
1361558883,1980262596,16,896,56,1361558857833,1361558882601,1980237429,1980262197,24768
1361558883,1980262648,1,64,64,1361558856820,1361558856820,1980236468,1980236468,0
1361558883,1980262668,32,3072,96,1361558857567,1361558882783,1980237235,1980262451,25216
1361558898,1980277836,3,138,46,1361558894072,1361558894200,1980273908,1980274036,128
1361558899,1980278696,18,1008,56,1361558873669,1361558898117,1980253365,1980277813,24448
1361558907,1980286716,3,491,163.6666667,1361558879217,1361558879473,1980258933,1980259189,256
1361558911,1980290548,40,2240,56,1361558883159,1361558910679,1980262707,1980290227,27520
1361558911,1980290552,40,3840,96,1361558883222,1361558910742,1980262774,1980290294,27520
1361558911,1980290632,20,1120,56,1361558883204,1361558910404,1980262836,1980290036,27200
1361558911,1980290640,1,64,64,1361558883900,1361558883900,1980263540,1980263540,0
1361558914,1980293788,9,445,49.44444444,1361558908458,1361558909226,1980288246,1980289014,768
1361558927,1980306632,23,1288,56,1361558899076,1361558926532,1980278708,1980306164,27456
1361558935,1980314608,11,2057,187,1361558909406,1361558909598,1980289014,1980289206,192
1361558939,1980318580,38,2128,56,1361558910969,1361558938297,1980290549,1980317877,27328
1361558939,1980318588,19,1064,56,1361558911282,1361558938162,1980290870,1980317750,26880
1361558939,1980318660,4,656,164,1361558913706,1361558914090,1980293366,1980293750,384
1361558939,1980318664,2,128,64,1361558910947,1361558937955,1980290611,1980317619,27008
1361558939,1980318668,38,3648,96,1361558910942,1361558938334,1980290610,1980318002,27392
1361558947,1980326596,3,491,163.6666667,1361558919336,1361558919656,1980298932,1980299252,320
1361558955,1980334600,10,560,56,1361558927333,1361558954277,1980306933,1980333877,26944
1361558967,1980346660,18,1728,96,1361558941609,1361558966761,1980321269,1980346421,25152
1361558967,1980346660,10,560,56,1361558941735,1361558966823,1980321395,1980346483,25088
1361558967,1980346736,19,1064,56,1361558941340,1361558966492,1980321076,1980346228,25152
1361558970,1980349900,5,236,47.2,1361558959671,1361558965879,1980339571,1980345779,6208
1361558970,1980349988,8,399,49.875,1361558968287,1361558969375,1980348275,1980349363,1088
1361558987,1980366640,16,896,56,1361558959677,1361558979133,1980339317,1980358773,19456
1361558987,1980366720,4,890,222.5,1361558959339,1361558959979,1980339059,1980339699,640
1361558991,1980370768,2,128,64,1361558964923,1361558967611,1980344691,1980347379,2688
1361558995,1980374632,23,1288,56,1361558967042,1361558979714,1980346674,1980359346,12672
1361558995,1980374664,11,616,56,1361558967587,1361558979619,1980347251,1980359283,12032
1361558995,1980374716,23,2208,96,1361558967023,1361558979759,1980346739,1980359475,12736
1361558995,1980374800,16,2409,150.5625,1361558969564,1361558970396,1980349364,1980350196,832
1361559023,1980402772,8,1920,240,1361558997688,1361559018680,1980377460,1980398452,20992
1361559026,1980406028,277,383916,1385.978339,1361558959414,1361559024246,1980339442,1980404274,64832
1361559027,1980406640,6,2394,399,1361558999482,1361559023930,1980379122,1980403570,24448
1361559034,1980414092,2,92,46,1361559028725,1361559028853,1980408817,1980408945,128
1361559042,1980421988,7,508,72.57142857,1361559029278,1361559039454,1980409266,1980419442,10176
1361559042,1980422000,5,230,46,1361559033556,1361559041236,1980413556,1980421236,7680
1361559058,1980437976,4,184,46,1361559038187,1361559050411,1980418163,1980430387,12224
1361559066,1980445976,2,445,222.5,1361559048809,1361559059177,1980428785,1980439153,10368
1361559066,1980446056,2,92,46,1361559049307,1361559065563,1980429363,1980445619,16256
1361559075,1980454676,2,154,77,1361559050260,1361559071316,1980429936,1980450992,21056
1361559082,1980461952,4,184,46,1361559058883,1361559078915,1980438835,1980458867,20032
1361559114,1980494064,3,138,46,1361559088784,1361559108752,1980468848,1980488816,19968
1361559122,1980502052,190752,284499466,1491.462559,1361557938847,1361559119519,1979318899,1980499571,1180672
1361559123,1980502724,1,46,46,1361559098404,1361559098404,1980478128,1980478128,0
1361559127,1980506832,1,399,399,1361559099384,1361559099384,1980479216,1980479216,0
1361560311,1981690688,1,46,46,1361560282936,1361560282936,1981662624,1981662624,0
1361560311,1981690772,1,46,46,1361560282979,1361560282979,1981662751,1981662751,0
1361560311,1981690812,1,46,46,1361560282939,1361560282939,1981662751,1981662751,0
1361560312,1981691364,1,46,46,1361560283322,1361560283322,1981662686,1981662686,0
1361560883,1982263052,1,48,48,1361560854212,1361560854212,1982234264,1982234264,0
1361561261,1982640740,3,144,48,1361561233015,1361561242039,1982612755,1982621779,9024
1361561871,1983250588,1,46,46,1361561844869,1361561844869,1983224457,1983224457,0
1361564364,1985743732,1,46,46,1361564338126,1361564338126,1985717858,1985717858,0
1361564897,1986276556,3,144,48,1361564872310,1361564882358,1986251866,1986261914,10048
1361567358,1988737584,2,128,64,1361567331767,1361567335735,1988711351,1988715319,3968
1361567851,1989231000,1,60,60,1361567824207,1361567824207,1989204207,1989204207,0
1361568073,1989452364,1,46,46,1361568044870,1361568044870,1989424234,1989424234,0
1361568192,1989572172,1,60,60,1361568164381,1361568164381,1989544553,1989544553,0
1361568317,1989696416,1,60,60,1361568288977,1361568288977,1989668393,1989668393,0
1361571218,1992597556,1,46,46,1361571189080,1361571189080,1992568636,1992568636,0
1361571581,1992960652,6,298,49.66666667,1361571554612,1361571576308,1992934264,1992955960,21696
1361572582,1993961744,1,48,48,1361572554248,1361572554248,1993933992,1993933992,0
1361572675,1994054536,1,46,46,1361572648021,1361572648021,1994027557,1994027557,0
1361573613,1994992912,1,60,60,1361573585935,1361573585935,1994965847,1994965847,0
1361573838,1995217792,1,60,60,1361573811203,1361573811203,1995190995,1995190995,0
1361573838,1995217840,1,60,60,1361573812435,1361573812435,1995192275,1995192275,0
1361573850,1995229804,1,60,60,1361573824504,1361573824504,1995204308,1995204308,0
1361573894,1995273832,1,60,60,1361573866524,1361573866524,1995246356,1995246356,0
1361574026,1995405984,1,60,60,1361574000001,1361574000001,1995379985,1995379985,0
1361574487,1995867052,1,60,60,1361574459255,1361574459255,1995839307,1995839307,0
1361575081,1996460544,1,46,46,1361575055339,1361575055339,1996434883,1996434883,0
1361576994,1998374200,1,48,48,1361576967036,1361576967036,1998347236,1998347236,0
1361577042,1998421296,1,60,60,1361577017282,1361577017282,1998396578,1998396578,0
1361577247,1998626452,1,46,46,1361577221029,1361577221029,1998600481,1998600481,0
1361578200,1999579336,2,122,61,1361578174538,1361578176650,1999553874,1999555986,2112
1361579628,2001007492,1,46,46,1361579602971,1361579602971,2000982463,2000982463,0
1361581826,2003205632,1,46,46,1361581799021,1361581799021,2003178653,2003178653,0
1361581826,2003205668,1,46,46,1361581799048,1361581799048,2003178716,2003178716,0
1361581826,2003205800,1,46,46,1361581798981,1361581798981,2003178781,2003178781,0
1361581826,2003205872,1,46,46,1361581798971,1361581798971,2003178843,2003178843,0
1361581826,2003205920,1,46,46,1361581798990,1361581798990,2003178910,2003178910,0
1361581827,2003206460,1,46,46,1361581799256,1361581799256,2003178716,2003178716,0
1361581827,2003206496,1,46,46,1361581799284,1361581799284,2003178780,2003178780,0
1361581827,2003206532,1,46,46,1361581799249,1361581799249,2003178781,2003178781,0
1361581827,2003206584,1,46,46,1361581799258,1361581799258,2003178842,2003178842,0
1361581827,2003206660,1,46,46,1361581799249,1361581799249,2003178909,2003178909,0
1361584643,2006022408,1,46,46,1361584618785,1361584618785,2005998193,2005998193,0
1361585685,2007064700,1,445,445,1361585657901,1361585657901,2007037601,2007037601,0
1361586102,2007481248,1,48,48,1361586071340,1361586071340,2007450588,2007450588,0
1361586134,2007514008,5,250,50,1361586106354,1361586128498,2007486362,2007508506,22144
1361586597,2007976676,2,92,46,1361586589242,1361586589562,2007968918,2007969238,320
1361586627,2008007200,1,46,46,1361586600362,1361586600362,2007980562,2007980562,0
1361586653,2008032776,3,138,46,1361586642898,1361586648722,2008022674,2008028498,5824
1361589161,2010541040,1,64,64,1361589135400,1361589135400,2010515440,2010515440,0
1361590348,2011727580,1,46,46,1361590322144,1361590322144,2011701724,2011701724,0
1361592280,2013659988,1,48,48,1361592253228,1361592253228,2013633216,2013633216,0
1361592364,2013743456,1,60,60,1361592338623,1361592338623,2013718079,2013718079,0
1361592447,2013826928,1,48,48,1361592416931,1361592416931,2013796859,2013796859,0
1361592886,2014265672,1,46,46,1361592860764,1361592860764,2014240436,2014240436,0
1361592886,2014265752,1,46,46,1361592860751,1361592860751,2014240503,2014240503,0
1361592887,2014266480,1,46,46,1361592860959,1361592860959,2014240439,2014240439,0
1361592887,2014266516,1,46,46,1361592860985,1361592860985,2014240501,2014240501,0
1361594316,2015695720,1,84,84,1361594291161,1361594291161,2015670881,2015670881,0
1361595919,2017298852,1,48,48,1361595888444,1361595888444,2017268296,2017268296,0
1361596859,2018238392,1,60,60,1361596833914,1361596833914,2018213306,2018213306,0
1361596939,2018318556,1,60,60,1361596913812,1361596913812,2018293368,2018293368,0
1361597007,2018386828,1,60,60,1361596981891,1361596981891,2018361719,2018361719,0
1361597530,2018910064,1,48,48,1361597502863,1361597502863,2018882927,2018882927,0
1361601843,2023222664,1,78,78,1361601817951,1361601817951,2023197615,2023197615,0
1361601963,2023342684,1,46,46,1361601936265,1361601936265,2023315949,2023315949,0
1361602131,2023511128,1,46,46,1361602103305,1361602103305,2023483433,2023483433,0
1361603178,2024557528,2,122,61,1361603153300,1361603155604,2024532828,2024535132,2304
1361603567,2024946704,1,56,56,1361603540894,1361603540894,2024920598,2024920598,0
1361604136,2025515608,2,96,48,1361604110579,1361604113523,2025490187,2025493131,2944
1361604350,2025729280,1,46,46,1361604322042,1361604322042,2025701322,2025701322,0
1361604350,2025729288,1,46,46,1361604322097,1361604322097,2025701385,2025701385,0
1361604350,2025729324,1,46,46,1361604322062,1361604322062,2025701386,2025701386,0
1361604350,2025730016,1,46,46,1361604321240,1361604321240,2025701256,2025701256,0
1361604350,2025730052,1,46,46,1361604321206,1361604321206,2025701258,2025701258,0
1361604350,2025730092,1,46,46,1361604321228,1361604321228,2025701320,2025701320,0
1361604351,2025730204,1,46,46,1361604322247,1361604322247,2025701451,2025701451,0
1361604637,2026016368,1,46,46,1361604612702,1361604612702,2025992070,2025992070,0
1361606536,2027916108,1,46,46,1361606510044,1361606510044,2027890152,2027890152,0
1361609074,2030453332,2,92,46,1361609046207,1361609048895,2030425539,2030428227,2688
1361609482,2030862004,2,92,46,1361609456472,1361609458648,2030836476,2030838652,2176
1361612576,2033955356,1,46,46,1361612549554,1361612549554,2033928910,2033928910,0
1361614192,2035571932,1,46,46,1361614166231,1361614166231,2035546163,2035546163,0
1361614825,2036205048,2,120,60,1361614798745,1361614798745,2036178793,2036178793,0
1361615734,2037113124,1,46,46,1361615706793,1361615706793,2037085917,2037085917,0
1361615734,2037113272,1,46,46,1361615706708,1361615706708,2037085980,2037085980,0
1361615734,2037113392,1,46,46,1361615706654,1361615706654,2037086046,2037086046,0
1361615735,2037114252,1,46,46,1361615706664,1361615706664,2037085916,2037085916,0
1361615735,2037114288,1,46,46,1361615706692,1361615706692,2037085980,2037085980,0
1361615735,2037114296,1,46,46,1361615706687,1361615706687,2037085983,2037085983,0
1361615735,2037114328,1,46,46,1361615706655,1361615706655,2037085983,2037085983,0
1361615735,2037114340,1,46,46,1361615706641,1361615706641,2037085981,2037085981,0
1361616298,2037677152,1,60,60,1361616273092,1361616273092,2037652244,2037652244,0
1361618150,2039529852,1,46,46,1361618124207,1361618124207,2039504059,2039504059,0
1361620174,2041553244,1,46,46,1361620145967,1361620145967,2041525211,2041525211,0
1361623837,2045216980,1,46,46,1361623811609,1361623811609,2045191589,2045191589,0
1361626765,2048144488,1,46,46,1361626736662,1361626736662,2048116150,2048116150,0
1361626765,2048144500,1,46,46,1361626736717,1361626736717,2048116217,2048116217,0
1361626765,2048144540,1,46,46,1361626736676,1361626736676,2048116216,2048116216,0
1361626766,2048145824,1,46,46,1361626736327,1361626736327,2048116151,2048116151,0
1361626766,2048145944,1,46,46,1361626736336,1361626736336,2048116280,2048116280,0
1361626897,2048276544,1,46,46,1361626870048,1361626870048,2048249592,2048249592,0
1361627786,2049165564,1,46,46,1361627759869,1361627759869,2049139433,2049139433,0
1361628868,2050247736,1,46,46,1361628843008,1361628843008,2050222744,2050222744,0
1361629843,2051222524,1,48,48,1361629816966,1361629816966,2051196490,2051196490,0
1361631775,2053154948,1,48,48,1361631746047,1361631746047,2053125995,2053125995,0
1361632375,2053754176,1,48,48,1361632346364,1361632346364,2053725540,2053725540,0
1361633026,2054405516,1,46,46,1361633000541,1361633000541,2054380057,2054380057,0
1361636983,2058362592,1,46,46,1361636958102,1361636958102,2058337694,2058337694,0
1361637711,2059090100,1,46,46,1361637681974,1361637681974,2059061074,2059061074,0
1361639616,2060995836,1,46,46,1361639589305,1361639589305,2060969141,2060969141,0
1361642758,2064137364,1,443,443,1361642732962,1361642732962,2064112326,2064112326,0
1361642910,2064289832,1,56,56,1361642883277,1361642883277,2064263109,2064263109,0
1361643219,2064598620,1,46,46,1361643191388,1361643191388,2064571008,2064571008,0
1361643508,2064887636,1,46,46,1361643482439,1361643482439,2064862075,2064862075,0
1361644102,2065481332,1,46,46,1361644074735,1361644074735,2065454067,2065454067,0
1361644301,2065680748,1,46,46,1361644273742,1361644273742,2065653490,2065653490,0
1361644427,2065806816,1,46,46,1361644399303,1361644399303,2065779119,2065779119,0
1361645468,2066847424,1,60,60,1361645442431,1361645442431,2066821855,2066821855,0
1361645540,2066919672,1,71,71,1361645514116,1361645514116,2066893788,2066893788,0
1361645668,2067047636,1,444,444,1361645642086,1361645642086,2067021722,2067021722,0
1361645744,2067123604,1,65,65,1361645717255,1361645717255,2067096859,2067096859,0
1361646553,2067932444,1,46,46,1361646526426,1361646526426,2067905870,2067905870,0
1361646725,2068104640,1,52,52,1361646699925,1361646699925,2068079565,2068079565,0
1361647467,2068846212,1,46,46,1361647440307,1361647440307,2068819519,2068819519,0
1361648579,2069958128,1,46,46,1361648550135,1361648550135,2069929263,2069929263,0
1361648579,2069958140,1,46,46,1361648550189,1361648550189,2069929329,2069929329,0
1361648579,2069958168,1,46,46,1361648550162,1361648550162,2069929330,2069929330,0
1361648579,2069958628,1,46,46,1361648549637,1361648549637,2069929265,2069929265,0
1361648579,2069958748,1,46,46,1361648549580,1361648549580,2069929328,2069929328,0
1361648782,2070161812,1,46,46,1361648756936,1361648756936,2070136748,2070136748,0
1361651172,2072551036,3,150,50,1361651156909,1361651166957,2072535945,2072545993,10048
1361652259,2073638328,1,48,48,1361652231673,1361652231673,2073611001,2073611001,0
1361653191,2074570468,1,46,46,1361653162784,1361653162784,2074542252,2074542252,0
1361656275,2077654208,1,46,46,1361656248116,1361656248116,2077627324,2077627324,0
1361659661,2081040360,1,46,46,1361659632811,1361659632811,2081012171,2081012171,0
1361659661,2081040372,1,46,46,1361659632863,1361659632863,2081012235,2081012235,0
1361659661,2081040392,1,46,46,1361659632840,1361659632840,2081012232,2081012232,0
1361659661,2081040440,1,46,46,1361659632858,1361659632858,2081012298,2081012298,0
1361659661,2081040472,1,46,46,1361659632824,1361659632824,2081012296,2081012296,0
1361659661,2081040552,1,46,46,1361659632809,1361659632809,2081012361,2081012361,0
1361659662,2081041516,1,46,46,1361659632847,1361659632847,2081012363,2081012363,0
1361660097,2081476448,1,46,46,1361660071179,1361660071179,2081450627,2081450627,0
1361661041,2082420468,1,46,46,1361661013992,1361661013992,2082393460,2082393460,0
1361661621,2083000508,1,52,52,1361661595192,1361661595192,2082974700,2082974700,0
1361661685,2083064640,1,52,52,1361661657333,1361661657333,2083036973,2083036973,0
1361662268,2083647888,1,46,46,1361662241844,1361662241844,2083621732,2083621732,0
1361663685,2085064136,1,46,46,1361663659150,1361663659150,2085038286,2085038286,0
1361670856,2092235308,1,46,46,1361670828086,1361670828086,2092207394,2092207394,0
1361670856,2092235344,1,46,46,1361670828049,1361670828049,2092207393,2092207393,0
1361670856,2092235416,1,46,46,1361670828040,1361670828040,2092207456,2092207456,0
1361670857,2092236152,1,46,46,1361670828179,1361670828179,2092207331,2092207331,0
1361670857,2092236236,1,46,46,1361670828157,1361670828157,2092207393,2092207393,0
1361670857,2092236308,1,46,46,1361670828148,1361670828148,2092207456,2092207456,0
1361671124,2092503072,1,52,52,1361671096287,1361671096287,2092475359,2092475359,0
1361673105,2094484196,1,46,46,1361673077697,1361673077697,2094456893,2094456893,0
1361673240,2094619712,1,60,60,1361673215358,1361673215358,2094595070,2094595070,0
1361676051,2097430804,1,48,48,1361676025336,1361676025336,2097405140,2097405140,0
1361677049,2098428772,1,60,60,1361677021831,1361677021831,2098401603,2098401603,0
1361677202,2098581168,1,60,60,1361677174050,1361677174050,2098553218,2098553218,0
1361677250,2098629360,2,120,60,1361677224864,1361677225824,2098604224,2098605184,960
1361679370,2100749080,1,60,60,1361679342104,1361679342104,2100721184,2100721184,0
1361679659,2101038124,3,156,52,1361679631463,1361679640423,2101010587,2101019547,8960
1361680870,2102248984,1,46,46,1361680843680,1361680843680,2102222664,2102222664,0
1361681643,2103022304,1,46,46,1361681618007,1361681618007,2102997311,2102997311,0
1361682033,2103412580,1,46,46,1361682005309,1361682005309,2103384889,2103384889,0
1361682034,2103413748,1,46,46,1361682005206,1361682005206,2103384954,2103384954,0
1361682034,2103413788,1,46,46,1361682005163,1361682005163,2103384951,2103384951,0
1361683074,2104453104,1,46,46,1361683048455,1361683048455,2104427559,2104427559,0
1361683590,2104969780,1,46,46,1361683564764,1361683564764,2104944544,2104944544,0
1361688194,2109573504,1,46,46,1361688168749,1361688168749,2109548253,2109548253,0
1361689237,2110616148,1,58,58,1361689210816,1361689210816,2110589964,2110589964,0
1361690552,2111931096,1,46,46,1361690525921,1361690525921,2111905017,2111905017,0
1361693384,2114763520,1,46,46,1361693355087,1361693355087,2114734607,2114734607,0
1361693385,2114764576,1,46,46,1361693355030,1361693355030,2114734606,2114734606,0
1361693439,2114818088,1,60,60,1361693411966,1361693411966,2114791054,2114791054,0
1361695748,2117126868,5,250,50,1361695721335,1361695743159,2117100203,2117122027,21824
1361695792,2117170968,1,48,48,1361695767313,1361695767313,2117146281,2117146281,0
1361695824,2117203044,1,48,48,1361695796613,1361695796613,2117175657,2117175657,0
1361696449,2117828140,3,144,48,1361696423068,1361696432028,2117802208,2117811168,8960
1361696528,2117907580,1,48,48,1361696498657,1361696498657,2117878237,2117878237,0
1361697115,2118494656,1,48,48,1361697088971,1361697088971,2118468627,2118468627,0
1361699096,2120475792,1,46,46,1361699067881,1361699067881,2120447673,2120447673,0
1361699727,2121106004,1,444,444,1361699702451,1361699702451,2121081455,2121081455,0
1361700771,2122150780,5,320,64,1361700744220,1361700746652,2122124000,2122126432,2432
1361702758,2124137228,1,60,60,1361702731877,1361702731877,2124111105,2124111105,0
1361703678,2125056892,1,46,46,1361703651621,1361703651621,2125030513,2125030513,0
1361704573,2125952356,5,250,50,1361704548743,1361704570183,2125928099,2125949539,21440
1361704621,2126000404,1,48,48,1361704594135,1361704594135,2125973539,2125973539,0
1361704650,2126029580,1,46,46,1361704622312,1361704622312,2126001892,2126001892,0
1361704650,2126029616,1,46,46,1361704622339,1361704622339,2126001955,2126001955,0
1361704651,2126030016,1,48,48,1361704623514,1361704623514,2126002530,2126002530,0
1361704651,2126030504,1,46,46,1361704622451,1361704622451,2126001955,2126001955,0
1361709146,2130525160,1,46,46,1361709119882,1361709119882,2130499042,2130499042,0
1361712540,772233568,1,46,46,1361712513912,1361712513912,772207480,772207480,0
1361714490,2135868796,1,48,48,1361714463011,1361714463011,2135841807,2135841807,0
1361715793,2137172756,1,46,46,1361715767695,1361715767695,2137147451,2137147451,0
1361715794,2137172788,1,46,46,1361715768662,1361715768662,2137147450,2137147450,0
1361715794,2137172844,1,46,46,1361715768671,1361715768671,2137147515,2137147515,0
1361715794,2137173000,1,46,46,1361715768646,1361715768646,2137147646,2137147646,0
1361715794,2137173600,1,46,46,1361715767850,1361715767850,2137147450,2137147450,0
1361715794,2137173720,1,46,46,1361715767797,1361715767797,2137147517,2137147517,0
1361715794,2137173764,1,46,46,1361715767753,1361715767753,2137147517,2137147517,0
1361715795,2137173800,1,46,46,1361715768781,1361715768781,2137147581,2137147581,0
1361715795,2137173836,1,46,46,1361715768744,1361715768744,2137147580,2137147580,0
1361715795,2137173880,1,46,46,1361715768766,1361715768766,2137147646,2137147646,0
1361715796,2137175460,1,46,46,1361715767927,1361715767927,2137147387,2137147387,0
1361716177,2137556448,1,60,60,1361716149567,1361716149567,2137529015,2137529015,0
1361717919,2139298248,1,46,46,1361717892780,1361717892780,2139272028,2139272028,0
1361720887,2142266532,1,46,46,1361720861923,1361720861923,2142241455,2142241455,0
1361721901,2143280328,1,60,60,1361721875935,1361721875935,2143255263,2143255263,0
1361722116,2143495512,1,46,46,1361722088295,1361722088295,2143467807,2143467807,0
1361722246,2143624956,1,60,60,1361722220560,1361722220560,2143599516,2143599516,0
1361722318,2143697048,1,60,60,1361722291441,1361722291441,2143670489,2143670489,0
1361722338,2143717264,1,60,60,1361722311195,1361722311195,2143690459,2143690459,0
1361722390,2143769332,1,60,60,1361722365396,1361722365396,2143744728,2143744728,0
1361723051,2144430256,1,60,60,1361723023382,1361723023382,2144402638,2144402638,0
1361726641,2148020624,1,52,52,1361726615343,1361726615343,2147994967,2147994967,0
1361726645,2148024524,1,52,52,1361726617427,1361726617427,2147996951,2147996951,0
1361726729,2148108720,2,122,61,1361726703249,1361726705361,2148082969,2148085081,2112
1361726764,2148143612,1,46,46,1361726735228,1361726735228,2148114840,2148114840,0
1361726765,2148144160,1,46,46,1361726736125,1361726736125,2148115285,2148115285,0
1361727558,2148937644,1,48,48,1361727531599,1361727531599,2148911243,2148911243,0
1361730158,789851000,1,46,46,1361730132000,1361730132000,789825000,789825000,0
1361732932,2154311532,1,78,78,1361732906733,1361732906733,2154286265,2154286265,0
1361733534,2154913376,1,46,46,1361733508479,1361733508479,2154887855,2154887855,0
1361734002,2155381104,1,46,46,1361733974155,1361733974155,2155353259,2155353259,0
1361735301,2156680592,1,46,46,1361735273548,1361735273548,2156653140,2156653140,0
1361736998,2158377008,1,46,46,1361736969915,1361736969915,2158348923,2158348923,0
1361737726,2159104908,1,46,46,1361737697814,1361737697814,2159076722,2159076722,0
1361737726,2159105040,1,46,46,1361737697746,1361737697746,2159076786,2159076786,0
1361737726,2159105120,1,46,46,1361737697731,1361737697731,2159076851,2159076851,0
1361737726,2159105148,1,46,46,1361737697764,1361737697764,2159076912,2159076912,0
1361737726,2159105192,1,46,46,1361737697723,1361737697723,2159076915,2159076915,0
1361737727,2159106144,1,46,46,1361737697578,1361737697578,2159076722,2159076722,0
1361737727,2159106180,1,46,46,1361737697606,1361737697606,2159076786,2159076786,0
1361737727,2159106188,1,46,46,1361737697598,1361737697598,2159076786,2159076786,0
1361737727,2159106264,1,46,46,1361737697586,1361737697586,2159076850,2159076850,0
1361737727,2159106420,1,46,46,1361737697493,1361737697493,2159076913,2159076913,0
1361738029,2159408124,1,46,46,1361738000887,1361738000887,2159380011,2159380011,0
1361738570,2159949064,1,46,46,1361738541996,1361738541996,2159921060,2159921060,0
1361739074,798767772,2,128,64,1361739049306,1361739050266,798743078,798744038,960
1361740225,2161604156,1,46,46,1361740197048,1361740197048,2161576204,2161576204,0
1361740998,2162376964,1,446,446,1361740973484,1361740973484,2162352448,2162352448,0
1361741235,2162613756,1,48,48,1361741209144,1361741209144,2162587900,2162587900,0
1361741825,2163203840,1,48,48,1361741800412,1361741800412,2163179252,2163179252,0
1361742225,2163603896,2,122,61,1361742197148,1361742199516,2163576044,2163578412,2368
1361742686,2164064848,1,46,46,1361742659909,1361742659909,2164038757,2164038757,0
1361744575,2165954360,1,52,52,1361744549355,1361744549355,2165928715,2165928715,0
1361744627,2166006548,1,52,52,1361744601197,1361744601197,2165980745,2165980745,0
1361745641,2167020384,4,202,50.5,1361745614400,1361745617536,2166993784,2166996920,3136
1361745673,2167052472,2,96,48,1361745648810,1361745660842,2167028282,2167040314,12032
1361745950,2167329276,1,46,46,1361745925223,1361745925223,2167304499,2167304499,0
1361747201,2168579824,1,60,60,1361747174747,1361747174747,2168553571,2168553571,0
1361747205,2168583748,1,60,60,1361747179752,1361747179752,2168558500,2168558500,0
1361747457,2168836284,1,46,46,1361747430282,1361747430282,2168809566,2168809566,0
1361748633,2170012040,1,46,46,1361748604655,1361748604655,2169983695,2169983695,0
1361749558,2170937100,1,52,52,1361749529893,1361749529893,2170908993,2170908993,0
1362074655,2496033520,1,46,46,1362074628036,1362074628036,2496006556,2496006556,0
1362075137,2496515096,2,152,76,1362075109476,1362075124516,2496487572,2496502612,15040
1362075165,2496543492,2,152,76,1362075139160,1362075154200,2496517652,2496532692,15040
1362075197,2496575348,2,152,76,1362075169386,1362075184426,2496547734,2496562774,15040
1362075225,2496603600,2,152,76,1362075199214,1362075214254,2496577814,2496592854,15040
1362075257,2496635612,2,152,76,1362075229278,1362075244318,2496607890,2496622930,15040
1362075286,2496663632,2,152,76,1362075260340,1362075275380,2496637972,2496653012,15040
1362075318,2496695916,2,152,76,1362075290136,1362075305176,2496668052,2496683092,15040
1362075346,2496723960,2,152,76,1362075320170,1362075336042,2496698130,2496714002,15872
1362075348,2496726296,20,3924,196.2,1362075332635,1362075341915,2496710931,2496720211,9280
1362075378,2496755860,2,152,76,1362075351180,1362075366156,2496729040,2496744016,14976
1362075406,2496783916,1,76,76,1362075381207,1362075381207,2496759123,2496759123,0
1362075486,2496864360,1,60,60,1362075461719,1362075461719,2496840079,2496840079,0
1362075808,1135501012,3,393,131,1362075780255,1362075786335,1135473267,1135479347,6080
1362075811,2497189180,1,60,60,1362075784010,1362075784010,2497162190,2497162190,0
1362076589,2497966776,1,436,436,1362076560784,1362076560784,2497938560,2497938560,0
1362076793,2498171440,1,436,436,1362076765492,1362076765492,2498143932,2498143932,0
1362076826,1136518952,6,455,75.83333333,1362076818914,1362076819042,1136511866,1136511994,128
1362076858,1136550948,5,242,48.4,1362076851684,1362076857700,1136544632,1136550648,6016
1362076858,1136550948,5,242,48.4,1362076851684,1362076857700,1136544632,1136550648,6016
1362076858,1136550948,5,242,48.4,1362076851684,1362076857700,1136544632,1136550648,6016
1362076858,1136550948,5,242,48.4,1362076851684,1362076857764,1136544632,1136550712,6080
1362076858,1136550948,4,196,49,1362076851684,1362076857764,1136544632,1136550712,6080
1362076862,2498239972,8,374,46.75,1362076851784,1362076859784,2498229756,2498237756,8000
1362076866,1136558940,3,138,46,1362076858541,1362076865389,1136551481,1136558329,6848
1362076866,1136558940,3,138,46,1362076858668,1362076864556,1136551608,1136557496,5888
1362076866,1136558940,4,196,49,1362076855147,1362076864747,1136548087,1136557687,9600
1362076866,1136558948,3,138,46,1362076858598,1362076865382,1136551546,1136558330,6784
1362076866,1136558952,2,92,46,1362076858594,1362076864482,1136551546,1136557434,5888
1362076866,1136558952,3,138,46,1362076858658,1362076864546,1136551610,1136557498,5888
1362076866,1136558952,6,294,49,1362076855137,1362076865185,1136548089,1136558137,10048
1362076866,1136558952,3,150,50,1362076855265,1362076864737,1136548217,1136557689,9472
1362076866,1136558952,4,196,49,1362076855520,1362076864736,1136548472,1136557688,9216
1362076870,2498247960,6,300,50,1362076856084,1362076865172,2498234044,2498243132,9088
1362076870,2498247960,7,346,49.42857143,1362076856084,1362076867604,2498234044,2498245564,11520
1362076870,2498247960,7,346,49.42857143,1362076856084,1362076867668,2498234044,2498245628,11584
1362076870,2498247976,7,346,49.42857143,1362076856068,1362076867652,2498234044,2498245628,11584
1362076870,2498248020,6,276,46,1362076862104,1362076868120,2498240124,2498246140,6016
1362076870,2498248036,7,346,49.42857143,1362076855752,1362076867528,2498233788,2498245564,11776
1362076870,2498248036,6,300,50,1362076855752,1362076865096,2498233788,2498243132,9344
1362076870,2498248036,16,6778,423.625,1362076855943,1362076868487,2498233979,2498246523,12544
1362076870,2498248036,6,300,50,1362076856007,1362076865095,2498234043,2498243131,9088
1362076870,2498248036,7,346,49.42857143,1362076856007,1362076867463,2498234043,2498245499,11456
1362076874,1136566936,6,300,50,1362076857778,1362076871730,1136550714,1136564666,13952
1362076874,1136566936,5,254,50.8,1362076857778,1362076871730,1136550714,1136564666,13952
1362076874,1136566936,5,254,50.8,1362076858097,1362076872753,1136551033,1136565689,14656
1362076874,1136566944,5,254,50.8,1362076857513,1362076871721,1136550457,1136564665,14208
1362076874,1136566944,5,254,50.8,1362076857705,1362076871721,1136550649,1136564665,14016
1362076874,1136566944,5,254,50.8,1362076857769,1362076872681,1136550713,1136565625,14912
1362076874,1136566944,5,254,50.8,1362076857769,1362076871721,1136550713,1136564665,13952
1362076874,1136566944,2,92,46,1362076866088,1362076869288,1136559032,1136562232,3200
1362076874,1136566944,2,92,46,1362076866280,1362076866280,1136559224,1136559224,0
1362076878,2498255952,6,306,51,1362076858522,1362076875162,2498236474,2498253114,16640
1362076878,2498255980,4,196,49,1362076865021,1362076877309,2498243001,2498255289,12288
1362076878,2498255980,4,196,49,1362076865025,1362076877697,2498243005,2498255677,12672
1362076878,2498255980,3,150,50,1362076865025,1362076873153,2498243005,2498251133,8128
1362076878,2498255980,3,150,50,1362076865024,1362076873152,2498243004,2498251132,8128
1362076878,2498255980,8,404,50.5,1362076868351,1362076877247,2498246331,2498255227,8896
1362076878,2498255980,4,196,49,1362076868223,1362076875391,2498246203,2498253371,7168
1362076878,2498255980,4,196,49,1362076868286,1362076875582,2498246266,2498253562,7296
1362076878,2498255984,5,248,49.6,1362076868603,1362076877307,2498246587,2498255291,8704
1362076878,2498255984,4,196,49,1362076868730,1362076876986,2498246714,2498254970,8256
1362076878,1136570588,7,2899,414.1428571,1362076852044,1362076856908,1136544632,1136549496,4864
1362076878,2498256064,5,248,49.6,1362076864941,1362076877229,2498243005,2498255293,12288
1362076878,2498256064,8,404,50.5,1362076868267,1362076877099,2498246331,2498255163,8832
1362076878,2498256064,4,196,49,1362076868202,1362076875498,2498246266,2498253562,7296
1362076878,2498256068,4,188,47,1362076868454,1362076876902,2498246522,2498254970,8448
1362076878,2498256068,4,202,50.5,1362076868585,1362076876713,2498246653,2498254781,8128
1362076878,2498256068,3,150,50,1362076868456,1362076875048,2498246524,2498253116,6592
1362076878,2498256068,3,150,50,1362076868520,1362076875048,2498246588,2498253116,6528
1362076878,2498256068,4,202,50.5,1362076868583,1362076875175,2498246651,2498253243,6592
1362076878,2498256072,3,140,46.66666667,1362076869093,1362076877413,2498247165,2498255485,8320
1362076878,2498256184,49,36009,734.877551,1362076851701,1362076866293,2498229885,2498244477,14592
1362076878,2498256188,19,11634,612.3157895,1362076852080,1362076873264,2498230268,2498251452,21184
1362076878,2498256212,13,728,56,1362076852694,1362076866774,2498230906,2498244986,14080
1362076878,2498256216,22,1232,56,1362076852821,1362076867285,2498231037,2498245501,14464
1362076878,2498256268,4,856,214,1362076851359,1362076851487,2498229627,2498229755,128
1362076882,2498259900,16,18868,1179.25,1362076855119,1362076870415,2498233019,2498248315,15296
1362076882,2498259924,53,64972,1225.886792,1362076855545,1362076875449,2498233469,2498253373,19904
1362076882,2498259924,9,504,56,1362076855608,1362076867000,2498233532,2498244924,11392
1362076882,2498259932,4,208,52,1362076856368,1362076875696,2498234300,2498253628,19328
1362076882,1136574524,22,21404,972.9090909,1362076855566,1362076869838,1136548090,1136562362,14272
1362076882,1136574524,16,13580,848.75,1362076855502,1362076871566,1136548026,1136564090,16064
1362076882,1136574524,12,9300,775,1362076855948,1362076876044,1136548472,1136568568,20096
1362076882,2498260008,21,21542,1025.809524,1362076854754,1362076869730,2498232762,2498247738,14976
1362076882,1136574564,13,13702,1054,1362076855462,1362076869926,1136548026,1136562490,14464
1362076882,2498260012,24,12924,538.5,1362076854880,1362076875232,2498232892,2498253244,20352
1362076882,1136574564,21,21358,1017.047619,1362076855525,1362076870373,1136548089,1136562937,14848
1362076882,2498260012,23,4494,195.3913043,1362076855007,1362076874527,2498233019,2498252539,19520
1362076882,2498260012,22,22840,1038.181818,1362076855007,1362076880159,2498233019,2498258171,25152
1362076882,2498260016,46,55926,1215.782609,1362076855450,1362076875802,2498233466,2498253818,20352
1362076882,2498260036,11,4670,424.5454545,1362076855495,1362076869191,2498233531,2498247227,13696
1362076882,2498260048,4,208,52,1362076856253,1362076874813,2498234301,2498252861,18560
1362076882,2498260048,4,208,52,1362076856253,1362076875389,2498234301,2498253437,19136
1362076882,2498260048,9,864,96,1362076856442,1362076866810,2498234490,2498244858,10368
1362076882,2498260084,14,5485,391.7857143,1362076857367,1362076879639,2498235451,2498257723,22272
1362076882,1136574944,3,150,50,1362076874729,1362076880233,1136567673,1136573177,5504
1362076882,1136574944,3,150,50,1362076874729,1362076880169,1136567673,1136573113,5440
1362076882,1136574948,6,294,49,1362076868964,1362076878756,1136561912,1136571704,9792
1362076882,1136574948,4,196,49,1362076868964,1362076877988,1136561912,1136570936,9024
1362076882,1136574948,4,196,49,1362076869028,1362076878180,1136561976,1136571128,9152
1362076882,1136574952,3,150,50,1362076874719,1362076879583,1136567671,1136572535,4864
1362076882,1136574952,3,150,50,1362076874719,1362076880223,1136567671,1136573175,5504
1362076882,1136574952,3,150,50,1362076874719,1362076880159,1136567671,1136573111,5440
1362076882,1136574968,5,242,48.4,1362076868946,1362076878162,1136561914,1136571130,9216
1362076882,1136574968,4,196,49,1362076868946,1362076878546,1136561914,1136571514,9600
1362076882,1136574968,4,196,49,1362076868946,1362076878802,1136561914,1136571770,9856
1362076886,2498264008,4,184,46,1362076877922,1362076885666,2498255930,2498263674,7744
1362076886,2498264012,12,5381,448.4166667,1362076870175,1362076885279,2498248187,2498263291,15104
1362076886,2498264012,2,92,46,1362076878303,1362076884703,2498256315,2498262715,6400
1362076886,2498264020,11,548,49.81818182,1362076871254,1362076884950,2498249274,2498262970,13696
1362076886,2498264020,18,882,49,1362076871254,1362076884950,2498249274,2498262970,13696
1362076886,2498264024,2,92,46,1362076879121,1362076883537,2498257145,2498261561,4416
1362076886,2498264028,15,762,50.8,1362076871952,1362076885200,2498249980,2498263228,13248
1362076886,2498264028,18,900,50,1362076871887,1362076885327,2498249915,2498263355,13440
1362076886,2498264044,18,900,50,1362076872063,1362076885631,2498250107,2498263675,13568
1362076886,2498264044,18,900,50,1362076872001,1362076885185,2498250045,2498263229,13184
1362076886,2498264044,3,144,48,1362076880189,1362076884669,2498258233,2498262713,4480
1362076886,2498264056,2,98,49,1362076881393,1362076882673,2498259449,2498260729,1280
1362076886,2498264056,15,7252,483.4666667,1362076868468,1362076884084,2498246524,2498262140,15616
1362076886,2498264060,2,94,47,1362076869169,1362076883825,2498247229,2498261885,14656
1362076886,2498264100,3,138,46,1362076878217,1362076884681,2498256317,2498262781,6464
1362076886,2498264108,5,254,50.8,1362076858431,1362076881983,2498236539,2498260091,23552
1362076886,2498264112,17,854,50.23529412,1362076871868,1362076885244,2498249980,2498263356,13376
1362076886,2498264136,17,854,50.23529412,1362076871845,1362076885221,2498249981,2498263357,13376
1362076886,2498264136,16,808,50.5,1362076871845,1362076884965,2498249981,2498263101,13120
1362076886,2498264136,4,184,46,1362076883108,1362076885092,2498261244,2498263228,1984
1362076886,2498264140,2,98,49,1362076880097,1362076883105,2498258237,2498261245,3008
1362076886,2498264140,3,144,48,1362076880351,1362076885087,2498258491,2498263227,4736
1362076886,2498264140,3,138,46,1362076880478,1362076885342,2498258618,2498263482,4864
1362076886,2498264152,4,196,49,1362076884434,1362076885330,2498262586,2498263482,896
1362076886,2498264152,8,632,79,1362076868372,1362076884948,2498246524,2498263100,16576
1362076890,2498268020,12,5056,421.3333333,1362076864857,1362076888729,2498242877,2498266749,23872
1362076890,2498268020,16,3923,245.1875,1362076864856,1362076879000,2498242876,2498257020,14144
1362076890,2498268020,18,7916,439.7777778,1362076864854,1362076883990,2498242874,2498262010,19136
1362076890,2498268020,20,9018,450.9,1362076864854,1362076883926,2498242874,2498261946,19072
1362076890,2498268140,19,10105,531.8421053,1362076864735,1362076884511,2498242875,2498262651,19776
1362076890,2498268144,16,2870,179.375,1362076864733,1362076875037,2498242877,2498253181,10304
1362076890,1136582940,3,144,48,1362076881774,1362076883630,1136574714,1136576570,1856
1362076890,1136582940,2,92,46,1362076886252,1362076887980,1136579192,1136580920,1728
1362076890,1136582944,3,138,46,1362076884136,1362076888232,1136577080,1136581176,4096
1362076890,1136582944,3,138,46,1362076884136,1362076888168,1136577080,1136581112,4032
1362076890,1136582952,3,138,46,1362076886306,1362076888034,1136579258,1136580986,1728
1362076890,1136582952,3,144,48,1362076879072,1362076889504,1136572024,1136582456,10432
1362076890,1136582964,5,230,46,1362076884053,1362076889429,1136577017,1136582393,5376
1362076890,1136582964,3,138,46,1362076884181,1362076889429,1136577145,1136582393,5248
1362076894,1136586532,1,46,46,1362076866757,1362076866757,1136559289,1136559289,0
1362076894,1136586532,1,46,46,1362076867011,1362076867011,1136559543,1136559543,0
1362076894,2498272036,2,92,46,1362076885896,1362076885896,2498263932,2498263932,0
1362076894,2498272036,9,456,50.66666667,1362076877895,1362076888519,2498255931,2498266555,10624
1362076894,2498272044,4,430,107.5,1362076886593,1362076887873,2498264637,2498265917,1280
1362076894,2498272044,2,92,46,1362076886656,1362076892480,2498264700,2498270524,5824
1362076894,2498272048,3,138,46,1362076879419,1362076889915,2498257467,2498267963,10496
1362076894,2498272048,3,138,46,1362076879610,1362076890618,2498257658,2498268666,11008
1362076894,2498272072,11,554,50.36363636,1362076872036,1362076891684,2498250108,2498269756,19648
1362076894,2498272072,6,306,51,1362076872100,1362076891684,2498250172,2498269756,19584
1362076894,2498272076,2,92,46,1362076883296,1362076886880,2498261372,2498264956,3584
1362076894,2498272084,2,92,46,1362076888726,1362076891734,2498266810,2498269818,3008
1362076894,2498272084,2,92,46,1362076888726,1362076891734,2498266810,2498269818,3008
1362076894,2498272088,2,92,46,1362076884049,1362076886737,2498262137,2498264825,2688
1362076894,2498272120,15,744,49.6,1362076877747,1362076889779,2498255867,2498267899,12032
1362076894,2498272128,2,92,46,1362076886571,1362076892395,2498264699,2498270523,5824
1362076894,2498272128,3,138,46,1362076878634,1362076888490,2498256762,2498266618,9856
1362076894,2498272160,10,508,50.8,1362076871947,1362076891595,2498250107,2498269755,19648
1362076894,2498272160,13,4618,355.2307692,1362076872267,1362076893515,2498250427,2498271675,21248
1362076894,2498272168,2,92,46,1362076888579,1362076891587,2498266747,2498269755,3008
1362076894,2498272168,2,92,46,1362076888642,1362076891650,2498266810,2498269818,3008
1362076894,2498272172,2,92,46,1362076888637,1362076891645,2498266809,2498269817,3008
1362076894,2498272172,4,190,47.5,1362076881152,1362076891328,2498259324,2498269500,10176
1362076894,2498272292,12,7253,604.4166667,1362076868360,1362076879240,2498246652,2498257532,10880
1362076894,2498272404,12,1462,121.8333333,1362076867927,1362076889367,2498246331,2498267771,21440
1362076894,2498272408,15,1144,76.26666667,1362076867924,1362076875924,2498246332,2498254332,8000
1362076894,2498272408,12,6424,535.3333333,1362076868243,1362076884435,2498246651,2498262843,16192
1362076894,2498272412,13,5505,423.4615385,1362076868176,1362076883728,2498246588,2498262140,15552
1362076898,2498276016,1,46,46,1362076872989,1362076872989,2498251005,2498251005,0
1362076898,2498276096,8,410,51.25,1362076872073,1362076897673,2498250169,2498275769,25600
1362076898,2498276120,1,46,46,1362076872757,1362076872757,2498250877,2498250877,0
1362076898,2498276120,1,46,46,1362076872883,1362076872883,2498251003,2498251003,0
1362076898,2498276128,1,46,46,1362076873515,1362076873515,2498251643,2498251643,0
1362076898,1136590960,7,6138,876.8571429,1362076881690,1362076896090,1136574650,1136589050,14400
1362076898,1136590960,10,7948,794.8,1362076882456,1362076896152,1136575416,1136589112,13696
1362076898,1136590960,12,9504,792,1362076882648,1362076896984,1136575608,1136589944,14336
1362076902,2498280008,3,1592,530.6666667,1362076885795,1362076895267,2498263803,2498273275,9472
1362076902,2498280012,8,404,50.5,1362076878111,1362076897439,2498256123,2498275451,19328
1362076902,2498280016,5,440,88,1362076898205,1362076899549,2498276221,2498277565,1344
1362076902,2498280024,2,98,49,1362076895573,1362076901717,2498273597,2498279741,6144
1362076902,2498280024,2,98,49,1362076895572,1362076901716,2498273596,2498279740,6144
1362076902,2498280024,3,1562,520.6666667,1362076895572,1362076896468,2498273596,2498274492,896
1362076902,2498280024,7,358,51.14285714,1362076887571,1362076894355,2498265595,2498272379,6784
1362076902,2498280024,6,306,51,1362076874899,1362076899731,2498252923,2498277755,24832
1362076902,2498280024,6,306,51,1362076875154,1362076899730,2498253178,2498277754,24576
1362076902,2498280052,4,202,50.5,1362076880247,1362076896695,2498258299,2498274747,16448
1362076902,2498280068,6,306,51,1362076877221,1362076894693,2498255289,2498272761,17472
1362076902,2498280096,3,138,46,1362076894026,1362076899146,2498272122,2498277242,5120
1362076902,2498280100,22,26316,1196.181818,1362076885961,1362076897417,2498264061,2498275517,11456
1362076902,2498280104,7,346,49.42857143,1362076882049,1362076900673,2498260153,2498278777,18624
1362076902,2498280112,7,358,51.14285714,1362076887482,1362076897210,2498265594,2498275322,9728
1362076902,2498280136,6,4452,742,1362076883429,1362076895781,2498261565,2498273917,12352
1362076902,2498280140,12,948,79,1362076888543,1362076901087,2498266683,2498279227,12544
1362076902,2498280140,7,352,50.28571429,1362076888542,1362076900766,2498266682,2498278906,12224
1362076902,2498280148,6,306,51,1362076877145,1362076894553,2498255293,2498272701,17408
1362076902,2498280148,5,254,50.8,1362076877400,1362076895576,2498255548,2498273724,18176
1362076902,2498280148,7,358,51.14285714,1362076877399,1362076901591,2498255547,2498279739,24192
1362076902,2498280148,5,254,50.8,1362076877399,1362076895575,2498255547,2498273723,18176
1362076902,2498280148,3,1592,530.6666667,1362076885590,1362076896278,2498263738,2498274426,10688
1362076902,2498280212,1,46,46,1362076877590,1362076877590,2498255802,2498255802,0
1362076902,2498280260,1,46,46,1362076875559,1362076875559,2498253819,2498253819,0
1362076902,2498280348,1,46,46,1362076874641,1362076874641,2498252989,2498252989,0
1362076902,2498280380,1,46,46,1362076875438,1362076875438,2498253818,2498253818,0
1362076906,2498284040,1,46,46,1362076881409,1362076881409,2498259449,2498259449,0
1362076906,2498284044,3,144,48,1362076881281,1362076885441,2498259325,2498263485,4160
1362076906,1136598948,8,553,69.125,1362076904102,1362076905446,1136597050,1136598394,1344
1362076906,1136598972,3,144,48,1362076897227,1362076904139,1136590199,1136597111,6912
1362076910,2498288056,7,352,50.28571429,1362076901811,1362076908723,2498279867,2498286779,6912
1362076910,2498288064,3,150,50,1362076886635,1362076902507,2498264699,2498280571,15872
1362076910,2498288072,13,2413,185.6153846,1362076899301,1362076908389,2498277373,2498286461,9088
1362076910,2498288096,14,2524,180.2857143,1362076899467,1362076909643,2498277563,2498287739,10176
1362076910,2498288096,10,2281,228.1,1362076899594,1362076906634,2498277690,2498284730,7040
1362076910,2498288096,13,2413,185.6153846,1362076899530,1362076909642,2498277626,2498287738,10112
1362076910,2498288108,4,202,50.5,1362076897088,1362076903616,2498275196,2498281724,6528
1362076910,2498288136,4,196,49,1362076900581,1362076906597,2498278717,2498284733,6016
1362076910,2498288136,11,2924,265.8181818,1362076900835,1362076907619,2498278971,2498285755,6784
1362076910,2498288144,6,294,49,1362076898201,1362076905689,2498276345,2498283833,7488
1362076910,2498288152,45,56539,1256.422222,1362076890706,1362076904658,2498268858,2498282810,13952
1362076910,2498288176,5,248,49.6,1362076903035,1362076909627,2498281211,2498287803,6592
1362076910,1136602732,1,46,46,1362076883132,1362076883132,1136575864,1136575864,0
1362076910,1136602760,85,97051,1141.776471,1362076884770,1362076906274,1136577530,1136599034,21504
1362076910,2498288180,10,2269,226.9,1362076899191,1362076908343,2498277371,2498286523,9152
1362076910,2498288184,13,2413,185.6153846,1362076899317,1362076908213,2498277501,2498286397,8896
1362076910,2498288336,5,248,49.6,1362076900698,1362076907418,2498279034,2498285754,6720
1362076910,2498288336,5,242,48.4,1362076900506,1362076907418,2498278842,2498285754,6912
1362076910,2498288340,7,346,49.42857143,1362076901208,1362076908440,2498279548,2498286780,7232
1362076910,2498288340,6,300,50,1362076901272,1362076908440,2498279612,2498286780,7168
1362076910,2498288396,4,1827,456.75,1362076882847,1362076892767,2498261243,2498271163,9920
1362076910,2498288472,12,1055,87.91666667,1362076881682,1362076900690,2498260154,2498279162,19008
1362076910,2498288492,1,46,46,1362076881727,1362076881727,2498260219,2498260219,0
1362076910,2498288508,1,46,46,1362076882864,1362076882864,2498261372,2498261372,0
1362076914,2498291968,1,46,46,1362076886218,1362076886218,2498264186,2498264186,0
1362076914,2498291972,1,46,46,1362076886216,1362076886216,2498264188,2498264188,0
1362076914,2498291972,1,46,46,1362076886534,1362076886534,2498264506,2498264506,0
1362076914,2498291980,1,46,46,1362076886912,1362076886912,2498264892,2498264892,0
1362076914,2498292020,1,46,46,1362076888598,1362076888598,2498266618,2498266618,0
1362076914,1136606712,42,50929,1212.595238,1362076886226,1362076900946,1136578938,1136593658,14720
1362076914,1136606956,3,144,48,1362076900124,1362076906332,1136593080,1136599288,6208
1362076914,1136606956,3,144,48,1362076900124,1362076906332,1136593080,1136599288,6208
1362076914,1136606956,3,150,50,1362076900379,1362076906267,1136593335,1136599223,5888
1362076914,1136606956,3,144,48,1362076900635,1362076907355,1136593591,1136600311,6720
1362076914,1136606960,3,144,48,1362076901401,1362076908313,1136594361,1136601273,6912
1362076914,1136606980,3,150,50,1362076899460,1362076906308,1136592440,1136599288,6848
1362076914,1136606984,2,98,49,1362076900354,1362076906242,1136593338,1136599226,5888
1362076914,1136606984,2,98,49,1362076900290,1362076906242,1136593274,1136599226,5952
1362076914,1136606984,3,144,48,1362076900354,1362076906306,1136593338,1136599290,5952
1362076914,1136606984,3,150,50,1362076900353,1362076906241,1136593337,1136599225,5888
1362076914,1136606984,2,98,49,1362076901120,1362076908288,1136594104,1136601272,7168
1362076918,2498296132,3,138,46,1362076914472,1362076914536,2498292604,2498292668,64
1362076918,2498296168,10,758,75.8,1362076904705,1362076910721,2498282873,2498288889,6016
1362076918,1136610756,1,46,46,1362076892198,1362076892198,1136584954,1136584954,0
1362076918,2498296236,1,46,46,1362076889601,1362076889601,2498267837,2498267837,0
1362076918,2498296284,1,46,46,1362076891533,1362076891533,2498269817,2498269817,0
1362076918,2498296288,1,46,46,1362076892169,1362076892169,2498270457,2498270457,0
1362076918,2498296292,1,46,46,1362076892422,1362076892422,2498270714,2498270714,0
1362076918,2498296412,6,1491,248.5,1362076892685,1362076900429,2498271097,2498278841,7744
1362076922,2498299984,1,46,46,1362076894138,1362076894138,2498272122,2498272122,0
1362076922,2498300068,1,46,46,1362076896870,1362076896870,2498274938,2498274938,0
1362076922,2498300076,13,728,56,1362076897504,1362076918304,2498275580,2498296380,20800
1362076922,2498300080,1,46,46,1362076893979,1362076893979,2498272059,2498272059,0
1362076922,2498300112,11,3077,279.7272727,1362076894588,1362076898236,2498272700,2498276348,3648
1362076922,2498300120,4,2838,709.5,1362076895156,1362076896372,2498273276,2498274492,1216
1362076922,2498300120,1,46,46,1362076895156,1362076895156,2498273276,2498273276,0
1362076922,2498300144,26,30303,1165.5,1362076895705,1362076897561,2498273849,2498275705,1856
1362076922,2498300184,1,46,46,1362076897203,1362076897203,2498275387,2498275387,0
1362076926,2498304056,2,92,46,1362076911731,1362076919731,2498289787,2498297787,8000
1362076926,1136618708,1,46,46,1362076898965,1362076898965,1136591673,1136591673,0
1362076926,2498304176,10,5584,558.4,1362076920892,1362076924092,2498299068,2498302268,3200
1362076926,1136618716,4,435,108.75,1362076900300,1362076903948,1136593016,1136596664,3648
1362076926,1136618728,10,10411,1041.1,1362076900354,1362076903362,1136593082,1136596090,3008
1362076926,2498304176,16,8940,558.75,1362076924089,1362076925433,2498302265,2498303609,1344
1362076926,2498304248,14,3308,236.2857143,1362076901619,1362076904691,2498279867,2498282939,3072
1362076926,2498304252,15,1783,118.8666667,1362076897840,1362076902832,2498276092,2498281084,4992
1362076926,2498304252,19,1064,56,1362076897902,1362076918510,2498276154,2498296762,20608
1362076926,2498304256,17,952,56,1362076898409,1362076918377,2498276665,2498296633,19968
1362076926,2498304288,1,46,46,1362076899084,1362076899084,2498277372,2498277372,0
1362076926,2498304288,1,52,52,1362076899402,1362076899402,2498277690,2498277690,0
1362076926,2498304292,1,52,52,1362076899591,1362076899591,2498277883,2498277883,0
1362076926,2498304336,15,4462,297.4666667,1362076901211,1362076904539,2498279547,2498282875,3328
1362076926,2498304340,14,3713,265.2142857,1362076901334,1362076904726,2498279674,2498283066,3392
1362076926,2498304372,8,595,74.375,1362076898424,1362076899640,2498276796,2498278012,1216
1362076926,2498304372,1,52,52,1362076898677,1362076898677,2498277049,2498277049,0
1362076926,2498304412,8,768,96,1362076899856,1362076917840,2498278268,2498296252,17984
1362076926,2498304412,22,26500,1204.545455,1362076900110,1362076902798,2498278522,2498281210,2688
1362076926,2498304416,3,280,93.33333333,1362076900300,1362076901708,2498278716,2498280124,1408
1362076930,2498307992,11,907,82.45454545,1362076902004,1362076904820,2498279996,2498282812,2816
1362076930,2498307992,2,3000,1500,1362076902193,1362076910065,2498280185,2498288057,7872
1362076930,2498308000,11,3339,303.5454545,1362076902635,1362076905067,2498280635,2498283067,2432
1362076930,2498308040,11,3355,305,1362076903749,1362076905285,2498281789,2498283325,1536
1362076930,2498308080,18,3482,193.4444444,1362076905051,1362076905563,2498283131,2498283643,512
1362076930,2498308084,9,2841,315.6666667,1362076905302,1362076905750,2498283386,2498283834,448
1362076930,2498308092,14,3311,236.5,1362076902032,1362076905040,2498280124,2498283132,3008
1362076930,2498308120,1,46,46,1362076903282,1362076903282,2498281402,2498281402,0
1362076930,2498308124,1,46,46,1362076903470,1362076903470,2498281594,2498281594,0
1362076930,2498308124,23,11965,520.2173913,1362076903470,1362076906030,2498281594,2498284154,2560
1362076930,1136622688,6,728,121.3333333,1362076904423,1362076904999,1136597111,1136597687,576
1362076930,2498308192,1,1500,1500,1362076905196,1362076905196,2498283388,2498283388,0
1362076930,2498308200,1,46,46,1362076905443,1362076905443,2498283643,2498283643,0
1362076934,2498311928,14,5135,366.7857143,1362076926129,1362076932401,2498304057,2498310329,6272
1362076934,2498311928,16,7774,485.875,1362076926129,1362076927345,2498304057,2498305273,1216
1362076934,2498311940,11,4943,449.3636364,1362076927398,1362076932966,2498305338,2498310906,5568
1362076934,2498311940,11,4943,449.3636364,1362076927334,1362076932966,2498305274,2498310906,5632
1362076934,2498312064,11,5775,525,1362076921002,1362076926314,2498299066,2498304378,5312
1362076934,2498312220,1,46,46,1362076906127,1362076906127,2498284347,2498284347,0
1362076934,2498312264,9,3235,359.4444444,1362076907105,1362076907233,2498285369,2498285497,128
1362076938,2498316112,1,46,46,1362076911865,1362076911865,2498289977,2498289977,0
1362076938,2498316152,12,1537,128.0833333,1362076912914,1362076920466,2498291066,2498298618,7552
1362076938,2498316196,1,46,46,1362076910630,1362076910630,2498288826,2498288826,0
1362076938,2498316268,1,46,46,1362076913313,1362076913313,2498291581,2498291581,0
1362076942,2498320064,63,67621,1073.349206,1362076928041,1362076940777,2498306105,2498318841,12736
1362076942,2498320104,10,4228,422.8,1362076932100,1362076937732,2498310204,2498315836,5632
1362076942,2498320104,10,2409,240.9,1362076932099,1362076937795,2498310203,2498315899,5696
1362076942,1136634684,1,46,46,1362076916333,1362076916333,1136609017,1136609017,0
1362076942,1136634684,1,46,46,1362076916461,1362076916461,1136609145,1136609145,0
1362076942,2498320128,9,578,64.22222222,1362076933034,1362076938730,2498311162,2498316858,5696
1362076942,2498320140,6,404,67.33333333,1362076930208,1362076939808,2498308348,2498317948,9600
1362076942,2498320344,1,46,46,1362076917329,1362076917329,2498295673,2498295673,0
1362076942,2498320424,1,46,46,1362076916226,1362076916226,2498294650,2498294650,0
1362076946,2498324092,3,605,201.6666667,1362076918160,1362076918288,2498296252,2498296380,128
1362076946,2498324092,1,46,46,1362076918286,1362076918286,2498296378,2498296378,0
1362076946,2498324136,1,46,46,1362076919842,1362076919842,2498297978,2498297978,0
1362076946,2498324212,1,46,46,1362076918232,1362076918232,2498296444,2498296444,0
1362076946,2498324248,21,13203,628.7142857,1362076920051,1362076927219,2498298299,2498305467,7168
1362076950,2498327952,7,334,47.71428571,1362076942169,1362076949849,2498320121,2498327801,7680
1362076950,2498328128,6,288,48,1362076941994,1362076949674,2498320122,2498327802,7680
1362076950,2498328368,20,8448,422.4,1362076922300,1362076925308,2498300668,2498303676,3008
1362076950,2498328412,7,2656,379.4285714,1362076924237,1362076924429,2498302649,2498302841,192
1362076954,2498332144,13,7897,607.4615385,1362076927322,1362076927962,2498305466,2498306106,640
1362076954,2498332200,3,144,48,1362076925922,1362076926114,2498304122,2498304314,192
1362076954,2498332232,10,6211,621.1,1362076926977,1362076953601,2498305209,2498331833,26624
1362076958,2498335964,3,150,50,1362076950160,1362076956752,2498328124,2498334716,6592
1362076958,2498336064,32,38715,1209.84375,1362076950826,1362076955178,2498328890,2498333242,4352
1362076958,2498336068,13,11874,913.3846154,1362076951461,1362076955045,2498329529,2498333113,3584
1362076958,2498336068,7,4747,678.1428571,1362076951525,1362076957669,2498329593,2498335737,6144
1362076958,2498336068,6,2939,489.8333333,1362076951461,1362076954149,2498329529,2498332217,2688
1362076958,2498336072,7,4210,601.4285714,1362076951457,1362076954209,2498329529,2498332281,2752
1362076958,2498336072,7,2633,376.1428571,1362076951521,1362076955169,2498329593,2498333241,3648
1362076958,2498336072,16,15220,951.25,1362076951457,1362076954977,2498329529,2498333049,3520
1362076958,2498336072,7,4424,632,1362076951456,1362076954208,2498329528,2498332280,2752
1362076958,2498336072,10,6886,688.6,1362076951524,1362076957540,2498329596,2498335612,6016
1362076958,2498336072,7,3458,494,1362076951524,1362076955684,2498329596,2498333756,4160
1362076958,2498336072,5,3354,670.8,1362076951524,1362076955044,2498329596,2498333116,3520
1362076958,2498336140,5,248,49.6,1362076949982,1362076957470,2498328122,2498335610,7488
1362076958,2498336140,5,248,49.6,1362076949981,1362076957341,2498328121,2498335481,7360
1362076958,2498336140,3,150,50,1362076949981,1362076956765,2498328121,2498334905,6784
1362076958,2498336144,5,248,49.6,1362076950298,1362076956826,2498328442,2498334970,6528
1362076958,2498336148,3,144,48,1362076950869,1362076957525,2498329017,2498335673,6656
1362076958,2498336152,9,5254,583.7777778,1362076951378,1362076954130,2498329530,2498332282,2752
1362076958,2498336152,6,2068,344.6666667,1362076951378,1362076954194,2498329530,2498332346,2816
1362076958,2498336152,8,5796,724.5,1362076951442,1362076954322,2498329594,2498332474,2880
1362076958,2498336152,5,2068,413.6,1362076951442,1362076954770,2498329594,2498332922,3328
1362076958,2498336176,8,3964,495.5,1362076951352,1362076954104,2498329528,2498332280,2752
1362076958,2498336176,10,4245,424.5,1362076951420,1362076954748,2498329596,2498332924,3328
1362076958,2498336220,4,343,85.75,1362076953612,1362076953868,2498331832,2498332088,256
1362076958,2498336224,3,150,50,1362076949450,1362076956618,2498327674,2498334842,7168
1362076958,2498336308,3,138,46,1362076931255,1362076931319,2498309563,2498309627,64
1362076958,2498336312,29,1624,56,1362076931635,1362076957619,2498309947,2498335931,25984
1362076958,2498336352,17,952,56,1362076933132,1362076957196,2498311484,2498335548,24064
1362076958,2498336392,14,7068,504.8571429,1362076930148,1362076938020,2498308540,2498316412,7872
1362076958,2498336392,18,5381,298.9444444,1362076930212,1362076936868,2498308604,2498315260,6656
1362076958,2498336392,25,1400,56,1362076930211,1362076957411,2498308603,2498335803,27200
1362076958,2498336436,15,1440,96,1362076931640,1362076957048,2498310076,2498335484,25408
1362076958,2498336464,98,88757,905.6836735,1362076932633,1362076938777,2498311097,2498317241,6144
1362076966,2498344112,3,144,48,1362076953915,1362076962043,2498332027,2498340155,8128
1362076966,2498344112,4,190,47.5,1362076954105,1362076961913,2498332217,2498340025,7808
1362076966,2498344116,3,138,46,1362076958325,1362076962613,2498336441,2498340729,4288
1362076966,2498344156,3,150,50,1362076952525,1362076961741,2498330681,2498339897,9216
1362076966,2498344472,56,63606,1135.821429,1362076939153,1362076957457,2498317625,2498335929,18304
1362076970,2498348120,26,29301,1126.961538,1362076942001,1362076945137,2498320121,2498323257,3136
1362076970,2498348124,73,92396,1265.69863,1362076941996,1362076950828,2498320120,2498328952,8832
1362076970,2498348220,37,47164,1274.702703,1362076941904,1362076943248,2498320124,2498321468,1344
1362076970,2498348220,13,12788,983.6923077,1362076941903,1362076942287,2498320123,2498320507,384
1362076974,2498351952,4,196,49,1362076962777,1362076968985,2498340729,2498346937,6208
1362076974,2498351992,3,150,50,1362076960945,1362076967857,2498338937,2498345849,6912
1362076974,2498351992,4,202,50.5,1362076960945,1362076967857,2498338937,2498345849,6912
1362076974,2498351992,6,294,49,1362076960945,1362076967921,2498338937,2498345913,6976
1362076974,2498351992,5,248,49.6,1362076960945,1362076967857,2498338937,2498345849,6912
1362076974,2498351992,4,202,50.5,1362076961009,1362076967857,2498339001,2498345849,6848
1362076974,2498351996,3,150,50,1362076960940,1362076967852,2498338936,2498345848,6912
1362076974,2498351996,3,150,50,1362076960940,1362076967852,2498338936,2498345848,6912
1362076974,2498351996,3,150,50,1362076960940,1362076967852,2498338936,2498345848,6912
1362076974,2498351996,4,202,50.5,1362076961008,1362076967856,2498339004,2498345852,6848
1362076974,2498351996,3,150,50,1362076961644,1362076967852,2498339640,2498345848,6208
1362076974,2498352084,2,98,49,1362076961556,1362076967764,2498339640,2498345848,6208
1362076974,2498352084,3,150,50,1362076961556,1362076967764,2498339640,2498345848,6208
1362076974,2498352124,5,248,49.6,1362076962607,1362076968751,2498340731,2498346875,6144
1362076974,2498352128,8,525,65.625,1362076967593,1362076972713,2498345721,2498350841,5120
1362076974,2498352132,2,98,49,1362076967588,1362076972708,2498345720,2498350840,5120
1362076974,2498352160,5,242,48.4,1362076960778,1362076967754,2498338938,2498345914,6976
1362076974,2498352160,3,150,50,1362076960778,1362076967690,2498338938,2498345850,6912
1362076974,2498352160,4,202,50.5,1362076960778,1362076967690,2498338938,2498345850,6912
1362076974,2498352164,4,202,50.5,1362076960775,1362076967687,2498338939,2498345851,6912
1362076974,2498352164,4,202,50.5,1362076960775,1362076967687,2498338939,2498345851,6912
1362076974,2498352164,4,202,50.5,1362076960775,1362076967687,2498338939,2498345851,6912
1362076974,2498352164,5,248,49.6,1362076960775,1362076967687,2498338939,2498345851,6912
1362076974,2498352164,4,202,50.5,1362076960775,1362076967687,2498338939,2498345851,6912
1362076974,2498352164,5,248,49.6,1362076960839,1362076967687,2498339003,2498345851,6848
1362076974,2498352168,5,248,49.6,1362076956417,1362076966977,2498334585,2498345145,10560
1362076974,2498352272,1,52,52,1362076947034,1362076947034,2498325306,2498325306,0
1362076974,2498352280,1,52,52,1362076947602,1362076947602,2498325882,2498325882,0
1362076974,2498352324,5,2463,492.6,1362076949350,1362076950054,2498327674,2498328378,704
1362076974,2498352328,1,46,46,1362076949668,1362076949668,2498327996,2498327996,0
1362076974,2498352392,1,52,52,1362076947681,1362076947681,2498326073,2498326073,0
1362076974,2498352436,6,4287,714.5,1362076949239,1362076950263,2498327675,2498328699,1024
1362076978,2498356120,13,14019,1078.384615,1362076950324,1362076950964,2498328444,2498329084,640
1362076978,2498356152,13,11686,898.9230769,1362076951444,1362076954004,2498329596,2498332156,2560
1362076978,2498356240,16,18284,1142.75,1362076951292,1362076953532,2498329532,2498331772,2240
1362076978,2498356240,15,16562,1104.133333,1362076951292,1362076954172,2498329532,2498332412,2880
1362076978,2498356240,14,16320,1165.714286,1362076951292,1362076953276,2498329532,2498331516,1984
1362076978,2498356240,6,2434,405.6666667,1362076951355,1362076953275,2498329595,2498331515,1920
1362076978,2498356240,15,16378,1091.866667,1362076951290,1362076953274,2498329530,2498331514,1984
1362076978,2498356240,15,17790,1186,1362076951354,1362076954490,2498329594,2498332730,3136
1362076978,2498356240,27,19837,734.7037037,1362076951354,1362076959098,2498329594,2498337338,7744
1362076978,2498356272,3,138,46,1362076952346,1362076953562,2498330618,2498331834,1216
1362076982,2498359960,4,196,49,1362076974417,1362076981841,2498352377,2498359801,7424
1362076982,2498359964,2,98,49,1362076974861,1362076981837,2498352825,2498359801,6976
1362076982,2498359964,5,248,49.6,1362076974988,1362076981836,2498352952,2498359800,6848
1362076982,2498360144,3,150,50,1362076974426,1362076981530,2498352570,2498359674,7104
1362076982,2498360148,5,248,49.6,1362076974680,1362076981656,2498352828,2498359804,6976
1362076982,2498360284,19,16637,875.6315789,1362076954575,1362076961487,2498332859,2498339771,6912
1362076982,2498360368,1,46,46,1362076953787,1362076953787,2498332155,2498332155,0
1362076982,2498360388,22,22633,1028.772727,1362076954150,1362076962470,2498332538,2498340858,8320
1362076986,2498364140,22,20220,919.0909091,1362076958045,1362076962397,2498336185,2498340537,4352
1362076986,2498364144,28,28234,1008.357143,1362076958104,1362076984856,2498336248,2498363000,26752
1362076986,2498364144,32,34279,1071.21875,1362076958104,1362076980184,2498336248,2498358328,22080
1362076986,2498364144,13,8303,638.6923077,1362076958104,1362076981400,2498336248,2498359544,23296
1362076986,2498364144,27,26573,984.1851852,1362076958040,1362076980248,2498336184,2498358392,22208
1362076986,2498364144,7,3335,476.4285714,1362076958104,1362076960408,2498336248,2498338552,2304
1362076986,2498364144,21,20230,963.3333333,1362076958040,1362076963224,2498336184,2498341368,5184
1362076986,2498364144,22,17295,786.1363636,1362076958107,1362076981275,2498336251,2498359419,23168
1362076986,2498364144,33,1848,56,1362076958233,1362076985689,2498336377,2498363833,27456
1362076986,2498364144,52,63661,1224.25,1362076958297,1362076984665,2498336441,2498362809,26368
1362076986,2498364144,11,9628,875.2727273,1362076958297,1362076961689,2498336441,2498339833,3392
1362076986,2498364144,30,32581,1086.033333,1362076958296,1362076984472,2498336440,2498362616,26176
1362076986,2498364144,5,304,60.8,1362076958360,1362076959320,2498336504,2498337464,960
1362076986,2498364144,20,19149,957.45,1362076958296,1362076963160,2498336440,2498341304,4864
1362076986,2498364144,7,3452,493.1428571,1362076958296,1362076960856,2498336440,2498339000,2560
1362076986,2498364152,12,3063,255.25,1362076958802,1362076983890,2498336954,2498362042,25088
1362076986,2498364156,1,46,46,1362076959055,1362076959055,2498337211,2498337211,0
1362076986,2498364232,9,3654,406,1362076957953,1362076981313,2498336185,2498359545,23360
1362076986,2498364232,18,15282,849,1362076957953,1362076963649,2498336185,2498341881,5696
1362076986,2498364232,22,26444,1202,1362076957953,1362076962689,2498336185,2498340921,4736
1362076986,2498364232,37,37102,1002.756757,1362076958017,1362076984321,2498336249,2498362553,26304
1362076986,2498364232,6,2120,353.3333333,1362076958017,1362076960321,2498336249,2498338553,2304
1362076986,2498364232,23,21978,955.5652174,1362076958017,1362076963841,2498336249,2498342073,5824
1362076986,2498364232,7,4113,587.5714286,1362076958017,1362076961089,2498336249,2498339321,3072
1362076986,2498364232,6,2440,406.6666667,1362076958017,1362076961153,2498336249,2498339385,3136
1362076986,2498364232,6,2593,432.1666667,1362076958017,1362076960321,2498336249,2498338553,2304
1362076986,2498364232,29,1624,56,1362076958016,1362076985472,2498336248,2498363704,27456
1362076986,2498364236,1,46,46,1362076958076,1362076958076,2498336312,2498336312,0
1362076986,2498364236,15,1440,96,1362076958206,1362076985150,2498336442,2498363386,26944
1362076986,2498364236,9,736,81.77777778,1362076958206,1362076960958,2498336442,2498339194,2752
1362076986,2498364260,16,896,56,1362076958309,1362076985253,2498336569,2498363513,26944
1362076990,2498367980,2,92,46,1362076981950,1362076982910,2498359930,2498360890,960
1362076990,2498367984,3,150,50,1362076982648,1362076988856,2498360632,2498366840,6208
1362076990,2498367988,4,202,50.5,1362076982840,1362076988856,2498360828,2498366844,6016
1362076990,2498367988,3,150,50,1362076982839,1362076988855,2498360827,2498366843,6016
1362076990,2498367992,3,150,50,1362076983411,1362076989875,2498361403,2498367867,6464
1362076990,2498367992,3,150,50,1362076983347,1362076989875,2498361339,2498367867,6528
1362076990,2498367992,4,196,49,1362076983474,1362076989874,2498361466,2498367866,6400
1362076990,2498367996,4,196,49,1362076983855,1362076989871,2498361851,2498367867,6016
1362076990,2498367996,2,98,49,1362076983855,1362076989871,2498361851,2498367867,6016
1362076990,2498368120,5,248,49.6,1362076980722,1362076987762,2498358842,2498365882,7040
1362076990,2498368160,3,150,50,1362076982475,1362076988683,2498360635,2498366843,6208
1362076990,2498368160,3,150,50,1362076982475,1362076988683,2498360635,2498366843,6208
1362076990,2498368164,5,242,48.4,1362076982852,1362076988740,2498361016,2498366904,5888
1362076990,2498368168,3,150,50,1362076983235,1362076989699,2498361403,2498367867,6464
1362076990,2498368188,4,196,49,1362076983596,1362076989676,2498361784,2498367864,6080
1362076990,2498368192,3,150,50,1362076983660,1362076989676,2498361852,2498367868,6016
1362076990,2498368192,3,150,50,1362076983659,1362076989675,2498361851,2498367867,6016
1362076990,2498368296,2,123,61.5,1362076963011,1362076963011,2498341307,2498341307,0
1362076990,2498368296,1,77,77,1362076963011,1362076963011,2498341307,2498341307,0
1362076990,2498368328,3,169,56.33333333,1362076963875,1362076963939,2498342203,2498342267,64
1362076990,2498368328,2,123,61.5,1362076963875,1362076963875,2498342203,2498342203,0
1362076990,2498368356,2,154,77,1362076964872,1362076965832,2498343228,2498344188,960
1362076990,2498368404,2,123,61.5,1362076962902,1362076962902,2498341306,2498341306,0
1362076990,2498368404,3,169,56.33333333,1362076962902,1362076963478,2498341306,2498341882,576
1362076990,2498368404,2,123,61.5,1362076962902,1362076962902,2498341306,2498341306,0
1362076990,2498368436,1,77,77,1362076963766,1362076963766,2498342202,2498342202,0
1362076994,2498372156,3,169,56.33333333,1362076966028,1362076966092,2498344184,2498344248,64
1362076994,2498372280,2,92,46,1362076966544,1362076966608,2498344824,2498344888,64
1362076998,2498376008,2,98,49,1362076990113,1362076995873,2498368121,2498373881,5760
1362076998,2498376008,5,527,105.4,1362076990176,1362076990496,2498368184,2498368504,320
1362076998,2498376152,2,98,49,1362076985362,1362076990674,2498363514,2498368826,5312
1362076998,2498376152,2,98,49,1362076985489,1362076990673,2498363641,2498368825,5184
1362076998,2498376184,4,396,99,1362076990065,1362076995697,2498368249,2498373881,5632
1362076998,2498376188,7,328,46.85714286,1362076986158,1362076994094,2498364346,2498372282,7936
1362076998,2498376256,3,144,48,1362076985322,1362076990634,2498363578,2498368890,5312
1362076998,2498376256,3,144,48,1362076985322,1362076990570,2498363578,2498368826,5248
1362076998,1136690828,2,92,46,1362076972511,1362076972575,1136665339,1136665403,64
1362076998,2498376500,60,41945,699.0833333,1362076973237,1362076997557,2498351737,2498376057,24320
1362077002,2498380180,5,370,74,1362076974005,1362076974261,2498352185,2498352441,256
1362077002,2498380180,4,734,183.5,1362076974005,1362076974133,2498352185,2498352313,128
1362077002,2498380188,4,714,178.5,1362076974383,1362076974831,2498352571,2498353019,448
1362077002,2498380192,5,1817,363.4,1362076974761,1362076975145,2498352953,2498353337,384
1362077002,2498380276,22,26914,1223.363636,1362076974292,1362076979796,2498352568,2498358072,5504
1362077002,2498380356,1,46,46,1362076977284,1362076977284,2498355640,2498355640,0
1362077002,1136694944,4,190,47.5,1362076990249,1362076995625,1136683193,1136688569,5376
1362077002,1136694956,6,282,47,1362076990684,1362076997276,1136683640,1136690232,6592
1362077006,2498384188,3,350,116.6666667,1362076998061,1362077003693,2498376249,2498381881,5632
1362077006,2498384188,7,340,48.57142857,1362076998061,1362077005485,2498376249,2498383673,7424
1362077006,2498384188,6,573,95.5,1362076998060,1362076998892,2498376248,2498377080,832
1362077006,2498384340,14,5842,417.2857143,1362076979094,1362076981846,2498357434,2498360186,2752
1362077006,2498384344,24,24173,1007.208333,1362076979216,1362076986192,2498357560,2498364536,6976
1362077006,2498384348,42,56808,1352.571429,1362076979724,1362076980236,2498358072,2498358584,512
1362077006,2498384432,9,6956,772.8888889,1362076979000,1362076979192,2498357432,2498357624,192
1362077006,2498384440,4,344,86,1362076979315,1362076979571,2498357755,2498358011,256
1362077006,2498384476,6,447,74.5,1362076980366,1362076982606,2498358842,2498361082,2240
1362077010,2498388404,21,16750,797.6190476,1362076984790,1362076985814,2498363194,2498364218,1024
1362077010,2498388404,4,546,136.5,1362076985045,1362076985301,2498363449,2498363705,256
1362077010,2498388408,2,92,46,1362076985424,1362076985488,2498363832,2498363896,64
1362077010,2498388444,7,1632,233.1428571,1362076981807,1362076983983,2498360251,2498362427,2176
1362077010,2498388444,1,46,46,1362076982060,1362076982060,2498360504,2498360504,0
1362077010,2498388448,12,2546,212.1666667,1362076982056,1362076997864,2498360504,2498376312,15808
1362077010,2498388452,1,46,46,1362076982311,1362076982311,2498360763,2498360763,0
1362077010,2498388452,1,46,46,1362076982311,1362076982311,2498360763,2498360763,0
1362077010,2498388552,4,546,136.5,1362076984896,1362076985088,2498363448,2498363640,192
1362077010,2498388556,24,29948,1247.833333,1362076985085,1362076998013,2498363641,2498376569,12928
1362077010,2498388560,4,318,79.5,1362076985080,1362076989624,2498363640,2498368184,4544
1362077014,2498392068,4,190,47.5,1362076999462,1362077009894,2498377530,2498387962,10432
1362077014,2498392068,3,144,48,1362076999462,1362077009318,2498377530,2498387386,9856
1362077014,2498392264,7,340,48.57142857,1362076999265,1362077009633,2498377529,2498387897,10368
1362077014,2498392268,3,138,46,1362077007391,1362077009375,2498385659,2498387643,1984
1362077014,2498392320,2,92,46,1362077013543,1362077013543,2498391863,2498391863,0
1362077014,2498392348,33,1848,56,1362076985997,1362077012813,2498364345,2498391161,26816
1362077014,2498392352,36,2016,56,1362076986059,1362077013451,2498364411,2498391803,27392
1362077014,2498392352,18,1728,96,1362076986186,1362077013514,2498364538,2498391866,27328
1362077014,2498392352,12,9964,830.3333333,1362076986249,1362076987337,2498364601,2498365689,1088
1362077014,2498392356,6,2727,454.5,1362076986501,1362076986757,2498364857,2498365113,256
1362077014,2498392392,6,2045,340.8333333,1362076988000,1362077012576,2498366392,2498390968,24576
1362077014,2498392436,2,92,46,1362076989301,1362076989429,2498367737,2498367865,128
1362077014,2498392440,3,138,46,1362076989299,1362076989427,2498367739,2498367867,128
1362077014,2498392440,1,46,46,1362076989490,1362076989490,2498367930,2498367930,0
1362077014,2498392440,1,46,46,1362076989489,1362076989489,2498367929,2498367929,0
1362077014,2498392440,5,3329,665.8,1362076989489,1362076989489,2498367929,2498367929,0
1362077014,2498392440,7,2919,417,1362076989553,1362076997937,2498367993,2498376377,8384
1362077014,2498392468,18,1008,56,1362076986260,1362077013652,2498364728,2498392120,27392
1362077014,2498392472,10,4565,456.5,1362076986513,1362076986769,2498364985,2498365241,256
1362077014,2498392544,3,138,46,1362076989193,1362076989257,2498367737,2498367801,64
1362077014,2498392544,2,92,46,1362076989193,1362076989321,2498367737,2498367865,128
1362077018,1136710776,4,641,160.25,1362076990289,1362076990481,1136683065,1136683257,192
1362077018,2498396232,2,251,125.5,1362076990273,1362076990401,2498368505,2498368633,128
1362077018,2498396316,12,1890,157.5,1362076989806,1362076998126,2498368122,2498376442,8320
1362077022,2498400232,2,92,46,1362077019650,1362077019650,2498397882,2498397882,0
1362077022,2498400236,2,92,46,1362077016703,1362077016703,2498394939,2498394939,0
1362077022,2498400244,4,190,47.5,1362077012533,1362077019317,2498390777,2498397561,6784
1362077022,2498400244,2,98,49,1362077012789,1362077018677,2498391033,2498396921,5888
1362077026,2498404280,6,1246,207.6666667,1362076999247,1362077023887,2498377527,2498402167,24640
1362077026,2498404280,4,544,136,1362076999250,1362076999506,2498377530,2498377786,256
1362077026,2498404280,6,1246,207.6666667,1362076999250,1362077025106,2498377530,2498403386,25856
1362077026,2498404340,5,654,130.8,1362076997908,1362076998676,2498376248,2498377016,768
1362077030,2498408040,2,92,46,1362077013954,1362077024322,2498391994,2498402362,10368
1362077030,2498408056,7,922,131.7142857,1362077023921,1362077027569,2498401977,2498405625,3648
1362077030,2498408084,4,481,120.25,1362077025044,1362077025300,2498403128,2498403384,256
1362077030,2498408088,7,643,91.85714286,1362077025234,1362077029138,2498403322,2498407226,3904
1362077030,2498408264,12,1238,103.1666667,1362077019938,1362077024546,2498398202,2498402810,4608
1362077038,2498416060,4,396,99,1362077027116,1362077032940,2498405176,2498411000,5824
1362077038,2498416184,4,396,99,1362077025135,1362077031215,2498403319,2498409399,6080
1362077042,1136734812,2,92,46,1362077017580,1362077018028,1136710392,1136710840,448
1362077042,1136734816,9,1094,121.5555556,1362077017642,1362077020074,1136710458,1136712890,2432
1362077042,2498420304,25,2400,96,1362077014586,1362077041594,2498392890,2498419898,27008
1362077042,2498420388,47,2632,56,1362077013797,1362077041765,2498392185,2498420153,27968
1362077042,2498420392,45,2520,56,1362077013987,1362077041059,2498392379,2498419451,27072
1362077042,2498420432,22,1232,56,1362077015607,1362077041655,2498394039,2498420087,26048
1362077042,2498420468,4,382,95.5,1362077016534,1362077016854,2498395002,2498395322,320
1362077046,2498424064,4,184,46,1362077043241,1362077043817,2498421305,2498421881,576
1362077046,2498424064,5,230,46,1362077043241,1362077044265,2498421305,2498422329,1024
1362077046,2498424068,3,138,46,1362077040227,1362077041251,2498418295,2498419319,1024
1362077046,2498424144,3,138,46,1362077040154,1362077041178,2498418298,2498419322,1024
1362077046,1136738788,2,92,46,1362077019588,1362077019844,1136712376,1136712632,256
1362077046,1136738788,1,46,46,1362077019588,1362077019588,1136712376,1136712376,0
1362077046,2498424352,2,123,61.5,1362077021576,1362077021832,2498399928,2498400184,256
1362077046,2498424352,2,123,61.5,1362077021576,1362077045832,2498399928,2498424184,24256
1362077046,2498424352,2,123,61.5,1362077021576,1362077021832,2498399928,2498400184,256
1362077046,2498424448,2,92,46,1362077021418,1362077025962,2498399866,2498404410,4544
1362077046,2498424448,1,77,77,1362077021482,1362077021482,2498399930,2498399930,0
1362077046,2498424448,1,77,77,1362077021481,1362077021481,2498399929,2498399929,0
1362077046,2498424484,5,279,55.8,1362077018438,1362077019334,2498396922,2498397818,896
1362077046,2498424484,2,123,61.5,1362077018437,1362077018437,2498396921,2498396921,0
1362077046,2498424528,2,473,236.5,1362077020248,1362077020376,2498398776,2498398904,128
1362077050,2498428336,4,233,58.25,1362077022616,1362077023384,2498400952,2498401720,768
1362077050,2498428420,4,1827,456.75,1362077025603,1362077025923,2498404023,2498404343,320
1362077050,2498428448,3,206,68.66666667,1362077022504,1362077023080,2498400952,2498401528,576
1362077050,2498428448,3,181,60.33333333,1362077022504,1362077023272,2498400952,2498401720,768
1362077050,2498428488,3,181,60.33333333,1362077024067,1362077024323,2498402555,2498402811,256
1362077050,2498428492,2,123,61.5,1362077024446,1362077024638,2498402938,2498403130,192
1362077054,2498432080,2,98,49,1362077046106,1362077052122,2498424186,2498430202,6016
1362077054,2498432128,4,196,49,1362077044714,1362077051178,2498422842,2498429306,6464
1362077054,2498432128,3,144,48,1362077044968,1362077051176,2498423096,2498429304,6208
1362077054,2498432160,5,443,88.6,1362077046025,1362077046601,2498424185,2498424761,576
1362077054,2498432160,2,94,47,1362077046025,1362077052041,2498424185,2498430201,6016
1362077054,2498432328,4,196,49,1362077045090,1362077052578,2498423418,2498430906,7488
1362077054,2498432332,4,190,47.5,1362077045342,1362077051998,2498423674,2498430330,6656
1362077054,2498432424,4,1636,409,1362077027970,1362077029634,2498406394,2498408058,1664
1362077054,2498432488,2,98,49,1362077029632,1362077029696,2498408120,2498408184,64
1362077054,2498432544,1,46,46,1362077028106,1362077028106,2498406650,2498406650,0
1362077058,1136750944,3,144,48,1362077046378,1362077054378,1136739322,1136747322,8000
1362077058,1136750956,2,98,49,1362077046685,1362077052829,1136739641,1136745785,6144
1362077058,1136750972,2,98,49,1362077044559,1362077050831,1136737531,1136743803,6272
1362077058,1136750972,2,98,49,1362077044623,1362077050831,1136737595,1136743803,6208
1362077058,1136750972,3,144,48,1362077044942,1362077051342,1136737914,1136744314,6400
1362077058,1136750972,4,190,47.5,1362077045198,1362077051790,1136738170,1136744762,6592
1362077058,2498436556,2,674,337,1362077033083,1362077045051,2498411639,2498423607,11968
1362077062,2498440216,4,184,46,1362077055057,1362077058449,2498433273,2498436665,3392
1362077062,2498440352,3,138,46,1362077052872,1362077054920,2498431224,2498433272,2048
1362077062,2498440372,3,138,46,1362077053875,1362077054579,2498432247,2498432951,704
1362077062,2498440496,4,184,46,1362077033850,1362077034426,2498412346,2498412922,576
1362077062,2498440496,4,184,46,1362077033913,1362077034425,2498412409,2498412921,512
1362077066,2498444448,2,92,46,1362077038440,1362077039272,2498416888,2498417720,832
1362077070,1136763096,14,12588,899.1428571,1362077044178,1362077046098,1136737274,1136739194,1920
1362077070,2498448524,48,2688,56,1362077041883,1362077069211,2498420407,2498447735,27328
1362077070,2498448524,13,1287,99,1362077045597,1362077046621,2498424121,2498425145,1024
1362077070,2498448528,43,2408,56,1362077042329,1362077068825,2498420857,2498447353,26496
1362077070,2498448528,19,1824,96,1362077042455,1362077068951,2498420983,2498447479,26496
1362077071,2498448652,20,1120,56,1362077043461,1362077069893,2498421113,2498447545,26432
1362077071,2498448684,6,3165,527.5,1362077044261,1362077047269,2498421945,2498424953,3008
1362077071,2498448688,5,3235,647,1362077044514,1362077046370,2498422202,2498424058,1856
1362077074,2498452328,3,212,70.66666667,1362077045858,1362077045922,2498424186,2498424250,64
1362077074,2498452332,2,446,223,1362077046045,1362077046109,2498424377,2498424441,64
1362077074,2498452448,3,138,46,1362077046632,1362077046760,2498425080,2498425208,128
1362077078,2498456600,4,274,68.5,1362077077455,1362077077455,2498456055,2498456055,0
1362077079,2498456868,8,1190,148.75,1362077052716,1362077058412,2498430584,2498436280,5696
1362077082,2498460520,1,46,46,1362077055392,1362077055392,2498433912,2498433912,0
1362077086,2498464240,2,92,46,1362077078970,1362077079930,2498457210,2498458170,960
1362077086,2498464244,9,510,56.66666667,1362077082868,1362077085044,2498461112,2498463288,2176
1362077086,2498464360,8,404,50.5,1362077080577,1362077084929,2498458937,2498463289,4352
1362077086,2498464360,9,510,56.66666667,1362077080704,1362077084032,2498459064,2498462392,3328
1362077086,2498464360,9,450,50,1362077080575,1362077085631,2498458935,2498463991,5056
1362077086,2498464364,7,412,58.85714286,1362077080702,1362077083902,2498459066,2498462266,3200
1362077086,2498464372,19,1000,52.63157895,1362077081782,1362077085302,2498460154,2498463674,3520
1362077086,2498464400,8,380,47.5,1362077077912,1362077078808,2498456312,2498457208,896
1362077086,2498464404,9,522,58,1362077082195,1362077085267,2498460599,2498463671,3072
1362077086,2498464444,9,510,56.66666667,1362077080619,1362077083947,2498459063,2498462391,3328
1362077086,2498464448,9,510,56.66666667,1362077080618,1362077083626,2498459066,2498462074,3008
1362077086,2498464448,9,638,70.88888889,1362077084200,1362077085416,2498462648,2498463864,1216
1362077086,2498464480,19,1000,52.63157895,1362077081673,1362077085129,2498460153,2498463609,3456
1362077090,2498468456,2,92,46,1362077065762,1362077066466,2498444218,2498444922,704
1362077094,2498472232,6,343,57.16666667,1362077086143,1362077087487,2498464375,2498465719,1344
1362077094,2498472232,7,352,50.28571429,1362077082111,1362077090495,2498460343,2498468727,8384
1362077094,2498472232,7,352,50.28571429,1362077082111,1362077090495,2498460343,2498468727,8384
1362077094,2498472236,2,92,46,1362077086460,1362077088508,2498464696,2498466744,2048
1362077094,2498472240,7,346,49.42857143,1362077082362,1362077090682,2498460602,2498468922,8320
1362077094,2498472240,2,92,46,1362077090487,1362077090935,2498468727,2498469175,448
1362077094,2498472240,3,138,46,1362077090487,1362077091895,2498468727,2498470135,1408
1362077094,2498472352,9,444,49.33333333,1362077080136,1362077091720,2498458488,2498470072,11584
1362077094,2498472360,7,358,51.14285714,1362077084097,1362077089409,2498462457,2498467769,5312
1362077094,2498472360,10,502,50.2,1362077081152,1362077090496,2498459512,2498468856,9344
1362077094,2498472360,10,502,50.2,1362077081152,1362077090496,2498459512,2498468856,9344
1362077094,2498472360,10,502,50.2,1362077081152,1362077090560,2498459512,2498468920,9408
1362077094,2498472360,4,196,49,1362077081216,1362077090432,2498459576,2498468792,9216
1362077094,2498472396,6,300,50,1362077082203,1362077090331,2498460599,2498468727,8128
1362077094,2498472444,4,196,49,1362077081066,1362077090346,2498459510,2498468790,9280
1362077094,2498472444,4,196,49,1362077081130,1362077090282,2498459574,2498468726,9152
1362077094,2498472448,4,196,49,1362077081066,1362077090218,2498459514,2498468666,9152
1362077094,2498472448,9,456,50.66666667,1362077081129,1362077090281,2498459577,2498468729,9152
1362077094,2498472600,37,2072,56,1362077069582,1362077093454,2498448182,2498472054,23872
1362077095,2498472688,1,337,337,1362077069920,1362077069920,2498447608,2498447608,0
1362077098,2498476464,22,2112,96,1362077070105,1362077097369,2498448569,2498475833,27264
1362077098,2498476488,44,2464,56,1362077070785,1362077097217,2498449273,2498475705,26432
1362077098,2498476496,23,1288,56,1362077071480,1362077097592,2498449976,2498476088,26112
1362077102,2498480240,7,334,47.71428571,1362077095546,1362077097274,2498473786,2498475514,1728
1362077102,2498480240,6,282,47,1362077095482,1362077097146,2498473722,2498475386,1664
1362077102,2498480240,7,643,91.85714286,1362077087609,1362077094521,2498465849,2498472761,6912
1362077102,2498480240,5,448,89.6,1362077087863,1362077097015,2498466103,2498475255,9152
1362077102,2498480376,2,92,46,1362077099376,1362077100144,2498477752,2498478520,768
1362077102,2498480380,2,92,46,1362077088366,1362077096622,2498466746,2498475002,8256
1362077102,2498480384,7,352,50.28571429,1362077080810,1362077099370,2498459194,2498477754,18560
1362077102,2498480384,7,352,50.28571429,1362077080808,1362077099432,2498459192,2498477816,18624
1362077102,2498480388,4,190,47.5,1362077100325,1362077101157,2498478713,2498479545,832
1362077102,2498480460,4,402,100.5,1362077088350,1362077096798,2498466810,2498475258,8448
1362077102,2498480460,3,350,116.6666667,1362077088539,1362077096795,2498466999,2498475255,8256
1362077102,2498480464,7,352,50.28571429,1362077080728,1362077099352,2498459192,2498477816,18624
1362077102,2498480472,3,144,48,1362077101264,1362077101584,2498479736,2498480056,320
1362077102,2498480528,2,92,46,1362077077719,1362077078743,2498456247,2498457271,1024
1362077102,2498480584,1,46,46,1362077075680,1362077075680,2498454264,2498454264,0
1362077102,2498480616,1,46,46,1362077076609,1362077076609,2498455225,2498455225,0
1362077102,2498480616,1,46,46,1362077076609,1362077076609,2498455225,2498455225,0
1362077103,2498480620,3,144,48,1362077077605,1362077079013,2498455225,2498456633,1408
1362077103,2498480628,2,129,64.5,1362077078429,1362077078877,2498456057,2498456505,448
1362077103,2498480628,2,92,46,1362077078618,1362077079578,2498456246,2498457206,960
1362077103,2498480700,2,92,46,1362077076502,1362077077142,2498454202,2498454842,640
1362077103,2498480700,1,46,46,1362077076563,1362077076563,2498454263,2498454263,0
1362077103,2498480700,2,92,46,1362077076563,1362077077203,2498454263,2498454903,640
1362077103,2498480716,1,46,46,1362077077509,1362077077509,2498455225,2498455225,0
1362077106,2498484408,1,46,46,1362077078801,1362077078801,2498457209,2498457209,0
1362077106,2498484408,2,92,46,1362077078801,1362077079825,2498457209,2498458233,1024
1362077106,2498484436,33,41544,1258.909091,1362077079796,1362077085556,2498458232,2498463992,5760
1362077106,2498484440,2,92,46,1362077079793,1362077080561,2498458233,2498459001,768
1362077106,2498484440,14,7377,526.9285714,1362077080112,1362077082992,2498458552,2498461432,2880
1362077106,2498484464,43,42219,981.8372093,1362077080728,1362077092824,2498459192,2498471288,12096
1362077106,2498484468,36,34074,946.5,1362077080725,1362077092245,2498459193,2498470713,11520
1362077106,2498484468,10,6652,665.2,1362077080789,1362077090005,2498459257,2498468473,9216
1362077106,2498484520,1,46,46,1362077078686,1362077078686,2498457206,2498457206,0
1362077106,2498484556,62,83410,1345.322581,1362077079678,1362077088702,2498458234,2498467258,9024
1362077106,2498484556,7,5811,830.1428571,1362077079868,1362077081148,2498458424,2498459704,1280
1362077106,2498484564,9,6364,707.1111111,1362077080627,1362077086963,2498459191,2498465527,6336
1362077106,2498484564,10,6392,639.2,1362077080627,1362077089587,2498459191,2498468151,8960
1362077106,2498484568,48,52582,1095.458333,1362077080626,1362077092018,2498459194,2498470586,11392
1362077106,2498484568,28,29340,1047.857143,1362077080626,1362077089970,2498459194,2498468538,9344
1362077106,2498484592,8,5298,662.25,1362077080601,1362077089689,2498459193,2498468281,9088
1362077110,2498488236,6,288,48,1362077102268,1362077104316,2498480504,2498482552,2048
1362077110,2498488240,3,138,46,1362077102520,1362077104184,2498480760,2498482424,1664
1362077110,2498488240,2,92,46,1362077102584,1362077104184,2498480824,2498482424,1600
1362077110,2498488400,4,184,46,1362077101785,1362077103961,2498480185,2498482361,2176
1362077110,2498488404,520,739820,1422.730769,1362076974037,1362077104661,2498352441,2498483065,130624
1362077110,2498488404,5,236,47.2,1362077102227,1362077103827,2498480631,2498482231,1600
1362077110,2498488408,2,92,46,1362077102418,1362077104018,2498480826,2498482426,1600
1362077110,2498488444,107,141348,1321.009346,1362076979693,1362077104621,2498358137,2498483065,124928
1362077110,2498488444,3,138,46,1362077105260,1362077109420,2498483704,2498487864,4160
1362077110,2498488520,1,46,46,1362077085730,1362077085730,2498464250,2498464250,0
1362077114,2498492424,7,2474,353.4285714,1362077086015,1362077088639,2498464439,2498467063,2624
1362077114,2498492468,5,1688,337.6,1362077087442,1362077089170,2498465910,2498467638,1728
1362077114,2498492512,8,1774,221.75,1362077089127,1362077102759,2498467639,2498481271,13632
1362077114,2498492524,1,46,46,1362077085916,1362077085916,2498464440,2498464440,0
1362077114,2498492524,1,46,46,1362077086043,1362077086043,2498464567,2498464567,0
1362077122,2498500504,2,92,46,1362077095217,1362077096369,2498473721,2498474873,1152
1362077122,2498500504,1,46,46,1362077095217,1362077095217,2498473721,2498473721,0
1362077122,2498500512,1,46,46,1362077096230,1362077096230,2498474742,2498474742,0
1362077122,2498500512,1,46,46,1362077096230,1362077096230,2498474742,2498474742,0
1362077122,2498500512,2,92,46,1362077096230,1362077096678,2498474742,2498475190,448
1362077122,2498500516,1,46,46,1362077096357,1362077096357,2498474873,2498474873,0
1362077122,2498500588,25,1400,56,1362077094045,1362077108253,2498472633,2498486841,14208
1362077123,2498500636,1,46,46,1362077097044,1362077097044,2498474680,2498474680,0
1362077123,2498500636,2,92,46,1362077097108,1362077097492,2498474744,2498475128,384
1362077123,2498500636,1,46,46,1362077097108,1362077097108,2498474744,2498474744,0
1362077123,2498500636,1,46,46,1362077097234,1362077097234,2498474870,2498474870,0
1362077123,2498500672,2,92,46,1362077098033,1362077098097,2498475705,2498475769,64
1362077126,2498504532,1,46,46,1362077098517,1362077098517,2498477049,2498477049,0
1362077126,2498504532,11,1056,96,1362077098643,1362077125459,2498477175,2498503991,26816
1362077126,2498504568,10,560,56,1362077099438,1362077125486,2498478006,2498504054,26048
1362077126,2498504572,1,46,46,1362077099886,1362077099886,2498478458,2498478458,0
1362077126,2498504572,1,46,46,1362077100075,1362077100075,2498478647,2498478647,0
1362077126,2498504600,1,46,46,1362077101134,1362077101134,2498479734,2498479734,0
1362077126,2498504612,23,1288,56,1362077097733,1362077125701,2498476345,2498504313,27968
1362077127,2498504640,2,92,46,1362077099089,1362077099089,2498476729,2498476729,0
1362077127,2498504644,1,46,46,1362077099406,1362077099406,2498477050,2498477050,0
1362077127,2498504652,1,46,46,1362077100037,1362077100037,2498477689,2498477689,0
1362077127,2498504652,1,46,46,1362077100037,1362077100037,2498477689,2498477689,0
1362077127,2498504692,4,196,49,1362077102043,1362077104603,2498479735,2498482295,2560
1362077130,2498508468,1,46,46,1362077102036,1362077102036,2498480504,2498480504,0
1362077130,2498508516,2,123,61.5,1362077104101,1362077104101,2498482617,2498482617,0
1362077130,2498508552,1,46,46,1362077101950,1362077101950,2498480502,2498480502,0
1362077130,2498508556,2,92,46,1362077102139,1362077103867,2498480695,2498482423,1728
1362077130,1136823116,3892,5362955,1377.943217,1362076990526,1362077128190,1136683642,1136821306,137664
1362077131,2498508632,2,92,46,1362077106070,1362077106134,2498483702,2498483766,64
1362077131,2498508636,1,46,46,1362077106069,1362077106069,2498483705,2498483705,0
1362077134,2498512252,3,144,48,1362077128045,1362077133549,2498506297,2498511801,5504
1362077134,2498512276,6,573,95.5,1362077129363,1362077129555,2498507639,2498507831,192
1362077134,2498512284,4,196,49,1362077125261,1362077130509,2498503545,2498508793,5248
1362077134,1136827072,2,92,46,1362077106218,1362077106474,1136799290,1136799546,256
1362077138,2498516516,1,46,46,1362077109923,1362077109923,2498488439,2498488439,0
1362077138,1136831104,2,98,49,1362077129291,1362077135243,1136822395,1136828347,5952
1362077139,2498516684,1,46,46,1362077112930,1362077112930,2498490614,2498490614,0
1362077142,2498520280,6,573,95.5,1362077137293,1362077137485,2498515573,2498515765,192
1362077142,2498520280,8,458,57.25,1362077137361,1362077137425,2498515641,2498515705,64
1362077142,2498520604,1,337,337,1362077117005,1362077117005,2498495609,2498495609,0
1362077142,2498520612,1,46,46,1362077113987,1362077113987,2498492599,2498492599,0
1362077146,1136839116,4,190,47.5,1362077137152,1362077142336,1136830268,1136835452,5184
1362077146,2498524588,2,92,46,1362077120155,1362077120539,2498498743,2498499127,384
1362077147,2498524628,1,46,46,1362077122651,1362077122651,2498500279,2498500279,0
1362077150,2498528252,9,444,49.33333333,1362077138219,1362077148203,2498516471,2498526455,9984
1362077150,2498528264,8,392,49,1362077139105,1362077149601,2498517369,2498527865,10496
1362077150,2498528264,2,92,46,1362077143326,1362077147870,2498521590,2498526134,4544
1362077150,2498528268,66,59692,904.4242424,1362077139739,1362077147931,2498518007,2498526199,8192
1362077150,2498528332,9,444,49.33333333,1362077138140,1362077148124,2498516472,2498526456,9984
1362077150,2498528344,2,92,46,1362077143245,1362077149197,2498521589,2498527541,5952
1362077150,2498528544,2,92,46,1362077122185,1362077122441,2498500729,2498500985,256
1362077150,2498528544,1,46,46,1362077122248,1362077122248,2498500792,2498500792,0
1362077150,2498528620,1,46,46,1362077124604,1362077124604,2498503224,2498503224,0
1362077150,2498528620,15,2749,183.2666667,1362077124668,1362077137596,2498503288,2498516216,12928
1362077151,2498528660,2,92,46,1362077123321,1362077123385,2498500981,2498501045,64
1362077151,2498528696,17,952,56,1362077124758,1362077147286,2498502454,2498524982,22528
1362077154,2498532580,15,840,56,1362077127460,1362077147876,2498506040,2498526456,20416
1362077154,2498532580,8,768,96,1362077127586,1362077148642,2498506166,2498527222,21056
1362077155,2498532676,7,392,56,1362077128619,1362077144107,2498506295,2498521783,15488
1362077155,2498532708,3,620,206.6666667,1362077129995,1362077130059,2498507703,2498507767,64
1362077158,2498536588,2,92,46,1362077132187,1362077132251,2498510775,2498510839,64
1362077162,2498540612,5,1101,220.2,1362077137541,1362077137733,2498516153,2498516345,192
1362077162,2498540612,5,747,149.4,1362077137539,1362077137859,2498516151,2498516471,320
1362077163,2498540692,3,620,206.6666667,1362077137947,1362077138011,2498515639,2498515703,64
1362077163,2498540696,4,723,180.75,1362077138453,1362077138901,2498516149,2498516597,448
1362077166,2498544304,2,92,46,1362077152695,1362077162295,2498530999,2498540599,9600
1362077166,2498544384,3,144,48,1362077152871,1362077158119,2498531255,2498536503,5248
1362077166,2498544580,13,2612,200.9230769,1362077138788,1362077161252,2498517368,2498539832,22464
1362077166,2498544580,3,138,46,1362077139042,1362077139554,2498517622,2498518134,512
1362077166,2498544580,2,92,46,1362077139042,1362077139554,2498517622,2498518134,512
1362077166,2498544612,4,538,134.5,1362077139585,1362077140289,2498518197,2498518901,704
1362077166,2498544616,5,3726,745.2,1362077140159,1362077140351,2498518775,2498518967,192
1362077167,2498544648,2,92,46,1362077141960,1362077141960,2498519608,2498519608,0
1362077167,2498544680,21,3838,182.7619048,1362077139494,1362077165926,2498517174,2498543606,26432
1362077179,2498556632,2,92,46,1362077153557,1362077154453,2498531189,2498532085,896
1362077179,2498556656,3,1465,488.3333333,1362077153598,1362077153662,2498531254,2498531318,64
1362077179,2498556660,21,21516,1024.571429,1362077153724,1362077153980,2498531384,2498531640,256
1362077183,2498560636,1,46,46,1362077156629,1362077156629,2498534265,2498534265,0
1362077183,2498560636,1,46,46,1362077156564,1362077156564,2498534200,2498534200,0
1362077183,2498560644,21,1176,56,1362077157129,1362077171401,2498534773,2498549045,14272
1362077183,2498560672,10,960,96,1362077157744,1362077171184,2498535416,2498548856,13440
1362077183,2498560752,11,616,56,1362077156895,1362077171231,2498534647,2498548983,14336
1362077183,2498560756,20,1120,56,1362077157147,1362077171611,2498534903,2498549367,14464
1362077187,1136879252,1,46,46,1362077162656,1362077162656,1136854908,1136854908,0
1362077187,2498564844,1,46,46,1362077162498,1362077162498,2498540342,2498540342,0
1362077187,2498564848,2,92,46,1362077162496,1362077162688,2498540344,2498540536,192
1362077191,2498568772,1,77,77,1362077162890,1362077162890,2498540662,2498540662,0
1362077191,2498568792,1,46,46,1362077163128,1362077163128,2498540920,2498540920,0
1362077195,2498572860,7,1146,163.7142857,1362077169585,1362077189361,2498547445,2498567221,19776
1362077199,2498576796,3,544,181.3333333,1362077171827,1362077171891,2498549623,2498549687,64
1362077202,1136895096,120,167368,1394.733333,1362077044181,1362077196757,1136737277,1136889853,152576
1362077206,2498584300,219,267141,1219.821918,1362077080188,1362077201148,2498458488,2498579448,120960
1362077206,2498584364,2443,3442149,1408.984445,1362077154362,1362077200634,2498532726,2498578998,46272
1362077206,2498584416,2653,3690943,1391.233698,1362077137736,1362077198152,2498516152,2498576568,60416
1362077207,2498584804,5,1292,258.4,1362077180396,1362077191404,2498558200,2498569208,11008
1362077211,2498588760,1,46,46,1362077186518,1362077186518,2498564278,2498564278,0
1362077214,2498592296,6,294,49,1362077206591,1362077213631,2498584887,2498591927,7040
1362077214,2498592296,4,202,50.5,1362077206655,1362077213439,2498584951,2498591735,6784
1362077214,2498592296,3,150,50,1362077206654,1362077213438,2498584950,2498591734,6784
1362077214,2498592296,3,150,50,1362077206718,1362077213438,2498585014,2498591734,6720
1362077214,2498592300,3,144,48,1362077206713,1362077213625,2498585013,2498591925,6912
1362077214,2498592300,3,150,50,1362077206904,1362077213432,2498585204,2498591732,6528
1362077214,2498592300,4,202,50.5,1362077206776,1362077213432,2498585076,2498591732,6656
1362077214,2498592300,2,98,49,1362077206907,1362077213371,2498585207,2498591671,6464
1362077214,2498592308,3,144,48,1362077207924,1362077213428,2498586232,2498591736,5504
1362077214,2498592332,4,184,46,1362077203865,1362077213465,2498582197,2498591797,9600
1362077214,2498592332,4,184,46,1362077204057,1362077210713,2498582389,2498589045,6656
1362077214,2498592340,4,184,46,1362077200851,1362077207635,2498579191,2498585975,6784
1362077214,2498592376,3,150,50,1362077206575,1362077213359,2498584951,2498591735,6784
1362077214,2498592380,3,144,48,1362077206828,1362077213420,2498585208,2498591800,6592
1362077214,2498592388,2,98,49,1362077207844,1362077213348,2498586232,2498591736,5504
1362077214,2498592416,4,184,46,1362077203912,1362077208840,2498582328,2498587256,4928
1362077214,2498592420,4,184,46,1362077204035,1362077210115,2498582455,2498588535,6080
1362077214,2498592424,4,184,46,1362077200704,1362077205952,2498579128,2498584376,5248
1362077219,2498596844,1,46,46,1362077190915,1362077190915,2498568759,2498568759,0
1362077222,2498600472,3,144,48,1362077208847,1362077214223,2498587319,2498592695,5376
1362077222,2498600472,3,144,48,1362077208847,1362077214223,2498587319,2498592695,5376
1362077231,2498608748,16,8636,539.75,1362077206562,1362077208546,2498584310,2498586294,1984
1362077231,2498608748,30,36911,1230.366667,1362077206561,1362077208225,2498584309,2498585973,1664
1362077231,2498608748,19,15903,837,1362077206625,1362077208673,2498584373,2498586421,2048
1362077231,2498608828,21,24414,1162.571429,1362077205840,1362077206160,2498583668,2498583988,320
1362077231,2498608836,13,14794,1138,1362077206475,1362077207051,2498584311,2498584887,576
1362077231,2498608836,25,26270,1050.8,1362077206475,1362077208011,2498584311,2498585847,1536
1362077231,2498608836,25,28121,1124.84,1362077206474,1362077208074,2498584310,2498585910,1600
1362077235,2498612780,16,15348,959.25,1362077207170,1362077208642,2498584950,2498586422,1472
1362077235,2498612820,16,896,56,1362077208921,1362077234457,2498586741,2498612277,25536
1362077235,2498612828,8,768,96,1362077209424,1362077234448,2498587252,2498612276,25024
1362077235,2498612852,12,672,56,1362077209979,1362077234683,2498587831,2498612535,24704
1362077235,2498612852,8,2573,321.625,1362077210297,1362077217785,2498588149,2498595637,7488
1362077235,2498612864,18,18106,1005.888889,1362077207342,1362077208686,2498585206,2498586550,1344
1362077235,2498612908,10,9441,944.1,1362077208324,1362077208580,2498586232,2498586488,256
1362077235,2498612940,7,392,56,1362077209570,1362077234338,2498587510,2498612278,24768
1362077235,2498612940,7,1140,162.8571429,1362077209570,1362077213154,2498587510,2498591094,3584
1362077238,2498616308,1,46,46,1362077210289,1362077210289,2498588597,2498588597,0
1362077238,2498616368,10,556,55.6,1362077233784,1362077233912,2498612152,2498612280,128
1362077238,2498616368,7,648,92.57142857,1362077233847,1362077237751,2498612215,2498616119,3904
1362077238,2498616368,7,648,92.57142857,1362077233847,1362077237815,2498612215,2498616183,3968
1362077238,2498616472,7,503,71.85714286,1362077233680,1362077236880,2498612152,2498615352,3200
1362077238,2498616472,7,648,92.57142857,1362077233743,1362077237647,2498612215,2498616119,3904
1362077238,2498616472,7,648,92.57142857,1362077233743,1362077237711,2498612215,2498616183,3968
1362077238,2498616472,7,503,71.85714286,1362077233743,1362077237199,2498612215,2498615671,3456
1362077238,2498616472,7,648,92.57142857,1362077233742,1362077237646,2498612214,2498616118,3904
1362077238,2498616472,7,648,92.57142857,1362077233742,1362077237646,2498612214,2498616118,3904
1362077238,2498616472,7,648,92.57142857,1362077233742,1362077237710,2498612214,2498616182,3968
1362077238,2498616472,7,648,92.57142857,1362077233742,1362077237710,2498612214,2498616182,3968
1362077238,2498616472,7,648,92.57142857,1362077233742,1362077237710,2498612214,2498616182,3968
1362077238,2498616472,7,503,71.85714286,1362077233741,1362077237197,2498612213,2498615669,3456
1362077239,2498616864,3,138,46,1362077211756,1362077211756,2498589620,2498589620,0
1362077246,2498624324,6,590,98.33333333,1362077239266,1362077245730,2498617590,2498624054,6464
1362077254,2498632336,9,438,48.66666667,1362077234839,1362077251735,2498613175,2498630071,16896
1362077254,2498632344,7,340,48.57142857,1362077235788,1362077251340,2498614132,2498629684,15552
1362077254,2498632368,12,5022,418.5,1362077236022,1362077246710,2498614390,2498625078,10688
1362077254,2498632368,3,150,50,1362077236022,1362077251254,2498614390,2498629622,15232
1362077254,2498632376,6,294,49,1362077236396,1362077251628,2498614772,2498630004,15232
1362077254,2498632380,8,404,50.5,1362077236779,1362077250091,2498615159,2498628471,13312
1362077254,2498632412,5,242,48.4,1362077246603,1362077251467,2498625015,2498629879,4864
1362077254,2498632412,4,892,223,1362077230921,1362077251273,2498609333,2498629685,20352
1362077254,2498632420,7,485,69.28571429,1362077240001,1362077251841,2498618421,2498630261,11840
1362077254,2498632424,23,25020,1087.826087,1362077235839,1362077252735,2498614263,2498631159,16896
1362077254,2498632424,5,248,49.6,1362077235710,1362077253822,2498614134,2498632246,18112
1362077254,2498632424,5,248,49.6,1362077235710,1362077253694,2498614134,2498632118,17984
1362077254,2498632448,6,294,49,1362077236198,1362077251494,2498614646,2498629942,15296
1362077254,2498632448,4,196,49,1362077235941,1362077251493,2498614389,2498629941,15552
1362077254,2498632452,5,242,48.4,1362077236068,1362077251556,2498614520,2498630008,15488
1362077254,2498632452,8,386,48.25,1362077236641,1362077251425,2498615093,2498629877,14784
1362077262,2498640316,2,92,46,1362077254571,1362077254699,2498632887,2498633015,128
1362077262,2498640316,4,190,47.5,1362077254122,1362077254890,2498632438,2498633206,768
1362077262,2498640316,4,190,47.5,1362077254121,1362077254889,2498632437,2498633205,768
1362077262,2498640324,3,150,50,1362077255266,1362077261538,2498633590,2498639862,6272
1362077262,2498640332,3,150,50,1362077256091,1362077261531,2498634423,2498639863,5440
1362077262,2498640396,2,92,46,1362077254554,1362077254746,2498632950,2498633142,192
1362077262,2498640396,7,328,46.85714286,1362077254042,1362077255002,2498632438,2498633398,960
1362077262,2498640404,4,196,49,1362077255122,1362077261842,2498633526,2498640246,6720
1362077262,2498640404,4,196,49,1362077255377,1362077261777,2498633781,2498640181,6400
1362077262,2498640408,4,196,49,1362077255949,1362077261837,2498634357,2498640245,5888
1362077263,2498640788,10,560,56,1362077235322,1362077262778,2498613110,2498640566,27456
1362077263,2498640788,70,66212,945.8857143,1362077235385,1362077262841,2498613173,2498640629,27456
1362077263,2498640788,5,480,96,1362077235512,1362077262648,2498613300,2498640436,27136
1362077263,2498640816,19,17910,942.6315789,1362077236318,1362077257502,2498614134,2498635318,21184
1362077263,2498640816,19,20868,1098.315789,1362077236318,1362077256862,2498614134,2498634678,20544
1362077263,2498640948,2,394,197,1362077238555,1362077240859,2498616503,2498618807,2304
1362077263,2498640972,9,504,56,1362077235202,1362077262018,2498613174,2498639990,26816
1362077263,2498640976,18,22506,1250.333333,1362077235836,1362077256508,2498613812,2498634484,20672
1362077263,2498640980,23,26464,1150.608696,1362077235960,1362077257144,2498613940,2498635124,21184
1362077263,2498640980,30,36422,1214.066667,1362077236090,1362077257722,2498614070,2498635702,21632
1362077266,1136959088,8,738,92.25,1362077258778,1362077264282,1136951866,1136957370,5504
1362077267,2498644784,2,394,197,1362077239807,1362077242687,2498617591,2498620471,2880
1362077267,2498644784,2,394,197,1362077239806,1362077242750,2498617590,2498620534,2944
1362077267,2498644784,2,394,197,1362077239805,1362077242685,2498617589,2498620469,2880
1362077267,2498644784,2,394,197,1362077239933,1362077243005,2498617717,2498620789,3072
1362077267,2498644896,2,394,197,1362077239759,1362077242639,2498617655,2498620535,2880
1362077267,2498644896,2,394,197,1362077239695,1362077242575,2498617591,2498620471,2880
1362077267,2498644896,2,394,197,1362077239758,1362077242702,2498617654,2498620598,2944
1362077267,2498644896,2,394,197,1362077239822,1362077242894,2498617718,2498620790,3072
1362077267,2498644896,2,394,197,1362077239821,1362077242893,2498617717,2498620789,3072
1362077270,2498648324,6,294,49,1362077261923,1362077265891,2498640247,2498644215,3968
1362077270,2498648328,5,248,49.6,1362077262173,1362077265821,2498640501,2498644149,3648
1362077270,2498648328,5,248,49.6,1362077262172,1362077265820,2498640500,2498644148,3648
1362077270,2498648332,10,1444,144.4,1362077258969,1362077269849,2498637301,2498648181,10880
1362077270,2498648368,6,288,48,1362077268212,1362077269876,2498646580,2498648244,1664
1362077270,2498648372,7,340,48.57142857,1362077257202,1362077269426,2498635574,2498647798,12224
1362077270,2498648372,6,294,49,1362077257202,1362077266674,2498635574,2498645046,9472
1362077270,2498648372,7,340,48.57142857,1362077257202,1362077269618,2498635574,2498647990,12416
1362077270,2498648372,7,340,48.57142857,1362077257202,1362077269810,2498635574,2498648182,12608
1362077270,2498648372,6,294,49,1362077257202,1362077266994,2498635574,2498645366,9792
1362077270,2498648372,5,236,47.2,1362077257265,1362077267185,2498635637,2498645557,9920
1362077270,2498648376,8,392,49,1362077257455,1362077269679,2498635831,2498648055,12224
1362077270,2498648376,8,392,49,1362077257455,1362077269679,2498635831,2498648055,12224
1362077270,2498648376,6,282,47,1362077257455,1362077266671,2498635831,2498645047,9216
1362077270,2498648376,21,6701,319.0952381,1362077257455,1362077268079,2498635831,2498646455,10624
1362077270,2498648376,19,6662,350.6315789,1362077257455,1362077266927,2498635831,2498645303,9472
1362077270,2498648376,7,340,48.57142857,1362077257455,1362077266543,2498635831,2498644919,9088
1362077270,2498648376,5,236,47.2,1362077257455,1362077266607,2498635831,2498644983,9152
1362077270,2498648376,3,144,48,1362077269164,1362077269612,2498647540,2498647988,448
1362077270,2498648412,5,248,49.6,1362077262091,1362077265739,2498640503,2498644151,3648
1362077270,2498648420,6,306,51,1362077259650,1362077269122,2498638070,2498647542,9472
1362077270,2498648456,7,340,48.57142857,1362077257119,1362077269343,2498635575,2498647799,12224
1362077270,2498648456,7,340,48.57142857,1362077257119,1362077269407,2498635575,2498647863,12288
1362077270,2498648456,21,6701,319.0952381,1362077257118,1362077268510,2498635574,2498646966,11392
1362077270,2498648456,7,340,48.57142857,1362077257118,1362077269662,2498635574,2498648118,12544
1362077270,2498648456,7,340,48.57142857,1362077257118,1362077269790,2498635574,2498648246,12672
1362077270,2498648456,8,392,49,1362077257373,1362077269597,2498635829,2498648053,12224
1362077270,2498648456,7,340,48.57142857,1362077257373,1362077269021,2498635829,2498647477,11648
1362077270,2498648456,6,294,49,1362077257373,1362077266269,2498635829,2498644725,8896
1362077270,2498648456,7,346,49.42857143,1362077257373,1362077266397,2498635829,2498644853,9024
1362077270,2498648456,8,392,49,1362077257372,1362077269596,2498635828,2498648052,12224
1362077270,2498648456,7,340,48.57142857,1362077257372,1362077269020,2498635828,2498647476,11648
1362077270,2498648456,7,340,48.57142857,1362077257372,1362077269532,2498635828,2498647988,12160
1362077270,2498648456,6,294,49,1362077257372,1362077266268,2498635828,2498644724,8896
1362077271,2498648780,6,294,49,1362077262467,1362077266371,2498640247,2498644151,3904
1362077274,1136967100,3,317,105.6666667,1362077266769,1362077269521,1136959869,1136962621,2752
1362077278,2498656340,6,282,47,1362077269906,1362077276754,2498648246,2498655094,6848
1362077278,2498656340,9,426,47.33333333,1362077270417,1362077277137,2498648757,2498655477,6720
1362077278,2498656344,4,190,47.5,1362077270095,1362077276751,2498648439,2498655095,6656
1362077278,2498656344,5,236,47.2,1362077270158,1362077276686,2498648502,2498655030,6528
1362077278,2498656344,5,236,47.2,1362077270158,1362077276622,2498648502,2498654966,6464
1362077278,2498656344,4,184,46,1362077270606,1362077276302,2498648950,2498654646,5696
1362077278,2498656344,6,282,47,1362077270157,1362077276749,2498648501,2498655093,6592
1362077278,2498656344,9,432,48,1362077270221,1362077277261,2498648565,2498655605,7040
1362077278,2498656344,5,236,47.2,1362077270220,1362077276812,2498648564,2498655156,6592
1362077278,2498656348,5,230,46,1362077270987,1362077277259,2498649335,2498655607,6272
1362077278,2498656348,4,190,47.5,1362077270923,1362077276619,2498649271,2498654967,5696
1362077278,2498656348,6,276,46,1362077271113,1362077276297,2498649461,2498654645,5184
1362077278,2498656348,5,230,46,1362077271304,1362077277384,2498649652,2498655732,6080
1362077278,2498656348,4,190,47.5,1362077271304,1362077276680,2498649652,2498655028,5376
1362077278,2498656348,4,190,47.5,1362077271303,1362077276743,2498649651,2498655091,5440
1362077278,2498656352,3,138,46,1362077271367,1362077276295,2498649719,2498654647,4928
1362077278,2498656352,3,138,46,1362077271366,1362077276294,2498649718,2498654646,4928
1362077278,2498656376,4,184,46,1362077272299,1362077277163,2498650675,2498655539,4864
1362077278,2498656376,3,138,46,1362077276014,1362077276526,2498654390,2498654902,512
1362077278,2498656376,3,138,46,1362077276014,1362077276526,2498654390,2498654902,512
1362077278,2498656376,3,138,46,1362077276012,1362077276588,2498654388,2498654964,576
1362077278,2498656380,279,248022,888.9677419,1362076851371,1362077277227,2498229751,2498655607,425856
1362077278,2498656384,32,15757,492.40625,1362077257189,1362077277541,2498635573,2498655925,20352
1362077278,2498656424,6,282,47,1362077270015,1362077276671,2498648439,2498655095,6656
1362077278,2498656424,4,184,46,1362077270590,1362077276158,2498649014,2498654582,5568
1362077278,2498656424,4,190,47.5,1362077270078,1362077276542,2498648502,2498654966,6464
1362077278,2498656424,5,236,47.2,1362077270078,1362077276670,2498648502,2498655094,6592
1362077278,2498656428,5,236,47.2,1362077270842,1362077276538,2498649270,2498654966,5696
1362077278,2498656428,4,190,47.5,1362077270842,1362077276538,2498649270,2498654966,5696
1362077278,2498656428,4,190,47.5,1362077271289,1362077276601,2498649717,2498655029,5312
1362077278,2498656432,3,138,46,1362077271351,1362077276279,2498649783,2498654711,4928
1362077278,2498656432,4,190,47.5,1362077271542,1362077276662,2498649974,2498655094,5120
1362077278,2498656456,4,190,47.5,1362077272093,1362077277021,2498650549,2498655477,4928
1362077278,2498656468,4,184,46,1362077273233,1362077276433,2498651701,2498654901,3200
1362077279,2498656864,3,144,48,1362077253611,1362077255275,2498631475,2498633139,1664
1362077283,2498660792,1,46,46,1362077255091,1362077255091,2498632883,2498632883,0
1362077283,2498660796,1,46,46,1362077255155,1362077255155,2498632951,2498632951,0
1362077283,2498660796,1,46,46,1362077255091,1362077255091,2498632887,2498632887,0
1362077283,2498660796,1,46,46,1362077255155,1362077255155,2498632951,2498632951,0
1362077283,2498660796,1,46,46,1362077255217,1362077255217,2498633013,2498633013,0
1362077283,2498660796,1,46,46,1362077255217,1362077255217,2498633013,2498633013,0
1362077283,2498660804,4,714,178.5,1362077255785,1362077256041,2498633589,2498633845,256
1362077283,2498660832,12,2648,220.6666667,1362077256525,1362077261965,2498634357,2498639797,5440
1362077283,2498660840,5,5364,1072.8,1362077257030,1362077257222,2498634870,2498635062,192
1362077283,2498660844,17,1521,89.47058824,1362077257791,1362077272511,2498635635,2498650355,14720
1362077283,2498660884,2,2940,1470,1362077255064,1362077255064,2498632948,2498632948,0
1362077283,2498660884,1,46,46,1362077255064,1362077255064,2498632948,2498632948,0
1362077283,2498660888,1,46,46,1362077255253,1362077255253,2498633141,2498633141,0
1362077283,2498660916,42,37070,882.6190476,1362077255483,1362077280699,2498633399,2498658615,25216
1362077283,2498660928,6,1118,186.3333333,1362077256431,1362077257903,2498634359,2498635831,1472
1362077283,2498660948,4,4089,1022.25,1362077257178,1362077257178,2498635126,2498635126,0
1362077283,2498660948,11,12246,1113.272727,1362077257241,1362077257817,2498635189,2498635765,576
1362077283,2498660952,26,25776,991.3846154,1362077257620,1362077261716,2498635572,2498639668,4096
1362077283,2498660952,20,6386,319.3,1362077257620,1362077265812,2498635572,2498643764,8192
1362077283,2498660952,8,860,107.5,1362077257620,1362077261780,2498635572,2498639732,4160
1362077286,2498664320,9,462,51.33333333,1362077263525,1362077279269,2498641845,2498657589,15744
1362077286,2498664396,9,462,51.33333333,1362077263448,1362077279192,2498641844,2498657588,15744
1362077286,2498664424,31,33736,1088.258065,1362077273276,1362077284412,2498651700,2498662836,11136
1362077287,2498664776,13,2952,227.0769231,1362077262852,1362077277316,2498640628,2498655092,14464
1362077287,2498664816,11,1604,145.8181818,1362077259868,1362077270940,2498637684,2498648756,11072
1362077287,2498664872,7,392,56,1362077259173,1362077265829,2498637045,2498643701,6656
1362077291,2498668812,5,280,56,1362077263458,1362077265058,2498641270,2498642870,1600
1362077291,2498668812,3,288,96,1362077263648,1362077265696,2498641460,2498643508,2048
1362077291,2498668892,6,336,56,1362077262801,1362077265297,2498640693,2498643189,2496
1362077291,2498668932,16,11714,732.125,1362077264296,1362077277864,2498642228,2498655796,13568
1362077294,2498672344,6,300,50,1362077279308,1362077287948,2498657652,2498666292,8640
1362077299,2498676812,22,3851,175.0454545,1362077271458,1362077281122,2498649270,2498658934,9664
1362077299,2498676956,1,52,52,1362077273488,1362077273488,2498651444,2498651444,0
1362077303,2498680880,1,46,46,1362077276959,1362077276959,2498654839,2498654839,0
1362077307,2498684968,7,555,79.28571429,1362077279430,1362077283270,2498657398,2498661238,3840
1362077307,2498684972,9,2062,229.1111111,1362077279619,1362077282179,2498657591,2498660151,2560
1362077310,2498688384,8,1392,174,1362077308004,1362077309284,2498686388,2498687668,1280
1362077311,2498688924,7,3452,493.1428571,1362077285554,1362077292146,2498663478,2498670070,6592
1362077318,2498696372,7,346,49.42857143,1362077310129,1362077317681,2498688501,2498696053,7552
1362077318,2498696408,5,248,49.6,1362077308556,1362077317260,2498686964,2498695668,8704
1362077318,2498696488,5,248,49.6,1362077307899,1362077316283,2498686387,2498694771,8384
1362077318,2498696492,5,248,49.6,1362077308473,1362077317241,2498686965,2498695733,8768
1362077318,1137011060,6,722,120.3333333,1362077290806,1362077295478,1136983866,1136988538,4672
1362077326,2498704376,2,98,49,1362077319790,1362077320174,2498698166,2498698550,384
1362077326,2498704376,2,98,49,1362077320107,1362077320363,2498698483,2498698739,256
1362077326,2498704408,3,144,48,1362077322060,1362077322956,2498700468,2498701364,896
1362077326,2498704412,2,98,49,1362077322186,1362077323018,2498700598,2498701430,832
1362077326,2498704452,4,184,46,1362077323361,1362077324257,2498701813,2498702709,896
1362077331,2498708980,9,504,56,1362077305529,1362077330745,2498683509,2498708725,25216
1362077331,2498708980,9,504,56,1362077305465,1362077330617,2498683445,2498708597,25152
1362077334,2498712416,3,144,48,1362077324035,1362077329923,2498702451,2498708339,5888
1362077334,2498712420,3,144,48,1362077324032,1362077329856,2498702452,2498708276,5824
1362077334,2498712424,3,144,48,1362077324412,1362077329980,2498702836,2498708404,5568
1362077334,2498712460,4,190,47.5,1362077326743,1362077332887,2498705203,2498711347,6144
1362077335,2498712868,74,74202,1002.72973,1362077310630,1362077331110,2498688498,2498708978,20480
1362077335,2498712956,5,480,96,1362077307088,1362077331728,2498685044,2498709684,24640
1362077335,2498712992,5,280,56,1362077307882,1362077331882,2498685874,2498709874,24000
1362077347,2498724948,9,3006,334,1362077321882,1362077332634,2498699830,2498710582,10752
1362077351,2498728896,40,36739,918.475,1362077324106,1362077350218,2498702002,2498728114,26112
1362077351,2498728912,20,12031,601.55,1362077324858,1362077349690,2498702770,2498727602,24832
1362077351,2498728984,20,16060,803,1362077323827,1362077348403,2498701811,2498726387,24576
1362077351,2498728988,1,46,46,1362077323825,1362077323825,2498701813,2498701813,0
1362077358,2498736376,14,686,49,1362077346731,1362077357739,2498725107,2498736115,11008
1362077358,2498736376,14,686,49,1362077346731,1362077357675,2498725107,2498736051,10944
1362077358,2498736428,4,196,49,1362077346104,1362077355896,2498724532,2498734324,9792
1362077358,2498736452,16,778,48.625,1362077346464,1362077357600,2498724916,2498736052,11136
1362077358,2498736452,14,686,49,1362077346464,1362077357600,2498724916,2498736052,11136
1362077359,2498736960,3,168,56,1362077331467,1362077333259,2498709427,2498711219,1792
1362077359,2498736960,2,112,56,1362077331531,1362077332491,2498709491,2498710451,960
1362077362,1137055024,5,254,50.8,1362077346651,1362077359323,1137039675,1137052347,12672
1362077362,1137055032,4,202,50.5,1362077346386,1362077359314,1137039418,1137052346,12928
1362077362,1137055032,8,392,49,1362077346386,1362077360530,1137039418,1137053562,14144
1362077366,2498744400,4,196,49,1362077358674,1362077365778,2498737074,2498744178,7104
1362077366,2498744400,3,138,46,1362077357974,1362077359766,2498736374,2498738166,1792
1362077366,2498744400,4,202,50.5,1362077346453,1362077359381,2498724853,2498737781,12928
1362077366,2498744400,5,248,49.6,1362077346453,1362077359445,2498724853,2498737845,12992
1362077366,2498744400,4,202,50.5,1362077346453,1362077359381,2498724853,2498737781,12928
1362077366,2498744400,5,248,49.6,1362077346453,1362077359445,2498724853,2498737845,12992
1362077366,2498744400,4,202,50.5,1362077346453,1362077359381,2498724853,2498737781,12928
1362077366,2498744436,8,410,51.25,1362077352047,1362077358255,2498730483,2498736691,6208
1362077366,2498744448,8,410,51.25,1362077353636,1362077359332,2498732084,2498737780,5696
1362077366,2498744480,4,196,49,1362077358595,1362077365699,2498737075,2498744179,7104
1362077366,2498744484,4,196,49,1362077358848,1362077365696,2498737332,2498744180,6848
1362077366,2498744492,5,248,49.6,1362077358266,1362077365690,2498736758,2498744182,7424
1362077366,2498744520,8,410,51.25,1362077351708,1362077358044,2498730228,2498736564,6336
1362077366,2498744532,8,410,51.25,1362077353294,1362077359118,2498731826,2498737650,5824
1362077371,1137063328,13,5126,394.3076923,1362077346706,1362077364626,1137039034,1137056954,17920
1362077371,2498748968,92,111834,1215.586957,1362077346436,1362077370628,2498724404,2498748596,24192
1362077371,2498748968,39,40775,1045.512821,1362077346436,1362077362180,2498724404,2498740148,15744
1362077371,2498748968,15,10050,670,1362077346563,1362077357891,2498724531,2498735859,11328
1362077371,2498748968,21,14437,687.4761905,1362077346563,1362077360195,2498724531,2498738163,13632
1362077371,2498748968,17,11336,666.8235294,1362077346562,1362077357698,2498724530,2498735666,11136
1362077371,2498749076,36,37244,1034.555556,1362077346330,1362077360154,2498724406,2498738230,13824
1362077371,2498749076,11,7184,653.0909091,1362077346456,1362077355288,2498724532,2498733364,8832
1362077374,2498752544,5,230,46,1362077365954,1362077369986,2498744498,2498748530,4032
1362077374,2498752548,5,230,46,1362077366017,1362077369985,2498744565,2498748533,3968
1362077374,2498752560,6,421,70.16666667,1362077368181,1362077369845,2498746741,2498748405,1664
1362077374,2498752620,6,276,46,1362077365878,1362077369910,2498744498,2498748530,4032
1362077375,2498752624,6,276,46,1362077366877,1362077370909,2498744501,2498748533,4032
1362077375,2498752632,6,421,70.16666667,1362077368852,1362077370324,2498746484,2498747956,1472
1362077375,2498752676,5,363,72.6,1362077371114,1362077371306,2498748790,2498748982,192
1362077378,1137071028,3,150,50,1362077362968,1362077370648,1137055996,1137063676,7680
1362077378,1137071028,2,98,49,1362077362967,1362077370647,1137055995,1137063675,7680
1362077378,1137071028,2,98,49,1362077363223,1362077370647,1137056251,1137063675,7424
1362077378,1137071028,2,98,49,1362077363222,1362077370646,1137056250,1137063674,7424
1362077378,1137071028,3,144,48,1362077363222,1362077370646,1137056250,1137063674,7424
1362077378,1137071032,2,98,49,1362077363989,1362077370645,1137057021,1137063677,6656
1362077378,1137071040,2,98,49,1362077363211,1362077370635,1137056251,1137063675,7424
1362077378,1137071040,2,98,49,1362077363211,1362077370635,1137056251,1137063675,7424
1362077378,1137071052,2,98,49,1362077364160,1362077370624,1137057212,1137063676,6464
1362077379,2498756880,14,11560,825.7142857,1362077351324,1362077359068,2498729204,2498736948,7744
1362077379,2498757000,13,7897,607.4615385,1362077351780,1362077364964,2498729780,2498742964,13184
1362077379,2498757068,29,21787,751.2758621,1362077354527,1362077365855,2498732595,2498743923,11328
1362077383,2498760904,3,853,284.3333333,1362077355397,1362077358725,2498733301,2498736629,3328
1362077383,2498760984,26,31422,1208.538462,1362077358514,1362077364466,2498736498,2498742450,5952
1362077387,2498764876,16,1536,96,1362077359327,1362077382687,2498737203,2498760563,23360
1362077387,2498764880,16,896,56,1362077359581,1362077383261,2498737461,2498761141,23680
1362077387,2498764956,13,12523,963.3076923,1362077358865,1362077360465,2498736821,2498738421,1600
1362077387,2498764956,31,1736,56,1362077359055,1362077382351,2498737011,2498760307,23296
1362077387,2498764964,30,1680,56,1362077359560,1362077383304,2498737524,2498761268,23744
1362077390,2498768548,8,392,49,1362077379328,1362077387904,2498757876,2498766452,8576
1362077390,2498768580,5,236,47.2,1362077380063,1362077388127,2498758643,2498766707,8064
1362077390,2498768588,8,380,47.5,1362077380825,1362077388121,2498759413,2498766709,7296
1362077391,2498768616,7,340,48.57142857,1362077383523,1362077390627,2498761139,2498768243,7104
1362077391,2498768624,2,92,46,1362077384221,1362077386205,2498761845,2498763829,1984
1362077391,2498768624,4,188,47,1362077384220,1362077390492,2498761844,2498768116,6272
1362077391,1137083272,19,18630,980.5263158,1362077363722,1362077371082,1137055994,1137063354,7360
1362077391,1137083276,20,22299,1114.95,1362077363721,1362077370313,1137055997,1137062589,6592
1362077391,1137083324,6,3467,577.8333333,1362077363673,1362077367833,1137055997,1137060157,4160
1362077394,1137087036,6,461,76.83333333,1362077391313,1362077392465,1137084349,1137085501,1152
1362077395,2498773060,11,940,85.45454545,1362077370345,1362077370729,2498748405,2498748789,384
1362077395,2498773064,8,2795,349.375,1362077370597,1362077370853,2498748661,2498748917,256
1362077399,2498777012,10,1558,155.8,1362077370969,1362077371161,2498748981,2498749173,192
1362077399,2498777048,1,46,46,1362077372085,1362077372085,2498750133,2498750133,0
1362077399,2498777048,1,46,46,1362077372085,1362077372085,2498750133,2498750133,0
1362077399,2498777056,2,92,46,1362077373101,1362077373101,2498751157,2498751157,0
1362077399,2498777056,1,46,46,1362077373099,1362077373099,2498751155,2498751155,0
1362077399,2498777124,1,46,46,1362077371046,1362077371046,2498749170,2498749170,0
1362077399,2498777136,1,46,46,1362077371995,1362077371995,2498750131,2498750131,0
1362077399,2498777168,1,46,46,1362077372986,1362077372986,2498751154,2498751154,0
1362077399,2498777168,1,46,46,1362077372986,1362077372986,2498751154,2498751154,0
1362077399,2498777168,1,46,46,1362077372986,1362077372986,2498751154,2498751154,0
1362077403,2498780984,1,46,46,1362077375093,1362077375093,2498753077,2498753077,0
1362077403,2498781112,1,46,46,1362077376884,1362077376884,2498754996,2498754996,0
1362077407,2498784632,4,184,46,1362077399570,1362077403282,2498777202,2498780914,3712
1362077407,2498784760,5,236,47.2,1362077398419,1362077402451,2498776179,2498780211,4032
1362077407,2498785104,1,46,46,1362077379066,1362077379066,2498757170,2498757170,0
1362077407,2498785148,1,46,46,1362077380622,1362077380622,2498758770,2498758770,0
1362077410,1137103140,3,138,46,1362077404330,1362077405610,1137097470,1137098750,1280
1362077411,2498789276,2,92,46,1362077385872,1362077388368,2498764148,2498766644,2496
1362077415,2498793092,10,560,56,1362077389129,1362077394761,2498767221,2498772853,5632
1362077415,2498793112,10,560,56,1362077389363,1362077394675,2498767475,2498772787,5312
1362077415,2498793116,5,480,96,1362077389550,1362077394158,2498767666,2498772274,4608
1362077415,2498793124,5,636,127.2,1362077389991,1362077390183,2498768115,2498768307,192
1362077415,2498793208,1,46,46,1362077389525,1362077389525,2498767733,2498767733,0
1362077415,2498793236,5,280,56,1362077389814,1362077394294,2498768050,2498772530,4480
1362077419,2498797064,2,92,46,1362077392098,1362077392802,2498770162,2498770866,704
1362077419,2498797196,2,92,46,1362077392927,1362077395039,2498771123,2498773235,2112
1362077423,2498801212,4,544,136,1362077398033,1362077403665,2498776245,2498781877,5632
1362077439,2498816776,14,6357,454.0714286,1362077437378,1362077437954,2498815154,2498815730,576
1362077447,2498824788,7,328,46.85714286,1362077436918,1362077445430,2498814706,2498823218,8512
1362077447,2498824792,10,466,46.6,1362077437362,1362077445554,2498815154,2498823346,8192
1362077451,2498829204,58,52929,912.5689655,1362077424728,1362077445784,2498802932,2498823988,21056
1362077455,2498832788,3,144,48,1362077445238,1362077451958,2498823026,2498829746,6720
1362077455,2498832800,4,196,49,1362077446378,1362077454186,2498824178,2498831986,7808
1362077455,2498832800,3,144,48,1362077446186,1362077452138,2498823986,2498829938,5952
1362077455,2498833156,4,283,70.75,1362077429509,1362077430021,2498807665,2498808177,512
1362077455,2498833156,5,304,60.8,1362077429509,1362077430213,2498807665,2498808369,704
1362077455,2498833232,5,304,60.8,1362077429434,1362077430010,2498807666,2498808242,576
1362077455,2498833268,5,654,130.8,1362077429976,1362077430424,2498808244,2498808692,448
1362077463,1137155348,7,5182,740.2857143,1362077436799,1362077437311,1137129147,1137129659,512
1362077463,2498841116,7,4520,645.7142857,1362077436141,1362077451501,2498814257,2498829617,15360
1362077463,2498841156,7,2082,297.4285714,1362077437255,1362077437447,2498815411,2498815603,192
1362077463,2498841164,33,1848,56,1362077437692,1362077459004,2498815856,2498837168,21312
1362077463,2498841168,17,1632,96,1362077437883,1362077460347,2498816051,2498838515,22464
1362077463,2498841232,8,5406,675.75,1362077436155,1362077451451,2498814387,2498829683,15296
1362077463,2498841232,3,2926,975.3333333,1362077436282,1362077436282,2498814514,2498814514,0
1362077463,2498841232,4,1600,400,1362077436346,1362077436794,2498814578,2498815026,448
1362077463,2498841232,4,2419,604.75,1362077436346,1362077436410,2498814578,2498814642,64
1362077463,2498841240,10,2634,263.4,1362077436915,1362077437427,2498815155,2498815667,512
1362077463,2498841280,33,1848,56,1362077437641,1362077460105,2498815921,2498838385,22464
1362077463,2498841284,15,840,56,1362077437831,1362077455495,2498816115,2498833779,17664
1362077467,2498845320,12,1400,116.6666667,1362077441249,1362077451233,2498819569,2498829553,9984
1362077471,2498848656,105,110159,1049.133333,1362077371130,1362077467130,2498748786,2498844786,96000
1362077471,2498849176,4,538,134.5,1362077443059,1362077445427,2498821235,2498823603,2368
1362077475,2498853124,1,46,46,1362077449573,1362077449573,2498827697,2498827697,0
1362077479,2498856684,3,138,46,1362077476190,1362077476254,2498853874,2498853938,64
1362077479,2498856828,4,184,46,1362077466960,1362077474768,2498844788,2498852596,7808
1362077483,2498861204,1,46,46,1362077455511,1362077455511,2498833715,2498833715,0
1362077487,2498864692,4,184,46,1362077480214,1362077484182,2498857906,2498861874,3968
1362077487,2498864724,3,138,46,1362077482230,1362077484278,2498859954,2498862002,2048
1362077487,2498864732,3,200,66.66666667,1362077486382,1362077486702,2498864114,2498864434,320
1362077491,1137183188,4,184,46,1362077486240,1362077490336,1137178428,1137182524,4096
1362077491,2498869268,27,1512,56,1362077464599,1362077482903,2498842867,2498861171,18304
1362077491,2498869268,28,1568,56,1362077464535,1362077482775,2498842803,2498861043,18240
1362077491,2498869440,13,728,56,1362077464299,1362077479659,2498842739,2498858099,15360
1362077491,2498869448,13,1248,96,1362077465059,1362077479523,2498843507,2498857971,14464
1362077495,2498872764,4,246,61.5,1362077487246,1362077490062,2498865010,2498867826,2816
1362077495,2498872768,7,508,72.57142857,1362077487436,1362077494732,2498865204,2498872500,7296
1362077495,2498873124,2,92,46,1362077470757,1362077470821,2498848881,2498848945,64
1362077495,2498873196,5,636,127.2,1362077470173,1362077470173,2498848369,2498848369,0
1362077499,2498877212,2,92,46,1362077473676,1362077474828,2498851888,2498853040,1152
1362077503,2498881260,6,744,124,1362077478687,1362077483679,2498856947,2498861939,4992
1362077503,2498881272,1,46,46,1362077476370,1362077476370,2498854642,2498854642,0
1362077507,1137199356,2,92,46,1362077481081,1362077484089,1137173437,1137176445,3008
1362077507,2498885316,1,46,46,1362077481318,1362077481318,2498859634,2498859634,0
1362077511,1137203376,2,92,46,1362077484070,1362077484582,1137176446,1137176958,512
1362077515,2498893172,8,485,60.625,1362077488501,1362077489589,2498866673,2498867761,1088
1362077515,2498893172,7,408,58.28571429,1362077488501,1362077489461,2498866673,2498867633,960
1362077515,2498893172,8,485,60.625,1362077488501,1362077489717,2498866673,2498867889,1216
1362077519,2498896772,3,144,48,1362077507335,1362077514183,2498885107,2498891955,6848
1362077519,2498896772,3,144,48,1362077507335,1362077514183,2498885107,2498891955,6848
1362077519,2498896812,14,12741,910.0714286,1362077505117,1362077514973,2498882929,2498892785,9856
1362077519,2498896824,3,144,48,1362077509584,1362077516112,2498887408,2498893936,6528
1362077519,2498896844,3,144,48,1362077509565,1362077516093,2498887409,2498893937,6528
1362077519,2498896844,3,144,48,1362077509628,1362077517116,2498887472,2498894960,7488
1362077519,2498897300,1,46,46,1362077493494,1362077493494,2498871794,2498871794,0
1362077523,2498901176,26,30003,1153.961538,1362077495473,1362077516081,2498873649,2498894257,20608
1362077527,2498904692,3,1592,530.6666667,1362077523861,1362077523861,2498901553,2498901553,0
1362077527,2498904732,4,196,49,1362077509740,1362077519212,2498887472,2498896944,9472
1362077527,2498904812,4,196,49,1362077509663,1362077519135,2498887475,2498896947,9472
1362077527,2498905248,2,154,77,1362077501736,1362077516776,2498879984,2498895024,15040
1362077531,2498909244,13,9942,764.7692308,1362077506797,1362077522925,2498885041,2498901169,16128
1362077531,2498909244,12,8815,734.5833333,1362077506797,1362077522989,2498885041,2498901233,16192
1362077535,2498912736,5,1684,336.8,1362077534250,1362077534378,2498911986,2498912114,128
1362077535,2498912740,19,14589,767.8421053,1362077507366,1362077533222,2498885106,2498910962,25856
1362077551,2498929244,6,1353,225.5,1362077523053,1362077546349,2498901297,2498924593,23296
1362077551,2498929312,16,3625,226.5625,1362077525096,1362077534504,2498903408,2498912816,9408
1362077555,1137247260,3,552,184,1362077534360,1362077554456,1137226620,1137246716,20096
1362077559,2498936720,2,92,46,1362077557111,1362077557687,2498934831,2498935407,576
1362077559,2498936732,156,180018,1153.961538,1362077346669,1362077558701,2498724401,2498936433,212032
1362077559,1137251624,11,9414,855.8181818,1362077533934,1362077534574,1137226558,1137227198,640
1362077559,1137251624,16,18747,1171.6875,1362077534188,1362077534636,1137226812,1137227260,448
1362077559,1137251636,6,4541,756.8333333,1362077534369,1362077534689,1137227005,1137227325,320
1362077559,2498937176,9,5357,595.2222222,1362077534642,1362077550514,2498912818,2498928690,15872
1362077559,2498937216,1,52,52,1362077532872,1362077532872,2498911088,2498911088,0
1362077559,2498937220,3,439,146.3333333,1362077532998,1362077532998,2498911218,2498911218,0
1362077559,2498937260,1,48,48,1362077534620,1362077534620,2498912880,2498912880,0
1362077559,2498937340,5,3160,632,1362077533839,1362077533903,2498912179,2498912243,64
1362077559,2498937340,5,3199,639.8,1362077533901,1362077534029,2498912241,2498912369,128
1362077567,2498944788,3,138,46,1362077558835,1362077566067,2498936623,2498943855,7232
1362077571,1137263220,2,908,454,1362077558080,1362077565184,1137250300,1137257404,7104
1362077571,2498949264,1,77,77,1362077546713,1362077546713,2498924977,2498924977,0
1362077575,2498952796,2,92,46,1362077556715,1362077572523,2498934511,2498950319,15808
1362077575,2498952828,2,92,46,1362077562764,1362077571084,2498940592,2498948912,8320
1362077575,2498953060,118,147318,1248.457627,1362077255331,1362077272035,2498633391,2498650095,16704
1362077583,2498960868,2,92,46,1362077573732,1362077581028,2498951600,2498958896,7296
1362077583,2498961196,2,1538,769,1362077554846,1362077571806,2498933042,2498950002,16960
1362077591,2498969316,1,161,161,1362077566563,1362077566563,2498944879,2498944879,0
1362077595,2498973364,1,46,46,1362077569075,1362077569075,2498947439,2498947439,0
1362077599,2498976824,2,92,46,1362077575696,1362077594960,2498953520,2498972784,19264
1362077607,2498984904,2,815,407.5,1362077606016,1362077606720,2498983920,2498984624,704
1362077607,1137299572,1,454,454,1362077579170,1362077579170,1137271742,1137271742,0
1362077615,2498992872,4,329,82.25,1362077611295,1362077613535,2498989167,2498991407,2240
1362077615,2498992952,4,329,82.25,1362077610767,1362077612559,2498988719,2498990511,1792
1362077615,2498992952,4,329,82.25,1362077610894,1362077613390,2498988846,2498991342,2496
1362077615,2498993364,1,46,46,1362077587251,1362077587251,2498965615,2498965615,0
1362077623,2499001340,1,161,161,1362077598734,1362077598734,2498977074,2498977074,0
1362077631,2499009400,1,46,46,1362077603663,1362077603663,2498982063,2498982063,0
1362077635,1137327624,1,454,454,1362077607725,1362077607725,1137300349,1137300349,0
1362077635,2499013268,444,504606,1136.5,1362077282452,1362077331540,2498660720,2498709808,49088
1362077643,2499021288,1,101,101,1362077615807,1362077615807,2498994095,2498994095,0
1362077643,2499021436,1,101,101,1362077617452,1362077617452,2498995888,2498995888,0
1362077643,2499021440,1,101,101,1362077617833,1362077617833,2498996273,2498996273,0
1362077647,2499024928,2,92,46,1362077629672,1362077639656,2499007600,2499017584,9984
1362077647,2499025328,1,46,46,1362077620631,1362077620631,2498998959,2498998959,0
1362077659,2499037348,1,46,46,1362077633093,1362077633093,2499011441,2499011441,0
1362077663,2499040836,5,230,46,1362077654787,1362077658947,2499032623,2499036783,4160
1362077667,2499045416,1,46,46,1362077639934,1362077639934,2499018350,2499018350,0
1362077671,2499048864,4,184,46,1362077662695,1362077670631,2499040559,2499048495,7936
1362077671,2499048876,2,207,103.5,1362077663196,1362077668700,2499041072,2499046576,5504
1362077679,2499056864,2,92,46,1362077663337,1362077672233,2499041201,2499050097,8896
1362077683,2499061472,1,46,46,1362077658057,1362077658057,2499036529,2499036529,0
1362077687,2499065416,1,46,46,1362077659454,1362077659454,2499037870,2499037870,0
1362077687,2499065448,1,46,46,1362077660383,1362077660383,2499038831,2499038831,0
1362077687,2499065448,1,46,46,1362077660446,1362077660446,2499038894,2499038894,0
1362077687,2499065524,1,46,46,1362077662546,1362077662546,2499041070,2499041070,0
1362077688,2499065652,1,46,46,1362077661243,1362077661243,2499038895,2499038895,0
1362077695,2499072796,2,92,46,1362077691755,1362077692971,2499069551,2499070767,1216
1362077695,2499073428,1,46,46,1362077667125,1362077667125,2499045553,2499045553,0
1362077707,2499085400,1,46,46,1362077679121,1362077679121,2499057521,2499057521,0
1362077715,2499093492,1,46,46,1362077689395,1362077689395,2499067887,2499067887,0
1362077719,2499096852,2,92,46,1362077710515,1362077713331,2499088367,2499091183,2816
1362077720,2499097628,1,46,46,1362077695571,1362077695571,2499073199,2499073199,0
1362077744,2499121728,1,46,46,1362077719149,1362077719149,2499096877,2499096877,0
1362077752,2499129912,1,46,46,1362077725557,1362077725557,2499103469,2499103469,0
1362077764,2499141764,1,46,46,1362077736907,1362077736907,2499114671,2499114671,0
1362077764,2499141792,1,46,46,1362077737837,1362077737837,2499115629,2499115629,0
1362077768,2499145924,1,46,46,1362077742634,1362077742634,2499120558,2499120558,0
1362077804,2499181960,8,585,73.125,1362077778628,1362077802564,2499156588,2499180524,23936
1362077828,2499205896,1753,2324098,1325.783229,1362077351431,1362077527431,2498729327,2498905327,176000
1362077852,2499230124,1,77,77,1362077826720,1362077826720,2499204844,2499204844,0
1362077900,2499278168,1,77,77,1362077875318,1362077875318,2499253486,2499253486,0
1362078043,1137735312,3,138,46,1362078034921,1362078036393,1137727233,1137728705,1472
1362078043,1137735324,2,92,46,1362078034524,1362078038172,1137726848,1137730496,3648
1362078043,1137735324,2,92,46,1362078034588,1362078037660,1137726912,1137729984,3072
1362078047,2499425508,2,92,46,1362078033630,1362078043422,2499412138,2499421930,9792
1362078288,1137980660,1,46,46,1362078263372,1362078263372,1137956032,1137956032,0
1362080832,2502210460,1,46,46,1362080805154,1362080805154,2502183614,2502183614,0
1362081412,2502789656,3,150,50,1362081405121,1362081411137,2502782777,2502788793,6016
1362081412,2502789656,2,98,49,1362081405121,1362081411137,2502782777,2502788793,6016
1362081412,2502789656,2,98,49,1362081405118,1362081411134,2502782774,2502788790,6016
1362081412,2502789660,5,460,92,1362081405308,1362081405436,2502782968,2502783096,128
1362081412,2502789712,3,144,48,1362081405063,1362081411143,2502782775,2502788855,6080
1362081412,2502789712,2,98,49,1362081405127,1362081411079,2502782839,2502788791,5952
1362081412,1141104472,2,98,49,1362081404894,1362081410846,1141097366,1141103318,5952
1362081412,1141104472,3,144,48,1362081404830,1362081410910,1141097302,1141103382,6080
1362081412,1141104472,2,98,49,1362081404894,1362081410846,1141097366,1141103318,5952
1362081412,1141104484,4,196,49,1362081402964,1362081408852,1141095448,1141101336,5888
1362081412,1141104484,2,98,49,1362081403220,1362081408852,1141095704,1141101336,5632
1362081412,1141104484,2,98,49,1362081403220,1362081408852,1141095704,1141101336,5632
1362081412,1141104484,2,98,49,1362081403220,1362081408852,1141095704,1141101336,5632
1362081412,1141104484,3,144,48,1362081402963,1362081408851,1141095447,1141101335,5888
1362081412,1141104484,2,98,49,1362081404881,1362081410833,1141097365,1141103317,5952
1362081412,1141104484,2,98,49,1362081404881,1362081410833,1141097365,1141103317,5952
1362081412,1141104484,2,98,49,1362081404881,1362081410897,1141097365,1141103381,6016
1362081412,1141104504,2,98,49,1362081402942,1362081408830,1141095446,1141101334,5888
1362081412,1141104504,2,98,49,1362081402942,1362081408830,1141095446,1141101334,5888
1362081412,1141104504,2,98,49,1362081403198,1362081408830,1141095702,1141101334,5632
1362081412,1141104504,2,98,49,1362081403198,1362081408830,1141095702,1141101334,5632
1362081412,1141104504,3,144,48,1362081403198,1362081408830,1141095702,1141101334,5632
1362081412,2502790020,2,98,49,1362081404754,1362081410770,2502782774,2502788790,6016
1362081412,2502790024,2,98,49,1362081405198,1362081410766,2502783222,2502788790,5568
1362081412,2502790028,19,13223,695.9473684,1362081403146,1362081407434,2502781174,2502785462,4288
1362081420,2502797716,4,190,47.5,1362081407042,1362081413122,2502784758,2502790838,6080
1362081420,2502797744,4,190,47.5,1362081407718,1362081413222,2502785462,2502790966,5504
1362081428,1141120964,5,733,146.6,1362081402484,1362081405556,1141095448,1141098520,3072
1362081428,1141120964,4,1057,264.25,1362081402483,1362081406323,1141095447,1141099287,3840
1362081430,2502807672,31,36505,1177.580645,1362081405872,1362081406512,2502783544,2502784184,640
1362081430,2502807708,8,5460,682.5,1362081404746,1362081406794,2502782454,2502784502,2048
1362081430,2502807712,4,856,214,1362081402629,1362081402757,2502780341,2502780469,128
1362081430,2502807716,9,6082,675.7777778,1362081404673,1362081406657,2502782389,2502784373,1984
1362081430,2502807716,6,3129,521.5,1362081404740,1362081406852,2502782456,2502784568,2112
1362081430,2502807716,78,91210,1169.358974,1362081404865,1362081407297,2502782581,2502785013,2432
1362081430,2502807756,9,3000,333.3333333,1362081403420,1362081404124,2502781176,2502781880,704
1362081430,2502807760,8,2586,323.25,1362081403672,1362081404120,2502781432,2502781880,448
1362081430,2502807760,7,392,56,1362081403671,1362081413015,2502781431,2502790775,9344
1362081430,2502807792,12,3534,294.5,1362081404149,1362081404597,2502781941,2502782389,448
1362081430,2502807800,92,104220,1132.826087,1362081404400,1362081407088,2502782200,2502784888,2688
1362081430,2502807824,6,3169,528.1666667,1362081404629,1362081406805,2502782453,2502784629,2176
1362081430,2502807828,45,39703,882.2888889,1362081402644,1362081405012,2502780472,2502782840,2368
1362081430,2502807828,14,2300,164.2857143,1362081402643,1362081407763,2502780471,2502785591,5120
1362081430,2502807840,4,384,96,1362081403336,1362081410952,2502781176,2502788792,7616
1362081430,2502807840,29,17929,618.2413793,1362081403144,1362081408200,2502780984,2502786040,5056
1362081430,2502807868,4,224,56,1362081403372,1362081411308,2502781240,2502789176,7936
1362081430,2502807876,7,392,56,1362081403492,1362081411428,2502781368,2502789304,7936
1362081430,2502807876,7,2908,415.4285714,1362081403556,1362081404132,2502781432,2502782008,576
1362081432,1141124880,27,27500,1018.518519,1362081404486,1362081405446,1141097366,1141098326,960
1362081432,1141124880,8,6176,772,1362081404485,1362081406405,1141097365,1141099285,1920
1362081434,2502811728,12,3609,300.75,1362081407734,1362081408182,2502785462,2502785910,448
1362081434,2502811728,7,3143,449,1362081407670,1362081408118,2502785398,2502785846,448
1362081434,2502811812,6,698,116.3333333,1362081407011,1362081407651,2502784823,2502785463,640
1362081434,2502811840,25,12272,490.88,1362081407559,1362081408263,2502785399,2502786103,704
1362081434,2502811840,11,5421,492.8181818,1362081407623,1362081408327,2502785463,2502786167,704
1362081434,2502811840,4,1383,345.75,1362081407623,1362081408199,2502785463,2502786039,576
1362081434,2502811840,8,4245,530.625,1362081407622,1362081408006,2502785462,2502785846,384
1362081436,2502813724,13,1284,98.76923077,1362081430010,1362081433914,2502807734,2502811638,3904
1362081438,2502815760,2,98,49,1362081411413,1362081411541,2502789173,2502789301,128
1362081444,2502821648,10,3281,328.1,1362081436166,1362081436230,2502813814,2502813878,64
1362081444,2502821652,10,2887,288.7,1362081438787,1362081438851,2502816439,2502816503,64
1362081444,2502821656,12,3420,285,1362081438909,1362081439229,2502816565,2502816885,320
1362081444,2502821656,12,4588,382.3333333,1362081439038,1362081439422,2502816694,2502817078,384
1362081444,2502821732,15,3511,234.0666667,1362081438900,1362081442804,2502816632,2502820536,3904
1362081444,2502821732,11,4542,412.9090909,1362081438964,1362081439348,2502816696,2502817080,384
1362081444,2502821732,9,2632,292.4444444,1362081439281,1362081439665,2502817013,2502817397,384
1362081444,2502821736,8,575,71.875,1362081439536,1362081439792,2502817272,2502817528,256
1362081450,2502827680,1,46,46,1362081422117,1362081422117,2502799797,2502799797,0
1362081452,2502829776,11,2980,270.9090909,1362081448837,1362081449541,2502826613,2502827317,704
1362081456,1141148964,8,1036,129.5,1362081429235,1362081429427,1141122199,1141122391,192
1362081458,2502835708,2,473,236.5,1362081430347,1362081430411,2502808055,2502808119,64
1362081460,2502837700,2,98,49,1362081449107,1362081454995,2502826807,2502832695,5888
1362081462,2502839840,66,52797,799.9545455,1362081435975,1362081452743,2502813815,2502830583,16768
1362081462,2502839888,10,560,56,1362081436885,1362081456853,2502814773,2502834741,19968
1362081462,2502839924,10,560,56,1362081437105,1362081457329,2502815029,2502835253,20224
1362081466,2502843716,6,2085,347.5,1362081437891,1362081446211,2502815607,2502823927,8320
1362081466,2502843720,6,576,96,1362081438397,1362081462909,2502816117,2502840629,24512
1362081466,2502843724,8,2591,323.875,1362081438650,1362081438778,2502816374,2502816502,128
1362081466,2502843760,6,336,56,1362081439701,1362081463061,2502817461,2502840821,23360
1362081466,2502843768,3,285,95,1362081440140,1362081440140,2502817908,2502817908,0
1362081466,2502843768,4,435,108.75,1362081440207,1362081440463,2502817975,2502818231,256
1362081466,2502843792,3,1263,421,1362081440438,1362081440566,2502818230,2502818358,128
1362081466,2502843832,14,3750,267.8571429,1362081438477,1362081438925,2502816309,2502816757,448
1362081466,2502843836,3,675,225,1362081438729,1362081438793,2502816565,2502816629,64
1362081466,2502843840,78,75835,972.2435897,1362081438854,1362081448838,2502816694,2502826678,9984
1362081466,2502843840,96,67629,704.46875,1362081438918,1362081456966,2502816758,2502834806,18048
1362081468,2502845664,2,98,49,1362081455032,1362081461176,2502832696,2502838840,6144
1362081468,2502845664,2,98,49,1362081455032,1362081461176,2502832696,2502838840,6144
1362081468,2502845692,3,144,48,1362081455834,1362081461146,2502833526,2502838838,5312
1362081468,2502845692,2,98,49,1362081455834,1362081461146,2502833526,2502838838,5312
1362081468,2502845692,2,98,49,1362081455834,1362081461146,2502833526,2502838838,5312
1362081468,2502845692,3,144,48,1362081455834,1362081461146,2502833526,2502838838,5312
1362081468,2502845692,3,144,48,1362081455833,1362081461145,2502833525,2502838837,5312
1362081468,2502845692,2,98,49,1362081455833,1362081461145,2502833525,2502838837,5312
1362081468,2502845700,3,144,48,1362081456467,1362081462163,2502834167,2502839863,5696
1362081468,2502845704,2,98,49,1362081457357,1362081463117,2502835061,2502840821,5760
1362081468,2502845704,3,150,50,1362081457357,1362081463117,2502835061,2502840821,5760
1362081468,2502845744,2,98,49,1362081454951,1362081461095,2502832695,2502838839,6144
1362081468,2502845776,2,98,49,1362081455749,1362081461061,2502833525,2502838837,5312
1362081468,2502845808,2,98,49,1362081457254,1362081463014,2502835062,2502840822,5760
1362081468,2502845808,3,144,48,1362081457254,1362081463078,2502835062,2502840886,5824
1362081468,2502845808,22,19459,884.5,1362081457254,1362081462502,2502835062,2502840310,5248
1362081468,2502845808,2,98,49,1362081457253,1362081463013,2502835061,2502840821,5760
1362081474,2502851816,27,31188,1155.111111,1362081448796,1362081454108,2502826612,2502831924,5312
1362081474,2502851940,26,29109,1119.576923,1362081448865,1362081454945,2502826805,2502832885,6080
1362081474,2502851944,42,44932,1069.809524,1362081448670,1362081454878,2502826614,2502832822,6208
1362081478,2502855736,43,34383,799.6046512,1362081452910,1362081466478,2502830646,2502844214,13568
1362081478,2502855744,4,1846,461.5,1362081452904,1362081457192,2502830648,2502834936,4288
1362081478,2502855780,13,11190,860.7692308,1362081453635,1362081454787,2502831415,2502832567,1152
1362081478,2502855780,8,4206,525.75,1362081453699,1362081454915,2502831479,2502832695,1216
1362081478,2502855784,6,1246,207.6666667,1362081453694,1362081457150,2502831478,2502834934,3456
1362081478,2502855784,11,11246,1022.363636,1362081453694,1362081454462,2502831478,2502832246,768
1362081478,2502855900,21,21738,1035.142857,1362081453579,1362081454603,2502831479,2502832503,1024
1362081478,2502855900,6,2410,401.6666667,1362081453579,1362081454731,2502831479,2502832631,1152
1362081478,2502855900,53,60487,1141.264151,1362081453579,1362081456139,2502831479,2502834039,2560
1362081482,2502859716,11,10928,993.4545455,1362081454978,1362081455362,2502832694,2502833078,384
1362081482,2502859716,4,999,249.75,1362081454978,1362081455618,2502832694,2502833334,640
1362081482,2502859716,4,345,86.25,1362081454978,1362081455682,2502832694,2502833398,704
1362081482,2502859716,11,10319,938.0909091,1362081454977,1362081455809,2502832693,2502833525,832
1362081482,2502859720,10,9785,978.5,1362081454972,1362081455228,2502832692,2502832948,256
1362081482,2502859752,4,346,86.5,1362081455903,1362081456031,2502833655,2502833783,128
1362081482,2502859784,4,1007,251.75,1362081457279,1362081457791,2502835063,2502835575,512
1362081482,2502859792,5,769,153.8,1362081457270,1362081457654,2502835062,2502835446,384
1362081482,2502859832,4,731,182.75,1362081454861,1362081455437,2502832693,2502833269,576
1362081482,2502859832,11,10402,945.6363636,1362081454861,1362081455629,2502832693,2502833461,768
1362081482,2502859836,11,11243,1022.090909,1362081454859,1362081455179,2502832695,2502833015,320
1362081482,2502859836,4,745,186.25,1362081454859,1362081455371,2502832695,2502833207,512
1362081482,2502859868,4,399,99.75,1362081456105,1362081456425,2502833973,2502834293,320
1362081482,2502859884,4,815,203.75,1362081456987,1362081457179,2502834871,2502835063,192
1362081482,2502859884,4,714,178.5,1362081457178,1362081457562,2502835062,2502835446,384
1362081486,2502863836,10,1684,168.4,1362081458057,1362081478217,2502835893,2502856053,20160
1362081490,2502867712,23,1288,56,1362081462661,1362081486085,2502840373,2502863797,23424
1362081490,2502867716,3,169,56.33333333,1362081462787,1362081462851,2502840503,2502840567,64
1362081490,2502867824,23,1288,56,1362081462232,1362081479896,2502840056,2502857720,17664
1362081490,2502867832,2,123,61.5,1362081462668,1362081462668,2502840500,2502840500,0
1362081494,2502871760,12,672,56,1362081466581,1362081486293,2502844341,2502864053,19712
1362081494,2502871764,2,123,61.5,1362081466769,1362081466769,2502844533,2502844533,0
1362081494,2502871852,14,1344,96,1362081466362,1362081486010,2502844214,2502863862,19648
1362081508,2502885740,2867,3721627,1298.091036,1362081457130,1362081503210,2502834870,2502880950,46080
1362081510,2502888192,3,491,163.6666667,1362081485540,1362081485668,2502863732,2502863860,128
1362081516,2502893748,1908,2536433,1329.3674,1362081469088,1362081509088,2502846836,2502886836,40000
1362081522,2502900168,3,169,56.33333333,1362081496380,1362081496380,2502874548,2502874548,0
1362081522,2502900300,2,123,61.5,1362081497211,1362081497275,2502875511,2502875575,64
1362081522,2502900300,1,77,77,1362081497210,1362081497210,2502875510,2502875510,0
1362081524,2502901732,3,138,46,1362081523185,1362081523185,2502900917,2502900917,0
1362081524,2502901732,2,92,46,1362081523185,1362081523185,2502900917,2502900917,0
1362081524,2502901736,3,138,46,1362081523247,1362081523311,2502900983,2502901047,64
1362081524,2502901736,2,92,46,1362081523244,1362081523244,2502900980,2502900980,0
1362081524,2502901800,3,138,46,1362081522094,1362081522158,2502899894,2502899958,64
1362081524,2502901816,2,92,46,1362081523165,1362081523165,2502900981,2502900981,0
1362081526,2502904264,2,123,61.5,1362081498270,1362081498270,2502876534,2502876534,0
1362081526,2502904320,3,138,46,1362081499237,1362081499301,2502877557,2502877621,64
1362081532,2502909724,3,138,46,1362081524218,1362081524282,2502901942,2502902006,64
1362081532,2502909812,2,92,46,1362081524131,1362081524131,2502901943,2502901943,0
1362081534,2502912176,1,77,77,1362081507381,1362081507381,2502885557,2502885557,0
1362081538,2502916144,2,123,61.5,1362081511381,1362081511381,2502889525,2502889525,0
1362081538,2502916188,2,92,46,1362081513385,1362081513449,2502891573,2502891637,64
1362081538,2502916256,3,138,46,1362081511331,1362081511331,2502889587,2502889587,0
1362081538,2502916308,3,138,46,1362081513267,1362081513331,2502891575,2502891639,64
1362081542,2502920180,2,123,61.5,1362081515375,1362081515375,2502893555,2502893555,0
1362081546,2502924188,1,77,77,1362081521321,1362081521321,2502899509,2502899509,0
1362081546,2502924196,2,92,46,1362081521698,1362081521762,2502899894,2502899958,64
1362081546,2502924300,2,123,61.5,1362081521209,1362081521273,2502899509,2502899573,64
1362081549,1141241312,2,92,46,1362081521152,1362081521152,1141213464,1141213464,0
1362081549,1141241320,1,46,46,1362081522102,1362081522102,1141214422,1141214422,0
1362081549,1141241320,2,92,46,1362081522101,1362081522101,1141214421,1141214421,0
1362081549,1141241372,1,46,46,1362081522053,1362081522053,1141214425,1141214425,0
1362081550,2502928204,3,491,163.6666667,1362081525465,1362081525593,2502903669,2502903797,128
1362081550,2502928320,2,123,61.5,1362081525221,1362081525221,2502903541,2502903541,0
1362081554,2502932272,3,544,181.3333333,1362081527955,1362081527955,2502906227,2502906227,0
1362081554,2502932276,1,46,46,1362081528592,1362081528592,2502906868,2502906868,0
1362081554,2502932312,1,46,46,1362081529005,1362081529005,2502907317,2502907317,0
1362081558,2502936292,1,46,46,1362081530304,1362081530304,2502908596,2502908596,0
1362081582,2502960220,2,92,46,1362081555658,1362081555722,2502933878,2502933942,64
1362081582,2502960224,2,123,61.5,1362081554307,1362081554371,2502932531,2502932595,64
1362081582,2502960260,2,123,61.5,1362081556255,1362081556319,2502934515,2502934579,64
1362081582,2502960332,1,46,46,1362081555544,1362081555544,2502933876,2502933876,0
1362081582,2502960372,1,77,77,1362081556209,1362081556209,2502934581,2502934581,0
1362081582,2502960380,2,123,61.5,1362081555176,1362081555176,2502933556,2502933556,0
1362081588,2502965760,7,412,58.85714286,1362081580820,1362081580820,2502958580,2502958580,0
1362081588,2502965796,7,412,58.85714286,1362081584751,1362081584815,2502962547,2502962611,64
1362081588,2502965864,6,366,61,1362081580718,1362081580718,2502958582,2502958582,0
1362081590,2502968424,3,491,163.6666667,1362081565499,1362081565627,2502943923,2502944051,128
1362081594,2502972316,1,46,46,1362081569576,1362081569576,2502947892,2502947892,0
1362081594,2502972316,1,46,46,1362081569576,1362081569576,2502947892,2502947892,0
1362081594,2502972316,1,46,46,1362081569576,1362081569576,2502947892,2502947892,0
1362081594,2502972348,2,123,61.5,1362081566216,1362081566216,2502944564,2502944564,0
1362081594,2502972392,6,1088,181.3333333,1362081567900,1362081583388,2502946292,2502961780,15488
1362081594,2502972440,1,46,46,1362081569451,1362081569451,2502947891,2502947891,0
1362081594,2502972440,1,46,46,1362081569451,1362081569451,2502947891,2502947891,0
1362081594,2502972440,2,92,46,1362081569451,1362081569451,2502947891,2502947891,0
1362081594,2502972440,1,46,46,1362081569451,1362081569451,2502947891,2502947891,0
1362081596,2502973896,2,98,49,1362081583883,1362081589003,2502961779,2502966899,5120
1362081598,2502976264,2,92,46,1362081571613,1362081571677,2502949877,2502949941,64
1362081598,2502976296,1,46,46,1362081570618,1362081570618,2502948914,2502948914,0
1362081598,2502976300,1,46,46,1362081570618,1362081570618,2502948918,2502948918,0
1362081598,2502976300,1,46,46,1362081570617,1362081570617,2502948917,2502948917,0
1362081598,2502976300,1,46,46,1362081570617,1362081570617,2502948917,2502948917,0
1362081598,2502976312,1,46,46,1362081572587,1362081572587,2502950899,2502950899,0
1362081598,2502976316,2,92,46,1362081572584,1362081572648,2502950900,2502950964,64
1362081598,2502976388,2,123,61.5,1362081570143,1362081570207,2502948531,2502948595,64
1362081598,2502976392,2,92,46,1362081571612,1362081571740,2502950004,2502950132,128
1362081598,2502976400,1,46,46,1362081570517,1362081570517,2502948917,2502948917,0
1362081598,2502976400,1,46,46,1362081570517,1362081570517,2502948917,2502948917,0
1362081598,2502976400,2,92,46,1362081570517,1362081570517,2502948917,2502948917,0
1362081598,2502976400,1,46,46,1362081570517,1362081570517,2502948917,2502948917,0
1362081598,2502976400,1,46,46,1362081570517,1362081570517,2502948917,2502948917,0
1362081598,2502976400,1,46,46,1362081570517,1362081570517,2502948917,2502948917,0
1362081598,2502976400,1,46,46,1362081570517,1362081570517,2502948917,2502948917,0
1362081598,2502976436,2,92,46,1362081572464,1362081572464,2502950900,2502950900,0
1362081598,2502976436,1,46,46,1362081572464,1362081572464,2502950900,2502950900,0
1362081598,2502976440,1,46,46,1362081572458,1362081572458,2502950898,2502950898,0
1362081598,2502976440,1,46,46,1362081572462,1362081572462,2502950902,2502950902,0
1362081602,2502980204,2,123,61.5,1362081574360,1362081574360,2502952564,2502952564,0
1362081606,2502984280,2,92,46,1362081581643,1362081581643,2502959923,2502959923,0
1362081610,2502988380,4,815,203.75,1362081583334,1362081583462,2502961714,2502961842,128
1362081618,2502996236,1,56,56,1362081590199,1362081590199,2502968435,2502968435,0
1362081618,2502996360,1,56,56,1362081590331,1362081590331,2502968691,2502968691,0
1362081620,2502997776,7,412,58.85714286,1362081614788,1362081614788,2502992564,2502992564,0
1362081620,2502997808,7,412,58.85714286,1362081615780,1362081615780,2502993588,2502993588,0
1362081620,2502997808,7,412,58.85714286,1362081615780,1362081615844,2502993588,2502993652,64
1362081620,2502997824,7,412,58.85714286,1362081613716,1362081613780,2502991540,2502991604,64
1362081620,2502997864,136,137255,1009.227941,1362081438762,1362081617706,2502816626,2502995570,178944
1362081620,2502997864,113,108080,956.460177,1362081438762,1362081615722,2502816626,2502993586,176960
1362081628,2503005868,138,118971,862.1086957,1362081438311,1362081625767,2502816179,2503003635,187456
1362081628,2503005904,176,186856,1061.681818,1362081436612,1362081625732,2502814516,2503003636,189120
1362081628,2503005944,7,412,58.85714286,1362081625627,1362081625691,2503003571,2503003635,64
1362081628,2503005948,1962,2537537,1293.341998,1362081585305,1362081620313,2502963253,2502998261,35008
1362081630,2503008460,3,491,163.6666667,1362081604825,1362081604953,2502983285,2502983413,128
1362081634,2503012348,3,544,181.3333333,1362081608072,1362081608136,2502986420,2502986484,64
1362081636,2503013908,7,412,58.85714286,1362081629696,1362081629696,2503007604,2503007604,0
1362081636,2503013920,8,458,57.25,1362081633653,1362081633717,2503011573,2503011637,64
1362081644,2503021876,79,78577,994.6455696,1362081636830,1362081640798,2503014706,2503018674,3968
1362081662,2503040596,4,384,96,1362081636561,1362081647825,2503015157,2503026421,11264
1362081662,2503040600,4,224,56,1362081637066,1362081648138,2503015666,2503026738,11072
1362081663,2503040604,3,168,56,1362081638319,1362081645999,2503015923,2503023603,7680
1362081663,2503040720,4,224,56,1362081638076,1362081649148,2503015796,2503026868,11072
1362081670,2503048572,6,1088,181.3333333,1362081642983,1362081647911,2503021555,2503026483,4928
1362081670,2503048600,3,491,163.6666667,1362081644748,1362081644876,2503023348,2503023476,128
1362081671,2503048712,1,671,671,1362081643908,1362081643908,2503021620,2503021620,0
1362081674,2503052584,5,1950,390,1362081648349,1362081648413,2503026933,2503026997,64
1362081674,2503052584,30,25607,853.5666667,1362081648411,1362081648667,2503026995,2503027251,256
1362081700,2503077868,3,144,48,1362081690406,1362081695526,2503068274,2503073394,5120
1362081707,2503084756,6,2899,483.1666667,1362081682328,1362081690648,2503060084,2503068404,8320
1362081716,2503093888,2,98,49,1362081709137,1362081714513,2503087025,2503092401,5376
1362081716,2503093892,3,144,48,1362081709135,1362081714511,2503087027,2503092403,5376
1362081735,2503112684,7,672,96,1362081706910,1362081709278,2503084594,2503086962,2368
1362081735,2503112804,7,392,56,1362081706792,1362081709032,2503084596,2503086836,2240
1362081735,2503112808,6,336,56,1362081707042,1362081708898,2503084850,2503086706,1856
1362081735,2503112808,7,392,56,1362081707105,1362081714721,2503084913,2503092529,7616
1362081740,2503117908,931,1270121,1364.254565,1362081705471,1362081738623,2503083379,2503116531,33152
1362081755,2503132656,6,1088,181.3333333,1362081728892,1362081751420,2503106548,2503129076,22528
1362081755,2503132692,3,491,163.6666667,1362081730580,1362081730708,2503108272,2503108400,128
1362081767,2503144616,1050,1351349,1286.999048,1362081460451,1362081466659,2502838067,2502844275,6208
1362081772,2503149928,5,363,72.6,1362081769131,1362081769195,2503147059,2503147123,64
1362081779,2503156752,5,1642,328.4,1362081751322,1362081778778,2503129074,2503156530,27456
1362081780,2503157888,2,98,49,1362081772563,1362081779347,2503150451,2503157235,6784
1362081780,2503157888,4,458,114.5,1362081775825,1362081776273,2503153713,2503154161,448
1362081780,2503157888,4,467,116.75,1362081775825,1362081776273,2503153713,2503154161,448
1362081780,2503158008,6,282,47,1362081776858,1362081777050,2503154866,2503155058,192
1362081780,1141472564,8,677,84.625,1362081776835,1362081777027,1141469399,1141469591,192
1362081787,2503164728,69,60177,872.1304348,1362081761778,1362081786610,2503139506,2503164338,24832
1362081788,2503165888,2,98,49,1362081775250,1362081781458,2503153138,2503159346,6208
1362081788,2503165892,2,98,49,1362081775820,1362081781452,2503153712,2503159344,5632
1362081788,2503165896,3,144,48,1362081779466,1362081785418,2503157362,2503163314,5952
1362081788,2503165920,2,98,49,1362081776307,1362081781427,2503154227,2503159347,5120
1362081788,2503165920,3,140,46.66666667,1362081776242,1362081781426,2503154162,2503159346,5184
1362081788,2503165920,2,98,49,1362081776306,1362081781426,2503154226,2503159346,5120
1362081788,2503165924,3,144,48,1362081781484,1362081787628,2503159408,2503165552,6144
1362081788,2503165928,2,98,49,1362081781483,1362081787435,2503159411,2503165363,5952
1362081788,2503165928,3,150,50,1362081781483,1362081787755,2503159411,2503165683,6272
1362081788,2503165928,3,150,50,1362081781483,1362081787755,2503159411,2503165683,6272
1362081788,2503165936,10,1211,121.1,1362081785249,1362081785569,2503163185,2503163505,320
1362081788,2503165936,16,7794,487.125,1362081785568,1362081785888,2503163504,2503163824,320
1362081788,1141480560,3,144,48,1362081779464,1362081785288,1141472024,1141477848,5824
1362081788,2503165972,2,98,49,1362081779389,1362081785341,2503157361,2503163313,5952
1362081788,2503165972,3,144,48,1362081779389,1362081785341,2503157361,2503163313,5952
1362081788,1141480564,3,144,48,1362081775686,1362081781318,1141468250,1141473882,5632
1362081788,2503165996,2,98,49,1362081779494,1362081785318,2503157490,2503163314,5824
1362081788,2503165996,3,140,46.66666667,1362081776164,1362081781348,2503154160,2503159344,5184
1362081788,1141480564,2,98,49,1362081776196,1362081781316,1141468760,1141473880,5120
1362081788,2503166004,2,98,49,1362081781407,1362081787359,2503159411,2503165363,5952
1362081788,2503166004,3,144,48,1362081781407,1362081787359,2503159411,2503165363,5952
1362081788,2503166004,4,196,49,1362081781405,1362081787741,2503159409,2503165745,6336
1362081788,2503166004,3,150,50,1362081781405,1362081787677,2503159409,2503165681,6272
1362081791,2503168764,1,46,46,1362081764619,1362081764619,2503142383,2503142383,0
1362081791,2503168884,2,92,46,1362081764503,1362081764503,2503142387,2503142387,0
1362081795,2503172808,3,491,163.6666667,1362081770529,1362081770657,2503148337,2503148465,128
1362081795,2503172880,8,1491,186.375,1362081768728,1362081788632,2503146608,2503166512,19904
1362081795,2503172888,43,8099,188.3488372,1362081769168,1362081783184,2503147056,2503161072,14016
1362081796,2503173892,2,98,49,1362081788751,1362081794831,2503166643,2503172723,6080
1362081796,2503173892,12,4027,335.5833333,1362081788815,1362081789327,2503166707,2503167219,512
1362081796,2503173912,3,144,48,1362081789176,1362081794808,2503167088,2503172720,5632
1362081796,2503173912,2,98,49,1362081789176,1362081794808,2503167088,2503172720,5632
1362081796,2503173916,3,325,108.3333333,1362081789238,1362081794870,2503167154,2503172786,5632
1362081796,2503173972,9,2213,245.8888889,1362081775743,1362081788607,2503153715,2503166579,12864
1362081796,2503173996,2,98,49,1362081788646,1362081794726,2503166642,2503172722,6080
1362081796,2503173996,10,1258,125.8,1362081788708,1362081789476,2503166704,2503167472,768
1362081796,2503174000,1339,1720885,1285.201643,1362081787682,1362081792290,2503165682,2503170290,4608
1362081796,2503174000,9,1212,134.6666667,1362081788833,1362081792289,2503166833,2503170289,3456
1362081796,2503174004,2,98,49,1362081789087,1362081794719,2503167091,2503172723,5632
1362081801,1141493436,5,2316,463.2,1362081775813,1362081776325,1141468249,1141468761,512
1362081801,1141493480,4,994,248.5,1362081775768,1362081775896,1141468248,1141468376,128
1362081801,1141493488,17,15407,906.2941176,1362081776528,1362081776656,1141469016,1141469144,128
1362081803,2503180744,8,6909,863.625,1362081778786,1362081781666,2503156530,2503159410,2880
1362081803,2503180748,25,22858,914.32,1362081775006,1362081780830,2503152754,2503158578,5824
1362081803,2503180748,34,33456,984,1362081775005,1362081783389,2503152753,2503161137,8384
1362081803,2503180748,32,31864,995.75,1362081775005,1362081783453,2503152753,2503161201,8448
1362081803,2503180752,11,11127,1011.545455,1362081775384,1362081778264,2503153136,2503156016,2880
1362081803,2503180756,15,15131,1008.733333,1362081775382,1362081778454,2503153138,2503156210,3072
1362081803,2503180756,31,33006,1064.709677,1362081775382,1362081783574,2503153138,2503161330,8192
1362081803,2503180756,13,9581,737,1362081775382,1362081781206,2503153138,2503158962,5824
1362081803,2503180756,19,1064,56,1362081775509,1362081800853,2503153265,2503178609,25344
1362081803,2503180760,18,1728,96,1362081775888,1362081800464,2503153648,2503178224,24576
1362081803,2503180780,18,1008,56,1362081775996,1362081800572,2503153776,2503178352,24576
1362081803,2503180788,25,13970,558.8,1362081776437,1362081799733,2503154225,2503177521,23296
1362081803,2503180792,31,31201,1006.483871,1362081776626,1362081788978,2503154418,2503166770,12352
1362081803,2503180796,8,5580,697.5,1362081777261,1362081778669,2503155057,2503156465,1408
1362081803,2503180796,47,55262,1175.787234,1362081777261,1362081783661,2503155057,2503161457,6400
1362081803,2503180796,7,2908,415.4285714,1362081777261,1362081778733,2503155057,2503156529,1472
1362081803,2503180796,20,20952,1047.6,1362081777260,1362081781100,2503155056,2503158896,3840
1362081803,2503180844,19,16614,874.4210526,1362081774909,1362081780797,2503152753,2503158641,5888
1362081803,2503180844,33,37961,1150.333333,1362081774909,1362081778941,2503152753,2503156785,4032
1362081803,2503180844,29,25510,879.6551724,1362081774909,1362081783549,2503152753,2503161393,8640
1362081803,2503180872,22,16739,760.8636364,1362081775265,1362081784673,2503153137,2503162545,9408
1362081803,2503180876,18,1008,56,1362081775517,1362081799901,2503153393,2503177777,24384
1362081803,2503180880,6,990,165,1362081775833,1362081784537,2503153713,2503162417,8704
1362081803,2503180916,17,13095,770.2941176,1362081777142,1362081781174,2503155058,2503159090,4032
1362081803,2503180916,15,14631,975.4,1362081777142,1362081781174,2503155058,2503159090,4032
1362081803,2503180916,4,399,99.75,1362081777206,1362081782390,2503155122,2503160306,5184
1362081803,2503180916,9,6499,722.1111111,1362081777140,1362081781300,2503155056,2503159216,4160
1362081803,2503180916,9,896,99.55555556,1362081777140,1362081780404,2503155056,2503158320,3264
1362081804,2503181888,10,1258,125.8,1362081795922,1362081799954,2503173810,2503177842,4032
1362081804,2503181888,10,1258,125.8,1362081795921,1362081796241,2503173809,2503174129,320
1362081805,1141497436,6,585,97.5,1362081779590,1362081779910,1141472026,1141472346,320
1362081807,2503184780,6,4347,724.5,1362081779581,1362081780989,2503157361,2503158769,1408
1362081807,2503184780,5,3728,745.6,1362081779581,1362081781565,2503157361,2503159345,1984
1362081807,2503184820,11,10429,948.0909091,1362081781588,1362081781652,2503159408,2503159472,64
1362081807,2503184824,8,1587,198.375,1362081781583,1362081784783,2503159407,2503162607,3200
1362081807,2503184828,3,513,171,1362081781835,1362081782027,2503159663,2503159855,192
1362081807,2503184904,7,5135,733.5714286,1362081779458,1362081781058,2503157362,2503158962,1600
1362081807,2503184904,6,3917,652.8333333,1362081779458,1362081781250,2503157362,2503159154,1792
1362081807,2503184916,20,7340,367,1362081781494,1362081803638,2503159410,2503181554,22144
1362081807,2503184916,4,1199,299.75,1362081781494,1362081781750,2503159410,2503159666,256
1362081812,2503189884,2,98,49,1362081803990,1362081809750,2503181874,2503187634,5760
1362081812,2503189884,2,98,49,1362081803990,1362081809750,2503181874,2503187634,5760
1362081812,2503189892,3,144,48,1362081804365,1362081809741,2503182257,2503187633,5376
1362081812,2503189896,10,1258,125.8,1362081803593,1362081804041,2503181489,2503181937,448
1362081812,2503189896,3,325,108.3333333,1362081803656,1362081809736,2503181552,2503187632,6080
1362081812,2503189964,2,98,49,1362081803908,1362081809668,2503181872,2503187632,5760
1362081812,2503189964,2,98,49,1362081803907,1362081809667,2503181871,2503187631,5760
1362081812,2503190012,3,144,48,1362081805463,1362081810647,2503183475,2503188659,5184
1362081815,2503192724,1,46,46,1362081788276,1362081788276,2503166000,2503166000,0
1362081815,2503192732,17,5007,294.5294118,1362081788525,1362081808173,2503166257,2503185905,19648
1362081815,2503192764,1,46,46,1362081788878,1362081788878,2503166642,2503166642,0
1362081815,2503192836,2,92,46,1362081788164,1362081788164,2503166000,2503166000,0
1362081815,2503192836,1,46,46,1362081788164,1362081788164,2503166000,2503166000,0
1362081815,2503192840,4,1032,258,1362081787008,1362081787200,2503164848,2503165040,192
1362081815,2503192876,3,626,208.6666667,1362081788767,1362081788959,2503166643,2503166835,192
1362081820,2503197920,3,144,48,1362081809457,1362081814705,2503187377,2503192625,5248
1362081820,2503198004,2,98,49,1362081809373,1362081814621,2503187377,2503192625,5248
1362081831,2503208972,5,747,149.4,1362081803902,1362081804094,2503181874,2503182066,192
1362081831,2503208972,4,815,203.75,1362081803901,1362081804349,2503181873,2503182321,448
1362081831,2503208972,2,963,481.5,1362081803900,1362081803964,2503181872,2503181936,64
1362081831,2503209004,31,2976,96,1362081803421,1362081826781,2503181425,2503204785,23360
1362081831,2503209048,9,1238,137.5555556,1362081805426,1362081825842,2503183474,2503203890,20416
1362081831,2503209084,5,1095,219,1362081803789,1362081803981,2503181873,2503182065,192
1362081831,2503209096,4,1002,250.5,1362081804159,1362081804287,2503182255,2503182383,128
1362081831,2503209100,32,1792,56,1362081803323,1362081830587,2503181423,2503208687,27264
1362081831,2503209104,3,1108,369.3333333,1362081803320,1362081803576,2503181424,2503181680,256
1362081831,2503209124,31,1736,56,1362081803491,1362081827683,2503181615,2503205807,24192
1362081831,2503209132,31,1736,56,1362081803613,1362081829853,2503181745,2503207985,26240
1362081831,2503209144,12,2188,182.3333333,1362081805330,1362081825426,2503183474,2503203570,20096
1362081835,2503213196,3,491,163.6666667,1362081810077,1362081810205,2503188273,2503188401,128
1362081835,2503213196,2,92,46,1362081810076,1362081810204,2503188272,2503188400,128
1362081852,2503229928,1326,1754699,1323.302413,1362081809833,1362081846825,2503187761,2503224753,36992
1362081859,2503237020,12,1152,96,1362081831181,1362081850573,2503209201,2503228593,19392
1362081859,2503237020,11,616,56,1362081831307,1362081846731,2503209327,2503224751,15424
1362081859,2503237020,11,616,56,1362081831371,1362081850315,2503209391,2503228335,18944
1362081859,2503237148,11,616,56,1362081831308,1362081850316,2503209456,2503228464,19008
1362081863,2503241068,3,169,56.33333333,1362081837148,1362081837148,2503215216,2503215216,0
1362081863,2503241132,3,544,181.3333333,1362081835742,1362081835742,2503213874,2503213874,0
1362081863,2503241148,3,544,181.3333333,1362081835467,1362081835531,2503213615,2503213679,64
1362081867,2503245220,2,123,61.5,1362081840965,1362081841029,2503219185,2503219249,64
1362081868,2503245988,3752,5078196,1353.463753,1362081812716,1362081863852,2503190704,2503241840,51136
1362081875,2503253092,5,1053,210.6,1362081850179,1362081871939,2503228271,2503250031,21760
1362081884,2503261888,6,496,82.66666667,1362081879632,1362081881744,2503257520,2503259632,2112
1362081899,2503277092,8,448,56,1362081872132,1362081897924,2503250224,2503276016,25792
1362081899,2503277096,8,448,56,1362081872513,1362081898049,2503250609,2503276145,25536
1362081899,2503277100,8,448,56,1362081872573,1362081898109,2503250673,2503276209,25536
1362081903,2503281016,8,768,96,1362081875150,1362081898958,2503253166,2503276974,23808
1362081903,2503281144,7,1146,163.7142857,1362081875598,1362081894222,2503253742,2503272366,18624
1362081907,2503285156,1,46,46,1362081879363,1362081879363,2503257519,2503257519,0
1362081908,2503285988,1965,2545955,1295.651399,1362081871020,1362081906924,2503249008,2503284912,35904
1362081916,2503294076,3,144,48,1362081908178,1362081913234,2503286254,2503291310,5056
1362081917,1141609608,1,46,46,1362081891995,1362081891995,1141584603,1141584603,0
1362081917,1141609700,2,92,46,1362081891903,1362081891903,1141584603,1141584603,0
1362081919,2503297144,2,92,46,1362081893904,1362081893904,2503272048,2503272048,0
1362081919,2503297144,1,46,46,1362081893904,1362081893904,2503272048,2503272048,0
1362081919,2503297152,1,671,671,1362081894213,1362081894213,2503272365,2503272365,0
1362081919,2503297272,1,46,46,1362081893776,1362081893776,2503272048,2503272048,0
1362081919,2503297272,1,46,46,1362081893774,1362081893774,2503272046,2503272046,0
1362081917,1141609700,1,46,46,1362081891902,1362081891902,1141584602,1141584602,0
1362081921,1141613640,2,92,46,1362081894905,1362081894905,1141587545,1141587545,0
1362081923,2503301048,1,46,46,1362081895982,1362081895982,2503274030,2503274030,0
1362081923,2503301052,1,46,46,1362081895980,1362081895980,2503274032,2503274032,0
1362081923,2503301076,2,92,46,1362081896914,1362081896978,2503274990,2503275054,64
1362081923,2503301076,1,46,46,1362081896914,1362081896914,2503274990,2503274990,0
1362081923,2503301080,1,46,46,1362081896912,1362081896912,2503274992,2503274992,0
1362081923,2503301220,2,92,46,1362081897924,1362081897988,2503276144,2503276208,64
1362081923,2503301260,1,46,46,1362081895770,1362081895770,2503274030,2503274030,0
1362081923,2503301264,2,92,46,1362081895768,1362081895768,2503274032,2503274032,0
1362081923,2503301264,1,46,46,1362081895768,1362081895768,2503274032,2503274032,0
1362081923,2503301264,1,46,46,1362081895768,1362081895768,2503274032,2503274032,0
1362081923,2503301264,2,123,61.5,1362081895959,1362081895959,2503274223,2503274223,0
1362081923,2503301296,1,46,46,1362081896694,1362081896694,2503274990,2503274990,0
1362081923,2503301296,1,46,46,1362081896694,1362081896694,2503274990,2503274990,0
1362081923,2503301300,1,46,46,1362081896690,1362081896690,2503274990,2503274990,0
1362081923,2503301300,1,46,46,1362081896690,1362081896690,2503274990,2503274990,0
1362081923,2503301300,1,46,46,1362081896754,1362081896754,2503275054,2503275054,0
1362081927,2503305044,1,46,46,1362081898995,1362081898995,2503277039,2503277039,0
1362081927,2503305044,1,46,46,1362081898994,1362081898994,2503277038,2503277038,0
1362081927,2503305044,16,896,56,1362081899954,1362081922098,2503277998,2503300142,22144
1362081927,2503305044,2,92,46,1362081899953,1362081900017,2503277997,2503278061,64
1362081927,2503305048,1,46,46,1362081899949,1362081899949,2503277997,2503277997,0
1362081927,2503305056,15,840,56,1362081900454,1362081921702,2503278510,2503299758,21248
1362081927,2503305120,2,92,46,1362081898918,1362081898918,2503277038,2503277038,0
1362081927,2503305120,1,46,46,1362081898918,1362081898918,2503277038,2503277038,0
1362081927,2503305120,2,92,46,1362081898917,1362081898917,2503277037,2503277037,0
1362081927,2503305124,1,46,46,1362081899874,1362081899874,2503277998,2503277998,0
1362081927,2503305156,16,896,56,1362081900035,1362081923203,2503278191,2503301359,23168
1362081927,2503305156,2,123,61.5,1362081900035,1362081900099,2503278191,2503278255,64
1362081931,2503309032,15,1440,96,1362081902975,1362081921791,2503281007,2503299823,18816
1362081931,2503309124,2,92,46,1362081902885,1362081902949,2503281009,2503281073,64
1362081931,2503309156,2,92,46,1362081903874,1362081903874,2503282030,2503282030,0
1362081931,2503309156,1,46,46,1362081903874,1362081903874,2503282030,2503282030,0
1362081935,2503313076,6,2556,426,1362081908116,1362081920340,2503286192,2503298416,12224
1362081943,2503321228,4,596,149,1362081915643,1362081915643,2503293871,2503293871,0
1362081947,2503325080,2,92,46,1362081919245,1362081919245,2503297325,2503297325,0
1362081947,2503325080,1,46,46,1362081919245,1362081919245,2503297325,2503297325,0
1362081947,2503325080,1,46,46,1362081919245,1362081919245,2503297325,2503297325,0
1362081947,2503325112,2,92,46,1362081920301,1362081920301,2503298413,2503298413,0
1362081947,2503325116,1,46,46,1362081920299,1362081920299,2503298415,2503298415,0
1362081947,2503325200,1,46,46,1362081919125,1362081919125,2503297325,2503297325,0
1362081951,2503329092,2,92,46,1362081923265,1362081923329,2503301357,2503301421,64
1362081956,2503334032,7,412,58.85714286,1362081955200,1362081955200,2503333232,2503333232,0
1362081956,2503334100,1878,2536433,1350.603301,1362081914684,1362081951676,2503292784,2503329776,36992
1362081964,2503342224,7,412,58.85714286,1362081959039,1362081959039,2503337263,2503337263,0
1362081980,2503357656,2,92,46,1362081951732,1362081951732,2503329388,2503329388,0
1362081983,2503361612,7,1140,162.8571429,1362081955324,1362081982332,2503333936,2503360944,27008
1362081987,2503365548,2,445,222.5,1362081959738,1362081959866,2503338286,2503338414,128
1362081987,2503365588,7,392,56,1362081960787,1362081964627,2503339375,2503343215,3840
1362081987,2503365588,7,392,56,1362081960851,1362081964691,2503339439,2503343279,3840
1362081988,2503365668,8,448,56,1362081961129,1362081965737,2503338797,2503343405,4608
1362081988,2503365672,8,768,96,1362081961637,1362081965989,2503339309,2503343661,4352
1362081996,2503374168,1933,2543103,1315.624935,1362081958644,1362081995060,2503336812,2503373228,36416
1362082004,2503382124,145,115683,797.8137931,1362081402339,1362082003811,2502780463,2503381935,601472
1362082008,2503385684,4,1434,358.5,1362081983194,1362082001050,2503360878,2503378734,17856
1362082012,2503389652,11,2034,184.9090909,1362081986363,1362082009275,2503364015,2503386927,22912
1362082020,2503398044,3,144,48,1362082008627,1362082014259,2503386671,2503392303,5632
1362082020,2503398160,4,467,116.75,1362082014525,1362082014717,2503392685,2503392877,192
1362082020,2503398204,4,190,47.5,1362082008338,1362082014162,2503386542,2503392366,5824
1362082023,2503401564,3,544,181.3333333,1362081995627,1362081995691,2503374191,2503374255,64
1362082023,2503401596,20,1120,56,1362081996361,1362082021897,2503374957,2503400493,25536
1362082024,2503401636,19,1064,56,1362081998665,1362082020873,2503376301,2503398509,22208
1362082024,2503401644,19,1824,96,1362081999107,1362082021827,2503376751,2503399471,22720
1362082024,2503401720,19,1064,56,1362081997751,1362082020407,2503375471,2503398127,22656
1362082028,2503405696,3,491,163.6666667,1362082001231,1362082001359,2503378927,2503379055,128
1362082028,2503406036,2,98,49,1362082015417,1362082021433,2503393453,2503399469,6016
1362082028,2503406036,2,98,49,1362082015481,1362082021497,2503393517,2503399533,6016
1362082028,2503406036,3,144,48,1362082015417,1362082021497,2503393453,2503399533,6080
1362082028,2503406036,2,98,49,1362082015481,1362082021497,2503393517,2503399533,6016
1362082028,2503406052,920,1185151,1288.207609,1362082016425,1362082025513,2503394477,2503403565,9088
1362082028,1141720624,2,98,49,1362082014604,1362082020428,1141707228,1141713052,5824
1362082028,1141720632,2,98,49,1362082014596,1362082020420,1141707228,1141713052,5824
1362082028,1141720644,3,144,48,1362082014903,1362082020407,1141707547,1141713051,5504
1362082028,2503406084,2,98,49,1362082014411,1362082020427,2503392495,2503398511,6016
1362082028,2503406084,2,98,49,1362082014410,1362082020426,2503392494,2503398510,6016
1362082028,2503406084,3,144,48,1362082014410,1362082020426,2503392494,2503398510,6016
1362082028,2503406084,2,98,49,1362082014410,1362082020426,2503392494,2503398510,6016
1362082028,2503406084,3,144,48,1362082014410,1362082020426,2503392494,2503398510,6016
1362082028,2503406084,2,98,49,1362082014665,1362082020425,2503392749,2503398509,5760
1362082028,2503406084,2,98,49,1362082014600,1362082020424,2503392684,2503398508,5824
1362082028,2503406084,3,140,46.66666667,1362082014600,1362082020424,2503392684,2503398508,5824
1362082028,2503406084,2,98,49,1362082014664,1362082020424,2503392748,2503398508,5760
1362082028,2503406120,4,190,47.5,1362082015335,1362082021415,2503393455,2503399535,6080
1362082028,2503406120,2,98,49,1362082015398,1362082021414,2503393518,2503399534,6016
1362082028,2503406156,3,144,48,1362082016322,1362082022338,2503394478,2503400494,6016
1362082028,2503406168,3,144,48,1362082014325,1362082020341,2503392493,2503398509,6016
1362082028,2503406168,2,98,49,1362082014325,1362082020341,2503392493,2503398509,6016
1362082028,2503406168,2,98,49,1362082014325,1362082020341,2503392493,2503398509,6016
1362082028,2503406172,2,98,49,1362082014515,1362082020339,2503392687,2503398511,5824
1362082028,2503406172,3,140,46.66666667,1362082014514,1362082020338,2503392686,2503398510,5824
1362082028,2503406196,3,144,48,1362082015193,1362082020377,2503393389,2503398573,5184
1362082032,2503409764,7,832,118.8571429,1362082006539,1362082006795,2503384303,2503384559,256
1362082035,2503413588,43,34793,809.1395349,1362082008080,1362082033104,2503386668,2503411692,25024
1362082036,2503413704,8,1431,178.875,1362082008967,1362082031623,2503386671,2503409327,22656
1362082036,2503414068,2,98,49,1362082029464,1362082034712,2503407532,2503412780,5248
1362082036,2503414068,2,98,49,1362082029464,1362082034712,2503407532,2503412780,5248
1362082036,2503414068,3,144,48,1362082029464,1362082034776,2503407532,2503412844,5312
1362082036,2503414068,2,98,49,1362082029464,1362082034712,2503407532,2503412780,5248
1362082036,2503414068,2,98,49,1362082029464,1362082034712,2503407532,2503412780,5248
1362082036,2503414080,2,98,49,1362082030479,1362082035727,2503408559,2503413807,5248
1362082036,2503414084,3,144,48,1362082026120,1362082031752,2503404204,2503409836,5632
1362082036,2503414160,2,98,49,1362082029375,1362082034623,2503407535,2503412783,5248
1362082036,2503414160,2,98,49,1362082029374,1362082034622,2503407534,2503412782,5248
1362082036,2503414160,2,98,49,1362082029373,1362082034621,2503407533,2503412781,5248
1362082040,2503417676,14,10757,768.3571429,1362082014817,1362082031393,2503392493,2503409069,16576
1362082040,2503417684,15,1835,122.3333333,1362082015577,1362082029913,2503393261,2503407597,14336
1362082040,2503417688,4,608,152,1362082015765,1362082033109,2503393453,2503410797,17344
1362082040,2503417772,28,26439,944.25,1362082014721,1362082031809,2503392493,2503409581,17088
1362082040,2503417772,36,38657,1073.805556,1362082014721,1362082033729,2503392493,2503411501,19008
1362082040,2503417788,9,4067,451.8888889,1362082014961,1362082015217,2503392749,2503393005,256
1362082040,2503417792,35,42846,1224.171429,1362082015150,1362082015534,2503392942,2503393326,384
1362082041,1141733868,9,1026,114,1362082014869,1362082016085,1141707737,1141708953,1216
1362082043,2503421584,9,3000,333.3333333,1362082014934,1362082015126,2503393518,2503393710,192
1362082044,2503421716,10,810,81,1362082016057,1362082031481,2503393773,2503409197,15424
1362082044,2503422056,3,144,48,1362082031525,1362082037733,2503409581,2503415789,6208
1362082044,2503422060,2,98,49,1362082031778,1362082037730,2503409838,2503415790,5952
1362082044,2503422076,787,1056543,1342.494282,1362082000594,1362082036178,2503378670,2503414254,35584
1362082044,2503422140,2,98,49,1362082031443,1362082037651,2503409583,2503415791,6208
1362082044,2503422140,2,98,49,1362082031443,1362082037651,2503409583,2503415791,6208
1362082044,2503422140,2,98,49,1362082031697,1362082037649,2503409837,2503415789,5952
1362082044,2503422152,4,190,47.5,1362082032581,1362082038661,2503410733,2503416813,6080
1362082044,2503422188,2,98,49,1362082033635,1362082039651,2503411823,2503417839,6016
1362082044,2503422188,3,144,48,1362082033635,1362082039651,2503411823,2503417839,6016
1362082052,2503429624,17,952,56,1362082025939,1362082050835,2503403563,2503428459,24896
1362082052,2503429632,13,11376,875.0769231,1362082026382,1362082046286,2503404014,2503423918,19904
1362082052,2503429660,16,896,56,1362082026738,1362082050674,2503404398,2503428334,23936
1362082052,2503429744,10,8536,853.6,1362082026271,1362082045919,2503404015,2503423663,19648
1362082052,2503429744,17,952,56,1362082026269,1362082051165,2503404013,2503428909,24896
1362082052,2503429748,16,1536,96,1362082026395,1362082050459,2503404143,2503428207,24064
1362082056,2503433836,4,707,176.75,1362082029698,1362082029890,2503407534,2503407726,192
1362082056,2503433848,8,1798,224.75,1362082030708,1362082033908,2503408556,2503411756,3200
1362082056,2503433848,8,3125,390.625,1362082030708,1362082033972,2503408556,2503411820,3264
1362082060,2503437600,10,8099,809.9,1362082031980,1362082046380,2503409580,2503423980,14400
1362082060,2503437600,5,1750,350,1362082032236,1362082032620,2503409836,2503410220,384
1362082060,2503437648,4,1282,320.5,1362082033535,1362082033919,2503411183,2503411567,384
1362082060,2503437652,5,2472,494.4,1362082034169,1362082034361,2503411821,2503412013,192
1362082060,2503437700,6,3488,581.3333333,1362082031881,1362082032073,2503409581,2503409773,192
1362082060,2503437704,11,6514,592.1818182,1362082032134,1362082043270,2503409838,2503420974,11136
1362082060,2503437704,13,12112,931.6923077,1362082032134,1362082032646,2503409838,2503410350,512
1362082060,2503437728,3,498,166,1362082032494,1362082032686,2503410222,2503410414,192
1362082060,2503437732,3,550,183.3333333,1362082032999,1362082033191,2503410731,2503410923,192
1362082060,2503437736,7,1540,220,1362082033189,1362082053349,2503410925,2503431085,20160
1362082060,2503437740,4,1772,443,1362082033439,1362082033759,2503411179,2503411499,320
1362082060,2503437740,3,1368,456,1362082033439,1362082033887,2503411179,2503411627,448
1362082060,2503437768,4,324,81,1362082034051,1362082034115,2503411819,2503411883,64
1362082060,2503438176,2,98,49,1362082046124,1362082052012,2503424300,2503430188,5888
1362082060,2503438176,2,98,49,1362082046252,1362082052012,2503424428,2503430188,5760
1362082060,2503438256,3,144,48,1362082046173,1362082051933,2503424429,2503430189,5760
1362082060,2503438256,3,144,48,1362082046237,1362082051933,2503424493,2503430189,5696
1362082068,2503445764,2,445,222.5,1362082040522,1362082040650,2503418286,2503418414,128
1362082068,2503445844,2,616,308,1362082043193,1362082043193,2503421037,2503421037,0
1362082072,2503449708,3,2614,871.3333333,1362082046015,1362082046079,2503423723,2503423787,64
1362082072,2503449712,8,7828,978.5,1362082046204,1362082046396,2503423916,2503424108,192
1362082072,2503449716,7,5184,740.5714286,1362082046458,1362082046586,2503424174,2503424302,128
1362082072,2503449716,6,4121,686.8333333,1362082046583,1362082046775,2503424299,2503424491,192
1362082072,2503449716,7,4986,712.2857143,1362082046519,1362082046647,2503424235,2503424363,128
1362082072,2503449864,14,13337,952.6428571,1362082045926,1362082046310,2503423790,2503424174,384
1362082072,2503449868,6,4074,679,1362082046242,1362082046370,2503424110,2503424238,128
1362082072,2503449872,7,5256,750.8571429,1362082046366,1362082046558,2503424238,2503424430,192
1362082076,2503454352,1448,1848015,1276.253453,1362082029181,1362082074173,2503407533,2503452525,44992
1362082080,2503457652,1,96,96,1362082052473,1362082052473,2503430125,2503430125,0
1362082080,2503457696,1,56,56,1362082053774,1362082053774,2503431470,2503431470,0
1362082080,2503457812,1,56,56,1362082053211,1362082053211,2503431023,2503431023,0
1362082084,2503461660,178,229901,1291.578652,1362081779824,1362081780912,2503157484,2503158572,1088
1362082084,2503461788,3,138,46,1362082059696,1362082059760,2503437484,2503437548,64
1362082084,2503462256,2905,3684779,1268.426506,1362082029277,1362082079965,2503407533,2503458221,50688
1362082100,2503478532,3,169,56.33333333,1362082073480,1362082073480,2503452012,2503452012,0
1362082101,2503478700,1,46,46,1362082074761,1362082074761,2503452461,2503452461,0
1362082101,2503478736,1,46,46,1362082074789,1362082074789,2503452525,2503452525,0
1362082101,2503478820,1,46,46,1362082074768,1362082074768,2503452588,2503452588,0
1362082101,2503479388,1,46,46,1362082074137,1362082074137,2503452525,2503452525,0
1362082101,2503479432,1,46,46,1362082074094,1362082074094,2503452526,2503452526,0
1362082108,2503485672,3,491,163.6666667,1362082080678,1362082080806,2503458350,2503458478,128
1362082111,2503489520,165,209399,1269.084848,1362081803350,1362081809174,2503181870,2503187694,5824
1362082111,2503489520,1390,1803119,1297.207914,1362081803350,1362081809238,2503181870,2503187758,5888
1362082116,2503493740,2,123,61.5,1362082090271,1362082090271,2503468011,2503468011,0
1362082116,2503494304,3,150,50,1362082109484,1362082114860,2503487788,2503493164,5376
1362082116,2503494304,3,144,48,1362082109484,1362082114860,2503487788,2503493164,5376
1362082116,2503494304,2,98,49,1362082109484,1362082114860,2503487788,2503493164,5376
1362082116,2503494304,2,98,49,1362082109483,1362082114859,2503487787,2503493163,5376
1362082116,2503494392,2,98,49,1362082109395,1362082114771,2503487787,2503493163,5376
1362082116,2503494396,2,98,49,1362082109393,1362082114769,2503487789,2503493165,5376
1362082116,2503494396,3,150,50,1362082109393,1362082114769,2503487789,2503493165,5376
1362082124,2503501712,6,1088,181.3333333,1362082097917,1362082107965,2503475629,2503485677,10048
1362082124,2503502372,6,497,82.83333333,1362082120169,1362082122281,2503498541,2503500653,2112
1362082128,2503505776,3,544,181.3333333,1362082103420,1362082103484,2503481196,2503481260,64
1362082136,2503514188,7,1642,234.5714286,1362082109023,1362082109279,2503487211,2503487467,256
1362082144,2503521996,5,280,56,1362082119583,1362082132959,2503497579,2503510955,13376
1362082144,2503522128,5,480,96,1362082119259,1362082132059,2503497387,2503510187,12800
1362082144,2503522132,1,46,46,1362082116057,1362082116057,2503494189,2503494189,0
1362082144,2503522172,5,280,56,1362082116721,1362082131377,2503494893,2503509549,14656
1362082148,2503526128,6,1942,323.6666667,1362082120157,1362082147613,2503498285,2503525741,27456
1362082148,2503526128,1,46,46,1362082120411,1362082120411,2503498539,2503498539,0
1362082148,2503526340,5,280,56,1362082119945,1362082132937,2503498285,2503511277,12992
1362082152,2503529976,2,92,46,1362082124213,1362082124213,2503502189,2503502189,0
1362082152,2503529988,1,46,46,1362082124521,1362082124521,2503502509,2503502509,0
1362082156,2503534144,2,92,46,1362082129995,1362082130059,2503508139,2503508203,64
1362082156,2503534156,3,662,220.6666667,1362082131070,1362082131134,2503509226,2503509290,64
1362082156,2503534160,2,92,46,1362082131069,1362082131069,2503509229,2503509229,0
1362082156,2503534444,3,144,48,1362082147230,1362082152798,2503525674,2503531242,5568
1362082157,1141850004,2,92,46,1362082131792,1362082131792,1141824796,1141824796,0
1362082160,2503538140,2,123,61.5,1362082132877,1362082132877,2503511017,2503511017,0
1362082168,2503546220,3,544,181.3333333,1362082143038,1362082143038,2503521258,2503521258,0
1362082172,2503550184,1,46,46,1362082147042,1362082147042,2503525226,2503525226,0
1362082172,2503550260,2,92,46,1362082144982,1362082144982,2503523242,2503523242,0
1362082172,2503550376,2,92,46,1362082146852,1362082146852,2503525228,2503525228,0
1362082176,2503554060,1,77,77,1362082148959,1362082148959,2503527019,2503527019,0
1362082176,2503554084,1,46,46,1362082149126,1362082149126,2503527210,2503527210,0
1362082176,2503554088,1,46,46,1362082149124,1362082149124,2503527212,2503527212,0
1362082176,2503554100,9,864,96,1362082150197,1362082162101,2503528297,2503540201,11904
1362082176,2503554140,1,46,46,1362082148112,1362082148112,2503526252,2503526252,0
1362082176,2503554140,1,46,46,1362082148112,1362082148112,2503526252,2503526252,0
1362082176,2503554140,2,92,46,1362082148112,1362082148112,2503526252,2503526252,0
1362082176,2503554140,1,46,46,1362082148111,1362082148111,2503526251,2503526251,0
1362082176,2503554172,1,46,46,1362082149039,1362082149039,2503527211,2503527211,0
1362082176,2503554176,1,46,46,1362082149037,1362082149037,2503527213,2503527213,0
1362082176,2503554176,1,46,46,1362082149037,1362082149037,2503527213,2503527213,0
1362082176,2503554176,1,46,46,1362082149037,1362082149037,2503527213,2503527213,0
1362082176,2503554176,1,46,46,1362082149037,1362082149037,2503527213,2503527213,0
1362082176,2503554216,8,448,56,1362082150212,1362082158020,2503528428,2503536236,7808
1362082176,2503554216,9,504,56,1362082150084,1362082161028,2503528300,2503539244,10944
1362082176,2503554216,8,448,56,1362082150147,1362082153155,2503528363,2503531371,3008
1362082184,2503562432,2,92,46,1362082157802,1362082157802,2503536234,2503536234,0
1362082189,2503566692,1,46,46,1362082161551,1362082161551,2503539243,2503539243,0
1362082189,2503566692,1,46,46,1362082161551,1362082161551,2503539243,2503539243,0
1362082189,2503566928,1,46,46,1362082162338,1362082162338,2503540266,2503540266,0
1362082189,2503566936,1,46,46,1362082162333,1362082162333,2503540269,2503540269,0
1362082189,2503567372,2,92,46,1362082160869,1362082160869,2503539241,2503539241,0
1362082189,2503567372,1,46,46,1362082160869,1362082160869,2503539241,2503539241,0
1362082189,2503567372,1,46,46,1362082160872,1362082160872,2503539244,2503539244,0
1362082189,2503567520,1,46,46,1362082161748,1362082161748,2503540268,2503540268,0
1362082189,2503567520,2,92,46,1362082161747,1362082161747,2503540267,2503540267,0
1362082189,2503567520,1,46,46,1362082161747,1362082161747,2503540267,2503540267,0
1362082197,2503574608,1,46,46,1362082171173,1362082171173,2503548781,2503548781,0
1362082197,2503575008,7,412,58.85714286,1362082192020,1362082192020,2503570028,2503570028,0
1362082208,2503586172,2,498,249,1362082183152,1362082183152,2503561324,2503561324,0
1362082212,2503590120,2,112,56,1362082186019,1362082187811,2503564139,2503565931,1792
1362082212,2503590168,1,56,56,1362082187444,1362082187444,2503565612,2503565612,0
1362082212,2503590168,1,96,96,1362082187571,1362082187571,2503565739,2503565739,0
1362082212,2503590248,2,112,56,1362082186148,1362082191716,2503564396,2503569964,5568
1362082212,2503590284,3,491,163.6666667,1362082187327,1362082187455,2503565611,2503565739,128
1362082213,2503590656,7,412,58.85714286,1362082208372,1362082208372,2503586028,2503586028,0
1362082229,2503606612,3,138,46,1362082225693,1362082225757,2503603305,2503603369,64
1362082244,2503622212,3,168,56,1362082218439,1362082227015,2503596651,2503605227,8576
1362082244,2503622216,3,288,96,1362082218755,1362082227139,2503596971,2503605355,8384
1362082248,2503626216,3,168,56,1362082222978,1362082227330,2503601194,2503605546,4352
1362082248,2503626216,2,92,46,1362082223041,1362082223041,2503601257,2503601257,0
1362082248,2503626220,2,112,56,1362082223168,1362082225216,2503601388,2503603436,2048
1362082248,2503626220,3,544,181.3333333,1362082223231,1362082223231,2503601451,2503601451,0
1362082252,2503630352,3,491,163.6666667,1362082226875,1362082227003,2503605227,2503605355,128
1362082253,2503630724,116,147238,1269.293103,1362082130479,1362082246575,2503508203,2503624299,116096
1362082272,2503650220,2,92,46,1362082247037,1362082247037,2503625257,2503625257,0
1362082276,2503654224,1,56,56,1362082251384,1362082251384,2503629608,2503629608,0
1362082276,2503654344,1,56,56,1362082250945,1362082250945,2503629289,2503629289,0
1362082284,2503662152,5,710,142,1362082257475,1362082257859,2503635627,2503636011,384
1362082288,2503666284,6715,8630669,1285.282055,1362082114238,1362082280830,2503492522,2503659114,166592
1362082288,2503666528,4,596,149,1362082262986,1362082263050,2503641514,2503641578,64
1362082293,2503670692,3,491,163.6666667,1362082267727,1362082267855,2503645419,2503645547,128
1362082300,2503678336,663,853307,1287.039216,1362081995399,1362081997831,2503373735,2503376167,2432
1362082304,2503682472,639,831561,1301.347418,1362081997633,1362082000193,2503376105,2503378665,2560
1362082308,2503686476,665,901699,1355.938346,1362082000573,1362082005437,2503379049,2503383913,4864
1362082317,2503694948,2,98,49,1362082305355,1362082310539,2503683303,2503688487,5184
1362082317,2503694948,2,98,49,1362082305355,1362082310539,2503683303,2503688487,5184
1362082317,2503694952,2,98,49,1362082305354,1362082310538,2503683306,2503688490,5184
1362082317,2503694952,2,98,49,1362082305354,1362082310538,2503683306,2503688490,5184
1362082317,2503695024,3,144,48,1362082304448,1362082309504,2503682472,2503687528,5056
1362082317,2503695036,4,190,47.5,1362082305271,1362082310455,2503683307,2503688491,5184
1362082317,2503695036,3,144,48,1362082305270,1362082310454,2503683306,2503688490,5184
1362082329,2503706704,3,544,181.3333333,1362082303935,1362082303935,2503681639,2503681639,0
1362082332,2503710508,16,18614,1163.375,1362082304094,1362082304222,2503682602,2503682730,128
1362082332,2503710508,8,6019,752.375,1362082304094,1362082304478,2503682602,2503682986,384
1362082332,2503710508,11,11316,1028.727273,1362082304094,1362082304670,2503682602,2503683178,576
1362082332,2503710508,11,10172,924.7272727,1362082304094,1362082304670,2503682602,2503683178,576
1362082332,2503710508,8,6780,847.5,1362082304093,1362082304413,2503682601,2503682921,320
1362082332,2503710508,9,7907,878.5555556,1362082304093,1362082304797,2503682601,2503683305,704
1362082332,2503710520,2,192,96,1362082304913,1362082307153,2503683433,2503685673,2240
1362082332,2503710588,2,112,56,1362082306763,1362082309899,2503685351,2503688487,3136
1362082333,2503710624,8,7089,886.125,1362082304976,1362082305168,2503682600,2503682792,192
1362082333,2503710624,9,8025,891.6666667,1362082304976,1362082305424,2503682600,2503683048,448
1362082333,2503710624,7,4776,682.2857143,1362082304975,1362082305743,2503682599,2503683367,768
1362082333,2503710640,2,112,56,1362082305983,1362082309951,2503683623,2503687591,3968
1362082333,2503710768,3,491,163.6666667,1362082307583,1362082307711,2503685351,2503685479,128
1362082333,2503710776,1,56,56,1362082307898,1362082307898,2503685674,2503685674,0
1362082361,2503738812,3,544,181.3333333,1362082335126,1362082335190,2503712938,2503713002,64
1362082365,2503742984,6,502,83.66666667,1362082361511,1362082363687,2503739495,2503741671,2176
1362082373,2503750656,3,491,163.6666667,1362082347632,1362082347760,2503725288,2503725416,128
1362082393,2503770712,4,656,164,1362082368569,1362082368953,2503746281,2503746665,384
1362082397,2503774976,2,98,49,1362082389871,1362082396527,2503767847,2503774503,6656
1362082401,2503778616,2,92,46,1362082373849,1362082373913,2503751465,2503751529,64
1362082404,1142096760,2,98,49,1362082397701,1362082403589,1142090461,1142096349,5888
1362082405,2503782968,2,92,46,1362082396662,1362082402806,2503774630,2503780774,6144
1362082405,2503782972,3,144,48,1362082396662,1362082402870,2503774634,2503780842,6208
1362082405,2503782972,2,98,49,1362082396661,1362082401781,2503774633,2503779753,5120
1362082405,2503782972,6,786,131,1362082396661,1362082397173,2503774633,2503775145,512
1362082405,2503782972,2,92,46,1362082397234,1362082402802,2503775206,2503780774,5568
1362082405,2503782976,10,2344,234.4,1362082397233,1362082402801,2503775209,2503780777,5568
1362082405,2503782976,36,42647,1184.638889,1362082397361,1362082397937,2503775337,2503775913,576
1362082405,2503782976,37,41819,1130.243243,1362082397425,1362082398193,2503775401,2503776169,768
1362082405,2503782976,64,77282,1207.53125,1362082397425,1362082398449,2503775401,2503776425,1024
1362082405,2503782976,65,77993,1199.892308,1362082397423,1362082398703,2503775399,2503776679,1280
1362082405,2503782980,2,98,49,1362082397740,1362082403820,2503775720,2503781800,6080
1362082405,2503782980,3,144,48,1362082397931,1362082403819,2503775911,2503781799,5888
1362082405,2503783020,5,907,181.4,1362082396930,1362082397378,2503774950,2503775398,448
1362082405,2503783024,3,325,108.3333333,1362082396926,1362082402750,2503774950,2503780774,5824
1362082405,2503783048,3,325,108.3333333,1362082397158,1362082402726,2503775206,2503780774,5568
1362082405,2503783052,2,98,49,1362082397411,1362082402787,2503775463,2503780839,5376
1362082405,2503783056,3,144,48,1362082397601,1362082402721,2503775657,2503780777,5120
1362082405,2503783056,2,98,49,1362082397664,1362082403744,2503775720,2503781800,6080
1362082408,2503786580,3,144,48,1362082395862,1362082401238,2503774442,2503779818,5376
1362082413,2503790664,3,491,163.6666667,1362082387625,1362082387689,2503765289,2503765353,64
1362082413,2503790992,3,144,48,1362082404961,1362082410017,2503782953,2503788009,5056
1362082413,2503791028,3,144,48,1362082398587,1362082404923,2503776615,2503782951,6336
1362082413,2503791068,3,144,48,1362082404882,1362082409938,2503782950,2503788006,5056
1362082413,2503791084,12,6434,536.1666667,1362082393730,1362082409282,2503771814,2503787366,15552
1362082413,2503791104,2,98,49,1362082398512,1362082404784,2503776616,2503782888,6272
1362082413,2503791104,3,144,48,1362082398512,1362082404784,2503776616,2503782888,6272
1362082417,2503794636,54,45360,840,1362082389509,1362082416389,2503767145,2503794025,26880
1362082417,2503794636,16,896,56,1362082389573,1362082416325,2503767209,2503793961,26752
1362082417,2503794636,16,1536,96,1362082389700,1362082416516,2503767336,2503794152,26816
1362082417,2503794672,15,840,56,1362082390494,1362082407390,2503768166,2503785062,16896
1362082417,2503794832,16,896,56,1362082390142,1362082416638,2503767974,2503794470,26496
1362082417,2503794936,6,1020,170,1362082392279,1362082404951,2503770215,2503782887,12672
1362082417,2503794940,4,447,111.75,1362082392339,1362082392595,2503770279,2503770535,256
1362082418,1142110396,5,720,144,1362082392368,1362082404912,1142084764,1142097308,12544
1362082421,2503798648,12,4892,407.6666667,1362082394488,1362082398136,2503772136,2503775784,3648
1362082421,2503798876,9,1588,176.4444444,1362082395670,1362082405142,2503773546,2503783018,9472
1362082421,2503799032,5,1060,212,1362082396407,1362082416119,2503774439,2503794151,19712
1362082421,2503799040,112,123361,1101.4375,1362082388721,1362082415985,2503766761,2503794025,27264
1362082421,2503799040,1652,1883962,1140.412833,1362082405231,1362082415407,2503783271,2503793447,10176
1362082421,2503799128,114,110256,967.1578947,1362082389016,1362082415896,2503767144,2503794024,26880
1362082421,2503799128,233,289780,1243.690987,1362082389016,1362082415896,2503767144,2503794024,26880
1362082421,2503799160,3,144,48,1362082410167,1362082415799,2503788327,2503793959,5632
1362082421,2503799164,3,144,48,1362082410165,1362082415861,2503788329,2503794025,5696
1362082425,2503802672,29,32952,1136.275862,1362082398942,1362082400670,2503776614,2503778342,1728
1362082425,2503802756,11,3410,310,1362082397450,1362082398474,2503775206,2503776230,1024
1362082425,2503802788,36,19338,537.1666667,1362082398189,1362082416429,2503775977,2503794217,18240
1362082425,2503802792,11,1468,133.4545455,1362082398568,1362082406824,2503776360,2503784616,8256
1362082425,2503802796,3,273,91,1362082398820,1362082399012,2503776616,2503776808,192
1362082428,2503806588,2,600,300,1362082399947,1362082400139,2503778535,2503778727,192
1362082428,2503806588,2,608,304,1362082399947,1362082400075,2503778535,2503778663,128
1362082429,2503806716,3,1311,437,1362082400820,1362082406900,2503778536,2503784616,6080
1362082429,2503806716,3,1311,437,1362082400820,1362082406516,2503778536,2503784232,5696
1362082437,2503814652,6,1275,212.5,1362082409907,1362082410291,2503787559,2503787943,384
1362082449,2503826964,1,46,46,1362082420987,1362082420987,2503798951,2503798951,0
1362082449,2503826964,1,46,46,1362082420987,1362082420987,2503798951,2503798951,0
1362082449,2503826964,2,92,46,1362082420986,1362082421050,2503798950,2503799014,64
1362082449,2503826964,1,46,46,1362082420986,1362082420986,2503798950,2503798950,0
1362082449,2503826964,1,46,46,1362082420986,1362082420986,2503798950,2503798950,0
1362082449,2503827000,3,138,46,1362082421592,1362082421592,2503799592,2503799592,0
1362082449,2503827116,1,46,46,1362082420837,1362082420837,2503798953,2503798953,0
1362082449,2503827116,1,46,46,1362082420836,1362082420836,2503798952,2503798952,0
1362082449,2503827116,1,46,46,1362082420836,1362082420836,2503798952,2503798952,0
1362082449,2503827116,1,56,56,1362082420836,1362082420836,2503798952,2503798952,0
1362082449,2503827116,1,46,46,1362082420836,1362082420836,2503798952,2503798952,0
1362082449,2503827132,1,56,56,1362082421461,1362082421461,2503799593,2503799593,0
1362082453,2503831152,3,138,46,1362082425536,1362082425600,2503803688,2503803752,64
1362082453,2503831180,2,574,287,1362082426019,1362082426019,2503804199,2503804199,0
1362082453,2503831224,3,491,163.6666667,1362082427127,1362082427255,2503805351,2503805479,128
1362082461,2503839352,6,786,131,1362082456693,1362082456885,2503835045,2503835237,192
1362082461,2503839436,5,643,128.6,1362082457633,1362082457761,2503836069,2503836197,128
1362082469,2503847520,4,371,92.75,1362082457551,1362082463631,2503836071,2503842151,6080
1362082477,2503855168,2,92,46,1362082450798,1362082450798,2503828966,2503828966,0
1362082481,2503859048,3,169,56.33333333,1362082456808,1362082456872,2503834856,2503834920,64
1362082481,2503859296,2,574,287,1362082455917,1362082455917,2503834213,2503834213,0
1362082493,2503871276,3,491,163.6666667,1362082466948,1362082467076,2503845224,2503845352,128
1362082493,2503871312,1,78,78,1362082468318,1362082468318,2503846630,2503846630,0
1362082509,2503887460,139,156631,1126.841727,1362082389387,1362082507019,2503767847,2503885479,117632
1362082509,2503887460,3,144,48,1362082502410,1362082508298,2503880870,2503886758,5888
1362082509,2503887460,2,98,49,1362082502410,1362082508234,2503880870,2503886694,5824
1362082509,2503887460,2,98,49,1362082502409,1362082508233,2503880869,2503886693,5824
1362082509,2503887480,7,2374,339.1428571,1362082506550,1362082507062,2503885030,2503885542,512
1362082509,2503887492,6,1101,183.5,1362082507818,1362082508202,2503886310,2503886694,384
1362082509,2503887536,7,1889,269.8571429,1362082502591,1362082502847,2503881127,2503881383,256
1362082509,2503887536,2,98,49,1362082502590,1362082508222,2503881126,2503886758,5632
1362082509,2503887576,5,1085,217,1362082507541,1362082507797,2503886117,2503886373,256
1362082509,2503887580,31,32228,1039.612903,1362082508115,1362082508563,2503886695,2503887143,448
1362082509,2503887580,7,466,66.57142857,1362082508179,1362082508435,2503886759,2503887015,256
1362082516,1142208752,3,144,48,1362082507277,1362082512653,1142200029,1142205405,5376
1362082516,1142208776,3,144,48,1362082505013,1362082510453,1142197789,1142203229,5440
1362082517,2503895456,2,92,46,1362082508495,1362082514447,2503886951,2503892903,5952
1362082517,2503895460,3,144,48,1362082508940,1362082514444,2503887400,2503892904,5504
1362082517,2503895460,9,2298,255.3333333,1362082504779,1362082510219,2503883239,2503888679,5440
1362082517,2503895464,246,315307,1281.735772,1362082388676,1362082515460,2503767140,2503893924,126784
1362082517,2503895464,2,98,49,1362082505350,1362082511366,2503883814,2503889830,6016
1362082517,2503895464,2,98,49,1362082505350,1362082511366,2503883814,2503889830,6016
1362082517,2503895468,2,98,49,1362082505476,1362082511364,2503883944,2503889832,5888
1362082517,2503895468,3,144,48,1362082510210,1362082515394,2503888678,2503893862,5184
1362082517,2503895468,2,98,49,1362082505793,1362082511361,2503884261,2503889829,5568
1362082517,2503895496,3,144,48,1362082506279,1362082512423,2503884775,2503890919,6144
1362082517,2503895496,3,144,48,1362082511205,1362082516389,2503889701,2503894885,5184
1362082517,2503895500,6,461,76.83333333,1362082511649,1362082511905,2503890149,2503890405,256
1362082517,2503895500,3,144,48,1362082511777,1362082512865,2503890277,2503891365,1088
1362082517,2503895504,3,150,50,1362082506975,1362082512415,2503885479,2503890919,5440
1362082517,2503895508,4,190,47.5,1362082507610,1362082512922,2503886118,2503891430,5312
1362082517,2503895508,4,196,49,1362082507865,1362082513433,2503886373,2503891941,5568
1362082517,2503895512,2,92,46,1362082508248,1362082514392,2503886760,2503892904,6144
1362082517,2503895512,16,2661,166.3125,1362082508440,1362082514136,2503886952,2503892648,5696
1362082517,2503895548,2,98,49,1362082509940,1362082515316,2503888488,2503893864,5376
1362082517,2503895576,12,3493,291.0833333,1362082511448,1362082511832,2503890024,2503890408,384
1362082517,2503895576,3,144,48,1362082503639,1362082509079,2503882215,2503887655,5440
1362082517,2503895580,28,12735,454.8214286,1362082507283,1362082512979,2503885863,2503891559,5696
1362082517,2503895584,3,144,48,1362082508109,1362082513293,2503886693,2503891877,5184
1362082517,2503895584,2,98,49,1362082508109,1362082514317,2503886693,2503892901,6208
1362082517,2503895584,2,98,49,1362082508173,1362082514253,2503886757,2503892837,6080
1362082525,2503903512,6,786,131,1362082516567,1362082516695,2503895079,2503895207,128
1362082525,2503903520,5,643,128.6,1362082517519,1362082517711,2503896039,2503896231,192
1362082525,2503903520,12,8327,693.9166667,1362082509710,1362082522894,2503888230,2503901414,13184
1362082525,2503903520,14,9417,672.6428571,1362082509710,1362082522894,2503888230,2503901414,13184
1362082525,2503903556,6,282,47,1362082511275,1362082519595,2503889831,2503898151,8320
1362082525,2503903556,3,144,48,1362082511274,1362082517290,2503889830,2503895846,6016
1362082525,2503903560,14,4966,354.7142857,1362082511588,1362082524068,2503890148,2503902628,12480
1362082525,2503903560,16,11393,712.0625,1362082512164,1362082523620,2503890724,2503902180,11456
1362082525,2503903588,3,144,48,1362082512585,1362082518281,2503891173,2503896869,5696
1362082525,2503903596,6,1898,316.3333333,1362082509634,1362082522818,2503888230,2503901414,13184
1362082525,2503903604,12,5559,463.25,1362082510905,1362082524537,2503889509,2503903141,13632
1362082526,2503903636,52,56631,1089.057692,1362082511874,1362082524546,2503889510,2503902182,12672
1362082526,2503903640,4,190,47.5,1362082512509,1362082520445,2503890149,2503898085,7936
1362082529,2503907128,45,34131,758.4666667,1362082501080,1362082525912,2503879208,2503904040,24832
1362082529,2503907168,4,774,193.5,1362082502701,1362082502957,2503880869,2503881125,256
1362082529,2503907172,3,876,292,1362082502700,1362082509676,2503880872,2503887848,6976
1362082529,2503907172,7,2543,363.2857143,1362082502699,1362082502955,2503880871,2503881127,256
1362082529,2503907204,57,24213,424.7894737,1362082503242,1362082514954,2503881446,2503893158,11712
1362082529,2503907208,67,44685,666.9402985,1362082503238,1362082515014,2503881446,2503893222,11776
1362082529,2503907216,16,1536,96,1362082503548,1362082528636,2503881764,2503906852,25088
1362082529,2503907248,59,71242,1207.491525,1362082503968,1362082505888,2503882216,2503884136,1920
1362082529,2503907336,5,2282,456.4,1362082502535,1362082502663,2503880871,2503880999,128
1362082529,2503907340,83,85657,1032.012048,1362082502852,1362082510404,2503881192,2503888744,7552
1362082529,2503907364,48,25255,526.1458333,1362082503082,1362082514794,2503881446,2503893158,11712
1362082529,2503907372,15,840,56,1362082503522,1362082526946,2503881894,2503905318,23424
1362082530,1142222464,12,1823,151.9166667,1362082502956,1362082529708,1142195420,1142222172,26752
1362082533,2503911036,15,840,56,1362082504880,1362082527664,2503882916,2503905700,22784
1362082533,2503911036,18,1008,56,1362082505009,1362082532209,2503883045,2503910245,27200
1362082533,2503911124,37,35581,961.6486486,1362082505436,1362082532252,2503883560,2503910376,26816
1362082533,2503911124,14,2801,200.0714286,1362082505498,1362082530650,2503883622,2503908774,25152
1362082533,2503911124,20,18332,916.6,1362082505434,1362082506266,2503883558,2503884390,832
1362082533,2503911164,33,33931,1028.212121,1362082506611,1362082532211,2503884775,2503910375,25600
1362082533,2503911164,3,301,100.3333333,1362082506611,1362082506931,2503884775,2503885095,320
1362082533,2503911184,9,6664,740.4444444,1362082506717,1362082508637,2503884901,2503886821,1920
1362082533,2503911260,11,4776,434.1818182,1362082507604,1362082508500,2503885864,2503886760,896
1362082533,2503911324,33,25246,765.030303,1362082504914,1362082530450,2503883238,2503908774,25536
1362082533,2503911336,13,8476,652,1362082505479,1362082530887,2503883815,2503909223,25408
1362082533,2503911336,27,20524,760.1481481,1362082505477,1362082530693,2503883813,2503909029,25216
1362082533,2503911340,69,82242,1191.913043,1362082505729,1362082530561,2503884069,2503908901,24832
1362082533,2503911372,9,5028,558.6666667,1362082506340,1362082525860,2503884712,2503904232,19520
1362082533,2503911372,8,3732,466.5,1362082506402,1362082531810,2503884774,2503910182,25408
1362082533,2503911372,4,347,86.75,1362082506402,1362082510434,2503884774,2503888806,4032
1362082533,2503911372,20,18498,924.9,1362082506402,1362082507298,2503884774,2503885670,896
1362082533,2503911408,3,491,163.6666667,1362082506879,1362082507135,2503885287,2503885543,256
1362082533,2503911412,12,9795,816.25,1362082507067,1362082508411,2503885479,2503886823,1344
1362082533,2503911416,6,726,121,1362082507255,1362082507511,2503885671,2503885927,256
1362082533,2503911444,5,1064,212.8,1362082507995,1362082508251,2503886439,2503886695,256
1362082533,2503911492,263,309509,1176.840304,1362082388648,1362082528424,2503767140,2503906916,139776
1362082533,2503911496,3,138,46,1362082525415,1362082525415,2503903911,2503903911,0
1362082533,2503911504,14,6702,478.7142857,1362082510620,1362082527196,2503889124,2503905700,16576
1362082533,2503911528,6,461,76.83333333,1362082526596,1362082526724,2503905124,2503905252,128
1362082533,2503911528,12,4496,374.6666667,1362082510982,1362082527814,2503889510,2503906342,16832
1362082533,2503911532,5,749,149.8,1362082511299,1362082526339,2503889831,2503904871,15040
1362082533,2503911536,4,190,47.5,1362082531324,1362082532348,2503909860,2503910884,1024
1362082533,2503911608,6,461,76.83333333,1362082531000,1362082531256,2503909608,2503909864,256
1362082533,2503911608,10,1001,100.1,1362082531000,1362082531512,2503909608,2503910120,512
1362082534,2503911616,8,5426,678.25,1362082513111,1362082526231,2503890727,2503903847,13120
1362082534,1142226424,19,16058,845.1578947,1362082507031,1362082507671,1142199455,1142200095,640
1362082537,2503915420,1,46,46,1362082512435,1362082512435,2503890855,2503890855,0
1362082538,1142230432,6,3828,638,1362082512141,1362082512205,1142204573,1142204637,64
1362082540,1142232772,3,144,48,1362082529467,1362082534779,1142222239,1142227551,5312
1362082541,2503919496,1,46,46,1362082513380,1362082513380,2503891876,2503891876,0
1362082541,2503919572,1,46,46,1362082515289,1362082515289,2503893861,2503893861,0
1362082542,2503919648,3,144,48,1362082529784,1362082535416,2503907432,2503913064,5632
1362082542,2503919648,8,522,65.25,1362082530037,1362082535349,2503907685,2503912997,5312
1362082542,2503919656,6,461,76.83333333,1362082538796,1362082538988,2503916452,2503916644,192
1362082542,2503919732,11,1356,123.2727273,1362082537889,1362082538465,2503915621,2503916197,576
1362082542,2503919736,13,4085,314.2307692,1362082537888,1362082538272,2503915624,2503916008,384
1362082542,2503919772,3,144,48,1362082531322,1362082537338,2503909094,2503915110,6016
1362082542,2503919776,3,144,48,1362082535992,1362082541240,2503913768,2503919016,5248
1362082548,1142240752,3,144,48,1362082541902,1362082547726,1142234654,1142240478,5824
1362082548,1142240760,3,144,48,1362082535943,1362082541767,1142228703,1142234527,5824
1362082549,2503927348,2,92,46,1362082521529,1362082521529,2503899877,2503899877,0
1362082549,2503927496,3,144,48,1362082541224,1362082546536,2503919720,2503925032,5312
1362082549,2503927544,9,568,63.11111111,1362082535606,1362082541430,2503914150,2503919974,5824
1362082549,2503927548,5,415,83,1362082544368,1362082544496,2503922916,2503923044,128
1362082549,2503927576,4,190,47.5,1362082544471,1362082545495,2503923047,2503924071,1024
1362082549,2503927580,2,98,49,1362082536723,1362082542419,2503915303,2503920999,5696
1362082549,2503927588,8,522,65.25,1362082541516,1362082547340,2503920104,2503925928,5824
1362082549,2503927588,2,98,49,1362082537546,1362082543370,2503916134,2503921958,5824
1362082549,2503927592,3,138,46,1362082538117,1362082543493,2503916709,2503922085,5376
1362082550,2503927620,10,1001,100.1,1362082545299,1362082545491,2503922919,2503923111,192
1362082553,2503931152,86,67943,790.0348837,1362082528831,1362082548543,2503906983,2503926695,19712
1362082557,2503935136,23,1288,56,1362082528910,1362082553742,2503907046,2503931878,24832
1362082557,2503935144,8,1844,230.5,1362082529477,1362082547589,2503907621,2503925733,18112
1362082557,2503935328,22,1232,56,1362082528909,1362082550733,2503907237,2503929061,21824
1362082557,2503935332,22,2112,96,1362082529160,1362082552520,2503907492,2503930852,23360
1362082557,2503935404,83,105382,1269.662651,1362082530882,1362082531586,2503909286,2503909990,704
1362082557,2503935496,9,949,105.4444444,1362082549094,1362082549286,2503927590,2503927782,192
1362082557,2503935496,6,461,76.83333333,1362082549094,1362082549286,2503927590,2503927782,192
1362082557,2503935548,3,144,48,1362082547824,1362082553392,2503926372,2503931940,5568
1362082557,2503935548,3,144,48,1362082547888,1362082553392,2503926436,2503931940,5504
1362082557,2503935580,4,190,47.5,1362082549139,1362082550227,2503927719,2503928807,1088
1362082558,2503935616,3,144,48,1362082547478,1362082553302,2503925094,2503930918,5824
1362082558,2503935628,3,144,48,1362082548811,1362082554315,2503926439,2503931943,5504
1362082561,2503939152,20,1120,56,1362082532863,1362082560255,2503911015,2503938407,27392
1362082561,2503939240,36,27626,767.3888889,1362082536423,1362082549095,2503914663,2503927335,12672
1362082561,2503939268,14,2801,200.0714286,1362082536649,1362082548425,2503914917,2503926693,11776
1362082562,1142254428,6,1002,167,1362082536337,1362082547857,1142228765,1142240285,11520
1362082565,2503943152,9,6203,689.2222222,1362082537020,1362082543292,2503915172,2503921444,6272
1362082565,2503943156,65,81338,1251.353846,1362082537083,1362082548859,2503915239,2503927015,11776
1362082565,2503943164,3,138,46,1362082537715,1362082537843,2503915879,2503916007,128
1362082565,2503943244,20,12664,633.2,1362082536865,1362082548833,2503915109,2503927077,11968
1362082565,2503943272,8,5814,726.75,1362082537285,1362082537605,2503915557,2503915877,320
1362082565,2503943352,3,529,176.3333333,1362082538101,1362082538421,2503916453,2503916773,320
1362082565,2503943504,12,3012,251,1362082543326,1362082559902,2503921830,2503938406,16576
1362082565,2503943516,112,124257,1109.4375,1362082547856,1362082561488,2503926372,2503940004,13632
1362082565,2503943516,6,455,75.83333333,1362082564113,1362082564305,2503942629,2503942821,192
1362082569,2503947272,44,51710,1175.227273,1362082544455,1362082549255,2503922727,2503927527,4800
1362082569,2503947368,20,12405,620.25,1362082543716,1362082548964,2503922084,2503927332,5248
1362082573,2503951208,8,6398,799.75,1362082547526,1362082550470,2503925734,2503928678,2944
1362082573,2503951384,3,491,163.6666667,1362082546837,1362082547477,2503925221,2503925861,640
1362082573,2503951392,18,16106,894.7777778,1362082547340,1362082550284,2503925732,2503928676,2944
1362082573,2503951392,15,14402,960.1333333,1362082547340,1362082550284,2503925732,2503928676,2944
1362082573,2503951468,4,215,53.75,1362082569090,1362082569154,2503947558,2503947622,64
1362082582,2503959604,5,643,128.6,1362082578466,1362082578594,2503956070,2503956198,128
1362082582,2503959648,6,786,131,1362082577397,1362082577589,2503955045,2503955237,192
1362082582,2503959724,6,461,76.83333333,1362082579879,1362082580007,2503957603,2503957731,128
1362082585,2503963328,2,112,56,1362082558860,1362082564236,2503937188,2503942564,5376
1362082585,2503963332,3,138,46,1362082558857,1362082558921,2503937189,2503937253,64
1362082589,2503967264,2,192,96,1362082561676,1362082568268,2503939940,2503946532,6592
1362082589,2503967452,3,169,56.33333333,1362082561489,1362082561489,2503939941,2503939941,0
1362082589,2503967468,2,112,56,1362082561728,1362082569152,2503940196,2503947620,7424
1362082589,2503967556,1,56,56,1362082564137,1362082564137,2503942693,2503942693,0
1362082593,2503971384,3,138,46,1362082568151,1362082568151,2503946535,2503946535,0
1362082593,2503971504,2,92,46,1362082568031,1362082568031,2503946535,2503946535,0
1362082598,2503975824,6,461,76.83333333,1362082594823,1362082594951,2503972647,2503972775,128
1362082613,2503991452,3,491,163.6666667,1362082586834,1362082586962,2503965286,2503965414,128
1362082614,2503991860,6,461,76.83333333,1362082609763,1362082609891,2503987623,2503987751,128
1362082614,2503991888,6,497,82.83333333,1362082602820,1362082605764,2503980708,2503983652,2944
1362082617,2503995492,2,92,46,1362082591271,1362082591335,2503969763,2503969827,64
1362082617,2503995508,2,92,46,1362082592471,1362082592535,2503970979,2503971043,64
1362082617,2503995588,2,92,46,1362082591177,1362082591241,2503969765,2503969829,64
1362082618,2503995628,2,92,46,1362082593351,1362082593415,2503970979,2503971043,64
1362082630,2504007672,1,46,46,1362082603035,1362082603035,2503980707,2503980707,0
1362082634,2504011680,3,169,56.33333333,1362082607254,1362082607318,2503984934,2503984998,64
1362082634,2504011724,3,138,46,1362082608680,1362082608744,2503986404,2503986468,64
1362082637,2504015504,3,138,46,1362082609051,1362082609115,2503987555,2503987619,64
1362082638,2504015972,4,694,173.5,1362082637105,1362082637233,2504015077,2504015205,128
1362082645,2504023552,1,46,46,1362082618091,1362082618091,2503996643,2503996643,0
1362082646,2504023756,2,92,46,1362082618889,1362082618953,2503996645,2503996709,64
1362082646,2504023828,2,123,61.5,1362082621120,1362082621120,2503998948,2503998948,0
1362082646,2504023964,4,597,149.25,1362082638135,1362082638327,2504016099,2504016291,192
1362082646,2504023992,1710,2294283,1341.685965,1362082631130,1362082640922,2504009122,2504018914,9792
1362082646,2504024000,6,461,76.83333333,1362082639635,1362082639763,2504017635,2504017763,128
1362082650,2504027620,2,92,46,1362082624015,1362082624079,2504001635,2504001699,64
1362082650,2504027636,2,92,46,1362082625026,1362082625026,2504002662,2504002662,0
1362082650,2504027676,2,92,46,1362082621976,1362082622040,2503999652,2503999716,64
1362082650,2504027676,1,46,46,1362082621976,1362082621976,2503999652,2503999652,0
1362082650,2504027720,2,92,46,1362082623020,1362082623084,2504000740,2504000804,64
1362082650,1142342700,2,92,46,1362082622593,1362082622593,1142315293,1142315293,0
1362082654,2504031644,5,936,187.2,1362082627703,1362082628471,2504005347,2504006115,768
1362082654,2504031764,2,92,46,1362082626882,1362082626882,2504004646,2504004646,0
1362082654,2504032076,4,317,79.25,1362082649863,1362082649927,2504027939,2504028003,64
1362082654,1142346712,2,92,46,1362082627512,1362082627704,1142320224,1142320416,192
1362082657,2504035596,29,1624,56,1362082631038,1362082656254,2504009634,2504034850,25216
1362082658,2504035604,29,2784,96,1362082632353,1362082657697,2504009957,2504035301,25344
1362082658,2504035604,29,1624,56,1362082632415,1362082657567,2504010019,2504035171,25152
1362082658,2504035608,28,1568,56,1362082632541,1362082657053,2504010149,2504034661,24512
1362082658,2504035616,11,5845,531.3636364,1362082633171,1362082648403,2504010787,2504026019,15232
1362082660,1142352804,3,144,48,1362082653274,1362082658522,1142346078,1142351326,5248
1362082662,2504039948,6,461,76.83333333,1362082654855,1362082655687,2504032803,2504033635,832
1362082662,2504039980,40,45794,1144.85,1362082659880,1362082660840,2504037860,2504038820,960
1362082662,2504039984,7,816,116.5714286,1362082656869,1362082657765,2504034853,2504035749,896
1362082662,2504039984,3,350,116.6666667,1362082656869,1362082659941,2504034853,2504037925,3072
1362082662,2504039984,5,690,138,1362082656933,1362082657125,2504034917,2504035109,192
1362082662,2504039984,66,75602,1145.484848,1362082660003,1362082661347,2504037987,2504039331,1344
1362082662,2504040112,42,48135,1146.071429,1362082659682,1362082660706,2504037794,2504038818,1024
1362082662,2504040112,26,27942,1074.692308,1362082659813,1362082660645,2504037925,2504038757,832
1362082662,2504040140,14,10984,784.5714286,1362082656710,1362082656838,2504034850,2504034978,128
1362082662,2504040140,6,574,95.66666667,1362082656710,1362082657606,2504034850,2504035746,896
1362082662,2504040140,5,608,121.6,1362082656778,1362082656970,2504034918,2504035110,192
1362082665,2504043524,1,46,46,1362082637066,1362082637066,2504015590,2504015590,0
1362082670,2504047720,2,92,46,1362082642412,1362082642412,2504020132,2504020132,0
1362082670,2504047852,2,92,46,1362082665898,1362082665898,2504043750,2504043750,0
1362082670,2504047884,178,162830,914.7752809,1362082502982,1362082665926,2503880866,2504043810,162944
1362082670,2504047888,225,221132,982.8088889,1362082503557,1362082665861,2503881445,2504043749,162304
1362082670,2504047888,6,729,121.5,1362082667396,1362082667524,2504045284,2504045412,128
1362082670,2504047888,3,144,48,1362082659716,1362082664900,2504037604,2504042788,5184
1362082670,2504047896,3,140,46.66666667,1362082656957,1362082662909,2504034853,2504040805,5952
1362082670,2504047896,4,196,49,1362082657020,1362082662908,2504034916,2504040804,5888
1362082670,2504047896,3,144,48,1362082657020,1362082662908,2504034916,2504040804,5888
1362082670,2504047900,2,98,49,1362082660281,1362082665849,2504038181,2504043749,5568
1362082670,2504047900,2,98,49,1362082660345,1362082665913,2504038245,2504043813,5568
1362082670,2504047928,2,92,46,1362082660890,1362082666842,2504038818,2504044770,5952
1362082670,2504047932,2,92,46,1362082665815,1362082665815,2504043747,2504043747,0
1362082670,2504047936,2,92,46,1362082665814,1362082665814,2504043750,2504043750,0
1362082670,2504047964,4,602,150.5,1362082658807,1362082669495,2504036771,2504047459,10688
1362082670,2504047972,3,144,48,1362082659312,1362082664816,2504037284,2504042788,5504
1362082670,2504047972,7,1271,181.5714286,1362082656176,1362082666416,2504034148,2504044388,10240
1362082670,2504047972,125,106385,851.08,1362082503472,1362082665776,2503881444,2504043748,162304
1362082670,2504047976,1443,1835561,1272.045045,1362082659756,1362082668396,2504037732,2504046372,8640
1362082670,2504047980,2,98,49,1362082660265,1362082665833,2504038245,2504043813,5568
1362082670,2504047980,2,98,49,1362082660201,1362082665769,2504038181,2504043749,5568
1362082670,2504047980,2,98,49,1362082660264,1362082665832,2504038244,2504043812,5568
1362082670,2504048008,2,98,49,1362082656910,1362082662798,2504034918,2504040806,5888
1362082673,2504051576,1,46,46,1362082647572,1362082647572,2504026148,2504026148,0
1362082674,2504051628,35,18050,515.7142857,1362082646601,1362082671177,2504024229,2504048805,24576
1362082674,2504051664,2,92,46,1362082647459,1362082647459,2504025123,2504025123,0
1362082674,2504051700,2,92,46,1362082648448,1362082648448,2504026148,2504026148,0
1362082674,2504051700,1,46,46,1362082648447,1362082648447,2504026147,2504026147,0
1362082674,2504051732,8,2954,369.25,1362082649632,1362082650016,2504027364,2504027748,384
1362082677,2504055504,6,483,80.5,1362082648861,1362082648989,2504027365,2504027493,128
1362082677,2504055512,26,12436,478.3076923,1362082649491,1362082649875,2504028003,2504028387,384
1362082677,2504055512,9,840,93.33333333,1362082649555,1362082649683,2504028067,2504028195,128
1362082677,2504055556,4,797,199.25,1362082651239,1362082651303,2504029795,2504029859,64
1362082677,2504055588,88,105389,1197.602273,1362082652041,1362082674505,2504030629,2504053093,22464
1362082677,2504055588,20,13517,675.85,1362082652039,1362082670151,2504030627,2504048739,18112
1362082677,2504055588,48,50488,1051.833333,1362082652038,1362082670086,2504030626,2504048674,18048
1362082677,2504055588,22,13969,634.9545455,1362082652038,1362082670278,2504030626,2504048866,18240
1362082678,2504055628,12,3559,296.5833333,1362082650054,1362082650182,2504027682,2504027810,128
1362082678,2504055704,7,529,75.57142857,1362082650236,1362082650364,2504027940,2504028068,128
1362082678,2504055752,28,22829,815.3214286,1362082652171,1362082658379,2504029923,2504036131,6208
1362082678,2504055776,60,62494,1041.566667,1362082652851,1362082670643,2504030627,2504048419,17792
1362082678,2504055776,21,13964,664.952381,1362082652851,1362082671091,2504030627,2504048867,18240
1362082678,2504055864,12,6188,515.6666667,1362082658971,1362082675483,2504036835,2504053347,16512
1362082678,2504055872,5,1455,291,1362082659667,1362082675475,2504037539,2504053347,15808
1362082678,2504055904,509,668609,1313.573674,1362082652725,1362082675061,2504030629,2504052965,22336
1362082678,1142370700,10,8661,866.1,1362082653378,1362082655298,1142346078,1142347998,1920
1362082681,2504059532,12,7780,648.3333333,1362082653825,1362082656961,2504032357,2504035493,3136
1362082681,2504059532,25,20091,803.64,1362082653825,1362082658817,2504032357,2504037349,4992
1362082681,2504059548,22,2649,120.4090909,1362082654190,1362082667310,2504032738,2504045858,13120
1362082682,2504059608,1,46,46,1362082657309,1362082657309,2504034917,2504034917,0
1362082682,2504059640,2,92,46,1362082653882,1362082653882,2504031522,2504031522,0
1362082682,2504059676,2,92,46,1362082654934,1362082654998,2504032610,2504032674,64
1362082682,2504059752,13,728,56,1362082657611,1362082675659,2504035363,2504053411,18048
1362082682,2504059756,4,928,232,1362082657606,1362082657798,2504035362,2504035554,192
1362082682,1142374668,6,524,87.33333333,1362082654244,1362082657572,1142346912,1142350240,3328
1362082682,1142374668,9,1565,173.8888889,1362082654689,1362082658849,1142347357,1142351517,4160
1362082682,1142374716,18,15696,872,1362082654193,1362082657457,1142346909,1142350173,3264
1362082685,2504063508,12,672,56,1362082657305,1362082674393,2504035813,2504052901,17088
1362082685,2504063508,12,672,56,1362082657368,1362082674584,2504035876,2504053092,17216
1362082685,2504063508,12,1152,96,1362082657495,1362082674775,2504036003,2504053283,17280
1362082685,2504063536,6,574,95.66666667,1362082658300,1362082678716,2504036836,2504057252,20416
1362082685,2504063540,2,461,230.5,1362082658551,1362082658615,2504037091,2504037155,64
1362082686,2504063628,26,15280,587.6923077,1362082657926,1362082662150,2504035554,2504039778,4224
1362082686,2504063736,1,46,46,1362082659038,1362082659038,2504036774,2504036774,0
1362082686,2504063736,6,574,95.66666667,1362082659100,1362082679964,2504036836,2504057700,20864
1362082686,2504063780,31,35631,1149.387097,1362082660400,1362082661744,2504038180,2504039524,1344
1362082686,2504063784,3,383,127.6666667,1362082660716,1362082661548,2504038500,2504039332,832
1362082686,2504063788,3,1246,415.3333333,1362082661033,1362082661737,2504038821,2504039525,704
1362082686,2504063944,7,412,58.85714286,1362082679372,1362082679372,2504057316,2504057316,0
1362082686,2504064064,6,461,76.83333333,1362082684562,1362082684690,2504062626,2504062754,128
1362082690,2504067676,1,46,46,1362082665112,1362082665112,2504042788,2504042788,0
1362082690,2504067676,1,46,46,1362082665112,1362082665112,2504042788,2504042788,0
1362082690,2504067712,4,246,61.5,1362082665588,1362082665908,2504043300,2504043620,320
1362082690,2504067720,1,46,46,1362082663020,1362082663020,2504040740,2504040740,0
1362082690,2504067788,1,46,46,1362082665001,1362082665001,2504042789,2504042789,0
1362082693,2504071568,3,491,163.6666667,1362082666971,1362082667099,2504045539,2504045667,128
1362082702,2504079904,6,786,131,1362082697203,1362082697523,2504075107,2504075427,320
1362082702,2504079944,5,643,128.6,1362082698186,1362082698314,2504076130,2504076258,128
1362082705,2504083392,979,1201480,1227.252298,1362082397451,1362082404235,2503775843,2503782627,6784
1362082706,2504083732,2,574,287,1362082681185,1362082681185,2504058917,2504058917,0
1362082710,2504088208,4,522,130.5,1362082692290,1362082708098,2504070498,2504086306,15808
1362082713,2504091528,3,138,46,1362082684929,1362082684993,2504063457,2504063521,64
1362082718,2504095956,3,144,48,1362082711103,1362082716223,2504089059,2504094179,5120
1362082725,2504103556,1,46,46,1362082697128,1362082697128,2504075684,2504075684,0
1362082726,2504103600,3,138,46,1362082699876,1362082699940,2504077476,2504077540,64
1362082726,2504103676,3,138,46,1362082698199,1362082698199,2504075875,2504075875,0
1362082734,2504111656,3,169,56.33333333,1362082708780,1362082708780,2504086436,2504086436,0
1362082734,2504111656,2,123,61.5,1362082708780,1362082708780,2504086436,2504086436,0
1362082734,2504111656,1,77,77,1362082708780,1362082708780,2504086436,2504086436,0
1362082734,2504111768,3,491,163.6666667,1362082707517,1362082707645,2504085285,2504085413,128
1362082734,2504111784,1,77,77,1362082708652,1362082708652,2504086436,2504086436,0
1362082734,2504111784,2,123,61.5,1362082708652,1362082708652,2504086436,2504086436,0
1362082734,2504111784,1,77,77,1362082708652,1362082708652,2504086436,2504086436,0
1362082734,2504111924,6,461,76.83333333,1362082729757,1362082729885,2504107681,2504107809,128
1362082734,2504112052,9,497,55.22222222,1362082724384,1362082729184,2504102436,2504107236,4800
1362082737,2504115572,8,1681,210.125,1362082709592,1362082710168,2504088164,2504088740,576
1362082738,2504115724,2,574,287,1362082711080,1362082711144,2504088804,2504088868,64
1362082738,2504115764,1,46,46,1362082712513,1362082712513,2504090277,2504090277,0
1362082742,2504119640,3,138,46,1362082716858,1362082716922,2504094498,2504094562,64
1362082745,2504123552,1,46,46,1362082716972,1362082716972,2504095524,2504095524,0
1362082745,2504123560,1,46,46,1362082718113,1362082718113,2504096673,2504096673,0
1362082746,2504123640,1,46,46,1362082717882,1362082717882,2504095522,2504095522,0
1362082746,2504123672,3,138,46,1362082718811,1362082718875,2504096483,2504096547,64
1362082758,2504136356,6,786,131,1362082756720,1362082756912,2504135076,2504135268,192
1362082766,2504144324,5,643,128.6,1362082757712,1362082757904,2504136036,2504136228,192
1362082772,1142464788,3,138,46,1362082770924,1362082770924,1142463712,1142463712,0
1362082774,2504151860,3,491,163.6666667,1362082747360,1362082747552,2504125220,2504125412,192
1362082774,2504152056,3,138,46,1362082747993,1362082748057,2504126049,2504126113,64
1362082774,2504152264,323,405853,1256.510836,1362082398347,1362082771851,2503776611,2504150115,373504
1362082790,2504168208,7,906,129.4285714,1362082767300,1362082782916,2504145508,2504161124,15616
1362082794,2504171876,1,77,77,1362082767503,1362082767503,2504145379,2504145379,0
1362082794,2504171876,1,77,77,1362082767503,1362082767503,2504145379,2504145379,0
1362082794,2504171996,2,92,46,1362082767124,1362082767188,2504145120,2504145184,64
1362082794,2504171996,2,123,61.5,1362082767382,1362082767382,2504145378,2504145378,0
1362082794,2504171996,1,77,77,1362082767382,1362082767382,2504145378,2504145378,0
1362082794,2504171996,1,77,77,1362082767382,1362082767382,2504145378,2504145378,0
1362082794,2504171996,1,77,77,1362082767381,1362082767381,2504145377,2504145377,0
1362082798,1142490904,2,92,46,1362082772793,1362082772793,1142465697,1142465697,0
1362082798,1142490920,2,92,46,1362082773735,1362082773735,1142466655,1142466655,0
1362082798,1142490952,1,46,46,1362082772744,1362082772744,1142465696,1142465696,0
1362082802,2504180028,2,92,46,1362082777079,1362082777079,2504155107,2504155107,0
1362082802,2504180100,2,92,46,1362082775020,1362082775020,2504153120,2504153120,0
1362082806,2504184196,2,574,287,1362082780624,1362082780688,2504158820,2504158884,64
1362082806,2504184400,6,461,76.83333333,1362082804225,1362082804417,2504182625,2504182817,192
1362082814,2504192160,3,491,163.6666667,1362082787059,1362082787187,2504165219,2504165347,128
1362082822,2504200308,5,643,128.6,1362082817758,1362082817886,2504196066,2504196194,128
1362082830,2504208300,3,138,46,1362082825830,1362082825894,2504204130,2504204194,64
1362082830,2504208304,6,366,61,1362082826019,1362082826083,2504204323,2504204387,64
1362082830,2504208304,6,366,61,1362082826019,1362082826083,2504204323,2504204387,64
1362082830,2504208304,7,412,58.85714286,1362082826018,1362082826082,2504204322,2504204386,64
1362082830,2504208304,6,366,61,1362082826018,1362082826082,2504204322,2504204386,64
1362082830,2504208380,143,100654,703.8741259,1362082628117,1362082826005,2504006497,2504204385,197888
1362082830,2504208388,6,366,61,1362082825935,1362082825999,2504204323,2504204387,64
1362082830,2504208388,6,366,61,1362082825935,1362082825999,2504204323,2504204387,64
1362082846,2504224356,6,503,83.83333333,1362082843181,1362082845293,2504221537,2504223649,2112
1362082854,2504232192,3,491,163.6666667,1362082827088,1362082827216,2504205280,2504205408,128
1362082870,2504248216,1,46,46,1362082843321,1362082843321,2504221537,2504221537,0
1362082870,2504248588,8,2060,257.5,1362082851462,1362082865670,2504230050,2504244258,14208
1362082874,2504252168,4,656,164,1362082848680,1362082849128,2504226848,2504227296,448
1362082878,2504256516,6,786,131,1362082876558,1362082876750,2504255074,2504255266,192
1362082886,2504264496,5,643,128.6,1362082877601,1362082877729,2504256097,2504256225,128
1362082886,2504264532,1397,1789889,1281.237652,1362082879996,1362082884860,2504258528,2504263392,4864
1362082894,2504272320,3,491,163.6666667,1362082867346,1362082867474,2504245666,2504245794,128
1362082906,2504284312,9,3015,335,1362082881433,1362082902489,2504259745,2504280801,21056
1362082910,2504288128,2,112,56,1362082882578,1362082883922,2504260706,2504262050,1344
1362082910,2504288160,2,112,56,1362082883569,1362082884849,2504261729,2504263009,1280
1362082910,2504288320,3,168,56,1362082882128,1362082884880,2504260448,2504263200,2752
1362082910,2504288336,2,192,96,1362082883329,1362082884609,2504261665,2504262945,1280
1362082919,2504296700,2,92,46,1362082918138,1362082918138,2504295838,2504295838,0
1362082922,2504300344,2,92,46,1362082895735,1362082895799,2504274079,2504274143,64
1362082926,2504304456,4,672,168,1362082900298,1362082900426,2504278754,2504278882,128
1362082934,2504312528,3,491,163.6666667,1362082906751,1362082906879,2504285279,2504285407,128
1362082943,2504320760,22,25366,1153,1362082942079,1362082942399,2504319839,2504320159,320
1362082943,2504320764,17,14898,876.3529412,1362082942202,1362082942522,2504319966,2504320286,320
1362082943,2504320804,6,461,76.83333333,1362082939859,1362082939987,2504317663,2504317791,128
1362082943,2504320812,6,786,131,1362082937292,1362082937420,2504315104,2504315232,128
1362082943,2504320844,5,643,128.6,1362082938221,1362082938349,2504316065,2504316193,128
1362082943,2504320848,13,13000,1000,1362082941991,1362082942375,2504319839,2504320223,384
1362082943,2504320848,53,68296,1288.603774,1362082942055,1362082942503,2504319903,2504320351,448
1362082951,2504328680,1320,1807570,1369.371212,1362082942545,1362082948305,2504320225,2504325985,5760
1362082951,2504328680,3,144,48,1362082942864,1362082948240,2504320544,2504325920,5376
1362082951,2504328680,5,730,146,1362082942863,1362082945231,2504320543,2504322911,2368
1362082951,2504328680,31,33362,1076.193548,1362082943246,1362082944078,2504320926,2504321758,832
1362082951,2504328684,3,144,48,1362082943309,1362082949261,2504320993,2504326945,5952
1362082951,2504328684,6,460,76.66666667,1362082943373,1362082944269,2504321057,2504321953,896
1362082951,2504328684,3,144,48,1362082943692,1362082949260,2504321376,2504326944,5568
1362082951,2504328684,2,98,49,1362082943691,1362082949195,2504321375,2504326879,5504
1362082951,2504328692,2,98,49,1362082944261,1362082950405,2504321953,2504328097,6144
1362082951,2504328756,2,98,49,1362082942469,1362082948165,2504320225,2504325921,5696
1362082951,2504328756,3,144,48,1362082942469,1362082948293,2504320225,2504326049,5824
1362082951,2504328756,3,144,48,1362082942787,1362082948163,2504320543,2504325919,5376
1362082951,2504328756,5,726,145.2,1362082942787,1362082945155,2504320543,2504322911,2368
1362082951,2504328760,2,98,49,1362082943167,1362082949183,2504320927,2504326943,6016
1362082951,2504328760,31,34742,1120.709677,1362082943295,1362082943999,2504321055,2504321759,704
1362082951,2504328760,6,460,76.66666667,1362082943295,1362082944191,2504321055,2504321951,896
1362082951,2504328764,2,98,49,1362082943612,1362082949180,2504321376,2504326944,5568
1362082951,2504328764,4,190,47.5,1362082943676,1362082949244,2504321440,2504327008,5568
1362082951,2504328772,5,414,82.8,1362082944181,1362082944373,2504321953,2504322145,192
1362082951,2504328772,5,414,82.8,1362082944181,1362082944309,2504321953,2504322081,128
1362082951,2504328772,3,144,48,1362082944181,1362082950325,2504321953,2504328097,6144
1362082951,2504328816,3,144,48,1362082941641,1362082947145,2504319457,2504324961,5504
1362082951,2504328816,3,144,48,1362082941641,1362082947145,2504319457,2504324961,5504
1362082951,2504328836,2,98,49,1362082942386,1362082948082,2504320222,2504325918,5696
1362082956,1142648860,3,144,48,1362082950373,1362082955749,1142643233,1142648609,5376
1362082959,2504336744,10,2344,234.4,1362082950992,1362082956304,2504328736,2504334048,5312
1362082959,2504336756,11,4402,400.1818182,1362082952068,1362082957316,2504329824,2504335072,5248
1362082959,2504336756,11,3447,313.3636364,1362082952259,1362082952451,2504330015,2504330207,192
1362082959,2504336756,6,461,76.83333333,1362082952258,1362082952386,2504330014,2504330142,128
1362082959,2504336756,8,2913,364.125,1362082952258,1362082958338,2504330014,2504336094,6080
1362082959,2504336816,5,1455,291,1362082941254,1362082957254,2504319070,2504335070,16000
1362082959,2504336820,3,144,48,1362082949764,1362082955204,2504327584,2504333024,5440
1362082959,2504336820,2,98,49,1362082949763,1362082955203,2504327583,2504333023,5440
1362082959,2504336824,5,947,189.4,1362082942720,1362082953664,2504320544,2504331488,10944
1362082959,2504336832,5,363,72.6,1362082951481,1362082951545,2504329313,2504329377,64
1362082959,2504336832,2,98,49,1362082951416,1362082957176,2504329248,2504335008,5760
1362082959,2504336832,2,98,49,1362082951544,1362082957176,2504329376,2504335008,5632
1362082959,2504336860,4,190,47.5,1362082952156,1362082953244,2504330016,2504331104,1088
1362082959,2504336900,12,4445,370.4166667,1362082941172,1362082953588,2504319072,2504331488,12416
1362082959,2504336900,2,98,49,1362082949682,1362082955122,2504327582,2504333022,5440
1362082959,2504336900,3,144,48,1362082949682,1362082955186,2504327582,2504333086,5504
1362082959,2504336900,3,144,48,1362082949682,1362082955186,2504327582,2504333086,5504
1362082964,1142656888,4,190,47.5,1362082951626,1362082956682,1142644514,1142649570,5056
1362082966,2504344544,5,974,194.8,1362082940528,1362082950128,2504319072,2504328672,9600
1362082966,2504344544,20,8801,440.05,1362082940528,1362082958576,2504319072,2504337120,18048
1362082966,2504344572,10,2417,241.7,1362082941653,1362082942997,2504320225,2504321569,1344
1362082967,1142659200,6,766,127.6666667,1362082941368,1362082951032,1142633568,1142643232,9664
1362082967,2504344664,6,574,95.66666667,1362082941409,1362082961953,2504319073,2504339617,20544
1362082967,2504344664,6,574,95.66666667,1362082941409,1362082961825,2504319073,2504339489,20416
1362082967,2504344788,28,21256,759.1428571,1362082949348,1362082963172,2504327136,2504340960,13824
1362082967,2504344812,104,124848,1200.461538,1362082950924,1362082964364,2504328736,2504342176,13440
1362082970,2504348376,42,52433,1248.404762,1362082941976,1362082951384,2504320352,2504329760,9408
1362082970,2504348388,18,1008,56,1362082942602,1362082962570,2504320990,2504340958,19968
1362082970,2504348392,4,970,242.5,1362082942665,1362082943241,2504321057,2504321633,576
1362082970,2504348416,18,1008,56,1362082943279,1362082963695,2504321695,2504342111,20416
1362082970,2504348580,2,92,46,1362082941834,1362082942026,2504320414,2504320606,192
1362082970,2504348580,19,1064,56,1362082941770,1362082966346,2504320350,2504344926,24576
1362082970,2504348592,19,1824,96,1362082942337,1362082966465,2504320929,2504345057,24128
1362082970,2504348592,4,388,97,1362082942400,1362082942848,2504320992,2504321440,448
1362082974,2504352556,15,7862,524.1333333,1362082949029,1362082950885,2504327585,2504329441,1856
1362082974,2504352556,12,7150,595.8333333,1362082949029,1362082950757,2504327585,2504329313,1728
1362082974,2504352596,3,491,163.6666667,1362082946810,1362082946938,2504325406,2504325534,128
1362082975,2504352672,36,33009,916.9166667,1362082949913,1362082953113,2504327585,2504330785,3200
1362082975,2504352672,37,34655,936.6216216,1362082949913,1362082953113,2504327585,2504330785,3200
1362082975,2504352672,24,19187,799.4583333,1362082949912,1362082953112,2504327584,2504330784,3200
1362082975,2504352672,5,437,87.4,1362082949912,1362082950424,2504327584,2504328096,512
1362082975,2504352672,12,7215,601.25,1362082949912,1362082951704,2504327584,2504329376,1792
1362082975,2504352720,6,461,76.83333333,1362082967273,1362082967401,2504344993,2504345121,128
1362082978,2504356464,24,27232,1134.666667,1362082951102,1362082951294,2504329566,2504329758,192
1362082978,2504356556,7,5070,724.2857143,1362082950179,1362082951331,2504328735,2504329887,1152
1362082978,2504356556,13,12439,956.8461538,1362082950179,1362082950563,2504328735,2504329119,384
1362082978,2504356556,10,9202,920.2,1362082950178,1362082950626,2504328734,2504329182,448
1362082978,2504356556,5,3895,779,1362082950178,1362082950882,2504328734,2504329438,704
1362082978,2504356596,10,1385,138.5,1362082950778,1362082951162,2504329374,2504329758,384
1362082983,2504360892,6,461,76.83333333,1362082982076,1362082982268,2504359968,2504360160,192
1362082986,2504364624,1,46,46,1362082961438,1362082961438,2504340062,2504340062,0
1362082999,2504376804,6,786,131,1362082997331,1362082997459,2504375135,2504375263,128
1362082999,2504376828,5,643,128.6,1362082998266,1362082998394,2504376094,2504376222,128
1362082999,2504376912,6,461,76.83333333,1362082997096,1362082997224,2504375008,2504375136,128
1362083007,2504384772,3,144,48,1362082998643,1362083003699,2504376415,2504381471,5056
1362083007,2504384772,3,144,48,1362082998707,1362083003699,2504376479,2504381471,4992
1362083007,2504384772,3,144,48,1362082998706,1362083004722,2504376478,2504382494,6016
1362083007,2504384812,9,590,65.55555556,1362083000460,1362083005708,2504378272,2504383520,5248
1362083007,2504384812,6,461,76.83333333,1362083000841,1362083000969,2504378653,2504378781,128
1362083007,2504384812,10,995,99.5,1362083000841,1362083001033,2504378653,2504378845,192
1362083007,2504384812,4,190,47.5,1362083000841,1362083001865,2504378653,2504379677,1024
1362083007,2504384856,2,279,139.5,1362082998240,1362083003616,2504376096,2504381472,5376
1362083007,2504384860,2,98,49,1362082998621,1362083003613,2504376481,2504381473,4992
1362083007,2504384860,3,144,48,1362082998620,1362083004636,2504376480,2504382496,6016
1362083007,2504384864,8,522,65.25,1362082999253,1362083004629,2504377117,2504382493,5376
1362083007,2504384892,2,98,49,1362082999801,1362083005561,2504377693,2504383453,5760
1362083007,2504384892,3,144,48,1362083000059,1362083005627,2504377951,2504383519,5568
1362083007,2504384900,7,455,65,1362083000756,1362083006644,2504378656,2504384544,5888
1362083007,2504384928,2,92,46,1362082997206,1362083002582,2504375134,2504380510,5376
1362083012,1142704876,3,144,48,1362082998804,1362083004180,1142691680,1142697056,5376
1362083012,1142704892,3,144,48,1362083000262,1362083006150,1142693154,1142699042,5888
1362083014,2504392444,3,491,163.6666667,1362082986963,1362082987091,2504365407,2504365535,128
1362083015,2504392796,5,576,115.2,1362082992667,1362083008731,2504370463,2504386527,16064
1362083015,2504392864,125,142175,1137.4,1362082998101,1362083013525,2504375965,2504391389,15424
1362083015,2504392876,11,3115,283.1818182,1362082999561,1362083012553,2504377437,2504390429,12992
1362083018,2504396512,1,46,46,1362082992847,1362082992847,2504371359,2504371359,0
1362083023,2504400852,2,98,49,1362083011809,1362083017825,2504389661,2504395677,6016
1362083023,2504400876,3,144,48,1362083011788,1362083016844,2504389664,2504394720,5056
1362083023,2504400964,3,144,48,1362083011699,1362083017715,2504389663,2504395679,6016
1362083023,2504400964,2,98,49,1362083011698,1362083016690,2504389662,2504394654,4992
1362083026,2504404416,29,31162,1074.551724,1362082998127,1362083001199,2504376543,2504379615,3072
1362083026,2504404456,5,949,189.8,1362082999237,1362082999493,2504377693,2504377949,256
1362083026,2504404460,14,12412,886.5714286,1362082999298,1362083001154,2504377758,2504379614,1856
1362083026,2504404464,22,27128,1233.090909,1362082999678,1362082999742,2504378142,2504378206,64
1362083026,2504404468,9,504,56,1362082999803,1362083022715,2504378271,2504401183,22912
1362083026,2504404472,31,40532,1307.483871,1362082999992,1362083000056,2504378464,2504378528,64
1362083026,2504404472,1,46,46,1362083000120,1362083000120,2504378592,2504378592,0
1362083026,1142719144,2,334,167,1362082998474,1362082998474,1142691618,1142691618,0
1362083026,2504404632,15,13489,899.2666667,1362082997911,1362083000983,2504376543,2504379615,3072
1362083026,2504404644,1,415,415,1362082998410,1362082998410,2504377054,2504377054,0
1362083027,2504404672,15,12998,866.5333333,1362082999768,1362083000664,2504377440,2504378336,896
1362083027,2504404672,11,11774,1070.363636,1362083000085,1362083001941,2504377757,2504379613,1856
1362083027,2504404676,9,9211,1023.444444,1362083000211,1362083000723,2504377887,2504378399,512
1362083027,2504404680,9,504,56,1362083000335,1362083022991,2504378015,2504400671,22656
1362083027,2504404680,9,504,56,1362083000462,1362083023182,2504378142,2504400862,22720
1362083027,2504404688,8,768,96,1362083000837,1362083022853,2504378525,2504400541,22016
1362083030,2504408464,1,46,46,1362083003584,1362083003584,2504382048,2504382048,0
1362083030,2504408548,1,46,46,1362083002473,1362083002473,2504381021,2504381021,0
1362083034,2504412504,3,169,56.33333333,1362083008216,1362083008280,2504386720,2504386784,64
1362083038,2504416432,7,1469,209.8571429,1362083010463,1362083010911,2504388895,2504389343,448
1362083039,2504416744,6,461,76.83333333,1362083030862,1362083031054,2504408606,2504408798,192
1362083047,2504424904,7,976,139.4285714,1362083022704,1362083038832,2504400608,2504416736,16128
1362083047,2504425060,6,461,76.83333333,1362083045588,1362083045780,2504423648,2504423840,192
1362083054,2504432492,1,96,96,1362083026723,1362083026723,2504405215,2504405215,0
1362083054,2504432508,1,56,56,1362083027025,1362083027025,2504405533,2504405533,0
1362083054,2504432640,3,491,163.6666667,1362083026572,1362083026700,2504405212,2504405340,128
1362083058,2504436596,1,56,56,1362083030008,1362083030008,2504408604,2504408604,0
1362083058,2504436600,1,56,56,1362083030069,1362083030069,2504408669,2504408669,0
1362083063,2504440908,6,461,76.83333333,1362083060715,1362083060843,2504438623,2504438751,128
1362083063,2504440912,5,740,148,1362083058150,1362083058406,2504436062,2504436318,256
1362083063,2504440912,5,643,128.6,1362083058277,1362083058405,2504436189,2504436317,128
1362083071,2504449080,2,92,46,1362083066623,1362083066623,2504444703,2504444703,0
1362083071,2504449088,7,584,83.42857143,1362083055990,1362083067894,2504434078,2504445982,11904
1362083071,2504449156,2,92,46,1362083066545,1362083066545,2504444701,2504444701,0
1362083071,2504449232,3,325,108.3333333,1362083057956,1362083063460,2504436188,2504441692,5504
1362083079,2504457188,6,461,76.83333333,1362083075474,1362083075602,2504453662,2504453790,128
1362083087,2504464712,1,46,46,1362083058989,1362083058989,2504436701,2504436701,0
1362083087,2504464920,2,92,46,1362083058782,1362083058782,2504436702,2504436702,0
1362083087,2504464920,3,169,56.33333333,1362083058846,1362083058910,2504436766,2504436830,64
1362083095,2504472712,2,92,46,1362083066927,1362083066991,2504444639,2504444703,64
1362083095,2504472720,3,491,163.6666667,1362083067494,1362083067622,2504445214,2504445342,128
1362083095,2504472728,2,123,61.5,1362083067998,1362083068062,2504445726,2504445790,64
1362083095,2504472896,2,92,46,1362083066805,1362083066805,2504444701,2504444701,0
1362083095,2504473048,6,461,76.83333333,1362083090589,1362083090717,2504468637,2504468765,128
1362083095,2504473140,5,363,72.6,1362083087042,1362083087106,2504465182,2504465246,64
1362083095,2504473144,7,542,77.42857143,1362083087613,1362083094269,2504465757,2504472413,6656
1362083103,2504481092,7,4148,592.5714286,1362083099057,1362083099377,2504477149,2504477469,320
1362083103,2504481104,9,5783,642.5555556,1362083100071,1362083100711,2504478175,2504478815,640
1362083103,2504481124,5,690,138,1362083100306,1362083100434,2504478430,2504478558,128
1362083103,2504481176,6,4142,690.3333333,1362083098974,1362083099294,2504477150,2504477470,320
1362083103,2504481212,5,608,121.6,1362083100215,1362083100343,2504478427,2504478555,128
1362083103,2504481220,2,92,46,1362083097265,1362083097265,2504475485,2504475485,0
1362083108,1142800880,2,98,49,1362083099858,1362083104978,1142792738,1142797858,5120
1362083108,1142800900,3,144,48,1362083098748,1362083103996,1142791648,1142796896,5248
1362083108,1142800904,3,144,48,1362083100537,1362083105977,1142793441,1142798881,5440
1362083108,1142800908,3,144,48,1362083099830,1362083104950,1142792738,1142797858,5120
1362083111,2504488820,1,46,46,1362083085249,1362083085249,2504463069,2504463069,0
1362083111,2504488936,4,428,107,1362083086669,1362083086861,2504464605,2504464797,192
1362083111,2504489060,31,30611,987.4516129,1362083102608,1362083109392,2504480668,2504487452,6784
1362083111,2504489148,3,140,46.66666667,1362083098807,1362083104311,2504476955,2504482459,5504
1362083111,2504489148,2,94,47,1362083098811,1362083104251,2504476959,2504482399,5440
1362083111,2504489152,2,92,46,1362083099255,1362083105207,2504477407,2504483359,5952
1362083111,2504489180,4,396,99,1362083099995,1362083106139,2504478175,2504484319,6144
1362083111,2504489180,3,150,50,1362083100249,1362083106201,2504478429,2504484381,5952
1362083111,2504489188,4,401,100.25,1362083100882,1362083106258,2504479070,2504484446,5376
1362083111,2504489220,3,144,48,1362083101296,1362083107184,2504479516,2504485404,5888
1362083115,2504492756,16,1536,96,1362083086977,1362083112769,2504464733,2504490525,25792
1362083115,2504492756,16,896,56,1362083087169,1362083112897,2504464925,2504490653,25728
1362083115,2504492760,16,3869,241.8125,1362083087486,1362083096510,2504465246,2504474270,9024
1362083115,2504492760,8,3189,398.625,1362083087422,1362083087550,2504465182,2504465310,128
1362083115,2504492764,16,896,56,1362083087865,1362083114553,2504465629,2504492317,26688
1362083115,2504492868,7,529,75.57142857,1362083086866,1362083087122,2504464734,2504464990,256
1362083115,2504492868,8,2954,369.25,1362083086866,1362083087186,2504464734,2504465054,320
1362083115,2504492868,15,3742,249.4666667,1362083087056,1362083096208,2504464924,2504474076,9152
1362083115,2504492872,43,21235,493.8372093,1362083087309,1362083096589,2504465181,2504474461,9280
1362083115,2504492880,15,840,56,1362083087878,1362083112518,2504465758,2504490398,24640
1362083119,2504497120,40,37798,944.95,1362083098838,1362083112342,2504476958,2504490462,13504
1362083119,2504497120,7,1213,173.2857143,1362083098838,1362083112022,2504476958,2504490142,13184
1362083119,2504497120,37,35393,956.5675676,1362083098838,1362083115030,2504476958,2504493150,16192
1362083119,2504497172,2,92,46,1362083117216,1362083117216,2504495388,2504495388,0
1362083119,2504497172,2,92,46,1362083117152,1362083117152,2504495324,2504495324,0
1362083119,2504497196,2,92,46,1362083117192,1362083117192,2504495388,2504495388,0
1362083119,2504497200,5,740,148,1362083117892,1362083118084,2504496092,2504496284,192
1362083119,2504497204,17,9476,557.4117647,1362083098752,1362083112320,2504476956,2504490524,13568
1362083119,2504497284,3,138,46,1362083117040,1362083117104,2504495324,2504495388,64
1362083119,2504497288,5,643,128.6,1362083117869,1362083117997,2504496157,2504496285,128
1362083123,2504501024,4,797,199.25,1362083098295,1362083098359,2504476319,2504476383,64
1362083123,2504501024,32,25620,800.625,1362083098421,1362083102261,2504476445,2504480285,3840
1362083127,1142819380,4,1490,372.5,1362083101060,1362083101124,1142793440,1142793504,64
1362083127,1142819380,47,49917,1062.06383,1362083099780,1362083100420,1142792160,1142792800,640
1362083127,1142819396,28,31358,1119.928571,1362083100343,1362083100535,1142792739,1142792931,192
1362083127,2504504848,4,927,231.75,1362083101223,1362083101287,2504479071,2504479135,64
1362083127,1142819444,1,349,349,1362083100293,1362083100293,1142792737,1142792737,0
1362083127,2504505012,1,46,46,1362083100417,1362083100417,2504478429,2504478429,0
1362083127,2504505140,6,461,76.83333333,1362083120576,1362083120704,2504498716,2504498844,128
1362083127,2504505204,7,412,58.85714286,1362083125569,1362083125633,2504503773,2504503837,64
1362083127,2504505288,3,325,108.3333333,1362083117868,1362083123884,2504496156,2504502172,6016
1362083135,2504512784,3,491,163.6666667,1362083107557,1362083107685,2504485341,2504485469,128
1362083135,2504513128,20,8263,413.15,1362083130511,1362083131663,2504508639,2504509791,1152
1362083135,2504513132,3,138,46,1362083126985,1362083127049,2504505117,2504505181,64
1362083139,2504517036,6,2287,381.1666667,1362083112679,1362083136615,2504490715,2504514651,23936
1362083139,2504517104,2,92,46,1362083114211,1362083114275,2504492315,2504492379,64
1362083143,2504520788,5,480,96,1362083115553,1362083127329,2504493341,2504505117,11776
1362083143,2504521076,4,224,56,1362083115775,1362083124095,2504493851,2504502171,8320
1362083143,2504521076,4,224,56,1362083115906,1362083125570,2504493982,2504503646,9664
1362083143,2504521084,1,46,46,1362083116282,1362083116282,2504494366,2504494366,0
1362083143,2504521084,1,46,46,1362083116282,1362083116282,2504494366,2504494366,0
1362083143,2504521088,3,138,46,1362083116662,1362083116726,2504494750,2504494814,64
1362083143,2504521240,3,169,56.33333333,1362083117533,1362083117597,2504495773,2504495837,64
1362083143,2504521280,5,280,56,1362083114933,1362083125493,2504493213,2504503773,10560
1362083143,2504521280,2,92,46,1362083115059,1362083115123,2504493339,2504493403,64
1362083143,2504521320,2,92,46,1362083116046,1362083116046,2504494366,2504494366,0
1362083143,2504521476,15,11097,739.8,1362083136176,1362083139184,2504514652,2504517660,3008
1362083143,2504521528,6,461,76.83333333,1362083135163,1362083135291,2504513691,2504513819,128
1362083151,2504529308,6,461,76.83333333,1362083150360,1362083150488,2504528668,2504528796,128
1362083167,2504545064,17,3661,215.3529412,1362083142542,1362083161230,2504520606,2504539294,18688
1362083167,2504545220,13,5722,440.1538462,1362083163439,1362083164079,2504541659,2504542299,640
1362083167,2504545252,17,8962,527.1764706,1362083164049,1362083164689,2504542301,2504542941,640
1362083167,2504545288,6,461,76.83333333,1362083166125,1362083166253,2504544413,2504544541,128
1362083167,2504545300,363,486353,1339.815427,1362083159967,1362083161695,2504538267,2504539995,1728
1362083167,2504545336,3,144,48,1362083160828,1362083166012,2504539164,2504544348,5184
1362083167,2504545344,18,7854,436.3333333,1362083164661,1362083165109,2504543005,2504543453,448
1362083171,2504548908,2,123,61.5,1362083145833,1362083145833,2504523741,2504523741,0
1362083171,2504548912,3,169,56.33333333,1362083145826,1362083145890,2504523738,2504523802,64
1362083171,2504548948,3,138,46,1362083143169,1362083143233,2504521117,2504521181,64
1362083171,2504549036,3,169,56.33333333,1362083145768,1362083145768,2504523804,2504523804,0
1362083175,2504552804,3,491,163.6666667,1362083147409,1362083147537,2504525213,2504525341,128
1362083175,2504553284,8,544,68,1362083167984,1362083174000,2504546268,2504552284,6016
1362083175,2504553320,11,4973,452.0909091,1362083164683,1362083169995,2504543003,2504548315,5312
1362083175,2504553320,41,28302,690.2926829,1362083169739,1362083171723,2504548059,2504550043,1984
1362083175,2504553324,11,4943,449.3636364,1362083165127,1362083171015,2504543451,2504549339,5888
1362083175,2504553328,9,4851,539,1362083165125,1362083171013,2504543453,2504549341,5888
1362083175,2504553364,12,5821,485.0833333,1362083163104,1362083169056,2504541468,2504547420,5952
1362083175,2504553364,8,2682,335.25,1362083167520,1362083172960,2504545884,2504551324,5440
1362083175,2504553364,9,2310,256.6666667,1362083167520,1362083172896,2504545884,2504551260,5376
1362083175,2504553368,9,590,65.55555556,1362083167902,1362083173982,2504546270,2504552350,6080
1362083183,2504560832,1,77,77,1362083154931,1362083154931,2504532763,2504532763,0
1362083183,2504560952,1,77,77,1362083154814,1362083154814,2504532766,2504532766,0
1362083183,2504560952,3,169,56.33333333,1362083154813,1362083154877,2504532765,2504532829,64
1362083183,2504561248,8,544,68,1362083170772,1362083176020,2504549020,2504554268,5248
1362083183,2504561384,6,398,66.33333333,1362083169739,1362083174923,2504548123,2504553307,5184
1362083183,2504561384,6,786,131,1362083177674,1362083177930,2504556058,2504556314,256
1362083183,2504561408,5,643,128.6,1362083177781,1362083177909,2504556189,2504556317,128
1362083187,2504565040,23,26633,1157.956522,1362083162146,1362083162274,2504540186,2504540314,128
1362083191,2504568888,7,2656,379.4285714,1362083164669,1362083164861,2504542557,2504542749,192
1362083191,2504568968,17,10086,593.2941176,1362083163435,1362083165675,2504541403,2504543643,2240
1362083191,2504569032,19,7648,402.5263158,1362083163885,1362083164845,2504541917,2504542877,960
1362083191,2504569084,14,9298,664.1428571,1362083165625,1362083166073,2504543709,2504544157,448
1362083191,2504569108,62,66029,1064.983871,1362083166047,1362083171615,2504544155,2504549723,5568
1362083191,2504569380,3,325,108.3333333,1362083177809,1362083182929,2504556189,2504561309,5120
1362083195,2504572916,25,14197,567.88,1362083167967,1362083182239,2504545883,2504560155,14272
1362083195,2504573036,10,3475,347.5,1362083167976,1362083171304,2504546012,2504549340,3328
1362083195,2504573108,9,2010,223.3333333,1362083169952,1362083171360,2504548060,2504549468,1408
1362083199,2504577236,2,92,46,1362083191646,1362083191646,2504569882,2504569882,0
1362083199,2504577276,52,61918,1190.730769,1362083197368,1362083198008,2504575644,2504576284,640
1362083199,2504577276,36,41608,1155.777778,1362083197240,1362083197624,2504575516,2504575900,384
1362083199,2504577276,32,36595,1143.59375,1362083197240,1362083197816,2504575516,2504576092,576
1362083199,2504577276,49,57388,1171.183673,1362083197431,1362083198199,2504575707,2504576475,768
1362083199,2504577356,1496,1898869,1269.29746,1362083189799,1362083194599,2504568155,2504572955,4800
1362083207,2504585272,3,144,48,1362083196603,1362083201979,2504574875,2504580251,5376
1362083207,2504585272,3,144,48,1362083196603,1362083201979,2504574875,2504580251,5376
1362083207,2504585272,3,144,48,1362083196602,1362083201914,2504574874,2504580186,5312
1362083207,2504585280,3,144,48,1362083197619,1362083203251,2504575899,2504581531,5632
1362083207,2504585280,2,98,49,1362083197619,1362083203251,2504575899,2504581531,5632
1362083207,2504585356,3,144,48,1362083196518,1362083201830,2504574874,2504580186,5312
1362083207,2504585356,3,144,48,1362083196839,1362083203175,2504575195,2504581531,6336
1362083207,2504585364,1401,1872509,1336.551749,1362083197538,1362083203490,2504575902,2504581854,5952
1362083207,2504585364,2,98,49,1362083197538,1362083203042,2504575902,2504581406,5504
1362083207,2504585364,3,144,48,1362083197537,1362083203105,2504575901,2504581469,5568
1362083215,2504592924,9,504,56,1362083187350,1362083213782,2504565274,2504591706,26432
1362083215,2504592928,9,864,96,1362083187603,1362083214227,2504565531,2504592155,26624
1362083215,2504593004,8,448,56,1362083190153,1362083213449,2504568157,2504591453,23296
1362083215,2504593040,3,491,163.6666667,1362083187235,1362083187299,2504565275,2504565339,64
1362083215,2504593044,9,504,56,1362083187361,1362083213921,2504565405,2504591965,26560
1362083215,2504593272,6,455,75.83333333,1362083210812,1362083210940,2504589084,2504589212,128
1362083215,2504593316,5,1455,291,1362083196814,1362083212942,2504575130,2504591258,16128
1362083215,2504593428,5,648,129.6,1362083196446,1362083209118,2504574874,2504587546,12672
1362083219,2504596928,30,26196,873.2,1362083191060,1362083199444,2504568988,2504577372,8384
1362083219,2504597084,2,92,46,1362083192121,1362083192185,2504570205,2504570269,64
1362083223,1142915400,2,334,167,1362083196978,1362083196978,1142889378,1142889378,0
1362083223,2504600976,4,559,139.75,1362083196899,1362083196899,2504574875,2504574875,0
1362083223,2504600976,6,574,95.66666667,1362083196898,1362083217890,2504574874,2504595866,20992
1362083223,2504600980,6,574,95.66666667,1362083196897,1362083217761,2504574877,2504595741,20864
1362083223,2504601008,2,817,408.5,1362083197572,1362083197636,2504575580,2504575644,64
1362083223,2504601132,12,15615,1301.25,1362083197703,1362083197703,2504575835,2504575835,0
1362083231,2504609440,1,77,77,1362083204308,1362083204308,2504582748,2504582748,0
1362083231,2504609440,1,77,77,1362083204306,1362083204306,2504582746,2504582746,0
1362083231,2504609568,2,123,61.5,1362083204180,1362083204180,2504582748,2504582748,0
1362083239,2504617440,2,123,61.5,1362083213266,1362083213330,2504591706,2504591770,64
1362083239,2504617444,1,77,77,1362083213264,1362083213264,2504591708,2504591708,0
1362083239,2504617448,2,92,46,1362083213770,1362083213770,2504592218,2504592218,0
1362083239,2504617560,1,46,46,1362083212890,1362083212890,2504591450,2504591450,0
1362083239,2504617564,1,77,77,1362083213144,1362083213144,2504591708,2504591708,0
1362083240,2504617692,6,786,131,1362083238398,1362083238590,2504616090,2504616282,192
1362083240,2504617692,5,643,128.6,1362083238462,1362083238590,2504616154,2504616282,128
1362083243,1142935388,1,46,46,1362083216318,1362083216318,1142908706,1142908706,0
1362083243,1142935436,2,92,46,1362083216270,1362083216334,1142908706,1142908770,64
1362083243,1142935436,1,46,46,1362083216270,1362083216270,1142908706,1142908706,0
1362083243,2504621332,1,56,56,1362083215807,1362083215807,2504594139,2504594139,0
1362083243,2504621380,1,56,56,1362083217297,1362083217297,2504595677,2504595677,0
1362083243,2504621532,1,56,56,1362083217270,1362083217270,2504595802,2504595802,0
1362083248,2504625816,3,325,108.3333333,1362083238340,1362083244484,2504616156,2504622300,6144
1362083255,2504633288,3,491,163.6666667,1362083226986,1362083227050,2504605274,2504605338,64
1362083264,2504641732,6,461,76.83333333,1362083256345,1362083256473,2504634077,2504634205,128
1362083272,2504649660,7,412,58.85714286,1362083264094,1362083264094,2504641754,2504641754,0
1362083272,2504649740,6,366,61,1362083264015,1362083264015,2504641755,2504641755,0
1362083272,2504649740,6,366,61,1362083264014,1362083264014,2504641754,2504641754,0
1362083275,2504653500,1,46,46,1362083248854,1362083248854,2504627354,2504627354,0
1362083279,2504657388,1,46,46,1362083253446,1362083253446,2504631834,2504631834,0
1362083280,2504657640,7,412,58.85714286,1362083273076,1362083273140,2504650716,2504650780,64
1362083280,2504657680,18,17857,992.0555556,1362083263435,1362083279499,2504641115,2504657179,16064
1362083280,2504657720,6,366,61,1362083272995,1362083273059,2504650715,2504650779,64
1362083280,2504657720,7,412,58.85714286,1362083272994,1362083273058,2504650714,2504650778,64
1362083280,2504657748,190,138525,729.0789474,1362083068552,1362083273032,2504446300,2504650780,204480
1362083283,2504661344,1,46,46,1362083255412,1362083255412,2504633756,2504633756,0
1362083283,2504661388,1,46,46,1362083256389,1362083256389,2504634777,2504634777,0
1362083283,2504661512,1,46,46,1362083255882,1362083255882,2504634394,2504634394,0
1362083283,2504661512,1,46,46,1362083255946,1362083255946,2504634458,2504634458,0
1362083288,2504665856,12,3493,291.0833333,1362083286684,1362083286940,2504664540,2504664796,256
1362083288,2504665860,2,92,46,1362083287253,1362083287253,2504665113,2504665113,0
1362083288,2504665900,3,138,46,1362083281199,1362083281263,2504659099,2504659163,64
1362083288,2504665900,2,92,46,1362083281262,1362083281262,2504659162,2504659162,0
1362083288,2504665936,5,415,83,1362083286603,1362083286731,2504664539,2504664667,128
1362083288,2504665940,2,92,46,1362083287176,1362083287176,2504665116,2504665116,0
1362083292,1142984988,3,144,48,1362083284711,1362083290663,1142977699,1142983651,5952
1362083292,1142985000,4,190,47.5,1362083286042,1362083291674,1142979042,1142984674,5632
1362083295,2504673380,3,491,163.6666667,1362083266960,1362083267088,2504645340,2504645468,128
1362083296,2504673776,3,144,48,1362083284520,1362083290344,2504662296,2504668120,5824
1362083296,2504673804,2,98,49,1362083285837,1362083291277,2504663641,2504669081,5440
1362083296,2504673808,2,98,49,1362083286090,1362083291274,2504663898,2504669082,5184
1362083296,2504673816,10,4356,435.6,1362083286594,1362083292290,2504664410,2504670106,5696
1362083296,2504673820,10,2993,299.3,1362083286719,1362083292543,2504664539,2504670363,5824
1362083296,2504673848,3,144,48,1362083284516,1362083290276,2504662364,2504668124,5760
1362083296,2504673848,2,98,49,1362083284516,1362083290276,2504662364,2504668124,5760
1362083296,2504673848,3,144,48,1362083284516,1362083290276,2504662364,2504668124,5760
1362083296,2504673852,9,568,63.11111111,1362083285277,1362083291229,2504663129,2504669081,5952
1362083296,2504673888,2,98,49,1362083285755,1362083291195,2504663643,2504669083,5440
1362083296,2504673888,2,98,49,1362083285755,1362083291195,2504663643,2504669083,5440
1362083296,2504673888,2,98,49,1362083285755,1362083291195,2504663643,2504669083,5440
1362083296,2504673892,2,98,49,1362083286008,1362083291192,2504663900,2504669084,5184
1362083296,2504673900,4,190,47.5,1362083286639,1362083287727,2504664539,2504665627,1088
1362083304,2504681756,5,643,128.6,1362083298432,1362083298560,2504676188,2504676316,128
1362083304,2504681756,6,786,131,1362083298301,1362083298557,2504676057,2504676313,256
1362083304,2504681800,123,142718,1160.308943,1362083284050,1362083300306,2504661850,2504678106,16256
1362083304,2504681836,11,3066,278.7272727,1362083285485,1362083298349,2504663321,2504676185,12864
1362083304,2504681840,2,92,46,1362083298282,1362083298282,2504676122,2504676122,0
1362083307,2504685372,1,46,46,1362083279767,1362083279767,2504658139,2504658139,0
1362083307,2504685596,1,46,46,1362083279540,1362083279540,2504658136,2504658136,0
1362083311,1143003624,2,334,167,1362083284693,1362083284693,1142977317,1142977317,0
1362083311,2504689400,16,8845,552.8125,1362083283961,1362083285753,2504662361,2504664153,1792
1362083311,2504689400,5,437,87.4,1362083283961,1362083284409,2504662361,2504662809,448
1362083311,2504689400,25,21283,851.32,1362083283961,1362083287289,2504662361,2504665689,3328
1362083311,2504689404,7,585,83.57142857,1362083283956,1362083306228,2504662360,2504684632,22272
1362083311,2504689404,41,31020,756.5853659,1362083283895,1362083287287,2504662299,2504665691,3392
1362083311,2504689404,25,20430,817.2,1362083283959,1362083287223,2504662363,2504665627,3264
1362083311,2504689412,8,768,96,1362083284268,1362083306860,2504662680,2504685272,22592
1362083311,2504689416,12,12393,1032.75,1362083284905,1362083285161,2504663321,2504663577,256
1362083311,2504689420,11,9234,839.4545455,1362083284967,1362083285607,2504663387,2504664027,640
1362083311,2504689440,8,5119,639.875,1362083285202,1362083285778,2504663642,2504664218,576
1362083311,2504689444,22,27140,1233.636364,1362083285455,1362083285711,2504663899,2504664155,256
1362083312,2504689636,42,39376,937.5238095,1362083284727,1362083287991,2504662363,2504665627,3264
1362083312,2504689636,13,7474,574.9230769,1362083284726,1362083286646,2504662362,2504664282,1920
1362083312,2504689644,1,415,415,1362083285167,1362083285167,2504662811,2504662811,0
1362083312,2504689668,8,448,56,1362083285332,1362083307796,2504663000,2504685464,22464
1362083312,2504689668,8,448,56,1362083285398,1362083307926,2504663066,2504685594,22528
1362083312,2504689668,9,9067,1007.444444,1362083285461,1362083286037,2504663129,2504663705,576
1362083312,2504689672,8,448,56,1362083285650,1362083309394,2504663322,2504687066,23744
1362083312,2504689680,4,317,79.25,1362083286026,1362083286154,2504663706,2504663834,128
1362083312,2504689684,12,1477,123.0833333,1362083286152,1362083286664,2504663836,2504664348,512
1362083312,2504689948,9,2760,306.6666667,1362083292991,1362083309183,2504670939,2504687131,16192
1362083312,2504689956,3,325,108.3333333,1362083298232,1362083304184,2504676188,2504682140,5952
1362083320,2504697684,3,144,48,1362083313032,1362083318472,2504690716,2504696156,5440
1362083320,2504697684,2,98,49,1362083313032,1362083318408,2504690716,2504696092,5376
1362083320,2504697684,6,461,76.83333333,1362083316871,1362083316999,2504694555,2504694683,128
1362083320,2504697764,4,190,47.5,1362083312948,1362083318388,2504690712,2504696152,5440
1362083332,2504709608,3,491,163.6666667,1362083307667,1362083307795,2504685275,2504685403,128
1362083336,2504713896,6,461,76.83333333,1362083331635,1362083331763,2504709531,2504709659,128
1362083339,2504717480,13,4357,335.1538462,1362083311338,1362083329706,2504689818,2504708186,18368
1362083339,2504717480,2,112,56,1362083311401,1362083312617,2504689881,2504691097,1216
1362083339,2504717512,2,112,56,1362083312072,1362083316104,2504690584,2504694616,4032
1362083339,2504717516,2,92,46,1362083312580,1362083312644,2504691096,2504691160,64
1362083339,2504717520,1,46,46,1362083312576,1362083312576,2504691096,2504691096,0
1362083340,2504717596,3,288,96,1362083312159,1362083318495,2504689755,2504696091,6336
1362083340,2504717600,2,112,56,1362083312728,1362083316888,2504690328,2504694488,4160
1362083360,2504737888,5,643,128.6,1362083358264,1362083358392,2504736152,2504736280,128
1362083360,2504737968,6,786,131,1362083358121,1362083358313,2504736089,2504736281,192
1362083368,2504745644,3,169,56.33333333,1362083343213,1362083343277,2504720857,2504720921,64
1362083368,2504746036,6,461,76.83333333,1362083361511,1362083361639,2504739547,2504739675,128
1362083368,2504746048,3,325,108.3333333,1362083358106,1362083364122,2504736154,2504742170,6016
1362083372,2504749660,3,169,56.33333333,1362083345245,1362083345309,2504722905,2504722969,64
1362083375,2504753340,3,491,163.6666667,1362083346997,1362083347125,2504725337,2504725465,128
1362083384,2504762232,6,500,83.33333333,1362083378338,1362083381410,2504756570,2504759642,3072
1362083400,2504778164,19,18020,948.4210526,1362083382883,1362083398947,2504761047,2504777111,16064
1362083404,2504781884,1,46,46,1362083378683,1362083378683,2504756567,2504756567,0
1362083408,2504786052,2,92,46,1362083402068,1362083402068,2504780120,2504780120,0
1362083408,2504786064,2,92,46,1362083403017,1362083403017,2504781081,2504781081,0
1362083408,2504786064,6,461,76.83333333,1362083406472,1362083406664,2504784536,2504784728,192
1362083408,2504786136,2,92,46,1362083401985,1362083401985,2504780121,2504780121,0
1362083408,2504786144,3,138,46,1362083402938,1362083403002,2504781082,2504781146,64
1362083408,2504786144,2,92,46,1362083402938,1362083402938,2504781082,2504781082,0
1362083408,2504786144,2,92,46,1362083402938,1362083402938,2504781082,2504781082,0
1362083412,2504789796,3,491,163.6666667,1362083387413,1362083387541,2504765209,2504765337,128
1362083424,2504802104,6,786,131,1362083417951,1362083418207,2504796055,2504796311,256
1362083424,2504802108,5,643,128.6,1362083418077,1362083418205,2504796185,2504796313,128
1362083427,1143119740,2,92,46,1362083399904,1362083399904,1143092644,1143092644,0
1362083428,2504805736,2,92,46,1362083401361,1362083401361,2504779097,2504779097,0
1362083428,2504805736,1,46,46,1362083401361,1362083401361,2504779097,2504779097,0
1362083428,2504805736,2,92,46,1362083401359,1362083401359,2504779095,2504779095,0
1362083428,2504805772,2,92,46,1362083402284,1362083402348,2504780056,2504780120,64
1362083428,2504805772,1,46,46,1362083402348,1362083402348,2504780120,2504780120,0
1362083428,2504805820,2,92,46,1362083400251,1362083400251,2504778071,2504778071,0
1362083428,2504805864,2,123,61.5,1362083401999,1362083402063,2504779863,2504779927,64
1362083432,2504809792,3,169,56.33333333,1362083404122,1362083404186,2504781914,2504781978,64
1362083432,2504810028,2,279,139.5,1362083418156,1362083424108,2504796184,2504802136,5952
1362083432,2504810108,1761,2267153,1287.423623,1362083421339,1362083427675,2504799447,2504805783,6336
1362083440,2504818188,10,995,99.5,1362083437773,1362083438093,2504815961,2504816281,320
1362083440,2504818188,6,461,76.83333333,1362083437772,1362083438028,2504815960,2504816216,256
1362083444,1143137016,3,144,48,1362083436174,1362083441806,1143129190,1143134822,5632
1362083444,1143137024,3,144,48,1362083437442,1362083442818,1143130466,1143135842,5376
1362083448,2504825800,8,448,56,1362083422096,1362083442448,2504799896,2504820248,20352
1362083448,2504825992,8,448,56,1362083421903,1362083443279,2504799895,2504821271,21376
1362083448,2504825996,8,448,56,1362083422092,1362083445260,2504800088,2504823256,23168
1362083448,2504826000,5,1724,344.8,1362083422662,1362083422854,2504800662,2504800854,192
1362083448,2504826080,2,98,49,1362083435706,1362083441210,2504813786,2504819290,5504
1362083448,2504826088,2,98,49,1362083436784,1362083442224,2504814872,2504820312,5440
1362083448,2504826088,2,98,49,1362083436784,1362083442224,2504814872,2504820312,5440
1362083448,2504826088,3,138,46,1362083445231,1362083445295,2504823319,2504823383,64
1362083448,2504826112,2,98,49,1362083437082,1362083442202,2504815194,2504820314,5120
1362083448,2504826112,3,144,48,1362083437209,1362083443161,2504815321,2504821273,5952
1362083448,2504826112,2,98,49,1362083437272,1362083443160,2504815384,2504821272,5888
1362083448,2504826116,8,544,68,1362083437652,1362083443156,2504815768,2504821272,5504
1362083448,2504826120,8,495,61.875,1362083437840,1362083443216,2504815960,2504821336,5376
1362083448,2504826156,3,144,48,1362083435630,1362083441134,2504813786,2504819290,5504
1362083448,2504826156,2,98,49,1362083435629,1362083441133,2504813785,2504819289,5504
1362083448,2504826156,2,98,49,1362083435629,1362083441133,2504813785,2504819289,5504
1362083448,2504826164,10,2344,234.4,1362083436451,1362083442147,2504814615,2504820311,5696
1362083448,2504826168,2,98,49,1362083436770,1362083442146,2504814938,2504820314,5376
1362083448,2504826168,3,144,48,1362083436705,1362083442145,2504814873,2504820313,5440
1362083448,2504826168,2,98,49,1362083437022,1362083442142,2504815190,2504820310,5120
1362083448,2504826192,2,98,49,1362083437321,1362083443081,2504815513,2504821273,5760
1362083452,2504829888,8,768,96,1362083425079,1362083448887,2504802967,2504826775,23808
1362083452,2504829964,3,491,163.6666667,1362083427243,1362083427371,2504805207,2504805335,128
1362083456,2504834180,11,3077,279.7272727,1362083436693,1362083448597,2504814873,2504826777,11904
1362083456,2504834308,122,142157,1165.221311,1362083434962,1362083449490,2504813270,2504827798,14528
1362083463,1143155724,3,386,128.6666667,1362083435568,1362083436272,1143128292,1143128996,704
1362083464,2504841900,41,38829,947.0487805,1362083435883,1362083439595,2504813783,2504817495,3712
1362083464,2504841900,26,22405,861.7307692,1362083435882,1362083439658,2504813782,2504817558,3776
1362083464,2504841904,22,18802,854.6363636,1362083435878,1362083439590,2504813782,2504817494,3712
1362083464,2504841904,21,19080,908.5714286,1362083435878,1362083439654,2504813782,2504817558,3776
1362083464,2504841916,6,3944,657.3333333,1362083436701,1362083437341,2504814617,2504815257,640
1362083464,2504841944,24,27232,1134.666667,1362083437439,1362083437631,2504815383,2504815575,192
1362083464,2504842104,3,513,171,1362083435680,1362083436320,2504813784,2504814424,640
1362083464,2504842104,11,7153,650.2727273,1362083435679,1362083437087,2504813783,2504815191,1408
1362083464,2504842104,22,18518,841.7272727,1362083435679,1362083439455,2504813783,2504817559,3776
1362083464,2504842108,40,46270,1156.75,1362083435802,1362083437786,2504813910,2504815894,1984
1362083464,2504842144,10,9258,925.8,1362083436727,1362083437239,2504814871,2504815383,512
1362083464,2504842144,5,949,189.8,1362083436790,1362083437046,2504814934,2504815190,256
1362083464,2504842148,12,10669,889.0833333,1362083437043,1362083437491,2504815191,2504815639,448
1362083464,2504842284,7,412,58.85714286,1362083460588,1362083460652,2504838872,2504838936,64
1362083472,2504850308,6,455,75.83333333,1362083467667,1362083467795,2504845975,2504846103,128
1362083476,2504854176,1,56,56,1362083449558,1362083449558,2504827734,2504827734,0
1362083480,2504858324,5,643,128.6,1362083477827,1362083478019,2504856151,2504856343,192
1362083480,2504858404,6,786,131,1362083477683,1362083477875,2504856087,2504856279,192
1362083488,2504866436,3,325,108.3333333,1362083477716,1362083483732,2504856152,2504862168,6016
1362083492,2504870156,3,491,163.6666667,1362083467117,1362083467245,2504845273,2504845401,128
1362083520,2504898408,6,461,76.83333333,1362083512560,1362083512816,2504890968,2504891224,256
1362083524,2504901972,3,169,56.33333333,1362083495908,1362083495972,2504873880,2504873944,64
1362083524,1143217028,3,144,48,1362083514623,1362083520639,1143207651,1143213667,6016
1362083528,2504906384,4,196,49,1362083517447,1362083522759,2504895831,2504901143,5312
1362083528,2504906384,3,144,48,1362083517447,1362083522759,2504895831,2504901143,5312
1362083528,2504906392,27,29856,1105.777778,1362083523135,1362083523455,2504901527,2504901847,320
1362083528,2504906392,34,37603,1105.970588,1362083523199,1362083523903,2504901591,2504902295,704
1362083528,2504906480,51,62893,1233.196078,1362083523111,1362083523879,2504901591,2504902359,768
1362083536,2504914204,3,491,163.6666667,1362083507898,1362083508026,2504886102,2504886230,128
1362083536,2504914240,41,42165,1028.414634,1362083508759,1362083514839,2504886999,2504893079,6080
1362083536,2504914364,3,144,48,1362083523484,1362083528860,2504901848,2504907224,5376
1362083536,2504914408,4,184,46,1362083530673,1362083531761,2504909081,2504910169,1088
1362083536,2504914408,3,144,48,1362083522544,1362083527728,2504900952,2504906136,5184
1362083536,2504914408,2,98,49,1362083523373,1362083528685,2504901781,2504907093,5312
1362083536,2504914444,6,461,76.83333333,1362083527819,1362083527947,2504906263,2504906391,128
1362083536,2504914448,4,190,47.5,1362083527945,1362083529033,2504906393,2504907481,1088
1362083536,2504914488,4,602,150.5,1362083522398,1362083535134,2504900886,2504913622,12736
1362083536,2504914488,4,184,46,1362083530653,1362083531741,2504909141,2504910229,1088
1362083536,2504914492,3,144,48,1362083522396,1362083527644,2504900888,2504906136,5248
1362083536,2504914492,3,144,48,1362083522460,1362083527644,2504900952,2504906136,5184
1362083536,2504914496,1181,1487257,1259.320068,1362083523286,1362083527638,2504901782,2504906134,4352
1362083536,2504914496,3,144,48,1362083523286,1362083528598,2504901782,2504907094,5312
1362083536,2504914496,2,98,49,1362083523286,1362083528598,2504901782,2504907094,5312
1362083536,2504914496,2,98,49,1362083523350,1362083528662,2504901846,2504907158,5312
1362083539,1143231920,14,12111,865.0714286,1362083514731,1362083515499,1143207651,1143208419,768
1362083539,1143231920,5,2022,404.4,1362083514731,1362083516075,1143207651,1143208995,1344
1362083539,1143231968,9,6186,687.3333333,1362083514683,1362083515835,1143207651,1143208803,1152
1362083540,2504918172,9,504,56,1362083514972,1362083538012,2504893144,2504916184,23040
1362083540,2504918172,9,864,96,1362083515227,1362083538907,2504893399,2504917079,23680
1362083540,2504918172,8,448,56,1362083515482,1362083537882,2504893654,2504916054,22400
1362083540,2504918172,91,120834,1327.846154,1362083515481,1362083517657,2504893653,2504895829,2176
1362083540,2504918172,7,3098,442.5714286,1362083515481,1362083516825,2504893653,2504894997,1344
1362083540,2504918176,11,7274,661.2727273,1362083515479,1362083517527,2504893655,2504895703,2048
1362083540,2504918304,83,102204,1231.373494,1362083515350,1362083517206,2504893654,2504895510,1856
1362083540,2504918304,4,1026,256.5,1362083515350,1362083515926,2504893654,2504894230,576
1362083540,2504918304,11,6744,613.0909091,1362083515350,1362083517270,2504893654,2504895574,1920
1362083540,2504918304,6,5269,878.1666667,1362083515350,1362083517462,2504893654,2504895766,2112
1362083540,2504918304,5,3227,645.4,1362083515350,1362083516694,2504893654,2504894998,1344
1362083540,2504918304,9,504,56,1362083514965,1362083538005,2504893269,2504916309,23040
1362083540,2504918332,34,42004,1235.411765,1362083515323,1362083515451,2504893655,2504893783,128
1362083540,2504918332,8,6369,796.125,1362083515323,1362083517307,2504893655,2504895639,1984
1362083543,1143235892,6,2793,465.5,1362083515272,1362083517192,1143208164,1143210084,1920
1362083543,1143235892,9,7329,814.3333333,1362083515272,1362083516872,1143208164,1143209764,1600
1362083543,1143235944,8,6049,756.125,1362083515220,1362083517012,1143208164,1143209956,1792
1362083543,1143235944,5,1878,375.6,1362083515220,1362083517140,1143208164,1143210084,1920
1362083543,1143235944,17,12527,736.8823529,1362083515219,1362083517459,1143208163,1143210403,2240
1362083543,1143235944,10,8474,847.4,1362083515219,1362083517011,1143208163,1143209955,1792
1362083544,2504922272,3,1036,345.3333333,1362083516728,1362083516984,2504895000,2504895256,256
1362083544,2504922472,5,643,128.6,1362083537712,1362083537840,2504916184,2504916312,128
1362083544,2504922484,5,1456,291.2,1362083522916,1362083538660,2504901400,2504917144,15744
1362083544,2504922552,6,786,131,1362083537502,1362083537758,2504916054,2504916310,256
1362083544,2504922560,6,574,95.66666667,1362083522389,1362083543189,2504900949,2504921749,20800
1362083544,2504922564,6,574,95.66666667,1362083522388,1362083543316,2504900952,2504921880,20928
1362083547,1143239924,2,334,167,1362083522473,1362083522537,1143215397,1143215461,64
1362083548,2504926172,31,28079,905.7741935,1362083522714,1362083524826,2504900886,2504902998,2112
1362083548,2504926204,5,2041,408.2,1362083523580,1362083524028,2504901784,2504902232,448
1362083548,2504926292,1,415,415,1362083522595,1362083522595,2504900887,2504900887,0
1362083552,2504930108,37,42527,1149.378378,1362083524123,1362083524443,2504902231,2504902551,320
1362083552,2504930568,3,325,108.3333333,1362083537616,1362083543568,2504916184,2504922136,5952
1362083556,2504934180,4,1388,347,1362083531153,1362083531345,2504909333,2504909525,192
1362083556,2504934208,16,12881,805.0625,1362083531318,1362083531446,2504909526,2504909654,128
1362083560,2504938552,2,92,46,1362083554591,1362083554591,2504933143,2504933143,0
1362083560,2504938552,2,92,46,1362083554591,1362083554591,2504933143,2504933143,0
1362083560,2504938552,2,92,46,1362083554591,1362083554591,2504933143,2504933143,0
1362083560,2504938596,2,92,46,1362083552496,1362083552496,2504931092,2504931092,0
1362083561,2504938620,6,455,75.83333333,1362083558339,1362083558531,2504935959,2504936151,192
1362083561,2504938628,2,92,46,1362083555513,1362083555513,2504933141,2504933141,0
1362083561,2504938632,3,138,46,1362083555508,1362083555508,2504933140,2504933140,0
1362083568,2504946288,1,56,56,1362083543399,1362083543399,2504921687,2504921687,0
1362083568,2504946416,1,56,56,1362083543397,1362083543397,2504921813,2504921813,0
1362083572,2504950116,1,56,56,1362083543954,1362083543954,2504922070,2504922070,0
1362083576,2504954120,4,537,134.25,1362083548173,1362083548301,2504926293,2504926421,128
1362083580,2504958176,2,92,46,1362083552919,1362083552983,2504931095,2504931159,64
1362083580,2504958176,1,46,46,1362083552918,1362083552918,2504931094,2504931094,0
1362083580,2504958176,1,46,46,1362083552918,1362083552918,2504931094,2504931094,0
1362083580,2504958304,2,92,46,1362083552789,1362083552853,2504931093,2504931157,64
1362083580,2504958304,1,46,46,1362083552789,1362083552789,2504931093,2504931093,0
1362083580,2504958344,3,169,56.33333333,1362083553837,1362083553901,2504932181,2504932245,64
1362083584,2504962268,2,92,46,1362083559290,1362083559354,2504937558,2504937622,64
1362083584,2504962272,3,138,46,1362083559285,1362083559349,2504937557,2504937621,64
1362083584,2504962272,2,92,46,1362083559285,1362083559349,2504937557,2504937621,64
1362083592,2504970168,3,138,46,1362083565405,1362083565405,2504943573,2504943573,0
1362083592,2504970208,2,92,46,1362083566390,1362083566390,2504944598,2504944598,0
1362083592,2504970212,3,138,46,1362083566387,1362083566387,2504944599,2504944599,0
1362083601,2504978636,6,786,131,1362083598448,1362083598640,2504976084,2504976276,192
1362083601,2504978640,5,643,128.6,1362083598511,1362083598703,2504976151,2504976343,192
1362083604,2504982196,1,46,46,1362083578048,1362083578048,2504956244,2504956244,0
1362083608,2504986464,4,523,130.75,1362083592567,1362083607671,2504971031,2504986135,15104
1362083608,2504986496,3,325,108.3333333,1362083597655,1362083603671,2504976151,2504982167,6016
1362083608,2504986572,6,461,76.83333333,1362083602441,1362083602569,2504981013,2504981141,128
1362083612,2504990168,1,46,46,1362083585245,1362083585245,2504963413,2504963413,0
1362083616,2504994280,4,537,134.25,1362083588014,1362083588142,2504966294,2504966422,128
1362083625,2505002664,9,497,55.22222222,1362083613525,1362083618453,2504991189,2504996117,4928
1362083625,2505002700,6,499,83.16666667,1362083619825,1362083622961,2504997525,2505000661,3136
1362083632,2505010596,3,144,48,1362083622512,1362083627568,2505001108,2505006164,5056
1362083633,2505010708,2,92,46,1362083631403,1362083631403,2505009111,2505009111,0
1362083640,2505018172,7,1375,196.4285714,1362083612313,1362083612697,2504990485,2504990869,384
1362083640,2505018552,105,123516,1176.342857,1362083516443,1362083633627,2504894995,2505012179,117184
1362083640,2505018588,176,213427,1212.653409,1362083515064,1362083633528,2504893652,2505012116,118464
1362083640,2505018592,195,228843,1173.553846,1362083515061,1362083633589,2504893653,2505012181,118528
1362083644,2505022400,1,46,46,1362083619125,1362083619125,2504997525,2504997525,0
1362083655,1143348012,2,92,46,1362083630675,1362083630675,1143323687,1143323687,0
1362083656,2505034200,3,491,163.6666667,1362083628221,1362083628349,2505006421,2505006549,128
1362083659,1143352128,2,92,46,1362083631580,1362083631580,1143324708,1143324708,0
1362083659,1143352128,2,92,46,1362083631516,1362083631516,1143324644,1143324644,0
1362083659,1143352136,2,92,46,1362083632533,1362083632533,1143325669,1143325669,0
1362083659,1143352136,1,46,46,1362083632533,1362083632533,1143325669,1143325669,0
1362083659,1143352136,1,46,46,1362083632533,1362083632533,1143325669,1143325669,0
1362083660,1143352184,1,46,46,1362083633484,1362083633484,1143325668,1143325668,0
1362083660,1143352184,1,46,46,1362083633484,1362083633484,1143325668,1143325668,0
1362083660,1143352184,1,46,46,1362083633484,1362083633484,1143325668,1143325668,0
1362083660,2505038236,1,46,46,1362083631895,1362083631895,2505010131,2505010131,0
1362083660,2505038252,2,92,46,1362083632905,1362083632905,2505011157,2505011157,0
1362083660,2505038252,1,46,46,1362083632840,1362083632840,2505011092,2505011092,0
1362083660,2505038392,1,46,46,1362083632701,1362083632701,2505011093,2505011093,0
1362083664,1143356200,2,92,46,1362083638461,1362083638461,1143330661,1143330661,0
1362083664,2505042360,1,46,46,1362083635803,1362083635803,2505014163,2505014163,0
1362083664,2505042440,1,46,46,1362083637644,1362083637644,2505016084,2505016084,0
1362083665,2505042716,6,786,131,1362083658339,1362083658595,2505036055,2505036311,256
1362083665,2505042716,5,643,128.6,1362083658466,1362083658594,2505036182,2505036310,128
1362083665,2505042716,3,325,108.3333333,1362083658465,1362083664417,2505036181,2505042133,5952
1362083668,2505046248,1,46,46,1362083639883,1362083639883,2505018131,2505018131,0
1362083668,2505046248,2,92,46,1362083639886,1362083639886,2505018134,2505018134,0
1362083672,2505050320,2,92,46,1362083646790,1362083646790,2505025110,2505025110,0
1362083672,2505050440,1,46,46,1362083646669,1362083646669,2505025109,2505025109,0
1362083681,2505058696,6,455,75.83333333,1362083678326,1362083678518,2505056022,2505056214,192
1362083697,2505074764,3,491,163.6666667,1362083668977,1362083669105,2505046741,2505046869,128
1362083713,2505090936,796,1004302,1261.68593,1362083702659,1362083705283,2505080595,2505083219,2624
1362083721,2505099036,6,786,131,1362083718047,1362083718239,2505096083,2505096275,192
1362083721,2505099040,5,643,128.6,1362083718109,1362083718301,2505096149,2505096341,192
1362083729,2505106864,4,2142,535.5,1362083703947,1362083704075,2505081811,2505081939,128
1362083729,2505106964,3,325,108.3333333,1362083718183,1362083724199,2505096147,2505102163,6016
1362083729,2505107092,3,138,46,1362083728040,1362083728104,2505106132,2505106196,64
1362083733,2505110960,1,96,96,1362083708459,1362083708459,2505086419,2505086419,0
1362083733,2505110960,3,491,163.6666667,1362083708394,1362083708522,2505086354,2505086482,128
1362083737,2505114864,1,56,56,1362083708876,1362083708876,2505086740,2505086740,0
1362083773,2505150912,3,491,163.6666667,1362083748251,1362083748379,2505126163,2505126291,128
1362083785,2505163072,3,325,108.3333333,1362083778106,1362083784058,2505156178,2505162130,5952
1362083785,2505163152,6,786,131,1362083777900,1362083778156,2505156052,2505156308,256
1362083785,2505163152,5,643,128.6,1362083778027,1362083778155,2505156179,2505156307,128
1362083813,2505190956,3,491,163.6666667,1362083788527,1362083788591,2505166483,2505166547,64
1362083817,2505195140,6,461,76.83333333,1362083812854,1362083812982,2505190994,2505191122,128
1362083825,2505203224,2,92,46,1362083819105,1362083819105,2505197329,2505197329,0
1362083833,2505211176,1310,1658414,1265.964885,1362083823570,1362083828050,2505201746,2505206226,4480
1362083837,2505214828,4,656,164,1362083810413,1362083810797,2505188241,2505188625,384
1362083841,2505219228,6,786,131,1362083837854,1362083838046,2505216082,2505216274,192
1362083841,2505219256,5,643,128.6,1362083837890,1362083838082,2505216146,2505216338,192
1362083849,2505226924,3,168,56,1362083824080,1362083828880,2505202004,2505206804,4800
1362083849,2505226928,2,112,56,1362083824394,1362083827210,2505202322,2505205138,2816
1362083849,2505227324,3,325,108.3333333,1362083837822,1362083843838,2505216146,2505222162,6016
1362083853,2505231056,2,112,56,1362083826699,1362083828619,2505204755,2505206675,1920
1362083853,2505231124,3,491,163.6666667,1362083828420,1362083828548,2505206544,2505206672,128
1362083853,2505231132,2,1425,712.5,1362083824830,1362083824958,2505202962,2505203090,128
1362083853,2505231196,2,192,96,1362083826367,1362083828351,2505204563,2505206547,1984
1362083865,2505243460,6,502,83.66666667,1362083860086,1362083863158,2505238546,2505241618,3072
1362083885,2505263332,1,46,46,1362083860212,1362083860212,2505238544,2505238544,0
1362083893,2505271488,3,491,163.6666667,1362083867736,1362083867864,2505246224,2505246352,128
1362083906,2505283964,3,144,48,1362083893157,1362083898277,2505271121,2505276241,5120
1362083906,2505284084,5,643,128.6,1362083898094,1362083898222,2505276178,2505276306,128
1362083906,2505284084,6,786,131,1362083898029,1362083898221,2505276113,2505276305,192
1362083906,2505284084,3,325,108.3333333,1362083898092,1362083904172,2505276176,2505282256,6080
1362083914,2505292244,4,524,131,1362083892813,1362083907981,2505271057,2505286225,15168
1362083922,2505300136,3,144,48,1362083913592,1362083918648,2505291728,2505296784,5056
1362083922,2505300136,3,144,48,1362083913592,1362083919672,2505291728,2505297808,6080
1362083922,2505300136,3,144,48,1362083913592,1362083919608,2505291728,2505297744,6016
1362083922,2505300220,2,98,49,1362083913510,1362083919526,2505291730,2505297746,6016
1362083922,2505300220,2,98,49,1362083913510,1362083919526,2505291730,2505297746,6016
1362083933,2505311384,3,491,163.6666667,1362083907841,1362083907969,2505286225,2505286353,128
1362083937,2505315304,7,1589,227,1362083912658,1362083913106,2505290962,2505291410,448
1362083938,2505315676,6,461,76.83333333,1362083933317,1362083933509,2505310993,2505311185,192
1362083953,2505331548,3,138,46,1362083948701,1362083949789,2505327249,2505328337,1088
1362083953,2505331548,3,138,46,1362083948701,1362083949789,2505327249,2505328337,1088
1362083953,2505331548,3,138,46,1362083948701,1362083949789,2505327249,2505328337,1088
1362083953,2505331548,2,92,46,1362083944988,1362083950556,2505323536,2505329104,5568
1362083953,2505331548,3,138,46,1362083944988,1362083946140,2505323536,2505324688,1152
1362083953,2505331548,3,138,46,1362083944987,1362083946139,2505323535,2505324687,1152
1362083953,2505331548,3,138,46,1362083944987,1362083946075,2505323535,2505324623,1088
1362083953,2505331548,3,138,46,1362083944987,1362083950619,2505323535,2505329167,5632
1362083953,2505331556,3,138,46,1362083949524,1362083950612,2505328080,2505329168,1088
1362083953,2505331556,3,138,46,1362083949523,1362083950611,2505328079,2505329167,1088
1362083953,2505331556,5,415,83,1362083949587,1362083949715,2505328143,2505328271,128
1362083953,2505331556,12,3493,291.0833333,1362083949587,1362083949907,2505328143,2505328463,320
1362083953,2505331560,3,138,46,1362083949519,1362083950671,2505328079,2505329231,1152
1362083953,2505331560,3,138,46,1362083949776,1362083950864,2505328336,2505329424,1088
1362083953,2505331560,3,138,46,1362083949839,1362083950927,2505328399,2505329487,1088
1362083953,2505331560,3,138,46,1362083949839,1362083950927,2505328399,2505329487,1088
1362083953,2505331584,3,138,46,1362083950072,1362083951160,2505328656,2505329744,1088
1362083953,2505331584,3,138,46,1362083950072,1362083951160,2505328656,2505329744,1088
1362083953,2505331584,3,138,46,1362083950072,1362083951160,2505328656,2505329744,1088
1362083953,2505331584,3,138,46,1362083950073,1362083951161,2505328657,2505329745,1088
1362083953,2505331588,3,138,46,1362083946102,1362083947190,2505324690,2505325778,1088
1362083953,2505331588,3,138,46,1362083946102,1362083947254,2505324690,2505325842,1152
1362083953,2505331588,3,138,46,1362083946102,1362083947254,2505324690,2505325842,1152
1362083953,2505331588,3,138,46,1362083946101,1362083947189,2505324689,2505325777,1088
1362083953,2505331592,2,98,49,1362083946609,1362083952497,2505325201,2505331089,5888
1362083953,2505331592,2,98,49,1362083946863,1362083952495,2505325455,2505331087,5632
1362083954,2505331596,3,138,46,1362083951955,1362083953043,2505329551,2505330639,1088
1362083954,2505331596,3,138,46,1362083952214,1362083953302,2505329810,2505330898,1088
1362083954,2505331596,11,2396,217.8181818,1362083948053,1362083953493,2505325649,2505331089,5440
1362083954,2505331596,3,138,46,1362083948244,1362083949332,2505325840,2505326928,1088
1362083954,2505331596,3,138,46,1362083952212,1362083953300,2505329808,2505330896,1088
1362083954,2505331596,3,138,46,1362083952211,1362083953299,2505329807,2505330895,1088
1362083954,2505331624,3,138,46,1362083949048,1362083950136,2505326672,2505327760,1088
1362083954,2505331624,27,28879,1069.592593,1362083933239,1362083947639,2505310863,2505325263,14400
1362083954,2505331628,3,138,46,1362083949366,1362083950454,2505326994,2505328082,1088
1362083954,2505331628,3,138,46,1362083949300,1362083950388,2505326928,2505328016,1088
1362083954,2505331628,3,138,46,1362083949364,1362083950452,2505326992,2505328080,1088
1362083954,2505331636,3,138,46,1362083949550,1362083950638,2505327186,2505328274,1088
1362083954,2505331636,3,138,46,1362083945901,1362083946989,2505323537,2505324625,1088
1362083954,2505331636,3,138,46,1362083945901,1362083946989,2505323537,2505324625,1088
1362083954,2505331636,3,138,46,1362083945901,1362083946989,2505323537,2505324625,1088
1362083954,2505331636,2,98,49,1362083945644,1362083951468,2505323280,2505329104,5824
1362083954,2505331636,2,98,49,1362083945644,1362083951468,2505323280,2505329104,5824
1362083954,2505331636,3,138,46,1362083945900,1362083946988,2505323536,2505324624,1088
1362083954,2505331672,3,138,46,1362083950471,1362083951559,2505328143,2505329231,1088
1362083954,2505331672,3,138,46,1362083947016,1362083948104,2505324688,2505325776,1088
1362083954,2505331672,3,138,46,1362083950728,1362083951816,2505328400,2505329488,1088
1362083954,2505331672,3,138,46,1362083950728,1362083951816,2505328400,2505329488,1088
1362083954,2505331672,3,138,46,1362083950728,1362083951816,2505328400,2505329488,1088
1362083954,2505331672,3,138,46,1362083950727,1362083951879,2505328399,2505329551,1152
1362083954,2505331672,3,138,46,1362083950727,1362083951879,2505328399,2505329551,1152
1362083954,2505331676,3,138,46,1362083947013,1362083948101,2505324689,2505325777,1088
1362083954,2505331676,3,138,46,1362083947013,1362083948165,2505324689,2505325841,1152
1362083954,2505331676,3,138,46,1362083950980,1362083952068,2505328656,2505329744,1088
1362083954,2505331676,3,138,46,1362083950979,1362083952067,2505328655,2505329743,1088
1362083954,2505331684,3,144,48,1362083947515,1362083953467,2505325199,2505331151,5952
1362083954,2505331700,3,138,46,1362083951852,1362083952940,2505329552,2505330640,1088
1362083954,2505331700,3,138,46,1362083948331,1362083949419,2505326031,2505327119,1088
1362083954,2505331700,3,138,46,1362083948139,1362083949227,2505325839,2505326927,1088
1362083954,2505331704,3,138,46,1362083951849,1362083952937,2505329553,2505330641,1088
1362083954,2505331704,3,138,46,1362083951849,1362083952937,2505329553,2505330641,1088
1362083954,2505331704,3,138,46,1362083948329,1362083949481,2505326033,2505327185,1152
1362083954,2505331704,3,138,46,1362083952103,1362083953191,2505329807,2505330895,1088
1362083954,2505331708,3,138,46,1362083952099,1362083953187,2505329807,2505330895,1088
1362083954,2505331708,3,138,46,1362083952099,1362083953187,2505329807,2505330895,1088
1362083954,2505331708,3,138,46,1362083952102,1362083953190,2505329810,2505330898,1088
1362083954,2505331708,3,138,46,1362083952101,1362083953189,2505329809,2505330897,1088
1362083954,2505331708,3,138,46,1362083952101,1362083953189,2505329809,2505330897,1088
1362083954,2505331708,3,138,46,1362083952101,1362083953189,2505329809,2505330897,1088
1362083954,2505331708,3,138,46,1362083948964,1362083950052,2505326672,2505327760,1088
1362083954,2505331708,7,2280,325.7142857,1362083948835,1362083949027,2505326543,2505326735,192
1362083954,2505331712,3,138,46,1362083948959,1362083950047,2505326671,2505327759,1088
1362083954,2505331712,3,138,46,1362083948959,1362083950047,2505326671,2505327759,1088
1362083954,2505331712,3,138,46,1362083949218,1362083950370,2505326930,2505328082,1152
1362083954,2505331712,3,138,46,1362083949218,1362083950306,2505326930,2505328018,1088
1362083954,2505331712,3,138,46,1362083949217,1362083950305,2505326929,2505328017,1088
1362083954,2505331720,2,92,46,1362083953242,1362083953754,2505330962,2505331474,512
1362083956,1143649012,3,144,48,1362083944851,1362083950611,1143637863,1143643623,5760
1362083956,1143649012,3,144,48,1362083949650,1362083955666,1143642662,1143648678,6016
1362083956,1143649032,3,144,48,1362083944829,1362083950589,1143637861,1143643621,5760
1362083957,2505335196,2,92,46,1362083952766,1362083953278,2505330962,2505331474,512
1362083957,2505335196,2,92,46,1362083952766,1362083953278,2505330962,2505331474,512
1362083956,1143649040,3,144,48,1362083947125,1362083952629,1143640165,1143645669,5504
1362083960,1143652396,7,358,51.14285714,1362083933436,1362083958268,1143625832,1143650664,24832
1362083960,1143652396,7,358,51.14285714,1362083933753,1362083959225,1143626149,1143651621,25472
1362083961,2505339268,3,152,50.66666667,1362083933046,1362083942006,2505311314,2505320274,8960
1362083961,2505339268,8,416,52,1362083933045,1362083942325,2505311313,2505320593,9280
1362083961,2505339268,3,152,50.66666667,1362083933045,1362083942069,2505311313,2505320337,9024
1362083961,2505339268,3,152,50.66666667,1362083933045,1362083942005,2505311313,2505320273,8960
1362083961,2505339268,3,152,50.66666667,1362083933045,1362083942005,2505311313,2505320273,8960
1362083961,2505339268,8,416,52,1362083933044,1362083942516,2505311312,2505320784,9472
1362083961,2505339384,8,416,52,1362083932929,1362083942209,2505311313,2505320593,9280
1362083961,2505339384,3,152,50.66666667,1362083932929,1362083941889,2505311313,2505320273,8960
1362083961,2505339384,3,152,50.66666667,1362083932929,1362083941889,2505311313,2505320273,8960
1362083961,2505339384,8,416,52,1362083932929,1362083942273,2505311313,2505320657,9344
1362083961,2505339392,10,877,87.7,1362083933242,1362083942714,2505311634,2505321106,9472
1362083961,2505339580,11,4402,400.1818182,1362083948478,1362083954494,2505327058,2505333074,6016
1362083961,2505339592,3,138,46,1362083953712,1362083954928,2505332304,2505333520,1216
1362083961,2505339592,3,138,46,1362083953712,1362083954928,2505332304,2505333520,1216
1362083961,2505339592,2,98,49,1362083953712,1362083959536,2505332304,2505338128,5824
1362083961,2505339592,3,138,46,1362083953712,1362083954928,2505332304,2505333520,1216
1362083961,2505339592,3,138,46,1362083953712,1362083954928,2505332304,2505333520,1216
1362083962,2505339596,3,138,46,1362083954966,1362083956054,2505332562,2505333650,1088
1362083962,2505339596,3,138,46,1362083954966,1362083956054,2505332562,2505333650,1088
1362083962,2505339596,3,138,46,1362083954965,1362083956053,2505332561,2505333649,1088
1362083962,2505339628,3,138,46,1362083956085,1362083957173,2505333713,2505334801,1088
1362083962,2505339628,112,127267,1136.3125,1362083948021,1362083960629,2505325649,2505338257,12608
1362083962,2505339628,3,138,46,1362083956085,1362083957173,2505333713,2505334801,1088
1362083962,2505339628,3,138,46,1362083956085,1362083957173,2505333713,2505334801,1088
1362083962,2505339628,11,3016,274.1818182,1362083948019,1362083959539,2505325647,2505337167,11520
1362083962,2505339636,2,98,49,1362083948971,1362083954475,2505326607,2505332111,5504
1362083962,2505339636,2,98,49,1362083948971,1362083954475,2505326607,2505332111,5504
1362083962,2505339636,2,98,49,1362083948971,1362083954475,2505326607,2505332111,5504
1362083962,2505339636,2,98,49,1362083948971,1362083954475,2505326607,2505332111,5504
1362083962,2505339636,2,98,49,1362083948843,1362083954475,2505326479,2505332111,5632
1362083962,2505339636,3,144,48,1362083948907,1362083954475,2505326543,2505332111,5568
1362083962,2505339656,3,144,48,1362083948953,1362083954457,2505326609,2505332113,5504
1362083962,2505339660,3,138,46,1362083953300,1362083954388,2505330960,2505332048,1088
1362083962,2505339664,3,144,48,1362083949522,1362083955474,2505327186,2505333138,5952
1362083962,2505339672,5,643,128.6,1362083958537,1362083958665,2505336209,2505336337,128
1362083962,2505339672,6,786,131,1362083958409,1362083958601,2505336081,2505336273,192
1362083962,2505339672,3,144,48,1362083954632,1362083960520,2505332304,2505338192,5888
1362083962,2505339672,2,98,49,1362083954632,1362083960456,2505332304,2505338128,5824
1362083962,2505339672,3,138,46,1362083954632,1362083955848,2505332304,2505333520,1216
1362083962,2505339672,3,138,46,1362083954632,1362083955848,2505332304,2505333520,1216
1362083962,2505339672,3,138,46,1362083954632,1362083955848,2505332304,2505333520,1216
1362083962,2505339700,10,2993,299.3,1362083950574,1362083956398,2505328274,2505334098,5824
1362083962,2505339700,3,138,46,1362083954862,1362083955950,2505332562,2505333650,1088
1362083962,2505339700,3,138,46,1362083954862,1362083955950,2505332562,2505333650,1088
1362083962,2505339700,3,138,46,1362083954861,1362083955949,2505332561,2505333649,1088
1362083962,2505339700,3,138,46,1362083954861,1362083955949,2505332561,2505333649,1088
1362083962,2505339716,3,138,46,1362083955998,1362083957086,2505333714,2505334802,1088
1362083962,2505339716,3,138,46,1362083955998,1362083957086,2505333714,2505334802,1088
1362083962,2505339716,3,138,46,1362083955997,1362083957149,2505333713,2505334865,1152
1362083962,2505339716,3,138,46,1362083955997,1362083957149,2505333713,2505334865,1152
1362083962,2505339740,3,144,48,1362083948869,1362083954373,2505326609,2505332113,5504
1362083962,2505339740,2,98,49,1362083948869,1362083954373,2505326609,2505332113,5504
1362083962,2505339740,3,144,48,1362083948932,1362083954372,2505326672,2505332112,5440
1362083968,1143660440,9,2316,257.3333333,1362083943247,1362083965071,1143635687,1143657511,21824
1362083970,2505347600,5,363,72.6,1362083966033,1362083966161,2505343633,2505343761,128
1362083970,2505347636,3,138,46,1362083964908,1362083965996,2505342544,2505343632,1088
1362083970,2505347640,3,138,46,1362083965353,1362083966505,2505342993,2505344145,1152
1362083970,2505347640,3,138,46,1362083965353,1362083966505,2505342993,2505344145,1152
1362083970,2505347644,3,138,46,1362083965347,1362083966499,2505342991,2505344143,1152
1362083970,2505347644,3,138,46,1362083965347,1362083966563,2505342991,2505344207,1216
1362083970,2505347684,3,325,108.3333333,1362083958524,1362083964476,2505336208,2505342160,5952
1362083970,2505347712,4,317,79.25,1362083966498,1362083966562,2505344210,2505344274,64
1362083970,2505347720,3,138,46,1362083964826,1362083965914,2505342546,2505343634,1088
1362083970,2505347720,3,138,46,1362083964826,1362083965914,2505342546,2505343634,1088
1362083970,2505347720,3,138,46,1362083964823,1362083965911,2505342543,2505343631,1088
1362083970,2505347720,3,138,46,1362083964823,1362083965911,2505342543,2505343631,1088
1362083970,2505347720,3,138,46,1362083964823,1362083965911,2505342543,2505343631,1088
1362083970,2505347720,3,138,46,1362083964823,1362083965911,2505342543,2505343631,1088
1362083970,2505347724,3,138,46,1362083965266,1362083966418,2505342990,2505344142,1152
1362083970,2505347724,3,138,46,1362083965270,1362083966422,2505342994,2505344146,1152
1362083970,2505347748,3,138,46,1362083965245,1362083966461,2505342993,2505344209,1216
1362083972,1143665012,3,144,48,1362083966293,1362083971669,1143659305,1143664681,5376
1362083973,2505351304,6,796,132.6666667,1362083947023,1362083964559,2505325327,2505342863,17536
1362083973,2505351308,27,17456,646.5185185,1362083947339,1362083968011,2505325647,2505346319,20672
1362083973,2505351316,29,28529,983.7586207,1362083947778,1362083967938,2505326094,2505346254,20160
1362083973,2505351320,20,12727,636.35,1362083948161,1362083967681,2505326481,2505346001,19520
1362083973,2505351348,3,491,163.6666667,1362083948261,1362083948453,2505326609,2505326801,192
1362083973,2505351348,47,54745,1164.787234,1362083948325,1362083968037,2505326673,2505346385,19712
1362083973,2505351348,17,4499,264.6470588,1362083948324,1362083967268,2505326672,2505345616,18944
1362083973,2505351468,15,15207,1013.8,1362083948013,1362083949229,2505326481,2505327697,1216
1362083973,2505351468,49,59406,1212.367347,1362083948139,1362083968299,2505326607,2505346767,20160
1362083977,2505355244,16,896,56,1362083949388,1362083972876,2505327632,2505351120,23488
1362083977,2505355248,15,840,56,1362083949513,1362083973833,2505327761,2505352081,24320
1362083977,2505355364,17,952,56,1362083948949,1362083975765,2505327313,2505354129,26816
1362083977,2505355364,16,1536,96,1362083949011,1362083971731,2505327375,2505350095,22720
1362083978,2505355612,6,455,75.83333333,1362083970694,1362083970950,2505348306,2505348562,256
1362083978,2505355612,4,190,47.5,1362083970694,1362083971718,2505348306,2505349330,1024
1362083978,2505355612,10,1001,100.1,1362083970694,1362083970886,2505348306,2505348498,192
1362083978,2505355644,10,2344,234.4,1362083967078,1362083972518,2505344722,2505350162,5440
1362083978,2505355676,3,144,48,1362083965315,1362083970499,2505342991,2505348175,5184
1362083978,2505355680,3,144,48,1362083968254,1362083973438,2505345934,2505351118,5184
1362083978,2505355720,8,501,62.625,1362083970583,1362083976471,2505348303,2505354191,5888
1362083978,2505355760,4,190,47.5,1362083965234,1362083970418,2505342994,2505348178,5184
1362083978,2505355760,2,98,49,1362083967536,1362083973360,2505345296,2505351120,5824
1362083978,2505355764,2,98,49,1362083967918,1362083973358,2505345682,2505351122,5440
1362083978,2505355764,2,98,49,1362083965229,1362083970413,2505342993,2505348177,5184
1362083978,2505355764,2,98,49,1362083968173,1362083973357,2505345937,2505351121,5184
1362083978,2505355768,3,144,48,1362083968617,1362083974377,2505346385,2505352145,5760
1362083978,2505355796,2,98,49,1362083968716,1362083974348,2505346512,2505352144,5632
1362083978,2505355796,8,544,68,1362083968716,1362083974348,2505346512,2505352144,5632
1362083980,1143673040,4,190,47.5,1362083969783,1362083975607,1143662823,1143668647,5824
1362083981,2505359240,1,46,46,1362083953809,1362083953809,2505332049,2505332049,0
1362083981,2505359240,1,46,46,1362083953809,1362083953809,2505332049,2505332049,0
1362083981,2505359356,1,46,46,1362083953692,1362083953692,2505332048,2505332048,0
1362083986,2505363664,125,143070,1144.56,1362083964433,1362083981713,2505342097,2505359377,17280
1362083986,2505363668,8,1986,248.25,1362083968012,1362083978700,2505345680,2505356368,10688
1362083989,2505367328,4,698,174.5,1362083964216,1362083964536,2505342544,2505342864,320
1362083989,2505367328,2,590,295,1362083964279,1362083964599,2505342607,2505342927,320
1362083989,2505367332,16,14695,918.4375,1362083964659,1362083965619,2505342991,2505343951,960
1362083989,2505367444,8,1268,158.5,1362083964100,1362083966724,2505342544,2505345168,2624
1362083989,2505367448,4,565,141.25,1362083964095,1362083964351,2505342543,2505342799,256
1362083993,2505371248,51,40236,788.9411765,1362083965384,1362083969352,2505343632,2505347600,3968
1362083993,2505371248,25,9300,372,1362083965384,1362083969992,2505343632,2505348240,4608
1362083993,2505371248,45,24603,546.7333333,1362083965448,1362083969416,2505343696,2505347664,3968
1362083993,2505371248,29,9417,324.7241379,1362083965383,1362083967303,2505343631,2505345551,1920
1362083993,2505371256,13,1617,124.3846154,1362083965951,1362083969343,2505344207,2505347599,3392
1362083993,2505371256,11,1224,111.2727273,1362083965950,1362083967038,2505344206,2505345294,1088
1362083993,2505371256,16,11368,710.5,1362083965950,1362083969342,2505344206,2505347598,3392
1362083993,2505371272,8,722,90.25,1362083966001,1362083966129,2505344273,2505344401,128
1362083993,2505371328,6,2129,354.8333333,1362083967609,1362083968057,2505345937,2505346385,448
1362083993,2505371328,6,2127,354.5,1362083967609,1362083967865,2505345937,2505346193,256
1362083993,2505371332,5,789,157.8,1362083968051,1362083968243,2505346383,2505346575,192
1362083993,2505371332,6,2737,456.1666667,1362083968050,1362083968242,2505346382,2505346574,192
1362083993,2505371336,38,42680,1123.157895,1362083968303,1362083968623,2505346639,2505346959,320
1362083993,2505371368,32,19733,616.65625,1362083965265,1362083969233,2505343633,2505347601,3968
1362083993,2505371368,22,8493,386.0454545,1362083965329,1362083967249,2505343697,2505345617,1920
1362083993,2505371372,11,1224,111.2727273,1362083965835,1362083966731,2505344207,2505345103,896
1362083993,2505371400,10,1178,117.8,1362083965808,1362083966640,2505344208,2505345040,832
1362083993,2505371400,8,1086,135.75,1362083965808,1362083966640,2505344208,2505345040,832
1362084002,2505379800,6,461,76.83333333,1362084000456,1362084000648,2505378256,2505378448,192
1362084005,2505383380,1,96,96,1362083977922,1362083977922,2505356302,2505356302,0
1362084010,2505387788,1,56,56,1362083981525,1362083981525,2505359313,2505359313,0
1362084014,2505391608,3,491,163.6666667,1362083988999,1362083989063,2505366607,2505366671,64
1362084017,2505395560,3,138,46,1362083990032,1362083990032,2505368592,2505368592,0
1362084026,2505403696,3,138,46,1362084000112,1362084000112,2505377808,2505377808,0
1362084026,2505403820,3,138,46,1362083999923,1362083999987,2505377743,2505377807,64
1362084026,2505403900,6,786,131,1362084018213,1362084018405,2505396113,2505396305,192
1362084026,2505403980,5,643,128.6,1362084018196,1362084018324,2505396176,2505396304,128
1362084026,2505403980,2,279,139.5,1362084018196,1362084024148,2505396176,2505402128,5952
1362084026,2505404020,383,470214,1227.712794,1362084023403,1362084025003,2505401423,2505403023,1600
1362084034,2505411968,3,138,46,1362084029153,1362084029217,2505407121,2505407185,64
1362084034,2505411976,3,144,48,1362084025560,1362084031128,2505403536,2505409104,5568
1362084042,2505419948,18,20083,1115.722222,1362084025522,1362084041202,2505403470,2505419150,15680
1362084042,2505420120,71,85040,1197.746479,1362084023817,1362084041033,2505401937,2505419153,17216
1362084050,2505427768,5,480,96,1362084025447,1362084029287,2505403215,2505407055,3840
1362084050,2505427852,5,280,56,1362084024340,1362084028500,2505402192,2505406352,4160
1362084050,2505427884,5,280,56,1362084025202,1362084028594,2505403086,2505406478,3392
1362084050,2505427888,10,2892,289.2,1362084025136,1362084025712,2505403024,2505403600,576
1362084050,2505427924,3,375,125,1362084025483,1362084025547,2505403407,2505403471,64
1362084050,2505428052,195,248249,1273.071795,1362084011789,1362084042125,2505389841,2505420177,30336
1362084050,2505428060,6,461,76.83333333,1362084045251,1362084045379,2505423311,2505423439,128
1362084053,2505431580,3,138,46,1362084025147,1362084025211,2505403727,2505403791,64
1362084054,2505431660,3,491,163.6666667,1362084028563,1362084028691,2505406223,2505406351,128
1362084054,2505431672,1,77,77,1362084025798,1362084025798,2505403470,2505403470,0
1362084054,2505431696,6,336,56,1362084025967,1362084053295,2505403663,2505430991,27328
1362084054,2505431700,2,446,223,1362084025836,1362084025900,2505403536,2505403600,64
1362084054,2505431708,3,169,56.33333333,1362084026787,1362084026915,2505404495,2505404623,128
1362084066,2505443928,1374,1825350,1328.49345,1362084052102,1362084057734,2505430030,2505435662,5632
1362084066,2505444044,6,461,76.83333333,1362084060243,1362084060371,2505438287,2505438415,128
1362084078,2505455800,5,280,56,1362084052742,1362084060486,2505430542,2505438286,7744
1362084078,2505455804,5,280,56,1362084052996,1362084060548,2505430800,2505438352,7552
1362084078,2505455804,5,2058,411.6,1362084053059,1362084053315,2505430863,2505431119,256
1362084078,2505455804,4,384,96,1362084053059,1362084057667,2505430863,2505435471,4608
1362084081,2505459564,3,168,56,1362084054156,1362084057100,2505432720,2505435664,2944
1362084082,2505459868,6,786,131,1362084078211,1362084078403,2505456079,2505456271,192
1362084082,2505459868,5,643,128.6,1362084078338,1362084078466,2505456206,2505456334,128
1362084082,2505459956,6,461,76.83333333,1362084075307,1362084075499,2505453263,2505453455,192
1362084090,2505467656,2,92,46,1362084065432,1362084065432,2505443088,2505443088,0
1362084090,2505467892,2,279,139.5,1362084078315,1362084084203,2505456207,2505462095,5888
1362084090,2505467900,2,92,46,1362084083169,1362084083233,2505461069,2505461133,64
1362084090,2505467900,2,92,46,1362084083236,1362084083236,2505461136,2505461136,0
1362084090,2505467900,2,92,46,1362084083236,1362084083236,2505461136,2505461136,0
1362084090,2505467928,2,92,46,1362084084165,1362084084165,2505462093,2505462093,0
1362084090,2505467928,2,92,46,1362084084165,1362084084165,2505462093,2505462093,0
1362084090,2505467940,2,92,46,1362084085179,1362084085179,2505463119,2505463119,0
1362084090,2505467940,2,92,46,1362084085179,1362084085179,2505463119,2505463119,0
1362084090,2505467976,3,138,46,1362084086101,1362084086165,2505464077,2505464141,64
1362084090,2505467984,2,92,46,1362084083151,1362084083151,2505461135,2505461135,0
1362084090,2505467984,2,92,46,1362084083151,1362084083151,2505461135,2505461135,0
1362084090,2505467984,2,92,46,1362084083150,1362084083150,2505461134,2505461134,0
1362084090,2505468012,2,92,46,1362084084082,1362084084082,2505462094,2505462094,0
1362084090,2505468012,106,115130,1086.132075,1362083947314,1362084083058,2505325326,2505461070,135744
1362084090,2505468020,3,138,46,1362084085097,1362084085097,2505463117,2505463117,0
1362084090,2505468024,3,138,46,1362084085096,1362084085096,2505463120,2505463120,0
1362084090,2505468024,2,92,46,1362084085096,1362084085096,2505463120,2505463120,0
1362084094,2505471632,3,491,163.6666667,1362084068655,1362084068783,2505446287,2505446415,128
1362084106,2505483664,1,46,46,1362084080399,1362084080399,2505458063,2505458063,0
1362084106,2505483988,6,502,83.66666667,1362084101578,1362084103626,2505479566,2505481614,2048
1362084106,2505484064,6,461,76.83333333,1362084105215,1362084105343,2505483279,2505483407,128
1362084108,1143800668,2,92,46,1362084079980,1362084079980,1143772648,1143772648,0
1362084110,2505487708,2,92,46,1362084083363,1362084083427,2505461071,2505461135,64
1362084110,2505487708,1,46,46,1362084083363,1362084083363,2505461071,2505461071,0
1362084110,2505487740,1,46,46,1362084084355,1362084084355,2505462095,2505462095,0
1362084110,2505487744,2,123,61.5,1362084084734,1362084084734,2505462478,2505462478,0
1362084110,2505487876,2,92,46,1362084084217,1362084084217,2505462093,2505462093,0
1362084110,2505487876,1,46,46,1362084084217,1362084084217,2505462093,2505462093,0
1362084114,2505491596,3,169,56.33333333,1362084085906,1362084086034,2505463502,2505463630,128
1362084130,2505507748,1,46,46,1362084101755,1362084101755,2505479503,2505479503,0
1362084134,2505511836,3,491,163.6666667,1362084108512,1362084108640,2505486348,2505486476,128
1362084142,2505519624,1,46,46,1362084114743,1362084114743,2505492367,2505492367,0
1362084146,2505524080,6,786,131,1362084138030,1362084138222,2505516110,2505516302,192
1362084146,2505524080,4,371,92.75,1362084138092,1362084143276,2505516172,2505521356,5184
1362084146,2505524080,5,643,128.6,1362084138092,1362084138220,2505516172,2505516300,128
1362084146,2505524124,7,412,58.85714286,1362084143362,1362084143362,2505521486,2505521486,0
1362084154,2505532068,6,461,76.83333333,1362084150203,1362084150459,2505528271,2505528527,256
1362084154,2505532224,9,497,55.22222222,1362084144286,1362084148190,2505522510,2505526414,3904
1362084166,2505544172,1,46,46,1362084141136,1362084141136,2505519308,2505519308,0
1362084166,2505544300,2,92,46,1362084141007,1362084141071,2505519307,2505519371,64
1362084166,2505544300,1,46,46,1362084141007,1362084141007,2505519307,2505519307,0
1362084170,2505548372,2,92,46,1362084168011,1362084168011,2505546383,2505546383,0
1362084174,2505552048,3,491,163.6666667,1362084148363,1362084148427,2505526411,2505526475,64
1362084202,2505580344,6,786,131,1362084197733,1362084197925,2505576077,2505576269,192
1362084202,2505580424,5,643,128.6,1362084197782,1362084197910,2505576206,2505576334,128
1362084210,2505588356,3,325,108.3333333,1362084197848,1362084203800,2505576204,2505582156,5952
1362084210,2505588404,9,2761,306.7777778,1362084192615,1362084208807,2505571019,2505587211,16192
1362084210,2505588432,6,409,68.16666667,1362084209229,1362084209485,2505587661,2505587917,256
1362084210,2505588472,4,317,79.25,1362084207139,1362084207139,2505585611,2505585611,0
1362084214,2505592204,3,491,163.6666667,1362084188080,1362084188208,2505566284,2505566412,128
1362084218,2505596408,2,98,49,1362084210022,1362084215910,2505588430,2505594318,5888
1362084218,2505596408,2,98,49,1362084209956,1362084215908,2505588364,2505594316,5952
1362084218,2505596412,3,144,48,1362084210273,1362084215905,2505588685,2505594317,5632
1362084218,2505596412,6,461,76.83333333,1362084210527,1362084210655,2505588939,2505589067,128
1362084218,2505596448,2,98,49,1362084207547,1362084212731,2505585995,2505591179,5184
1362084218,2505596448,2,98,49,1362084207547,1362084212731,2505585995,2505591179,5184
1362084218,2505596452,56,63772,1138.785714,1362084215544,1362084216248,2505593996,2505594700,704
1362084218,2505596456,9,568,63.11111111,1362084208116,1362084213748,2505586572,2505592204,5632
1362084218,2505596460,2,98,49,1362084208753,1362084214769,2505587213,2505593229,6016
1362084218,2505596476,2,98,49,1362084208799,1362084214751,2505587275,2505593227,5952
1362084218,2505596480,2,98,49,1362084209435,1362084214747,2505587915,2505593227,5312
1362084218,2505596484,8,544,68,1362084210071,1362084215831,2505588555,2505594315,5760
1362084218,2505596488,10,1001,100.1,1362084210452,1362084210644,2505588940,2505589132,192
1362084218,2505596488,7,455,65,1362084210516,1362084215828,2505589004,2505594316,5312
1362084218,2505596488,4,190,47.5,1362084210579,1362084211667,2505589067,2505590155,1088
1362084218,2505596536,3,144,48,1362084207462,1362084212710,2505585998,2505591246,5248
1362084218,2505596536,2,98,49,1362084207462,1362084212646,2505585998,2505591182,5184
1362084218,2505596536,45,52354,1163.422222,1362084215461,1362084215717,2505593997,2505594253,256
1362084218,2505596536,93,109325,1175.537634,1362084215461,1362084216357,2505593997,2505594893,896
1362084218,2505596536,43,48655,1131.511628,1362084215525,1362084216229,2505594061,2505594765,704
1362084218,2505596564,4,190,47.5,1362084208649,1362084214665,2505587213,2505593229,6016
1362084218,2505596564,2,98,49,1362084209095,1362084214663,2505587659,2505593227,5568
1362084218,2505596564,2,98,49,1362084209095,1362084214663,2505587659,2505593227,5568
1362084220,1143913016,3,144,48,1362084208081,1362084213777,1143901097,1143906793,5696
1362084220,1143913024,3,144,48,1362084207562,1362084212746,1143900586,1143905770,5184
1362084220,1143913044,2,98,49,1362084210422,1362084215798,1143903466,1143908842,5376
1362084226,2505604400,8,1599,199.875,1362084209514,1362084220330,2505587914,2505598730,10816
1362084226,2505604404,2,98,49,1362084213929,1362084219881,2505592333,2505598285,5952
1362084226,2505604404,3,144,48,1362084213929,1362084219945,2505592333,2505598349,6016
1362084226,2505604416,30,21212,707.0666667,1362084206749,1362084220253,2505585165,2505598669,13504
1362084226,2505604452,3,144,48,1362084215864,1362084221944,2505594316,2505600396,6080
1362084226,2505604480,105,123948,1180.457143,1362084209179,1362084223579,2505587659,2505602059,14400
1362084226,2505604484,8,1599,199.875,1362084209433,1362084220505,2505587917,2505598989,11072
1362084226,2505604488,3,144,48,1362084213844,1362084219796,2505592332,2505598284,5952
1362084226,2505604564,2,98,49,1362084215686,1362084221702,2505594250,2505600266,6016
1362084226,2505604564,3,144,48,1362084215690,1362084221706,2505594254,2505600270,6016
1362084234,2505612092,37,15924,430.3783784,1362084207521,1362084211809,2505585613,2505589901,4288
1362084234,2505612092,5,856,171.2,1362084207520,1362084208544,2505585612,2505586636,1024
1362084234,2505612092,4,676,169,1362084207520,1362084207904,2505585612,2505585996,384
1362084234,2505612092,29,4761,164.1724138,1362084207520,1362084209504,2505585612,2505587596,1984
1362084234,2505612092,29,5062,174.5517241,1362084207520,1362084211872,2505585612,2505589964,4352
1362084234,2505612092,6,592,98.66666667,1362084207520,1362084208800,2505585612,2505586892,1280
1362084234,2505612092,3,631,210.3333333,1362084207520,1362084207840,2505585612,2505585932,320
1362084234,2505612104,11,1056,96,1362084208339,1362084228627,2505586443,2505606731,20288
1362084234,2505612128,16,7053,440.8125,1362084208442,1362084210106,2505586570,2505588234,1664
1362084234,2505612132,11,616,56,1362084208505,1362084229881,2505586637,2505608013,21376
1362084234,2505612136,10,560,56,1362084208754,1362084228402,2505586890,2505606538,19648
1362084234,2505612144,19,18361,966.3684211,1362084209323,1362084209899,2505587467,2505588043,576
1362084234,2505612308,50,34953,699.06,1362084207306,1362084211594,2505585614,2505589902,4288
1362084234,2505612308,39,16105,412.9487179,1362084207306,1362084211658,2505585614,2505589966,4352
1362084234,2505612308,5,2282,456.4,1362084207306,1362084207434,2505585614,2505585742,128
1362084234,2505612308,46,18639,405.1956522,1362084207305,1362084211657,2505585613,2505589965,4352
1362084234,2505612308,4,774,193.5,1362084207305,1362084207561,2505585613,2505585869,256
1362084234,2505612308,4,447,111.75,1362084207304,1362084207496,2505585612,2505585804,192
1362084234,2505612312,9,768,85.33333333,1362084207683,1362084207811,2505585995,2505586123,128
1362084234,2505612316,4,464,116,1362084207682,1362084208834,2505585998,2505587150,1152
1362084234,2505612316,4,345,86.25,1362084207682,1362084208898,2505585998,2505587214,1216
1362084234,2505612320,11,616,56,1362084208188,1362084228604,2505586508,2505606924,20416
1362084234,2505612348,9,2232,248,1362084208865,1362084209633,2505587213,2505587981,768
1362084234,2505612388,6,461,76.83333333,1362084225848,1362084225976,2505604236,2505604364,128
1362084234,2505612516,4,190,47.5,1362084228471,1362084229495,2505606987,2505608011,1024
1362084238,2505616064,25,27617,1104.68,1362084209852,1362084210364,2505587916,2505588428,512
1362084238,2505616068,7,4702,671.7142857,1362084210295,1362084210487,2505588363,2505588555,192
1362084238,2505616076,31,34720,1120,1362084210610,1362084210802,2505588686,2505588878,192
1362084238,2505616076,23,25904,1126.26087,1362084210481,1362084210609,2505588557,2505588685,128
1362084238,2505616184,11,1431,130.0909091,1362084209796,1362084210436,2505587980,2505588620,640
1362084238,2505616192,8,4742,592.75,1362084210174,1362084210302,2505588366,2505588494,128
1362084238,2505616276,7,1408,201.1428571,1362084213224,1362084213736,2505591500,2505592012,512
1362084242,2505620324,8,4765,595.625,1362084215286,1362084215670,2505593610,2505593994,384
1362084242,2505620600,6,461,76.83333333,1362084240421,1362084240741,2505619021,2505619341,320
1362084254,2505632276,3,491,163.6666667,1362084228198,1362084228326,2505606474,2505606602,128
1362084258,2505636488,6,455,75.83333333,1362084254613,1362084254805,2505633101,2505633293,192
1362084258,2505636520,2,98,49,1362084252147,1362084257651,2505630667,2505636171,5504
1362084258,2505636524,8,2252,281.5,1362084252463,1362084257647,2505630987,2505636171,5184
1362084258,2505636528,7,584,83.42857143,1362084239787,1362084250795,2505618315,2505629323,11008
1362084258,2505636568,4,184,46,1362084254531,1362084255619,2505633099,2505634187,1088
1362084258,2505636568,11,3459,314.4545455,1362084254595,1362084254851,2505633163,2505633419,256
1362084258,2505636596,2,98,49,1362084251944,1362084257576,2505630540,2505636172,5632
1362084260,1143953084,3,144,48,1362084252173,1362084257677,1143945257,1143950761,5504
1362084260,1143953096,2,98,49,1362084252482,1362084257602,1143945578,1143950698,5120
1362084260,1143953108,3,144,48,1362084254516,1362084259636,1143947624,1143952744,5120
1362084262,2505640156,3,138,46,1362084234401,1362084234465,2505612557,2505612621,64
1362084262,2505640156,6,336,56,1362084234401,1362084260001,2505612557,2505638157,25600
1362084266,2505644504,5,643,128.6,1362084257670,1362084257798,2505636174,2505636302,128
1362084266,2505644504,5,740,148,1362084257604,1362084257796,2505636108,2505636300,192
1362084266,2505644508,10,4356,435.6,1362084253823,1362084259711,2505632331,2505638219,5888
1362084266,2505644512,2,98,49,1362084254203,1362084259643,2505632715,2505638155,5440
1362084266,2505644516,8,2913,364.125,1362084254646,1362084260726,2505633162,2505639242,6080
1362084266,2505644588,3,144,48,1362084253553,1362084258609,2505632141,2505637197,5056
1362084266,2505644588,3,325,108.3333333,1362084257584,1362084263600,2505636172,2505642188,6016
1362084266,2505644592,2,98,49,1362084253868,1362084259564,2505632460,2505638156,5696
1362084266,2505644596,2,98,49,1362084254120,1362084259560,2505632716,2505638156,5440
1362084270,2505648172,2,92,46,1362084242768,1362084242832,2505620940,2505621004,64
1362084270,2505648312,3,138,46,1362084242629,1362084242693,2505620941,2505621005,64
1362084274,2505652500,8,1599,199.875,1362084253961,1362084265737,2505632461,2505644237,11776
1362084275,2505652612,29,21608,745.1034483,1362084252542,1362084266750,2505630154,2505644362,14208
1362084275,2505652656,5,1140,228,1362084253973,1362084266709,2505631629,2505644365,12736
1362084275,2505652660,99,123680,1249.292929,1362084254158,1362084266702,2505631818,2505644362,12544
1362084278,2505656128,11,10663,969.3636364,1362084253818,1362084254330,2505631946,2505632458,512
1362084278,2505656252,7,2133,304.7142857,1362084253761,1362084254273,2505632013,2505632525,512
1362084278,2505656324,17,16450,967.6470588,1362084252215,1362084252791,2505630539,2505631115,576
1362084278,2505656332,30,33324,1110.8,1362084252720,1362084255856,2505631052,2505634188,3136
1362084278,2505656332,18,16349,908.2777778,1362084252720,1362084255600,2505631052,2505633932,2880
1362084278,2505656336,8,768,96,1362084252973,1362084268781,2505631309,2505647117,15808
1362084278,2505656336,8,448,56,1362084253163,1362084272683,2505631499,2505651019,19520
1362084278,2505656336,8,448,56,1362084253163,1362084268843,2505631499,2505647179,15680
1362084278,2505656444,8,9071,1133.875,1362084253246,1362084253950,2505631690,2505632394,704
1362084278,2505656448,5,949,189.8,1362084253372,1362084253628,2505631820,2505632076,256
1362084280,1143972888,6,1936,322.6666667,1362084252239,1362084252751,1143945127,1143945639,512
1362084282,2505660140,12,12181,1015.083333,1362084253871,1362084255791,2505632011,2505633931,1920
1362084282,2505660152,30,37923,1264.1,1362084254437,1362084254501,2505632589,2505632653,64
1362084282,2505660156,6,4644,774,1362084254817,1362084254817,2505632973,2505632973,0
1362084282,2505660156,21,25806,1228.857143,1362084254944,1362084255008,2505633100,2505633164,64
1362084282,2505660340,22,27128,1233.090909,1362084253926,1362084253990,2505632266,2505632330,64
1362084282,2505660380,10,11255,1125.5,1362084255489,1362084255489,2505633869,2505633869,0
1362084283,2505660604,1694,2123572,1253.584416,1362084269512,1362084275336,2505647116,2505652940,5824
1362084290,2505668592,6,455,75.83333333,1362084284460,1362084284588,2505663052,2505663180,128
1362084294,2505672168,2,112,56,1362084266194,1362084268306,2505644362,2505646474,2112
1362084294,2505672308,2,123,61.5,1362084266057,1362084266057,2505644365,2505644365,0
1362084294,2505672360,3,491,163.6666667,1362084267861,1362084267989,2505646221,2505646349,128
1362084298,2505676356,3,138,46,1362084270041,1362084270105,2505648397,2505648461,64
1362084298,2505676356,3,2695,898.3333333,1362084270040,1362084270040,2505648396,2505648396,0
1362084318,2505696216,3,604,201.3333333,1362084290596,1362084290852,2505668812,2505669068,256
1362084323,2505700852,6,786,131,1362084318224,1362084318416,2505696076,2505696268,192
1362084323,2505700852,5,643,128.6,1362084318351,1362084318543,2505696203,2505696395,192
1362084323,2505700952,6,455,75.83333333,1362084315114,1362084315242,2505693066,2505693194,128
1362084331,2505708804,2,279,139.5,1362084318398,1362084324286,2505696202,2505702090,5888
1362084331,2505708844,2,92,46,1362084325269,1362084325269,2505703113,2505703113,0
1362084331,2505708892,3,138,46,1362084327205,1362084327269,2505705097,2505705161,64
1362084331,2505708980,6,461,76.83333333,1362084330128,1362084330256,2505708108,2505708236,128
1362084334,2505712552,3,491,163.6666667,1362084307666,1362084307794,2505686218,2505686346,128
1362084338,2505716572,3,169,56.33333333,1362084311805,1362084311869,2505690377,2505690441,64
1362084342,2505720560,3,138,46,1362084313866,1362084313866,2505692426,2505692426,0
1362084347,2505724784,6,499,83.16666667,1362084342740,1362084344852,2505720524,2505722636,2112
1362084347,2505724864,6,461,76.83333333,1362084345539,1362084345667,2505723403,2505723531,128
1362084350,2505728476,2,92,46,1362084322653,1362084322653,2505701129,2505701129,0
1362084350,2505728588,1,46,46,1362084325487,1362084325487,2505704075,2505704075,0
1362084351,2505728624,1,46,46,1362084323507,1362084323507,2505701131,2505701131,0
1362084351,2505728636,2,92,46,1362084324454,1362084324518,2505702090,2505702154,64
1362084351,2505728696,2,92,46,1362084325418,1362084325418,2505703114,2505703114,0
1362084351,2505728696,2,92,46,1362084325418,1362084325418,2505703114,2505703114,0
1362084351,2505728700,2,123,61.5,1362084325672,1362084325736,2505703372,2505703436,64
1362084351,2505728728,2,92,46,1362084326348,1362084326412,2505704076,2505704140,64
1362084355,2505732932,4,184,46,1362084348158,1362084349246,2505726090,2505727178,1088
1362084363,2505740824,6,461,76.83333333,1362084360232,1362084360424,2505738056,2505738248,192
1362084370,2505748544,1,46,46,1362084341978,1362084341978,2505720522,2505720522,0
1362084375,2505752628,3,491,163.6666667,1362084348590,1362084348654,2505726218,2505726282,64
1362084379,2505756836,2,92,46,1362084371295,1362084371295,2505749131,2505749131,0
1362084379,2505756836,2,92,46,1362084371295,1362084371295,2505749131,2505749131,0
1362084379,2505756840,6,461,76.83333333,1362084375258,1362084375386,2505753098,2505753226,128
1362084379,2505756840,4,190,47.5,1362084375257,1362084376345,2505753097,2505754185,1088
1362084379,2505756916,10,1065,106.5,1362084378190,1362084378702,2505756106,2505756618,512
1362084379,2505756924,3,138,46,1362084371207,1362084371207,2505749131,2505749131,0
1362084379,2505756952,3,138,46,1362084372200,1362084372200,2505750152,2505750152,0
1362084379,2505757000,15,8277,551.8,1362084376827,1362084377083,2505754827,2505755083,256
1362084379,2505757000,4,1345,336.25,1362084377146,1362084378042,2505755146,2505756042,896
1362084381,1144073248,16,3144,196.5,1362084376723,1362084378195,1144068971,1144070443,1472
1362084387,2505764836,3,144,48,1362084378973,1362084384477,2505756809,2505762313,5504
1362084387,2505764836,6,2803,467.1666667,1362084382877,1362084382941,2505760713,2505760777,64
1362084387,2505764844,3,144,48,1362084379412,1362084385492,2505757256,2505763336,6080
1362084387,2505764848,7,412,58.85714286,1362084383761,1362084383889,2505761609,2505761737,128
1362084387,2505764884,2,98,49,1362084376557,1362084382381,2505754441,2505760265,5824
1362084387,2505764888,2,98,49,1362084376552,1362084382376,2505754440,2505760264,5824
1362084387,2505764912,14,6456,461.1428571,1362084376913,1362084382993,2505754825,2505760905,6080
1362084387,2505764916,4,190,47.5,1362084377167,1362084382415,2505755083,2505760331,5248
1362084387,2505764916,2,92,46,1362084377231,1362084382415,2505755147,2505760331,5184
1362084387,2505764916,6,1816,302.6666667,1362084377230,1362084383502,2505755146,2505761418,6272
1362084387,2505764916,3,144,48,1362084377869,1362084383437,2505755785,2505761353,5568
1362084387,2505764916,2,94,47,1362084377805,1362084383501,2505755721,2505761417,5696
1362084387,2505764916,2,98,49,1362084377805,1362084383437,2505755721,2505761353,5632
1362084387,2505764916,2,94,47,1362084378188,1362084383436,2505756104,2505761352,5248
1362084387,2505764924,2,98,49,1362084378696,1362084384328,2505756620,2505762252,5632
1362084387,2505764924,3,144,48,1362084378887,1362084384391,2505756811,2505762315,5504
1362084387,2505764924,3,138,46,1362084379077,1362084384389,2505757001,2505762313,5312
1362084387,2505764928,5,658,131.6,1362084379267,1362084379523,2505757195,2505757451,256
1362084387,2505764956,4,317,79.25,1362084383781,1362084383781,2505761737,2505761737,0
1362084387,2505764992,2,98,49,1362084376452,1362084382276,2505754444,2505760268,5824
1362084387,2505764992,3,144,48,1362084376452,1362084382340,2505754444,2505760332,5888
1362084387,2505764992,3,144,48,1362084376514,1362084382338,2505754506,2505760330,5824
1362084387,2505765000,2,279,139.5,1362084377083,1362084382331,2505755083,2505760331,5248
1362084387,2505765000,3,142,47.33333333,1362084377147,1362084382331,2505755147,2505760331,5184
1362084387,2505765000,6,1800,300,1362084377147,1362084385019,2505755147,2505763019,7872
1362084387,2505765000,3,144,48,1362084377211,1362084383419,2505755211,2505761419,6208
1362084387,2505765000,3,144,48,1362084377211,1362084383419,2505755211,2505761419,6208
1362084387,2505765000,2,98,49,1362084377721,1362084383353,2505755721,2505761353,5632
1362084387,2505765004,3,144,48,1362084378103,1362084383351,2505756107,2505761355,5248
1362084389,1144081160,4,190,47.5,1362084378218,1362084383786,1144070378,1144075946,5568
1362084389,1144081168,3,144,48,1362084376803,1362084382691,1144068971,1144074859,5888
1362084389,1144081172,3,144,48,1362084378144,1362084383712,1144070316,1144075884,5568
1362084393,1144085260,2,92,46,1362084368391,1362084368391,1144060651,1144060651,0
1362084394,2505772552,1,46,46,1362084367569,1362084367569,2505746121,2505746121,0
1362084395,2505772608,2,92,46,1362084370497,1362084370497,2505748105,2505748105,0
1362084395,2505772608,1,46,46,1362084370496,1362084370496,2505748104,2505748104,0
1362084395,2505772800,1,46,46,1362084370305,1362084370305,2505748105,2505748105,0
1362084395,2505772800,1,46,46,1362084370305,1362084370305,2505748105,2505748105,0
1362084395,2505772800,1,46,46,1362084370305,1362084370305,2505748105,2505748105,0
1362084395,2505772868,3,144,48,1362084383294,1362084388414,2505761162,2505766282,5120
1362084395,2505772904,5,464,92.8,1362084376281,1362084392409,2505754185,2505770313,16128
1362084395,2505772912,6,461,76.83333333,1362084390163,1362084390291,2505768075,2505768203,128
1362084395,2505772944,5,534,106.8,1362084378161,1362084389233,2505756105,2505767177,11072
1362084395,2505772956,2,98,49,1362084383205,1362084388325,2505761161,2505766281,5120
1362084395,2505773028,29,17533,604.5862069,1362084374112,1362084392288,2505752140,2505770316,18176
1362084395,2505773028,7,1778,254,1362084374112,1362084392288,2505752140,2505770316,18176
1362084398,2505776552,3,169,56.33333333,1362084370835,1362084370899,2505749387,2505749451,64
1362084399,2505776672,2,92,46,1362084371459,1362084371459,2505749131,2505749131,0
1362084401,1144093212,14,4994,356.7142857,1362084376759,1362084378487,1144068971,1144070699,1728
1362084401,1144093252,4,1287,321.75,1362084376396,1362084376524,1144068648,1144068776,128
1362084403,2505780596,7,1762,251.7142857,1362084377231,1362084377487,2505754827,2505755083,256
1362084403,2505780600,14,9339,667.0714286,1362084377547,1362084378059,2505755147,2505755659,512
1362084403,2505780608,12,1152,96,1362084378113,1362084401217,2505755721,2505778825,23104
1362084403,2505780608,37,41750,1128.378378,1362084378112,1362084379072,2505755720,2505756680,960
1362084403,2505780652,5,528,105.6,1362084375316,1362084396180,2505752968,2505773832,20864
1362084403,2505780752,13,4289,329.9230769,1362084375987,1362084379443,2505753739,2505757195,3456
1362084403,2505780784,10,4146,414.6,1362084376658,1362084379026,2505754442,2505756810,2368
1362084403,2505780792,5,2126,425.2,1362084377032,1362084377160,2505754824,2505754952,128
1362084403,2505780820,12,672,56,1362084377647,1362084400943,2505755467,2505778763,23296
1362084403,2505780824,10,5568,556.8,1362084377899,1362084378923,2505755723,2505756747,1024
1362084403,2505780880,9,3235,359.4444444,1362084396464,1362084396784,2505774344,2505774664,320
1362084403,2505780912,12,3373,281.0833333,1362084397777,1362084398097,2505775689,2505776009,320
1362084403,2505780952,12,4557,379.75,1362084394795,1362084394923,2505772747,2505772875,128
1362084403,2505780952,11,2788,253.4545455,1362084394984,1362084395496,2505772936,2505773448,512
1362084405,1144097228,4,539,134.75,1362084378086,1362084378278,1144070314,1144070506,192
1362084405,1144097276,4,539,134.75,1362084378036,1362084378164,1144070312,1144070440,128
1362084406,2505784564,13,728,56,1362084378052,1362084405700,2505756616,2505784264,27648
1362084406,2505784568,13,728,56,1362084378113,1362084405569,2505756681,2505784137,27456
1362084406,2505784572,6,1146,191,1362084378238,1362084379070,2505756810,2505757642,832
1362084406,2505784572,7,3955,565,1362084378238,1362084378430,2505756810,2505757002,192
1362084406,2505784572,5,2046,409.2,1362084378428,1362084378940,2505757000,2505757512,512
1362084407,2505784728,34,40927,1203.735294,1362084379529,1362084379721,2505757257,2505757449,192
1362084410,2505788564,10,3287,328.7,1362084382596,1362084383236,2505761160,2505761800,640
1362084410,2505788588,9,1177,130.7777778,1362084383149,1362084383277,2505761737,2505761865,128
1362084410,2505788592,33,26992,817.9393939,1362084383401,1362084395881,2505761993,2505774473,12480
1362084410,2505788592,11,3289,299,1362084383401,1362084394217,2505761993,2505772809,10816
1362084411,2505788596,17,4020,236.4705882,1362084384591,1362084405711,2505762187,2505783307,21120
1362084411,2505788688,83,49769,599.626506,1362084383025,1362084398129,2505760713,2505775817,15104
1362084411,2505788716,31,19590,631.9354839,1362084383445,1362084396949,2505761161,2505774665,13504
1362084411,2505788800,34,30195,888.0882353,1362084384192,1362084396544,2505761992,2505774344,12352
1362084411,2505788964,7,2604,372,1362084405278,1362084405406,2505783242,2505783370,128
1362084411,2505788996,2,92,46,1362084406524,1362084406524,2505784520,2505784520,0
1362084411,2505789048,11,2788,253.4545455,1362084405194,1362084405578,2505783242,2505783626,384
1362084415,2505792600,3,491,163.6666667,1362084388683,1362084388811,2505766283,2505766411,128
1362084419,2505796936,3,138,46,1362084417145,1362084417209,2505795081,2505795145,64
1362084427,2505805120,6,461,76.83333333,1362084419969,1362084420161,2505798089,2505798281,192
1362084431,2505808744,12,1152,96,1362084406329,1362084421433,2505784073,2505799177,15104
1362084431,2505808868,12,672,56,1362084406078,1362084420350,2505783946,2505798218,14272
1362084435,2505812652,10,560,56,1362084407189,1362084420437,2505784841,2505798089,13248
1362084435,2505812852,11,616,56,1362084406863,1362084421647,2505784715,2505799499,14784
1362084435,2505813140,9,497,55.22222222,1362084429485,1362084434029,2505807625,2505812169,4544
1362084439,2505816700,24,19209,800.375,1362084412070,1362084412902,2505789770,2505790602,832
1362084439,2505816832,19,16685,878.1578947,1362084414562,1362084421410,2505792394,2505799242,6848
1362084443,2505820656,26,27946,1074.846154,1362084415763,1362084421587,2505793419,2505799243,5824
1362084443,2505821020,1477,1851071,1253.264049,1362084396454,1362084435622,2505774474,2505813642,39168
1362084455,2505832716,3,491,163.6666667,1362084428950,1362084429078,2505806666,2505806794,128
1362084463,2505840732,3,138,46,1362084436934,1362084436998,2505814666,2505814730,64
1362084467,2505845092,6,461,76.83333333,1362084465054,1362084465182,2505843146,2505843274,128
1362084471,2505848652,2,123,61.5,1362084442901,1362084442901,2505820553,2505820553,0
1362084471,2505848772,2,123,61.5,1362084442779,1362084442843,2505820551,2505820615,64
1362084479,2505856972,2,123,61.5,1362084453588,1362084453652,2505831560,2505831624,64
1362084483,2505860956,2,123,61.5,1362084455586,1362084455650,2505833542,2505833606,64
1362084491,2505868900,2,123,61.5,1362084463710,1362084463710,2505841610,2505841610,0
1362084495,2505873068,3,491,163.6666667,1362084468148,1362084468212,2505846216,2505846280,64
1362084499,2505877132,58,51943,895.5689655,1362084471474,1362084498546,2505849606,2505876678,27072
1362084499,2505877268,3,138,46,1362084491882,1362084491946,2505870150,2505870214,64
1362084499,2505877300,2,92,46,1362084493837,1362084493837,2505872137,2505872137,0
1362084500,1144193092,3,138,46,1362084492616,1362084492744,1144185708,1144185836,128
1362084507,2505884940,13,7381,567.7692308,1362084479669,1362084498741,2505857609,2505876681,19072
1362084507,2505885160,11,7374,670.3636364,1362084479447,1362084498583,2505857607,2505876743,19136
1362084507,2505885308,4,317,79.25,1362084502917,1362084502981,2505881225,2505881289,64
1362084507,2505885352,2,98,49,1362084492953,1362084498777,2505871305,2505877129,5824
1362084507,2505885352,2,98,49,1362084493080,1362084498776,2505871432,2505877128,5696
1362084507,2505885440,3,144,48,1362084492865,1362084498753,2505871305,2505877193,5888
1362084515,2505893416,5,575,115,1362084492759,1362084508887,2505871175,2505887303,16128
1362084517,1144209256,2,92,46,1362084492425,1362084492425,1144184681,1144184681,0
1362084519,2505896900,91,51116,561.7142857,1362084491034,1362084503514,2505868934,2505881414,12480
1362084519,2505896952,43,40144,933.5813953,1362084493033,1362084499241,2505870985,2505877193,6208
1362084519,2505896992,28,1568,56,1362084493886,1362084518782,2505871878,2505896774,24896
1362084519,2505896992,27,2592,96,1362084494016,1362084518272,2505872008,2505896264,24256
1362084519,2505896996,1,46,46,1362084494142,1362084494142,2505872138,2505872138,0
1362084519,2505896996,27,1512,56,1362084494205,1362084518397,2505872201,2505896393,24192
1362084519,2505897108,18,19911,1106.166667,1362084493196,1362084493388,2505871304,2505871496,192
1362084519,2505897112,28,1568,56,1362084493447,1362084518343,2505871559,2505896455,24896
1362084519,2505897140,2,92,46,1362084493995,1362084493995,2505872135,2505872135,0
1362084519,2505897140,1,46,46,1362084493995,1362084493995,2505872135,2505872135,0
1362084521,1144213244,2,92,46,1362084493464,1362084493464,1144185708,1144185708,0
1362084521,1144213300,2,92,46,1362084494367,1362084494367,1144186667,1144186667,0
1362084523,2505900924,2,92,46,1362084495236,1362084495364,2505873160,2505873288,128
1362084523,2505900924,2,92,46,1362084495236,1362084495364,2505873160,2505873288,128
1362084523,2505900924,1,46,46,1362084495235,1362084495235,2505873159,2505873159,0
1362084523,2505901120,47,22134,470.9361702,1362084498561,1362084510273,2505876681,2505888393,11712
1362084523,2505901124,1,46,46,1362084495034,1362084495034,2505873158,2505873158,0
1362084523,2505901236,65,58447,899.1846154,1362084498445,1362084501005,2505876681,2505879241,2560
1362084523,2505901360,2,98,49,1362084514642,1362084520658,2505893002,2505899018,6016
1362084527,2505905012,23,7046,306.3478261,1362084501868,1362084502188,2505879880,2505880200,320
1362084527,2505905096,11,3235,294.0909091,1362084501079,1362084501207,2505879175,2505879303,128
1362084527,2505905100,2,123,61.5,1362084501395,1362084501459,2505879495,2505879559,64
1362084527,2505905104,60,25429,423.8166667,1362084501775,1362084511951,2505879879,2505890055,10176
1362084531,2505908940,24,21816,909,1362084503348,1362084503412,2505881288,2505881352,64
1362084535,2505912988,3,491,163.6666667,1362084508421,1362084508549,2505886409,2505886537,128
1362084539,2505917132,2,123,61.5,1362084512370,1362084512370,2505890502,2505890502,0
1362084539,2505917364,8,1356,169.5,1362084513739,1362084514315,2505892103,2505892679,576
1362084543,2505921020,7,672,96,1362084518818,1362084524194,2505896838,2505902214,5376
1362084547,2505925044,7,392,56,1362084519245,1362084532109,2505897289,2505910153,12864
1362084547,2505925044,7,392,56,1362084519371,1362084532619,2505897415,2505910663,13248
1362084547,2505925236,2,123,61.5,1362084522253,1362084522317,2505900489,2505900553,64
1362084547,2505925244,7,392,56,1362084518788,1362084531780,2505897032,2505910024,12992
1362084547,2505925412,6,461,76.83333333,1362084539738,1362084539866,2505918150,2505918278,128
1362084555,2505933392,1443,1846271,1279.467082,1362084514609,1362084553521,2505893001,2505931913,38912
1362084555,2505933480,1463,1842160,1259.166097,1362084510487,1362084546775,2505888967,2505925255,36288
1362084555,2505933512,3,144,48,1362084547319,1362084553079,2505925831,2505931591,5760
1362084559,2505937176,60,34500,575,1362084531785,1362084557385,2505909961,2505935561,25600
1362084563,2505941560,7,412,58.85714286,1362084559944,1362084559944,2505938504,2505938504,0
1362084571,2505949200,21,15081,718.1428571,1362084545264,1362084547696,2505923464,2505925896,2432
1362084571,2505949212,5,5093,1018.6,1362084546468,1362084546468,2505924680,2505924680,0
1362084571,2505949236,12,6544,545.3333333,1362084546570,1362084557322,2505924806,2505935558,10752
1362084571,2505949364,12,10337,861.4166667,1362084546315,1362084546315,2505924679,2505924679,0
1362084575,2505953072,5,376,75.2,1362084546928,1362084547248,2505925000,2505925320,320
1362084575,2505953072,2,168,84,1362084547246,1362084547246,2505925318,2505925318,0
1362084575,2505953080,10,5004,500.4,1362084547751,1362084547751,2505925831,2505925831,0
1362084575,2505953116,2,445,222.5,1362084548354,1362084548482,2505926470,2505926598,128
1362084575,2505953132,10,960,96,1362084549365,1362084567413,2505927497,2505945545,18048
1362084575,2505953196,7,3622,517.4285714,1362084547634,1362084547634,2505925830,2505925830,0
1362084575,2505953200,6,2173,362.1666667,1362084547759,1362084547823,2505925959,2505926023,64
1362084575,2505953240,10,560,56,1362084549318,1362084567622,2505927558,2505945862,18304
1362084575,2505953244,10,560,56,1362084549381,1362084571205,2505927625,2505949449,21824
1362084575,2505953244,9,504,56,1362084549635,1362084564483,2505927879,2505942727,14848
1362084579,2505957436,7,412,58.85714286,1362084571013,1362084571077,2505949449,2505949513,64
1362084583,2505961156,2,123,61.5,1362084557340,1362084557340,2505935496,2505935496,0
1362084587,2505965440,1468,1842385,1255.030654,1362084546111,1362084582527,2505924551,2505960967,36416
1362084591,2505969220,11,847,77,1362084564186,1362084577370,2505942406,2505955590,13184
1362084595,2505973588,5,452,90.4,1362084582953,1362084587049,2505961541,2505965637,4096
1362084611,2505989292,9,504,56,1362084584402,1362084587090,2505962694,2505965382,2688
1362084611,2505989372,1,46,46,1362084583172,1362084583172,2505961544,2505961544,0
1362084611,2505989404,10,560,56,1362084584161,1362084589153,2505962565,2505967557,4992
1362084611,2505989404,10,960,96,1362084584161,1362084589217,2505962565,2505967621,5056
1362084611,2505989408,10,560,56,1362084584350,1362084589534,2505962758,2505967942,5184
1362084615,2505993408,3,491,163.6666667,1362084587934,1362084588062,2505966342,2505966470,128
1362084620,2505997648,2983,3690098,1237.042575,1362084550742,1362084619606,2505928390,2505997254,68864
1362084631,2506009228,26,6733,258.9615385,1362084605268,1362084619860,2505983496,2505998088,14592
1362084631,2506009228,7,5308,758.2857143,1362084605268,1362084618132,2505983496,2505996360,12864
1362084631,2506009272,1,77,77,1362084606183,1362084606183,2505984455,2505984455,0
1362084631,2506009276,26,19850,763.4615385,1362084606180,1362084619428,2505984456,2505997704,13248
1362084631,2506009356,2,123,61.5,1362084605137,1362084605137,2505983493,2505983493,0
1362084631,2506009356,3,246,82,1362084605137,1362084618001,2505983493,2505996357,12864
1362084631,2506009392,7,3896,556.5714286,1362084606062,1362084619886,2505984454,2505998278,13824
1362084631,2506009392,28,21517,768.4642857,1362084606062,1362084617518,2505984454,2505995910,11456
1362084635,2506013564,2,92,46,1362084608067,1362084608067,2505986631,2505986631,0
1362084636,2506013836,3,138,46,1362084630489,1362084630553,2506008325,2506008389,64
1362084643,2506021424,9,504,56,1362084618575,1362084628687,2505996999,2506007111,10112
1362084643,2506021440,84,67658,805.452381,1362084615420,1362084641788,2505993860,2506020228,26368
1362084643,2506021464,31,16786,541.483871,1362084615974,1362084628198,2505994438,2506006662,12224
1362084643,2506021520,10,560,56,1362084618352,1362084629808,2505996872,2506008328,11456
1362084643,2506021580,3,708,236,1362084615923,1362084619571,2505994503,2505998151,3648
1362084644,2506021620,10,560,56,1362084618416,1362084629744,2505996036,2506007364,11328
1362084644,2506021632,9,864,96,1362084619239,1362084629287,2505996871,2506006919,10048
1362084655,2506033480,3,491,163.6666667,1362084628631,1362084628759,2506007111,2506007239,128
1362084660,2506037688,1433,1843534,1286.485694,1362084617580,1362084652716,2505995268,2506030404,35136
1362084660,2506037760,1416,1845029,1302.986582,1362084621541,1362084658405,2505999301,2506036165,36864
1362084667,2506045468,38,14511,381.8684211,1362084642017,1362084665697,2506020485,2506044165,23680
1362084668,2506045712,10,2033,203.3,1362084665495,1362084665943,2506043207,2506043655,448
1362084671,2506049356,16,1280,80,1362084643665,1362084665681,2506022021,2506044037,22016
1362084671,2506049360,7,546,78,1362084644045,1362084665677,2506022405,2506044037,21632
1362084671,2506049392,8,2004,250.5,1362084644781,1362084645293,2506023173,2506023685,512
1362084671,2506049400,23,2208,96,1362084645478,1362084670374,2506023878,2506048774,24896
1362084671,2506049424,23,1288,56,1362084645581,1362084670477,2506024005,2506048901,24896
1362084671,2506049428,22,1232,56,1362084645834,1362084670218,2506024262,2506048646,24384
1362084671,2506049464,8,6591,823.875,1362084643109,1362084664933,2506021573,2506043397,21824
1362084671,2506049468,60,31795,529.9166667,1362084643298,1362084666914,2506021766,2506045382,23616
1362084671,2506049540,22,1232,56,1362084645593,1362084669913,2506024133,2506048453,24320
1362084676,2506053808,6,1310,218.3333333,1362084668854,1362084669110,2506046662,2506046918,256
1362084679,2506057564,8,1184,148,1362084653057,1362084666817,2506031621,2506045381,13760
1362084684,2506061680,6,461,76.83333333,1362084677430,1362084677558,2506055110,2506055238,128
1362084691,2506069580,5,2561,512.2,1362084663729,1362084664817,2506042309,2506043397,1088
1362084692,2506069764,1419,1840136,1296.78365,1362084651362,1362084686434,2506029126,2506064198,35072
1362084695,2506073352,9,7291,810.1111111,1362084667350,1362084667670,2506045702,2506046022,320
1362084695,2506073356,19,20438,1075.684211,1362084667665,1362084668497,2506046021,2506046853,832
1362084695,2506073504,17,17755,1044.411765,1362084667838,1362084668158,2506046342,2506046662,320
1362084695,2506073552,3,491,163.6666667,1362084669134,1362084669262,2506047686,2506047814,128
1362084699,2506077336,5,280,56,1362084671783,1362084678823,2506050119,2506057159,7040
1362084699,2506077436,6,336,56,1362084670977,1362084679041,2506049413,2506057477,8064
1362084699,2506077436,6,336,56,1362084671040,1362084679104,2506049476,2506057540,8064
1362084699,2506077440,5,480,96,1362084671102,1362084676734,2506049542,2506055174,5632
1362084700,2506077712,1428,1840061,1288.558123,1362084654419,1362084692179,2506032131,2506069891,37760
1362084703,2506081396,3,275,91.66666667,1362084676074,1362084676074,2506054470,2506054470,0
1362084708,2506085648,2,123,61.5,1362084679637,1362084679637,2506057285,2506057285,0
1362084708,2506085828,7,1356,193.7142857,1362084700831,1362084700959,2506078659,2506078787,128
1362084708,2506085984,1421,1839678,1294.636172,1362084665798,1362084700102,2506043782,2506078086,34304
1362084715,2506093336,1330,1623669,1220.803759,1362084396324,1362084411684,2505774660,2505790020,15360
1362084727,2506105408,5,280,56,1362084701084,1362084705884,2506079492,2506084292,4800
1362084727,2506105412,5,280,56,1362084701400,1362084709720,2506079812,2506088132,8320
1362084727,2506105520,5,480,96,1362084700843,1362084705515,2506079363,2506084035,4672
1362084727,2506105524,5,280,56,1362084701224,1362084709352,2506079748,2506087876,8128
1362084731,2506109396,2,123,61.5,1362084703849,1362084703913,2506082245,2506082309,64
1362084735,2506113460,3,491,163.6666667,1362084709415,1362084709543,2506087875,2506088003,128
1362084740,2506117876,2837,3692207,1301.447656,1362084666159,1362084735471,2506044035,2506113347,69312
1362084748,2506125704,3,144,48,1362084735581,1362084740637,2506113285,2506118341,5056
1362084751,2506129412,1,77,77,1362084723863,1362084723863,2506102275,2506102275,0
1362084751,2506129416,1,77,77,1362084723862,1362084723862,2506102278,2506102278,0
1362084751,2506129528,1,77,77,1362084723749,1362084723749,2506102277,2506102277,0
1362084751,2506129528,2,123,61.5,1362084723748,1362084723748,2506102276,2506102276,0
1362084751,2506129528,1,77,77,1362084723748,1362084723748,2506102276,2506102276,0
1362084751,2506129604,2,123,61.5,1362084725658,1362084725722,2506104262,2506104326,64
1362084763,2506141388,2,123,61.5,1362084734895,1362084734895,2506113283,2506113283,0
1362084763,2506141584,2,123,61.5,1362084737706,1362084737706,2506116290,2506116290,0
1362084764,2506141788,7,1356,193.7142857,1362084755721,1362084755849,2506133509,2506133637,128
1362084775,2506153576,3,491,163.6666667,1362084748788,1362084748916,2506127364,2506127492,128
1362084783,2506161500,3,168,56,1362084756927,1362084762751,2506135427,2506141251,5824
1362084784,2506161616,3,288,96,1362084757618,1362084759730,2506135234,2506137346,2112
1362084784,2506161620,3,168,56,1362084757744,1362084760624,2506135364,2506138244,2880
1362084784,2506161652,3,168,56,1362084758032,1362084763856,2506135684,2506141508,5824
1362084788,2506165788,2,123,61.5,1362084763464,1362084763528,2506141252,2506141316,64
1362084796,2506173812,3,144,48,1362084784176,1362084789360,2506161988,2506167172,5184
1362084796,2506173888,1403,1838911,1310.699216,1362084755746,1362084789858,2506133634,2506167746,34112
1362084796,2506173896,3,144,48,1362084784285,1362084790301,2506162181,2506168197,6016
1362084800,2506177628,4,656,164,1362084773543,1362084773927,2506151171,2506151555,384
1362084804,2506181872,7,412,58.85714286,1362084797429,1362084797429,2506175301,2506175301,0
1362084807,2506185564,85,105027,1235.611765,1362084781503,1362084781695,2506160067,2506160259,192
1362084808,2506185604,2,92,46,1362084783551,1362084783615,2506161155,2506161219,64
1362084808,2506185604,1,77,77,1362084783679,1362084783679,2506161283,2506161283,0
1362084808,2506185608,2,123,61.5,1362084783674,1362084783674,2506161282,2506161282,0
1362084808,2506185656,1,77,77,1362084783626,1362084783626,2506161282,2506161282,0
1362084808,2506185732,1,77,77,1362084783553,1362084783553,2506161285,2506161285,0
1362084811,2506189500,281,392755,1397.704626,1362084507262,1362084509886,2505885762,2505888386,2624
1362084811,2506189500,1191,1647696,1383.455919,1362084503230,1362084509822,2505881730,2505888322,6592
1362084811,2506189512,6,2375,395.8333333,1362084783477,1362084783669,2506161989,2506162181,192
1362084811,2506189516,1,46,46,1362084783661,1362084783661,2506162177,2506162177,0
1362084811,2506189576,2,123,61.5,1362084784693,1362084784757,2506163269,2506163333,64
1362084812,2506189656,2,92,46,1362084784522,1362084784522,2506162178,2506162178,0
1362084812,2506189984,5,576,115.2,1362084795203,1362084811267,2506173187,2506189251,16064
1362084816,2506193596,3,491,163.6666667,1362084790281,1362084790409,2506167877,2506168005,128
1362084820,2506197712,2,123,61.5,1362084794580,1362084794580,2506172292,2506172292,0
1362084828,2506205856,6,503,83.83333333,1362084824709,1362084826757,2506202565,2506204613,2048
1362084828,2506205884,2,98,49,1362084817575,1362084822631,2506195459,2506200515,5056
1362084828,2506205884,3,144,48,1362084817575,1362084823655,2506195459,2506201539,6080
1362084828,2506205968,5,242,48.4,1362084817491,1362084822547,2506195459,2506200515,5056
1362084828,2506205972,7,412,58.85714286,1362084822288,1362084822352,2506200260,2506200324,64
1362084844,2506221668,7,1420,202.8571429,1362084817023,1362084817471,2506194691,2506195139,448
1362084844,2506221920,7,412,58.85714286,1362084842370,1362084842370,2506220290,2506220290,0
1362084844,2506221920,6,366,61,1362084842370,1362084842370,2506220290,2506220290,0
1362084844,2506221920,6,366,61,1362084842369,1362084842369,2506220289,2506220289,0
1362084844,2506221960,747,924584,1237.729585,1362084383193,1362084841369,2505761153,2506219329,458176
1362084844,2506222000,385,415130,1078.25974,1362084493618,1362084842290,2505871618,2506220290,348672
1362084844,2506222032,6,366,61,1362084842257,1362084842321,2506220289,2506220353,64
1362084851,2506229600,1,46,46,1362084823961,1362084823961,2506202561,2506202561,0
1362084852,2506229960,126,138659,1100.468254,1362084645723,1362084844379,2506023683,2506222339,198656
1362084852,2506230012,8,458,57.25,1362084844327,1362084844327,2506222339,2506222339,0
1362084856,2506233696,3,491,163.6666667,1362084829795,1362084829923,2506207491,2506207619,128
1362084860,2506238056,7,412,58.85714286,1362084853243,1362084853307,2506231299,2506231363,64
1362084868,2506245740,2,123,61.5,1362084841526,1362084841590,2506219266,2506219330,64
1362084876,2506254180,200,101116,505.58,1362084643263,1362084872191,2506021443,2506250371,228928
1362084896,2506273780,3,491,163.6666667,1362084869517,1362084869581,2506247297,2506247361,64
1362084908,2506286024,3,144,48,1362084896601,1362084902489,2506274625,2506280513,5888
1362084908,2506286104,2,98,49,1362084896520,1362084902408,2506274624,2506280512,5888
1362084924,2506301768,2,123,61.5,1362084899608,1362084899608,2506277376,2506277376,0
1362084924,2506301772,2,92,46,1362084899733,1362084899797,2506277505,2506277569,64
1362084936,2506313680,3,491,163.6666667,1362084909680,1362084909808,2506287360,2506287488,128
1362084940,2506318024,3,138,46,1362084932504,1362084932568,2506310528,2506310592,64
1362084940,2506318112,6,461,76.83333333,1362084932035,1362084932163,2506310147,2506310275,128
1362084952,2506329684,134,181753,1356.365672,1362084649325,1362084650221,2506027009,2506027905,896
1362084952,2506329684,960,1307248,1361.716667,1362084646381,1362084650221,2506024065,2506027905,3840
1362084964,2506342352,7,412,58.85714286,1362084958032,1362084958032,2506336384,2506336384,0
1362084976,2506353880,3,491,163.6666667,1362084950123,1362084950251,2506328003,2506328131,128
1362084980,2506358308,6,2803,467.1666667,1362084972796,1362084972860,2506351104,2506351168,64
1362084996,2506374320,6,2803,467.1666667,1362084988272,1362084988336,2506366592,2506366656,64
1362084996,2506374352,3,144,48,1362084989967,1362084995023,2506368319,2506373375,5056
1362085000,2506377784,13,3796,292,1362084973321,1362084973577,2506351105,2506351361,256
1362085012,2506390364,3,144,48,1362085005446,1362085010502,2506383810,2506388866,5056
1362085012,2506390420,3,144,48,1362085005390,1362085011470,2506383810,2506389890,6080
1362085016,2506393848,2,192,96,1362084989319,1362084990407,2506367167,2506368255,1088
1362085016,2506393852,1,56,56,1362084989764,1362084989764,2506367616,2506367616,0
1362085016,2506393856,2,112,56,1362084989634,1362084995458,2506367490,2506373314,5824
1362085016,2506393964,46,51146,1111.869565,1362084988691,1362084988819,2506366655,2506366783,128
1362085016,2506393980,3,491,163.6666667,1362084989509,1362084989637,2506367489,2506367617,128
1362085016,2506394004,1,56,56,1362084989804,1362084989804,2506367808,2506367808,0
1362085028,2506406416,3,144,48,1362085018383,1362085023439,2506396799,2506401855,5056
1362085028,2506406500,3,144,48,1362085018362,1362085024378,2506396862,2506402878,6016
1362085056,2506433872,3,491,163.6666667,1362085029359,1362085029423,2506407231,2506407295,64
1362085056,2506433920,3,169,56.33333333,1362085031422,1362085031486,2506409342,2506409406,64
1362085060,2506438504,5,2757,551.4,1362085058745,1362085058809,2506437249,2506437313,64
1362085068,2506446392,6,2803,467.1666667,1362085060968,1362085061032,2506439360,2506439424,64
1362085068,2506446420,9,2033,225.8888889,1362085062028,1362085062220,2506440448,2506440640,192
1362085068,2506446468,4,317,79.25,1362085060573,1362085060573,2506439041,2506439041,0
1362085068,2506446496,5,2757,551.4,1362085061441,1362085061505,2506439937,2506440001,64
1362085068,2506446496,6,500,83.33333333,1362085065024,1362085067136,2506443520,2506445632,2112
1362085068,1144761116,6,757,126.1666667,1362085062836,1362085063028,1144755952,1144756144,192
1362085072,2506450032,51,60153,1179.470588,1362085047312,1362085060560,2506425344,2506438592,13248
1362085076,2506454376,18,5348,297.1111111,1362085075638,1362085075894,2506454014,2506454270,256
1362085076,2506454428,5,460,92,1362085075138,1362085075266,2506453566,2506453694,128
1362085076,2506454428,18,6308,350.4444444,1362085075138,1362085075586,2506453566,2506454014,448
1362085076,2506454512,13,6311,485.4615385,1362085075057,1362085075569,2506453569,2506454081,512
1362085084,2506462024,96,64547,672.3645833,1362085058584,1362085080600,2506436608,2506458624,22016
1362085084,2506462032,9,3235,359.4444444,1362085059214,1362085059470,2506437246,2506437502,256
1362085084,2506462032,17,952,56,1362085059214,1362085081486,2506437246,2506459518,22272
1362085084,2506462036,16,4080,255,1362085059274,1362085060618,2506437310,2506438654,1344
1362085084,2506462152,17,952,56,1362085059286,1362085081430,2506437438,2506459582,22144
1362085084,2506462404,13,4911,377.7692308,1362085075676,1362085081308,2506454080,2506459712,5632
1362085084,2506462444,4,190,47.5,1362085070453,1362085076405,2506448897,2506454849,5952
1362085084,2506462476,2,98,49,1362085075285,1362085081237,2506453761,2506459713,5952
1362085084,2506462476,2,92,46,1362085075412,1362085081236,2506453888,2506459712,5824
1362085084,1144777116,3,144,48,1362085074228,1362085080180,1144767344,1144773296,5952
1362085084,1144777120,3,144,48,1362085071725,1362085077165,1144764845,1144770285,5440
1362085084,2506462528,4,190,47.5,1362085070368,1362085076320,2506448896,2506454848,5952
1362085084,1144777136,2,98,49,1362085074205,1362085080157,1144767341,1144773293,5952
1362085088,2506465928,24,2304,96,1362085059896,1362085087736,2506437824,2506465664,27840
1362085088,2506465928,41,8377,204.3170732,1362085060406,1362085078902,2506438334,2506456830,18496
1362085088,2506465932,21,11954,569.2380952,1362085060405,1362085061173,2506438337,2506439105,768
1362085088,2506465932,8,2553,319.125,1362085060404,1362085060724,2506438336,2506438656,320
1362085088,2506465968,17,5480,322.3529412,1362085061454,1362085062030,2506439422,2506439998,576
1362085088,2506466008,4,735,183.75,1362085062889,1362085063017,2506440897,2506441025,128
1362085088,2506466020,16,3540,221.25,1362085060250,1362085061018,2506438270,2506439038,768
1362085088,2506466052,24,1344,56,1362085060221,1362085087677,2506438273,2506465729,27456
1362085088,2506466060,9,958,106.4444444,1362085060977,1362085061105,2506439037,2506439165,128
1362085088,2506466092,11,3470,315.4545455,1362085061907,1362085061971,2506439999,2506440063,64
1362085092,2506469984,1,46,46,1362085065534,1362085065534,2506443518,2506443518,0
1362085096,2506474036,15,3284,218.9333333,1362085070539,1362085075275,2506448575,2506453311,4736
1362085096,2506474048,12,6291,524.25,1362085071359,1362085075583,2506449407,2506453631,4224
1362085096,2506474120,3,491,163.6666667,1362085069432,1362085069624,2506447552,2506447744,192
1362085096,2506474156,93,70546,758.5591398,1362085070418,1362085075090,2506448574,2506453246,4672
1362085096,2506474156,4,656,164,1362085070418,1362085070866,2506448574,2506449022,448
1362085097,1144789956,10,7332,733.2,1362085071890,1362085073042,1144764846,1144765998,1152
1362085100,2506477812,36,44400,1233.333333,1362085071977,1362085072425,2506449789,2506450237,448
1362085100,2506477956,4,1089,272.25,1362085071837,1362085072093,2506449793,2506450049,256
1362085100,2506478052,6,3649,608.1666667,1362085075516,1362085075708,2506453568,2506453760,192
1362085100,2506478188,6,2488,414.6666667,1362085075633,1362085075697,2506453821,2506453885,64
1362085100,2506478408,6,786,131,1362085099671,1362085099863,2506478079,2506478271,192
1362085100,2506478532,721,926227,1284.642164,1362085062233,1362085094361,2506440765,2506472893,32128
1362085100,2506478584,6,461,76.83333333,1362085096615,1362085096743,2506475199,2506475327,128
1362085102,1144794168,14,15603,1114.5,1362085075176,1362085075304,1144767344,1144767472,128
1362085102,1144794168,4,423,105.75,1362085075176,1362085075560,1144767344,1144767728,384
1362085102,1144794216,6,4032,672,1362085075128,1362085075448,1144767344,1144767664,320
1362085102,1144794216,10,9368,936.8,1362085075128,1362085075320,1144767344,1144767536,192
1362085104,2506481956,7,2082,297.4285714,1362085075866,1362085075994,2506453822,2506453950,128
1362085104,2506482092,2,92,46,1362085076181,1362085076181,2506454273,2506454273,0
1362085108,2506486512,5,907,181.4,1362085100590,1362085100718,2506479102,2506479230,128
1362085112,2506490052,13,728,56,1362085084349,1362085100989,2506462401,2506479041,16640
1362085112,2506490092,14,784,56,1362085084179,1362085109523,2506462271,2506487615,25344
1362085116,2506493984,7,672,96,1362085088318,1362085112254,2506466302,2506490238,23936
1362085116,2506494108,7,392,56,1362085088513,1362085114817,2506466621,2506492925,26304
1362085116,2506494448,6,461,76.83333333,1362085111727,1362085111855,2506490175,2506490303,128
1362085116,2506494492,9,2760,306.6666667,1362085094724,1362085111684,2506473216,2506490176,16960
1362085116,2506494576,1414,1842660,1303.154173,1362085078896,1362085114224,2506457472,2506492800,35328
1362085124,2506502580,1432,1840245,1285.087291,1362085081900,1362085119660,2506460480,2506498240,37760
1362085132,2506510592,6,461,76.83333333,1362085126560,1362085126688,2506505152,2506505280,128
1362085136,2506514100,3,491,163.6666667,1362085109195,1362085109323,2506487295,2506487423,128
1362085140,2506518208,4,224,56,1362085111902,1362085127006,2506490110,2506505214,15104
1362085144,2506522140,3,168,56,1362085117285,1362085127013,2506495425,2506505153,9728
1362085144,2506522140,3,169,56.33333333,1362085117284,1362085117348,2506495424,2506495488,64
1362085144,2506522180,2,123,61.5,1362085119290,1362085119290,2506497470,2506497470,0
1362085144,2506522180,2,123,61.5,1362085119290,1362085119290,2506497470,2506497470,0
1362085144,2506522184,1,77,77,1362085119285,1362085119285,2506497469,2506497469,0
1362085144,2506522184,2,112,56,1362085119607,1362085122871,2506497791,2506501055,3264
1362085144,2506522304,2,123,61.5,1362085119167,1362085119167,2506497471,2506497471,0
1362085144,2506522304,1,77,77,1362085119167,1362085119167,2506497471,2506497471,0
1362085144,2506522304,2,192,96,1362085119101,1362085120381,2506497405,2506498685,1280
1362085144,2506522304,1,77,77,1362085119165,1362085119165,2506497469,2506497469,0
1362085148,2506526096,1,77,77,1362085120334,1362085120334,2506498430,2506498430,0
1362085148,2506526220,2,123,61.5,1362085120210,1362085120274,2506498430,2506498494,64
1362085148,2506526300,3,138,46,1362085122690,1362085122690,2506500990,2506500990,0
1362085164,2506542152,2,123,61.5,1362085137301,1362085137301,2506515453,2506515453,0
1362085164,2506542340,2,123,61.5,1362085139097,1362085139161,2506517437,2506517501,64
1362085164,2506542492,6,786,131,1362085160579,1362085160771,2506539071,2506539263,192
1362085164,2506542524,5,643,128.6,1362085161633,1362085161761,2506540157,2506540285,128
1362085164,2506542572,6,461,76.83333333,1362085156594,1362085156786,2506535166,2506535358,192
1362085172,2506550296,3,138,46,1362085147269,1362085147269,2506525565,2506525565,0
1362085176,2506554204,6,1096,182.6666667,1362085149089,1362085161057,2506527293,2506539261,11968
1362085180,2506558576,4,190,47.5,1362085171245,1362085176301,2506549821,2506554877,5056
1362085188,2506566584,3,138,46,1362085186276,1362085186404,2506564860,2506564988,128
1362085189,2506566692,3,138,46,1362085188193,1362085188257,2506565885,2506565949,64
1362085196,2506574292,10,3795,379.5,1362085170892,1362085171212,2506549184,2506549504,320
1362085197,2506574688,3,138,46,1362085191204,1362085191268,2506568892,2506568956,64
1362085204,2506582232,1,77,77,1362085178247,1362085178247,2506556479,2506556479,0
1362085204,2506582232,1,77,77,1362085178247,1362085178247,2506556479,2506556479,0
1362085204,2506582232,1,77,77,1362085178245,1362085178245,2506556477,2506556477,0
1362085204,2506582232,1,77,77,1362085178244,1362085178244,2506556476,2506556476,0
1362085204,2506582268,2,123,61.5,1362085179171,1362085179235,2506557439,2506557503,64
1362085204,2506582304,2,123,61.5,1362085176127,1362085176191,2506554431,2506554495,64
1362085204,2506582344,1,77,77,1362085178133,1362085178133,2506556477,2506556477,0
1362085204,2506582344,2,123,61.5,1362085178133,1362085178133,2506556477,2506556477,0
1362085204,2506582388,1,77,77,1362085179049,1362085179049,2506557437,2506557437,0
1362085205,2506582604,6,461,76.83333333,1362085202555,1362085202747,2506580159,2506580351,192
1362085208,2506586296,3,138,46,1362085183301,1362085183301,2506561597,2506561597,0
1362085212,2506590256,1,46,46,1362085185261,1362085185261,2506563517,2506563517,0
1362085212,2506590312,2,92,46,1362085187508,1362085187572,2506565820,2506565884,64
1362085213,1144905164,3,144,48,1362085205674,1362085211562,1144897838,1144903726,5888
1362085214,1144906224,2,92,46,1362085189169,1362085189169,1144881393,1144881393,0
1362085216,2506594332,1,46,46,1362085191521,1362085191521,2506569853,2506569853,0
1362085216,2506594464,1,46,46,1362085191390,1362085191390,2506569854,2506569854,0
1362085218,1144910180,1,46,46,1362085191194,1362085191194,1144883374,1144883374,0
1362085218,1144910180,1,46,46,1362085191194,1362085191194,1144883374,1144883374,0
1362085218,1144910232,2,92,46,1362085191145,1362085191145,1144883377,1144883377,0
1362085218,1144910232,1,46,46,1362085191144,1362085191144,1144883376,1144883376,0
1362085220,2506598564,7,1351,193,1362085212603,1362085213051,2506591167,2506591615,448
1362085221,2506598592,6,461,76.83333333,1362085218118,1362085218246,2506595710,2506595838,128
1362085221,2506598600,3,144,48,1362085215422,1362085220670,2506593022,2506598270,5248
1362085221,2506598600,7,1356,193.7142857,1362085218750,1362085220798,2506596350,2506598398,2048
1362085221,2506598632,5,1456,291.2,1362085205084,1362085220636,2506582716,2506598268,15552
1362085221,2506598636,5,1264,252.8,1362085217242,1362085217370,2506594878,2506595006,128
1362085224,2506602212,15,7464,497.6,1362085196250,1362085217946,2506574462,2506596158,21696
1362085224,2506602272,1,46,46,1362085198237,1362085198237,2506576509,2506576509,0
1362085228,2506606384,3,492,164,1362085201007,1362085201135,2506579391,2506579519,128
1362085230,1144922248,8,980,122.5,1362085205783,1362085206871,1144898031,1144899119,1088
1362085232,2506610252,9,4138,459.7777778,1362085204657,1362085205041,2506582909,2506583293,384
1362085232,2506610284,14,1775,126.7857143,1362085205330,1362085212050,2506583614,2506590334,6720
1362085232,2506610404,4,319,79.75,1362085204891,1362085205275,2506583295,2506583679,384
1362085236,2506614328,6,465,77.5,1362085210597,1362085212133,2506588925,2506590461,1536
1362085236,2506614364,5,4246,849.2,1362085211586,1362085211650,2506589950,2506590014,64
1362085236,2506614460,16,1536,96,1362085210595,1362085232995,2506589055,2506611455,22400
1362085236,2506614460,16,896,56,1362085210722,1362085233122,2506589182,2506611582,22400
1362085236,2506614556,15,840,56,1362085211330,1362085232130,2506589886,2506610686,20800
1362085237,2506614684,6,461,76.83333333,1362085233002,1362085233194,2506610686,2506610878,192
1362085237,2506614688,7,1356,193.7142857,1362085233699,1362085233827,2506611387,2506611515,128
1362085237,2506614732,8,458,57.25,1362085234875,1362085234875,2506612607,2506612607,0
1362085240,2506618240,16,896,56,1362085211963,1362085238715,2506590203,2506616955,26752
1362085240,2506618240,9,662,73.55555556,1362085211965,1362085214141,2506590205,2506592381,2176
1362085240,2506618316,5,437,87.4,1362085214703,1362085214767,2506593019,2506593083,64
1362085240,2506618364,15,12965,864.3333333,1362085211905,1362085214081,2506590269,2506592445,2176
1362085240,2506618404,4,3757,939.25,1362085213209,1362085213209,2506591613,2506591613,0
1362085240,2506618408,6,483,80.5,1362085213461,1362085213653,2506591869,2506592061,192
1362085240,2506618436,2,170,85,1362085213946,1362085213946,2506592382,2506592382,0
1362085240,2506618448,4,290,72.5,1362085214702,1362085214702,2506593150,2506593150,0
1362085244,2506622296,5,2329,465.8,1362085217862,1362085218054,2506596158,2506596350,192
1362085245,2506622680,7,412,58.85714286,1362085236908,1362085236972,2506614588,2506614652,64
1362085245,2506622732,3,144,48,1362085231159,1362085237111,2506608891,2506614843,5952
1362085256,2506634408,6,1556,259.3333333,1362085230038,1362085253078,2506608446,2506631486,23040
1362085256,2506634428,6,976,162.6666667,1362085230209,1362085230337,2506608637,2506608765,128
1362085256,2506634432,5,2666,533.2,1362085230334,1362085230462,2506608766,2506608894,128
1362085261,2506638664,1225,1589281,1297.372245,1362085218683,1362085252987,2506596347,2506630651,34304
1362085264,2506642460,2,112,56,1362085238177,1362085244641,2506616637,2506623101,6464
1362085268,2506646408,1,96,96,1362085241878,1362085241878,2506620286,2506620286,0
1362085268,2506646408,3,138,46,1362085241877,1362085241941,2506620285,2506620349,64
1362085269,2506646616,2914,3688304,1265.7186,1362085220779,1362085268843,2506598395,2506646459,48064
1362085269,2506646744,6,461,76.83333333,1362085262958,1362085263086,2506640702,2506640830,128
1362085272,2506650416,1,56,56,1362085244363,1362085244363,2506622779,2506622779,0
1362085276,2506654400,1,56,56,1362085248157,1362085248157,2506626557,2506626557,0
1362085276,2506654400,4,1388,347,1362085248156,1362085248220,2506626556,2506626620,64
1362085276,2506654400,20,16902,845.1,1362085248219,1362085248347,2506626619,2506626747,128
1362085296,2506674576,13,2022,155.5384615,1362085271533,1362085274989,2506650109,2506653565,3456
1362085297,2506674624,2,123,61.5,1362085270948,1362085270948,2506648572,2506648572,0
1362085297,2506674700,7,2637,376.7142857,1362085269017,1362085275609,2506646717,2506653309,6592
1362085297,2506674748,1,77,77,1362085270822,1362085270822,2506648570,2506648570,0
1362085300,2506678572,1,77,77,1362085271986,1362085271986,2506650558,2506650558,0
1362085301,2506678604,3,169,56.33333333,1362085273913,1362085273977,2506651517,2506651581,64
1362085301,2506678604,2,123,61.5,1362085273975,1362085273975,2506651579,2506651579,0
1362085301,2506678748,2,123,61.5,1362085272808,1362085272808,2506650556,2506650556,0
1362085301,2506678748,2,123,61.5,1362085272807,1362085272807,2506650555,2506650555,0
1362085301,2506678748,2,123,61.5,1362085272807,1362085272807,2506650555,2506650555,0
1362085301,2506678748,1,77,77,1362085272807,1362085272807,2506650555,2506650555,0
1362085305,2506682636,2,123,61.5,1362085276889,1362085276953,2506654525,2506654589,64
1362085309,2506686616,9,504,56,1362085284524,1362085287724,2506662140,2506665340,3200
1362085309,2506686772,9,864,96,1362085283791,1362085287247,2506661563,2506665019,3456
1362085309,2506687020,6,461,76.83333333,1362085307673,1362085307801,2506685693,2506685821,128
1362085313,2506690644,8,448,56,1362085285010,1362085287250,2506662654,2506664894,2240
1362085313,2506690648,8,448,56,1362085285070,1362085287310,2506662718,2506664958,2240
1362085317,2506695052,6,500,83.33333333,1362085306488,1362085309560,2506684540,2506687612,3072
1362085325,2506703120,1346,1836289,1364.256315,1362085282675,1362085316915,2506660795,2506695035,34240
1362085333,2506710896,1,46,46,1362085306645,1362085306645,2506684541,2506684541,0
1362085333,2506710992,3,144,48,1362085321716,1362085327796,2506699708,2506705788,6080
1362085333,2506711096,2,98,49,1362085321612,1362085327692,2506699708,2506705788,6080
1362085341,2506718932,3,492,164,1362085315376,1362085315504,2506693308,2506693436,128
1362085341,2506719128,3,144,48,1362085330093,1362085335661,2506708221,2506713789,5568
1362085346,1145038592,2,92,46,1362085321665,1362085321729,1145014257,1145014321,64
1362085349,2506726868,2,92,46,1362085320879,1362085320879,2506698747,2506698747,0
1362085349,2506726868,1,46,46,1362085320878,1362085320878,2506698746,2506698746,0
1362085349,2506727080,3,138,46,1362085346715,1362085346715,2506724795,2506724795,0
1362085357,2506734680,1,77,77,1362085329837,1362085329837,2506707517,2506707517,0
1362085357,2506734820,1,77,77,1362085331678,1362085331678,2506709498,2506709498,0
1362085357,2506734820,1,77,77,1362085331678,1362085331678,2506709498,2506709498,0
1362085357,2506734824,2,123,61.5,1362085331674,1362085331674,2506709498,2506709498,0
1362085357,2506734892,2,123,61.5,1362085329624,1362085329624,2506707516,2506707516,0
1362085357,2506734948,1,77,77,1362085331553,1362085331553,2506709501,2506709501,0
1362085357,2506734948,1,77,77,1362085331553,1362085331553,2506709501,2506709501,0
1362085357,2506734980,1,77,77,1362085332545,1362085332545,2506710525,2506710525,0
1362085361,2506738656,2,123,61.5,1362085332802,1362085332866,2506710458,2506710522,64
1362085361,2506738704,2,92,46,1362085334036,1362085334036,2506711740,2506711740,0
1362085361,2506738836,2,123,61.5,1362085335631,1362085335695,2506713467,2506713531,64
1362085365,2506743116,3,144,48,1362085350777,1362085356857,2506728893,2506734973,6080
1362085381,2506758856,1,46,46,1362085355067,1362085355067,2506732923,2506732923,0
1362085381,2506758992,3,492,164,1362085355381,1362085355445,2506733373,2506733437,64
1362085389,2506766836,2,92,46,1362085364045,1362085364109,2506741881,2506741945,64
1362085389,2506766968,1,46,46,1362085363917,1362085363917,2506741885,2506741885,0
1362085389,2506767116,6,366,61,1362085388341,1362085388341,2506766457,2506766457,0
1362085389,2506767160,6,461,76.83333333,1362085382537,1362085382921,2506760697,2506761081,384
1362085393,2506770708,7,412,58.85714286,1362085388752,1362085388752,2506766460,2506766460,0
1362085397,2506775020,7,1045,149.2857143,1362085372440,1362085372696,2506750460,2506750716,256
1362085397,2506775196,6,366,61,1362085390248,1362085390248,2506768444,2506768444,0
1362085397,2506775196,6,366,61,1362085390248,1362085390248,2506768444,2506768444,0
1362085397,2506775304,7,412,58.85714286,1362085390138,1362085390138,2506768442,2506768442,0
1362085397,2506775304,6,366,61,1362085390138,1362085390138,2506768442,2506768442,0
1362085397,2506775304,6,366,61,1362085390138,1362085390138,2506768442,2506768442,0
1362085397,2506775312,7,412,58.85714286,1362085394097,1362085394161,2506772409,2506772473,64
1362085397,2506775316,7,412,58.85714286,1362085391152,1362085391152,2506769468,2506769468,0
1362085397,2506775316,6,366,61,1362085391150,1362085391150,2506769466,2506769466,0
1362085405,2506783180,116,70773,610.112069,1362085198264,1362085400312,2506576444,2506778492,202048
1362085413,2506791236,5,575,115,1362085395517,1362085411581,2506773753,2506789817,16064
1362085417,2506794700,6,2901,483.5,1362085389717,1362085394581,2506767417,2506772281,4864
1362085421,2506798716,4,434,108.5,1362085394565,1362085394757,2506772281,2506772473,192
1362085445,2506823028,7,1357,193.8571429,1362085440461,1362085440589,2506818489,2506818617,128
1362085461,2506839128,3,492,164,1362085434154,1362085434282,2506812282,2506812410,128
1362085461,2506839376,6,461,76.83333333,1362085457331,1362085457459,2506835707,2506835835,128
1362085469,2506847228,2,112,56,1362085441735,1362085443975,2506819963,2506822203,2240
1362085469,2506847228,2,112,56,1362085441991,1362085444039,2506820219,2506822267,2048
1362085469,2506847228,2,192,96,1362085442053,1362085444869,2506820281,2506823097,2816
1362085469,2506847276,2,112,56,1362085443605,1362085445077,2506821881,2506823353,1472
1362085477,2506855396,1414,1839417,1300.860679,1362085440221,1362085474397,2506818617,2506852793,34176
1362085477,2506855448,6,461,76.83333333,1362085472297,1362085472489,2506850745,2506850937,192
1362085485,2506863552,3,144,48,1362085472767,1362085478271,2506851319,2506856823,5504
1362085497,2506875280,7,1230,175.7142857,1362085472465,1362085472721,2506850745,2506851001,256
1362085501,2506879308,3,492,164,1362085474229,1362085474293,2506852537,2506852601,64
1362085509,2506887560,6,461,76.83333333,1362085502203,1362085502843,2506880763,2506881403,640
1362085517,2506895500,3,138,46,1362085509428,1362085509556,2506887928,2506888056,128
1362085521,2506898984,1168,1514980,1297.071918,1362085214007,1362085218103,2506591991,2506596087,4096
1362085521,2506898984,209,262483,1255.899522,1362085214263,1362085218039,2506592247,2506596023,3776
1362085541,2506919388,6,1098,183,1362085514021,1362085530981,2506892409,2506909369,16960
1362085550,2506927644,6,461,76.83333333,1362085548108,1362085548236,2506925752,2506925880,128
1362085557,2506935536,6,498,83,1362085547026,1362085549074,2506925562,2506927610,2048
1362085565,2506943524,7,533,76.14285714,1362085562204,1362085563676,2506940728,2506942200,1472
1362085573,2506951344,1,46,46,1362085547150,1362085547150,2506925494,2506925494,0
1362085577,2506955260,3,604,201.3333333,1362085551397,1362085551525,2506929657,2506929785,128
1362085577,2506955308,5,474,94.8,1362085549299,1362085549427,2506927607,2506927735,128
1362085581,2506959548,4,694,173.5,1362085580547,1362085580675,2506959095,2506959223,128
1362085581,2506959556,6,461,76.83333333,1362085577274,1362085577466,2506955830,2506956022,192
1362085590,2506967624,5,907,181.4,1362085582432,1362085582624,2506960056,2506960248,192
1362085597,2506975268,3,492,164,1362085571163,1362085571291,2506949431,2506949559,128
1362085598,2506975680,396,507021,1280.356061,1362085591143,1362085592423,2506968823,2506970103,1280
1362085598,2506975688,43,50931,1184.44186,1362085591967,1362085592287,2506969655,2506969975,320
1362085605,2506983548,2,92,46,1362085580675,1362085580675,2506959223,2506959223,0
1362085606,2506983644,3,138,46,1362085580042,1362085580106,2506957686,2506957750,64
1362085606,2506983644,14,4932,352.2857143,1362085580298,1362085592458,2506957942,2506970102,12160
1362085614,2506991608,6,461,76.83333333,1362085608110,1362085608238,2506985718,2506985846,128
1362085614,2506991692,2,92,46,1362085608218,1362085608218,2506985910,2506985910,0
1362085617,2506995520,2,373,186.5,1362085590880,1362085591008,2506969400,2506969528,128
1362085617,2506995548,50,61966,1239.32,1362085591490,1362085591682,2506970038,2506970230,192
1362085617,2506995552,1,56,56,1362085591744,1362085591744,2506970296,2506970296,0
1362085617,2506995556,1,56,56,1362085592058,1362085592058,2506970614,2506970614,0
1362085629,2507007544,1359,1863734,1371.40103,1362085621191,1362085626183,2506999735,2507004727,4992
1362085630,2507007632,4,190,47.5,1362085623127,1362085624279,2507000759,2507001911,1152
1362085630,2507007632,6,461,76.83333333,1362085623126,1362085623382,2507000758,2507001014,256
1362085638,2507015940,3,492,164,1362085611362,1362085611490,2506989302,2506989430,128
1362085645,2507023552,6,461,76.83333333,1362085637184,1362085637312,2507015736,2507015864,128
1362085645,2507023556,6,786,131,1362085641532,1362085641724,2507020088,2507020280,192
1362085646,2507023672,5,643,128.6,1362085643504,1362085643632,2507021176,2507021304,128
1362085649,2507027504,11,1056,96,1362085621806,1362085626222,2507000310,2507004726,4416
1362085649,2507027504,10,560,56,1362085621869,1362085625901,2507000373,2507004405,4032
1362085650,2507027656,10,560,56,1362085622848,1362085626880,2507000504,2507004536,4032
1362085650,2507027656,10,560,56,1362085622912,1362085626944,2507000568,2507004600,4032
1362085650,2507027656,4,1654,413.5,1362085623038,1362085623102,2507000694,2507000758,64
1362085654,2507031728,6,461,76.83333333,1362085652982,1362085653174,2507030710,2507030902,192
1362085661,2507039572,663,527811,796.0950226,1362084382826,1362085660714,2505761398,2507039286,1277888
1362085670,2507047624,3,138,46,1362085667165,1362085667293,2507044789,2507044917,128
1362085678,2507056016,3,492,164,1362085651351,1362085651479,2507029367,2507029495,128
1362085686,2507063688,6,461,76.83333333,1362085683037,1362085683229,2507060725,2507060917,192
1362085706,2507083760,1,46,46,1362085679061,1362085679061,2507056821,2507056821,0
1362085709,2507087560,5,643,128.6,1362085702582,1362085702710,2507081142,2507081270,128
1362085710,2507087640,6,786,131,1362085702479,1362085702607,2507080119,2507080247,128
1362085718,2507095704,4,524,131,1362085696143,1362085712079,2507073847,2507089783,15936
1362085718,2507095868,3,492,164,1362085692136,1362085692264,2507070004,2507070132,128
1362085733,2507111488,6,461,76.83333333,1362085727293,1362085727421,2507105781,2507105909,128
1362085734,2507111836,2,92,46,1362085707913,1362085707977,2507085749,2507085813,64
1362085741,2507119464,11,6181,561.9090909,1362085734869,1362085740437,2507113333,2507118901,5568
1362085741,2507119464,2,98,49,1362085734933,1362085740437,2507113397,2507118901,5504
1362085741,2507119484,10,6135,613.5,1362085734848,1362085740416,2507113332,2507118900,5568
1362085741,2507119492,4,190,47.5,1362085738680,1362085739768,2507117172,2507118260,1088
1362085742,2507119664,3,144,48,1362085735668,1362085741236,2507113332,2507118900,5568
1362085742,2507119668,2,98,49,1362085735663,1362085741231,2507113331,2507118899,5568
1362085742,2507119668,6,461,76.83333333,1362085739504,1362085739632,2507117172,2507117300,128
1362085742,2507119672,13,3539,272.2307692,1362085739501,1362085739757,2507117173,2507117429,256
1362085749,1145441252,4,190,47.5,1362085736471,1362085742231,1145428723,1145434483,5760
1362085749,1145441260,3,144,48,1362085739152,1362085745232,1145431412,1145437492,6080
1362085749,1145441260,3,144,48,1362085739408,1362085745232,1145431668,1145437492,5824
1362085749,2507127484,7,2855,407.8571429,1362085738691,1362085744451,2507117175,2507122935,5760
1362085749,2507127484,7,1232,176,1362085735873,1362085747713,2507114357,2507126197,11840
1362085749,2507127488,2,98,49,1362085736381,1362085742397,2507114869,2507120885,6016
1362085749,2507127488,2,98,49,1362085736508,1362085742396,2507114996,2507120884,5888
1362085750,2507127644,27,20205,748.3333333,1362085735241,1362085748553,2507112885,2507126197,13312
1362085750,2507127676,3,144,48,1362085736363,1362085742251,2507114039,2507119927,5888
1362085750,2507127676,8,2252,281.5,1362085736489,1362085742249,2507114165,2507119925,5760
1362085750,2507127684,3,144,48,1362085737183,1362085743263,2507114867,2507120947,6080
1362085750,2507127684,13,6124,471.0769231,1362085737696,1362085742944,2507115380,2507120628,5248
1362085750,2507127688,11,4402,400.1818182,1362085737695,1362085743263,2507115383,2507120951,5568
1362085757,2507135444,6,461,76.83333333,1362085753640,1362085753832,2507132084,2507132276,192
1362085757,2507135456,7,586,83.71428571,1362085734942,1362085754142,2507113398,2507132598,19200
1362085758,2507135660,103,123823,1202.165049,1362085736889,1362085751545,2507114549,2507129205,14656
1362085758,2507135780,3,492,164,1362085731455,1362085731583,2507109235,2507109363,128
1362085762,2507139992,19,17342,912.7368421,1362085735340,1362085738540,2507113332,2507116532,3200
1362085762,2507139996,3,513,171,1362085735337,1362085735593,2507113333,2507113589,256
1362085762,2507139996,37,37184,1004.972973,1362085735337,1362085738473,2507113333,2507116469,3136
1362085762,2507139996,5,437,87.4,1362085735337,1362085735593,2507113333,2507113589,256
1362085762,2507139996,32,39656,1239.25,1362085735401,1362085737385,2507113397,2507115381,1984
1362085762,2507139996,8,448,56,1362085735720,1362085754600,2507113716,2507132596,18880
1362085762,2507140020,7,392,56,1362085736017,1362085754001,2507114037,2507132021,17984
1362085762,2507140032,11,1431,130.0909091,1362085736518,1362085737030,2507114550,2507115062,512
1362085762,2507140120,22,18995,863.4090909,1362085735211,1362085738347,2507113331,2507116467,3136
1362085762,2507140120,3,272,90.66666667,1362085735215,1362085735343,2507113335,2507113463,128
1362085762,2507140120,26,19994,769,1362085735214,1362085738414,2507113334,2507116534,3200
1362085762,2507140148,7,392,56,1362085735698,1362085750994,2507113846,2507129142,15296
1362085762,2507140148,7,672,96,1362085735952,1362085754000,2507114100,2507132148,18048
1362085762,2507140152,13,11487,883.6153846,1362085736015,1362085737167,2507114167,2507115319,1152
1362085762,2507140152,13,12463,958.6923077,1362085736268,1362085736524,2507114420,2507114676,256
1362085762,2507140152,14,11178,798.4285714,1362085736332,1362085737356,2507114484,2507115508,1024
1362085762,2507140188,26,27687,1064.884615,1362085736810,1362085737322,2507114998,2507115510,512
1362085762,1145455028,4,432,108,1362085734862,1362085735118,1145427890,1145428146,256
1362085762,1145455056,9,4974,552.6666667,1362085737141,1362085737205,1145430197,1145430261,64
1362085766,2507143656,6,786,131,1362085762428,1362085762620,2507140084,2507140276,192
1362085766,2507143696,5,643,128.6,1362085763477,1362085763605,2507141173,2507141301,128
1362085766,2507143744,10,4724,472.4,1362085737831,1362085738023,2507115575,2507115767,192
1362085766,1145459040,30,33728,1124.266667,1362085738369,1362085738497,1145431409,1145431537,128
1362085773,2507151524,6,461,76.83333333,1362085768537,1362085768729,2507147061,2507147253,192
1362085781,2507159480,2,98,49,1362085773253,1362085778629,2507151733,2507157109,5376
1362085781,2507159560,3,144,48,1362085773174,1362085778550,2507151734,2507157110,5376
1362085781,2507159560,3,144,48,1362085773173,1362085778613,2507151733,2507157173,5440
1362085798,2507176092,6,499,83.16666667,1362085788682,1362085791562,2507166774,2507169654,2880
1362085798,2507176304,3,492,164,1362085770997,1362085771125,2507149301,2507149429,128
1362085798,2507176480,1,48,48,1362085772613,1362085772613,2507151093,2507151093,0
1362085799,2507176856,8,1384,173,1362085773238,1362085773622,2507151094,2507151478,384
1362085805,2507183560,6,461,76.83333333,1362085798517,1362085798709,2507177077,2507177269,192
1362085814,2507192104,1,46,46,1362085788670,1362085788670,2507166774,2507166774,0
1362085822,2507199940,3,169,56.33333333,1362085795362,1362085795362,2507173302,2507173302,0
1362085822,2507200028,3,169,56.33333333,1362085794247,1362085794311,2507172275,2507172339,64
1362085830,2507207592,6,786,131,1362085822523,1362085822651,2507200115,2507200243,128
1362085830,2507207600,5,643,128.6,1362085823475,1362085823603,2507201075,2507201203,128
1362085838,2507216108,3,492,164,1362085811448,1362085811512,2507189556,2507189620,64
1362085846,2507223916,6,455,75.83333333,1362085844153,1362085844409,2507222069,2507222325,256
1362085854,2507231740,3,169,56.33333333,1362085853351,1362085853351,2507231091,2507231091,0
1362085854,2507231764,1427,1844795,1292.778556,1362085846033,1362085850321,2507223797,2507228085,4288
1362085862,2507239680,3,138,46,1362085854435,1362085854435,2507232115,2507232115,0
1362085862,2507239680,2,92,46,1362085854435,1362085854435,2507232115,2507232115,0
1362085862,2507239680,2,92,46,1362085854434,1362085854434,2507232114,2507232114,0
1362085862,2507239764,2,92,46,1362085854351,1362085854351,2507232115,2507232115,0
1362085874,2507252044,5,280,56,1362085848504,1362085853496,2507226548,2507231540,4992
1362085874,2507252052,5,280,56,1362085849264,1362085854512,2507227316,2507232564,5248
1362085874,2507252056,5,3207,641.4,1362085845866,1362085847018,2507223922,2507225074,1152
1362085874,2507252164,5,280,56,1362085848574,1362085854078,2507226738,2507232242,5504
1362085874,2507252168,5,480,96,1362085849083,1362085854075,2507227251,2507232243,4992
1362085878,2507256092,2,92,46,1362085851977,1362085852041,2507230069,2507230133,64
1362085878,2507256104,2,92,46,1362085852987,1362085852987,2507231091,2507231091,0
1362085878,2507256180,2,92,46,1362085850928,1362085850928,2507229108,2507229108,0
1362085878,2507256180,1,46,46,1362085850927,1362085850927,2507229107,2507229107,0
1362085878,2507256184,3,492,164,1362085851117,1362085851245,2507229301,2507229429,128
1362085878,2507256228,1,46,46,1362085852863,1362085852863,2507231091,2507231091,0
1362085878,2507256228,1,46,46,1362085852863,1362085852863,2507231091,2507231091,0
1362085878,2507256228,1,46,46,1362085852863,1362085852863,2507231091,2507231091,0
1362085878,2507256228,2,123,61.5,1362085853054,1362085853054,2507231282,2507231282,0
1362085879,1145571164,2,92,46,1362085853489,1362085853489,1145545653,1145545653,0
1362085879,1145571184,2,92,46,1362085854429,1362085854493,1145546613,1145546677,64
1362085879,1145571200,2,92,46,1362085851404,1362085851468,1145543604,1145543668,64
1362085882,2507259988,3,169,56.33333333,1362085854320,1362085854320,2507232308,2507232308,0
1362085886,2507263800,6,786,131,1362085882285,1362085882477,2507260085,2507260277,192
1362085886,2507263824,5,643,128.6,1362085883282,1362085883410,2507261106,2507261234,128
1362085894,2507271836,3,138,46,1362085889350,1362085889414,2507267186,2507267250,64
1362085917,1145609264,4,190,47.5,1362085911053,1362085916429,1145603317,1145608693,5376
1362085917,1145609276,4,190,47.5,1362085909568,1362085915392,1145601844,1145607668,5824
1362085918,2507295696,13,4494,345.6923077,1362085910866,1362085916434,2507288562,2507294130,5568
1362085918,2507295700,9,955,106.1111111,1362085911120,1362085911312,2507288820,2507289012,192
1362085918,2507295700,4,190,47.5,1362085911184,1362085912208,2507288884,2507289908,1024
1362085918,2507295704,7,412,58.85714286,1362085911564,1362085911628,2507289268,2507289332,64
1362085918,2507295740,2,98,49,1362085908776,1362085914408,2507286516,2507292148,5632
1362085918,2507295744,10,2344,234.4,1362085909538,1362085915362,2507287282,2507293106,5824
1362085918,2507295744,3,144,48,1362085909793,1362085915361,2507287537,2507293105,5568
1362085918,2507295748,2,98,49,1362085909793,1362085915361,2507287541,2507293109,5568
1362085918,2507295764,2,98,49,1362085910030,1362085915342,2507287794,2507293106,5312
1362085918,2507295768,2,98,49,1362085910217,1362085915337,2507287985,2507293105,5120
1362085918,2507295772,6,461,76.83333333,1362085911047,1362085911175,2507288819,2507288947,128
1362085918,2507295816,2,98,49,1362085908699,1362085914331,2507286515,2507292147,5632
1362085918,2507295816,3,144,48,1362085908697,1362085914329,2507286513,2507292145,5632
1362085918,2507295816,4,190,47.5,1362085908697,1362085914329,2507286513,2507292145,5632
1362085918,2507295824,2,98,49,1362085909713,1362085915281,2507287537,2507293105,5568
1362085919,2507296600,3,492,164,1362085891635,1362085891763,2507269235,2507269363,128
1362085926,2507303756,29,20449,705.137931,1362085908309,1362085921941,2507286065,2507299697,13632
1362085926,2507303792,101,123739,1225.138614,1362085909745,1362085924529,2507287537,2507302321,14784
1362085926,2507303792,7,1251,178.7142857,1362085909745,1362085921393,2507287537,2507299185,11648
1362085934,2507311736,6,461,76.83333333,1362085926122,1362085926250,2507303858,2507303986,128
1362085934,2507312148,5,280,56,1362085909455,1362085914959,2507287603,2507293107,5504
1362085934,2507312236,18,21295,1183.055556,1362085908280,1362085910264,2507286516,2507288500,1984
1362085934,2507312236,41,38829,947.0487805,1362085908279,1362085912247,2507286515,2507290483,3968
1362085934,2507312236,21,18517,881.7619048,1362085908279,1362085911991,2507286515,2507290227,3712
1362085934,2507312244,6,336,56,1362085908720,1362085915824,2507286964,2507294068,7104
1362085934,2507312248,21,20107,957.4761905,1362085909035,1362085910123,2507287283,2507288371,1088
1362085934,2507312356,24,19633,818.0416667,1362085908160,1362085911872,2507286516,2507290228,3712
1362085934,2507312356,11,6856,623.2727273,1362085908160,1362085909504,2507286516,2507287860,1344
1362085934,2507312356,3,513,171,1362085908158,1362085908734,2507286514,2507287090,576
1362085934,2507312356,20,15919,795.95,1362085908157,1362085911869,2507286513,2507290225,3712
1362085934,2507312364,5,280,56,1362085908853,1362085912309,2507287217,2507290673,3456
1362085934,2507312392,11,10877,988.8181818,1362085909146,1362085909658,2507287538,2507288050,512
1362085934,2507312392,5,949,189.8,1362085909210,1362085909466,2507287602,2507287858,256
1362085935,1145627240,4,432,108,1362085908837,1362085909413,1145601077,1145601653,576
1362085942,2507319824,6,461,76.83333333,1362085941011,1362085941139,2507318835,2507318963,128
1362085950,2507327840,6,786,131,1362085942276,1362085942404,2507320116,2507320244,128
1362085950,2507327848,5,643,128.6,1362085943227,1362085943419,2507321075,2507321267,192
1362085958,2507336420,3,492,164,1362085930878,1362085931006,2507309298,2507309426,128
1362085966,2507343948,2,92,46,1362085962967,1362085962967,2507340915,2507340915,0
1362085974,2507351884,6,461,76.83333333,1362085970968,1362085971096,2507348852,2507348980,128
1362085994,2507372448,3,169,56.33333333,1362085967840,1362085967904,2507346288,2507346352,64
1362085998,2507376336,3,492,164,1362085971537,1362085971665,2507349873,2507350001,128
1362086006,2507383916,6,786,131,1362086002165,1362086002357,2507380081,2507380273,192
1362086006,2507383948,5,643,128.6,1362086003156,1362086003284,2507381104,2507381232,128
1362086006,2507384496,3,138,46,1362085981040,1362085981104,2507359536,2507359600,64
1362086014,2507392004,9,2760,306.6666667,1362085995870,1362086012190,2507373874,2507390194,16320
1362086022,2507399944,6,461,76.83333333,1362086015896,1362086016024,2507393840,2507393968,128
1362086030,2507407904,3,138,46,1362086027968,1362086028032,2507405872,2507405936,64
1362086030,2507407924,2,92,46,1362086027948,1362086027948,2507405872,2507405872,0
1362086030,2507407924,2,92,46,1362086027948,1362086027948,2507405872,2507405872,0
1362086030,2507408008,3,138,46,1362086027863,1362086027927,2507405871,2507405935,64
1362086030,2507408008,2,92,46,1362086027864,1362086027864,2507405872,2507405872,0
1362086030,2507408020,2,92,46,1362086025868,1362086025868,2507403888,2507403888,0
1362086038,2507415972,6,497,82.83333333,1362086029757,1362086032637,2507407729,2507410609,2880
1362086038,2507416496,3,492,164,1362086010735,1362086010863,2507389231,2507389359,128
1362086050,2507428468,1,46,46,1362086025420,1362086025420,2507403888,2507403888,0
1362086050,2507428560,1,46,46,1362086024303,1362086024303,2507402863,2507402863,0
1362086051,2507428592,1,46,46,1362086026297,1362086026297,2507403889,2507403889,0
1362086051,2507428596,2,92,46,1362086026294,1362086026294,2507403890,2507403890,0
1362086051,1145743460,2,92,46,1362086024970,1362086024970,1145717430,1145717430,0
1362086054,2507432472,3,169,56.33333333,1362086026891,1362086026955,2507405363,2507405427,64
1362086054,2507432544,1,46,46,1362086029186,1362086029186,2507407730,2507407730,0
1362086058,2507436396,4,656,164,1362086031444,1362086031828,2507409840,2507410224,384
1362086070,2507447892,6,786,131,1362086062222,1362086062350,2507440114,2507440242,128
1362086070,2507447896,5,643,128.6,1362086063177,1362086063305,2507441073,2507441201,128
1362086078,2507455992,1915,2467230,1288.370757,1362086067689,1362086073001,2507445681,2507450993,5312
1362086078,2507456016,6,461,76.83333333,1362086075856,1362086075984,2507453872,2507454000,128
1362086078,2507456568,3,492,164,1362086050726,1362086050790,2507429294,2507429358,64
1362086086,2507463932,3,144,48,1362086078115,1362086083939,2507456047,2507461871,5824
1362086086,2507463932,2,98,49,1362086078115,1362086083939,2507456047,2507461871,5824
1362086086,2507463932,2,98,49,1362086078115,1362086083939,2507456047,2507461871,5824
1362086086,2507463932,2,98,49,1362086078115,1362086083939,2507456047,2507461871,5824
1362086086,2507463936,3,144,48,1362086078178,1362086084066,2507456114,2507462002,5888
1362086086,2507464008,43,50430,1172.790698,1362086077783,1362086078039,2507455791,2507456047,256
1362086086,2507464008,59,72004,1220.40678,1362086077783,1362086078295,2507455791,2507456303,512
1362086086,2507464008,63,77901,1236.52381,1362086077849,1362086078617,2507455857,2507456625,768
1362086086,2507464012,29,32030,1104.482759,1362086078038,1362086078486,2507456050,2507456498,448
1362086086,2507464012,2,98,49,1362086078101,1362086083925,2507456113,2507461937,5824
1362086086,2507464012,1313,1792763,1365.394516,1362086078101,1362086082325,2507456113,2507460337,4224
1362086086,2507464092,3,144,48,1362086077315,1362086082819,2507455407,2507460911,5504
1362086086,2507464096,2,98,49,1362086077250,1362086082754,2507455346,2507460850,5504
1362086086,2507464096,3,144,48,1362086077250,1362086082818,2507455346,2507460914,5568
1362086086,2507464096,3,144,48,1362086077314,1362086082818,2507455410,2507460914,5504
1362086094,2507471916,9,497,55.22222222,1362086086452,1362086089972,2507464368,2507467888,3520
1362086094,2507471924,6,461,76.83333333,1362086090926,1362086091054,2507468850,2507468978,128
1362086094,2507471972,4,602,150.5,1362086077118,1362086088894,2507455090,2507466866,11776
1362086094,2507472080,5,1455,291,1362086077583,1362086092815,2507455663,2507470895,15232
1362086094,2507472524,17,7855,462.0588235,1362086068373,1362086079253,2507446897,2507457777,10880
1362086098,2507476480,13,728,56,1362086071999,1362086091071,2507450479,2507469551,19072
1362086098,2507476484,13,1248,96,1362086072126,1362086092350,2507450610,2507470834,20224
1362086098,2507476516,13,728,56,1362086072988,1362086097564,2507451504,2507476080,24576
1362086099,2507476600,13,728,56,1362086073070,1362086097838,2507450670,2507475438,24768
1362086099,2507476640,7,1042,148.8571429,1362086073928,1362086074312,2507451568,2507451952,384
1362086102,2507479976,6,574,95.66666667,1362086077177,1362086097529,2507455153,2507475505,20352
1362086102,2507479976,6,574,95.66666667,1362086077177,1362086098169,2507455153,2507476145,20992
1362086102,2507480544,4,963,240.75,1362086077504,1362086077760,2507456048,2507456304,256
1362086103,2507480624,3,513,171,1362086077464,1362086077720,2507455088,2507455344,256
1362086103,1145795484,4,432,108,1362086077170,1362086077234,1145769654,1145769718,64
1362086107,2507484624,37,41873,1131.702703,1362086078679,1362086078999,2507456303,2507456623,320
1362086110,2507488044,6,455,75.83333333,1362086105779,1362086105971,2507483823,2507484015,192
1362086118,2507496512,3,492,164,1362086090718,1362086090846,2507469230,2507469358,128
1362086126,2507504032,5,643,128.6,1362086123072,1362086123200,2507501104,2507501232,128
1362086126,2507504104,6,786,131,1362086121976,1362086122168,2507500080,2507500272,192
1362086131,2507508700,1,56,56,1362086106125,1362086106125,2507483825,2507483825,0
1362086131,2507508700,1,96,96,1362086106252,1362086106252,2507483952,2507483952,0
1362086142,2507520028,6,461,76.83333333,1362086135813,1362086135941,2507513841,2507513969,128
1362086142,2507520524,1,46,46,1362086114770,1362086114770,2507493294,2507493294,0
1362086155,2507532700,1,46,46,1362086129482,1362086129482,2507507182,2507507182,0
1362086158,2507536544,3,492,164,1362086131005,1362086131133,2507509549,2507509677,128
1362086159,2507536712,1,46,46,1362086133504,1362086133504,2507511216,2507511216,0
1362086163,2507540656,1,46,46,1362086135673,1362086135673,2507513329,2507513329,0
1362086163,2507540684,1,46,46,1362086136285,1362086136285,2507513969,2507513969,0
1362086166,2507544548,1,46,46,1362086138237,1362086138237,2507516785,2507516785,0
1362086166,2507544572,1,46,46,1362086138465,1362086138465,2507517037,2507517037,0
1362086182,2507560120,6,461,76.83333333,1362086180711,1362086180903,2507558831,2507559023,192
1362086190,2507567984,6,786,131,1362086182126,1362086182254,2507560110,2507560238,128
1362086190,2507568068,5,643,128.6,1362086183003,1362086183131,2507561071,2507561199,128
1362086198,2507576000,3,138,46,1362086189917,1362086189981,2507567917,2507567981,64
1362086198,2507576092,2,92,46,1362086194820,1362086194820,2507572912,2507572912,0
1362086199,2507576776,3,492,164,1362086171582,1362086171710,2507549358,2507549486,128
1362086219,2507596856,2,92,46,1362086193004,1362086193068,2507570860,2507570924,64
1362086219,2507596880,2,92,46,1362086194006,1362086194006,2507571886,2507571886,0
1362086219,2507596884,1,46,46,1362086194004,1362086194004,2507571888,2507571888,0
1362086219,1145911740,2,92,46,1362086192690,1362086192690,1145885430,1145885430,0
1362086221,1145913344,6,557,92.83333333,1362086218365,1362086218429,1145910709,1145910773,64
1362086222,2507600016,2,98,49,1362086215693,1362086221709,2507593709,2507599725,6016
1362086222,2507600016,3,144,48,1362086215693,1362086221709,2507593709,2507599725,6016
1362086222,2507600016,2,98,49,1362086215693,1362086221709,2507593709,2507599725,6016
1362086222,2507600044,7,1889,269.8571429,1362086216308,1362086217140,2507594352,2507595184,832
1362086222,2507600044,7,1889,269.8571429,1362086216308,1362086217396,2507594352,2507595440,1088
1362086222,2507600044,7,1889,269.8571429,1362086216308,1362086217396,2507594352,2507595440,1088
1362086222,2507600060,6,1131,188.5,1362086217956,1362086218276,2507596016,2507596336,320
1362086222,2507600120,2,98,49,1362086215591,1362086221607,2507593711,2507599727,6016
1362086222,2507600124,10,2344,234.4,1362086216033,1362086221665,2507594157,2507599789,5632
1362086222,2507600128,7,1889,269.8571429,1362086216160,1362086217056,2507594288,2507595184,896
1362086222,2507600128,3,144,48,1362086216224,1362086221728,2507594352,2507599856,5504
1362086222,2507600128,7,1889,269.8571429,1362086216224,1362086217312,2507594352,2507595440,1088
1362086222,2507600160,5,363,72.6,1362086217280,1362086217344,2507595440,2507595504,64
1362086222,2507600164,11,3459,314.4545455,1362086217977,1362086218297,2507596141,2507596461,320
1362086222,2507600168,6,1101,183.5,1362086218168,1362086218360,2507596336,2507596528,192
1362086222,2507600168,6,461,76.83333333,1362086218166,1362086218294,2507596334,2507596462,128
1362086229,1145921364,3,144,48,1362086216360,1362086221928,1145908724,1145914292,5568
1362086230,2507608060,2,98,49,1362086217379,1362086222691,2507595439,2507600751,5312
1362086230,2507608060,2,98,49,1362086217378,1362086222690,2507595438,2507600750,5312
1362086230,2507608060,2,98,49,1362086217378,1362086222690,2507595438,2507600750,5312
1362086230,2507608060,3,144,48,1362086217377,1362086222689,2507595437,2507600749,5312
1362086230,2507608060,2,98,49,1362086217377,1362086222689,2507595437,2507600749,5312
1362086230,2507608064,3,144,48,1362086217631,1362086223647,2507595695,2507601711,6016
1362086230,2507608064,11,4402,400.1818182,1362086217758,1362086223710,2507595822,2507601774,5952
1362086230,2507608080,3,144,48,1362086220944,1362086226704,2507599024,2507604784,5760
1362086230,2507608084,4,196,49,1362086218441,1362086223881,2507596525,2507601965,5440
1362086230,2507608172,8,2913,364.125,1362086218099,1362086223603,2507596271,2507601775,5504
1362086238,2507616028,28,20802,742.9285714,1362086215233,1362086230145,2507593261,2507608173,14912
1362086238,2507616064,102,124698,1222.529412,1362086216540,1362086231068,2507594604,2507609132,14528
1362086238,2507616068,6,461,76.83333333,1362086233243,1362086233371,2507611311,2507611439,128
1362086239,2507616872,3,492,164,1362086211487,1362086211615,2507589359,2507589487,128
1362086243,2507620728,4,559,139.75,1362086215981,1362086216493,2507593709,2507594221,512
1362086243,2507620748,31,29423,949.1290323,1362086215962,1362086219098,2507593710,2507596846,3136
1362086243,2507620748,41,51018,1244.341463,1362086215962,1362086218330,2507593710,2507596078,2368
1362086243,2507620748,14,8243,588.7857143,1362086215962,1362086217882,2507593710,2507595630,1920
1362086243,2507620748,16,10213,638.3125,1362086215962,1362086217882,2507593710,2507595630,1920
1362086243,2507620760,13,12463,958.6923077,1362086216846,1362086217166,2507594606,2507594926,320
1362086243,2507620760,6,336,56,1362086216973,1362086233613,2507594733,2507611373,16640
1362086243,2507620796,5,480,96,1362086217452,1362086230380,2507595248,2507608176,12928
1362086243,2507620800,11,1431,130.0909091,1362086217703,1362086218151,2507595503,2507595951,448
1362086243,2507620868,24,20928,872,1362086215842,1362086219042,2507593710,2507596910,3200
1362086243,2507620868,5,437,87.4,1362086215842,1362086215970,2507593710,2507593838,128
1362086243,2507620868,31,28655,924.3548387,1362086215841,1362086218977,2507593709,2507596845,3136
1362086243,2507620868,24,24659,1027.458333,1362086215841,1362086218977,2507593709,2507596845,3136
1362086243,2507620876,6,336,56,1362086216219,1362086231387,2507594095,2507609263,15168
1362086243,2507620876,21,19854,945.4285714,1362086216281,1362086217945,2507594157,2507595821,1664
1362086243,2507620876,6,336,56,1362086216281,1362086233433,2507594157,2507611309,17152
1362086243,2507620888,10,9174,917.4,1362086216844,1362086217484,2507594732,2507595372,640
1362086243,2507620920,24,27232,1134.666667,1362086217708,1362086217836,2507595628,2507595756,128
1362086243,1145935760,4,432,108,1362086215456,1362086216032,1145908216,1145908792,576
1362086246,2507624040,5,643,128.6,1362086243063,1362086243191,2507621103,2507621231,128
1362086246,2507624168,6,786,131,1362086241909,1362086242101,2507620077,2507620269,192
1362086254,2507632064,6,461,76.83333333,1362086248223,1362086248415,2507626287,2507626479,192
1362086278,2507656092,6,502,83.66666667,1362086270659,1362086273539,2507648751,2507651631,2880
1362086279,2507656944,3,492,164,1362086251477,1362086251605,2507629421,2507629549,128
1362086286,2507664140,6,461,76.83333333,1362086278160,1362086278352,2507656300,2507656492,192
1362086295,2507673056,1,46,46,1362086270693,1362086270693,2507648749,2507648749,0
1362086299,2507677140,3,169,56.33333333,1362086274322,1362086274386,2507652462,2507652526,64
1362086302,2507680116,1429,1844887,1291.03359,1362086294378,1362086298218,2507672494,2507676334,3840
1362086302,2507680200,3,144,48,1362086295702,1362086301398,2507673902,2507679598,5696
1362086303,2507680956,3,169,56.33333333,1362086276551,1362086276551,2507654507,2507654507,0
1362086310,2507688124,6,786,131,1362086301983,1362086302111,2507680107,2507680235,128
1362086310,2507688128,5,643,128.6,1362086302942,1362086303134,2507681070,2507681262,192
1362086318,2507696124,8,2232,279,1362086295648,1362086311072,2507673772,2507689196,15424
1362086319,2507696912,3,492,164,1362086291382,1362086291510,2507669294,2507669422,128
1362086326,2507704144,6,461,76.83333333,1362086323149,1362086323341,2507701293,2507701485,192
1362086327,2507704936,1,56,56,1362086302239,1362086302239,2507680175,2507680175,0
1362086327,2507704936,1,56,56,1362086302300,1362086302300,2507680236,2507680236,0
1362086327,2507705180,2,192,96,1362086301352,1362086303016,2507679532,2507681196,1664
1362086331,2507709100,1,56,56,1362086302967,1362086302967,2507681067,2507681067,0
1362086334,2507712188,2,92,46,1362086333152,1362086333152,2507711340,2507711340,0
1362086334,2507712188,2,92,46,1362086333152,1362086333152,2507711340,2507711340,0
1362086342,2507720140,3,138,46,1362086334224,1362086334288,2507712364,2507712428,64
1362086342,2507720140,2,92,46,1362086334224,1362086334224,2507712364,2507712364,0
1362086342,2507720140,2,92,46,1362086334224,1362086334224,2507712364,2507712364,0
1362086342,2507720232,2,92,46,1362086334132,1362086334132,2507712364,2507712364,0
1362086350,2507728160,3,144,48,1362086340859,1362086345915,2507719019,2507724075,5056
1362086359,2507737032,2,92,46,1362086331326,1362086331326,2507709358,2507709358,0
1362086359,2507737104,2,92,46,1362086333235,1362086333235,2507711339,2507711339,0
1362086359,2507737104,1,46,46,1362086333235,1362086333235,2507711339,2507711339,0
1362086359,2507737180,3,492,164,1362086331431,1362086331559,2507709611,2507709739,128
1362086359,1146051760,2,92,46,1362086331168,1362086331168,1146023928,1146023928,0
1362086359,2507737220,2,92,46,1362086332159,1362086332159,2507710379,2507710379,0
1362086359,2507737232,1,46,46,1362086333109,1362086333109,2507711341,2507711341,0
1362086359,2507737232,1,46,46,1362086333109,1362086333109,2507711341,2507711341,0
1362086359,2507737256,2,123,61.5,1362086333212,1362086333212,2507711468,2507711468,0
1362086363,2507741140,3,169,56.33333333,1362086335376,1362086335376,2507713516,2507713516,0
1362086366,2507744128,5,643,128.6,1362086362970,1362086363098,2507741098,2507741226,128
1362086366,2507744264,6,786,131,1362086361811,1362086362003,2507740075,2507740267,192
1362086382,2507760112,3,144,48,1362086374828,1362086380012,2507752940,2507758124,5184
1362086398,2507776304,7,412,58.85714286,1362086392170,1362086392234,2507770474,2507770538,64
1362086399,2507777152,8,1351,168.875,1362086373892,1362086374468,2507752044,2507752620,576
1362086399,2507777160,3,492,164,1362086371068,1362086371196,2507749228,2507749356,128
1362086406,2507784132,6,461,76.83333333,1362086398166,1362086398358,2507776298,2507776490,192
1362086406,2507784256,9,497,55.22222222,1362086394268,1362086397916,2507772524,2507776172,3648
1362086414,2507792260,6,461,76.83333333,1362086413078,1362086413206,2507791338,2507791466,128
1362086422,2507800136,6,501,83.5,1362086419282,1362086419474,2507797418,2507797610,192
1362086422,2507800180,5,608,121.6,1362086417191,1362086417447,2507795371,2507795627,256
1362086422,2507800180,6,736,122.6666667,1362086417255,1362086417511,2507795435,2507795691,256
1362086422,2507800180,9,5910,656.6666667,1362086417318,1362086417830,2507795498,2507796010,512
1362086422,2507800188,12,2165,180.4166667,1362086418209,1362086418529,2507796397,2507796717,320
1362086422,2507800216,5,363,72.6,1362086413955,1362086414019,2507792171,2507792235,64
1362086422,2507800224,11,2133,193.9090909,1362086419514,1362086419706,2507797738,2507797930,192
1362086422,2507800276,7,4355,622.1428571,1362086418057,1362086418377,2507796333,2507796653,320
1362086422,2507800276,16,8416,526,1362086418121,1362086418889,2507796397,2507797165,768
1362086429,1146121500,2,98,49,1362086418082,1362086423394,1146110582,1146115894,5312
1362086429,1146121500,3,144,48,1362086418082,1362086423394,1146110582,1146115894,5312
1362086429,1146121508,2,98,49,1362086417434,1362086423386,1146109942,1146115894,5952
1362086429,1146121520,3,144,48,1362086418765,1362086424397,1146111285,1146116917,5632
1362086430,2507808172,6,786,131,1362086421936,1362086422064,2507800108,2507800236,128
1362086430,2507808172,5,643,128.6,1362086422895,1362086423023,2507801067,2507801195,128
1362086430,2507808212,34,35769,1052.029412,1362086419977,1362086425673,2507798189,2507803885,5696
1362086430,2507808216,3,355,118.3333333,1362086417154,1362086423170,2507795370,2507801386,6016
1362086430,2507808224,4,401,100.25,1362086417852,1362086423228,2507796076,2507801452,5376
1362086430,2507808228,2,279,139.5,1362086418421,1362086424181,2507796649,2507802409,5760
1362086430,2507808228,2,279,139.5,1362086418425,1362086424121,2507796653,2507802349,5696
1362086430,2507808228,3,138,46,1362086418551,1362086424183,2507796779,2507802411,5632
1362086430,2507808256,2,92,46,1362086418843,1362086424091,2507797099,2507802347,5248
1362086430,2507808296,4,190,47.5,1362086419955,1362086425139,2507798251,2507803435,5184
1362086430,2507808296,3,144,48,1362086416562,1362086422130,2507794858,2507800426,5568
1362086430,2507808300,2,98,49,1362086416557,1362086422061,2507794857,2507800361,5504
1362086430,2507808300,3,144,48,1362086420272,1362086426096,2507798572,2507804396,5824
1362086430,2507808304,4,196,49,1362086417129,1362086423209,2507795433,2507801513,6080
1362086430,2507808308,2,98,49,1362086418343,1362086424039,2507796651,2507802347,5696
1362086430,2507808324,6,461,76.83333333,1362086428117,1362086428245,2507806441,2507806569,128
1362086431,2507809336,91,77058,846.7912088,1362086406281,1362086413833,2507784617,2507792169,7552
1362086438,2507816216,7,1255,179.2857143,1362086416643,1362086431043,2507794859,2507809259,14400
1362086438,2507816276,7,1535,219.2857143,1362086419655,1362086434823,2507797931,2507813099,15168
1362086438,2507816276,12,7456,621.3333333,1362086419655,1362086435015,2507797931,2507813291,15360
1362086438,2507816276,11,5158,468.9090909,1362086419655,1362086434887,2507797931,2507813163,15232
1362086438,2507816304,7,1357,193.8571429,1362086416557,1362086430893,2507794861,2507809197,14336
1362086438,2507816304,23,20924,909.7391304,1362086416557,1362086433773,2507794861,2507812077,17216
1362086438,2507816304,9,3691,410.1111111,1362086416557,1362086431085,2507794861,2507809389,14528
1362086438,2507816308,16,6609,413.0625,1362086417064,1362086433064,2507795372,2507811372,16000
1362086439,2507817164,8,3189,398.625,1362086414005,1362086414133,2507792169,2507792297,128
1362086439,2507817168,27,12452,461.1851852,1362086414005,1362086414261,2507792173,2507792429,256
1362086439,2507817168,10,3517,351.7,1362086414067,1362086414195,2507792235,2507792363,128
1362086439,2507817172,3,492,164,1362086411118,1362086411246,2507789290,2507789418,128
1362086439,2507817256,6,483,80.5,1362086413403,1362086413531,2507791659,2507791787,128
1362086439,2507817280,11,3488,317.0909091,1362086413700,1362086413764,2507791980,2507792044,64
1362086439,2507817296,14,784,56,1362086414129,1362086434865,2507792425,2507813161,20736
1362086439,2507817324,14,784,56,1362086414294,1362086435030,2507792618,2507813354,20736
1362086439,2507817328,13,1248,96,1362086414355,1362086433683,2507792683,2507812011,19328
1362086439,2507817384,6,483,80.5,1362086413274,1362086413402,2507791658,2507791786,128
1362086439,2507817412,14,784,56,1362086413569,1362086434689,2507791981,2507813101,21120
1362086443,2507821320,26,23270,895,1362086416092,1362086419740,2507794412,2507798060,3648
1362086443,1146135908,4,493,123.25,1362086417033,1362086417097,1146109941,1146110005,64
1362086443,1146135952,3,407,135.6666667,1362086416609,1362086416993,1146109561,1146109945,384
1362086443,2507821360,4,927,231.75,1362086417650,1362086417714,2507796010,2507796074,64
1362086443,1146135960,35,38715,1106.142857,1362086418263,1362086418711,1146111223,1146111671,448
1362086443,2507821368,7,5097,728.1428571,1362086418282,1362086418666,2507796650,2507797034,384
1362086443,2507821368,13,7643,587.9230769,1362086418346,1362086419306,2507796714,2507797674,960
1362086443,2507821444,4,793,198.25,1362086415840,1362086415904,2507794284,2507794348,64
1362086443,2507821480,1,46,46,1362086416893,1362086416893,2507795373,2507795373,0
1362086443,2507821524,15,9785,652.3333333,1362086418126,1362086418830,2507796650,2507797354,704
1362086447,2507825180,7,2513,359,1362086418855,1362086418983,2507797035,2507797163,128
1362086447,2507825236,9,3087,343,1362086420144,1362086421360,2507798380,2507799596,1216
1362086447,2507825348,16,10445,652.8125,1362086420030,1362086421182,2507798378,2507799530,1152
1362086457,2507835264,1,46,46,1362086429076,1362086429076,2507807340,2507807340,0
1362086462,2507840288,6,461,76.83333333,1362086458043,1362086458171,2507836331,2507836459,128
1362086470,2507848248,3,138,46,1362086467300,1362086467364,2507845548,2507845612,64
1362086470,2507848292,3,144,48,1362086460726,1362086466102,2507839018,2507844394,5376
1362086479,2507857332,3,492,164,1362086450957,1362086451085,2507829289,2507829417,128
1362086486,2507864192,3,144,48,1362086478939,1362086484763,2507857131,2507862955,5824
1362086486,2507864196,7,620,88.57142857,1362086479382,1362086480150,2507857578,2507858346,768
1362086486,2507864200,5,261,52.2,1362086478291,1362086483731,2507856491,2507861931,5440
1362086486,2507864240,6,786,131,1362086481833,1362086482025,2507860073,2507860265,192
1362086486,2507864276,5,643,128.6,1362086482823,1362086482951,2507861099,2507861227,128
1362086486,2507864276,3,140,46.66666667,1362086478854,1362086484678,2507857130,2507862954,5824
1362086486,2507864276,2,98,49,1362086478854,1362086484678,2507857130,2507862954,5824
1362086486,2507864280,4,396,99,1362086479298,1362086484610,2507857578,2507862890,5312
1362086486,2507864284,5,608,121.6,1362086479424,1362086479552,2507857708,2507857836,128
1362086487,2507865360,3,138,46,1362086459698,1362086459762,2507838058,2507838122,64
1362086494,2507872240,3,138,46,1362086489707,1362086489771,2507867947,2507868011,64
1362086494,2507872348,7,999,142.7142857,1362086478780,1362086493116,2507857128,2507871464,14336
1362086499,2507877288,3,169,56.33333333,1362086472249,1362086472313,2507850537,2507850601,64
1362086499,2507877288,2,123,61.5,1362086472249,1362086472249,2507850537,2507850537,0
1362086499,2507877292,17,8718,512.8235294,1362086472246,1362086477110,2507850538,2507855402,4864
1362086499,2507877292,72,68279,948.3194444,1362086472310,1362086476982,2507850602,2507855274,4672
1362086499,2507877492,2,123,61.5,1362086472046,1362086472046,2507850538,2507850538,0
1362086499,2507877492,5,340,68,1362086472046,1362086476974,2507850538,2507855466,4928
1362086499,2507877492,4,289,72.25,1362086472046,1362086476654,2507850538,2507855146,4608
1362086502,2507880176,18,14233,790.7222222,1362086478953,1362086494313,2507857129,2507872489,15360
1362086502,2507880176,13,8115,624.2307692,1362086478952,1362086494376,2507857128,2507872552,15424
1362086503,2507881316,8,768,96,1362086476381,1362086494173,2507854697,2507872489,17792
1362086503,2507881320,12,3784,315.3333333,1362086476571,1362086476827,2507854891,2507855147,256
1362086503,2507881324,7,392,56,1362086476760,1362086491416,2507855084,2507869740,14656
1362086503,2507881372,25,19551,782.04,1362086478308,1362086480164,2507856680,2507858536,1856
1362086503,2507881396,2,698,349,1362086478157,1362086478221,2507856553,2507856617,64
1362086503,2507881436,8,448,56,1362086476390,1362086494182,2507854826,2507872618,17792
1362086503,2507881476,7,392,56,1362086477180,1362086492924,2507855656,2507871400,15744
1362086507,2507885284,2,92,46,1362086480254,1362086480318,2507858538,2507858602,64
1362086507,2507885404,4,928,232,1362086479748,1362086479812,2507858152,2507858216,64
1362086507,2507885408,3,138,46,1362086480128,1362086480192,2507858536,2507858600,64
1362086507,1146200080,1,349,349,1362086479071,1362086479071,1146172151,1146172151,0
1362086510,2507888284,6,461,76.83333333,1362086503104,1362086503232,2507881388,2507881516,128
1362086518,2507896280,6,498,83,1362086511426,1362086514370,2507889706,2507892650,2944
1362086519,2507897232,3,492,164,1362086491248,1362086491376,2507869480,2507869608,128
1362086526,2507904232,1758,2369568,1347.877133,1362086516147,1362086521715,2507894379,2507899947,5568
1362086531,2507909348,9,2124,236,1362086505405,1362086516349,2507883753,2507894697,10944
1362086539,2507917324,1,46,46,1362086511380,1362086511380,2507889704,2507889704,0
1362086539,2507917484,4,656,164,1362086511863,1362086512311,2507890347,2507890795,448
1362086547,2507925312,2,112,56,1362086519841,1362086521889,2507898153,2507900201,2048
1362086547,2507925428,2,112,56,1362086519213,1362086520493,2507897641,2507898921,1280
1362086547,2507925464,1,96,96,1362086520136,1362086520136,2507898600,2507898600,0
1362086547,2507925484,1,56,56,1362086520372,1362086520372,2507898856,2507898856,0
1362086547,2507925532,3,138,46,1362086521670,1362086521734,2507900202,2507900266,64
1362086550,2507928208,6,786,131,1362086541896,1362086542024,2507920104,2507920232,128
1362086550,2507928256,5,643,128.6,1362086542811,1362086543003,2507921067,2507921259,192
1362086555,2507933384,1,77,77,1362086530200,1362086530200,2507908584,2507908584,0
1362086555,2507933488,2,123,61.5,1362086530096,1362086530096,2507908584,2507908584,0
1362086555,2507933492,1,77,77,1362086530092,1362086530092,2507908584,2507908584,0
1362086559,2507937304,1,46,46,1362086534056,1362086534056,2507912360,2507912360,0
1362086559,2507937308,3,492,164,1362086531174,1362086531302,2507909482,2507909610,128
1362086559,2507937432,2,92,46,1362086533929,1362086533993,2507912361,2507912425,64
1362086560,1146252148,2,92,46,1362086532803,1362086532803,1146224951,1146224951,0
1362086560,1146252200,2,92,46,1362086534738,1362086534738,1146226938,1146226938,0
1362086563,2507941296,1,77,77,1362086535281,1362086535281,2507913577,2507913577,0
1362086563,2507941296,1,77,77,1362086535281,1362086535281,2507913577,2507913577,0
1362086563,2507941296,3,169,56.33333333,1362086535281,1362086535345,2507913577,2507913641,64
1362086563,2507941408,2,123,61.5,1362086535235,1362086535235,2507913643,2507913643,0
1362086563,2507941408,1,77,77,1362086535168,1362086535168,2507913576,2507913576,0
1362086582,2507960320,6,461,76.83333333,1362086578073,1362086578201,2507956393,2507956521,128
1362086590,2507968280,6,366,61,1362086589311,1362086589311,2507967591,2507967591,0
1362086590,2507968284,6,366,61,1362086589307,1362086589307,2507967591,2507967591,0
1362086590,2507968384,7,412,58.85714286,1362086589207,1362086589207,2507967591,2507967591,0
1362086595,2507973524,3,138,46,1362086569996,1362086569996,2507948520,2507948520,0
1362086599,2507977320,3,492,164,1362086570903,1362086571031,2507949223,2507949351,128
1362086599,2507977444,1,46,46,1362086573917,1362086573917,2507952361,2507952361,0
1362086606,2507984292,6,786,131,1362086601780,1362086601972,2507980072,2507980264,192
1362086606,2507984296,7,1462,208.8571429,1362086605360,1362086605680,2507983656,2507983976,320
1362086606,2507984332,5,643,128.6,1362086603339,1362086603723,2507981671,2507982055,384
1362086606,2507984360,5,363,72.6,1362086603762,1362086603890,2507982122,2507982250,128
1362086606,2507984376,9,558,62,1362086604639,1362086604831,2507983015,2507983207,192
1362086606,2507984380,32,32393,1012.28125,1362086604957,1362086605533,2507983337,2507983913,576
1362086613,1146305540,3,144,48,1362086603646,1362086609278,1146296186,1146301818,5632
1362086613,1146305564,3,144,48,1362086606435,1362086612131,1146298999,1146304695,5696
1362086614,2507992240,10,2344,234.4,1362086603432,1362086609000,2507981672,2507987240,5568
1362086614,2507992240,11,3459,314.4545455,1362086606247,1362086606503,2507984487,2507984743,256
1362086614,2507992240,2,98,49,1362086603431,1362086608999,2507981671,2507987239,5568
1362086614,2507992240,2,279,139.5,1362086603431,1362086608999,2507981671,2507987239,5568
1362086614,2507992248,4,523,130.75,1362086595808,1362086610912,2507974056,2507989160,15104
1362086614,2507992272,3,144,48,1362086604042,1362086609866,2507982314,2507988138,5824
1362086614,2507992272,2,98,49,1362086604105,1362086609865,2507982377,2507988137,5760
1362086614,2507992284,2,92,46,1362086604734,1362086609918,2507983018,2507988202,5184
1362086614,2507992288,2,98,49,1362086602616,1362086607864,2507980904,2507986152,5248
1362086614,2507992288,2,98,49,1362086602616,1362086607864,2507980904,2507986152,5248
1362086614,2507992288,2,92,46,1362086605430,1362086610870,2507983718,2507989158,5440
1362086614,2507992292,2,98,49,1362086602614,1362086607862,2507980906,2507986154,5248
1362086614,2507992312,3,144,48,1362086605662,1362086611870,2507983974,2507990182,6208
1362086614,2507992312,7,506,72.28571429,1362086605665,1362086605985,2507983977,2507984297,320
1362086614,2507992320,7,2867,409.5714286,1362086606170,1362086611866,2507984490,2507990186,5696
1362086614,2507992320,6,461,76.83333333,1362086606168,1362086606296,2507984488,2507984616,128
1362086614,2507992320,4,190,47.5,1362086606167,1362086607255,2507984487,2507985575,1088
1362086614,2507992324,2,98,49,1362086603604,1362086608916,2507981928,2507987240,5312
1362086614,2507992328,2,98,49,1362086603792,1362086609808,2507982120,2507988136,6016
1362086614,2507992352,3,144,48,1362086603960,1362086609784,2507982312,2507988136,5824
1362086614,2507992360,10,4356,435.6,1362086604465,1362086609777,2507982825,2507988137,5312
1362086614,2507992360,28,12678,452.7857143,1362086604527,1362086610223,2507982887,2507988583,5696
1362086614,2507992372,7,512,73.14285714,1362086610534,1362086610662,2507988906,2507989034,128
1362086614,2507992372,10,6135,613.5,1362086602470,1362086607782,2507980842,2507986154,5312
1362086614,2507992392,16,2661,166.3125,1362086605329,1362086610833,2507983721,2507989225,5504
1362086614,2507992392,11,6181,561.9090909,1362086602449,1362086607761,2507980841,2507986153,5312
1362086614,2507992392,3,144,48,1362086602512,1362086607760,2507980904,2507986152,5248
1362086614,2507992392,2,98,49,1362086602512,1362086607760,2507980904,2507986152,5248
1362086614,2507992396,7,506,72.28571429,1362086605582,1362086606606,2507983978,2507985002,1024
1362086619,2507997444,1,77,77,1362086594140,1362086594140,2507972584,2507972584,0
1362086619,2507997444,1,77,77,1362086594139,1362086594139,2507972583,2507972583,0
1362086619,2507997560,2,92,46,1362086593834,1362086593898,2507972394,2507972458,64
1362086619,2507997560,1,77,77,1362086594025,1362086594025,2507972585,2507972585,0
1362086619,2507997560,1,77,77,1362086594024,1362086594024,2507972584,2507972584,0
1362086619,2507997560,2,123,61.5,1362086594024,1362086594024,2507972584,2507972584,0
1362086620,1146312448,2,92,46,1362086595482,1362086595546,1146287930,1146287994,64
1362086622,2508000224,8,1969,246.125,1362086603895,1362086614647,2507982119,2507992871,10752
1362086622,2508000264,6,455,75.83333333,1362086621201,1362086621329,2507999465,2507999593,128
1362086622,2508000344,11,2816,256,1362086605632,1362086615872,2507983976,2507994216,10240
1362086627,2508005440,4,559,139.75,1362086602462,1362086603038,2507980902,2507981478,576
1362086627,2508005440,40,24863,621.575,1362086602462,1362086611870,2507980902,2507990310,9408
1362086627,2508005440,3,556,185.3333333,1362086602335,1362086602463,2507980775,2507980903,128
1362086627,2508005440,39,25112,643.8974359,1362086602399,1362086612255,2507980839,2507990695,9856
1362086627,2508005440,31,15198,490.2580645,1362086602399,1362086611871,2507980839,2507990311,9472
1362086627,2508005444,5,437,87.4,1362086602462,1362086603038,2507980906,2507981482,576
1362086627,2508005528,31,27554,888.8387097,1362086601994,1362086623690,2507980522,2508002218,21696
1362086627,2508005556,44,21218,482.2272727,1362086602285,1362086611757,2507980841,2507990313,9472
1362086628,1146320476,7,812,116,1362086602940,1362086605564,1146295416,1146298040,2624
1362086630,2508008236,3,138,46,1362086627883,1362086627947,2508006119,2508006183,64
1362086631,2508009340,10,960,96,1362086602883,1362086623875,2507981223,2508002215,20992
1362086631,2508009344,13,10998,846,1362086605887,1362086607935,2507984231,2507986279,2048
1362086631,2508009348,10,560,56,1362086603070,1362086627774,2507981418,2508006122,24704
1362086631,2508009352,9,504,56,1362086603320,1362086621048,2507981672,2507999400,17728
1362086631,2508009352,10,9050,905,1362086603319,1362086603895,2507981671,2507982247,576
1362086631,2508009384,9,504,56,1362086603672,1362086621144,2507982056,2507999528,17472
1362086631,2508009392,23,27186,1182,1362086603983,1362086604175,2507982375,2507982567,192
1362086631,2508009400,4,437,109.25,1362086604295,1362086604423,2507982695,2507982823,128
1362086631,2508009428,5,1064,212.8,1362086604909,1362086605165,2507983337,2507983593,256
1362086631,2508009464,27,32784,1214.222222,1362086605767,1362086605895,2507984231,2507984359,128
1362086631,2508009464,10,6846,684.6,1362086605767,1362086606855,2507984231,2507985319,1088
1362086631,2508009472,14,10068,719.1428571,1362086603198,1362086604286,2507981670,2507982758,1088
1362086631,2508009472,5,1696,339.2,1362086603198,1362086604030,2507981670,2507982502,832
1362086631,2508009480,13,12463,958.6923077,1362086603450,1362086603642,2507981930,2507982122,192
1362086631,2508009508,11,1431,130.0909091,1362086603740,1362086604124,2507982248,2507982632,384
1362086631,2508009556,7,3662,523.1428571,1362086605419,1362086605611,2507983975,2507984167,192
1362086639,2508016648,6,461,76.83333333,1362086636857,1362086636985,2508014505,2508014633,128
1362086639,2508017408,36,15717,436.5833333,1362086610882,1362086611970,2507989290,2507990378,1088
1362086639,2508017408,3,492,164,1362086610943,1362086611135,2507989351,2507989543,192
1362086639,2508017532,39,16243,416.4871795,1362086610756,1362086611780,2507989288,2507990312,1024
1362086646,2508024552,7,506,72.28571429,1362086644786,1362086644914,2508023338,2508023466,128
1362086647,2508024632,4,190,47.5,1362086645832,1362086646024,2508023464,2508023656,192
1362086653,1146345548,4,190,47.5,1362086646707,1362086652339,1146339255,1146344887,5632
1362086654,2508032524,3,144,48,1362086647051,1362086652811,2508025575,2508031335,5760
1362086654,2508032528,9,590,65.55555556,1362086647430,1362086652870,2508025958,2508031398,5440
1362086654,2508032536,3,144,48,1362086647937,1362086653825,2508026473,2508032361,5888
1362086654,2508032536,5,415,83,1362086648318,1362086648510,2508026854,2508027046,192
1362086654,2508032540,8,501,62.625,1362086648381,1362086653821,2508026921,2508032361,5440
1362086654,2508032540,4,190,47.5,1362086648445,1362086649597,2508026985,2508028137,1152
1362086654,2508032568,6,366,61,1362086652065,1362086652065,2508030633,2508030633,0
1362086654,2508032568,6,366,61,1362086652065,1362086652065,2508030633,2508030633,0
1362086654,2508032568,7,412,58.85714286,1362086652063,1362086652063,2508030631,2508030631,0
1362086654,2508032580,3,144,48,1362086645460,1362086650836,2508024040,2508029416,5376
1362086654,2508032580,2,98,49,1362086645458,1362086650770,2508024038,2508029350,5312
1362086654,2508032580,7,412,58.85714286,1362086653074,1362086653138,2508031654,2508031718,64
1362086655,2508032584,2,98,49,1362086646777,1362086652793,2508024361,2508030377,6016
1362086655,2508032608,8,522,65.25,1362086647134,1362086652766,2508024742,2508030374,5632
1362086655,2508032644,9,955,106.1111111,1362086649212,1362086649404,2508026856,2508027048,192
1362086655,2508032648,6,366,61,1362086652985,1362086652985,2508030633,2508030633,0
1362086655,2508032656,2,98,49,1362086645872,1362086651696,2508023528,2508029352,5824
1362086655,2508032660,3,144,48,1362086646379,1362086651691,2508024039,2508029351,5312
1362086661,1146353532,3,144,48,1362086648899,1362086654403,1146341431,1146346935,5504
1362086662,2508040540,101,123700,1224.752475,1362086646653,1362086659965,2508025193,2508038505,13312
1362086663,2508040588,27,21209,785.5185185,1362086646002,1362086660914,2508023590,2508038502,14912
1362086663,2508040628,6,1186,197.6666667,1362086647434,1362086660938,2508025062,2508038566,13504
1362086663,2508040676,6,786,131,1362086662429,1362086662621,2508040105,2508040297,192
1362086670,2508048548,5,643,128.6,1362086662515,1362086662707,2508041063,2508041255,192
1362086671,2508048632,6,461,76.83333333,1362086664264,1362086664392,2508041896,2508042024,128
1362086671,2508049376,1,415,415,1362086646111,1362086646111,2508024487,2508024487,0
1362086671,2508049416,17,11472,674.8235294,1362086646649,1362086647993,2508025065,2508026409,1344
1362086671,2508049508,5,949,189.8,1362086646748,1362086647004,2508025256,2508025512,256
1362086671,2508049568,27,30358,1124.37037,1362086645855,1362086648927,2508024423,2508027495,3072
1362086671,2508049572,18,16162,897.8888889,1362086645853,1362086648925,2508024425,2508027497,3072
1362086672,1146364448,1,288,288,1362086646553,1362086646553,1146339001,1146339001,0
1362086675,2508053436,9,9117,1013,1362086646945,1362086647265,2508025381,2508025701,320
1362086675,2508053436,2,838,419,1362086647012,1362086647076,2508025448,2508025512,64
1362086675,2508053436,12,12385,1032.083333,1362086647012,1362086649060,2508025448,2508027496,2048
1362086675,2508053436,19,19825,1043.421053,1362086647012,1362086649188,2508025448,2508027624,2176
1362086675,2508053440,5,280,56,1362086647327,1362086652191,2508025767,2508030631,4864
1362086675,2508053440,22,27128,1233.090909,1362086647391,1362086647455,2508025831,2508025895,64
1362086675,2508053444,5,280,56,1362086647517,1362086652893,2508025961,2508031337,5376
1362086675,2508053448,5,280,56,1362086647833,1362086653913,2508026281,2508032361,6080
1362086675,2508053448,6,2133,355.5,1362086647960,1362086648152,2508026408,2508026600,192
1362086675,2508053472,31,40455,1305,1362086648320,1362086648384,2508026792,2508026856,64
1362086675,2508053548,3,1188,396,1362086646900,1362086646964,2508025448,2508025512,64
1362086675,2508053556,5,480,96,1362086647533,1362086653037,2508026089,2508031593,5504
1362086675,2508053564,4,749,187.25,1362086648036,1362086648164,2508026600,2508026728,128
1362086679,2508057548,3,492,164,1362086650929,1362086650993,2508029477,2508029541,64
1362086686,2508064532,2,98,49,1362086675075,1362086680259,2508053607,2508058791,5184
1362086686,2508064532,3,144,48,1362086675074,1362086680258,2508053606,2508058790,5184
1362086686,2508064532,2,98,49,1362086675074,1362086680258,2508053606,2508058790,5184
1362086687,2508064604,2,98,49,1362086676002,1362086681186,2508053606,2508058790,5184
1362086687,2508064608,6,461,76.83333333,1362086679264,1362086679392,2508056872,2508057000,128
1362086687,2508065488,3,169,56.33333333,1362086661169,1362086661169,2508039657,2508039657,0
1362086692,2508069640,3,138,46,1362086666944,1362086666944,2508044584,2508044584,0
1362086695,2508073428,3,138,46,1362086667114,1362086667178,2508045542,2508045606,64
1362086700,2508077656,8,1457,182.125,1362086675118,1362086675630,2508052774,2508053286,512
1362086703,2508081440,3,138,46,1362086675101,1362086675165,2508053541,2508053605,64
1362086711,2508088644,6,461,76.83333333,1362086709244,1362086709436,2508086888,2508087080,192
1362086719,2508097456,3,492,164,1362086691023,1362086691151,2508069479,2508069607,128
1362086727,2508104696,6,786,131,1362086722374,1362086722566,2508100070,2508100262,192
1362086727,2508104704,5,643,128.6,1362086723389,1362086723517,2508101093,2508101221,128
1362086732,2508109652,3,169,56.33333333,1362086705971,1362086706035,2508083623,2508083687,64
1362086744,2508121612,2,92,46,1362086719321,1362086719321,2508096933,2508096933,0
1362086747,2508125508,1,46,46,1362086719388,1362086719388,2508097896,2508097896,0
1362086747,2508125536,2,92,46,1362086720383,1362086720383,2508098919,2508098919,0
1362086748,2508125624,2,92,46,1362086720272,1362086720336,2508097896,2508097960,64
1362086748,2508125632,2,123,61.5,1362086721031,1362086721031,2508098663,2508098663,0
1362086758,2508136580,45,44501,988.9111111,1362086752145,1362086756561,2508130725,2508135141,4416
1362086759,2508136696,6,461,76.83333333,1362086754181,1362086754501,2508131877,2508132197,320
1362086760,2508137620,3,492,164,1362086731923,1362086732051,2508109543,2508109671,128
1362086767,2508144616,3,138,46,1362086765334,1362086765334,2508142950,2508142950,0
1362086767,2508144616,3,138,46,1362086765334,1362086765398,2508142950,2508143014,64
1362086767,2508144652,2,92,46,1362086763312,1362086763312,2508140964,2508140964,0
1362086767,2508144664,2,92,46,1362086764327,1362086764327,2508141991,2508141991,0
1362086767,2508144700,2,92,46,1362086765250,1362086765250,2508142950,2508142950,0
1362086767,2508144700,2,92,46,1362086765250,1362086765250,2508142950,2508142950,0
1362086767,2508144736,2,92,46,1362086763231,1362086763231,2508140967,2508140967,0
1362086780,2508157888,1,46,46,1362086753221,1362086753221,2508131109,2508131109,0
1362086783,2508160656,5,740,148,1362086782509,1362086782637,2508160165,2508160293,128
1362086783,2508160660,6,2803,467.1666667,1362086780008,1362086780072,2508157668,2508157732,64
1362086783,2508160668,5,363,72.6,1362086780259,1362086780259,2508157927,2508157927,0
1362086783,2508160736,7,412,58.85714286,1362086778975,1362086778975,2508156711,2508156711,0
1362086788,2508165772,2,92,46,1362086762170,1362086762170,2508139942,2508139942,0
1362086788,1146480484,2,92,46,1362086761974,1362086761974,1146454458,1146454458,0
1362086788,2508165928,2,92,46,1362086762973,1362086763037,2508140901,2508140965,64
1362086788,2508165928,1,46,46,1362086763037,1362086763037,2508140965,2508140965,0
1362086791,2508168760,2,92,46,1362086782406,1362086788166,2508160166,2508165926,5760
1362086791,2508168764,6,461,76.83333333,1362086784129,1362086784321,2508161893,2508162085,192
1362086791,2508168768,5,643,128.6,1362086784318,1362086784510,2508162086,2508162278,192
1362086792,2508169744,1,46,46,1362086764182,1362086764182,2508141926,2508141926,0
1362086792,2508169744,2,92,46,1362086764181,1362086764181,2508141925,2508141925,0
1362086792,2508169788,3,169,56.33333333,1362086764907,1362086764971,2508142695,2508142759,64
1362086792,2508169860,1,46,46,1362086764066,1362086764066,2508141926,2508141926,0
1362086796,2508174024,3,492,164,1362086771519,1362086771647,2508149543,2508149671,128
1362086799,2508176596,3,138,46,1362086791337,1362086791401,2508168933,2508168997,64
1362086800,2508177752,76,76822,1010.815789,1362086771919,1362086780175,2508149671,2508157927,8256
1362086804,2508181852,5,437,87.4,1362086779496,1362086779816,2508157348,2508157668,320
1362086804,2508181972,7,392,56,1362086779249,1362086803057,2508157221,2508181029,23808
1362086804,2508181976,7,392,56,1362086779310,1362086803246,2508157286,2508181222,23936
1362086804,2508181976,9,3000,333.3333333,1362086779374,1362086779694,2508157350,2508157670,320
1362086804,2508181976,6,576,96,1362086779564,1362086790956,2508157540,2508168932,11392
1362086806,2508184572,1560,2024957,1298.049359,1362086798170,1362086802714,2508176742,2508181286,4544
1362086806,2508184572,6,461,76.83333333,1362086798360,1362086798488,2508176932,2508177060,128
1362086808,2508185780,7,392,56,1362086779888,1362086807280,2508157668,2508185060,27392
1362086808,2508185788,8,3189,398.625,1362086780138,1362086780266,2508157926,2508158054,128
1362086808,2508185792,12,3609,300.75,1362086780262,1362086780390,2508158054,2508158182,128
1362086808,2508185868,28,27061,966.4642857,1362086782171,1362086782939,2508160039,2508160807,768
1362086808,2508185896,12,3534,294.5,1362086779773,1362086779901,2508157669,2508157797,128
1362086808,2508185900,27,12409,459.5925926,1362086780024,1362086780344,2508157924,2508158244,320
1362086808,2508185948,4,781,195.25,1362086781192,1362086781320,2508159140,2508159268,128
1362086814,2508192584,2,98,49,1362086807884,1362086813452,2508186468,2508192036,5568
1362086815,2508192588,3,144,48,1362086809074,1362086814450,2508186662,2508192038,5376
1362086815,2508192588,2,98,49,1362086809201,1362086814449,2508186789,2508192037,5248
1362086815,2508192616,10,995,99.5,1362086809813,1362086810069,2508187429,2508187685,256
1362086815,2508192660,8,522,65.25,1362086808360,1362086814376,2508186020,2508192036,6016
1362086815,2508192672,2,98,49,1362086808991,1362086814367,2508186663,2508192039,5376
1362086815,2508192672,2,98,49,1362086809182,1362086814366,2508186854,2508192038,5184
1362086815,2508192676,3,144,48,1362086807771,1362086813339,2508185447,2508191015,5568
1362086815,2508192676,2,98,49,1362086807770,1362086813338,2508185446,2508191014,5568
1362086815,2508192696,3,144,48,1362086807750,1362086813318,2508185446,2508191014,5568
1362086815,2508192696,2,98,49,1362086807749,1362086813317,2508185445,2508191013,5568
1362086815,2508192704,6,461,76.83333333,1362086809726,1362086809982,2508187430,2508187686,256
1362086821,1146513580,3,144,48,1362086808022,1362086813974,1146500602,1146506554,5952
1362086821,1146513584,3,144,48,1362086809362,1362086814994,1146501946,1146507578,5632
1362086823,2508200612,10,3126,312.6,1362086808793,1362086819801,2508186405,2508197413,11008
1362086823,2508200612,120,142764,1189.7,1362086807385,1362086822041,2508184997,2508199653,14656
1362086823,2508200644,9,590,65.55555556,1362086809528,1362086815352,2508187172,2508192996,5824
1362086823,2508200732,3,144,48,1362086809695,1362086815263,2508187427,2508192995,5568
1362086823,2508200732,8,495,61.875,1362086809762,1362086815330,2508187494,2508193062,5568
1362086828,2508205796,2,1462,731,1362086800224,1362086800352,2508178020,2508178148,128
1362086831,2508208608,6,455,75.83333333,1362086824859,1362086825115,2508202467,2508202723,256
1362086832,2508209812,8,768,96,1362086807184,1362086824912,2508184996,2508202724,17728
1362086832,2508209840,38,32524,855.8947368,1362086807604,1362086810804,2508185444,2508188644,3200
1362086832,2508209840,20,13819,690.95,1362086807604,1362086810804,2508185444,2508188644,3200
1362086832,2508209840,3,513,171,1362086807603,1362086808115,2508185443,2508185955,512
1362086832,2508209844,16,12129,758.0625,1362086807603,1362086810803,2508185447,2508188647,3200
1362086832,1146524508,4,432,108,1362086807453,1362086808029,1146499961,1146500537,576
1362086832,2508209956,7,392,56,1362086807423,1362086824511,2508185379,2508202467,17088
1362086832,2508209960,24,14223,592.625,1362086807484,1362086810748,2508185444,2508188708,3264
1362086832,2508209960,8,1457,182.125,1362086807484,1362086808828,2508185444,2508186788,1344
1362086832,2508209960,4,447,111.75,1362086807484,1362086807868,2508185444,2508185828,384
1362086832,2508209960,7,1201,171.5714286,1362086807483,1362086808763,2508185443,2508186723,1280
1362086832,2508209960,5,437,87.4,1362086807483,1362086807995,2508185443,2508185955,512
1362086832,2508209968,7,392,56,1362086807669,1362086824693,2508185637,2508202661,17024
1362086836,2508213804,3,492,164,1362086811866,1362086811994,2508189670,2508189798,128
1362086836,2508213808,17,15379,904.6470588,1362086808276,1362086809556,2508186084,2508187364,1280
1362086836,2508213812,6,336,56,1362086808465,1362086824721,2508186277,2508202533,16256
1362086836,2508213816,6,3841,640.1666667,1362086808718,1362086809422,2508186534,2508187238,704
1362086836,2508213820,4,903,225.75,1362086808775,1362086809031,2508186595,2508186851,256
1362086836,2508213944,24,27232,1134.666667,1362086808974,1362086809166,2508186918,2508187110,192
1362086847,2508224616,5,643,128.6,1362086844500,1362086844628,2508222116,2508222244,128
1362086847,2508224656,6,786,131,1362086842478,1362086842606,2508220134,2508220262,128
1362086847,2508224812,6,461,76.83333333,1362086839631,1362086839823,2508217443,2508217635,192
1362086864,2508241844,3,169,56.33333333,1362086839090,1362086839090,2508216934,2508216934,0
1362086864,2508241844,2,123,61.5,1362086839090,1362086839090,2508216934,2508216934,0
1362086864,2508241844,2,123,61.5,1362086839090,1362086839090,2508216934,2508216934,0
1362086864,2508241916,3,169,56.33333333,1362086837992,1362086837992,2508215908,2508215908,0
1362086864,2508241920,1,77,77,1362086837989,1362086837989,2508215909,2508215909,0
1362086864,2508242044,2,123,61.5,1362086837865,1362086837865,2508215909,2508215909,0
1362086864,2508242044,1,77,77,1362086837865,1362086837865,2508215909,2508215909,0
1362086871,2508248684,6,461,76.83333333,1362086869775,1362086869903,2508247459,2508247587,128
1362086876,2508253948,3,492,164,1362086851335,1362086851463,2508229283,2508229411,128
1362086892,2508270028,3,169,56.33333333,1362086865911,1362086865911,2508243939,2508243939,0
1362086892,2508270060,3,169,56.33333333,1362086866903,1362086866967,2508244963,2508245027,64
1362086903,2508280812,3,138,46,1362086898768,1362086898832,2508276580,2508276644,64
1362086903,2508280816,6,786,131,1362086902282,1362086902410,2508280098,2508280226,128
1362086911,2508288656,5,643,128.6,1362086904429,1362086904557,2508282085,2508282213,128
1362086916,2508294144,3,492,164,1362086891011,1362086891139,2508269155,2508269283,128
1362086919,2508296660,8,2709,338.625,1362086896489,1362086913513,2508274149,2508291173,17024
1362086919,2508296704,6,461,76.83333333,1362086914749,1362086914877,2508292453,2508292581,128
1362086924,2508302152,1,77,77,1362086896765,1362086896765,2508274917,2508274917,0
1362086924,2508302180,2,123,61.5,1362086897758,1362086897758,2508275938,2508275938,0
1362086924,2508302256,2,92,46,1362086896277,1362086896277,2508274533,2508274533,0
1362086924,2508302264,2,123,61.5,1362086896653,1362086896717,2508274917,2508274981,64
1362086924,2508302264,1,77,77,1362086896653,1362086896653,2508274917,2508274917,0
1362086924,2508302264,2,123,61.5,1362086896717,1362086896717,2508274981,2508274981,0
1362086924,2508302296,1,77,77,1362086897643,1362086897643,2508275939,2508275939,0
1362086924,2508302300,2,123,61.5,1362086897641,1362086897641,2508275941,2508275941,0
1362086927,2508304756,3,138,46,1362086926729,1362086926793,2508304485,2508304549,64
1362086927,2508304756,2,92,46,1362086926729,1362086926729,2508304485,2508304485,0
1362086927,2508304756,3,138,46,1362086926729,1362086926793,2508304485,2508304549,64
1362086927,2508304764,2,92,46,1362086924737,1362086924737,2508302501,2508302501,0
1362086927,2508304764,3,138,46,1362086924737,1362086924801,2508302501,2508302565,64
1362086927,2508304840,2,92,46,1362086926642,1362086926642,2508304482,2508304482,0
1362086948,1146640700,2,92,46,1362086923357,1362086923357,1146616057,1146616057,0
1362086948,2508326312,1,46,46,1362086923162,1362086923162,2508301474,2508301474,0
1362086948,2508326432,2,92,46,1362086923044,1362086923108,2508301476,2508301540,64
1362086951,2508328724,3,144,48,1362086941479,1362086946535,2508319203,2508324259,5056
1362086952,2508330284,2,123,61.5,1362086924661,1362086924725,2508302945,2508303009,64
1362086952,2508330336,3,169,56.33333333,1362086925633,1362086925697,2508303969,2508304033,64
1362086952,2508330384,2,92,46,1362086924116,1362086924116,2508302500,2508302500,0
1362086952,2508330384,1,46,46,1362086924116,1362086924116,2508302500,2508302500,0
1362086952,2508330384,1,46,46,1362086924116,1362086924116,2508302500,2508302500,0
1362086956,2508334316,3,492,164,1362086930902,1362086931030,2508309218,2508309346,128
1362086959,2508336744,7,412,58.85714286,1362086957204,1362086957268,2508334948,2508335012,64
1362086959,2508336788,6,366,61,1362086956261,1362086956325,2508334049,2508334113,64
1362086959,2508336788,6,366,61,1362086956261,1362086956325,2508334049,2508334113,64
1362086959,2508336832,7,412,58.85714286,1362086957113,1362086957113,2508334945,2508334945,0
1362086959,2508336832,6,366,61,1362086957113,1362086957113,2508334945,2508334945,0
1362086959,2508336876,7,412,58.85714286,1362086956175,1362086956239,2508334051,2508334115,64
1362086959,2508336876,6,366,61,1362086956175,1362086956239,2508334051,2508334115,64
1362086967,2508344748,5,643,128.6,1362086964368,1362086964496,2508342116,2508342244,128
1362086967,2508344748,6,786,131,1362086962381,1362086962509,2508340129,2508340257,128
1362086975,2508352852,6,461,76.83333333,1362086974632,1362086974760,2508352484,2508352612,128
1362086983,2508360756,6,461,76.83333333,1362086980744,1362086980872,2508358500,2508358628,128
1362086983,2508360756,12,3493,291.0833333,1362086980743,1362086980999,2508358499,2508358755,256
1362086983,2508360756,2,98,49,1362086977222,1362086982790,2508354978,2508360546,5568
1362086983,2508360756,11,6181,561.9090909,1362086977221,1362086982789,2508354977,2508360545,5568
1362086983,2508360808,9,558,62,1362086979219,1362086979411,2508357027,2508357219,192
1362086983,2508360808,34,38989,1146.735294,1362086982481,1362086982801,2508360289,2508360609,320
1362086983,2508360836,30,32438,1081.266667,1362086979511,1362086979895,2508357347,2508357731,384
1362086983,2508360836,7,1506,215.1428571,1362086979893,1362086980085,2508357729,2508357921,192
1362086983,2508360840,3,144,48,1362086976371,1362086981683,2508354211,2508359523,5312
1362086983,2508360844,4,190,47.5,1362086980655,1362086981743,2508358499,2508359587,1088
1362086983,2508360848,2,98,49,1362086977131,1362086982699,2508354979,2508360547,5568
1362086983,2508360848,3,144,48,1362086977131,1362086982763,2508354979,2508360611,5632
1362086983,2508360848,3,144,48,1362086977130,1362086982698,2508354978,2508360546,5568
1362086983,2508360848,2,98,49,1362086977130,1362086982698,2508354978,2508360546,5568
1362086983,2508360908,38,45390,1194.473684,1362086982320,1362086982640,2508360228,2508360548,320
1362086983,2508360916,7,506,72.28571429,1362086980006,1362086980966,2508357922,2508358882,960
1362086983,2508360916,7,506,72.28571429,1362086979878,1362086980134,2508357794,2508358050,256
1362086989,1146681576,3,144,48,1362086980442,1362086985498,1146673018,1146678074,5056
1362086989,1146681580,3,144,48,1362086977751,1362086983511,1146670331,1146676091,5760
1362086991,2508368772,9,2947,327.4444444,1362086980725,1362086986805,2508358497,2508364577,6080
1362086991,2508368776,7,506,72.28571429,1362086985011,1362086985267,2508362787,2508363043,256
1362086991,2508368808,8,2252,281.5,1362086977940,1362086983764,2508355748,2508361572,5824
1362086991,2508368812,7,412,58.85714286,1362086984077,1362086984077,2508361889,2508361889,0
1362086991,2508368816,2,98,49,1362086978571,1362086983755,2508356387,2508361571,5184
1362086991,2508368816,2,98,49,1362086978571,1362086983755,2508356387,2508361571,5184
1362086991,2508368820,3,144,48,1362086979078,1362086984774,2508356898,2508362594,5696
1362086991,2508368820,34,12935,380.4411765,1362086979205,1362086984709,2508357025,2508362529,5504
1362086991,2508368844,3,144,48,1362086982701,1362086988781,2508360545,2508366625,6080
1362086991,2508368888,3,144,48,1362086980227,1362086985667,2508358115,2508363555,5440
1362086991,2508368896,7,1267,181,1362086977978,1362086989818,2508355874,2508367714,11840
1362086991,2508368900,8,2094,261.75,1362086978230,1362086987766,2508356130,2508365666,9536
1362086991,2508368900,2,98,49,1362086978230,1362086983670,2508356130,2508361570,5440
1362086991,2508368904,2,98,49,1362086978482,1362086983666,2508356386,2508361570,5184
1362086991,2508368928,3,144,48,1362086978715,1362086984603,2508356643,2508362531,5888
1362086991,2508368928,38,43053,1132.973684,1362086982362,1362086983002,2508360290,2508360930,640
1362086991,2508368928,30,33546,1118.2,1362086982362,1362086982938,2508360290,2508360866,576
1362086991,2508368932,8,544,68,1362086979031,1362086984599,2508356963,2508362531,5568
1362086991,2508368932,3,144,48,1362086982613,1362086988757,2508360545,2508366689,6144
1362086991,2508368932,2,98,49,1362086982677,1362086988629,2508360609,2508366561,5952
1362086991,2508368936,2,92,46,1362086979284,1362086984660,2508357220,2508362596,5376
1362086996,2508374488,3,492,164,1362086970985,1362086971113,2508349473,2508349601,128
1362086999,2508376752,120,142496,1187.466667,1362086976716,1362086990988,2508354468,2508368740,14272
1362086999,2508376800,7,506,72.28571429,1362086994970,1362086995162,2508372770,2508372962,192
1362086999,2508376928,6,461,76.83333333,1362086995545,1362086995673,2508373473,2508373601,128
1362086999,2508376932,6,497,82.83333333,1362086995800,1362086998744,2508373732,2508376676,2944
1362087000,2508378424,13,4255,327.3076923,1362086974953,1362086992745,2508353377,2508371169,17792
1362087004,1146696692,7,812,116,1362086976808,1362086979368,1146669500,1146672060,2560
1362087004,2508382276,13,6986,537.3846154,1362086979839,1362086980927,2508358115,2508359203,1088
1362087004,2508382276,5,2089,417.8,1362086975933,1362086976061,2508354209,2508354337,128
1362087004,2508382288,23,18102,787.0434783,1362086976628,1362086980084,2508354916,2508358372,3456
1362087004,2508382288,19,16785,883.4210526,1362086976628,1362086980148,2508354916,2508358436,3520
1362087004,2508382288,3,513,171,1362086976691,1362086977267,2508354979,2508355555,576
1362087004,2508382288,28,22166,791.6428571,1362086976691,1362086980147,2508354979,2508358435,3456
1362087004,2508382320,12,1152,96,1362086977745,1362086998289,2508356065,2508376609,20544
1362087004,2508382320,13,9690,745.3846154,1362086977809,1362086978705,2508356129,2508357025,896
1362087004,2508382320,4,903,225.75,1362086977808,1362086978064,2508356128,2508356384,256
1362087004,2508382368,6,3653,608.8333333,1362086979552,1362086979680,2508357920,2508358048,128
1362087004,2508382396,21,15112,719.6190476,1362086976517,1362086979973,2508354913,2508358369,3456
1362087004,2508382400,40,38313,957.825,1362086976576,1362086980032,2508354976,2508358432,3456
1362087004,2508382404,12,672,56,1362086977023,1362086995263,2508355427,2508373667,18240
1362087004,2508382404,12,672,56,1362086977086,1362086995390,2508355490,2508373794,18304
1362087004,2508382408,12,672,56,1362086977338,1362086995642,2508355746,2508374050,18304
1362087004,2508382408,10,9128,912.8,1362086977338,1362086978170,2508355746,2508356578,832
1362087004,2508382412,13,12464,958.7692308,1362086977717,1362086977909,2508356129,2508356321,192
1362087004,2508382436,5,1721,344.2,1362086977951,1362086978335,2508356387,2508356771,384
1362087004,2508382440,24,27232,1134.666667,1362086978076,1362086978332,2508356516,2508356772,256
1362087004,2508382472,13,9841,757,1362086979706,1362086980794,2508358178,2508359266,1088
1362087008,2508386372,8,4605,575.625,1362086981535,1362086981919,2508359907,2508360291,384
1362087015,2508392896,6,461,76.83333333,1362087010620,1362087010748,2508388516,2508388644,128
1362087021,2508398616,1,46,46,1362086996113,1362086996113,2508373729,2508373729,0
1362087023,2508400824,6,786,131,1362087022275,1362087022403,2508400099,2508400227,128
1362087031,2508408952,5,643,128.6,1362087024128,1362087024256,2508402080,2508402208,128
1362087036,2508414384,3,492,164,1362087010963,1362087011091,2508389347,2508389475,128
1362087047,2508424876,1178,1568716,1331.677419,1362087042380,1362087046348,2508420256,2508424224,3968
1362087047,2508424916,6,461,76.83333333,1362087040549,1362087040741,2508418465,2508418657,192
1362087063,2508440892,4,415,103.75,1362087043646,1362087059006,2508421538,2508436898,15360
1362087064,2508442352,3,169,56.33333333,1362087036530,1362087036594,2508414882,2508414946,64
1362087064,2508442360,1,46,46,1362087037032,1362087037032,2508415392,2508415392,0
1362087068,2508446328,3,138,46,1362087040010,1362087040010,2508418338,2508418338,0
1362087068,2508446332,3,138,46,1362087040261,1362087040325,2508418593,2508418657,64
1362087068,2508446412,5,2744,548.8,1362087043127,1362087043319,2508421539,2508421731,192
1362087068,2508446504,6,574,95.66666667,1362087042969,1362087063577,2508421473,2508442081,20608
1362087068,2508446524,1,46,46,1362087043267,1362087043267,2508421791,2508421791,0
1362087072,2508450472,1,56,56,1362087044345,1362087044345,2508422817,2508422817,0
1362087072,2508450476,1,56,56,1362087044532,1362087044532,2508423008,2508423008,0
1362087072,2508450480,1,56,56,1362087044658,1362087044658,2508423138,2508423138,0
1362087077,2508454724,3,492,164,1362087051494,1362087051558,2508429218,2508429282,64
1362087081,2508458604,4,1360,340,1362087053213,1362087053277,2508430817,2508430881,64
1362087081,2508458620,17,14655,862.0588235,1362087053261,1362087053389,2508430881,2508431009,128
1362087087,2508464956,6,786,131,1362087082175,1362087082303,2508460131,2508460259,128
1362087087,2508464992,5,643,128.6,1362087084121,1362087084249,2508462113,2508462241,128
1362087087,2508465036,6,461,76.83333333,1362087085485,1362087085613,2508463521,2508463649,128
1362087103,2508480940,3,138,46,1362087096205,1362087096205,2508474145,2508474145,0
1362087103,2508480940,2,92,46,1362087096205,1362087096205,2508474145,2508474145,0
1362087103,2508481016,2,92,46,1362087096127,1362087096127,2508474143,2508474143,0
1362087103,2508481020,2,92,46,1362087096126,1362087096126,2508474146,2508474146,0
1362087103,2508481020,2,92,46,1362087096126,1362087096126,2508474146,2508474146,0
1362087111,2508488992,3,138,46,1362087108185,1362087108313,2508486177,2508486305,128
1362087117,2508494884,3,492,164,1362087091396,1362087091524,2508469280,2508469408,128
1362087117,2508494980,2,92,46,1362087092131,1362087092195,2508470111,2508470175,64
1362087120,1146812988,2,92,46,1362087094718,1362087094718,1146787706,1146787706,0
1362087121,2508498864,3,169,56.33333333,1362087096024,1362087096088,2508473888,2508473952,64
1362087121,2508498900,2,92,46,1362087094195,1362087094259,2508472095,2508472159,64
1362087121,2508498900,1,46,46,1362087094259,1362087094259,2508472159,2508472159,0
1362087121,2508498904,1,46,46,1362087094255,1362087094255,2508472159,2508472159,0
1362087121,2508498944,1,46,46,1362087095178,1362087095178,2508473122,2508473122,0
1362087121,2508498952,2,92,46,1362087093184,1362087093184,2508471136,2508471136,0
1362087121,2508499024,1,46,46,1362087094071,1362087094071,2508472095,2508472095,0
1362087121,2508499024,1,46,46,1362087094138,1362087094138,2508472162,2508472162,0
1362087129,2508506948,1,46,46,1362087103236,1362087103236,2508481184,2508481184,0
1362087143,2508521148,6,786,131,1362087141946,1362087142138,2508520094,2508520286,192
1362087151,2508529144,5,643,128.6,1362087143938,1362087144066,2508522082,2508522210,128
1362087157,2508534932,3,492,164,1362087131731,1362087131859,2508509663,2508509791,128
1362087167,2508545016,2,92,46,1362087159168,1362087159168,2508537184,2508537184,0
1362087167,2508545104,9,497,55.22222222,1362087154089,1362087159081,2508532193,2508537185,4992
1362087167,2508545144,6,461,76.83333333,1362087160383,1362087160511,2508538527,2508538655,128
1362087175,2508553020,7,2206,315.1428571,1362087169020,1362087174460,2508547040,2508552480,5440
1362087175,2508553020,2,98,49,1362087169019,1362087174459,2508547039,2508552479,5440
1362087175,2508553056,3,144,48,1362087167703,1362087173527,2508545759,2508551583,5824
1362087175,2508553056,13,5383,414.0769231,1362087173847,1362087174103,2508551903,2508552159,256
1362087175,2508553056,4,414,103.5,1362087173847,1362087174039,2508551903,2508552095,192
1362087175,2508553060,14,6345,453.2142857,1362087168020,1362087173460,2508546080,2508551520,5440
1362087175,2508553060,12,6253,521.0833333,1362087168020,1362087173460,2508546080,2508551520,5440
1362087175,2508553060,13,6299,484.5384615,1362087168020,1362087173460,2508546080,2508551520,5440
1362087175,2508553060,4,190,47.5,1362087168020,1362087173460,2508546080,2508551520,5440
1362087175,2508553064,26,17120,658.4615385,1362087168014,1362087169934,2508546078,2508547998,1920
1362087175,2508553064,13,6299,484.5384615,1362087168018,1362087173458,2508546082,2508551522,5440
1362087175,2508553064,2,98,49,1362087168018,1362087173458,2508546082,2508551522,5440
1362087175,2508553064,2,98,49,1362087168017,1362087173457,2508546081,2508551521,5440
1362087175,2508553100,2,98,49,1362087168942,1362087174382,2508547042,2508552482,5440
1362087175,2508553100,2,98,49,1362087168942,1362087174382,2508547042,2508552482,5440
1362087175,2508553104,2,98,49,1362087169254,1362087174374,2508547358,2508552478,5120
1362087175,2508553104,2,98,49,1362087169254,1362087174374,2508547358,2508552478,5120
1362087175,2508553144,2,98,49,1362087167937,1362087173377,2508546081,2508551521,5440
1362087175,2508553144,20,9994,499.7,1362087167934,1362087169918,2508546078,2508548062,1984
1362087175,2508553172,4,184,46,1362087171171,1362087172259,2508549343,2508550431,1088
1362087175,2508553176,6,461,76.83333333,1362087171169,1362087171425,2508549345,2508549601,256
1362087175,2508553176,9,949,105.4444444,1362087171169,1362087171425,2508549345,2508549601,256
1362087181,1146873692,3,144,48,1362087168873,1362087174377,1146861565,1146867069,5504
1362087181,1146873692,2,98,49,1362087173478,1362087179366,1146866170,1146872058,5888
1362087181,1146873692,2,98,49,1362087173478,1362087179366,1146866170,1146872058,5888
1362087181,1146873692,3,144,48,1362087173478,1362087179366,1146866170,1146872058,5888
1362087181,1146873696,2,98,49,1362087173541,1362087179365,1146866237,1146872061,5824
1362087181,1146873696,2,98,49,1362087174052,1362087179364,1146866748,1146872060,5312
1362087181,1146873696,3,144,48,1362087171171,1362087176355,1146863867,1146869051,5184
1362087181,1146873704,2,98,49,1362087173469,1362087179357,1146866173,1146872061,5888
1362087181,1146873704,2,98,49,1362087173469,1362087179357,1146866173,1146872061,5888
1362087181,1146873704,3,144,48,1362087173469,1362087179357,1146866173,1146872061,5888
1362087181,1146873704,2,98,49,1362087174107,1362087179355,1146866811,1146872059,5248
1362087181,1146873704,8,1452,181.5,1362087174171,1362087179355,1146866875,1146872059,5184
1362087183,2508561044,3,144,48,1362087169894,1362087175462,2508547938,2508553506,5568
1362087183,2508561044,3,144,48,1362087169893,1362087175525,2508547937,2508553569,5632
1362087183,2508561068,9,590,65.55555556,1362087170124,1362087175436,2508548192,2508553504,5312
1362087183,2508561068,14,6715,479.6428571,1362087170187,1362087181131,2508548255,2508559199,10944
1362087183,2508561068,3,144,48,1362087170251,1362087175499,2508548319,2508553567,5248
1362087183,2508561068,2,94,47,1362087173834,1362087179402,2508551902,2508557470,5568
1362087183,2508561072,3,144,48,1362087170440,1362087176456,2508548512,2508554528,6016
1362087183,2508561076,31,37478,1208.967742,1362087170437,1362087182021,2508548513,2508560097,11584
1362087183,2508561080,2,98,49,1362087170942,1362087176446,2508549022,2508554526,5504
1362087183,2508561084,3,144,48,1362087171262,1362087177406,2508549346,2508555490,6144
1362087183,2508561084,3,144,48,1362087171644,1362087177404,2508549728,2508555488,5760
1362087183,2508561084,3,144,48,1362087171260,1362087177404,2508549344,2508555488,6144
1362087183,2508561120,8,2006,250.75,1362087169239,1362087180439,2508547359,2508558559,11200
1362087183,2508561152,2,98,49,1362087169721,1362087175353,2508547873,2508553505,5632
1362087183,2508561152,3,144,48,1362087169785,1362087175417,2508547937,2508553569,5632
1362087183,2508561156,25,20062,802.48,1362087167603,1362087181491,2508545759,2508559647,13888
1362087183,2508561160,3,144,48,1362087170478,1362087176366,2508548638,2508554526,5888
1362087183,2508561164,3,144,48,1362087170348,1362087176364,2508548512,2508554528,6016
1362087183,2508561192,2,98,49,1362087170833,1362087176337,2508549025,2508554529,5504
1362087183,2508561192,7,449,64.14285714,1362087171152,1362087177296,2508549344,2508555488,6144
1362087183,2508561192,3,144,48,1362087171535,1362087177295,2508549727,2508555487,5760
1362087183,2508561192,3,144,48,1362087171535,1362087177295,2508549727,2508555487,5760
1362087183,2508561192,3,144,48,1362087171534,1362087177294,2508549726,2508555486,5760
1362087189,1146881716,3,144,48,1362087182418,1362087188178,1146875134,1146880894,5760
1362087191,2508569052,3,144,48,1362087183835,1362087189339,2508561887,2508567391,5504
1362087191,2508569056,7,498,71.14285714,1362087184024,1362087189272,2508562080,2508567328,5248
1362087191,2508569076,3,144,48,1362087182020,1362087187332,2508560096,2508565408,5312
1362087191,2508569076,2,98,49,1362087182019,1362087187267,2508560095,2508565343,5248
1362087191,2508569076,3,144,48,1362087182018,1362087187266,2508560094,2508565342,5248
1362087191,2508569076,10,1001,100.1,1362087184322,1362087184514,2508562398,2508562590,192
1362087191,2508569080,8,501,62.625,1362087184384,1362087190720,2508562464,2508568800,6336
1362087191,2508569092,8,4027,503.375,1362087171250,1362087183346,2508549342,2508561438,12096
1362087191,2508569116,2,98,49,1362087183133,1362087188253,2508561249,2508566369,5120
1362087191,2508569116,3,144,48,1362087181210,1362087186266,2508559326,2508564382,5056
1362087191,2508569160,4,190,47.5,1362087184367,1362087185455,2508562527,2508563615,1088
1362087191,2508569160,6,461,76.83333333,1362087184239,1362087184431,2508562399,2508562591,192
1362087191,2508569160,3,144,48,1362087181934,1362087187182,2508560094,2508565342,5248
1362087191,2508569164,9,568,63.11111111,1362087182443,1362087188203,2508560607,2508566367,5760
1362087192,1146885016,6,766,127.6666667,1362087167654,1362087182182,1146860670,1146875198,14528
1362087193,2508570964,6,586,97.66666667,1362087168115,1362087169139,2508546079,2508547103,1024
1362087193,2508570972,1,46,46,1362087168491,1362087168491,2508546463,2508546463,0
1362087193,2508570972,1,46,46,1362087168491,1362087168491,2508546463,2508546463,0
1362087193,2508571088,5,974,194.8,1362087167993,1362087182521,2508546081,2508560609,14528
1362087193,2508571088,6,483,80.5,1362087167993,1362087168441,2508546081,2508546529,448
1362087193,2508571088,16,1536,96,1362087168247,1362087188215,2508546335,2508566303,19968
1362087193,2508571092,16,896,56,1362087168373,1362087189237,2508546465,2508567329,20864
1362087193,2508571096,16,896,56,1362087168622,1362087190254,2508546718,2508568350,21632
1362087197,2508574884,17,952,56,1362087168963,1362087196419,2508546847,2508574303,27456
1362087197,2508574884,18,18292,1016.222222,1362087169154,1362087183938,2508547038,2508561822,14784
1362087197,2508574884,5,2024,404.8,1362087169154,1362087170242,2508547038,2508548126,1088
1362087197,2508574896,13,2337,179.7692308,1362087169783,1362087174071,2508547679,2508551967,4288
1362087197,2508574900,45,54314,1206.977778,1362087169972,1362087184052,2508547872,2508561952,14080
1362087197,2508574932,5,1632,326.4,1362087171026,1362087171346,2508548958,2508549278,320
1362087197,2508574936,4,538,134.5,1362087171342,1362087171534,2508549278,2508549470,192
1362087197,2508575012,32,29327,916.46875,1362087169026,1362087184130,2508547038,2508562142,15104
1362087197,2508575020,17,2623,154.2941176,1362087169340,1362087183612,2508547360,2508561632,14272
1362087197,2508575024,90,67366,748.5111111,1362087169721,1362087173881,2508547745,2508551905,4160
1362087197,2508575060,31,35950,1159.677419,1362087170898,1362087171090,2508548958,2508549150,192
1362087197,2508575064,6,3383,563.8333333,1362087170958,1362087171342,2508549022,2508549406,384
1362087197,2508575088,6,3296,549.3333333,1362087170873,1362087171193,2508548961,2508549281,320
1362087197,2508575088,5,1651,330.2,1362087170937,1362087171129,2508549025,2508549217,192
1362087197,1146889704,3,144,48,1362087184219,1362087190171,1146876923,1146882875,5952
1362087199,2508577040,7,1287,183.8571429,1362087183144,1362087194664,2508561184,2508572704,11520
1362087199,2508577120,99,123673,1249.222222,1362087183256,1362087194584,2508561376,2508572704,11328
1362087199,2508577124,25,20690,827.6,1362087181523,1362087193555,2508559647,2508571679,12032
1362087200,1146892980,6,3071,511.8333333,1362087173193,1362087173321,1146866173,1146866301,128
1362087201,2508578948,35,18053,515.8,1362087175685,1362087183749,2508553633,2508561697,8064
1362087201,2508578948,34,16354,481,1362087175685,1362087183685,2508553633,2508561633,8000
1362087201,2508578948,68,51118,751.7352941,1362087175682,1362087185282,2508553630,2508563230,9600
1362087201,2508578948,47,31215,664.1489362,1362087175682,1362087185218,2508553630,2508563166,9536
1362087201,2508578948,45,33991,755.3555556,1362087175682,1362087185218,2508553630,2508563166,9536
1362087201,2508578960,6,479,79.83333333,1362087173945,1362087174073,2508551905,2508552033,128
1362087201,2508579072,31,16756,540.516129,1362087175559,1362087183815,2508553631,2508561887,8256
1362087201,2508579084,6,480,80,1362087173819,1362087174331,2508551903,2508552415,512
1362087207,2508585128,5,643,128.6,1362087203983,1362087204111,2508582111,2508582239,128
1362087207,2508585140,6,461,76.83333333,1362087199298,1362087199426,2508577438,2508577566,128
1362087207,2508585168,6,786,131,1362087201958,1362087202086,2508580126,2508580254,128
1362087215,2508593248,6,455,75.83333333,1362087214165,1362087214293,2508592413,2508592541,128
1362087215,2508593264,5,575,115,1362087195975,1362087211911,2508574239,2508590175,15936
1362087221,2508598920,4,384,96,1362087193758,1362087203742,2508571678,2508581662,9984
1362087221,2508599000,4,224,56,1362087196176,1362087204176,2508574176,2508582176,8000
1362087221,2508599068,4,224,56,1362087194636,1362087204108,2508572704,2508582176,9472
1362087225,2508603096,2,112,56,1362087199406,1362087203438,2508577502,2508581534,4032
1362087229,2508607188,6,1458,243,1362087203154,1362087223378,2508581342,2508601566,20224
1362087239,2508617156,1471,2022347,1374.811013,1362087231154,1362087236338,2508609310,2508614494,5184
1362087247,2508625144,6,461,76.83333333,1362087244287,1362087244415,2508622431,2508622559,128
1362087247,2508625228,6,499,83.16666667,1362087236521,1362087239401,2508614749,2508617629,2880
1362087253,1146945732,15,3055,203.6666667,1362087248130,1362087249410,1146940862,1146942142,1280
1362087253,2508631212,3,169,56.33333333,1362087227193,1362087227193,2508605405,2508605405,0
1362087255,2508633064,3,144,48,1362087246928,1362087252432,2508624992,2508630496,5504
1362087255,2508633064,4,188,47,1362087249101,1362087254541,2508627165,2508632605,5440
1362087255,2508633104,3,144,48,1362087247782,1362087253414,2508625886,2508631518,5632
1362087255,2508633104,1117,1497516,1340.658908,1362087247845,1362087252901,2508625949,2508631005,5056
1362087255,2508633120,14,6452,460.8571429,1362087248664,1362087254552,2508626784,2508632672,5888
1362087255,2508633148,3,144,48,1362087246844,1362087252348,2508624992,2508630496,5504
1362087255,2508633148,3,144,48,1362087248954,1362087254394,2508627102,2508632542,5440
1362087255,2508633148,2,279,139.5,1362087249018,1362087254394,2508627166,2508632542,5376
1362087255,2508633156,35,41390,1182.571429,1362087247411,1362087247731,2508625567,2508625887,320
1362087255,2508633184,69,85270,1235.797101,1362087247384,1362087248152,2508625568,2508626336,768
1362087255,2508633184,75,92453,1232.706667,1362087247510,1362087248406,2508625694,2508626590,896
1362087255,2508633184,37,41073,1110.081081,1362087247510,1362087248342,2508625694,2508626526,832
1362087255,2508633192,2,98,49,1362087247760,1362087253328,2508625952,2508631520,5568
1362087255,2508633192,3,144,48,1362087247760,1362087253392,2508625952,2508631584,5632
1362087255,2508633192,3,144,48,1362087247760,1362087253392,2508625952,2508631584,5632
1362087255,2508633228,3,144,48,1362087246699,1362087252267,2508624927,2508630495,5568
1362087255,2508633228,7,884,126.2857143,1362087248555,1362087248875,2508626783,2508627103,320
1362087255,2508633228,15,8277,551.8,1362087248554,1362087248874,2508626782,2508627102,320
1362087257,2508635092,22,2112,96,1362087231796,1362087255220,2508609888,2508633312,23424
1362087257,2508635092,22,1232,56,1362087231858,1362087255346,2508609950,2508633438,23488
1362087257,2508635100,21,1176,56,1362087231978,1362087254378,2508610078,2508632478,22400
1362087257,2508635136,22,11071,503.2272727,1362087232390,1362087249478,2508610526,2508627614,17088
1362087257,2508635184,22,1232,56,1362087231575,1362087254423,2508609759,2508632607,22848
1362087261,1146953728,3,144,48,1362087247879,1362087253319,1146940607,1146946047,5440
1362087261,2508639240,1,46,46,1362087236509,1362087236509,2508614749,2508614749,0
1362087263,2508641084,2,98,49,1362087249467,1362087255419,2508627551,2508633503,5952
1362087263,2508641084,3,150,50,1362087249467,1362087255419,2508627551,2508633503,5952
1362087263,2508641088,3,144,48,1362087249847,1362087255415,2508627935,2508633503,5568
1362087263,2508641092,6,1247,207.8333333,1362087250100,1362087255220,2508628192,2508633312,5120
1362087263,2508641128,4,602,150.5,1362087246735,1362087257231,2508624863,2508635359,10496
1362087263,2508641164,2,98,49,1362087249387,1362087255339,2508627551,2508633503,5952
1362087263,2508641168,3,144,48,1362087249766,1362087255334,2508627934,2508633502,5568
1362087263,2508641196,3,144,48,1362087249996,1362087255308,2508628192,2508633504,5312
1362087263,2508641196,2,98,49,1362087250124,1362087255308,2508628320,2508633504,5184
1362087263,2508641200,6,786,131,1362087261896,1362087262088,2508640096,2508640288,192
1362087263,2508641208,6,461,76.83333333,1362087259264,1362087259392,2508637472,2508637600,128
1362087269,2508647072,3,169,56.33333333,1362087242373,1362087242437,2508620445,2508620509,64
1362087271,2508649092,7,2768,395.4285714,1362087247348,1362087263412,2508625440,2508641504,16064
1362087271,2508649124,5,643,128.6,1362087263956,1362087264084,2508642080,2508642208,128
1362087271,2508649136,6,574,95.66666667,1362087246791,1362087267591,2508624927,2508645727,20800
1362087271,2508649216,6,574,95.66666667,1362087246712,1362087267256,2508624928,2508645472,20544
1362087273,1146965208,2,334,167,1362087247244,1362087247244,1146939452,1146939452,0
1362087273,1146965228,6,1723,287.1666667,1362087248632,1362087249976,1146940860,1146942204,1344
1362087273,2508651124,12,4201,350.0833333,1362087247633,1362087250193,2508625757,2508628317,2560
1362087273,2508651176,1,415,415,1362087246686,1362087246686,2508624862,2508624862,0
1362087273,2508651208,6,2301,383.5,1362087245117,1362087248125,2508623325,2508626333,3008
1362087273,2508651288,8,3785,473.125,1362087248236,1362087249324,2508626524,2508627612,1088
1362087273,2508651292,4,784,196,1362087248553,1362087248873,2508626845,2508627165,320
1362087277,1146969184,3,493,164.3333333,1362087249894,1362087250214,1146942078,1146942398,320
1362087277,2508655092,7,4320,617.1428571,1362087249457,1362087250033,2508627549,2508628125,576
1362087277,2508655096,6,3765,627.5,1362087249520,1362087249840,2508627616,2508627936,320
1362087277,2508655100,5,1094,218.8,1362087249836,1362087250348,2508627936,2508628448,512
1362087277,2508655220,7,3538,505.4285714,1362087249332,1362087249908,2508627552,2508628128,576
1362087277,2508655220,4,1300,325,1362087249331,1362087249651,2508627551,2508627871,320
1362087279,2508657188,6,461,76.83333333,1362087274258,1362087274386,2508652446,2508652574,128
1362087285,2508663104,6,336,56,1362087257253,1362087273957,2508635357,2508652061,16704
1362087285,2508663156,6,336,56,1362087259251,1362087274291,2508637407,2508652447,15040
1362087285,2508663276,6,576,96,1362087259257,1362087274105,2508637533,2508652381,14848
1362087287,2508665116,2,92,46,1362087286364,1362087286364,2508664480,2508664480,0
1362087287,2508665200,3,138,46,1362087286280,1362087286280,2508664480,2508664480,0
1362087289,2508667148,5,280,56,1362087261945,1362087273977,2508640093,2508652125,12032
1362087295,2508673084,3,138,46,1362087289465,1362087289529,2508667549,2508667613,64
1362087297,2508675288,13,2231,171.6153846,1362087270062,1362087273774,2508648350,2508652062,3712
1362087301,2508679340,3,608,202.6666667,1362087273145,1362087273273,2508651485,2508651613,128
1362087303,2508681128,2,92,46,1362087299344,1362087299344,2508677472,2508677472,0
1362087303,2508681132,2,92,46,1362087300362,1362087300362,2508678494,2508678494,0
1362087303,2508681204,2,92,46,1362087299266,1362087299266,2508677470,2508677470,0
1362087303,2508681204,2,92,46,1362087299266,1362087299266,2508677470,2508677470,0
1362087303,2508681212,2,92,46,1362087300282,1362087300282,2508678494,2508678494,0
1362087303,2508681212,3,138,46,1362087300282,1362087300282,2508678494,2508678494,0
1362087305,2508683320,3,138,46,1362087280269,1362087280269,2508658589,2508658589,0
1362087309,2508687320,2,92,46,1362087284109,1362087284173,2508662429,2508662493,64
1362087311,2508689132,6,461,76.83333333,1362087304329,1362087304457,2508682461,2508682589,128
1362087313,2508691196,2,123,61.5,1362087286217,1362087286217,2508664413,2508664413,0
1362087313,2508691196,2,92,46,1362087286281,1362087286281,2508664477,2508664477,0
1362087313,2508691248,2,92,46,1362087285206,1362087285206,2508663454,2508663454,0
1362087313,2508691284,1,46,46,1362087286194,1362087286194,2508664478,2508664478,0
1362087317,1147009180,1,46,46,1362087289833,1362087289833,1146982013,1146982013,0
1362087317,2508695112,2,92,46,1362087289373,1362087289373,2508667485,2508667485,0
1362087317,2508695312,1,46,46,1362087292312,1362087292312,2508670624,2508670624,0
1362087319,2508697084,1,46,46,1362087292857,1362087292857,2508670941,2508670941,0
1362087321,2508699204,1,46,46,1362087294209,1362087294209,2508672413,2508672413,0
1362087325,2508703184,2,92,46,1362087299287,1362087299287,2508677471,2508677471,0
1362087325,2508703288,1,46,46,1362087298541,1362087298541,2508676829,2508676829,0
1362087325,2508703296,1,46,46,1362087299174,1362087299174,2508677470,2508677470,0
1362087325,2508703344,1,46,46,1362087300662,1362087300662,2508679006,2508679006,0
1362087327,2508705096,6,786,131,1362087322028,1362087322156,2508700124,2508700252,128
1362087327,2508705212,9,4713,523.6666667,1362087326137,1362087326393,2508704349,2508704605,256
1362087327,2508705220,5,643,128.6,1362087323888,1362087324016,2508702108,2508702236,128
1362087329,2508707192,1,46,46,1362087301968,1362087301968,2508680160,2508680160,0
1362087329,2508707260,1,46,46,1362087304457,1362087304457,2508682717,2508682717,0
1362087329,2508707280,8,1118,139.75,1362087301172,1362087325300,2508679452,2508703580,24128
1362087333,1147025700,4,190,47.5,1362087324895,1362087330975,1147017595,1147023675,6080
1362087333,1147025704,3,144,48,1362087326812,1362087331996,1147019516,1147024700,5184
1362087333,2508711168,1,46,46,1362087307300,1362087307300,2508685468,2508685468,0
1362087333,2508711284,1,46,46,1362087307122,1362087307122,2508685406,2508685406,0
1362087333,2508711324,3,138,46,1362087308363,1362087308427,2508686687,2508686751,64
1362087335,2508713088,8,2901,362.625,1362087326903,1362087332087,2508704991,2508710175,5184
1362087335,2508713092,2,98,49,1362087325168,1362087331056,2508703260,2508709148,5888
1362087335,2508713100,2,98,49,1362087325482,1362087331050,2508703582,2508709150,5568
1362087335,2508713100,2,98,49,1362087325482,1362087331050,2508703582,2508709150,5568
1362087335,2508713132,2,98,49,1362087325899,1362087331019,2508704031,2508709151,5120
1362087335,2508713136,11,4408,400.7272727,1362087326212,1362087332036,2508704348,2508710172,5824
1362087335,2508713148,3,144,48,1362087324026,1362087329978,2508702174,2508708126,5952
1362087335,2508713148,3,144,48,1362087324026,1362087330042,2508702174,2508708190,6016
1362087335,2508713148,2,98,49,1362087324090,1362087329978,2508702238,2508708126,5888
1362087335,2508713148,10,3413,341.3,1362087326841,1362087327097,2508704989,2508705245,256
1362087335,2508713172,4,184,46,1362087326816,1362087327904,2508704988,2508706076,1088
1362087335,2508713176,9,568,63.11111111,1362087324894,1362087330974,2508703070,2508709150,6080
1362087335,2508713224,2,92,46,1362087326191,1362087331951,2508704415,2508710175,5760
1362087335,2508713252,3,144,48,1362087323923,1362087329939,2508702175,2508708191,6016
1362087335,2508713252,6,461,76.83333333,1362087326738,1362087326866,2508704990,2508705118,128
1362087341,2508719312,6,1298,216.3333333,1362087313109,1362087324821,2508691421,2508703133,11712
1362087343,2508721116,7,1298,185.4285714,1362087325019,1362087335387,2508703135,2508713503,10368
1362087343,2508721116,104,123948,1191.807692,1362087325145,1362087337689,2508703261,2508715805,12544
1362087343,2508721208,6,455,75.83333333,1362087341758,1362087341950,2508719966,2508720158,192
1362087343,2508721244,28,20700,739.2857143,1362087323483,1362087337563,2508701727,2508715807,14080
1362087349,2508727176,5,480,96,1362087324829,1362087337629,2508703005,2508715805,12800
1362087349,2508727256,16,9606,600.375,1362087323919,1362087325583,2508702175,2508703839,1664
1362087349,2508727256,45,43148,958.8444444,1362087323916,1362087327308,2508702172,2508705564,3392
1362087349,2508727256,31,23690,764.1935484,1362087323916,1362087327244,2508702172,2508705500,3328
1362087349,2508727256,29,21274,733.5862069,1362087323916,1362087327244,2508702172,2508705500,3328
1362087349,2508727256,6,336,56,1362087324300,1362087341708,2508702556,2508719964,17408
1362087349,2508727264,6,336,56,1362087324615,1362087344327,2508702879,2508722591,19712
1362087349,2508727264,1,415,415,1362087324422,1362087324422,2508702686,2508702686,0
1362087349,2508727344,23,27738,1206,1362087323829,1362087326069,2508702173,2508704413,2240
1362087349,2508727344,22,16681,758.2272727,1362087323829,1362087327157,2508702173,2508705501,3328
1362087349,2508727348,26,20314,781.3076923,1362087323827,1362087327219,2508702175,2508705567,3392
1362087349,2508727376,6,336,56,1362087324436,1362087341652,2508702812,2508720028,17216
1362087351,2508729164,7,412,58.85714286,1362087344427,1362087344491,2508722591,2508722655,64
1362087353,1147045236,2,334,167,1362087325042,1362087325042,1147017278,1147017278,0
1362087353,1147045260,51,58865,1154.215686,1362087326938,1362087327194,1147019198,1147019454,256
1362087353,2508731196,14,11051,789.3571429,1362087324999,1362087326087,2508703195,2508704283,1088
1362087353,2508731196,9,9042,1004.666667,1362087325066,1362087325578,2508703262,2508703774,512
1362087353,2508731312,13,12463,958.6923077,1362087324949,1362087325077,2508703261,2508703389,128
1362087353,2508731316,5,1818,363.6,1362087325073,1362087325649,2508703389,2508703965,576
1362087353,2508731352,24,27232,1134.666667,1362087325551,1362087325743,2508703903,2508704095,192
1362087353,2508731356,4,1434,358.5,1362087325800,1362087325992,2508704156,2508704348,192
1362087359,2508737192,6,461,76.83333333,1362087356811,1362087356939,2508735003,2508735131,128
1362087367,2508745112,2,92,46,1362087364956,1362087364956,2508743068,2508743068,0
1362087367,2508745128,2,92,46,1362087365900,1362087365900,2508744028,2508744028,0
1362087383,2508761200,7,832,118.8571429,1362087381893,1362087382085,2508760093,2508760285,192
1362087383,2508761208,3,144,48,1362087371004,1362087376124,2508749212,2508754332,5120
1362087389,2508767544,6,1101,183.5,1362087363758,1362087374766,2508742302,2508753310,11008
1362087390,2508767696,2,92,46,1362087365308,1362087365372,2508743004,2508743068,64
1362087391,2508769152,6,461,76.83333333,1362087386806,1362087386934,2508764958,2508765086,128
1362087391,2508769236,5,643,128.6,1362087383842,1362087383970,2508762078,2508762206,128
1362087393,1147085196,2,92,46,1362087365336,1362087365400,1147057532,1147057596,64
1362087393,1147085196,1,46,46,1362087365336,1362087365336,1147057532,1147057532,0
1362087394,2508771596,2,92,46,1362087366431,1362087366431,2508744027,2508744027,0
1362087394,2508771600,1,46,46,1362087366427,1362087366427,2508744027,2508744027,0
1362087394,2508771600,1,46,46,1362087366427,1362087366427,2508744027,2508744027,0
1362087394,2508771600,1,46,46,1362087366431,1362087366431,2508744031,2508744031,0
1362087398,2508775612,7,1272,181.7142857,1362087371088,1362087371344,2508748700,2508748956,256
1362087410,2508787624,3,169,56.33333333,1362087384003,1362087384067,2508761627,2508761691,64
1362087439,2508817200,1844,2554495,1385.300976,1362087428610,1362087435906,2508806810,2508814106,7296
1362087439,2508817280,6,461,76.83333333,1362087431732,1362087431860,2508810012,2508810140,128
1362087441,2508819504,3,492,164,1362087414741,1362087414869,2508793245,2508793373,128
1362087445,2508823524,13,5535,425.7692308,1362087417854,1362087429630,2508796378,2508808154,11776
1362087447,2508825168,2,92,46,1362087441698,1362087441698,2508819866,2508819866,0
1362087447,2508825176,6,786,131,1362087441946,1362087442138,2508820122,2508820314,192
1362087447,2508825204,2,92,46,1362087442689,1362087442689,2508820893,2508820893,0
1362087447,2508825204,2,92,46,1362087442689,1362087442689,2508820893,2508820893,0
1362087447,2508825204,2,92,46,1362087442689,1362087442689,2508820893,2508820893,0
1362087447,2508825204,2,92,46,1362087442689,1362087442689,2508820893,2508820893,0
1362087447,2508825252,2,92,46,1362087441614,1362087441614,2508819866,2508819866,0
1362087447,2508825288,2,92,46,1362087442603,1362087442603,2508820891,2508820891,0
1362087447,2508825304,6,689,114.8333333,1362087443805,1362087444253,2508822109,2508822557,448
1362087454,2508831844,19,1824,96,1362087429478,1362087444198,2508807322,2508822042,14720
1362087457,2508835536,19,1064,56,1362087428917,1362087443637,2508807453,2508822173,14720
1362087457,2508835540,19,1064,56,1362087429102,1362087443758,2508807642,2508822298,14656
1362087457,2508835544,19,1064,56,1362087429227,1362087444011,2508807771,2508822555,14784
1362087463,2508841176,6,461,76.83333333,1362087461851,1362087461979,2508840027,2508840155,128
1362087465,1147157456,2,92,46,1362087439956,1362087439956,1147132412,1147132412,0
1362087466,2508843616,1,46,46,1362087441227,1362087441227,2508818843,2508818843,0
1362087466,2508843688,1,46,46,1362087440132,1362087440132,2508817820,2508817820,0
1362087466,2508843736,2,92,46,1362087441107,1362087441107,2508818843,2508818843,0
1362087469,1147161504,2,92,46,1362087442920,1362087442920,1147135424,1147135424,0
1362087470,2508847632,1,46,46,1362087442234,1362087442234,2508819866,2508819866,0
1362087470,2508847632,2,92,46,1362087442234,1362087442234,2508819866,2508819866,0
1362087470,2508847668,3,169,56.33333333,1362087443033,1362087443033,2508820701,2508820701,0
1362087470,2508847756,2,92,46,1362087442111,1362087442111,2508819867,2508819867,0
1362087470,2508847756,1,46,46,1362087442111,1362087442111,2508819867,2508819867,0
1362087479,2508857196,4,190,47.5,1362087471305,1362087476361,2508849501,2508854557,5056
1362087479,2508857272,2,98,49,1362087471226,1362087476282,2508849498,2508854554,5056
1362087479,2508857320,6,455,75.83333333,1362087476683,1362087476811,2508855003,2508855131,128
1362087482,2508859624,7,2098,299.7142857,1362087455618,1362087462914,2508833242,2508840538,7296
1362087487,2508865192,6,499,83.16666667,1362087477517,1362087480461,2508855709,2508858653,2944
1362087495,2508873360,6,455,75.83333333,1362087491621,1362087492197,2508869981,2508870557,576
1362087498,2508875864,10,1933,193.3,1362087471121,1362087473617,2508848985,2508851481,2496
1362087503,2508881200,6,786,131,1362087501892,1362087502084,2508880092,2508880284,192
1362087506,2508883684,1,46,46,1362087478022,1362087478022,2508855706,2508855706,0
1362087511,2508889232,5,643,128.6,1362087503842,1362087503970,2508882074,2508882202,128
1362087511,2508889276,9,497,55.22222222,1362087501365,1362087505781,2508879641,2508884057,4416
1362087514,2508891788,1,46,46,1362087488608,1362087488608,2508866396,2508866396,0
1362087519,2508897248,4,523,130.75,1362087496082,1362087511826,2508874330,2508890074,15744
1362087527,2508905304,2,92,46,1362087513948,1362087525468,2508892252,2508903772,11520
1362087527,2508905304,2,98,49,1362087514011,1362087525467,2508892315,2508903771,11456
1362087530,2508907764,6,1943,323.8333333,1362087502840,1362087528824,2508880604,2508906588,25984
1362087533,1147225892,3,144,48,1362087517601,1362087525409,1147210493,1147218301,7808
1362087535,2508913240,5,415,83,1362087534044,1362087534172,2508912284,2508912412,128
1362087541,1147233480,12,6513,542.75,1362087516222,1362087538622,1147208702,1147231102,22400
1362087542,2508919720,5,460,92,1362087514594,1362087514658,2508892314,2508892378,64
1362087542,2508919724,94,114228,1215.191489,1362087514716,1362087517852,2508892440,2508895576,3136
1362087542,2508919752,37,32260,871.8918919,1362087515394,1362087534978,2508893146,2508912730,19584
1362087542,2508919752,66,45847,694.6515152,1362087515457,1362087538945,2508893209,2508916697,23488
1362087542,2508919788,21,15614,743.5238095,1362087516383,1362087528863,2508894171,2508906651,12480
1362087542,2508919788,12,8313,692.75,1362087516509,1362087528989,2508894297,2508906777,12480
1362087543,2508921264,4,317,79.25,1362087541572,1362087541572,2508919836,2508919836,0
1362087543,2508921268,4,864,216,1362087541821,1362087541949,2508920089,2508920217,128
1362087543,2508921304,2,94,47,1362087536089,1362087542041,2508914393,2508920345,5952
1362087543,2508921304,4,190,47.5,1362087536089,1362087537241,2508914393,2508915545,1152
1362087543,2508921308,2,98,49,1362087536087,1362087542039,2508914395,2508920347,5952
1362087543,2508921308,2,98,49,1362087536087,1362087542039,2508914395,2508920347,5952
1362087543,2508921344,2,98,49,1362087532148,1362087541044,2508910492,2508919388,8896
1362087543,2508921352,3,1442,480.6666667,1362087541032,1362087541416,2508919384,2508919768,384
1362087543,2508921352,6,473,78.83333333,1362087541032,1362087541864,2508919384,2508920216,832
1362087543,2508921352,6,426,71,1362087541482,1362087541674,2508919834,2508920026,192
1362087543,2508921352,5,381,76.2,1362087541481,1362087541737,2508919833,2508920089,256
1362087543,2508921404,3,869,289.6666667,1362087534583,1362087538167,2508912987,2508916571,3584
1362087543,2508921420,3,144,48,1362087536103,1362087541991,2508914523,2508920411,5888
1362087543,2508921428,3,144,48,1362087532063,1362087540959,2508910491,2508919387,8896
1362087543,2508921428,2,98,49,1362087532063,1362087540895,2508910491,2508919323,8832
1362087543,2508921428,2,98,49,1362087532063,1362087540959,2508910491,2508919387,8896
1362087543,2508921468,5,380,76,1362087540728,1362087541368,2508919196,2508919836,640
1362087543,2508921468,15,14465,964.3333333,1362087540728,1362087540920,2508919196,2508919388,192
1362087543,2508921468,16,5521,345.0625,1362087540855,1362087541623,2508919323,2508920091,768
1362087543,2508921468,4,190,47.5,1362087540919,1362087542007,2508919387,2508920475,1088
1362087543,2508921468,4,1415,353.75,1362087540919,1362087541559,2508919387,2508920027,640
1362087545,1147237448,60,69751,1162.516667,1362087518045,1362087537949,1147210493,1147230397,19904
1362087545,1147237448,60,65072,1084.533333,1362087518045,1362087538717,1147210493,1147231165,20672
1362087545,1147237448,37,38828,1049.405405,1362087518045,1362087535005,1147210493,1147227453,16960
1362087545,1147237448,47,47298,1006.340426,1362087518045,1362087540829,1147210493,1147233277,22784
1362087545,1147237448,39,35193,902.3846154,1362087518045,1362087535133,1147210493,1147227581,17088
1362087545,1147237448,48,50113,1044.020833,1362087518109,1362087535709,1147210557,1147228157,17600
1362087545,1147237448,62,69821,1126.145161,1362087518109,1362087539037,1147210557,1147231485,20928
1362087545,1147237448,28,22800,814.2857143,1362087518109,1362087539165,1147210557,1147231613,21056
1362087545,1147237448,45,47209,1049.088889,1362087518109,1362087536029,1147210557,1147228477,17920
1362087545,1147237448,29,25570,881.7241379,1362087518109,1362087536541,1147210557,1147228989,18432
1362087545,1147237448,28,28056,1002,1362087518109,1362087534877,1147210557,1147227325,16768
1362087545,1147237448,64,75253,1175.828125,1362087518109,1362087541085,1147210557,1147233533,22976
1362087545,1147237448,54,56628,1048.666667,1362087518113,1362087541217,1147210561,1147233665,23104
1362087545,1147237448,62,67748,1092.709677,1362087518113,1362087541345,1147210561,1147233793,23232
1362087545,1147237452,42,46469,1106.404762,1362087518043,1362087535067,1147210495,1147227519,17024
1362087545,1147237452,51,50720,994.5098039,1362087518043,1362087540955,1147210495,1147233407,22912
1362087545,1147237452,54,57404,1063.037037,1362087518043,1362087538459,1147210495,1147230911,20416
1362087545,1147237452,29,25890,892.7586207,1362087518042,1362087535322,1147210494,1147227774,17280
1362087545,1147237452,59,66512,1127.322034,1362087518042,1362087538778,1147210494,1147231230,20736
1362087545,1147237452,54,58919,1091.092593,1362087518042,1362087538906,1147210494,1147231358,20864
1362087545,1147237452,50,54469,1089.38,1362087518106,1362087536602,1147210558,1147229054,18496
1362087545,1147237568,62,68810,1109.83871,1362087520679,1362087539751,1147213247,1147232319,19072
1362087545,1147237568,46,49655,1079.456522,1362087520678,1362087538406,1147213246,1147230974,17728
1362087545,1147237568,61,68110,1116.557377,1362087520678,1362087539622,1147213246,1147232190,18944
1362087545,1147237568,50,56548,1130.96,1362087520678,1362087537254,1147213246,1147229822,16576
1362087545,1147237568,56,59508,1062.642857,1362087520678,1362087540006,1147213246,1147232574,19328
1362087545,1147237568,51,50637,992.8823529,1362087520678,1362087540134,1147213246,1147232702,19456
1362087545,1147237568,59,62257,1055.20339,1362087520678,1362087540454,1147213246,1147233022,19776
1362087545,1147237576,50,50617,1012.34,1362087517920,1362087540384,1147210496,1147232960,22464
1362087545,1147237576,42,40893,973.6428571,1362087517920,1362087537632,1147210496,1147230208,19712
1362087545,1147237580,58,61736,1064.413793,1362087517916,1362087537756,1147210496,1147230336,19840
1362087545,1147237580,71,79365,1117.816901,1362087517916,1362087540252,1147210496,1147232832,22336
1362087545,1147237580,54,62528,1157.925926,1362087517916,1362087534812,1147210496,1147227392,16896
1362087545,1147237580,52,52956,1018.384615,1362087517916,1362087540508,1147210496,1147233088,22592
1362087545,1147237580,65,72680,1118.153846,1362087517916,1362087540572,1147210496,1147233152,22656
1362087545,1147237580,59,62979,1067.440678,1362087517916,1362087540636,1147210496,1147233216,22720
1362087545,1147237580,60,64959,1082.65,1362087517916,1362087540764,1147210496,1147233344,22848
1362087545,1147237580,33,32616,988.3636364,1362087517916,1362087535068,1147210496,1147227648,17152
1362087545,1147237580,48,51637,1075.770833,1362087517916,1362087538268,1147210496,1147230848,20352
1362087545,1147237580,38,38115,1003.026316,1362087517980,1362087538780,1147210560,1147231360,20800
1362087545,1147237580,52,55550,1068.269231,1362087517980,1362087538972,1147210560,1147231552,20992
1362087545,1147237580,38,41937,1103.605263,1362087517916,1362087535324,1147210496,1147227904,17408
1362087545,1147237580,61,65815,1078.934426,1362087517916,1362087538716,1147210496,1147231296,20800
1362087545,1147237580,41,44384,1082.536585,1362087517980,1362087532572,1147210560,1147225152,14592
1362087545,1147237580,40,41003,1025.075,1362087517980,1362087535836,1147210560,1147228416,17856
1362087545,1147237580,57,64773,1136.368421,1362087517980,1362087535964,1147210560,1147228544,17984
1362087545,1147237580,52,53367,1026.288462,1362087517980,1362087541020,1147210560,1147233600,23040
1362087545,1147237580,42,37315,888.452381,1362087517980,1362087541020,1147210560,1147233600,23040
1362087545,1147237580,67,71707,1070.253731,1362087517980,1362087541148,1147210560,1147233728,23168
1362087545,1147237616,62,66432,1071.483871,1362087520629,1362087539381,1147213245,1147231997,18752
1362087545,1147237620,69,76496,1108.637681,1362087520628,1362087542900,1147213248,1147235520,22272
1362087545,1147237620,57,63878,1120.666667,1362087520628,1362087537012,1147213248,1147229632,16384
1362087545,1147237620,51,52161,1022.764706,1362087520628,1362087539828,1147213248,1147232448,19200
1362087545,1147237620,56,63038,1125.678571,1362087520628,1362087539636,1147213248,1147232256,19008
1362087545,1147237620,48,49038,1021.625,1362087520628,1362087539892,1147213248,1147232512,19264
1362087545,1147237620,42,37325,888.6904762,1362087520628,1362087540148,1147213248,1147232768,19520
1362087545,1147237620,48,50499,1052.0625,1362087520628,1362087540020,1147213248,1147232640,19392
1362087545,1147237620,36,34873,968.6944444,1362087520628,1362087540276,1147213248,1147232896,19648
1362087545,1147237620,46,48027,1044.065217,1362087520628,1362087539444,1147213248,1147232064,18816
1362087545,1147237620,48,51167,1065.979167,1362087520628,1362087539764,1147213248,1147232384,19136
1362087546,2508923976,13,728,56,1362087517986,1362087544802,2508895962,2508922778,26816
1362087546,2508923980,13,728,56,1362087518239,1362087544927,2508896219,2508922907,26688
1362087546,2508924088,14,1344,96,1362087517620,1362087545140,2508895708,2508923228,27520
1362087546,2508924092,14,784,56,1362087517807,1362087545455,2508895899,2508923547,27648
1362087549,1147241888,2,98,49,1362087541032,1362087546984,1147233920,1147239872,5952
1362087549,1147241888,2,98,49,1362087541032,1362087546984,1147233920,1147239872,5952
1362087549,1147241888,4,190,47.5,1362087541989,1362087548005,1147234877,1147240893,6016
1362087549,1147241896,2,98,49,1362087541023,1362087546975,1147233919,1147239871,5952
1362087549,1147241896,3,144,48,1362087541470,1362087546974,1147234366,1147239870,5504
1362087549,1147241896,9,590,65.55555556,1362087541725,1362087546973,1147234621,1147239869,5248
1362087551,2508929248,2,98,49,1362087541841,1362087547089,2508920089,2508925337,5248
1362087551,2508929252,2,98,49,1362087543374,1362087549070,2508921626,2508927322,5696
1362087551,2508929252,3,144,48,1362087541966,1362087547086,2508920218,2508925338,5120
1362087551,2508929252,2,98,49,1362087541966,1362087547086,2508920218,2508925338,5120
1362087551,2508929252,2,98,49,1362087543437,1362087549069,2508921689,2508927321,5632
1362087551,2508929256,2,98,49,1362087543436,1362087549132,2508921692,2508927388,5696
1362087551,2508929256,2,98,49,1362087543436,1362087549068,2508921692,2508927324,5632
1362087551,2508929260,8,2252,281.5,1362087542084,1362087548100,2508920344,2508926360,6016
1362087551,2508929276,2,98,49,1362087542263,1362087548087,2508920539,2508926363,5824
1362087551,2508929280,2,98,49,1362087542260,1362087548084,2508920540,2508926364,5824
1362087551,2508929320,2,98,49,1362087541067,1362087547019,2508919387,2508925339,5952
1362087551,2508929320,9,4944,549.3333333,1362087541002,1362087547018,2508919322,2508925338,6016
1362087551,2508929320,2,98,49,1362087541066,1362087547018,2508919386,2508925338,5952
1362087551,2508929328,3,150,50,1362087541698,1362087547010,2508920026,2508925338,5312
1362087551,2508929328,2,98,49,1362087541762,1362087547010,2508920090,2508925338,5248
1362087551,2508929332,2,92,46,1362087541757,1362087547005,2508920089,2508925337,5248
1362087551,2508929332,4,2500,625,1362087543231,1362087543295,2508921563,2508921627,64
1362087551,2508929356,2,98,49,1362087541861,1362087546981,2508920217,2508925337,5120
1362087551,2508929356,2,98,49,1362087541861,1362087546981,2508920217,2508925337,5120
1362087551,2508929356,3,144,48,1362087543333,1362087549029,2508921689,2508927385,5696
1362087551,2508929356,2,98,49,1362087543333,1362087548965,2508921689,2508927321,5632
1362087551,2508929356,2,98,49,1362087543332,1362087548964,2508921688,2508927320,5632
1362087551,2508929360,2,98,49,1362087542176,1362087548000,2508920536,2508926360,5824
1362087551,2508929364,2,98,49,1362087542176,1362087548000,2508920540,2508926364,5824
1362087551,2508929364,2,98,49,1362087543584,1362087548960,2508921948,2508927324,5376
1362087551,2508929372,2,98,49,1362087543959,1362087548951,2508922331,2508927323,4992
1362087551,2508929408,3,144,48,1362087540980,1362087546932,2508919388,2508925340,5952
1362087557,1147249892,8,1452,181.5,1362087544612,1362087549988,1147237504,1147242880,5376
1362087557,1147249896,3,144,48,1362087543325,1362087549021,1147236221,1147241917,5696
1362087557,1147249920,2,98,49,1362087543302,1362087548934,1147236222,1147241854,5632
1362087557,1147249920,2,98,49,1362087543302,1362087548998,1147236222,1147241918,5696
1362087559,2508937236,8,1055,131.875,1362087541854,1362087552030,2508920090,2508930266,10176
1362087559,2508937244,3,150,50,1362087546644,1362087552148,2508924888,2508930392,5504
1362087559,2508937244,4,196,49,1362087546644,1362087552212,2508924888,2508930456,5568
1362087559,2508937324,3,150,50,1362087546439,1362087552071,2508924763,2508930395,5632
1362087559,2508937344,3,150,50,1362087546545,1362087552049,2508924889,2508930393,5504
1362087559,2508937344,3,150,50,1362087546545,1362087552049,2508924889,2508930393,5504
1362087562,2508939940,10,8519,851.9,1362087534406,1362087534726,2508912346,2508912666,320
1362087562,2508940052,5,1012,202.4,1362087534934,1362087535190,2508912986,2508913242,256
1362087566,2508943968,3,1423,474.3333333,1362087539435,1362087541419,2508917403,2508919387,1984
1362087566,2508944052,34,40623,1194.794118,1362087541716,1362087544084,2508919768,2508922136,2368
1362087566,2508944056,1,46,46,1362087538130,1362087538130,2508916186,2508916186,0
1362087566,2508944172,13,7269,559.1538462,1362087541214,1362087541662,2508919386,2508919834,448
1362087567,2508945248,3,144,48,1362087554513,1362087560081,2508932761,2508938329,5568
1362087569,1147261456,14,15740,1124.285714,1362087541461,1362087541525,1147233917,1147233981,64
1362087569,1147261512,6,3548,591.3333333,1362087541407,1362087541535,1147233919,1147234047,128
1362087569,1147261512,17,18689,1099.352941,1362087541406,1362087541598,1147233918,1147234110,192
1362087570,2508948024,14,8715,622.5,1362087543216,1362087543408,2508921240,2508921432,192
1362087570,2508948024,10,10477,1047.7,1362087541812,1362087543412,2508919836,2508921436,1600
1362087570,2508948024,5,1034,206.8,1362087543283,1362087543667,2508921307,2508921691,384
1362087570,2508948024,12,8619,718.25,1362087543283,1362087543731,2508921307,2508921755,448
1362087570,2508948024,4,317,79.25,1362087543283,1362087543411,2508921307,2508921435,128
1362087570,2508948024,13,9901,761.6153846,1362087541809,1362087543537,2508919833,2508921561,1728
1362087570,2508948032,10,4536,453.6,1362087542058,1362087542634,2508920090,2508920666,576
1362087570,2508948032,3,480,160,1362087542056,1362087542184,2508920088,2508920216,128
1362087570,2508948036,3,456,152,1362087542245,1362087542309,2508920281,2508920345,64
1362087570,2508948036,4,622,155.5,1362087543653,1362087543781,2508921689,2508921817,128
1362087570,2508948096,3,513,171,1362087542121,1362087542121,2508920217,2508920217,0
1362087570,2508948100,12,4955,412.9166667,1362087542248,1362087545768,2508920348,2508923868,3520
1362087570,2508948104,4,470,117.5,1362087542434,1362087542754,2508920538,2508920858,320
1362087570,2508948104,3,424,141.3333333,1362087542434,1362087542626,2508920538,2508920730,192
1362087570,2508948236,23,17018,739.9130435,1362087545311,1362087546143,2508923547,2508924379,832
1362087570,2508948236,10,3713,371.3,1362087545437,1362087546077,2508923673,2508924313,640
1362087570,2508948236,12,6070,505.8333333,1362087545437,1362087546141,2508923673,2508924377,704
1362087570,2508948244,8,1239,154.875,1362087541588,1362087541972,2508919832,2508920216,384
1362087570,2508948244,6,483,80.5,1362087543000,1362087543192,2508921244,2508921436,192
1362087570,2508948244,11,10373,943,1362087543000,1362087543640,2508921244,2508921884,640
1362087570,2508948244,13,8575,659.6153846,1362087543063,1362087543383,2508921307,2508921627,320
1362087570,2508948296,40,36856,921.4,1362087543392,1362087561376,2508921688,2508939672,17984
1362087570,2508948296,5,881,176.2,1362087543392,1362087543712,2508921688,2508922008,320
1362087570,2508948300,34,24229,712.6176471,1362087543456,1362087544672,2508921756,2508922972,1216
1362087570,2508948304,4,566,141.5,1362087542044,1362087542172,2508920348,2508920476,128
1362087570,2508948304,6,2381,396.8333333,1362087543640,1362087544024,2508921944,2508922328,384
1362087570,2508948308,28,31610,1128.928571,1362087542230,1362087542422,2508920538,2508920730,192
1362087570,2508948308,5,3113,622.6,1362087542230,1362087542486,2508920538,2508920794,256
1362087570,2508948308,5,619,123.8,1362087542230,1362087542614,2508920538,2508920922,384
1362087570,2508948376,39,24265,622.1794872,1362087542480,1362087543056,2508920856,2508921432,576
1362087570,2508948440,14,7867,561.9285714,1362087545107,1362087545811,2508923547,2508924251,704
1362087570,2508948440,22,14369,653.1363636,1362087545235,1362087545939,2508923675,2508924379,704
1362087570,2508948440,11,4174,379.4545455,1362087545234,1362087545874,2508923674,2508924314,640
1362087570,2508948440,15,7518,501.2,1362087545234,1362087546002,2508923674,2508924442,768
1362087573,1147265908,3,144,48,1362087564116,1362087570132,1147257024,1147263040,6016
1362087574,2508951920,28,1568,56,1362087545945,1362087573785,2508923865,2508951705,27840
1362087574,2508951928,27,1512,56,1362087546196,1362087573332,2508924124,2508951260,27136
1362087574,2508951936,4,1082,270.5,1362087546635,1362087546827,2508924571,2508924763,192
1362087574,2508951936,4,1059,264.75,1362087546635,1362087546891,2508924571,2508924827,256
1362087574,2508951940,5,2507,501.4,1362087546951,1362087547143,2508924891,2508925083,192
1362087574,2508952048,27,2592,96,1362087546200,1362087573272,2508924248,2508951320,27072
1362087574,2508952056,27,1512,56,1362087546452,1362087573460,2508924508,2508951516,27008
1362087574,2508952060,5,1936,387.2,1362087546830,1362087547086,2508924890,2508925146,256
1362087575,2508953236,5,415,83,1362087566941,1362087567069,2508945177,2508945305,128
1362087578,2508956160,1,46,46,1362087552937,1362087552937,2508931097,2508931097,0
1362087582,2508959972,27,12636,468,1362087554276,1362087561124,2508932248,2508939096,6848
1362087582,2508960052,29,33134,1142.551724,1362087556951,1362087567575,2508935003,2508945627,10624
1362087582,2508960096,4,546,136.5,1362087554538,1362087554666,2508932634,2508932762,128
1362087582,2508960096,4,546,136.5,1362087554538,1362087554602,2508932634,2508932698,64
1362087582,2508960180,29,33131,1142.448276,1362087556821,1362087568597,2508935001,2508946777,11776
1362087598,2508976124,3,138,46,1362087573580,1362087573644,2508951704,2508951768,64
1362087598,2508976256,68,3808,56,1362087573512,1362087597256,2508951768,2508975512,23744
1362087599,2508977316,7,322,46,1362087596494,1362087598350,2508974810,2508976666,1856
1362087599,2508977316,7,322,46,1362087596494,1362087598350,2508974810,2508976666,1856
1362087602,2508980100,79,7584,96,1362087573796,1362087601636,2508951896,2508979736,27840
1362087602,2508980112,79,4424,56,1362087573976,1362087601816,2508952088,2508979928,27840
1362087602,2508980180,6,1213,202.1666667,1362087576470,1362087582614,2508954650,2508960794,6144
1362087602,2508980232,79,4424,56,1362087573923,1362087601635,2508952155,2508979867,27712
1362087602,2508980316,2,92,46,1362087577228,1362087577292,2508955544,2508955608,64
1362087602,2508980316,1,46,46,1362087577228,1362087577228,2508955544,2508955544,0
1362087607,2508985380,2,92,46,1362087600463,1362087604751,2508978843,2508983131,4288
1362087607,2508985380,2,92,46,1362087600462,1362087604878,2508978842,2508983258,4416
1362087607,2508985380,4,215,53.75,1362087600845,1362087605837,2508979225,2508984217,4992
1362087614,2508992300,3,138,46,1362087588060,1362087588124,2508966360,2508966424,64
1362087615,2508993368,6,461,76.83333333,1362087611802,1362087611994,2508990170,2508990362,192
1362087622,2509000212,3,138,46,1362087593974,1362087594038,2508972186,2508972250,64
1362087626,2509004160,2,123,61.5,1362087600554,1362087600618,2508978714,2508978778,64
1362087626,2509004172,1,77,77,1362087601567,1362087601567,2508979739,2508979739,0
1362087626,2509004200,80,4480,56,1362087597762,1362087625538,2508975962,2509003738,27776
1362087626,2509004292,3,169,56.33333333,1362087601447,1362087601447,2508979739,2508979739,0
1362087630,2509008080,79,7584,96,1362087601975,1362087629303,2508980055,2509007383,27328
1362087630,2509008084,79,4424,56,1362087602165,1362087629493,2508980249,2509007577,27328
1362087630,2509008132,3,169,56.33333333,1362087603654,1362087603654,2508981786,2508981786,0
1362087630,2509008132,3,138,46,1362087603654,1362087603718,2508981786,2508981850,64
1362087630,2509008208,3,138,46,1362087601850,1362087601914,2508980058,2508980122,64
1362087630,2509008208,79,4424,56,1362087601977,1362087629305,2508980185,2509007513,27328
1362087630,2509008284,3,169,56.33333333,1362087604461,1362087604461,2508982745,2508982745,0
1362087631,2509009304,4,184,46,1362087627416,1362087627416,2509005720,2509005720,0
1362087631,2509009348,2,92,46,1362087613422,1362087630574,2508991770,2509008922,17152
1362087631,2509009348,3,138,46,1362087628397,1362087628397,2509006745,2509006745,0
1362087634,2509012120,14,3409,243.5,1362087607762,1362087621138,2508985882,2508999258,13376
1362087639,2509017252,2,92,46,1362087613708,1362087631180,2508991960,2509009432,17472
1362087642,2509020112,8,1316,164.5,1362087615643,1362087615835,2508993755,2508993947,192
1362087642,2509020284,1,46,46,1362087616942,1362087616942,2508995226,2508995226,0
1362087646,2509024296,3,138,46,1362087620450,1362087620514,2508998746,2508998810,64
1362087650,2509028140,9,1705,189.4444444,1362087622142,1362087645886,2509000282,2509024026,23744
1362087654,2509032148,73,4088,56,1362087625971,1362087653555,2509004119,2509031703,27584
1362087654,2509032276,63,6048,96,1362087629685,1362087653557,2509007961,2509031833,23872
1362087655,2509033432,161,193446,1201.52795,1362087531864,1362087648856,2508910296,2509027288,116992
1362087658,2509036188,72,4032,56,1362087629902,1362087657486,2509008090,2509035674,27584
1362087658,2509036316,72,4032,56,1362087629901,1362087657421,2509008217,2509035737,27520
1362087661,1147353912,114,131881,1156.850877,1362087517583,1362087659919,1147210495,1147352831,142336
1362087663,2509041296,2,92,46,1362087657954,1362087658018,2509036250,2509036314,64
1362087663,2509041296,3,169,56.33333333,1362087661985,1362087661985,2509040281,2509040281,0
1362087663,2509041296,3,169,56.33333333,1362087661984,1362087661984,2509040280,2509040280,0
1362087663,2509041296,2,123,61.5,1362087661984,1362087661984,2509040280,2509040280,0
1362087663,2509041332,2,92,46,1362087658941,1362087658941,2509037273,2509037273,0
1362087663,2509041384,3,169,56.33333333,1362087661896,1362087661896,2509040280,2509040280,0
1362087663,2509041384,2,123,61.5,1362087661896,1362087661896,2509040280,2509040280,0
1362087663,2509041384,4,215,53.75,1362087661895,1362087661895,2509040279,2509040279,0
1362087663,2509041420,3,138,46,1362087658852,1362087658916,2509037272,2509037336,64
1362087666,2509044256,3,138,46,1362087640328,1362087640328,2509018584,2509018584,0
1362087670,2509048244,2,92,46,1362087643990,1362087643990,2509022234,2509022234,0
1362087673,1147365720,2,92,46,1362087648078,1362087648078,1147340798,1147340798,0
1362087677,1147369720,1,46,46,1362087650063,1362087650063,1147342783,1147342783,0
1362087677,1147369740,1,46,46,1362087651069,1362087651069,1147343809,1147343809,0
1362087677,1147369740,1,46,46,1362087651067,1362087651067,1147343807,1147343807,0
1362087677,1147369740,1,46,46,1362087651067,1362087651067,1147343807,1147343807,0
1362087677,1147369748,1,46,46,1362087652018,1362087652018,1147344766,1147344766,0
1362087677,1147369768,1,46,46,1362087650015,1362087650015,1147342783,1147342783,0
1362087677,1147369768,1,46,46,1362087650015,1362087650015,1147342783,1147342783,0
1362087677,1147369772,2,92,46,1362087650013,1362087650013,1147342785,1147342785,0
1362087677,1147369772,1,46,46,1362087650013,1362087650013,1147342785,1147342785,0
1362087677,1147369776,2,92,46,1362087651031,1362087651031,1147343807,1147343807,0
1362087677,1147369776,1,46,46,1362087651031,1362087651031,1147343807,1147343807,0
1362087677,1147369788,1,46,46,1362087651020,1362087651020,1147343808,1147343808,0
1362087677,1147369788,1,46,46,1362087651020,1362087651020,1147343808,1147343808,0
1362087677,1147369792,1,46,46,1362087652039,1362087652039,1147344831,1147344831,0
1362087677,1147369796,2,92,46,1362087651972,1362087652036,1147344768,1147344832,64
1362087678,2509056188,2,92,46,1362087650062,1362087650062,2509028250,2509028250,0
1362087681,1147373728,1,46,46,1362087653063,1362087653063,1147345791,1147345791,0
1362087681,1147373736,2,92,46,1362087654080,1362087654080,1147346816,1147346816,0
1362087681,1147373736,1,46,46,1362087654080,1362087654080,1147346816,1147346816,0
1362087681,1147373736,2,92,46,1362087654078,1362087654078,1147346814,1147346814,0
1362087681,1147373736,1,46,46,1362087654078,1362087654078,1147346814,1147346814,0
1362087681,1147373736,1,46,46,1362087654078,1362087654078,1147346814,1147346814,0
1362087681,1147373736,1,46,46,1362087654078,1362087654078,1147346814,1147346814,0
1362087681,1147373756,1,46,46,1362087655020,1362087655020,1147347776,1147347776,0
1362087681,1147373756,2,92,46,1362087655019,1362087655019,1147347775,1147347775,0
1362087681,1147373756,1,46,46,1362087655019,1362087655019,1147347775,1147347775,0
1362087681,1147373756,1,46,46,1362087655019,1362087655019,1147347775,1147347775,0
1362087681,1147373756,1,46,46,1362087655018,1362087655018,1147347774,1147347774,0
1362087681,1147373764,1,46,46,1362087656035,1362087656035,1147348799,1147348799,0
1362087681,1147373764,1,46,46,1362087656035,1362087656035,1147348799,1147348799,0
1362087681,1147373764,1,46,46,1362087656035,1362087656035,1147348799,1147348799,0
1362087681,1147373764,1,46,46,1362087656035,1362087656035,1147348799,1147348799,0
1362087681,1147373764,1,46,46,1362087656035,1362087656035,1147348799,1147348799,0
1362087681,1147373776,1,46,46,1362087656025,1362087656025,1147348801,1147348801,0
1362087681,1147373776,1,46,46,1362087656025,1362087656025,1147348801,1147348801,0
1362087681,1147373784,2,92,46,1362087653009,1362087653009,1147345793,1147345793,0
1362087681,1147373784,1,46,46,1362087653008,1362087653008,1147345792,1147345792,0
1362087681,1147373784,1,46,46,1362087653008,1362087653008,1147345792,1147345792,0
1362087681,1147373800,1,46,46,1362087654017,1362087654017,1147346817,1147346817,0
1362087681,1147373800,1,46,46,1362087654017,1362087654017,1147346817,1147346817,0
1362087681,1147373800,1,46,46,1362087654016,1362087654016,1147346816,1147346816,0
1362087681,1147373800,1,46,46,1362087654016,1362087654016,1147346816,1147346816,0
1362087681,1147373800,1,46,46,1362087654016,1362087654016,1147346816,1147346816,0
1362087681,1147373800,1,46,46,1362087654016,1362087654016,1147346816,1147346816,0
1362087681,1147373808,2,92,46,1362087654967,1362087654967,1147347775,1147347775,0
1362087681,1147373808,1,46,46,1362087654967,1362087654967,1147347775,1147347775,0
1362087681,1147373808,1,46,46,1362087654967,1362087654967,1147347775,1147347775,0
1362087681,1147373808,1,46,46,1362087654967,1362087654967,1147347775,1147347775,0
1362087681,1147373812,1,46,46,1362087654965,1362087654965,1147347777,1147347777,0
1362087681,1147373812,1,46,46,1362087654965,1362087654965,1147347777,1147347777,0
1362087681,1147373828,2,92,46,1362087655973,1362087655973,1147348801,1147348801,0
1362087681,1147373828,1,46,46,1362087655973,1362087655973,1147348801,1147348801,0
1362087681,1147373828,1,46,46,1362087655973,1362087655973,1147348801,1147348801,0
1362087681,1147373828,1,46,46,1362087655973,1362087655973,1147348801,1147348801,0
1362087681,1147373828,1,46,46,1362087655972,1362087655972,1147348800,1147348800,0
1362087681,1147373828,1,46,46,1362087655972,1362087655972,1147348800,1147348800,0
1362087681,1147373828,1,46,46,1362087655972,1362087655972,1147348800,1147348800,0
1362087681,1147373828,1,46,46,1362087655972,1362087655972,1147348800,1147348800,0
1362087681,1147373828,1,46,46,1362087655972,1362087655972,1147348800,1147348800,0
1362087682,2509060324,71,3976,56,1362087653764,1362087681732,2509032088,2509060056,27968
1362087682,2509060324,70,6720,96,1362087653891,1362087681475,2509032215,2509059799,27584
1362087682,2509060436,2,92,46,1362087656851,1362087656851,2509035287,2509035287,0
1362087685,1147377728,1,46,46,1362087657095,1362087657095,1147349823,1147349823,0
1362087685,1147377728,1,46,46,1362087657095,1362087657095,1147349823,1147349823,0
1362087685,1147377740,2,92,46,1362087658045,1362087658045,1147350785,1147350785,0
1362087685,1147377784,1,46,46,1362087657039,1362087657039,1147349823,1147349823,0
1362087685,1147377784,2,92,46,1362087657039,1362087657039,1147349823,1147349823,0
1362087685,1147377940,783,970568,1239.550447,1362087564083,1362087682867,1147257023,1147375807,118784
1362087686,2509064192,70,3920,56,1362087657994,1362087685578,2509036186,2509063770,27584
1362087686,2509064192,2,92,46,1362087658057,1362087658057,2509036249,2509036249,0
1362087686,2509064192,1,46,46,1362087658056,1362087658056,2509036248,2509036248,0
1362087686,2509064192,1,46,46,1362087658056,1362087658056,2509036248,2509036248,0
1362087686,2509064220,1,46,46,1362087659051,1362087659051,2509037271,2509037271,0
1362087686,2509064220,1,46,46,1362087659051,1362087659051,2509037271,2509037271,0
1362087686,2509064232,2,123,61.5,1362087659616,1362087659616,2509037848,2509037848,0
1362087686,2509064236,2,92,46,1362087659995,1362087660059,2509038231,2509038295,64
1362087686,2509064276,1,46,46,1362087660981,1362087660981,2509039257,2509039257,0
1362087686,2509064308,71,3976,56,1362087657812,1362087685716,2509036120,2509064024,27904
1362087686,2509064312,2,92,46,1362087657937,1362087658001,2509036249,2509036313,64
1362087686,2509064312,1,46,46,1362087657937,1362087657937,2509036249,2509036249,0
1362087686,2509064312,1,46,46,1362087657937,1362087657937,2509036249,2509036249,0
1362087686,2509064320,2,123,61.5,1362087658504,1362087658568,2509036824,2509036888,64
1362087686,2509064348,1,46,46,1362087658925,1362087658925,2509037273,2509037273,0
1362087686,2509064348,1,46,46,1362087658925,1362087658925,2509037273,2509037273,0
1362087686,2509064348,2,92,46,1362087658924,1362087658924,2509037272,2509037272,0
1362087686,2509064348,1,46,46,1362087658924,1362087658924,2509037272,2509037272,0
1362087686,2509064356,1,77,77,1362087659493,1362087659493,2509037849,2509037849,0
1362087686,2509064404,3,169,56.33333333,1362087661492,1362087661556,2509039896,2509039960,64
1362087687,2509065332,7,353,50.42857143,1362087680253,1362087681021,2509058585,2509059353,768
1362087690,2509068244,2,123,61.5,1362087662674,1362087662674,2509040918,2509040918,0
1362087690,2509068448,1,46,46,1362087664839,1362087664839,2509043287,2509043287,0
1362087694,2509072320,1,46,46,1362087666056,1362087666056,2509044376,2509044376,0
1362087695,2509073304,6,461,76.83333333,1362087686873,1362087687065,2509065177,2509065369,192
1362087698,2509076328,1,46,46,1362087669952,1362087669952,2509048280,2509048280,0
1362087698,2509076328,2,92,46,1362087669951,1362087669951,2509048279,2509048279,0
1362087706,2509084456,9,1918,213.1111111,1362087680896,1362087681152,2509059352,2509059608,256
1362087706,2509084484,61,5856,96,1362087681634,1362087705186,2509060118,2509083670,23552
1362087710,2509088364,62,3472,56,1362087685724,1362087709596,2509064088,2509087960,23872
1362087710,2509088488,71,3976,56,1362087682142,1362087709598,2509060630,2509088086,27456
1362087710,2509088572,3,492,164,1362087684811,1362087684939,2509063383,2509063511,128
1362087714,2509092496,72,4032,56,1362087685848,1362087713688,2509064344,2509092184,27840
1362087719,2509097464,7,412,58.85714286,1362087717560,1362087717560,2509096024,2509096024,0
1362087719,2509097464,8,458,57.25,1362087717559,1362087717559,2509096023,2509096023,0
1362087719,2509097548,7,412,58.85714286,1362087716452,1362087716452,2509095000,2509095000,0
1362087727,2509105392,6,503,83.83333333,1362087718336,1362087721216,2509096728,2509099608,2880
1362087727,2509105400,9,497,55.22222222,1362087719609,1362087724857,2509098009,2509103257,5248
1362087727,2509105440,3,144,48,1362087716239,1362087721807,2509094679,2509100247,5568
1362087727,2509105512,9,497,55.22222222,1362087720519,1362087726727,2509099031,2509105239,6208
1362087734,2509112456,69,6624,96,1362087705856,1362087733568,2509084312,2509112024,27712
1362087738,2509116544,69,3864,56,1362087709926,1362087737446,2509088470,2509115990,27520
1362087738,2509116548,69,3864,56,1362087710052,1362087737508,2509088600,2509116056,27456
1362087742,2509120436,8,1325,165.625,1362087715605,1362087715861,2509094041,2509094297,256
1362087742,2509120516,68,3808,56,1362087713989,1362087741637,2509092505,2509120153,27648
1362087743,2509121552,7,353,50.42857143,1362087741023,1362087741087,2509119575,2509119639,64
1362087746,2509124528,1,46,46,1362087718199,1362087718199,2509096727,2509096727,0
1362087750,2509128588,3,492,164,1362087724729,1362087724857,2509103317,2509103445,128
1362087762,2509140524,73,7008,96,1362087734010,1362087761722,2509112534,2509140246,27712
1362087766,2509144412,72,4032,56,1362087738157,1362087765357,2509116569,2509143769,27200
1362087766,2509144412,72,4032,56,1362087738218,1362087765738,2509116630,2509144150,27520
1362087766,2509144500,11,4509,409.9090909,1362087741203,1362087741395,2509119703,2509119895,192
1362087770,2509148540,73,4088,56,1362087741932,1362087769644,2509120472,2509148184,27712
1362087790,2509168440,68,6528,96,1362087762125,1362087789709,2509140565,2509168149,27584
1362087790,2509168516,3,492,164,1362087764739,1362087764867,2509143255,2509143383,128
1362087794,2509172468,68,3808,56,1362087766451,1362087793779,2509144919,2509172247,27328
1362087794,2509172492,67,3752,56,1362087766553,1362087793433,2509145045,2509171925,26880
1362087798,2509176448,67,3752,56,1362087770054,1362087797766,2509148502,2509176214,27712
1362087807,2509185512,7,353,50.42857143,1362087801222,1362087801414,2509179734,2509179926,192
1362087818,2509196564,68,6528,96,1362087790163,1362087817555,2509168727,2509196119,27392
1362087822,2509200456,70,3920,56,1362087793854,1362087821822,2509172310,2509200278,27968
1362087822,2509200584,69,3864,56,1362087794174,1362087821502,2509172758,2509200086,27328
1362087824,2509201644,6,455,75.83333333,1362087822571,1362087822699,2509200215,2509200343,128
1362087826,2509204460,69,3864,56,1362087798393,1362087825465,2509176853,2509203925,27072
1362087826,2509204544,10,1964,196.4,1362087801445,1362087801637,2509179989,2509180181,192
1362087831,2509208628,6,1100,183.3333333,1362087805626,1362087830458,2509183254,2509208086,24832
1362087840,2509217588,3,144,48,1362087830883,1362087835939,2509208471,2509213527,5056
1362087843,2509220680,13,2068,159.0769231,1362087816774,1362087830854,2509194454,2509208534,14080
1362087847,2509224700,70,6720,96,1362087818865,1362087846257,2509196565,2509223957,27392
1362087851,2509228636,70,3920,56,1362087823089,1362087850545,2509200725,2509228181,27456
1362087851,2509228644,69,3864,56,1362087823208,1362087850664,2509200852,2509228308,27456
1362087855,2509232636,71,3976,56,1362087826864,1362087854704,2509204500,2509232340,27840
1362087859,2509236924,3,1487,495.6666667,1362087830801,1362087830929,2509208725,2509208853,128
1362087863,2509241548,7,353,50.42857143,1362087861152,1362087861728,2509239700,2509240276,576
1362087871,2509248928,61,5856,96,1362087846543,1362087870415,2509224471,2509248343,23872
1362087875,2509252784,60,3360,56,1362087850845,1362087874781,2509228629,2509252565,23936
1362087875,2509252896,60,3360,56,1362087850604,1362087874540,2509228500,2509252436,23936
1362087883,2509260944,70,3920,56,1362087854972,1362087882556,2509232916,2509260500,27584
1362087887,2509264984,11,2057,187,1362087862294,1362087862550,2509240278,2509240534,256
1362087895,2509273000,3,492,164,1362087870406,1362087870470,2509248406,2509248470,64
1362087899,2509276900,73,7008,96,1362087870823,1362087898727,2509248723,2509276627,27904
1362087903,2509280800,73,4088,56,1362087875147,1362087902539,2509252947,2509280339,27392
1362087903,2509280924,74,4144,56,1362087874895,1362087902671,2509252819,2509280595,27776
1362087911,2509288800,74,4144,56,1362087883021,1362087910861,2509260821,2509288661,27840
1362087927,2509304808,71,6816,96,1362087899141,1362087926661,2509276949,2509304469,27520
1362087927,2509305520,62,3472,56,1362087902139,1362087926203,2509280659,2509304723,24064
1362087928,2509305672,7,353,50.42857143,1362087922062,1362087922958,2509299734,2509300630,896
1362087931,2509308856,71,3976,56,1362087903062,1362087930774,2509280918,2509308630,27712
1362087935,2509313012,3,492,164,1362087910264,1362087910392,2509288276,2509288404,128
1362087939,2509316876,70,3920,56,1362087911040,1362087938432,2509288916,2509316308,27392
1362087943,2509320896,8,1140,142.5,1362087916845,1362087917101,2509294741,2509294997,256
1362087947,2509325064,11,4509,409.9090909,1362087922563,1362087922819,2509300627,2509300883,256
1362087955,2509332868,69,6624,96,1362087926920,1362087954696,2509304788,2509332564,27776
1362087955,2509332876,68,3808,56,1362087927169,1362087954625,2509305045,2509332501,27456
1362087959,2509337008,69,3864,56,1362087931068,1362087958524,2509309076,2509336532,27456
1362087967,2509344892,71,3976,56,1362087939056,1362087966704,2509316948,2509344596,27648
1362087968,2509345700,6,497,82.83333333,1362087960048,1362087962928,2509337748,2509340628,2880
1362087975,2509353096,3,492,164,1362087950243,1362087950371,2509328339,2509328467,128
1362087979,2509357112,3,604,201.3333333,1362087953684,1362087953748,2509331796,2509331860,64
1362087983,2509360888,75,4200,56,1362087954996,1362087982772,2509332884,2509360660,27776
1362087983,2509361008,75,7200,96,1362087954940,1362087982716,2509332948,2509360724,27776
1362087984,2509362088,7,353,50.42857143,1362087982253,1362087982893,2509360341,2509360981,640
1362087987,2509364896,74,4144,56,1362087959020,1362087986796,2509336916,2509364692,27776
1362087987,2509365024,1,46,46,1362087959724,1362087959724,2509337748,2509337748,0
1362087995,2509373020,71,3976,56,1362087966961,1362087994417,2509344981,2509372437,27456
1362088003,2509380972,9,3463,384.7777778,1362087975453,1362087990301,2509353425,2509368273,14848
1362088011,2509388904,70,3920,56,1362087983076,1362088010788,2509360980,2509388692,27712
1362088011,2509388904,10,1964,196.4,1362087983138,1362087983330,2509361042,2509361234,192
1362088011,2509388904,70,6720,96,1362087983138,1362088010850,2509361042,2509388754,27712
1362088015,2509393244,71,3976,56,1362087986960,1362088014480,2509365204,2509392724,27520
1362088015,2509393460,7,3833,547.5714286,1362087989751,1362087989943,2509368211,2509368403,192
1362088019,2509397224,62,3472,56,1362087994594,1362088018402,2509372818,2509396626,23808
1362088035,2509413260,61,5856,96,1362088010815,1362088034559,2509389075,2509412819,23744
1362088035,2509413304,3,605,201.6666667,1362088008660,1362088008788,2509386964,2509387092,128
1362088035,2509413380,62,3472,56,1362088010567,1362088034695,2509388947,2509413075,24128
1362088043,2509421248,72,4032,56,1362088015177,1362088042569,2509393425,2509420817,27392
1362088047,2509425332,73,4088,56,1362088018935,1362088046775,2509397267,2509425107,27840
1362088048,2509425984,7,353,50.42857143,1362088042387,1362088043347,2509420371,2509421331,960
1362088063,2509441216,73,7008,96,1362088034923,1362088062379,2509413139,2509440595,27456
1362088063,2509441340,73,4088,56,1362088035053,1362088062765,2509413393,2509441105,27712
1362088071,2509449456,73,4088,56,1362088042683,1362088070587,2509421139,2509449043,27904
1362088071,2509449460,10,1964,196.4,1362088042936,1362088043384,2509421396,2509421844,448
1362088072,2509450068,3,138,46,1362088069244,1362088069372,2509447312,2509447440,128
1362088075,2509453248,73,4088,56,1362088047241,1362088074569,2509425489,2509452817,27328
1362088075,2509453248,3,492,164,1362088048009,1362088048137,2509426257,2509426385,128
1362088080,2509458076,6,461,76.83333333,1362088077175,1362088077303,2509455251,2509455379,128
1362088091,2509469308,74,7104,96,1362088062990,1362088090702,2509441298,2509469010,27712
1362088091,2509469316,73,4088,56,1362088063302,1362088090566,2509441618,2509468882,27264
1362088099,2509477384,61,3416,56,1362088074754,1362088098754,2509453138,2509477138,24000
1362088099,2509477388,72,4032,56,1362088070974,1362088098750,2509449362,2509477138,27776
1362088104,2509482068,8,399,49.875,1362088103293,1362088103805,2509481361,2509481873,512
1362088107,2509485432,3,1483,494.3333333,1362088081107,1362088081235,2509459539,2509459667,128
1362088119,2509497280,70,3920,56,1362088091051,1362088118635,2509469331,2509496915,27584
1362088119,2509497280,70,6720,96,1362088091114,1362088118698,2509469394,2509496978,27584
1362088127,2509505396,71,3976,56,1362088099062,1362088126774,2509477458,2509505170,27712
1362088127,2509505396,71,3976,56,1362088099188,1362088126708,2509477584,2509505104,27520
1362088131,2509509380,2,92,46,1362088105861,1362088105925,2509484241,2509484305,64
1362088131,2509509408,12,4602,383.5,1362088103528,1362088103784,2509481936,2509482192,256
1362088147,2509525432,62,3472,56,1362088118994,1362088143122,2509497426,2509521554,24128
1362088147,2509525436,62,5952,96,1362088119118,1362088143246,2509497554,2509521682,24128
1362088147,2509525472,3,492,164,1362088120807,1362088120935,2509499279,2509499407,128
1362088155,2509533348,43,2408,56,1362088127076,1362088154532,2509505424,2509532880,27456
1362088155,2509533352,43,2408,56,1362088127138,1362088154594,2509505490,2509532946,27456
1362088160,2509538168,137191,194701035,1419.19685,1362087556633,1362088158425,2508934801,2509536593,601792
1362088160,2509538192,8,386,48.25,1362088148544,1362088159616,2509526736,2509537808,11072
1362088168,2509546040,7,353,50.42857143,1362088163866,1362088164250,2509541906,2509542290,384
1362088168,2509546272,8,386,48.25,1362088148721,1362088160561,2509526993,2509538833,11840
1362088179,2509557452,60,3360,56,1362088154236,1362088178620,2509532688,2509557072,24384
1362088179,2509557480,60,5760,96,1362088154338,1362088178594,2509532818,2509557074,24256
1362088180,2509557604,59,3304,56,1362088155598,1362088179598,2509533202,2509557202,24000
1362088183,2509561364,68,3808,56,1362088154901,1362088182741,2509533265,2509561105,27840
1362088187,2509565436,3,492,164,1362088160718,1362088160846,2509539154,2509539282,128
1362088191,2509569400,9,1918,213.1111111,1362088163890,1362088164018,2509542290,2509542418,128
1362088207,2509585364,70,3920,56,1362088179027,1362088206483,2509557391,2509584847,27456
1362088207,2509585368,70,3920,56,1362088179215,1362088206735,2509557583,2509585103,27520
1362088207,2509585484,70,6720,96,1362088178974,1362088206494,2509557458,2509584978,27520
1362088208,2509586372,6,497,82.83333333,1362088200333,1362088203277,2509578705,2509581649,2944
1362088211,2509589552,70,3920,56,1362088182938,1362088210458,2509561490,2509589010,27520
1362088224,2509602412,3,144,48,1362088217378,1362088223394,2509595790,2509601806,6016
1362088227,2509605448,1,46,46,1362088200255,1362088200255,2509578703,2509578703,0
1362088227,2509605580,6,2000,333.3333333,1362088201018,1362088217338,2509579598,2509595918,16320
1362088231,2509609520,59,5664,96,1362088206775,1362088230455,2509585295,2509608975,23680
1362088232,2509609644,60,3360,56,1362088207589,1362088231589,2509585233,2509609233,24000
1362088235,2509613448,68,3808,56,1362088206977,1362088234753,2509585425,2509613201,27776
1362088235,2509613456,11,3324,302.1818182,1362088208310,1362088224118,2509586766,2509602574,15808
1362088240,2509617592,69,3864,56,1362088211734,1362088239638,2509589326,2509617230,27904
1362088244,2509621632,9,1594,177.1111111,1362088217393,1362088217905,2509595025,2509595537,512
1362088259,2509637468,43,4128,96,1362088230890,1362088258666,2509609358,2509637134,27776
1362088260,2509637600,43,2408,56,1362088232206,1362088259726,2509609806,2509637326,27520
1362088263,2509641460,43,2408,56,1362088235378,1362088262642,2509613838,2509641102,27264
1362088264,2509642360,9,438,48.66666667,1362088247385,1362088259225,2509625745,2509637585,11840
1362088264,2509642408,19152,27183877,1419.375365,1362088154022,1362088258790,2509532430,2509637198,104768
1362088268,2509645600,44,2464,56,1362088240206,1362088267406,2509617806,2509645006,27200
1362088283,2509661580,3,492,164,1362088256701,1362088256829,2509635281,2509635409,128
1362088288,2509665596,68,6528,96,1362088259858,1362088287698,2509637454,2509665294,27840
1362088288,2509665624,67,3752,56,1362088260086,1362088287414,2509637710,2509665038,27328
1362088288,2509666356,8,399,49.875,1362088283546,1362088284314,2509661902,2509662670,768
1362088292,2509669660,69,3864,56,1362088263891,1362088291475,2509641551,2509669135,27584
1362088295,2509673504,69,3864,56,1362088267143,1362088294663,2509645647,2509673167,27520
1362088312,2509689704,15,3606,240.4,1362088284967,1362088307943,2509662671,2509685647,22976
1362088316,2509693648,72,4032,56,1362088287840,1362088315424,2509665488,2509693072,27584
1362088316,2509693648,72,6912,96,1362088287965,1362088315485,2509665613,2509693133,27520
1362088320,2509697676,70,3920,56,1362088291843,1362088319683,2509669519,2509697359,27840
1362088324,2509701660,69,3864,56,1362088295827,1362088323411,2509673487,2509701071,27584
1362088324,2509701740,3,492,164,1362088297602,1362088297730,2509675342,2509675470,128
1362088336,2509714344,6,461,76.83333333,1362088331878,1362088332070,2509710222,2509710414,192
1362088336,2509714456,3,138,46,1362088332149,1362088332149,2509710605,2509710605,0
1362088344,2509721604,59,3304,56,1362088315916,1362088343756,2509693520,2509721360,27840
1362088344,2509721604,58,5568,96,1362088316043,1362088343499,2509693647,2509721103,27456
1362088348,2509725676,57,3192,56,1362088319938,1362088347522,2509697614,2509725198,27584
1362088351,2509729564,53,2968,56,1362088322954,1362088350730,2509701518,2509729294,27776
1362088364,2509741644,7,2076,296.5714286,1362088338272,1362088340320,2509715916,2509717964,2048
1362088371,2509749560,39,3744,96,1362088342925,1362088370637,2509721485,2509749197,27712
1362088372,2509749684,38,2128,56,1362088343996,1362088371644,2509721680,2509749328,27648
1362088372,2509749724,5,1636,327.2,1362088345235,1362088345235,2509722959,2509722959,0
1362088376,2509753724,37,2072,56,1362088347795,1362088375571,2509725519,2509753295,27776
1362088380,2509757708,37,2072,56,1362088351904,1362088379616,2509729612,2509757324,27712
1362088400,2509777684,36,2016,56,1362088371834,1362088399738,2509749518,2509777422,27904
1362088400,2509777684,35,3360,96,1362088371834,1362088399482,2509749518,2509777166,27648
1362088404,2509781732,33,1848,56,1362088377227,1362088403787,2509754959,2509781519,26560
1362088408,2509785700,3,492,164,1362088380328,1362088380456,2509758028,2509758156,128
1362088408,2509785700,33,1848,56,1362088380328,1362088407592,2509758028,2509785292,27264
1362088408,2509786468,7,353,50.42857143,1362088404458,1362088404586,2509782926,2509783054,128
1362088424,2509801688,43,4128,96,1362088399861,1362088423605,2509777549,2509801293,23744
1362088428,2509805784,52,2912,56,1362088402900,1362088427604,2509780684,2509805388,24704
1362088432,2509809692,56,3136,56,1362088404146,1362088431602,2509781838,2509809294,27456
1362088432,2509809728,11,4509,409.9090909,1362088405325,1362088405517,2509783053,2509783245,192
1362088436,2509813832,59,3304,56,1362088407782,1362088435558,2509785614,2509813390,27776
1362088448,2509825712,6,1993,332.1666667,1362088420187,1362088420507,2509797899,2509798219,320
1362088448,2509825716,10,4844,484.4,1362088420378,1362088420506,2509798094,2509798222,128
1362088452,2509829820,47,4512,96,1362088423794,1362088450674,2509801614,2509828494,26880
1362088456,2509833700,37,2072,56,1362088428135,1362088448551,2509805835,2509826251,20416
1362088460,2509837820,32,1792,56,1362088431794,1362088459570,2509809614,2509837390,27776
1362088460,2509837880,4,656,164,1362088434038,1362088434422,2509811918,2509812302,384
1362088464,2509841740,35,1960,56,1362088436034,1362088463746,2509813774,2509841486,27712
1362088472,2509850512,8,386,48.25,1362088455291,1362088464123,2509833803,2509842635,8832
1362088472,2509850516,9,445,49.44444444,1362088464248,1362088464824,2509842764,2509843340,576
1362088484,2509861996,60,3360,56,1362088458945,1362088483265,2509836941,2509861261,24320
1362088484,2509861996,60,5760,96,1362088459008,1362088483520,2509837004,2509861516,24512
1362088488,2509865764,67,3752,56,1362088460137,1362088487657,2509837901,2509865421,27520
1362088488,2509865776,3,492,164,1362088460893,1362088461021,2509838669,2509838797,128
1362088492,2509869792,65,3640,56,1362088464011,1362088491787,2509841803,2509869579,27776
1362088492,2509869952,12,4602,383.5,1362088465388,1362088465580,2509843340,2509843532,192
1362088512,2509889944,67,3752,56,1362088483827,1362088511347,2509861771,2509889291,27520
1362088512,2509889948,67,6432,96,1362088483886,1362088511534,2509861834,2509889482,27648
1362088516,2509894020,68,3808,56,1362088487847,1362088515559,2509865867,2509893579,27712
1362088520,2509898008,68,3808,56,1362088491827,1362088519411,2509869835,2509897419,27584
1362088528,2509906016,3,492,164,1362088500267,1362088500395,2509878283,2509878411,128
1362088528,2509906552,4,190,47.5,1362088517845,1362088523093,2509896397,2509901645,5248
1362088536,2509914104,57,3192,56,1362088511635,1362088535187,2509889739,2509913291,23552
1362088536,2509914108,57,5472,96,1362088511695,1362088535183,2509889803,2509913291,23488
1362088536,2509914524,1394,1973082,1415.41033,1362088455088,1362088528944,2509833612,2509907468,73856
1362088537,2509914608,3,169,56.33333333,1362088536068,1362088536068,2509913676,2509913676,0
1362088540,2509918108,9,3138,348.6666667,1362088515469,1362088525581,2509893577,2509903689,10112
1362088544,2509922044,64,3584,56,1362088515919,1362088543567,2509893963,2509921611,27648
1362088544,2509922208,8,1324,165.5,1362088517419,1362088517867,2509895627,2509896075,448
1362088548,2509926168,65,3640,56,1362088519829,1362088547349,2509897997,2509925517,27520
1362088560,2509938260,57,3192,56,1362088535605,1362088559477,2509913865,2509937737,23872
1362088564,2509942060,63,6048,96,1362088535869,1362088563517,2509913929,2509941577,27648
1362088568,2509946076,3,492,164,1362088540333,1362088540397,2509918409,2509918473,64
1362088572,2509950192,55,3080,56,1362088543866,1362088571514,2509922058,2509949706,27648
1362088576,2509954100,50,2800,56,1362088547861,1362088575509,2509925961,2509953609,27648
1362088588,2509966092,23,1288,56,1362088560288,1362088587360,2509938380,2509965452,27072
1362088592,2509970088,19,1824,96,1362088564065,1362088591521,2509942153,2509969609,27456
1362088593,2509970636,7,384,54.85714286,1362088585895,1362088586087,2509963531,2509963723,192
1362088593,2509970704,6,461,76.83333333,1362088592097,1362088592353,2509969801,2509970057,256
1362088600,2509978244,30,1680,56,1362088571781,1362088599493,2509950025,2509977737,27712
1362088600,2509978552,6,294,49,1362088585489,1362088597137,2509964041,2509975689,11648
1362088600,2509978572,10,2972,297.2,1362088593471,1362088599103,2509972043,2509977675,5632
1362088601,2509978616,51746,73410865,1418.677096,1362088247928,1362088598712,2509625544,2509976328,350784
1362088601,2509978620,8,398,49.75,1362088580981,1362088598069,2509958601,2509975689,17088
1362088601,2509978624,9,450,50,1362088581235,1362088599027,2509958859,2509976651,17792
1362088601,2509978628,7,334,47.71428571,1362088589296,1362088598064,2509966924,2509975692,8768
1362088601,2509978632,7,346,49.42857143,1362088586155,1362088598059,2509963787,2509975691,11904
1362088601,2509978668,6,300,50,1362088587589,1362088597637,2509965257,2509975305,10048
1362088601,2509978672,5,232,46.4,1362088587842,1362088598018,2509965514,2509975690,10176
1362088608,2509986164,9,2892,321.3333333,1362088580374,1362088596950,2509958538,2509975114,16576
1362088608,2509986244,44,2464,56,1362088583302,1362088607238,2509961546,2509985482,23936
1362088612,2509990132,14,2219,158.5,1362088585655,1362088593271,2509963787,2509971403,7616
1362088616,2509994212,33,41556,1259.272727,1362088588455,1362088591591,2509966667,2509969803,3136
1362088616,2509994216,50,2800,56,1362088588769,1362088614497,2509966985,2509992713,25728
1362088620,2509998228,48,4608,96,1362088591960,1362088614552,2509970188,2509992780,22592
1362088628,2510006220,27,1512,56,1362088600156,1362088614940,2509978376,2509993160,14784
1362088636,2510014204,8,448,56,1362088610540,1362088614380,2509988744,2509992584,3840
1362088641,2510018712,3,138,46,1362088634011,1362088634011,2510011723,2510011723,0
1362088664,2510042136,3,492,164,1362088636083,1362088636211,2510014219,2510014347,128
1362088668,2510046164,8,3086,385.75,1362088640469,1362088653333,2510018633,2510031497,12864
1362088681,2510058676,3577,5060798,1414.816327,1362088592062,1362088674878,2509969738,2510052554,82816
1362088704,2510082384,3,492,164,1362088676410,1362088676538,2510054794,2510054922,128
1362088721,2510098704,9,445,49.44444444,1362088712801,1362088713953,2510090505,2510091657,1152
1362088740,2510118244,12,4439,369.9166667,1362088713412,1362088713540,2510091656,2510091784,128
1362088744,2510122204,3,492,164,1362088716014,1362088716142,2510094218,2510094346,128
1362088777,2510154712,9,445,49.44444444,1362088774041,1362088774233,2510151753,2510151945,192
1362088784,2510162344,3,492,164,1362088756384,1362088756512,2510134728,2510134856,128
1362088800,2510178444,12,4602,383.5,1362088773498,1362088773626,2510151942,2510152070,128
1362088820,2510198280,15,8792,586.1333333,1362088792671,1362088792735,2510170951,2510171015,64
1362088820,2510198392,4,1352,338,1362088792431,1362088792559,2510170823,2510170951,128
1362088824,2510202272,3,492,164,1362088796008,1362088796136,2510174280,2510174408,128
1362088830,1148522520,3,144,48,1362088817311,1362088822751,1148509831,1148515271,5440
1362088833,2510210656,53,39527,745.7924528,1362088828622,1362088832142,2510206278,2510209798,3520
1362088833,2510210792,3,144,48,1362088819205,1362088824901,2510196997,2510202693,5696
1362088838,1148530500,68,79496,1169.058824,1362088826996,1362088837940,1148519496,1148530440,10944
1362088841,2510218652,18,4037,224.2777778,1362088832786,1362088838290,2510210438,2510215942,5504
1362088841,2510218688,15,4248,283.2,1362088818413,1362088838317,2510196101,2510216005,19904
1362088841,2510218728,26,11088,426.4615385,1362088816904,1362088838152,2510194632,2510215880,21248
1362088841,2510218780,39,14746,378.1025641,1362088830547,1362088838099,2510208327,2510215879,7552
1362088841,2510218788,558,752940,1349.354839,1362088831177,1362088838089,2510208965,2510215877,6912
1362088841,2510218788,24,22391,932.9583333,1362088831371,1362088838155,2510209159,2510215943,6784
1362088849,2510226880,6,506,84.33333333,1362088847920,1362088848176,2510225800,2510226056,256
1362088852,2510230340,23,1288,56,1362088827105,1362088851361,2510205445,2510229701,24256
1362088852,2510230344,23,1288,56,1362088827359,1362088851423,2510205703,2510229767,24064
1362088854,1148546512,3,144,48,1362088847399,1362088852519,1148539911,1148545031,5120
1362088854,1148546512,3,144,48,1362088847398,1362088852518,1148539910,1148545030,5120
1362088854,1148546524,3,144,48,1362088845724,1362088851548,1148538248,1148544072,5824
1362088854,1148546524,2,98,49,1362088845724,1362088851484,1148538248,1148544008,5760
1362088854,1148546524,2,98,49,1362088847066,1362088852506,1148539590,1148545030,5440
1362088854,1148546536,3,144,48,1362088847377,1362088852497,1148539913,1148545033,5120
1362088854,1148546536,3,144,48,1362088847377,1362088852497,1148539913,1148545033,5120
1362088854,1148546536,3,144,48,1362088847376,1362088852496,1148539912,1148545032,5120
1362088854,1148546544,2,98,49,1362088845702,1362088851526,1148538246,1148544070,5824
1362088854,1148546544,3,144,48,1362088845702,1362088851526,1148538246,1148544070,5824
1362088856,2510234268,27,1512,56,1362088828075,1362088855275,2510206343,2510233543,27200
1362088856,2510234356,28,2688,96,1362088827859,1362088855699,2510206215,2510234055,27840
1362088856,2510234380,1,46,46,1362088827899,1362088827899,2510206279,2510206279,0
1362088857,2510234648,2,98,49,1362088848919,1362088854807,2510226567,2510232455,5888
1362088857,2510234656,3,144,48,1362088849486,1362088854862,2510227142,2510232518,5376
1362088857,2510234656,3,138,46,1362088849549,1362088850637,2510227205,2510228293,1088
1362088857,2510234660,3,138,46,1362088853259,1362088854347,2510230919,2510232007,1088
1362088857,2510234692,3,138,46,1362088854378,1362088855466,2510232070,2510233158,1088
1362088857,2510234692,3,138,46,1362088850985,1362088852009,2510228677,2510229701,1024
1362088857,2510234700,3,138,46,1362088852065,1362088853153,2510229765,2510230853,1088
1362088857,2510234704,2,98,49,1362088847648,1362088852768,2510225352,2510230472,5120
1362088857,2510234704,2,94,47,1362088848095,1362088853791,2510225799,2510231495,5696
1362088857,2510234704,4,190,47.5,1362088848095,1362088853855,2510225799,2510231559,5760
1362088857,2510234704,3,144,48,1362088848095,1362088853855,2510225799,2510231559,5760
1362088857,2510234736,3,138,46,1362088855552,1362088856576,2510233288,2510234312,1024
1362088857,2510234736,2,92,46,1362088855807,1362088856319,2510233543,2510234055,512
1362088857,2510234740,2,98,49,1362088848825,1362088854713,2510226565,2510232453,5888
1362088857,2510234748,4,190,47.5,1362088849396,1362088854900,2510227144,2510232648,5504
1362088857,2510234748,3,144,48,1362088849395,1362088854771,2510227143,2510232519,5376
1362088857,2510234752,3,138,46,1362088849776,1362088850864,2510227528,2510228616,1088
1362088857,2510234780,3,138,46,1362088850516,1362088851604,2510228296,2510229384,1088
1362088857,2510234784,3,138,46,1362088854608,1362088855696,2510232392,2510233480,1088
1362088857,2510234812,2,98,49,1362088847537,1362088852657,2510225349,2510230469,5120
1362088857,2510234812,2,98,49,1362088847537,1362088852657,2510225349,2510230469,5120
1362088857,2510234812,2,98,49,1362088847537,1362088852657,2510225349,2510230469,5120
1362088857,2510234816,15,5507,367.1333333,1362088847984,1362088849136,2510225800,2510226952,1152
1362088862,1148554512,3,144,48,1362088856552,1362088861544,1148549064,1148554056,4992
1362088862,1148554512,2,98,49,1362088856552,1362088861544,1148549064,1148554056,4992
1362088862,1148554516,3,144,48,1362088849188,1362088854500,1148541704,1148547016,5312
1362088864,2510242492,1,46,46,1362088837387,1362088837387,2510215879,2510215879,0
1362088865,2510242648,3,492,164,1362088837014,1362088837910,2510214662,2510215558,896
1362088865,2510242688,1,46,46,1362088838190,1362088838190,2510215878,2510215878,0
1362088865,2510242808,3,144,48,1362088857398,1362088862774,2510235206,2510240582,5376
1362088865,2510242812,3,144,48,1362088853170,1362088858738,2510230982,2510236550,5568
1362088865,2510242812,79,90140,1141.012658,1362088857778,1362088858930,2510235590,2510236742,1152
1362088865,2510242816,75,92789,1237.186667,1362088857776,1362088859056,2510235592,2510236872,1280
1362088865,2510242816,6,786,131,1362088857966,1362088858670,2510235782,2510236486,704
1362088865,2510242816,3,144,48,1362088853485,1362088858733,2510231301,2510236549,5248
1362088865,2510242820,3,325,108.3333333,1362088858220,1362088863724,2510236040,2510241544,5504
1362088865,2510242884,3,138,46,1362088856747,1362088857835,2510234631,2510235719,1088
1362088865,2510242892,64,75914,1186.15625,1362088857634,1362088858082,2510235526,2510235974,448
1362088865,2510242892,47,56401,1200.021277,1362088857698,1362088858658,2510235590,2510236550,960
1362088865,2510242920,3,138,46,1362088858056,1362088859144,2510235976,2510237064,1088
1362088865,2510242920,5,907,181.4,1362088858120,1362088858312,2510236040,2510236232,192
1362088865,2510242920,2,279,139.5,1362088858120,1362088863624,2510236040,2510241544,5504
1362088865,2510242920,3,144,48,1362088858055,1362088863559,2510235975,2510241479,5504
1362088865,2510242920,2,98,49,1362088858118,1362088863622,2510236038,2510241542,5504
1362088865,2510242920,3,144,48,1362088858118,1362088863686,2510236038,2510241606,5568
1362088865,2510242920,8,2252,281.5,1362088858309,1362088863621,2510236229,2510241541,5312
1362088865,2510242924,2,98,49,1362088858627,1362088864579,2510236551,2510242503,5952
1362088865,2510242928,3,144,48,1362088858816,1362088864576,2510236744,2510242504,5760
1362088865,2510242928,4,190,47.5,1362088858687,1362088864575,2510236615,2510242503,5888
1362088870,1148562548,2,98,49,1362088858178,1362088863490,1148550726,1148556038,5312
1362088873,2510250584,21,7776,370.2857143,1362088845976,1362088850072,2510223560,2510227656,4096
1362088873,2510250584,4,856,214,1362088845847,1362088845975,2510223431,2510223559,128
1362088873,2510250588,9,2632,292.4444444,1362088846416,1362088846544,2510224004,2510224132,128
1362088873,2510250592,9,3000,333.3333333,1362088846288,1362088846480,2510223880,2510224072,192
1362088873,2510250704,37,45023,1216.837838,1362088847837,1362088848093,2510225541,2510225797,256
1362088873,2510250708,24,10393,433.0416667,1362088848154,1362088869402,2510225862,2510247110,21248
1362088873,2510250772,40,35415,885.375,1362088845786,1362088846746,2510223558,2510224518,960
1362088873,2510250780,11,6537,594.2727273,1362088846160,1362088848080,2510223940,2510225860,1920
1362088873,2510250784,11,3486,316.9090909,1362088846543,1362088846607,2510224327,2510224391,64
1362088873,2510250816,45,53598,1191.066667,1362088847727,1362088848239,2510225543,2510226055,512
1362088873,2510250820,11,1187,107.9090909,1362088847980,1362088860140,2510225800,2510237960,12160
1362088873,2510250864,3,787,262.3333333,1362088868479,1362088868543,2510246343,2510246407,64
1362088873,2510250872,5,648,129.6,1362088857143,1362088872055,2510235015,2510249927,14912
1362088873,2510250880,2115,2805679,1326.562175,1362088857712,1362088872560,2510235592,2510250440,14848
1362088873,2510250956,33,32764,992.8484848,1362088852706,1362088871586,2510230662,2510249542,18880
1362088873,2510250960,5,462,92.4,1362088853021,1362088869597,2510230981,2510247557,16576
1362088873,2510250960,7,1164,166.2857143,1362088853021,1362088872605,2510230981,2510250565,19584
1362088873,2510250960,5,463,92.6,1362088853021,1362088871581,2510230981,2510249541,18560
1362088873,2510251028,13,6485,498.8461538,1362088855324,1362088871004,2510233352,2510249032,15680
1362088875,1148567248,17,18691,1099.470588,1362088847342,1362088847534,1148539590,1148539782,192
1362088875,1148567248,6,4366,727.6666667,1362088847345,1362088847601,1148539593,1148539849,256
1362088875,1148567284,6,3682,613.6666667,1362088847307,1362088847499,1148539591,1148539783,192
1362088876,2510254504,9,3235,359.4444444,1362088848064,1362088848448,2510226568,2510226952,384
1362088876,2510254512,4,1384,346,1362088848565,1362088848949,2510227077,2510227461,384
1362088876,2510254548,12,3608,300.6666667,1362088849363,1362088849491,2510227911,2510228039,128
1362088877,2510254628,27,12481,462.2592593,1362088848938,1362088849642,2510226566,2510227270,704
1362088877,2510254628,6,696,116,1362088849001,1362088849257,2510226629,2510226885,256
1362088879,1148571252,3,386,128.6666667,1362088854251,1362088857323,1148546503,1148549575,3072
1362088880,2510258552,26,1456,56,1362088855568,1362088877264,2510234120,2510255816,21696
1362088880,2510258556,5,885,177,1362088851978,1362088867914,2510230534,2510246470,15936
1362088881,2510258600,4,559,139.75,1362088854344,1362088854856,2510231944,2510232456,512
1362088881,2510258748,31,1736,56,1362088852849,1362088878193,2510230597,2510255941,25344
1362088881,2510258752,75,63804,850.72,1362088852908,1362088859692,2510230660,2510237444,6784
1362088881,2510258752,31,1736,56,1362088853037,1362088879341,2510230789,2510257093,26304
1362088881,2510258788,4,447,111.75,1362088854155,1362088854475,2510231943,2510232263,320
1362088881,2510258832,12,4892,407.6666667,1362088855837,1362088858845,2510233669,2510236677,3008
1362088881,2510258884,6,576,96,1362088857195,1362088877995,2510235079,2510255879,20800
1362088881,2510258976,6,576,96,1362088857038,1362088877966,2510235014,2510255942,20928
1362088884,2510262496,26,2496,96,1362088856840,1362088878920,2510235336,2510257416,22080
1362088884,2510262568,3,1311,437,1362088858559,1362088859455,2510237127,2510238023,896
1362088885,2510262604,1,46,46,1362088857026,1362088857026,2510234630,2510234630,0
1362088885,2510262656,9,3501,389,1362088858574,1362088859150,2510236230,2510236806,576
1362088885,2510262684,4,1019,254.75,1362088859059,1362088859187,2510236743,2510236871,128
1362088885,2510262688,2,600,300,1362088859437,1362088859565,2510237125,2510237253,128
1362088885,2510262696,1,46,46,1362088859752,1362088859752,2510237448,2510237448,0
1362088897,2510274936,4,190,47.5,1362088891255,1362088896375,2510269191,2510274311,5120
1362088905,2510282788,7,4103,586.1428571,1362088879305,1362088900169,2510257093,2510277957,20864
1362088905,2510282864,3,144,48,1362088897021,1362088902077,2510274885,2510279941,5056
1362088905,2510282868,3,144,48,1362088897275,1362088903099,2510275143,2510280967,5824
1362088905,2510282868,7,1889,269.8571429,1362088897339,1362088898107,2510275207,2510275975,768
1362088905,2510282872,3,144,48,1362088898039,1362088904055,2510275911,2510281927,6016
1362088905,2510282872,3,144,48,1362088898101,1362088904053,2510275973,2510281925,5952
1362088905,2510282876,2,98,49,1362088898354,1362088904050,2510276230,2510281926,5696
1362088905,2510282900,6,1131,188.5,1362088898776,1362088899032,2510276676,2510276932,256
1362088905,2510282904,6,1101,183.5,1362088899093,1362088899605,2510276997,2510277509,512
1362088905,2510282912,7,506,72.28571429,1362088899789,1362088899981,2510277701,2510277893,192
1362088905,2510282912,7,512,73.14285714,1362088899916,1362088900876,2510277828,2510278788,960
1362088905,2510282932,12,3493,291.0833333,1362088900345,1362088900537,2510278277,2510278469,192
1362088905,2510282932,4,190,47.5,1362088900345,1362088901433,2510278277,2510279365,1088
1362088905,2510282940,2,98,49,1362088896753,1362088902001,2510274693,2510279941,5248
1362088905,2510282940,2,98,49,1362088896816,1362088901936,2510274756,2510279876,5120
1362088905,2510282948,2,98,49,1362088897194,1362088902954,2510275142,2510280902,5760
1362088905,2510282948,9,568,63.11111111,1362088897194,1362088903018,2510275142,2510280966,5824
1362088905,2510282980,7,438,62.57142857,1362088897995,1362088903947,2510275975,2510281927,5952
1362088905,2510282980,2,98,49,1362088897931,1362088903947,2510275911,2510281927,6016
1362088905,2510282988,7,466,66.57142857,1362088898945,1362088899201,2510276933,2510277189,256
1362088905,2510282988,2,98,49,1362088898881,1362088903937,2510276869,2510281925,5056
1362088905,2510282992,32,32314,1009.8125,1362088899135,1362088899647,2510277127,2510277639,512
1362088905,2510282996,7,1478,211.1428571,1362088899704,1362088899832,2510277700,2510277828,128
1362088905,2510283024,6,461,76.83333333,1362088900252,1362088900380,2510278276,2510278404,128
1362088908,2510286580,16,896,56,1362088882355,1362088907251,2510260935,2510285831,24896
1362088909,2510286604,6,1212,202,1362088883266,1362088891202,2510260870,2510268806,7936
1362088909,2510286604,16,896,56,1362088883394,1362088908354,2510260998,2510285958,24960
1362088909,2510286604,15,840,56,1362088883585,1362088907457,2510261189,2510285061,23872
1362088910,1148602516,3,144,48,1362088897189,1362088902949,1148589705,1148595465,5760
1362088910,1148602536,3,144,48,1362088900241,1362088905937,1148592777,1148598473,5696
1362088910,1148602536,2,98,49,1362088904528,1362088909904,1148597064,1148602440,5376
1362088912,2510290548,18,1728,96,1362088885008,1362088911312,2510263556,2510289860,26304
1362088912,2510290548,3,138,46,1362088885010,1362088885010,2510263558,2510263558,0
1362088913,2510290856,2,98,49,1362088905093,1362088911045,2510282949,2510288901,5952
1362088913,2510290868,3,144,48,1362088906235,1362088912059,2510284103,2510289927,5824
1362088913,2510290868,3,144,48,1362088906362,1362088912058,2510284230,2510289926,5696
1362088913,2510290868,4,190,47.5,1362088906489,1362088907577,2510284357,2510285445,1088
1362088913,2510290868,3,144,48,1362088906425,1362088912057,2510284293,2510289925,5632
1362088913,2510290868,10,995,99.5,1362088906425,1362088906681,2510284293,2510284549,256
1362088913,2510290868,3,144,48,1362088906425,1362088912057,2510284293,2510289925,5632
1362088913,2510290884,3,144,48,1362088906731,1362088912043,2510284615,2510289927,5312
1362088913,2510290884,3,144,48,1362088906729,1362088912041,2510284613,2510289925,5312
1362088913,2510290888,32,12756,398.625,1362088899045,1362088905061,2510276933,2510282949,6016
1362088913,2510290888,2,92,46,1362088899044,1362088905060,2510276932,2510282948,6016
1362088913,2510290892,4,196,49,1362088899104,1362088905248,2510276996,2510283140,6144
1362088913,2510290904,2,98,49,1362088904214,1362088909974,2510282118,2510287878,5760
1362088913,2510290928,3,144,48,1362088903869,1362088909053,2510281797,2510286981,5184
1362088913,2510290928,3,144,48,1362088904188,1362088910012,2510282116,2510287940,5824
1362088913,2510290928,2,98,49,1362088904188,1362088910012,2510282116,2510287940,5824
1362088913,2510290932,7,476,68,1362088904571,1362088909947,2510282503,2510287879,5376
1362088913,2510290936,3,144,48,1362088905015,1362088910967,2510282951,2510288903,5952
1362088913,2510290936,3,144,48,1362088901108,1362088906996,2510279044,2510284932,5888
1362088913,2510290940,3,144,48,1362088905587,1362088910963,2510283527,2510288903,5376
1362088913,2510290944,3,144,48,1362088906159,1362088911983,2510284103,2510289927,5824
1362088913,2510290944,3,144,48,1362088906159,1362088911983,2510284103,2510289927,5824
1362088913,2510290944,6,461,76.83333333,1362088906413,1362088906541,2510284357,2510284485,128
1362088913,2510290944,6,403,67.16666667,1362088906477,1362088911981,2510284421,2510289925,5504
1362088913,2510290976,2,92,46,1362088898958,1362088904974,2510276934,2510282950,6016
1362088918,1148610512,4,190,47.5,1362088906343,1362088911975,1148598855,1148604487,5632
1362088921,2510298852,9,568,63.11111111,1362088913097,1362088919113,2510290949,2510296965,6016
1362088921,2510298856,11,1356,123.2727273,1362088917255,1362088917959,2510295111,2510295815,704
1362088921,2510298864,3,144,48,1362088914364,1362088920060,2510292228,2510297924,5696
1362088921,2510298864,2,98,49,1362088914367,1362088919999,2510292231,2510297863,5632
1362088921,2510298864,8,4900,612.5,1362088906749,1362088917245,2510284613,2510295109,10496
1362088921,2510298888,3,144,48,1362088910183,1362088916071,2510288071,2510293959,5888
1362088921,2510298888,10,1001,100.1,1362088915045,1362088915237,2510292933,2510293125,192
1362088921,2510298928,3,144,48,1362088912637,1362088918013,2510290565,2510295941,5376
1362088921,2510298928,8,1986,248.25,1362088905020,1362088916860,2510282948,2510294788,11840
1362088921,2510298928,3,144,48,1362088912636,1362088918012,2510290564,2510295940,5376
1362088921,2510298932,13,4077,313.6153846,1362088917177,1362088917881,2510295109,2510295813,704
1362088921,2510298936,14,6718,479.8571429,1362088905845,1362088918645,2510283781,2510296581,12800
1362088921,2510298940,9,3916,435.1111111,1362088906353,1362088916977,2510284293,2510294917,10624
1362088921,2510298944,6,461,76.83333333,1362088917935,1362088918255,2510295879,2510296199,320
1362088921,2510298976,6,786,131,1362088919564,1362088919692,2510297540,2510297668,128
1362088921,2510298976,5,643,128.6,1362088919692,1362088920076,2510297668,2510298052,384
1362088923,1148615620,15,2142,142.8,1362088896765,1362088919997,1148589385,1148612617,23232
1362088924,2510302516,7,2543,363.2857143,1362088896177,1362088896625,2510274693,2510275141,448
1362088924,2510302516,53,32094,605.5471698,1362088896177,1362088913137,2510274693,2510291653,16960
1362088924,2510302516,4,317,79.25,1362088896177,1362088896305,2510274693,2510274821,128
1362088924,2510302524,36,28662,796.1666667,1362088896616,1362088913640,2510275140,2510292164,17024
1362088924,2510302536,13,12463,958.6923077,1362088897116,1362088897372,2510275652,2510275908,256
1362088924,2510302536,20,5109,255.45,1362088897375,1362088909663,2510275911,2510288199,12288
1362088924,2510302556,23,4653,202.3043478,1362088897354,1362088920202,2510275910,2510298758,22848
1362088924,2510302556,21,6206,295.5238095,1362088897354,1362088913034,2510275910,2510291590,15680
1362088925,2510302616,91,74049,813.7252747,1362088896887,1362088921207,2510274503,2510298823,24320
1362088925,2510302616,8,2213,276.625,1362088897269,1362088920437,2510274885,2510298053,23168
1362088925,2510302648,37,37265,1007.162162,1362088898005,1362088917013,2510275653,2510294661,19008
1362088925,2510302652,64,55625,869.140625,1362088898255,1362088921935,2510275907,2510299587,23680
1362088925,2510302652,25,8224,328.96,1362088898259,1362088914003,2510275911,2510291655,15744
1362088925,2510302652,24,8799,366.625,1362088898258,1362088914066,2510275910,2510291718,15808
1362088925,2510302680,10,4724,472.4,1362088898807,1362088899767,2510276487,2510277447,960
1362088925,2510302720,19,16498,868.3157895,1362088900302,1362088901454,2510278022,2510279174,1152
1362088926,1148618516,3,144,48,1362088912997,1362088918949,1148605513,1148611465,5952
1362088926,1148618516,4,190,47.5,1362088917859,1362088922979,1148610375,1148615495,5120
1362088929,2510307008,2,98,49,1362088921132,1362088926892,2510299140,2510304900,5760
1362088929,2510307012,3,325,108.3333333,1362088917354,1362088922986,2510295366,2510300998,5632
1362088929,2510307012,3,325,108.3333333,1362088917353,1362088922985,2510295365,2510300997,5632
1362088929,2510307016,2,98,49,1362088917607,1362088922919,2510295623,2510300935,5312
1362088929,2510307016,6,461,76.83333333,1362088921702,1362088922022,2510299718,2510300038,320
1362088929,2510307020,3,138,46,1362088917859,1362088924003,2510295879,2510302023,6144
1362088929,2510307020,3,144,48,1362088918240,1362088923872,2510296260,2510301892,5632
1362088929,2510307024,4,190,47.5,1362088918235,1362088923931,2510296259,2510301955,5696
1362088929,2510307052,3,144,48,1362088919489,1362088924865,2510297541,2510302917,5376
1362088929,2510307052,9,568,63.11111111,1362088920000,1362088925824,2510298052,2510303876,5824
1362088929,2510307088,3,144,48,1362088916382,1362088921886,2510294470,2510299974,5504
1362088929,2510307092,3,144,48,1362088921048,1362088926808,2510299140,2510304900,5760
1362088929,2510307100,2,98,49,1362088917586,1362088922834,2510295686,2510300934,5248
1362088929,2510307104,9,6150,683.3333333,1362088906507,1362088921931,2510284611,2510300035,15424
1362088929,2510307136,3,144,48,1362088919406,1362088924782,2510297542,2510302918,5376
1362088933,2510310596,3,169,56.33333333,1362088905159,1362088905159,2510282755,2510282755,0
1362088933,2510310596,2,123,61.5,1362088905162,1362088905162,2510282758,2510282758,0
1362088933,2510310676,3,169,56.33333333,1362088908027,1362088908027,2510285703,2510285703,0
1362088933,2510310688,1,77,77,1362088905070,1362088905070,2510282758,2510282758,0
1362088933,2510310688,2,123,61.5,1362088905070,1362088905070,2510282758,2510282758,0
1362088933,2510310792,2,123,61.5,1362088907909,1362088907909,2510285701,2510285701,0
1362088934,1148626504,3,144,48,1362088920046,1362088925934,1148612550,1148618438,5888
1362088935,1148627572,1,46,46,1362088909931,1362088909931,1148602503,1148602503,0
1362088937,2510314616,24,1344,56,1362088909557,1362088936629,2510287173,2510314245,27072
1362088937,2510314620,23,1288,56,1362088909746,1362088936242,2510287366,2510313862,26496
1362088937,2510314620,8,1775,221.875,1362088909936,1362088936688,2510287556,2510314308,26752
1362088937,2510314716,2,123,61.5,1362088909008,1362088909008,2510286724,2510286724,0
1362088937,2510314716,24,1344,56,1362088909009,1362088936273,2510286725,2510313989,27264
1362088937,2510314724,2,574,287,1362088909449,1362088909449,2510287173,2510287173,0
1362088937,2510314732,16,3832,239.5,1362088910019,1362088910403,2510287751,2510288135,384
1362088937,2510314940,3,144,48,1362088929074,1362088935154,2510307014,2510313094,6080
1362088937,2510314948,2,98,49,1362088930283,1362088935979,2510308231,2510313927,5696
1362088937,2510314948,2,98,49,1362088930283,1362088935979,2510308231,2510313927,5696
1362088937,2510314972,11,1041,94.63636364,1362088931089,1362088931281,2510309061,2510309253,192
1362088937,2510315016,3,144,48,1362088928995,1362088934051,2510307011,2510312067,5056
1362088937,2510315020,9,568,63.11111111,1362088929571,1362088935011,2510307591,2510313031,5440
1362088937,2510315028,4,190,47.5,1362088930459,1362088935963,2510308487,2510313991,5504
1362088937,2510315048,3,144,48,1362088931012,1362088932100,2510309060,2510310148,1088
1362088937,2510315048,6,461,76.83333333,1362088931012,1362088931140,2510309060,2510309188,128
1362088941,2510318724,25,2400,96,1362088913033,1362088940681,2510290757,2510318405,27648
1362088941,2510318744,38,43853,1154.026316,1362088912822,1362088915126,2510290566,2510292870,2304
1362088941,2510318752,1,46,46,1362088913901,1362088913901,2510291653,2510291653,0
1362088942,1148634508,3,144,48,1362088935723,1362088940971,1148628231,1148633479,5248
1362088942,1148634516,3,144,48,1362088929572,1362088935076,1148622088,1148627592,5504
1362088942,1148634520,3,144,48,1362088931041,1362088936993,1148623561,1148629513,5952
1362088945,2510322636,8,5774,721.75,1362088917407,1362088917535,2510295043,2510295171,128
1362088945,2510322672,4,619,154.75,1362088918269,1362088918525,2510295941,2510296197,256
1362088945,2510322744,1,46,46,1362088917044,1362088917044,2510294788,2510294788,0
1362088945,2510322752,5,1898,379.6,1362088917676,1362088917932,2510295428,2510295684,256
1362088945,2510322976,4,190,47.5,1362088942286,1362088943310,2510320262,2510321286,1024
1362088945,2510323016,8,522,65.25,1362088935718,1362088940902,2510313734,2510318918,5184
1362088945,2510323040,2,98,49,1362088936588,1362088941964,2510314628,2510320004,5376
1362088945,2510323040,2,98,49,1362088936653,1362088941965,2510314693,2510320005,5312
1362088945,2510323040,3,144,48,1362088936588,1362088941964,2510314628,2510320004,5376
1362088945,2510323044,6,461,76.83333333,1362088937287,1362088937415,2510315331,2510315459,128
1362088945,2510323048,4,190,47.5,1362088937287,1362088938311,2510315335,2510316359,1024
1362088945,2510323060,6,461,76.83333333,1362088942138,1362088942266,2510320198,2510320326,128
1362088945,2510323088,2,98,49,1362088935071,1362088940831,2510313159,2510318919,5760
1362088945,2510323088,3,144,48,1362088935070,1362088940894,2510313158,2510318982,5824
1362088949,2510327220,4,399,99.75,1362088920919,1362088921047,2510299139,2510299267,128
1362088950,1148642524,3,144,48,1362088937309,1362088943005,1148629833,1148635529,5696
1362088954,2510332180,1,46,46,1362088925570,1362088925570,2510303750,2510303750,0
1362088955,1148647568,8,1336,167,1362088929522,1362088953522,1148622090,1148646090,24000
1362088955,2510333100,1,46,46,1362088926418,1362088926418,2510304518,2510304518,0
1362088955,2510333228,3,144,48,1362088941968,1362088947792,2510320196,2510326020,5824
1362088955,2510333264,149,165626,1111.583893,1362088928047,1362088952431,2510306311,2510330695,24384
1362088957,2510334624,47,37982,808.1276596,1362088929454,1362088956718,2510307078,2510334342,27264
1362088957,2510334628,5,1706,341.2,1362088929959,1362088953895,2510307587,2510331523,23936
1362088957,2510334660,36,36282,1007.833333,1362088930698,1362088955018,2510308358,2510332678,24320
1362088957,2510334712,69,61233,887.4347826,1362088929366,1362088956630,2510307078,2510334342,27264
1362088957,2510334740,75,78869,1051.586667,1362088930232,1362088955064,2510307972,2510332804,24832
1362088957,2510334744,20,3796,189.8,1362088930485,1362088954549,2510308229,2510332293,24064
1362088957,2510334744,85,79422,934.3764706,1362088930485,1362088956533,2510308229,2510334277,26048
1362088957,2510334744,76,68950,907.2368421,1362088930484,1362088956532,2510308228,2510334276,26048
1362088961,2510339384,3,144,48,1362088953139,1362088958707,2510331523,2510337091,5568
1362088961,2510339384,8,522,65.25,1362088953206,1362088958710,2510331590,2510337094,5504
1362088961,2510339388,2,98,49,1362088949682,1362088955698,2510328070,2510334086,6016
1362088961,2510339388,3,144,48,1362088949682,1362088955698,2510328070,2510334086,6016
1362088961,2510339416,3,144,48,1362088954070,1362088959702,2510332486,2510338118,5632
1362088961,2510339424,6,461,76.83333333,1362088954701,1362088954893,2510333125,2510333317,192
1362088961,2510339424,13,1139,87.61538462,1362088954636,1362088954892,2510333060,2510333316,256
1362088961,2510339456,3,144,48,1362088952493,1362088957677,2510330949,2510336133,5184
1362088961,2510339456,2,98,49,1362088952493,1362088957677,2510330949,2510336133,5184
1362088961,2510339460,2,98,49,1362088953067,1362088958635,2510331527,2510337095,5568
1362088961,2510339464,3,144,48,1362088949606,1362088955686,2510328070,2510334150,6080
1362088961,2510339468,2,98,49,1362088953699,1362088959651,2510332167,2510338119,5952
1362088965,2510342796,17,952,56,1362088937090,1362088964290,2510314886,2510342086,27200
1362088965,2510342836,17,952,56,1362088936921,1362088963929,2510314757,2510341765,27008
1362088965,2510342844,17,952,56,1362088937487,1362088964495,2510315331,2510342339,27008
1362088966,1148658508,4,190,47.5,1362088955054,1362088960174,1148647562,1148652682,5120
1362088966,1148658520,3,144,48,1362088953631,1362088959135,1148646151,1148651655,5504
1362088969,2510346788,16,1536,96,1362088941255,1362088968007,2510319043,2510345795,26752
1362088969,2510346796,67,87124,1300.358209,1362088942081,1362088942273,2510319877,2510320069,192
1362088969,2510346796,6,2381,396.8333333,1362088942081,1362088942337,2510319877,2510320133,256
1362088969,2510347400,2,92,46,1362088964774,1362088964774,2510343174,2510343174,0
1362088969,2510347400,3,138,46,1362088964773,1362088964837,2510343173,2510343237,64
1362088969,2510347404,103,123807,1202.009709,1362088953503,1362088967263,2510331907,2510345667,13760
1362088969,2510347404,159,168415,1059.213836,1362088929567,1362088966303,2510307971,2510344707,36736
1362088969,2510347432,4,184,46,1362088962691,1362088968195,2510341123,2510346627,5504
1362088969,2510347484,125,155985,1247.88,1362088852818,1362088966098,2510231302,2510344582,113280
1362088970,2510347600,2,92,46,1362088963526,1362088963526,2510341126,2510341126,0
1362088970,2510347608,3,138,46,1362088964541,1362088964605,2510342149,2510342213,64
1362088973,2510350784,11,4656,423.2727273,1362088945165,1362088945421,2510322949,2510323205,256
1362088973,2510350788,23,15563,676.6521739,1362088945159,1362088956487,2510322947,2510334275,11328
1362088973,2510350860,6,1212,202,1362088947841,1362088966209,2510325701,2510344069,18368
1362088977,2510354892,4,546,136.5,1362088952354,1362088952482,2510330246,2510330374,128
1362088977,2510355416,6,461,76.83333333,1362088969683,1362088969811,2510348099,2510348227,128
1362088981,2510358884,3,169,56.33333333,1362088955689,1362088955689,2510333573,2510333573,0
1362088986,2510363656,4,363,90.75,1362088985484,1362088985740,2510363140,2510363396,256
1362088986,2510363688,6,786,131,1362088979819,1362088980011,2510357507,2510357699,192
1362088986,2510363688,5,643,128.6,1362088979947,1362088980075,2510357635,2510357763,128
1362088989,2510366756,2,92,46,1362088961322,1362088961386,2510339078,2510339142,64
1362088989,2510366808,2,123,61.5,1362088963701,1362088963765,2510341509,2510341573,64
1362088989,2510366812,1,77,77,1362088963696,1362088963696,2510341508,2510341508,0
1362088989,2510366848,3,138,46,1362088960843,1362088960907,2510338691,2510338755,64
1362088989,2510366928,1,77,77,1362088963579,1362088963579,2510341507,2510341507,0
1362088989,2510366928,2,123,61.5,1362088963643,1362088963643,2510341571,2510341571,0
1362088991,1148683540,2,92,46,1362088963085,1362088963149,1148655625,1148655689,64
1362088991,1148683540,1,46,46,1362088963085,1362088963085,1148655625,1148655625,0
1362088991,1148683576,1,46,46,1362088963049,1362088963049,1148655625,1148655625,0
1362088993,2510370752,6,336,56,1362088966189,1362088979949,2510343941,2510357701,13760
1362088993,2510370760,1,77,77,1362088966819,1362088966819,2510344579,2510344579,0
1362088993,2510370836,6,336,56,1362088965210,1362088979546,2510343046,2510357382,14336
1362088993,2510370836,6,336,56,1362088965337,1362088979673,2510343173,2510357509,14336
1362088993,2510370876,2,123,61.5,1362088966703,1362088966703,2510344579,2510344579,0
1362088993,2510370904,2,123,61.5,1362088967635,1362088967699,2510345539,2510345603,64
1362088993,2510371576,3,138,46,1362088984949,1362088985909,2510363525,2510364485,960
1362088994,2510371620,4,532,133,1362088974898,1362088990962,2510352518,2510368582,16064
1362088994,2510371692,3,325,108.3333333,1362088979944,1362088985896,2510357636,2510363588,5952
1362088997,2510374844,2,92,46,1362088970257,1362088970257,2510348101,2510348101,0
1362088998,1148690536,3,144,48,1362088991889,1362088997905,1148684425,1148690441,6016
1362089001,2510378736,6,576,96,1362088973052,1362088995068,2510350788,2510372804,22016
1362089001,2510378772,2,92,46,1362088974295,1362088974359,2510352067,2510352131,64
1362089001,2510378808,2,92,46,1362088975283,1362088975283,2510353091,2510353091,0
1362089001,2510378852,1,46,46,1362088972936,1362088972936,2510350788,2510350788,0
1362089001,2510378892,1,46,46,1362088974304,1362088974304,2510352196,2510352196,0
1362089001,2510379576,10,995,99.5,1362088992755,1362088992947,2510371331,2510371523,192
1362089001,2510379576,6,461,76.83333333,1362088992755,1362088992947,2510371331,2510371523,192
1362089002,2510379580,7,449,64.14285714,1362088993753,1362088999257,2510371333,2510376837,5504
1362089002,2510379580,4,190,47.5,1362088993817,1362088994905,2510371397,2510372485,1088
1362089002,2510379612,3,144,48,1362088991673,1362088997305,2510369285,2510374917,5632
1362089002,2510379612,3,144,48,1362088991673,1362088997241,2510369285,2510374853,5568
1362089002,2510379620,10,2344,234.4,1362088992305,1362088998257,2510369925,2510375877,5952
1362089002,2510379620,2,98,49,1362088992560,1362088998256,2510370180,2510375876,5696
1362089002,2510379652,3,144,48,1362088993360,1362088999248,2510371012,2510376900,5888
1362089002,2510379696,3,144,48,1362088991586,1362088997218,2510369282,2510374914,5632
1362089002,2510379700,3,144,48,1362088992927,1362088998175,2510370627,2510375875,5248
1362089005,2510382960,2,574,287,1362088979420,1362088979420,2510357380,2510357380,0
1362089006,1148698524,3,144,48,1362088993372,1362088998876,1148685896,1148691400,5504
1362089010,2510387620,31,21259,685.7741935,1362088991218,1362089006002,2510368838,2510383622,14784
1362089010,2510387628,103,123902,1202.932039,1362088992552,1362089004968,2510370180,2510382596,12416
1362089010,2510387708,6,461,76.83333333,1362089008665,1362089008793,2510386373,2510386501,128
1362089013,2510390908,3,138,46,1362088986640,1362088986704,2510364548,2510364612,64
1362089017,2510394944,31,28482,918.7741935,1362088991530,1362089014570,2510369474,2510392514,23040
1362089017,2510394964,10,560,56,1362088992792,1362089014744,2510370756,2510392708,21952
1362089017,2510394964,6,4896,816,1362088992790,1362088993110,2510370754,2510371074,320
1362089017,2510395040,62,69891,1127.274194,1362088991373,1362089014477,2510369413,2510392517,23104
1362089017,2510395044,2,830,415,1362088991753,1362089011721,2510369797,2510389765,19968
1362089017,2510395068,28,27549,983.8928571,1362088992113,1362089013297,2510370181,2510391365,21184
1362089017,2510395068,26,24045,924.8076923,1362088992368,1362089014512,2510370436,2510392580,22144
1362089017,2510395068,10,1898,189.8,1362088992432,1362089012528,2510370500,2510390596,20096
1362089017,2510395068,14,13186,941.8571429,1362088992494,1362089013294,2510370562,2510391362,20800
1362089018,2510395624,2,98,49,1362089011562,1362089017322,2510389186,2510394946,5760
1362089018,2510395628,2,98,49,1362089011686,1362089017318,2510389314,2510394946,5632
1362089018,2510395676,12,1093,91.08333333,1362089014007,1362089014263,2510391683,2510391939,256
1362089018,2510395676,8,732,91.5,1362089014007,1362089017271,2510391683,2510394947,3264
1362089018,2510395716,3,144,48,1362089011602,1362089017298,2510389318,2510395014,5696
1362089018,2510395716,9,568,63.11111111,1362089012048,1362089017232,2510389764,2510394948,5184
1362089018,2510395716,3,169,56.33333333,1362089015247,1362089015247,2510392963,2510392963,0
1362089019,1148711600,4,668,167,1362088991759,1362089011727,1148684359,1148704327,19968
1362089021,2510398904,11,616,56,1362088993171,1362089018259,2510371075,2510396163,25088
1362089021,2510398908,28,35826,1279.5,1362088993296,1362088993360,2510371204,2510371268,64
1362089021,2510398924,11,616,56,1362088993471,1362089019327,2510371395,2510397251,25856
1362089021,2510398932,19,21346,1123.473684,1362088994424,1362089014648,2510372356,2510392580,20224
1362089021,2510399056,20,20053,1002.65,1362088994299,1362089014459,2510372355,2510392515,20160
1362089022,1148714536,3,144,48,1362089011793,1362089016977,1148704329,1148709513,5184
1362089022,1148714544,3,144,48,1362089013639,1362089019015,1148706183,1148711559,5376
1362089026,2510403580,3,144,48,1362089013143,1362089018391,2510390723,2510395971,5248
1362089026,2510403624,7,412,58.85714286,1362089022891,1362089022891,2510400515,2510400515,0
1362089026,2510403628,32,21275,664.84375,1362089011178,1362089024170,2510388806,2510401798,12992
1362089026,2510403636,2,98,49,1362089012894,1362089018334,2510390530,2510395970,5440
1362089026,2510403668,9,541,60.11111111,1362089014015,1362089019583,2510391683,2510397251,5568
1362089026,2510403784,6,366,61,1362089022731,1362089022731,2510400515,2510400515,0
1362089026,2510403784,6,366,61,1362089022731,1362089022731,2510400515,2510400515,0
1362089026,2510403784,7,412,58.85714286,1362089022731,1362089022795,2510400515,2510400579,64
1362089026,2510403796,2,98,49,1362089012478,1362089018174,2510390274,2510395970,5696
1362089029,2510407104,12,1152,96,1362089004491,1362089028491,2510382595,2510406595,24000
1362089033,2510411016,5,1932,386.4,1362089005348,1362089028260,2510383364,2510406276,22912
1362089034,2510411584,6,366,61,1362089026005,1362089026069,2510403589,2510403653,64
1362089034,2510411584,2,98,49,1362089025362,1362089030546,2510402946,2510408130,5184
1362089034,2510411596,2,98,49,1362089026505,1362089032521,2510404101,2510410117,6016
1362089034,2510411596,2,98,49,1362089026505,1362089032521,2510404101,2510410117,6016
1362089034,2510411596,2,98,49,1362089026504,1362089032520,2510404100,2510410116,6016
1362089034,2510411600,3,144,48,1362089026948,1362089032516,2510404548,2510410116,5568
1362089034,2510411624,7,455,65,1362089027436,1362089033516,2510405060,2510411140,6080
1362089034,2510411624,4,190,47.5,1362089027372,1362089028460,2510404996,2510406084,1088
1362089034,2510411664,7,412,58.85714286,1362089025925,1362089025989,2510403589,2510403653,64
1362089034,2510411664,3,144,48,1362089025282,1362089030402,2510402946,2510408066,5120
1362089034,2510411664,4,190,47.5,1362089025282,1362089030466,2510402946,2510408130,5184
1362089034,2510411668,2,98,49,1362089025342,1362089030462,2510403010,2510408130,5120
1362089034,2510411672,10,2344,234.4,1362089025722,1362089031482,2510403394,2510409154,5760
1362089034,2510411680,7,412,58.85714286,1362089026869,1362089026933,2510404549,2510404613,64
1362089034,2510411700,8,544,68,1362089027041,1362089032417,2510404741,2510410117,5376
1362089034,2510411700,9,955,106.1111111,1362089027296,1362089027552,2510404996,2510405252,256
1362089034,2510411704,6,461,76.83333333,1362089027290,1362089027482,2510404994,2510405186,192
1362089037,2510415136,2,92,46,1362089011821,1362089011885,2510389957,2510390021,64
1362089038,1148730512,4,190,47.5,1362089025447,1362089031143,1148717959,1148723655,5696
1362089038,1148730516,3,144,48,1362089027043,1362089032163,1148719559,1148724679,5120
1362089041,2510418940,2,123,61.5,1362089014577,1362089014641,2510392517,2510392581,64
1362089042,2510419632,247,306880,1242.42915,1362088858915,1362089034467,2510236547,2510412099,175552
1362089042,2510419640,6,786,131,1362089039901,1362089040093,2510417541,2510417733,192
1362089042,2510419640,5,643,128.6,1362089039965,1362089040093,2510417605,2510417733,128
1362089042,2510419640,133,154459,1161.345865,1362089012571,1362089038427,2510390211,2510416067,25856
1362089042,2510419684,8,2044,255.5,1362089026416,1362089037424,2510404100,2510415108,11008
1362089042,2510419684,104,123875,1191.105769,1362089026416,1362089040432,2510404100,2510418116,14016
1362089045,2510422920,9,504,56,1362089016965,1362089042181,2510394885,2510420101,25216
1362089049,2510427108,8,448,56,1362089023688,1362089042120,2510401796,2510420228,18432
1362089050,2510427604,6,461,76.83333333,1362089042431,1362089042623,2510420035,2510420227,192
1362089050,2510427716,3,325,108.3333333,1362089039886,1362089045070,2510417602,2510422786,5184
1362089051,1148743604,2,334,167,1362089025485,1362089025549,1148718089,1148718153,64
1362089053,2510430920,7,392,56,1362089024964,1362089042052,2510402884,2510419972,17088
1362089053,2510430924,30,31856,1061.866667,1362089025151,1362089028351,2510403075,2510406275,3200
1362089053,2510430956,9,9303,1033.666667,1362089026080,1362089026528,2510404036,2510404484,448
1362089053,2510430960,9,9164,1018.222222,1362089026394,1362089026650,2510404354,2510404610,256
1362089053,2510431036,2,461,230.5,1362089025551,1362089025615,2510403587,2510403651,64
1362089053,2510431040,17,15323,901.3529412,1362089025034,1362089028170,2510403074,2510406210,3136
1362089053,2510431080,5,949,189.8,1362089026019,1362089026083,2510404099,2510404163,64
1362089053,2510431080,13,14763,1135.615385,1362089026082,1362089028130,2510404162,2510406210,2048
1362089053,2510431084,11,11252,1022.909091,1362089026080,1362089028128,2510404164,2510406212,2048
1362089053,2510431092,10,10585,1058.5,1362089026457,1362089026841,2510404549,2510404933,384
1362089058,2510435608,6,461,76.83333333,1362089057402,1362089057530,2510435010,2510435138,128
1362089058,2510435728,3,144,48,1362089050885,1362089055941,2510428613,2510433669,5056
1362089058,2510435728,4,190,47.5,1362089050884,1362089055940,2510428612,2510433668,5056
1362089061,2510438924,4,384,96,1362089033150,1362089044734,2510411074,2510422658,11584
1362089061,2510438924,1,46,46,1362089033150,1362089033150,2510411074,2510411074,0
1362089061,2510439040,2,92,46,1362089033036,1362089033100,2510411076,2510411140,64
1362089061,2510439056,2,92,46,1362089034108,1362089034172,2510412164,2510412228,64
1362089065,2510442984,2,92,46,1362089037123,1362089037187,2510415107,2510415171,64
1362089066,2510443752,3,138,46,1362089060907,1362089060907,2510438659,2510438659,0
1362089074,2510451788,8,458,57.25,1362089072839,1362089072903,2510450627,2510450691,64
1362089082,2510459676,10,1544,154.4,1362089073335,1362089079223,2510451011,2510456899,5888
1362089082,2510459716,6,496,82.66666667,1362089070928,1362089073936,2510448644,2510451652,3008
1362089085,2510463020,2,92,46,1362089057632,1362089057632,2510435652,2510435652,0
1362089089,2510467172,7,2459,351.2857143,1362089061769,1362089072841,2510439941,2510451013,11072
1362089090,2510467688,6,461,76.83333333,1362089087338,1362089087466,2510465026,2510465154,128
1362089093,2510471192,2,92,46,1362089067441,1362089067441,2510445633,2510445633,0
1362089097,2510475076,1,46,46,1362089070566,1362089070566,2510448642,2510448642,0
1362089106,2510483680,5,643,128.6,1362089099956,1362089100148,2510477636,2510477828,192
1362089106,2510483680,2,92,46,1362089100020,1362089105396,2510477700,2510483076,5376
1362089106,2510483764,3,325,108.3333333,1362089099869,1362089105373,2510477633,2510483137,5504
1362089106,2510483768,6,786,131,1362089099739,1362089099995,2510477507,2510477763,256
1362089109,2510487240,3,169,56.33333333,1362089084418,1362089084546,2510462658,2510462786,128
1362089114,2510491656,266,326009,1225.597744,1362088898314,1362089111946,2510275970,2510489602,213632
1362089114,2510491760,5,632,126.4,1362089094881,1362089110369,2510472641,2510488129,15488
1362089121,2510499060,2,92,46,1362089094966,1362089095030,2510473026,2510473090,64
1362089121,2510499100,9,6025,669.4444444,1362089096016,1362089096080,2510474116,2510474180,64
1362089121,2510499208,4,1058,264.5,1362089095842,1362089095906,2510474050,2510474114,64
1362089125,2510503232,4,672,168,1362089099275,1362089099403,2510477507,2510477635,128
1362089137,2510515040,2,92,46,1362089109001,1362089109065,2510487041,2510487105,64
1362089138,2510515664,3,138,46,1362089130434,1362089130434,2510508098,2510508098,0
1362089138,2510515772,6,461,76.83333333,1362089132245,1362089132373,2510510017,2510510145,128
1362089141,2510519048,217,291112,1341.529954,1362088831105,1362088837441,2510209153,2510215489,6336
1362089141,2510519168,3,492,164,1362089112905,1362089113033,2510491073,2510491201,128
1362089146,2510523704,3,138,46,1362089144347,1362089144411,2510522051,2510522115,64
1362089146,2510523704,2,92,46,1362089144347,1362089144347,2510522051,2510522051,0
1362089146,2510523788,3,138,46,1362089144262,1362089144326,2510522050,2510522114,64
1362089146,2510523788,2,92,46,1362089144262,1362089144262,2510522050,2510522050,0
1362089154,2510531776,3,144,48,1362089148179,1362089153235,2510525955,2510531011,5056
1362089157,2510535220,2,92,46,1362089130007,1362089130071,2510508227,2510508291,64
1362089162,2510539716,5,643,128.6,1362089159884,1362089160012,2510537600,2510537728,128
1362089162,2510539800,6,786,131,1362089159740,1362089159932,2510537540,2510537732,192
1362089167,1148859988,2,92,46,1362089140621,1362089140621,1148833609,1148833609,0
1362089169,2510547104,2,92,46,1362089141962,1362089141962,2510520066,2510520066,0
1362089169,2510547164,3,169,56.33333333,1362089143565,1362089143693,2510521729,2510521857,128
1362089169,2510547208,1,46,46,1362089140835,1362089140835,2510519043,2510519043,0
1362089169,2510547224,1,46,46,1362089141843,1362089141843,2510520067,2510520067,0
1362089169,2510547224,1,46,46,1362089141842,1362089141842,2510520066,2510520066,0
1362089170,2510547672,3,144,48,1362089162810,1362089168314,2510540482,2510545986,5504
1362089170,2510547792,3,325,108.3333333,1362089159810,1362089165250,2510537602,2510543042,5440
1362089173,2510551400,6,1212,202,1362089147041,1362089161633,2510525441,2510540033,14592
1362089178,2510555848,5,575,115,1362089154697,1362089170185,2510532545,2510548033,15488
1362089185,2510563540,1,46,46,1362089160471,1362089160471,2510539011,2510539011,0
1362089201,2510579552,10,3283,328.3,1362089176071,1362089178375,2510554623,2510556927,2304
1362089210,2510587744,1495,1911220,1278.408027,1362089195377,1362089202289,2510573121,2510580033,6912
1362089210,2510587772,3,144,48,1362089196563,1362089202387,2510574335,2510580159,5824
1362089210,2510587816,9,497,55.22222222,1362089202921,1362089207401,2510580737,2510585217,4480
1362089210,2510587852,6,461,76.83333333,1362089207174,1362089207302,2510585026,2510585154,128
1362089222,2510599644,3,1582,527.3333333,1362089196693,1362089196821,2510574337,2510574465,128
1362089225,2510603436,9,504,56,1362089196861,1362089218749,2510575297,2510597185,21888
1362089225,2510603440,9,504,56,1362089196919,1362089219063,2510575359,2510597503,22144
1362089225,2510603440,9,504,56,1362089197241,1362089219129,2510575681,2510597569,21888
1362089225,2510603556,9,864,96,1362089197188,1362089219140,2510575744,2510597696,21952
1362089226,2510603768,6,786,131,1362089219735,1362089219927,2510597503,2510597695,192
1362089226,2510603788,3,325,108.3333333,1362089219843,1362089225795,2510597631,2510603583,5952
1362089226,2510603876,5,643,128.6,1362089219755,1362089219883,2510597631,2510597759,128
1362089237,2510615464,2,92,46,1362089210657,1362089210657,2510589121,2510589121,0
1362089237,2510615500,2,92,46,1362089211643,1362089211643,2510590143,2510590143,0
1362089242,2510619600,2,92,46,1362089215551,1362089215551,2510593151,2510593151,0
1362089242,2510619780,3,144,48,1362089233804,1362089239436,2510611584,2510617216,5632
1362089242,2510619780,7,438,62.57142857,1362089233804,1362089239436,2510611584,2510617216,5632
1362089242,2510619780,2,98,49,1362089233803,1362089239435,2510611583,2510617215,5632
1362089242,2510619788,9,2298,255.3333333,1362089234692,1362089240388,2510612480,2510618176,5696
1362089242,2510619812,3,144,48,1362089235307,1362089240427,2510613119,2510618239,5120
1362089242,2510619820,10,4356,435.6,1362089235814,1362089241382,2510613634,2510619202,5568
1362089242,2510619864,3,144,48,1362089233721,1362089239417,2510611585,2510617281,5696
1362089242,2510619864,2,98,49,1362089233721,1362089239353,2510611585,2510617217,5632
1362089242,2510619864,7,438,62.57142857,1362089233721,1362089239353,2510611585,2510617217,5632
1362089242,2510619864,2,98,49,1362089233785,1362089239353,2510611649,2510617217,5568
1362089242,2510619900,2,98,49,1362089234963,1362089240275,2510612863,2510618175,5312
1362089242,2510619900,5,363,72.6,1362089235030,1362089235094,2510612930,2510612994,64
1362089242,2510619904,3,144,48,1362089235407,1362089241359,2510613311,2510619263,5952
1362089242,2510619904,4,190,47.5,1362089235473,1362089241297,2510613377,2510619201,5824
1362089242,2510619908,12,3505,292.0833333,1362089235980,1362089236300,2510613888,2510614208,320
1362089242,2510619908,6,461,76.83333333,1362089236043,1362089236235,2510613951,2510614143,192
1362089246,2510623604,6,1116,186,1362089219262,1362089238526,2510596866,2510616130,19264
1362089246,1148938540,3,144,48,1362089234512,1362089240208,1148927052,1148932748,5696
1362089246,1148938540,3,144,48,1362089235916,1362089241228,1148928456,1148933768,5312
1362089250,2510627772,4,602,150.5,1362089229973,1362089245461,2510607745,2510623233,15488
1362089250,2510627780,106,124939,1178.669811,1362089234699,1362089248907,2510612479,2510626687,14208
1362089250,2510627856,25,20142,805.68,1362089233342,1362089246590,2510611198,2510624446,13248
1362089258,2510635820,3,144,48,1362089247014,1362089252262,2510624834,2510630082,5248
1362089258,2510635900,6,461,76.83333333,1362089251028,1362089251220,2510628928,2510629120,192
1362089259,1148952024,4,432,108,1362089233130,1362089233962,1148926154,1148926986,832
1362089261,2510639492,5,437,87.4,1362089233091,1362089233923,2510611583,2510612415,832
1362089261,2510639496,20,14070,703.5,1362089233090,1362089236290,2510611586,2510614786,3200
1362089261,2510639528,10,9132,913.2,1362089233953,1362089234977,2510612481,2510613505,1024
1362089261,2510639532,13,12463,958.6923077,1362089234078,1362089234334,2510612610,2510612866,256
1362089261,2510639544,7,392,56,1362089234642,1362089251474,2510613186,2510630018,16832
1362089261,2510639544,24,27232,1134.666667,1362089234705,1362089234897,2510613249,2510613441,192
1362089261,2510639544,6,2381,396.8333333,1362089234832,1362089235152,2510613376,2510613696,320
1362089261,2510639544,6,336,56,1362089234832,1362089248144,2510613376,2510626688,13312
1362089261,2510639572,6,576,96,1362089235317,1362089250421,2510613889,2510628993,15104
1362089262,2510639616,4,559,139.75,1362089233967,1362089234799,2510611583,2510612415,832
1362089262,2510639620,35,33015,943.2857143,1362089233962,1362089237098,2510611582,2510614718,3136
1362089262,2510639620,16,11866,741.625,1362089233962,1362089237162,2510611582,2510614782,3200
1362089262,2510639620,18,12538,696.5555556,1362089233966,1362089237102,2510611586,2510614722,3136
1362089262,2510639652,10,9169,916.9,1362089234827,1362089235403,2510612479,2510613055,576
1362089262,2510639652,11,10564,960.3636364,1362089234827,1362089235595,2510612479,2510613247,768
1362089262,2510639664,11,1431,130.0909091,1362089235392,1362089235712,2510613056,2510613376,320
1362089262,2510639692,6,336,56,1362089235876,1362089251236,2510613568,2510628928,15360
1362089273,2510651472,4,546,136.5,1362089245526,1362089245654,2510623998,2510624126,128
1362089274,2510651588,4,546,136.5,1362089247243,1362089247371,2510624831,2510624959,128
1362089274,2510651872,6,461,76.83333333,1362089266097,1362089266225,2510643969,2510644097,128
1362089282,2510659888,178,123857,695.8258427,1362088845600,1362089278240,2510223488,2510656128,432640
1362089282,2510659920,6,786,131,1362089279617,1362089279809,2510657537,2510657729,192
1362089282,2510659920,5,643,128.6,1362089279678,1362089279806,2510657598,2510657726,128
1362089290,2510667988,3,325,108.3333333,1362089279612,1362089284796,2510657600,2510662784,5184
1362089298,2510675972,6,461,76.83333333,1362089296013,1362089296141,2510673985,2510674113,128
1362089302,2510679712,4,382,95.5,1362089276305,1362089276433,2510654017,2510654145,128
1362089306,2510683612,3,492,164,1362089277875,1362089278003,2510655487,2510655615,128
1362089306,2510683896,6,461,76.83333333,1362089305238,1362089305430,2510683134,2510683326,192
1362089306,2510683972,10,1001,100.1,1362089305163,1362089305355,2510683135,2510683327,192
1362089306,2510683972,4,1531,382.75,1362089304778,1362089304906,2510682750,2510682878,128
1362089310,1149002544,4,190,47.5,1362089302987,1362089308171,1148995531,1149000715,5184
1362089314,2510691876,2,98,49,1362089302700,1362089308332,2510680576,2510686208,5632
1362089314,2510691876,2,98,49,1362089302699,1362089308331,2510680575,2510686207,5632
1362089314,2510691912,3,144,48,1362089303815,1362089309319,2510681727,2510687231,5504
1362089314,2510691920,9,590,65.55555556,1362089304385,1362089310273,2510682305,2510688193,5888
1362089314,2510691920,2,98,49,1362089304766,1362089310270,2510682686,2510688190,5504
1362089314,2510691960,2,98,49,1362089302616,1362089308248,2510680576,2510686208,5632
1362089314,2510691960,3,144,48,1362089302679,1362089308247,2510680639,2510686207,5568
1362089314,2510692044,8,2252,281.5,1362089302979,1362089308163,2510681023,2510686207,5184
1362089314,2510692056,3,144,48,1362089304247,1362089310135,2510682303,2510688191,5888
1362089314,2510692060,7,449,64.14285714,1362089305077,1362089311221,2510683137,2510689281,6144
1362089314,2510692080,4,190,47.5,1362089305055,1362089306143,2510683135,2510684223,1088
1362089318,2510695708,3,169,56.33333333,1362089292691,1362089292691,2510670399,2510670399,0
1362089318,1149010536,3,144,48,1362089305171,1362089310227,1148997707,1149002763,5056
1362089322,2510699588,8,1118,139.75,1362089293835,1362089304267,2510671423,2510681855,10432
1362089322,2510699952,11,3087,280.6363636,1362089303583,1362089314719,2510681535,2510692671,11136
1362089322,2510699960,10,3438,343.8,1362089304598,1362089314454,2510682558,2510692414,9856
1362089322,2510699988,6,461,76.83333333,1362089320187,1362089320315,2510698175,2510698303,128
1362089322,2510700004,123,142033,1154.739837,1362089302125,1362089315693,2510680129,2510693697,13568
1362089322,2510700048,6,497,82.83333333,1362089311553,1362089314561,2510689601,2510692609,3008
1362089327,1149020004,1,288,288,1362089302653,1362089302653,1148995657,1148995657,0
1362089330,2510707928,35,35687,1019.628571,1362089302712,1362089306040,2510680640,2510683968,3328
1362089330,2510707928,11,11138,1012.545455,1362089302710,1362089304118,2510680638,2510682046,1408
1362089330,2510707936,2,461,230.5,1362089303153,1362089303153,2510681089,2510681089,0
1362089330,2510707944,13,11601,892.3846154,1362089303846,1362089306086,2510681790,2510684030,2240
1362089330,2510707968,9,9153,1017,1362089303951,1362089304271,2510681919,2510682239,320
1362089330,2510707972,22,27128,1233.090909,1362089304139,1362089304267,2510682111,2510682239,128
1362089330,2510707972,11,616,56,1362089304203,1362089327179,2510682175,2510705151,22976
1362089330,2510707976,10,560,56,1362089304520,1362089323208,2510682496,2510701184,18688
1362089330,2510708064,9,5831,647.8888889,1362089303409,1362089304497,2510681473,2510682561,1088
1362089330,2510708068,12,12099,1008.25,1362089303724,1362089305900,2510681792,2510683968,2176
1362089330,2510708092,3,1581,527,1362089303893,1362089304213,2510681985,2510682305,320
1362089330,2510708096,10,960,96,1362089304591,1362089323215,2510682687,2510701311,18624
1362089330,2510708096,10,560,56,1362089304655,1362089323343,2510682751,2510701439,18688
1362089330,2510708140,3,144,48,1362089321570,1362089327074,2510699710,2510705214,5504
1362089331,1149024016,32,38632,1207.25,1362089304433,1362089304625,1148997449,1148997641,192
1362089334,2510711900,9,11194,1243.777778,1362089306004,1362089306004,2510683904,2510683904,0
1362089338,2510715916,1,46,46,1362089311683,1362089311683,2510689599,2510689599,0
1362089338,2510716264,6,461,76.83333333,1362089334886,1362089335014,2510713150,2510713278,128
1362089342,2510720028,9,2536,281.7777778,1362089317268,1362089323284,2510695296,2510701312,6016
1362089346,2510724012,10,1622,162.2,1362089321508,1362089330148,2510699520,2510708160,8640
1362089346,2510724204,5,643,128.6,1362089339428,1362089339556,2510717632,2510717760,128
1362089346,2510724280,6,786,131,1362089339223,1362089339415,2510717503,2510717695,192
1362089346,2510724284,3,325,108.3333333,1362089339348,1362089344916,2510717632,2510723200,5568
1362089358,2510735836,1,96,96,1362089330193,1362089330193,2510708029,2510708029,0
1362089358,2510735836,1,56,56,1362089330324,1362089330324,2510708160,2510708160,0
1362089358,2510735948,1,56,56,1362089330017,1362089330017,2510707965,2510707965,0
1362089358,2510735952,1,56,56,1362089330398,1362089330398,2510708350,2510708350,0
1362089370,2510748160,5,664,132.8,1362089349583,1362089365135,2510727743,2510743295,15552
1362089370,2510748288,6,461,76.83333333,1362089364877,1362089365005,2510743165,2510743293,128
1362089378,2510755840,2,92,46,1362089350350,1362089350350,2510728190,2510728190,0
1362089378,2510755872,2,123,61.5,1362089351469,1362089351469,2510729341,2510729341,0
1362089378,2510756052,2,92,46,1362089351098,1362089351162,2510729150,2510729214,64
1362089386,2510764016,2,92,46,1362089361184,1362089361184,2510739200,2510739200,0
1362089386,2510764256,3,144,48,1362089377647,1362089382703,2510755903,2510760959,5056
1362089390,2510767824,2,92,46,1362089362333,1362089362397,2510740157,2510740221,64
1362089390,2510767828,3,169,56.33333333,1362089362522,1362089362650,2510740350,2510740478,128
1362089390,2510767952,6,1937,322.8333333,1362089363229,1362089378077,2510741181,2510756029,14848
1362089402,2510780328,6,786,131,1362089399206,1362089399398,2510777534,2510777726,192
1362089402,2510780328,5,643,128.6,1362089399269,1362089399397,2510777597,2510777725,128
1362089410,2510788332,3,325,108.3333333,1362089399265,1362089405281,2510777597,2510783613,6016
1362089418,2510796160,2,92,46,1362089391756,1362089391756,2510769916,2510769916,0
1362089418,2510796348,6,461,76.83333333,1362089409810,1362089409938,2510788158,2510788286,128
1362089418,2510796352,7,412,58.85714286,1362089409999,1362089409999,2510788351,2510788351,0
1362089426,2510804204,3,138,46,1362089421344,1362089421408,2510799548,2510799612,64
1362089426,2510804208,3,138,46,1362089421341,1362089421405,2510799549,2510799613,64
1362089426,2510804316,2,92,46,1362089421235,1362089421235,2510799551,2510799551,0
1362089426,2510804316,2,92,46,1362089421235,1362089421235,2510799551,2510799551,0
1362089430,2510807984,3,607,202.3333333,1362089404478,1362089404606,2510782462,2510782590,128
1362089434,2510812352,1227,1613638,1315.108394,1362089423501,1362089428749,2510801853,2510807101,5248
1362089438,2510815980,12,4766,397.1666667,1362089413250,1362089425218,2510791230,2510803198,11968
1362089444,1149136240,2,92,46,1362089418874,1362089418874,1149111114,1149111114,0
1362089446,2510823900,2,92,46,1362089418642,1362089418706,2510796542,2510796606,64
1362089446,2510823936,2,92,46,1362089419628,1362089419628,2510797564,2510797564,0
1362089446,2510824052,1,46,46,1362089419514,1362089419514,2510797566,2510797566,0
1362089446,2510824052,1,46,46,1362089419514,1362089419514,2510797566,2510797566,0
1362089446,2510824052,1,46,46,1362089419512,1362089419512,2510797564,2510797564,0
1362089446,2510824084,1,46,46,1362089420507,1362089420507,2510798591,2510798591,0
1362089446,2510824092,3,169,56.33333333,1362089421328,1362089421392,2510799420,2510799484,64
1362089448,1149140216,2,92,46,1362089420884,1362089420884,1149113100,1149113100,0
1362089450,2510827948,7,622,88.85714286,1362089425120,1362089447648,2510803068,2510825596,22528
1362089450,2510828136,3,168,56,1362089425253,1362089427685,2510803389,2510805821,2432
1362089450,2510828136,3,288,96,1362089425444,1362089427876,2510803580,2510806012,2432
1362089450,2510828260,3,138,46,1362089445673,1362089445801,2510823933,2510824061,128
1362089454,2510831888,2,112,56,1362089426653,1362089427869,2510804541,2510805757,1216
1362089454,2510832004,2,112,56,1362089426409,1362089427753,2510804413,2510805757,1344
1362089458,2510836280,3,144,48,1362089451283,1362089456467,2510829563,2510834747,5184
1362089458,2510836280,3,144,48,1362089451283,1362089456467,2510829563,2510834747,5184
1362089458,2510836360,2,98,49,1362089451205,1362089456389,2510829565,2510834749,5184
1362089466,2510844220,3,325,108.3333333,1362089459410,1362089465490,2510837630,2510843710,6080
1362089466,2510844220,5,643,128.6,1362089459410,1362089459538,2510837630,2510837758,128
1362089466,2510844292,6,786,131,1362089459209,1362089459465,2510837501,2510837757,256
1362089470,2510847988,6,1960,326.6666667,1362089444729,1362089467833,2510822717,2510845821,23104
1362089478,2510856028,8,1477,184.625,1362089450703,1362089451215,2510828731,2510829243,512
1362089482,2510860064,4,937,234.25,1362089454637,1362089469805,2510832701,2510847869,15168
1362089491,2510868664,7,507,72.42857143,1362089485499,1362089485627,2510863163,2510863291,128
1362089491,2510868668,9,497,55.22222222,1362089480695,1362089485047,2510858363,2510862715,4352
1362089491,2510868668,2,92,46,1362089486008,1362089486008,2510863676,2510863676,0
1362089498,2510876312,7,460,65.71428571,1362089495222,1362089496694,2510873534,2510875006,1472
1362089498,2510876312,4,1498,374.5,1362089495412,1362089495668,2510873724,2510873980,256
1362089498,2510876316,4,1265,316.25,1362089495601,1362089495857,2510873917,2510874173,256
1362089498,2510876340,7,460,65.71428571,1362089495769,1362089497113,2510874109,2510875453,1344
1362089498,2510876352,5,2846,569.2,1362089497102,1362089497678,2510875454,2510876030,576
1362089498,2510876352,4,687,171.75,1362089497101,1362089497613,2510875453,2510875965,512
1362089498,2510876352,7,3209,458.4285714,1362089497101,1362089497677,2510875453,2510876029,576
1362089498,2510876352,2,92,46,1362089489163,1362089495179,2510867515,2510873531,6016
1362089498,2510876356,2,98,49,1362089489162,1362089495178,2510867518,2510873534,6016
1362089498,2510876388,91,109502,1203.318681,1362089495145,1362089496937,2510873533,2510875325,1792
1362089498,2510876388,3,869,289.6666667,1362089495208,1362089495528,2510873596,2510873916,320
1362089498,2510876416,4,864,216,1362089496012,1362089496332,2510874428,2510874748,320
1362089498,2510876428,4,486,121.5,1362089496897,1362089497217,2510875325,2510875645,320
1362089498,2510876428,6,3162,527,1362089497025,1362089497473,2510875453,2510875901,448
1362089502,1149194572,2,98,49,1362089493614,1362089498798,1149186186,1149191370,5184
1362089502,1149194572,3,144,48,1362089493614,1362089498798,1149186186,1149191370,5184
1362089502,1149194572,3,144,48,1362089493614,1362089499054,1149186186,1149191626,5440
1362089502,1149194572,3,144,48,1362089493614,1362089499054,1149186186,1149191626,5440
1362089502,1149194572,2,98,49,1362089493614,1362089498798,1149186186,1149191370,5184
1362089502,1149194572,3,144,48,1362089493614,1362089499054,1149186186,1149191626,5440
1362089502,1149194572,3,144,48,1362089493614,1362089499054,1149186186,1149191626,5440
1362089502,1149194572,3,144,48,1362089493614,1362089499054,1149186186,1149191626,5440
1362089502,1149194572,3,144,48,1362089493614,1362089499054,1149186186,1149191626,5440
1362089502,1149194572,3,144,48,1362089493614,1362089499054,1149186186,1149191626,5440
1362089502,1149194572,2,98,49,1362089493614,1362089498798,1149186186,1149191370,5184
1362089502,1149194572,2,98,49,1362089493614,1362089498798,1149186186,1149191370,5184
1362089502,1149194572,2,98,49,1362089493678,1362089498798,1149186250,1149191370,5120
1362089502,1149194572,2,98,49,1362089493678,1362089498798,1149186250,1149191370,5120
1362089502,1149194572,2,98,49,1362089493678,1362089498798,1149186250,1149191370,5120
1362089502,1149194572,2,98,49,1362089493678,1362089498798,1149186250,1149191370,5120
1362089502,1149194572,2,98,49,1362089493678,1362089498798,1149186250,1149191370,5120
1362089502,1149194572,2,98,49,1362089493678,1362089498798,1149186250,1149191370,5120
1362089502,1149194572,2,98,49,1362089493678,1362089498798,1149186250,1149191370,5120
1362089502,1149194572,2,98,49,1362089493678,1362089498798,1149186250,1149191370,5120
1362089502,1149194576,3,144,48,1362089493741,1362089499053,1149186317,1149191629,5312
1362089502,1149194576,3,144,48,1362089493741,1362089498797,1149186317,1149191373,5056
1362089502,1149194576,3,144,48,1362089493741,1362089499053,1149186317,1149191629,5312
1362089502,1149194576,3,144,48,1362089493741,1362089499053,1149186317,1149191629,5312
1362089502,1149194576,3,144,48,1362089493741,1362089499053,1149186317,1149191629,5312
1362089502,1149194576,2,98,49,1362089493741,1362089498797,1149186317,1149191373,5056
1362089502,1149194576,3,144,48,1362089493741,1362089499053,1149186317,1149191629,5312
1362089502,1149194576,2,98,49,1362089493741,1362089498797,1149186317,1149191373,5056
1362089502,1149194576,2,98,49,1362089493741,1362089498797,1149186317,1149191373,5056
1362089502,1149194592,2,98,49,1362089493597,1362089498781,1149186189,1149191373,5184
1362089502,1149194592,3,144,48,1362089493597,1362089498781,1149186189,1149191373,5184
1362089502,1149194592,3,144,48,1362089493597,1362089499037,1149186189,1149191629,5440
1362089502,1149194592,3,144,48,1362089493597,1362089499037,1149186189,1149191629,5440
1362089502,1149194592,3,144,48,1362089493597,1362089499037,1149186189,1149191629,5440
1362089502,1149194592,2,98,49,1362089493597,1362089498781,1149186189,1149191373,5184
1362089502,1149194592,2,98,49,1362089493596,1362089498780,1149186188,1149191372,5184
1362089502,1149194592,2,98,49,1362089493596,1362089498780,1149186188,1149191372,5184
1362089502,1149194592,2,98,49,1362089493596,1362089498780,1149186188,1149191372,5184
1362089502,1149194592,2,98,49,1362089493660,1362089498780,1149186252,1149191372,5120
1362089502,1149194592,2,98,49,1362089493660,1362089498780,1149186252,1149191372,5120
1362089502,1149194592,2,98,49,1362089493660,1362089498780,1149186252,1149191372,5120
1362089502,1149194592,2,98,49,1362089493660,1362089498780,1149186252,1149191372,5120
1362089502,1149194592,2,98,49,1362089493660,1362089498780,1149186252,1149191372,5120
1362089502,1149194592,2,98,49,1362089493660,1362089498780,1149186252,1149191372,5120
1362089502,1149194592,2,98,49,1362089493660,1362089498780,1149186252,1149191372,5120
1362089502,1149194592,3,144,48,1362089493724,1362089499036,1149186316,1149191628,5312
1362089502,1149194592,3,144,48,1362089493724,1362089498780,1149186316,1149191372,5056
1362089502,1149194592,3,144,48,1362089493724,1362089499036,1149186316,1149191628,5312
1362089502,1149194592,4,190,47.5,1362089493724,1362089499036,1149186316,1149191628,5312
1362089502,1149194592,3,144,48,1362089493724,1362089499036,1149186316,1149191628,5312
1362089502,1149194592,2,98,49,1362089493596,1362089498780,1149186188,1149191372,5184
1362089502,1149194592,3,144,48,1362089493596,1362089498780,1149186188,1149191372,5184
1362089502,1149194592,3,144,48,1362089493596,1362089499036,1149186188,1149191628,5440
1362089502,1149194592,2,98,49,1362089493595,1362089498779,1149186187,1149191371,5184
1362089502,1149194592,2,98,49,1362089493659,1362089498779,1149186251,1149191371,5120
1362089502,1149194592,3,144,48,1362089493723,1362089499035,1149186315,1149191627,5312
1362089502,1149194592,3,144,48,1362089493723,1362089499035,1149186315,1149191627,5312
1362089502,1149194592,2,98,49,1362089493723,1362089498779,1149186315,1149191371,5056
1362089502,1149194592,2,98,49,1362089493723,1362089498779,1149186315,1149191371,5056
1362089506,2510884328,7,1733,247.5714286,1362089498086,1362089500902,2510876414,2510879230,2816
1362089506,2510884328,4,188,47,1362089498086,1362089504358,2510876414,2510882686,6272
1362089506,2510884328,5,234,46.8,1362089498086,1362089504358,2510876414,2510882686,6272
1362089506,2510884328,4,548,137,1362089498086,1362089498470,2510876414,2510876798,384
1362089506,2510884328,7,3482,497.4285714,1362089498085,1362089500709,2510876413,2510879037,2624
1362089506,2510884328,3,144,48,1362089498085,1362089504293,2510876413,2510882621,6208
1362089506,2510884328,14,7212,515.1428571,1362089498085,1362089499045,2510876413,2510877373,960
1362089506,2510884328,4,548,137,1362089502115,1362089504035,2510880443,2510882363,1920
1362089506,2510884328,4,548,137,1362089502115,1362089504035,2510880443,2510882363,1920
1362089506,2510884328,3,718,239.3333333,1362089502115,1362089502883,2510880443,2510881211,768
1362089506,2510884336,6,3999,666.5,1362089498718,1362089499166,2510877054,2510877502,448
1362089506,2510884336,2,98,49,1362089499163,1362089504283,2510877499,2510882619,5120
1362089506,2510884336,2,92,46,1362089499163,1362089504283,2510877499,2510882619,5120
1362089506,2510884340,3,144,48,1362089495194,1362089500954,2510873534,2510879294,5760
1362089506,2510884340,2,98,49,1362089499162,1362089504282,2510877502,2510882622,5120
1362089506,2510884344,7,1908,272.5714286,1362089503061,1362089504149,2510881405,2510882493,1088
1362089506,2510884364,4,196,49,1362089495743,1362089502143,2510874107,2510880507,6400
1362089506,2510884368,3,140,46.66666667,1362089503485,1362089503677,2510881853,2510882045,192
1362089506,2510884368,9,1390,154.4444444,1362089503484,1362089504316,2510881852,2510882684,832
1362089506,2510884368,2,98,49,1362089495676,1362089502076,2510874044,2510880444,6400
1362089506,2510884368,5,605,121,1362089495740,1362089500220,2510874108,2510878588,4480
1362089506,2510884368,3,144,48,1362089497723,1362089504379,2510876091,2510882747,6656
1362089506,2510884368,4,467,116.75,1362089500411,1362089500859,2510878779,2510879227,448
1362089506,2510884372,3,144,48,1362089496058,1362089502138,2510874430,2510880510,6080
1362089506,2510884372,7,2382,340.2857143,1362089500665,1362089501369,2510879037,2510879741,704
1362089506,2510884372,8,4867,608.375,1362089500856,1362089501560,2510879228,2510879932,704
1362089506,2510884372,4,548,137,1362089500856,1362089501688,2510879228,2510880060,832
1362089506,2510884372,5,594,118.8,1362089500856,1362089501688,2510879228,2510880060,832
1362089506,2510884372,4,1165,291.25,1362089500919,1362089501559,2510879291,2510879931,640
1362089506,2510884372,2,92,46,1362089496055,1362089502135,2510874427,2510880507,6080
1362089506,2510884376,4,467,116.75,1362089500854,1362089502070,2510879230,2510880446,1216
1362089506,2510884376,2,98,49,1362089496628,1362089502132,2510875004,2510880508,5504
1362089506,2510884376,4,512,128,1362089504435,1362089505011,2510882811,2510883387,576
1362089506,2510884380,3,144,48,1362089496946,1362089502066,2510875326,2510880446,5120
1362089506,2510884380,2,98,49,1362089496946,1362089502066,2510875326,2510880446,5120
1362089506,2510884380,2,98,49,1362089497010,1362089502066,2510875390,2510880446,5056
1362089506,2510884380,3,144,48,1362089497073,1362089504241,2510875453,2510882621,7168
1362089506,2510884380,2,98,49,1362089497073,1362089504241,2510875453,2510882621,7168
1362089506,2510884380,4,548,137,1362089497073,1362089497969,2510875453,2510876349,896
1362089506,2510884380,5,594,118.8,1362089497073,1362089498033,2510875453,2510876413,960
1362089506,2510884380,4,725,181.25,1362089497073,1362089499057,2510875453,2510877437,1984
1362089506,2510884380,7,2938,419.7142857,1362089497073,1362089500465,2510875453,2510878845,3392
1362089506,2510884380,2,92,46,1362089497073,1362089504241,2510875453,2510882621,7168
1362089506,2510884380,3,144,48,1362089497073,1362089504241,2510875453,2510882621,7168
1362089506,2510884380,5,598,119.6,1362089504433,1362089504817,2510882813,2510883197,384
1362089506,2510884380,5,441,88.2,1362089504433,1362089505521,2510882813,2510883901,1088
1362089506,2510884408,5,486,97.2,1362089497622,1362089498006,2510876030,2510876414,384
1362089506,2510884412,4,548,137,1362089498000,1362089498384,2510876412,2510876796,384
1362089506,2510884412,4,188,47,1362089498000,1362089504272,2510876412,2510882684,6272
1362089506,2510884412,14,7207,514.7857143,1362089498000,1362089499152,2510876412,2510877564,1152
1362089506,2510884412,14,7904,564.5714286,1362089498000,1362089505360,2510876412,2510883772,7360
1362089506,2510884416,6,1808,301.3333333,1362089502029,1362089502797,2510880445,2510881213,768
1362089506,2510884416,6,1815,302.5,1362089502029,1362089502797,2510880445,2510881213,768
1362089506,2510884416,6,980,163.3333333,1362089502092,1362089502860,2510880508,2510881276,768
1362089506,2510884416,4,188,47,1362089498379,1362089504267,2510876795,2510882683,5888
1362089506,2510884420,12,7120,593.3333333,1362089498378,1362089499082,2510876798,2510877502,704
1362089506,2510884420,11,7276,661.4545455,1362089498633,1362089499081,2510877053,2510877501,448
1362089506,2510884424,3,144,48,1362089499077,1362089504197,2510877501,2510882621,5120
1362089506,2510884424,3,138,46,1362089499077,1362089504261,2510877501,2510882685,5184
1362089506,2510884424,8,3263,407.875,1362089499077,1362089500869,2510877501,2510879293,1792
1362089506,2510884424,2,98,49,1362089499077,1362089504197,2510877501,2510882621,5120
1362089506,2510884444,7,1906,272.2857143,1362089502961,1362089503985,2510881405,2510882429,1024
1362089506,2510884448,3,144,48,1362089495406,1362089500846,2510873854,2510879294,5440
1362089506,2510884448,17,11718,689.2941176,1362089495661,1362089500397,2510874109,2510878845,4736
1362089506,2510884452,39,42497,1089.666667,1362089495658,1362089501290,2510874110,2510879742,5632
1362089506,2510884452,3,150,50,1362089495658,1362089502058,2510874110,2510880510,6400
1362089506,2510884456,10,3548,354.8,1362089495973,1362089502053,2510874429,2510880509,6080
1362089506,2510884456,3,421,140.3333333,1362089500581,1362089500773,2510879037,2510879229,192
1362089506,2510884456,4,548,137,1362089500771,1362089501283,2510879227,2510879739,512
1362089506,2510884456,3,502,167.3333333,1362089500771,1362089501795,2510879227,2510880251,1024
1362089506,2510884460,4,467,116.75,1362089500770,1362089501986,2510879230,2510880446,1216
1362089506,2510884484,3,140,46.66666667,1362089496522,1362089501962,2510875006,2510880446,5440
1362089506,2510884484,5,841,168.2,1362089504330,1362089504842,2510882814,2510883326,512
1362089506,2510884484,3,144,48,1362089496841,1362089501961,2510875325,2510880445,5120
1362089506,2510884484,3,822,274,1362089504329,1362089504649,2510882813,2510883133,320
1362089506,2510884484,2,98,49,1362089496905,1362089501961,2510875389,2510880445,5056
1362089506,2510884484,11,7312,664.7272727,1362089496969,1362089497865,2510875453,2510876349,896
1362089506,2510884484,11,7315,665,1362089496969,1362089497865,2510875453,2510876349,896
1362089506,2510884484,27,28721,1063.740741,1362089496969,1362089503689,2510875453,2510882173,6720
1362089506,2510884484,2,98,49,1362089496968,1362089504136,2510875452,2510882620,7168
1362089506,2510884484,5,532,106.4,1362089496968,1362089500296,2510875452,2510878780,3328
1362089506,2510884484,2,98,49,1362089496968,1362089504136,2510875452,2510882620,7168
1362089506,2510884488,5,486,97.2,1362089497539,1362089500803,2510876027,2510879291,3264
1362089507,2510884728,1,46,46,1362089480766,1362089480766,2510858494,2510858494,0
1362089510,1149202560,3,144,48,1362089496061,1362089502461,1149188621,1149195021,6400
1362089510,1149202560,2,98,49,1362089496444,1362089502460,1149189004,1149195020,6016
1362089510,1149202560,2,98,49,1362089502267,1362089508603,1149194827,1149201163,6336
1362089510,1149202560,2,98,49,1362089496443,1362089502459,1149189003,1149195019,6016
1362089510,1149202568,3,144,48,1362089502259,1362089508595,1149194827,1149201163,6336
1362089510,1149202572,2,98,49,1362089497392,1362089502448,1149189964,1149195020,5056
1362089510,1149202572,3,144,48,1362089503281,1362089508593,1149195853,1149201165,5312
1362089514,2510892312,3,144,48,1362089505908,1362089511348,2510884220,2510889660,5440
1362089514,2510892312,2,98,49,1362089505972,1362089511284,2510884284,2510889596,5312
1362089514,2510892312,2,98,49,1362089505971,1362089511283,2510884283,2510889595,5312
1362089514,2510892312,2,94,47,1362089505971,1362089511347,2510884283,2510889659,5376
1362089514,2510892312,2,94,47,1362089505971,1362089512307,2510884283,2510890619,6336
1362089514,2510892316,16,2603,162.6875,1362089505967,1362089511983,2510884283,2510890299,6016
1362089514,2510892316,7,859,122.7142857,1362089501937,1362089506353,2510880253,2510884669,4416
1362089514,2510892320,2,92,46,1362089502126,1362089508270,2510880446,2510886590,6144
1362089514,2510892320,2,94,47,1362089502126,1362089508270,2510880446,2510886590,6144
1362089514,2510892320,6,463,77.16666667,1362089502190,1362089506990,2510880510,2510885310,4800
1362089514,2510892320,20,10817,540.85,1362089502190,1362089508654,2510880510,2510886974,6464
1362089514,2510892320,9,1681,186.7777778,1362089502190,1362089507502,2510880510,2510885822,5312
1362089514,2510892320,4,190,47.5,1362089502190,1362089507374,2510880510,2510885694,5184
1362089514,2510892320,2,279,139.5,1362089502189,1362089508269,2510880509,2510886589,6080
1362089514,2510892320,2,92,46,1362089502189,1362089508269,2510880509,2510886589,6080
1362089514,2510892320,7,2643,377.5714286,1362089502189,1362089509293,2510880509,2510887613,7104
1362089514,2510892320,8,3452,431.5,1362089502188,1362089509356,2510880508,2510887676,7168
1362089514,2510892320,2,92,46,1362089506667,1362089512299,2510884987,2510890619,5632
1362089514,2510892324,2,92,46,1362089506730,1362089512298,2510885054,2510890622,5568
1362089514,2510892324,2,92,46,1362089506730,1362089512298,2510885054,2510890622,5568
1362089514,2510892328,2,92,46,1362089507174,1362089512294,2510885502,2510890622,5120
1362089514,2510892332,3,140,46.66666667,1362089507810,1362089513250,2510886142,2510891582,5440
1362089514,2510892332,4,467,116.75,1362089507810,1362089509026,2510886142,2510887358,1216
1362089514,2510892332,7,1792,256,1362089507810,1362089508258,2510886142,2510886590,448
1362089514,2510892332,4,784,196,1362089507810,1362089508258,2510886142,2510886590,448
1362089514,2510892332,3,144,48,1362089507746,1362089513570,2510886078,2510891902,5824
1362089514,2510892332,4,186,46.5,1362089507809,1362089513249,2510886141,2510891581,5440
1362089514,2510892332,4,467,116.75,1362089507809,1362089508321,2510886141,2510886653,512
1362089514,2510892332,7,1773,253.2857143,1362089507809,1362089508257,2510886141,2510886589,448
1362089514,2510892352,16,1348,84.25,1362089495692,1362089505932,2510874044,2510884284,10240
1362089514,2510892356,10,3463,346.3,1362089508361,1362089509193,2510886717,2510887549,832
1362089514,2510892356,7,1246,178,1362089508361,1362089513737,2510886717,2510892093,5376
1362089514,2510892360,6,2892,482,1362089508742,1362089509062,2510887102,2510887422,320
1362089514,2510892364,3,144,48,1362089500930,1362089506690,2510879294,2510885054,5760
1362089514,2510892364,7,748,106.8571429,1362089500991,1362089511423,2510879355,2510889787,10432
1362089514,2510892368,5,836,167.2,1362089504444,1362089508220,2510882812,2510886588,3776
1362089514,2510892368,3,144,48,1362089504444,1362089510268,2510882812,2510888636,5824
1362089514,2510892368,2,98,49,1362089504444,1362089511228,2510882812,2510889596,6784
1362089514,2510892368,2,98,49,1362089501372,1362089506684,2510879740,2510885052,5312
1362089514,2510892368,2,92,46,1362089504444,1362089510268,2510882812,2510888636,5824
1362089514,2510892368,2,98,49,1362089504444,1362089510268,2510882812,2510888636,5824
1362089514,2510892368,3,144,48,1362089504444,1362089510268,2510882812,2510888636,5824
1362089514,2510892368,2,98,49,1362089504444,1362089511228,2510882812,2510889596,6784
1362089514,2510892368,2,92,46,1362089504316,1362089510268,2510882684,2510888636,5952
1362089514,2510892368,3,325,108.3333333,1362089504444,1362089511228,2510882812,2510889596,6784
1362089514,2510892368,2,98,49,1362089504444,1362089511292,2510882812,2510889660,6848
1362089514,2510892372,3,144,48,1362089504438,1362089510262,2510882810,2510888634,5824
1362089514,2510892400,2,92,46,1362089505500,1362089511196,2510883900,2510889596,5696
1362089514,2510892400,4,1017,254.25,1362089505563,1362089506651,2510883963,2510885051,1088
1362089514,2510892400,26,26062,1002.384615,1362089505563,1362089511195,2510883963,2510889595,5632
1362089514,2510892404,3,144,48,1362089505818,1362089511194,2510884222,2510889598,5376
1362089514,2510892404,2,94,47,1362089505881,1362089512217,2510884285,2510890621,6336
1362089514,2510892404,16,2689,168.0625,1362089505881,1362089511769,2510884285,2510890173,5888
1362089514,2510892404,2,94,47,1362089505881,1362089512217,2510884285,2510890621,6336
1362089514,2510892408,2,98,49,1362089502038,1362089508182,2510880446,2510886590,6144
1362089514,2510892408,4,196,49,1362089502101,1362089508245,2510880509,2510886653,6144
1362089514,2510892408,2,92,46,1362089502101,1362089508245,2510880509,2510886653,6144
1362089514,2510892408,9,1681,186.7777778,1362089502101,1362089507541,2510880509,2510885949,5440
1362089514,2510892408,2,92,46,1362089502101,1362089508181,2510880509,2510886589,6080
1362089514,2510892408,3,138,46,1362089502101,1362089508309,2510880509,2510886717,6208
1362089514,2510892412,3,138,46,1362089506833,1362089512273,2510885245,2510890685,5440
1362089514,2510892412,10,7474,747.4,1362089507151,1362089513167,2510885563,2510891579,6016
1362089514,2510892416,10,4085,408.5,1362089499082,1362089509002,2510877498,2510887418,9920
1362089514,2510892440,3,421,140.3333333,1362089507699,1362089508147,2510886139,2510886587,448
1362089514,2510892444,5,1019,203.8,1362089507761,1362089510193,2510886205,2510888637,2432
1362089514,2510892444,3,138,46,1362089507633,1362089513201,2510886077,2510891645,5568
1362089514,2510892448,44,40221,914.1136364,1362089495597,1362089508077,2510874045,2510886525,12480
1362089514,2510892448,5,234,46.8,1362089508269,1362089509933,2510886717,2510888381,1664
1362089514,2510892452,5,1126,225.2,1362089508650,1362089508970,2510887102,2510887422,320
1362089514,2510892452,21,22347,1064.142857,1362089508584,1362089508776,2510887036,2510887228,192
1362089514,2510892456,6,1239,206.5,1362089504037,1362089509285,2510882493,2510887741,5248
1362089514,2510892456,2,98,49,1362089500837,1362089506597,2510879293,2510885053,5760
1362089514,2510892456,9,1348,149.7777778,1362089504037,1362089510565,2510882493,2510889021,6528
1362089514,2510892460,3,325,108.3333333,1362089504226,1362089510242,2510882686,2510888702,6016
1362089514,2510892460,2,279,139.5,1362089501281,1362089506593,2510879741,2510885053,5312
1362089514,2510892488,2,98,49,1362089504325,1362089511109,2510882813,2510889597,6784
1362089514,2510892488,3,144,48,1362089504325,1362089510149,2510882813,2510888637,5824
1362089514,2510892488,2,98,49,1362089504325,1362089510149,2510882813,2510888637,5824
1362089514,2510892488,4,396,99,1362089504325,1362089511109,2510882813,2510889597,6784
1362089514,2510892488,3,144,48,1362089504325,1362089510149,2510882813,2510888637,5824
1362089514,2510892488,6,929,154.8333333,1362089504325,1362089506245,2510882813,2510884733,1920
1362089514,2510892488,4,190,47.5,1362089504324,1362089509508,2510882812,2510887996,5184
1362089514,2510892488,2,98,49,1362089504260,1362089511108,2510882748,2510889596,6848
1362089514,2510892488,2,98,49,1362089504324,1362089511108,2510882812,2510889596,6784
1362089514,2510892488,2,98,49,1362089504324,1362089511108,2510882812,2510889596,6784
1362089514,2510892488,6,728,121.3333333,1362089504324,1362089508932,2510882812,2510887420,4608
1362089514,2510892488,2,92,46,1362089504324,1362089510148,2510882812,2510888636,5824
1362089514,2510892488,2,94,47,1362089504324,1362089510148,2510882812,2510888636,5824
1362089514,2510892488,3,138,46,1362089504323,1362089511235,2510882811,2510889723,6912
1362089514,2510892488,2,98,49,1362089504323,1362089511171,2510882811,2510889659,6848
1362089514,2510892496,4,1024,256,1362089505534,1362089506686,2510884030,2510885182,1152
1362089515,2510892736,5,460,92,1362089489780,1362089489908,2510867516,2510867644,128
1362089518,1149210568,4,196,49,1362089510709,1362089516661,1149203277,1149209229,5952
1362089518,1149210568,3,144,48,1362089511154,1362089516658,1149203722,1149209226,5504
1362089518,1149210576,3,144,48,1362089509932,1362089515692,1149202508,1149208268,5760
1362089518,1149210576,3,144,48,1362089508652,1362089514604,1149201228,1149207180,5952
1362089518,1149210576,4,196,49,1362089510698,1362089517674,1149203274,1149210250,6976
1362089518,1149210588,2,98,49,1362089511326,1362089516638,1149203914,1149209226,5312
1362089518,2510896332,22,1232,56,1362089493345,1362089517537,2510871677,2510895869,24192
1362089518,2510896452,23,1288,56,1362089493161,1362089517737,2510871613,2510896189,24576
1362089518,2510896456,22,1232,56,1362089493413,1362089517541,2510871869,2510895997,24128
1362089518,2510896456,22,2112,96,1362089493539,1362089517603,2510871995,2510896059,24064
1362089520,1149212228,4,447,111.75,1362089494025,1362089494089,1149186253,1149186317,64
1362089520,1149212272,4,445,111.25,1362089493981,1362089495773,1149186253,1149188045,1792
1362089522,2510900340,3,144,48,1362089510808,1362089516376,2510889148,2510894716,5568
1362089522,2510900344,3,150,50,1362089507798,1362089514262,2510886142,2510892606,6464
1362089522,2510900376,2,98,49,1362089508980,1362089514228,2510887356,2510892604,5248
1362089522,2510900376,2,98,49,1362089509043,1362089514227,2510887419,2510892603,5184
1362089522,2510900376,2,98,49,1362089509043,1362089514227,2510887419,2510892603,5184
1362089522,2510900384,50,24126,482.52,1362089496366,1362089516718,2510874750,2510895102,20352
1362089522,2510900388,7,1246,178,1362089504422,1362089520550,2510882810,2510898938,16128
1362089522,2510900448,5,897,179.4,1362089507116,1362089519596,2510885564,2510898044,12480
1362089522,2510900452,3,150,50,1362089507687,1362089514151,2510886139,2510892603,6464
1362089522,2510900456,2,98,49,1362089507686,1362089514150,2510886142,2510892606,6464
1362089522,2510900456,3,140,46.66666667,1362089507686,1362089514150,2510886142,2510892606,6464
1362089522,2510900456,2,279,139.5,1362089507686,1362089514150,2510886142,2510892606,6464
1362089522,2510900460,2,98,49,1362089508126,1362089514142,2510886586,2510892602,6016
1362089522,2510900460,3,144,48,1362089508959,1362089514143,2510887419,2510892603,5184
1362089522,2510900464,2,98,49,1362089508958,1362089514142,2510887422,2510892606,5184
1362089522,2510900464,3,325,108.3333333,1362089508958,1362089514206,2510887422,2510892670,5248
1362089522,2510900492,7,806,115.1428571,1362089504319,1362089519807,2510882811,2510898299,15488
1362089522,2510900572,5,1012,202.4,1362089495090,1362089495346,2510873662,2510873918,256
1362089522,2510900576,11,7177,652.4545455,1362089495468,1362089496108,2510874044,2510874684,640
1362089523,2510900620,7,2389,341.2857143,1362089497385,1362089500841,2510875005,2510878461,3456
1362089523,2510900620,8,1481,185.125,1362089497385,1362089500969,2510875005,2510878589,3584
1362089523,2510900628,3,513,171,1362089497823,1362089500959,2510875451,2510878587,3136
1362089523,2510900632,5,1596,319.2,1362089497819,1362089501531,2510875451,2510879163,3712
1362089523,2510900664,6,2065,344.1666667,1362089498426,1362089498618,2510876090,2510876282,192
1362089523,2510900704,6,994,165.6666667,1362089496340,1362089497300,2510874044,2510875004,960
1362089523,2510900704,8,1442,180.25,1362089496340,1362089497364,2510874044,2510875068,1024
1362089523,2510900704,4,788,197,1362089496340,1362089496532,2510874044,2510874236,192
1362089523,2510900712,4,526,131.5,1362089496714,1362089496906,2510874426,2510874618,192
1362089523,2510900752,13,5001,384.6923077,1362089497698,1362089509346,2510875450,2510887098,11648
1362089524,1149216208,4,451,112.75,1362089496411,1362089496667,1149188619,1149188875,256
1362089524,1149216220,12,1890,157.5,1362089497617,1362089505105,1149189837,1149197325,7488
1362089524,1149216268,6,766,127.6666667,1362089497247,1362089502751,1149189515,1149195019,5504
1362089526,2510904268,10,7023,702.3,1362089498145,1362089499169,2510876413,2510877437,1024
1362089526,2510904272,1,46,46,1362089498461,1362089498461,2510876733,2510876733,0
1362089526,2510904300,7,3515,502.1428571,1362089499200,1362089499648,2510877500,2510877948,448
1362089526,2510904340,12,6032,502.6666667,1362089500954,1362089501722,2510879294,2510880062,768
1362089526,2510904380,1,46,46,1362089497967,1362089497967,2510876347,2510876347,0
1362089526,2510904396,32,13732,429.125,1362089499103,1362089504287,2510877499,2510882683,5184
1362089526,2510904440,12,6047,503.9166667,1362089500853,1362089501493,2510879293,2510879933,640
1362089528,1149220208,29,33006,1138.137931,1362089502429,1362089504157,1149194637,1149196365,1728
1362089530,2510908492,27,12261,454.1111111,1362089501954,1362089507202,2510880446,2510885694,5248
1362089530,2510908536,8,1814,226.75,1362089503573,1362089507477,2510882109,2510886013,3904
1362089530,2510908536,4,1514,378.5,1362089503573,1362089503765,2510882109,2510882301,192
1362089530,2510908544,4,354,88.5,1362089504269,1362089504461,2510882813,2510883005,192
1362089530,2510908544,4,817,204.25,1362089504269,1362089505037,2510882813,2510883581,768
1362089530,2510908544,2,784,392,1362089504269,1362089506765,2510882813,2510885309,2496
1362089530,2510908544,5,737,147.4,1362089504268,1362089508236,2510882812,2510886780,3968
1362089530,2510908564,3,1021,340.3333333,1362089504249,1362089505209,2510882813,2510883773,960
1362089531,2510908688,23,10107,439.4347826,1362089502756,1362089507876,2510880444,2510885564,5120
1362089531,2510908688,11,4689,426.2727273,1362089502756,1362089507748,2510880444,2510885436,4992
1362089531,2510908688,16,6943,433.9375,1362089502755,1362089508451,2510880443,2510886139,5696
1362089531,2510908732,8,1778,222.25,1362089504375,1362089508471,2510882107,2510886203,4096
1362089531,2510908744,4,1046,261.5,1362089505002,1362089505706,2510882746,2510883450,704
1362089531,2510908744,11,8351,759.1818182,1362089505070,1362089509102,2510882814,2510886846,4032
1362089531,2510908744,5,1159,231.8,1362089505070,1362089508974,2510882814,2510886718,3904
1362089531,2510908744,5,2188,437.6,1362089505070,1362089505198,2510882814,2510882942,128
1362089531,2510908744,4,533,133.25,1362089505069,1362089506221,2510882813,2510883965,1152
1362089531,2510908776,4,1470,367.5,1362089506124,1362089506252,2510883900,2510884028,128
1362089532,1149224216,3,815,271.6666667,1362089504146,1362089504338,1149196362,1149196554,192
1362089534,2510912336,5,840,168,1362089505948,1362089507164,2510884284,2510885500,1216
1362089534,2510912336,3,443,147.6666667,1362089505948,1362089506332,2510884284,2510884668,384
1362089534,2510912344,1,46,46,1362089506262,1362089506262,2510884606,2510884606,0
1362089534,2510912348,13,3529,271.4615385,1362089506577,1362089507793,2510884925,2510886141,1216
1362089534,2510912348,1,46,46,1362089506640,1362089506640,2510884988,2510884988,0
1362089534,2510912348,4,417,104.25,1362089506703,1362089507919,2510885051,2510886267,1216
1362089534,2510912376,4,441,110.25,1362089506998,1362089507254,2510885374,2510885630,256
1362089534,2510912376,5,2206,441.2,1362089507187,1362089507443,2510885563,2510885819,256
1362089534,2510912380,6,2252,375.3333333,1362089507182,1362089507374,2510885562,2510885754,192
1362089534,2510912384,5,2978,595.6,1362089507757,1362089508141,2510886141,2510886525,384
1362089534,2510912436,4,648,162,1362089505849,1362089505977,2510884285,2510884413,128
1362089534,2510912436,6,648,108,1362089505849,1362089508665,2510884285,2510887101,2816
1362089534,2510912464,1,46,46,1362089506142,1362089506142,2510884606,2510884606,0
1362089534,2510912464,1,46,46,1362089506269,1362089506269,2510884733,2510884733,0
1362089534,2510912464,1,46,46,1362089506268,1362089506268,2510884732,2510884732,0
1362089534,2510912468,12,3290,274.1666667,1362089506458,1362089507034,2510884926,2510885502,576
1362089534,2510912468,8,5552,694,1362089506521,1362089508569,2510884989,2510887037,2048
1362089534,2510912468,17,4014,236.1176471,1362089506583,1362089508503,2510885051,2510886971,1920
1362089534,2510912468,4,514,128.5,1362089506583,1362089506775,2510885051,2510885243,192
1362089534,2510912472,2,446,223,1362089506772,1362089507476,2510885244,2510885948,704
1362089536,1149228196,21,17899,852.3333333,1362089510311,1362089511463,1149202507,1149203659,1152
1362089536,1149228208,4,528,132,1362089509021,1362089509213,1149201229,1149201421,192
1362089536,1149228232,6,3759,626.5,1362089511621,1362089511941,1149203853,1149204173,320
1362089536,1149228272,4,590,147.5,1362089511386,1362089511514,1149203658,1149203786,128
1362089538,2510916520,5,881,176.2,1362089510500,1362089510692,2510889020,2510889212,192
1362089539,2510916728,25,12575,503,1362089514172,1362089516092,2510891900,2510893820,1920
1362089542,2510920504,19,22029,1159.421053,1362089514163,1362089516211,2510892667,2510894715,2048
1362089546,2510924516,70,3920,56,1362089517736,1362089545512,2510896252,2510924028,27776
1362089546,2510924516,70,3920,56,1362089517862,1362089545574,2510896378,2510924090,27712
1362089547,2510924640,70,6720,96,1362089518805,1362089546517,2510896445,2510924157,27712
1362089547,2510924640,70,3920,56,1362089518931,1362089546579,2510896571,2510924219,27648
1362089558,1149250596,3,144,48,1362089550232,1362089556248,1149242828,1149248844,6016
1362089558,2510936520,3,138,46,1362089530340,1362089530404,2510908860,2510908924,64
1362089562,2510940508,3,138,46,1362089554606,1362089554670,2510933114,2510933178,64
1362089562,2510940512,4,215,53.75,1362089555436,1362089560492,2510933948,2510939004,5056
1362089562,2510940540,5,452,90.4,1362089552080,1362089555088,2510930620,2510933628,3008
1362089566,2510944564,1,46,46,1362089538167,1362089538167,2510916731,2510916731,0
1362089570,2510948308,3,138,46,1362089566007,1362089566135,2510944315,2510944443,128
1362089570,2510948316,4,184,46,1362089562990,1362089563054,2510941306,2510941370,64
1362089574,2510952468,70,3920,56,1362089545879,1362089573527,2510924347,2510951995,27648
1362089575,2510952588,70,3920,56,1362089546822,1362089574470,2510924410,2510952058,27648
1362089575,2510952592,70,6720,96,1362089546885,1362089574533,2510924477,2510952125,27648
1362089575,2510952592,70,3920,56,1362089546947,1362089574659,2510924539,2510952251,27712
1362089575,2510952624,3,492,164,1362089547940,1362089548068,2510925564,2510925692,128
1362089575,2510952748,3,138,46,1362089549223,1362089549223,2510926971,2510926971,0
1362089578,2510956316,141,155511,1102.914894,1362089489393,1362089575729,2510867709,2510954045,86336
1362089578,2510956368,3,138,46,1362089576314,1362089576314,2510954682,2510954682,0
1362089578,2510956580,1,46,46,1362089552038,1362089552038,2510930618,2510930618,0
1362089583,2510960620,3,138,46,1362089555367,1362089555367,2510932987,2510932987,0
1362089586,2510964336,347,468429,1349.939481,1362089514204,1362089580380,2510892540,2510958716,66176
1362089587,2510964696,3,138,46,1362089560668,1362089560732,2510938364,2510938428,64
1362089590,2510968552,3,138,46,1362089563460,1362089563524,2510942012,2510942076,64
1362089591,2510968588,3,138,46,1362089565702,1362089565766,2510943290,2510943354,64
1362089591,2510968604,2,92,46,1362089566709,1362089566773,2510944313,2510944377,64
1362089591,2510968680,3,138,46,1362089565421,1362089565485,2510943101,2510943165,64
1362089591,2510968680,1,46,46,1362089565611,1362089565611,2510943291,2510943291,0
1362089591,2510968712,2,123,61.5,1362089566217,1362089566281,2510943929,2510943993,64
1362089595,2510972592,3,138,46,1362089568514,1362089568578,2510946106,2510946170,64
1362089595,2510972672,2,123,61.5,1362089567282,1362089567282,2510944954,2510944954,0
1362089595,2510972676,3,138,46,1362089567407,1362089567535,2510945083,2510945211,128
1362089595,2510972680,3,138,46,1362089567914,1362089567978,2510945594,2510945658,64
1362089595,2510972684,3,138,46,1362089568104,1362089568104,2510945788,2510945788,0
1362089595,2510972684,3,138,46,1362089568104,1362089568104,2510945788,2510945788,0
1362089595,2510972708,3,169,56.33333333,1362089568269,1362089568333,2510945977,2510946041,64
1362089595,2510972716,3,138,46,1362089568521,1362089568585,2510946237,2510946301,64
1362089595,2510972716,3,138,46,1362089568585,1362089568649,2510946301,2510946365,64
1362089599,2510976648,3,138,46,1362089571339,1362089571403,2510948987,2510949051,64
1362089599,2510976728,12,3323,276.9166667,1362089573949,1362089576253,2510951677,2510953981,2304
1362089599,2510976732,64,3584,56,1362089574584,1362089598392,2510952316,2510976124,23808
1362089602,2510980556,73,4088,56,1362089573824,1362089601472,2510952380,2510980028,27648
1362089602,2510980556,73,7008,96,1362089573950,1362089601534,2510952506,2510980090,27584
1362089603,2510980648,73,4088,56,1362089574924,1362089602572,2510952572,2510980220,27648
1362089615,2510992688,3,492,164,1362089587684,1362089587812,2510965372,2510965500,128
1362089618,2510996324,2,92,46,1362089615973,1362089615973,2510994297,2510994297,0
1362089619,2510996596,1,46,46,1362089591550,1362089591550,2510969146,2510969146,0
1362089623,2511000640,1,46,46,1362089598421,1362089598421,2510976061,2510976061,0
1362089626,2511004292,2,92,46,1362089623049,1362089623049,2511001341,2511001341,0
1362089626,2511004416,2,92,46,1362089623882,1362089623882,2511002298,2511002298,0
1362089626,2511004568,75,4200,56,1362089597937,1362089625713,2510976505,2511004281,27776
1362089627,2511004656,65,3640,56,1362089602755,1362089626755,2510980411,2511004411,24000
1362089631,2511008576,75,7200,96,1362089602899,1362089630611,2510980475,2511008187,27712
1362089631,2511008580,75,4200,56,1362089602957,1362089630669,2510980537,2511008249,27712
1362089636,1149328500,2,92,46,1362089609336,1362089609336,1149301836,1149301836,0
1362089636,1149328524,2,92,46,1362089611295,1362089611295,1149303819,1149303819,0
1362089639,2511016640,1,46,46,1362089612626,1362089612626,2510990266,2510990266,0
1362089639,2511016640,1,46,46,1362089612626,1362089612626,2510990266,2510990266,0
1362089639,2511016640,1,46,46,1362089612690,1362089612690,2510990330,2510990330,0
1362089639,2511016756,1,46,46,1362089612512,1362089612512,2510990268,2510990268,0
1362089640,1149332504,2,92,46,1362089612341,1362089612341,1149304845,1149304845,0
1362089643,2511020748,7,353,50.42857143,1362089636007,1362089636263,2511013755,2511014011,256
1362089643,2511020964,2,92,46,1362089615310,1362089615310,2510993274,2510993274,0
1362089643,2511020980,1,46,46,1362089616320,1362089616320,2510994300,2510994300,0
1362089643,2511021096,2,92,46,1362089616204,1362089616204,2510994300,2510994300,0
1362089643,2511021128,2,92,46,1362089617193,1362089617193,2510995321,2510995321,0
1362089643,2511021128,1,46,46,1362089617193,1362089617193,2510995321,2510995321,0
1362089644,1149336472,2,92,46,1362089618388,1362089618452,1149310860,1149310924,64
1362089644,1149336480,1,46,46,1362089619340,1362089619340,1149311820,1149311820,0
1362089647,2511024764,2,92,46,1362089620568,1362089620568,2510998332,2510998332,0
1362089647,2511024896,2,92,46,1362089621395,1362089621395,2510999291,2510999291,0
1362089647,2511024924,2,92,46,1362089622390,1362089622454,2511000314,2511000378,64
1362089648,1149340504,2,92,46,1362089620341,1362089620341,1149312845,1149312845,0
1362089651,2511028748,2,92,46,1362089623591,1362089623591,2511001339,2511001339,0
1362089651,2511028748,1,46,46,1362089623527,1362089623527,2511001275,2511001275,0
1362089651,2511028748,1,46,46,1362089623527,1362089623527,2511001275,2511001275,0
1362089651,2511028800,2,123,61.5,1362089624241,1362089624241,2511002041,2511002041,0
1362089651,2511028804,2,92,46,1362089624493,1362089624493,2511002297,2511002297,0
1362089651,2511028888,3,169,56.33333333,1362089626204,1362089626268,2511004092,2511004156,64
1362089651,2511028964,2,92,46,1362089623310,1362089623374,2511001274,2511001338,64
1362089651,2511028964,1,46,46,1362089623309,1362089623309,2511001273,2511001273,0
1362089651,2511028964,1,46,46,1362089623309,1362089623309,2511001273,2511001273,0
1362089651,2511028964,1,46,46,1362089623373,1362089623373,2511001337,2511001337,0
1362089651,2511029016,1,46,46,1362089624280,1362089624280,2511002296,2511002296,0
1362089651,2511029088,2,123,61.5,1362089624980,1362089624980,2511003068,2511003068,0
1362089652,1149344456,2,92,46,1362089626406,1362089626406,1149318862,1149318862,0
1362089652,1149344480,2,92,46,1362089624398,1362089624398,1149316878,1149316878,0
1362089652,1149344500,1,46,46,1362089626359,1362089626359,1149318859,1149318859,0
1362089652,1149344516,1,46,46,1362089627369,1362089627369,1149319885,1149319885,0
1362089655,2511032732,74,4144,56,1362089626870,1362089654646,2511004602,2511032378,27776
1362089655,2511032848,74,4144,56,1362089626883,1362089654595,2511004731,2511032443,27712
1362089655,2511032848,65,6240,96,1362089630723,1362089654659,2511008571,2511032507,23936
1362089655,2511032860,3,492,164,1362089627447,1362089627575,2511005307,2511005435,128
1362089659,2511036728,74,4144,56,1362089630971,1362089658811,2511008699,2511036539,27840
1362089663,2511040900,15,3600,240,1362089636173,1362089641549,2511014073,2511019449,5376
1362089670,1149362576,769,929691,1208.960988,1362089550252,1362089669548,1149242828,1149362124,119296
1362089682,2511060336,7,412,58.85714286,1362089681755,1362089681755,2511060091,2511060091,0
1362089683,2511060756,71,3976,56,1362089654944,1362089682656,2511032700,2511060412,27712
1362089683,2511060756,71,3976,56,1362089655005,1362089682717,2511032761,2511060473,27712
1362089683,2511060876,71,6816,96,1362089655016,1362089682728,2511032892,2511060604,27712
1362089687,2511064756,71,3976,56,1362089659229,1362089686301,2511036985,2511064057,27072
1362089690,2511068272,8,458,57.25,1362089682776,1362089682840,2511061048,2511061112,64
1362089690,2511068312,9,497,55.22222222,1362089684786,1362089689074,2511063098,2511067386,4288
1362089695,2511072888,3,492,164,1362089667418,1362089667546,2511045306,2511045434,128
1362089706,2511084316,4,190,47.5,1362089697132,1362089702252,2511075448,2511080568,5120
1362089711,2511088792,72,4032,56,1362089682937,1362089710521,2511060729,2511088313,27584
1362089711,2511088908,72,4032,56,1362089682949,1362089710469,2511060857,2511088377,27520
1362089711,2511088912,72,6912,96,1362089683008,1362089710592,2511060920,2511088504,27584
1362089715,2511092940,74,4144,56,1362089686820,1362089714532,2511064760,2511092472,27712
1362089723,2511100820,13,3410,262.3076923,1362089696476,1362089707100,2511074296,2511084920,10624
1362089723,2511100944,3,1406,468.6666667,1362089697313,1362089697441,2511075257,2511075385,128
1362089735,2511112988,63,3528,56,1362089710646,1362089734262,2511088634,2511112250,23616
1362089739,2511116912,73,4088,56,1362089710784,1362089738496,2511088696,2511116408,27712
1362089739,2511116916,73,7008,96,1362089710847,1362089738623,2511088763,2511116539,27776
1362089743,2511120832,71,3976,56,1362089714960,1362089742416,2511092792,2511120248,27456
1362089762,2511140384,3,144,48,1362089751913,1362089757097,2511130297,2511135481,5184
1362089762,2511140384,2,98,49,1362089751913,1362089757097,2511130297,2511135481,5184
1362089762,2511140384,3,144,48,1362089751913,1362089757097,2511130297,2511135481,5184
1362089762,2511140464,2,98,49,1362089751832,1362089757016,2511130296,2511135480,5184
1362089762,2511140464,2,98,49,1362089751832,1362089757016,2511130296,2511135480,5184
1362089763,2511140848,67,3752,56,1362089735039,1362089762495,2511112887,2511140343,27456
1362089763,2511141032,3,492,164,1362089737225,1362089737353,2511115257,2511115385,128
1362089767,2511144844,68,6528,96,1362089739011,1362089766467,2511116855,2511144311,27456
1362089767,2511144940,69,3864,56,1362089738854,1362089766758,2511116794,2511144698,27904
1362089771,2511148964,68,3808,56,1362089742862,1362089770318,2511120826,2511148282,27456
1362089779,2511156952,8,1648,206,1362089751447,1362089752023,2511129399,2511129975,576
1362089783,2511161028,4,1543,385.75,1362089756363,1362089756427,2511134391,2511134455,64
1362089787,2511164980,59,3304,56,1362089762750,1362089786686,2511140730,2511164666,23936
1362089795,2511172848,68,6528,96,1362089766975,1362089794815,2511144823,2511172663,27840
1362089795,2511172980,67,3752,56,1362089767102,1362089794622,2511145082,2511172602,27520
1362089799,2511177156,68,3808,56,1362089770636,1362089798412,2511148792,2511176568,27776
1362089802,2511180516,6,496,82.66666667,1362089793125,1362089796261,2511171641,2511174777,3136
1362089803,2511181328,3,492,164,1362089776926,1362089777054,2511155254,2511155382,128
1362089815,2511193152,66,3696,56,1362089786959,1362089814671,2511165111,2511192823,27712
1362089818,2511196440,9,445,49.44444444,1362089815278,1362089816110,2511193718,2511194550,832
1362089819,2511197224,1,46,46,1362089793418,1362089793418,2511171642,2511171642,0
1362089823,2511201148,65,3640,56,1362089794898,1362089822674,2511173046,2511200822,27776
1362089823,2511201152,65,6240,96,1362089795023,1362089822735,2511173175,2511200887,27712
1362089827,2511205288,65,3640,56,1362089798791,1362089826695,2511177079,2511204983,27904
1362089835,2511213284,3,604,201.3333333,1362089810058,1362089810378,2511188342,2511188662,320
1362089843,2511221196,12,4602,383.5,1362089816355,1362089816547,2511194551,2511194743,192
1362089843,2511221236,3,492,164,1362089817085,1362089817213,2511195321,2511195449,128
1362089843,2511221276,65,3640,56,1362089815061,1362089842325,2511193337,2511220601,27264
1362089851,2511229156,64,6144,96,1362089823242,1362089850634,2511201398,2511228790,27392
1362089851,2511229272,65,3640,56,1362089823062,1362089850710,2511201334,2511228982,27648
1362089855,2511233176,64,3584,56,1362089827253,1362089854389,2511205429,2511232565,27136
1362089871,2511249176,65,3640,56,1362089842872,1362089870776,2511221048,2511248952,27904
1362089879,2511257168,65,6240,96,1362089850877,1362089878717,2511229045,2511256885,27840
1362089879,2511257292,64,3584,56,1362089851138,1362089878530,2511229430,2511256822,27392
1362089879,2511257380,56,3136,56,1362089854636,1362089878636,2511233016,2511257016,24000
1362089882,2511260400,9,476,52.88888889,1362089875801,1362089876441,2511254201,2511254841,640
1362089883,2511261276,3,492,164,1362089857425,1362089857617,2511235701,2511235893,192
1362089899,2511277216,63,3528,56,1362089871184,1362089898576,2511249400,2511276792,27392
1362089903,2511281440,12,4602,383.5,1362089876397,1362089876653,2511254837,2511255093,256
1362089907,2511285196,63,3528,56,1362089879076,1362089906532,2511257272,2511284728,27456
1362089907,2511285316,63,6048,96,1362089879017,1362089906473,2511257333,2511284789,27456
1362089907,2511285316,63,3528,56,1362089879147,1362089906603,2511257463,2511284919,27456
1362089923,2511301280,3,492,164,1362089896975,1362089897103,2511275255,2511275383,128
1362089927,2511305316,65,3640,56,1362089898986,1362089926570,2511277302,2511304886,27584
1362089930,2511308536,3,138,46,1362089925967,1362089926031,2511304503,2511304567,64
1362089935,2511313200,67,3752,56,1362089907036,1362089934684,2511285236,2511312884,27648
1362089935,2511313320,67,6432,96,1362089906982,1362089934694,2511285302,2511313014,27712
1362089935,2511313320,67,3752,56,1362089907045,1362089934757,2511285365,2511313077,27712
1362089938,2511316448,9,445,49.44444444,1362089936101,1362089936805,2511314549,2511315253,704
1362089956,2511333676,66,3696,56,1362089927785,1362089955049,2511305461,2511332725,27264
1362089963,2511341252,66,3696,56,1362089935147,1362089962539,2511313399,2511340791,27392
1362089963,2511341256,66,3696,56,1362089935268,1362089962788,2511313524,2511341044,27520
1362089963,2511341328,3,492,164,1362089937628,1362089937692,2511315956,2511316020,64
1362089963,2511341368,66,6336,96,1362089935093,1362089962549,2511313461,2511340917,27456
1362089963,2511341448,10,2011,201.1,1362089936808,1362089936936,2511315256,2511315384,128
1362089983,2511361284,66,3696,56,1362089955017,1362089982345,2511333301,2511360629,27328
1362089991,2511369280,67,3752,56,1362089963084,1362089990540,2511341364,2511368820,27456
1362089991,2511369284,67,6432,96,1362089963146,1362089990602,2511341430,2511368886,27456
1362089991,2511369404,67,3752,56,1362089963090,1362089990610,2511341494,2511369014,27520
1362090002,2511380444,7,353,50.42857143,1362089996139,1362089997035,2511374583,2511375479,896
1362090003,2511381376,3,492,164,1362089977133,1362089977261,2511355509,2511355637,128
1362090010,2511388576,60,3360,56,1362089982563,1362090006563,2511361139,2511385139,24000
1362090015,2511393448,58,3248,56,1362089990755,1362090014691,2511369203,2511393139,23936
1362090019,2511397320,67,6432,96,1362089990950,1362090018534,2511369270,2511396854,27584
1362090019,2511397436,67,3752,56,1362089990961,1362090018481,2511369397,2511396917,27520
1362090023,2511401372,10,1964,196.4,1362089997106,1362089997298,2511375478,2511375670,192
1362090035,2511413340,65,3640,56,1362090007375,1362090034511,2511385715,2511412851,27136
1362090043,2511421352,56,5376,96,1362090018821,1362090042629,2511397173,2511420981,23808
1362090043,2511421360,65,3640,56,1362090015163,1362090042491,2511393523,2511420851,27328
1362090043,2511421440,3,492,164,1362090017580,1362090017708,2511396020,2511396148,128
1362090047,2511425356,65,3640,56,1362090018880,1362090046464,2511397236,2511424820,27584
1362090058,2511436500,2,98,49,1362090052145,1362090057521,2511430645,2511436021,5376
1362090058,2511436508,7,353,50.42857143,1362090057064,1362090057256,2511435572,2511435764,192
1362090058,2511436584,2,98,49,1362090052061,1362090057437,2511430645,2511436021,5376
1362090058,2511436584,3,144,48,1362090052125,1362090057501,2511430709,2511436085,5376
1362090058,2511436584,3,144,48,1362090052125,1362090057501,2511430709,2511436085,5376
1362090063,2511441376,65,3640,56,1362090034924,1362090062572,2511413300,2511440948,27648
1362090067,2511445540,56,3136,56,1362090042695,1362090066311,2511421235,2511444851,23616
1362090071,2511449520,65,6240,96,1362090042780,1362090070556,2511421300,2511449076,27776
1362090075,2511453528,66,3696,56,1362090046738,1362090074578,2511425266,2511453106,27840
1362090079,2511457540,8,1587,198.375,1362090051465,1362090051849,2511430005,2511430389,384
1362090083,2511461476,10,1964,196.4,1362090057287,1362090057479,2511435763,2511435955,192
1362090084,2511461632,3,492,164,1362090058643,1362090058771,2511436275,2511436403,128
1362090091,2511469548,65,3640,56,1362090062912,1362090090368,2511441460,2511468916,27456
1362090095,2511473412,66,3696,56,1362090067078,1362090094854,2511445490,2511473266,27776
1362090099,2511477536,66,6336,96,1362090070859,1362090098763,2511449395,2511477299,27904
1362090103,2511481432,64,3584,56,1362090075250,1362090102258,2511453682,2511480690,27008
1362090119,2511497524,65,3640,56,1362090090966,1362090118614,2511469490,2511497138,27648
1362090123,2511500692,8,399,49.875,1362090117846,1362090118358,2511495538,2511496050,512
1362090124,2511501576,64,3584,56,1362090096205,1362090123661,2511473781,2511501237,27456
1362090124,2511501656,3,492,164,1362090098492,1362090098620,2511476148,2511476276,128
1362090128,2511505576,65,6240,96,1362090100043,1362090127627,2511477619,2511505203,27584
1362090131,2511509548,65,3640,56,1362090102846,1362090130622,2511481394,2511509170,27776
1362090144,2511521744,14,4897,349.7857143,1362090118306,1362090118690,2511496050,2511496434,384
1362090147,2511525540,66,3696,56,1362090118921,1362090146761,2511497461,2511525301,27840
1362090151,2511529540,66,3696,56,1362090123015,1362090150791,2511501555,2511529331,27776
1362090155,2511533540,64,6144,96,1362090127111,1362090154439,2511505651,2511532979,27328
1362090160,2511537656,66,3696,56,1362090132090,1362090159738,2511509746,2511537394,27648
1362090164,2511541632,3,492,164,1362090138577,1362090138705,2511516209,2511516337,128
1362090171,2511548624,3,138,46,1362090168476,1362090168540,2511546100,2511546164,64
1362090176,2511553676,63,3528,56,1362090148198,1362090175398,2511525874,2511553074,27200
1362090180,2511557588,62,3472,56,1362090152191,1362090179775,2511529779,2511557363,27584
1362090183,2511561568,62,5952,96,1362090154859,1362090182699,2511533427,2511561267,27840
1362090187,2511564632,9,451,50.11111111,1362090178708,1362090179092,2511556340,2511556724,384
1362090188,2511565712,60,3360,56,1362090160196,1362090187204,2511537908,2511564916,27008
1362090204,2511581624,10,1964,196.4,1362090179100,1362090179292,2511556724,2511556916,192
1362090204,2511581708,3,492,164,1362090178567,1362090178631,2511556275,2511556339,64
1362090204,2511581736,62,3472,56,1362090175913,1362090203625,2511553649,2511581361,27712
1362090208,2511585736,63,3528,56,1362090180009,1362090207465,2511557745,2511585201,27456
1362090212,2511589740,64,6144,96,1362090183847,1362090211559,2511561587,2511589299,27712
1362090216,2511593616,65,3640,56,1362090187874,1362090215458,2511565490,2511593074,27584
1362090232,2511609648,66,3696,56,1362090204098,1362090231554,2511581746,2511609202,27456
1362090236,2511613672,66,3696,56,1362090208043,1362090235563,2511585715,2511613235,27520
1362090240,2511617764,67,6432,96,1362090211916,1362090239628,2511589680,2511617392,27712
1362090243,2511620632,9,445,49.44444444,1362090238738,1362090239378,2511616370,2511617010,640
1362090244,2511621772,65,3640,56,1362090215812,1362090243460,2511593584,2511621232,27648
1362090244,2511621868,3,492,164,1362090218469,1362090218597,2511596337,2511596465,128
1362090260,2511637768,64,3584,56,1362090231945,1362090259401,2511609713,2511637169,27456
1362090264,2511641664,65,3640,56,1362090236019,1362090263731,2511613683,2511641395,27712
1362090264,2511641748,9,1918,213.1111111,1362090239261,1362090239389,2511617009,2511617137,128
1362090268,2511645684,64,6144,96,1362090240223,1362090267743,2511617907,2511645427,27520
1362090272,2511649676,66,3696,56,1362090244004,1362090271716,2511621680,2511649392,27712
1362090284,2511661936,3,492,164,1362090258467,1362090258595,2511636403,2511636531,128
1362090288,2511665820,68,3808,56,1362090259927,1362090287639,2511637747,2511665459,27712
1362090292,2511669820,67,3752,56,1362090263957,1362090291733,2511641777,2511669553,27776
1362090296,2511673704,67,6432,96,1362090268232,1362090295560,2511645936,2511673264,27328
1362090300,2511677892,67,3752,56,1362090271822,1362090299790,2511649714,2511677682,27968
1362090307,2511684848,9,445,49.44444444,1362090298487,1362090299447,2511676335,2511677295,960
1362090316,2511693908,4,656,164,1362090290813,1362090291069,2511668721,2511668977,256
1362090316,2511693944,66,3696,56,1362090288474,1362090315674,2511666418,2511693618,27200
1362090320,2511697904,57,5472,96,1362090295807,1362090319807,2511673711,2511697711,24000
1362090320,2511697908,66,3696,56,1362090291965,1362090319741,2511669873,2511697649,27776
1362090324,2511701900,3,492,164,1362090298629,1362090298757,2511676529,2511676657,128
1362090324,2511702024,10,1964,196.4,1362090299273,1362090299401,2511677297,2511677425,128
1362090328,2511705916,67,3752,56,1362090300084,1362090327796,2511678000,2511705712,27712
1362090344,2511722060,64,3584,56,1362090316069,1362090343461,2511694129,2511721521,27392
1362090348,2511725964,64,3584,56,1362090320196,1362090347780,2511698160,2511725744,27584
1362090348,2511725968,63,6048,96,1362090320257,1362090347521,2511698225,2511725489,27264
1362090356,2511734092,63,3528,56,1362090328197,1362090355269,2511706289,2511733361,27072
1362090363,2511740792,8,399,49.875,1362090359534,1362090359726,2511737326,2511737518,192
1362090363,2511740864,3,144,48,1362090353127,1362090358247,2511730991,2511736111,5120
1362090364,2511742164,3,492,164,1362090338042,1362090338170,2511716206,2511716334,128
1362090372,2511749972,65,3640,56,1362090343996,1362090371708,2511721968,2511749680,27712
1362090376,2511753972,66,6336,96,1362090347834,1362090375738,2511725806,2511753710,27904
1362090376,2511753980,65,3640,56,1362090348275,1362090375667,2511726255,2511753647,27392
1362090380,2511758048,6,1209,201.5,1362090352433,1362090352689,2511730481,2511730737,256
1362090384,2511761988,66,3696,56,1362090355883,1362090383787,2511733871,2511761775,27904
1362090384,2511762088,11,2057,187,1362090359431,1362090359687,2511737519,2511737775,256
1362090400,2511778148,67,3752,56,1362090371979,1362090399755,2511750127,2511777903,27776
1362090404,2511782064,67,3752,56,1362090375904,1362090403680,2511753968,2511781744,27776
1362090404,2511782068,67,6432,96,1362090375965,1362090403741,2511754033,2511781809,27776
1362090404,2511782300,3,492,164,1362090378290,1362090378482,2511756590,2511756782,192
1362090412,2511790092,65,3640,56,1362090384129,1362090411841,2511762221,2511789933,27712
1362090427,2511804776,9,445,49.44444444,1362090419583,1362090420095,2511797359,2511797871,512
1362090428,2511806108,65,3640,56,1362090400116,1362090427828,2511778224,2511805936,27712
1362090432,2511810232,66,3696,56,1362090403894,1362090431734,2511782126,2511809966,27840
1362090432,2511810232,65,6240,96,1362090403957,1362090431477,2511782189,2511809709,27520
1362090440,2511818212,68,3808,56,1362090411913,1362090439433,2511790125,2511817645,27520
1362090444,2511822192,12,4602,383.5,1362090419679,1362090419871,2511797871,2511798063,192
1362090444,2511822328,3,492,164,1362090418068,1362090418196,2511796396,2511796524,128
1362090456,2511834388,60,5760,96,1362090431643,1362090455515,2511810031,2511833903,23872
1362090456,2511834396,70,3920,56,1362090427859,1362090455635,2511806255,2511834031,27776
1362090460,2511838360,70,3920,56,1362090431991,1362090459831,2511810351,2511838191,27840
1362090464,2511842340,60,3360,56,1362090439690,1362090463306,2511818030,2511841646,23616
1362090475,2511852868,3,138,46,1362090468258,1362090468322,2511846126,2511846190,64
1362090483,2511860784,60,5760,96,1362090456437,1362090480117,2511834221,2511857901,23680
1362090483,2511860884,9,445,49.44444444,1362090479891,1362090480275,2511857775,2511858159,384
1362090484,2511862368,69,3864,56,1362090455982,1362090483438,2511834350,2511861806,27456
1362090484,2511862492,3,492,164,1362090458675,1362090458803,2511837167,2511837295,128
1362090488,2511866492,69,3864,56,1362090460016,1362090487472,2511838508,2511865964,27456
1362090489,2511866616,60,3360,56,1362090464608,1362090488608,2511842224,2511866224,24000
1362090505,2511882620,11,2057,187,1362090480537,1362090480729,2511858157,2511858349,192
1362090508,2511886480,69,6624,96,1362090479933,1362090507773,2511858413,2511886253,27840
1362090512,2511890368,69,3864,56,1362090484012,1362090511724,2511862380,2511890092,27712
1362090516,2511894384,69,3864,56,1362090487966,1362090515678,2511866350,2511894062,27712
1362090516,2511894472,5,230,46,1362090491717,1362090492229,2511870189,2511870701,512
1362090516,2511894512,69,3864,56,1362090488030,1362090515742,2511866542,2511894254,27712
1362090524,2511902364,3,492,164,1362090498803,1362090498931,2511877167,2511877295,128
1362090536,2511914484,68,6528,96,1362090508216,1362090535416,2511886700,2511913900,27200
1362090540,2511918384,69,3864,56,1362090512029,1362090539805,2511890413,2511918189,27776
1362090544,2511922384,68,3808,56,1362090515998,1362090543774,2511894382,2511922158,27776
1362090544,2511922504,67,3752,56,1362090516069,1362090543461,2511894573,2511921965,27392
1362090547,2511924972,7,353,50.42857143,1362090539770,1362090540410,2511917742,2511918382,640
1362090563,2511940820,56,5376,96,1362090536400,1362090560400,2511914220,2511938220,24000
1362090564,2511942476,3,492,164,1362090539265,1362090539393,2511917741,2511917869,128
1362090568,2511946416,56,3136,56,1362090540350,1362090566910,2511918766,2511945326,26560
1362090568,2511946528,11,4509,409.9090909,1362090539917,1362090540109,2511918445,2511918637,192
1362090572,2511950536,51,2856,56,1362090543814,1362090571270,2511922350,2511949806,27456
1362090572,2511950544,50,2800,56,1362090544124,1362090570236,2511922668,2511948780,26112
1362090588,2511966460,14,1344,96,1362090560079,1362090571087,2511938539,2511949547,11008
1362090596,2511974524,3,168,56,1362090569362,1362090570002,2511947886,2511948526,640
1362090603,2511980932,7,353,50.42857143,1362090599842,1362090600802,2511977774,2511978734,960
1362090605,2511982620,3,492,164,1362090580313,1362090580441,2511957933,2511958061,128
1362090629,2512006920,9,1918,213.1111111,1362090600874,1362090601002,2511978794,2511978922,128
1362090635,2512012868,200750,285125118,1420.299467,1362089514783,1362090631711,2510892651,2512009579,1116928
1362090645,2512022976,3,492,164,1362090619314,1362090619442,2511997290,2511997418,128
1362090667,2512044892,9,445,49.44444444,1362090660870,1362090661126,2512038762,2512039018,256
1362090667,2512044904,3,150,50,1362090653820,1362090659196,2512031724,2512037100,5376
1362090667,2512044904,2,98,49,1362090653819,1362090659195,2512031723,2512037099,5376
1362090667,2512044904,3,144,48,1362090654010,1362090659194,2512031914,2512037098,5184
1362090667,2512044904,3,144,48,1362090654010,1362090659194,2512031914,2512037098,5184
1362090667,2512044904,2,98,49,1362090654010,1362090659194,2512031914,2512037098,5184
1362090667,2512044932,3,144,48,1362090659997,1362090665181,2512037929,2512043113,5184
1362090667,2512044932,4,190,47.5,1362090659999,1362090665247,2512037931,2512043179,5248
1362090667,2512044980,4,196,49,1362090653744,1362090659120,2512031724,2512037100,5376
1362090667,2512044980,2,98,49,1362090653934,1362090659118,2512031914,2512037098,5184
1362090667,2512044988,3,144,48,1362090659816,1362090665192,2512037804,2512043180,5376
1362090667,2512044988,3,144,48,1362090659816,1362090665192,2512037804,2512043180,5376
1362090667,2512045008,4,190,47.5,1362090659925,1362090665237,2512037933,2512043245,5312
1362090670,1150362912,3,144,48,1362090659554,1362090664802,1150352466,1150357714,5248
1362090681,2512058852,47,38912,827.9148936,1362090652910,1362090660014,2512030762,2512037866,7104
1362090681,2512058868,18,13846,769.2222222,1362090653855,1362090660255,2512031723,2512038123,6400
1362090683,2512061068,58,47387,817.0172414,1362090679511,1362090682775,2512057579,2512060843,3264
1362090685,2512062968,3,168,56,1362090660604,1362090682940,2512038572,2512060908,22336
1362090685,2512063012,23,26848,1167.304348,1362090659280,1362090659600,2512037292,2512037612,320
1362090685,2512063012,22,24905,1132.045455,1362090659280,1362090659536,2512037292,2512037548,256
1362090685,2512063044,17,18256,1073.882353,1362090659630,1362090659822,2512037674,2512037866,192
1362090685,2512063048,3,168,56,1362090659754,1362090682794,2512037802,2512060842,23040
1362090685,2512063052,4,538,134.5,1362090659879,1362090660007,2512037931,2512038059,128
1362090685,2512063052,6,3330,555,1362090659879,1362090660135,2512037931,2512038187,256
1362090685,1150377744,51,63880,1252.54902,1362090659084,1362090659660,1150351828,1150352404,576
1362090689,2512066868,3,288,96,1362090660895,1362090687711,2512038763,2512065579,26816
1362090689,2512066872,2,112,56,1362090661084,1362090682716,2512038956,2512060588,21632
1362090689,2512066872,9,1918,213.1111111,1362090661147,1362090661275,2512039019,2512039147,128
1362090697,2512074960,1,46,46,1362090671938,1362090671938,2512049898,2512049898,0
1362090697,2512075100,1,46,46,1362090672568,1362090672568,2512050668,2512050668,0
1362090705,2512083016,1,46,46,1362090679564,1362090679564,2512057580,2512057580,0
1362090713,2512091004,3,138,46,1362090687573,1362090687573,2512065577,2512065577,0
1362090723,2512100992,7,353,50.42857143,1362090720800,1362090721248,2512098792,2512099240,448
1362090725,2512103092,4,538,134.5,1362090699261,1362090699389,2512077353,2512077481,128
1362090729,2512107148,3,138,46,1362090704390,1362090704454,2512082538,2512082602,64
1362090749,2512127084,11,4509,409.9090909,1362090721157,1362090721349,2512099241,2512099433,192
1362090753,2512131032,7,1315,187.8571429,1362090727483,1362090727739,2512105515,2512105771,256
1362090753,2512131124,4,989,247.25,1362090727196,1362090727324,2512105320,2512105448,128
1362090753,2512131156,7,3396,485.1428571,1362090727614,1362090727806,2512105770,2512105962,192
1362090779,2512156992,3,138,46,1362090774818,1362090774882,2512152810,2512152874,64
1362090779,2512156992,2,92,46,1362090774818,1362090774818,2512152810,2512152810,0
1362090779,2512157008,3,138,46,1362090775825,1362090775889,2512153833,2512153897,64
1362090781,2512159448,3,138,46,1362090753112,1362090753112,2512131560,2512131560,0
1362090782,1150474960,4,190,47.5,1362090774836,1362090780404,1150467796,1150473364,5568
1362090785,2512163524,3,887,295.6666667,1362090760204,1362090760332,2512138728,2512138856,128
1362090787,2512165108,6,307,51.16666667,1362090781038,1362090781422,2512159146,2512159530,384
1362090795,2512173016,6,282,47,1362090783304,1362090788872,2512161320,2512166888,5568
1362090797,2512175296,3,604,201.3333333,1362090770739,1362090771059,2512149035,2512149355,320
1362090797,2512175320,30,13405,446.8333333,1362090771095,1362090782423,2512149415,2512160743,11328
1362090801,1150494016,2,92,46,1362090775355,1362090775355,1150468371,1150468371,0
1362090805,2512183340,1,46,46,1362090779268,1362090779268,2512157608,2512157608,0
1362090805,2512183504,1,46,46,1362090780448,1362090780448,2512158952,2512158952,0
1362090809,2512187288,1,46,46,1362090784824,1362090784824,2512163112,2512163112,0
1362090809,2512187340,60,3360,56,1362090782726,1362090808454,2512161066,2512186794,25728
1362090809,2512187408,42,14888,354.4761905,1362090781122,1362090783682,2512159530,2512162090,2560
1362090809,1150502000,42,51970,1237.380952,1362090781259,1362090781451,1150474259,1150474451,192
1362090809,2512187452,60,3360,56,1362090782678,1362090808278,2512161130,2512186730,25600
1362090809,2512187452,58,65945,1136.982759,1362090782612,1362090789652,2512161064,2512168104,7040
1362090809,2512187452,60,3360,56,1362090782867,1362090808467,2512161319,2512186919,25600
1362090809,2512187456,60,5760,96,1362090782993,1362090808529,2512161449,2512186985,25536
1362090813,2512191428,5,668,133.6,1362090785390,1362090785518,2512163818,2512163946,128
1362090825,2512203492,3,492,164,1362090800109,1362090800237,2512178601,2512178729,128
1362090837,2512215332,74,4144,56,1362090809294,1362090836750,2512187626,2512215082,27456
1362090837,2512215332,74,7104,96,1362090809357,1362090836813,2512187689,2512215145,27456
1362090837,2512215440,74,4144,56,1362090808929,1362090836449,2512187369,2512214889,27520
1362090837,2512215444,74,4144,56,1362090808990,1362090836574,2512187434,2512215018,27584
1362090851,2512229088,9,445,49.44444444,1362090843073,1362090844097,2512221161,2512222185,1024
1362090851,2512229120,3,138,46,1362090849953,1362090850017,2512228073,2512228137,64
1362090861,2512239476,3,1145,381.6666667,1362090833403,1362090833403,2512211879,2512211879,0
1362090865,2512243348,67,3752,56,1362090836989,1362090864253,2512215337,2512242601,27264
1362090865,2512243348,67,6432,96,1362090837116,1362090864444,2512215464,2512242792,27328
1362090865,2512243476,68,3808,56,1362090836797,1362090864637,2512215273,2512243113,27840
1362090865,2512243476,67,3752,56,1362090836923,1362090864251,2512215399,2512242727,27328
1362090865,2512243560,6,1368,228,1362090839720,1362090849896,2512218280,2512228456,10176
1362090869,2512247536,19,3737,196.6842105,1362090843649,1362090844353,2512222185,2512222889,704
1362090873,2512251468,3,138,46,1362090845058,1362090845058,2512223526,2512223526,0
1362090891,2512269136,3,138,46,1362090886416,1362090886608,2512264552,2512264744,192
1362090893,2512271344,74,4144,56,1362090864896,1362090892544,2512243240,2512270888,27648
1362090893,2512271348,74,4144,56,1362090864957,1362090892605,2512243305,2512270953,27648
1362090893,2512271468,74,7104,96,1362090864963,1362090892547,2512243431,2512271015,27584
1362090893,2512271472,73,4088,56,1362090865025,1362090892353,2512243497,2512270825,27328
1362090899,2512277160,4,215,53.75,1362090893625,1362090898617,2512271785,2512276777,4992
1362090907,2512285112,8,399,49.875,1362090904038,1362090904358,2512282150,2512282470,320
1362090909,2512287492,3,785,261.6666667,1362090882923,1362090883051,2512261415,2512261543,128
1362090918,1150610996,698,884928,1267.805158,1362090795089,1362090913105,1150488085,1150606101,118016
1362090921,2512299396,71,3976,56,1362090893641,1362090920777,2512272037,2512299173,27136
1362090921,2512299396,70,6720,96,1362090893773,1362090920589,2512272169,2512298985,26816
1362090921,2512299508,71,3976,56,1362090893403,1362090920603,2512271911,2512299111,27200
1362090921,2512299512,70,3920,56,1362090893593,1362090920409,2512272105,2512298921,26816
1362090922,1150614348,2,92,46,1362090897752,1362090897752,1150590100,1150590100,0
1362090929,2512307460,16,6145,384.0625,1362090904011,1362090916235,2512282471,2512294695,12224
1362090931,2512309268,6,498,83,1362090921484,1362090924364,2512299752,2512302632,2880
1362090937,2512315580,1,46,46,1362090911954,1362090911954,2512290534,2512290534,0
1362090946,2512323608,61,3416,56,1362090921696,1362090945696,2512299304,2512323304,24000
1362090949,2512327484,70,6720,96,1362090920884,1362090948532,2512299368,2512327016,27648
1362090949,2512327484,70,3920,56,1362090920946,1362090948594,2512299430,2512327078,27648
1362090949,2512327492,1,46,46,1362090921258,1362090921258,2512299750,2512299750,0
1362090950,2512327604,70,3920,56,1362090921893,1362090949605,2512299497,2512327209,27712
1362090950,2512327652,3,492,164,1362090924465,1362090924593,2512302117,2512302245,128
1362090963,2512341172,2,98,49,1362090954025,1362090959209,2512332197,2512337381,5184
1362090963,2512341172,3,144,48,1362090954025,1362090959209,2512332197,2512337381,5184
1362090973,2512351544,62,5952,96,1362090948790,1362090972662,2512327334,2512351206,23872
1362090974,2512351672,71,3976,56,1362090945885,1362090973469,2512323557,2512351141,27584
1362090977,2512355520,8,1449,181.125,1362090952845,1362090953357,2512331365,2512331877,512
1362090978,2512355616,73,4088,56,1362090949848,1362090977752,2512327464,2512355368,27904
1362090978,2512355616,72,4032,56,1362090949910,1362090977558,2512327526,2512355174,27648
1362090981,2512359532,13,7612,585.5384615,1362090954436,1362090954564,2512332968,2512333096,128
1362090982,2512359700,4,1373,343.25,1362090955201,1362090955265,2512332901,2512332965,64
1362090990,2512367684,4,1543,385.75,1362090965140,1362090965140,2512342824,2512342824,0
1362090990,2512367784,3,492,164,1362090964528,1362090964656,2512342312,2512342440,128
1362091001,2512379556,73,4088,56,1362090972907,1362091000619,2512351463,2512379175,27712
1362091002,2512379672,73,7008,96,1362090973855,1362091001567,2512351527,2512379239,27712
1362091006,2512383696,73,4088,56,1362090977798,1362091005510,2512355494,2512383206,27712
1362091006,2512383704,72,4032,56,1362090978048,1362091005440,2512355752,2512383144,27392
1362091027,2512405152,8,399,49.875,1362091023742,1362091024766,2512401894,2512402918,1024
1362091030,2512407600,72,4032,56,1362091001893,1362091029541,2512379493,2512407141,27648
1362091030,2512407604,72,6912,96,1362091002018,1362091029602,2512379622,2512407206,27584
1362091030,2512407812,3,492,164,1362091004625,1362091004753,2512382437,2512382565,128
1362091034,2512411596,73,4088,56,1362091006122,1362091033706,2512383718,2512411302,27584
1362091034,2512411716,73,4088,56,1362091005810,1362091033650,2512383526,2512411366,27840
1362091050,2512427732,10,1964,196.4,1362091025186,1362091025442,2512402918,2512403174,256
1362091058,2512435600,66,3696,56,1362091029863,1362091053863,2512407463,2512431463,24000
1362091058,2512435688,76,7296,96,1362091029901,1362091057293,2512407589,2512434981,27392
1362091062,2512439616,76,4256,56,1362091034070,1362091061782,2512411686,2512439398,27712
1362091062,2512439616,76,4256,56,1362091034006,1362091061718,2512411622,2512439334,27712
1362091070,2512447684,3,492,164,1362091044752,1362091044880,2512422436,2512422564,128
1362091075,2512453260,3,138,46,1362091069137,1362091069201,2512447397,2512447461,64
1362091082,2512459756,73,4088,56,1362091054026,1362091081482,2512431782,2512459238,27456
1362091086,2512463640,72,6912,96,1362091057917,1362091085437,2512435557,2512463077,27520
1362091090,2512467624,70,3920,56,1362091062094,1362091089614,2512439718,2512467238,27520
1362091090,2512467708,70,3920,56,1362091062071,1362091089591,2512439779,2512467299,27520
1362091091,2512469216,7,353,50.42857143,1362091084671,1362091085055,2512462887,2512463271,384
1362091098,2512475660,2,92,46,1362091070697,1362091070761,2512448357,2512448421,64
1362091098,2512475780,1,46,46,1362091070575,1362091070575,2512448355,2512448355,0
1362091110,2512487664,72,4032,56,1362091081891,1362091109667,2512459555,2512487331,27776
1362091110,2512487868,3,492,164,1362091084505,1362091084633,2512462373,2512462501,128
1362091110,2512487880,11,4509,409.9090909,1362091085388,1362091085644,2512463268,2512463524,256
1362091114,2512491692,72,6912,96,1362091086023,1362091113799,2512463715,2512491491,27776
1362091118,2512495704,74,4144,56,1362091089853,1362091117693,2512467557,2512495397,27840
1362091118,2512495796,74,4144,56,1362091089823,1362091117727,2512467619,2512495523,27904
1362091138,2512515712,73,4088,56,1362091109938,1362091137394,2512487650,2512515106,27456
1362091142,2512519852,75,7200,96,1362091113960,1362091141544,2512491812,2512519396,27584
1362091146,2512523720,73,4088,56,1362091118062,1362091145390,2512495782,2512523110,27328
1362091146,2512523836,73,4088,56,1362091117879,1362091145207,2512495715,2512523043,27328
1362091147,2512525408,7,353,50.42857143,1362091144378,1362091145210,2512522786,2512523618,832
1362091150,2512527928,3,492,164,1362091124571,1362091124699,2512502499,2512502627,128
1362091166,2512543728,71,3976,56,1362091137892,1362091165668,2512515620,2512543396,27776
1362091170,2512547816,62,3472,56,1362091145803,1362091169739,2512523619,2512547555,23936
1362091170,2512547816,71,6816,96,1362091141898,1362091169674,2512519714,2512547490,27776
1362091174,2512551828,9,1918,213.1111111,1362091145856,1362091145984,2512523684,2512523812,128
1362091174,2512551828,73,4088,56,1362091145856,1362091173760,2512523684,2512551588,27904
1362091190,2512568068,3,492,164,1362091164176,1362091164304,2512542244,2512542372,128
1362091194,2512571832,75,4200,56,1362091165883,1362091193595,2512543715,2512571427,27712
1362091198,2512575820,73,4088,56,1362091170057,1362091197577,2512547877,2512575397,27520
1362091198,2512575908,75,7200,96,1362091169905,1362091197745,2512547813,2512575653,27840
1362091202,2512579936,74,4144,56,1362091173970,1362091201618,2512551906,2512579554,27648
1362091211,2512589280,9,445,49.44444444,1362091205500,1362091205628,2512583780,2512583908,128
1362091222,2512600004,75,4200,56,1362091193872,1362091221328,2512571876,2512599332,27456
1362091226,2512603860,75,4200,56,1362091197919,1362091225567,2512575779,2512603427,27648
1362091226,2512603988,74,7104,96,1362091198048,1362091225376,2512576036,2512603364,27328
1362091230,2512607940,74,4144,56,1362091201935,1362091229711,2512579875,2512607651,27776
1362091230,2512608012,3,492,164,1362091204232,1362091204296,2512582244,2512582308,64
1362091234,2512611836,11,2057,187,1362091206071,1362091206327,2512583907,2512584163,256
1362091250,2512627848,55,3080,56,1362091222186,1362091249514,2512600034,2512627362,27328
1362091251,2512629572,6,503,83.83333333,1362091247830,1362091250070,2512626402,2512628642,2240
1362091254,2512631864,46,2576,56,1362091226201,1362091252505,2512604065,2512630369,26304
1362091254,2512631984,46,4416,96,1362091226018,1362091252002,2512604002,2512629986,25984
1362091258,2512636000,40,2240,56,1362091230035,1362091257363,2512608035,2512635363,27328
1362091259,2512637380,3,869,289.6666667,1362091253780,1362091254036,2512632160,2512632416,256
1362091263,1150955172,2,98,49,1362091252939,1362091258187,1150945111,1150950359,5248
1362091263,1150955172,2,98,49,1362091252939,1362091258123,1150945111,1150950295,5184
1362091263,1150955172,2,98,49,1362091253003,1362091258955,1150945175,1150951127,5952
1362091263,1150955172,2,98,49,1362091253003,1362091258955,1150945175,1150951127,5952
1362091263,1150955172,2,98,49,1362091253003,1362091258955,1150945175,1150951127,5952
1362091263,1150955172,2,98,49,1362091253003,1362091258955,1150945175,1150951127,5952
1362091263,1150955172,2,98,49,1362091253003,1362091258955,1150945175,1150951127,5952
1362091263,1150955172,2,98,49,1362091253002,1362091258954,1150945174,1150951126,5952
1362091263,1150955172,2,98,49,1362091253002,1362091258954,1150945174,1150951126,5952
1362091263,1150955172,2,98,49,1362091253002,1362091258954,1150945174,1150951126,5952
1362091263,1150955172,2,98,49,1362091253002,1362091258954,1150945174,1150951126,5952
1362091263,1150955172,2,98,49,1362091253002,1362091258954,1150945174,1150951126,5952
1362091263,1150955172,2,98,49,1362091253002,1362091258954,1150945174,1150951126,5952
1362091263,1150955172,2,98,49,1362091253002,1362091258954,1150945174,1150951126,5952
1362091263,1150955172,2,98,49,1362091253002,1362091258954,1150945174,1150951126,5952
1362091263,1150955172,2,98,49,1362091253002,1362091258954,1150945174,1150951126,5952
1362091263,1150955172,2,98,49,1362091252938,1362091258186,1150945110,1150950358,5248
1362091263,1150955172,4,190,47.5,1362091252938,1362091258186,1150945110,1150950358,5248
1362091263,1150955172,2,98,49,1362091252938,1362091258122,1150945110,1150950294,5184
1362091263,1150955172,4,190,47.5,1362091253002,1362091258122,1150945174,1150950294,5120
1362091263,1150955172,2,98,49,1362091253002,1362091258122,1150945174,1150950294,5120
1362091263,1150955172,2,98,49,1362091253002,1362091258122,1150945174,1150950294,5120
1362091263,1150955172,2,98,49,1362091253002,1362091258122,1150945174,1150950294,5120
1362091263,1150955172,2,98,49,1362091253002,1362091258954,1150945174,1150951126,5952
1362091263,1150955172,2,98,49,1362091253001,1362091258953,1150945173,1150951125,5952
1362091263,1150955172,3,144,48,1362091253001,1362091259017,1150945173,1150951189,6016
1362091263,1150955192,2,98,49,1362091252920,1362091258168,1150945112,1150950360,5248
1362091263,1150955192,2,98,49,1362091252920,1362091258104,1150945112,1150950296,5184
1362091263,1150955192,2,98,49,1362091252920,1362091258104,1150945112,1150950296,5184
1362091263,1150955192,3,144,48,1362091252984,1362091258104,1150945176,1150950296,5120
1362091263,1150955192,3,144,48,1362091252984,1362091258104,1150945176,1150950296,5120
1362091263,1150955192,3,144,48,1362091252984,1362091258104,1150945176,1150950296,5120
1362091263,1150955192,2,98,49,1362091252920,1362091258168,1150945112,1150950360,5248
1362091263,1150955192,3,144,48,1362091252920,1362091258104,1150945112,1150950296,5184
1362091263,1150955192,2,98,49,1362091252984,1362091258936,1150945176,1150951128,5952
1362091263,1150955192,2,98,49,1362091252984,1362091258936,1150945176,1150951128,5952
1362091263,1150955192,2,98,49,1362091252984,1362091258936,1150945176,1150951128,5952
1362091263,1150955192,2,98,49,1362091252984,1362091258936,1150945176,1150951128,5952
1362091263,1150955192,3,144,48,1362091252984,1362091258936,1150945176,1150951128,5952
1362091263,1150955192,2,98,49,1362091252984,1362091258936,1150945176,1150951128,5952
1362091263,1150955192,2,98,49,1362091252984,1362091258936,1150945176,1150951128,5952
1362091263,1150955192,2,98,49,1362091252984,1362091258936,1150945176,1150951128,5952
1362091263,1150955192,2,98,49,1362091252984,1362091258936,1150945176,1150951128,5952
1362091263,1150955192,2,98,49,1362091252984,1362091258936,1150945176,1150951128,5952
1362091263,1150955192,2,98,49,1362091252984,1362091258936,1150945176,1150951128,5952
1362091263,1150955192,2,98,49,1362091252984,1362091258936,1150945176,1150951128,5952
1362091263,1150955192,2,98,49,1362091252984,1362091258936,1150945176,1150951128,5952
1362091263,1150955192,2,98,49,1362091252983,1362091258935,1150945175,1150951127,5952
1362091263,1150955192,2,98,49,1362091252983,1362091258935,1150945175,1150951127,5952
1362091263,1150955192,2,98,49,1362091252983,1362091258935,1150945175,1150951127,5952
1362091267,2512645336,2,98,49,1362091255744,1362091261504,2512634080,2512639840,5760
1362091267,2512645368,2,98,49,1362091253667,1362091259363,2512632035,2512637731,5696
1362091267,2512645372,2,94,47,1362091254047,1362091259359,2512632419,2512637731,5312
1362091267,2512645408,2,98,49,1362091255674,1362091261434,2512634082,2512639842,5760
1362091267,2512645408,4,190,47.5,1362091255609,1362091261497,2512634017,2512639905,5888
1362091270,2512648148,3,492,164,1362091244925,1362091245053,2512623073,2512623201,128
1362091274,2512652212,10,4384,438.4,1362091248380,1362091248572,2512626592,2512626784,192
1362091274,2512652216,1,46,46,1362091248187,1362091248187,2512626403,2512626403,0
1362091278,2512656048,11,2098,190.7272727,1362091251298,1362091254562,2512629346,2512632610,3264
1362091278,2512656176,47,2632,56,1362091251554,1362091277282,2512629730,2512655458,25728
1362091278,1150970768,6,3765,627.5,1362091252343,1362091254199,1150945111,1150946967,1856
1362091282,2512660144,23,23626,1027.217391,1362091256385,1362091261121,2512634529,2512639265,4736
1362091282,2512660188,58,5568,96,1362091253847,1362091281751,2512632035,2512659939,27904
1362091282,2512660192,57,3192,56,1362091253971,1362091281555,2512632163,2512659747,27584
1362091282,2512660192,5,1012,202.4,1362091254034,1362091254226,2512632226,2512632418,192
1362091282,2512660200,13,7269,559.1538462,1362091254602,1362091254794,2512632802,2512632994,192
1362091282,2512660232,19,9609,505.7368421,1362091255978,1362091257770,2512634210,2512636002,1792
1362091286,2512664084,64,3584,56,1362091257919,1362091285631,2512636003,2512663715,27712
1362091287,1150979232,3,144,48,1362091274447,1362091280463,1150966679,1150972695,6016
1362091306,2512684072,71,3976,56,1362091277963,1362091305611,2512656035,2512683683,27648
1362091307,2512685356,119569,169938188,1421.256245,1362090782895,1362091305903,2512161251,2512684259,523008
1362091310,2512688172,69,3864,56,1362091281892,1362091309476,2512660064,2512687648,27584
1362091310,2512688196,69,6624,96,1362091282061,1362091309581,2512660257,2512687777,27520
1362091310,2512688280,3,492,164,1362091285433,1362091285689,2512663713,2512663969,256
1362091314,2512692132,68,3808,56,1362091286031,1362091313743,2512664163,2512691875,27712
1362091315,2512693312,4,215,53.75,1362091307416,1362091312472,2512685728,2512690784,5056
1362091323,2512701312,3,169,56.33333333,1362091313882,1362091318938,2512692194,2512697250,5056
1362091323,2512701364,110,117468,1067.890909,1362091248484,1362091320164,2512626848,2512698528,71680
1362091331,2512709376,1072,1454019,1356.361007,1362091256345,1362091327769,2512634721,2512706145,71424
1362091334,2512712144,73,4088,56,1362091305922,1362091333250,2512684066,2512711394,27328
1362091338,2512716232,75,4200,56,1362091309800,1362091337768,2512688032,2512716000,27968
1362091338,2512716236,74,7104,96,1362091310052,1362091337700,2512688288,2512715936,27648
1362091342,2512720212,14,3456,246.8571429,1362091315900,1362091317948,2512694112,2512696160,2048
1362091342,2512720264,3,138,46,1362091313930,1362091313930,2512692194,2512692194,0
1362091342,2512720288,76,4256,56,1362091314095,1362091341679,2512692383,2512719967,27584
1362091346,2512724224,3,138,46,1362091321073,1362091321073,2512699297,2512699297,0
1362091350,2512728244,3,492,164,1362091325086,1362091325214,2512703330,2512703458,128
1362091358,2512736292,67,3752,56,1362091333742,1362091357486,2512712034,2512735778,23744
1362091366,2512744216,76,7296,96,1362091338040,1362091365496,2512716256,2512743712,27456
1362091366,2512744344,77,4312,56,1362091338040,1362091365496,2512716384,2512743840,27456
1362091370,2512748204,76,4256,56,1362091342084,1362091369604,2512720288,2512747808,27520
1362091371,2512749332,3,138,46,1362091369860,1362091369988,2512748192,2512748320,128
1362091379,2512757428,9,445,49.44444444,1362091377314,1362091377954,2512755742,2512756382,640
1362091386,2512764300,73,4088,56,1362091358117,1362091385573,2512736417,2512763873,27456
1362091386,2512764416,1,46,46,1362091361777,1362091361777,2512740193,2512740193,0
1362091390,2512768296,1,46,46,1362091361897,1362091361897,2512740193,2512740193,0
1362091390,2512768384,63,6048,96,1362091365710,1362091389710,2512744094,2512768094,24000
1362091390,2512768492,3,492,164,1362091365219,1362091365347,2512743711,2512743839,128
1362091394,2512772300,72,4032,56,1362091365861,1362091393445,2512744161,2512771745,27584
1362091394,1151086908,2,92,46,1362091369770,1362091369962,1151062678,1151062870,192
1362091398,2512776428,72,4032,56,1362091369827,1362091397475,2512748255,2512775903,27648
1362091399,1151091232,692,884646,1278.390173,1362091274447,1362091391503,1150966679,1151083735,117056
1362091406,2512784324,10,4463,446.3,1362091378058,1362091378378,2512756382,2512756702,320
1362091414,2512792452,75,4200,56,1362091385869,1362091413645,2512764321,2512792097,27776
1362091418,2512796336,75,7200,96,1362091390014,1362091417854,2512768350,2512796190,27840
1362091422,2512800332,76,4256,56,1362091393858,1362091421826,2512772190,2512800158,27968
1362091426,2512804512,78,4368,56,1362091397776,1362091425744,2512776288,2512804256,27968
1362091431,2512808588,2,446,223,1362091406316,1362091406444,2512783904,2512784032,128
1362091443,2512820592,76,4256,56,1362091414885,1362091442597,2512792477,2512820189,27712
1362091443,2512821436,7,353,50.42857143,1362091437468,1362091438300,2512815904,2512816736,832
1362091446,2512824528,76,7296,96,1362091417983,1362091445823,2512796511,2512824351,27840
1362091450,2512828516,75,4200,56,1362091421965,1362091449485,2512800481,2512828001,27520
1362091455,2512832660,75,4200,56,1362091426915,1362091454563,2512804575,2512832223,27648
1362091466,2512844552,12,4602,383.5,1362091438246,1362091438502,2512816798,2512817054,256
1362091470,2512848548,73,4088,56,1362091442026,1362091469738,2512820574,2512848286,27712
1362091471,2512848628,3,492,164,1362091445828,1362091445956,2512823456,2512823584,128
1362091474,2512852556,73,7008,96,1362091446113,1362091473505,2512824669,2512852061,27392
1362091475,2512853412,63,3528,56,1362091449969,1362091473713,2512828381,2512852125,23744
1362091475,2512853428,4,190,47.5,1362091452003,1362091472995,2512830431,2512851423,20992
1362091483,2512860660,72,4032,56,1362091454946,1362091482466,2512832606,2512860126,27520
1362091499,2512876704,72,4032,56,1362091470903,1362091498615,2512848607,2512876319,27712
1362091499,2512877404,7,353,50.42857143,1362091498489,1362091498745,2512876893,2512877149,256
1362091499,2512877444,6,497,82.83333333,1362091488147,1362091491155,2512866591,2512869599,3008
1362091503,2512880616,70,6720,96,1362091475086,1362091502606,2512852702,2512880222,27520
1362091503,2512880728,70,3920,56,1362091475040,1362091502560,2512852768,2512880288,27520
1362091511,2512888628,71,3976,56,1362091482882,1362091510466,2512860510,2512888094,27584
1362091511,2512888792,3,492,164,1362091485981,1362091486173,2512863773,2512863965,192
1362091515,2512892692,1,46,46,1362091488897,1362091488897,2512866589,2512866589,0
1362091527,2512904716,62,5952,96,1362091502826,1362091526762,2512880542,2512904478,23936
1362091527,2512904720,71,3976,56,1362091498920,1362091526632,2512876640,2512904352,27712
1362091527,2512904756,12,4602,383.5,1362091499392,1362091499584,2512877148,2512877340,192
1362091531,2512908728,71,3976,56,1362091502876,1362091530396,2512880604,2512908124,27520
1362091539,2512916768,71,3976,56,1362091511606,1362091538678,2512889374,2512916446,27072
1362091551,2512928804,3,492,164,1362091525459,1362091525587,2512903263,2512903391,128
1362091555,2512932648,75,4200,56,1362091527084,1362091554732,2512904732,2512932380,27648
1362091555,2512932740,75,7200,96,1362091527057,1362091554705,2512904797,2512932445,27648
1362091559,2512936740,72,4032,56,1362091530962,1362091558674,2512908702,2512936414,27712
1362091563,2512941472,2,98,49,1362091555060,1362091560372,2512933532,2512938844,5312
1362091563,2512941472,2,98,49,1362091555060,1362091560372,2512933532,2512938844,5312
1362091563,2512941524,7,353,50.42857143,1362091557824,1362091558848,2512936348,2512937372,1024
1362091563,2512941552,2,98,49,1362091554981,1362091560293,2512933533,2512938845,5312
1362091563,2512941552,3,144,48,1362091554980,1362091560356,2512933532,2512938908,5376
1362091563,2512941552,2,98,49,1362091554980,1362091560292,2512933532,2512938844,5312
1362091567,2512944668,63,3528,56,1362091539098,1362091566746,2512916766,2512944414,27648
1362091579,2512957492,11,1780,161.8181818,1362091554337,1362091578721,2512932829,2512957213,24384
1362091580,2512957576,18,3816,212,1362091559860,1362091579508,2512937436,2512957084,19648
1362091580,2512957620,87949,125056078,1421.91586,1362091257097,1362091579465,2512634717,2512957085,322368
1362091580,2512957624,15,3435,229,1362091578693,1362091579461,2512956317,2512957085,768
1362091583,2512960968,32,1792,56,1362091554732,1362091579244,2512932700,2512957212,24512
1362091583,2512961088,25,1400,56,1362091558647,1362091578807,2512936735,2512956895,20160
1362091583,2512961088,32,3072,96,1362091554740,1362091581428,2512932828,2512959516,26688
1362091591,2512969000,4,538,134.5,1362091565325,1362091578765,2512943325,2512956765,13440
1362091595,2512972952,13,728,56,1362091567035,1362091579067,2512944987,2512957019,12032
1362091611,2512989548,6,2046,341,1362091605481,1362091609321,2512984029,2512987869,3840
1362091639,2513017280,3,1200,400,1362091613684,1362091638196,2512991964,2513016476,24512
1362092044,2513421864,1,46,46,1362092017807,1362092017807,2513395671,2513395671,0
1362092300,2513678228,1,46,46,1362092273823,1362092273823,2513652051,2513652051,0
1362093094,2514472480,2,122,61,1362093069654,1362093069910,2514448134,2514448390,256
1362093140,2514518004,1,46,46,1362093112497,1362093112497,2514490501,2514490501,0
1362093789,2515167176,1,46,46,1362093760253,1362093760253,2515138429,2515138429,0
1362093789,2515167216,1,46,46,1362093760212,1362093760212,2515138428,2515138428,0
1362093789,2515167256,1,46,46,1362093760235,1362093760235,2515138491,2515138491,0
1362093789,2515167296,1,46,46,1362093760198,1362093760198,2515138494,2515138494,0
1362093789,2515167464,1,46,46,1362093760154,1362093760154,2515138618,2515138618,0
1362093790,2515168252,1,46,46,1362093760110,1362093760110,2515138362,2515138362,0
1362093790,2515168260,1,46,46,1362093760105,1362093760105,2515138365,2515138365,0
1362093790,2515168292,1,46,46,1362093760071,1362093760071,2515138363,2515138363,0
1362093790,2515168444,1,46,46,1362093760046,1362093760046,2515138490,2515138490,0
1362093790,2515168476,1,46,46,1362093760079,1362093760079,2515138555,2515138555,0
1362093790,2515168540,1,46,46,1362093760014,1362093760014,2515138554,2515138554,0
1362093790,2515168544,1,46,46,1362093760077,1362093760077,2515138621,2515138621,0
1362094225,2515602780,1,52,52,1362094199042,1362094199042,2515576822,2515576822,0
1362095335,2516713536,1,46,46,1362095307836,1362095307836,2516686372,2516686372,0
1362095648,2517026456,2,122,61,1362095620872,1362095623368,2516999328,2517001824,2496
1362096884,2518262232,1,46,46,1362096857301,1362096857301,2518235533,2518235533,0
1362097219,2518596756,1,46,46,1362097192620,1362097192620,2518570376,2518570376,0
1362097961,2519339392,1,46,46,1362097933285,1362097933285,2519311677,2519311677,0
1362103421,2524799052,1,68,68,1362103396071,1362103396071,2524774123,2524774123,0
1362105346,2526723940,1,46,46,1362105318073,1362105318073,2526696013,2526696013,0
1362105346,2526723976,1,46,46,1362105318036,1362105318036,2526696012,2526696012,0
1362105346,2526724052,1,46,46,1362105318025,1362105318025,2526696077,2526696077,0
1362105346,2526724132,1,46,46,1362105318010,1362105318010,2526696142,2526696142,0
1362105346,2526724136,1,46,46,1362105318004,1362105318004,2526696140,2526696140,0
1362105346,2526724216,1,46,46,1362105317990,1362105317990,2526696206,2526696206,0
1362105347,2526724776,1,46,46,1362105318236,1362105318236,2526696012,2526696012,0
1362105347,2526724852,1,46,46,1362105318225,1362105318225,2526696077,2526696077,0
1362105347,2526724892,1,46,46,1362105318186,1362105318186,2526696078,2526696078,0
1362105347,2526724980,1,46,46,1362105318226,1362105318226,2526696206,2526696206,0
1362105465,2526843272,1,60,60,1362105440362,1362105440362,2526818634,2526818634,0
1362106219,2527596580,1,48,48,1362106190036,1362106190036,2527567616,2527567616,0
1362108276,2529654172,1,60,60,1362108249251,1362108249251,2529627423,2529627423,0
1362109924,2531301684,1,56,56,1362109897012,1362109897012,2531274696,2531274696,0
1362114470,2535848312,1,433,433,1362114442554,1362114442554,2535820866,2535820866,0
1362115321,2536698552,1,46,46,1362115293800,1362115293800,2536671352,2536671352,0
1362116339,2537716916,1,439,439,1362116313644,1362116313644,2537691560,2537691560,0
1362116595,2537973056,1,46,46,1362116568987,1362116568987,2537947043,2537947043,0
1362116743,2538121388,1,46,46,1362116715149,1362116715149,2538093537,2538093537,0
1362116785,2538162944,1,46,46,1362116757384,1362116757384,2538135328,2538135328,0
1362116786,2538164052,1,46,46,1362116757339,1362116757339,2538135391,2538135391,0
