unix_secs,sysuptime,dpkts,doctets,doctets/dpkts,Real First Packet,Real End Packet,first,last,Duration
1360768722,1190104296,1,46,46,1360768695502,1360768695502,1190077798,1190077798,0
1360769921,1191302896,1,46,46,1360769895691,1360769895691,1191277587,1191277587,0
1360770851,1192233772,1,46,46,1360770823057,1360770823057,1192205829,1192205829,0
1360770891,1192273616,7,3214,459.1428571,1360770889452,1360770889580,1192272068,1192272196,128
1360770891,1192273624,8,2747,343.375,1360770889891,1360770890147,1192272515,1192272771,256
1360770899,1192281540,10,3832,383.2,1360770891194,1360770891578,1192273734,1192274118,384
1360770899,1192281540,50,36183,723.66,1360770891639,1360770896183,1192274179,1192278723,4544
1360770899,1192281588,9,4124,458.2222222,1360770890439,1360770891015,1192273027,1192273603,576
1360770899,1192281592,10,3832,383.2,1360770891076,1360770891524,1192273668,1192274116,448
1360770899,1192281592,54,49333,913.5740741,1360770891588,1360770893892,1192274180,1192276484,2304
1360770906,4125568672,10,2488,248.8,1360770898405,1360770901221,4125561077,4125563893,2816
1360770906,4125568692,14,9170,655,1360770898384,1360770900048,4125561076,4125562740,1664
1360770912,1192293896,14,3598,257,1360770887612,1360770888380,1192269508,1192270276,768
1360770914,4125576676,13,8715,670.3846154,1360770898401,1360770908129,4125561077,4125570805,9728
1360770914,4125576676,16,13753,859.5625,1360770898401,1360770908705,4125561077,4125571381,10304
1360770914,4125576676,14,8687,620.5,1360770898401,1360770908001,4125561077,4125570677,9600
1360770914,4125576680,9,2364,262.6666667,1360770909342,1360770909534,4125572022,4125572214,192
1360770914,4125576680,9,2566,285.1111111,1360770909532,1360770909980,4125572212,4125572660,448
1360770914,4125576680,8,1490,186.25,1360770909532,1360770909852,4125572212,4125572532,320
1360770914,4125576680,8,1442,180.25,1360770909532,1360770910172,4125572212,4125572852,640
1360770914,4125576680,8,1506,188.25,1360770909532,1360770910172,4125572212,4125572852,640
1360770914,4125576680,9,2422,269.1111111,1360770909532,1360770909980,4125572212,4125572660,448
1360770914,4125576684,8,1714,214.25,1360770909849,1360770910041,4125572533,4125572725,192
1360770914,4125576684,9,2326,258.4444444,1360770909977,1360770910169,4125572661,4125572853,192
1360770914,4125576684,8,1240,155,1360770910360,1360770910488,4125573044,4125573172,128
1360770914,4125576684,8,1474,184.25,1360770909976,1360770910296,4125572660,4125572980,320
1360770914,4125576700,12,9490,790.8333333,1360770908554,1360770908810,4125571254,4125571510,256
1360770914,4125576700,16,14375,898.4375,1360770898375,1360770908167,4125561075,4125570867,9792
1360770914,4125576704,8,1656,207,1360770909316,1360770909508,4125572020,4125572212,192
1360770914,4125576704,8,1656,207,1360770909316,1360770909316,4125572020,4125572020,0
1360770914,4125576704,8,1426,178.25,1360770909507,1360770910147,4125572211,4125572851,640
1360770915,1192297588,3,193,64.33333333,1360770914119,1360770914119,1192296707,1192296707,0
1360770915,1192297776,56,22597,403.5178571,1360770887565,1360770888845,1192270341,1192271621,1280
1360770915,1192297784,19,4780,251.5789474,1360770888580,1360770890244,1192271364,1192273028,1664
1360770915,1192297812,5,380,76,1360770889449,1360770893545,1192272261,1192276357,4096
1360770916,1192297852,15,3767,251.1333333,1360770888617,1360770899753,1192270469,1192281605,11136
1360770920,1192301948,15,9217,614.4666667,1360770894535,1360770897607,1192276483,1192279555,3072
1360770920,1192301960,20,6183,309.15,1360770895548,1360770896380,1192277508,1192278340,832
1360770922,4125584672,14,8058,575.5714286,1360770916069,1360770918245,4125578741,4125580917,2176
1360770922,4125584676,10,3710,371,1360770917152,1360770917728,4125579828,4125580404,576
1360770922,4125584680,8,1554,194.25,1360770917725,1360770918045,4125580405,4125580725,320
1360770922,4125584684,8,1346,168.25,1360770919129,1360770919257,4125581813,4125581941,128
1360770922,4125584684,12,8546,712.1666667,1360770919321,1360770919577,4125582005,4125582261,256
1360770922,4125584684,8,1240,155,1360770919193,1360770919257,4125581877,4125581941,64
1360770922,4125584684,8,1442,180.25,1360770919320,1360770919512,4125582004,4125582196,192
1360770922,4125584684,8,1298,162.25,1360770919448,1360770919512,4125582132,4125582196,64
1360770922,4125584684,8,1576,197,1360770919512,1360770919640,4125582196,4125582324,128
1360770922,4125584696,9,1602,178,1360770916046,1360770916942,4125578742,4125579638,896
1360770922,4125584700,11,2670,242.7272727,1360770916936,1360770918344,4125579636,4125581044,1408
1360770922,4125584704,15,14403,960.2,1360770918021,1360770918789,4125580725,4125581493,768
1360770922,4125584704,8,1298,162.25,1360770921285,1360770921477,4125583989,4125584181,192
1360770922,4125584704,10,7034,703.4,1360770915587,1360770915843,4125578291,4125578547,256
1360770922,4125584708,8,1506,188.25,1360770919296,1360770919552,4125582004,4125582260,256
1360770922,4125584708,8,1458,182.25,1360770919296,1360770919488,4125582004,4125582196,192
1360770922,4125584708,8,1576,197,1360770919424,1360770919552,4125582132,4125582260,128
1360770922,4125584708,8,1576,197,1360770919488,1360770919552,4125582196,4125582260,64
1360770922,4125584708,8,1576,197,1360770919488,1360770919616,4125582196,4125582324,128
1360770922,4125584708,7,1246,178,1360770919616,1360770919616,4125582324,4125582324,0
1360770922,4125584708,8,1730,216.25,1360770919552,1360770919744,4125582260,4125582452,192
1360770923,1192305676,17,3791,223,1360770914098,1360770918514,1192296774,1192301190,4416
1360770924,1192305868,8,3893,486.625,1360770896855,1360770897303,1192278723,1192279171,448
1360770927,1192309800,49,29773,607.6122449,1360770900149,1360770926837,1192282949,1192309637,26688
1360770928,4125590620,8,1666,208.25,1360770923862,1360770923990,4125586482,4125586610,128
1360770930,4125592660,8,1123,140.375,1360770928303,1360770928367,4125590963,4125591027,64
1360770930,4125592664,9,2284,253.7777778,1360770925421,1360770925485,4125588085,4125588149,64
1360770930,4125592664,8,1240,155,1360770925932,1360770925996,4125588596,4125588660,64
1360770930,4125592672,11,7902,718.3636364,1360770923812,1360770924068,4125586484,4125586740,256
1360770930,4125592672,8,1570,196.25,1360770923940,1360770925412,4125586612,4125588084,1472
1360770930,4125592688,13,10603,815.6153846,1360770925397,1360770925781,4125588085,4125588469,384
1360770930,4125592688,8,1298,162.25,1360770925972,1360770926036,4125588660,4125588724,64
1360770930,4125592692,8,1378,172.25,1360770923473,1360770923537,4125586165,4125586229,64
1360770930,4125592692,10,7098,709.8,1360770923536,1360770923664,4125586228,4125586356,128
1360770932,1192314008,29,34209,1179.62069,1360770910796,1360770926348,1192292804,1192308356,15552
1360770938,4125600672,749,1059813,1414.970628,1360770928358,1360770931238,4125591030,4125593910,2880
1360770944,1192325960,40,2116,52.9,1360770916282,1360770920890,1192298242,1192302850,4608
1360770944,1192326000,15,3650,243.3333333,1360770919189,1360770921109,1192301189,1192303109,1920
1360770944,1192326080,1,158,158,1360770919429,1360770919429,1192301509,1192301509,0
1360770952,1192334016,3,478,159.3333333,1360770927685,1360770927749,1192309701,1192309765,64
1360770955,1192337604,3,156,52,1360770951158,1360770951478,1192333762,1192334082,320
1360770956,1192338008,1,52,52,1360770931660,1360770931660,1192313668,1192313668,0
1360770976,1192358028,2,104,52,1360770951734,1360770951734,1192333762,1192333762,0
1360770976,1192358104,40,2116,52.9,1360770951147,1360770953643,1192333251,1192335747,2496
1360771004,1192386044,3,710,236.6666667,1360770979429,1360771002789,1192361473,1192384833,23360
1360771008,1192390156,37,1924,52,1360770983608,1360770985400,1192365764,1192367556,1792
1360771011,1192393632,3,193,64.33333333,1360771009820,1360771009820,1192392452,1192392452,0
1360771036,1192418056,15,3731,248.7333333,1360771010392,1360771011352,1192392448,1192393408,960
1360771040,1192422148,37,1924,52,1360771015421,1360771017597,1192397569,1192399745,2176
1360771064,1192446088,1,158,158,1360771039355,1360771039355,1192421443,1192421443,0
1360771072,1192454160,38,1988,52.31578947,1360771047603,1360771049267,1192429763,1192431427,1664
1360771091,1192473632,5,309,61.8,1360771083033,1360771083225,1192465665,1192465857,192
1360771104,1192486200,37,1924,52,1360771079241,1360771083337,1192461441,1192465537,4096
1360771108,1192490144,19,4192,220.6315789,1360771083587,1360771097027,1192465731,1192479171,13440
1360771128,1192510144,3,380,126.6666667,1360771099331,1360771099587,1192481475,1192481731,256
1360771140,1192522264,44,2372,53.90909091,1360771113290,1360771117834,1192495554,1192500098,4544
1360771147,1192529652,4,310,77.5,1360771138887,1360771139015,1192521539,1192521667,128
1360771164,1192546212,4,922,230.5,1360771137532,1360771154620,1192519744,1192536832,17088
1360771176,1192558196,44,3062,69.59090909,1360771147981,1360771172557,1192530177,1192554753,24576
1360771180,1192562244,10,6552,655.2,1360771154270,1360771154398,1192536514,1192536642,128
1360771184,1192566256,2,210,105,1360771159183,1360771159183,1192541439,1192541439,0
1360771208,1192590344,43,2308,53.6744186,1360771181496,1360771184760,1192563840,1192567104,3264
1360771220,1192602456,15,9514,634.2666667,1360771195590,1360771195974,1192578046,1192578430,384
1360771240,1192622532,41,2180,53.17073171,1360771214586,1360771217082,1192597118,1192599614,2496
1360771268,1192650468,41,2168,52.87804878,1360771240313,1360771249337,1192622781,1192631805,9024
1360771276,1192658684,9,5871,652.3333333,1360771248741,1360771266917,1192631425,1192649601,18176
1360771304,1192686636,41,2180,53.17073171,1360771279185,1360771281617,1192661821,1192664253,2432
1360771332,1192714536,1,78,78,1360771305780,1360771305780,1192688316,1192688316,0
1360771336,1192718580,42,2244,53.42857143,1360771311691,1360771315659,1192694271,1192698239,3968
1360771364,1192746608,2,210,105,1360771338797,1360771338797,1192721405,1192721405,0
1360771372,1192754672,41,2180,53.17073171,1360771345516,1360771348396,1192728188,1192731068,2880
1360771395,1192777776,4,310,77.5,1360771393796,1360771393924,1192776572,1192776700,128
1360771404,1192786752,44,2372,53.90909091,1360771378334,1360771381854,1192761086,1192764606,3520
1360771424,1192806788,1,158,158,1360771398647,1360771398647,1192781435,1192781435,0
1360771440,1192822744,44,2372,53.90909091,1360771412902,1360771416422,1192795646,1192799166,3520
1360771468,1192850712,2,178,89,1360771439938,1360771440258,1192822650,1192822970,320
1360771473,1192854884,40,2116,52.9,1360771447294,1360771449470,1192829178,1192831354,2176
1360771485,1192866972,1,158,158,1360771459431,1360771459431,1192841403,1192841403,0
1360771501,1192882956,42,2269,54.02380952,1360771474934,1360771481974,1192856890,1192863930,7040
1360771537,1192919056,40,2116,52.9,1360771511892,1360771514068,1192893948,1192896124,2176
1360771545,1192927012,1,158,158,1360771519422,1360771519422,1192901434,1192901434,0
1360771549,1192930880,1,127,127,1360771523139,1360771523139,1192905019,1192905019,0
1360771553,1192934828,13,5665,435.7692308,1360771526007,1360771528119,1192907835,1192909947,2112
1360771569,1192951084,39,2052,52.61538462,1360771544056,1360771545848,1192926140,1192927932,1792
1360771601,1192983232,45,2436,54.13333333,1360771575713,1360771579681,1192957945,1192961913,3968
1360771605,1192987228,2,316,158,1360771579175,1360771579431,1192961403,1192961659,256
1360771637,1193019232,40,2116,52.9,1360771610018,1360771612130,1192992250,1192994362,2112
1360771637,1193019276,5,390,78,1360771608822,1360771612598,1192991098,1192994874,3776
1360771665,1193047224,1,158,158,1360771639211,1360771639211,1193021435,1193021435,0
1360771669,1193051388,38,1988,52.31578947,1360771641925,1360771643653,1193024313,1193026041,1728
1360771701,1193083332,42,2244,53.42857143,1360771673661,1360771676349,1193055993,1193058681,2688
1360771725,1193107368,1,158,158,1360771699031,1360771699031,1193081399,1193081399,0
1360771733,1193115276,37,1924,52,1360771706418,1360771707698,1193088694,1193089974,1280
1360771766,1193147808,45,2436,54.13333333,1360771738185,1360771742921,1193119993,1193124729,4736
1360771770,1193151836,2,178,89,1360771743597,1360771743917,1193125433,1193125753,320
1360771772,1193154048,10,3832,383.2,1360771764440,1360771764696,1193146488,1193146744,256
1360771772,1193154128,10,3832,383.2,1360771764360,1360771764616,1193146488,1193146744,256
1360771772,1193154136,4,310,77.5,1360771767678,1360771767806,1193149814,1193149942,128
1360771786,1193167928,1,158,158,1360771759502,1360771759502,1193141430,1193141430,0
1360771790,1193171864,28,24563,877.25,1360771764878,1360771765454,1193146742,1193147318,576
1360771790,1193171864,20,12613,630.65,1360771764880,1360771765456,1193146744,1193147320,576
1360771798,1193179932,40,2141,53.525,1360771772811,1360771790667,1193154743,1193172599,17856
1360771828,1193210112,2,116,58,1360771824341,1360771824917,1193206453,1193207029,576
1360771830,1193211988,37,1924,52,1360771804561,1360771805777,1193186549,1193187765,1216
1360771850,1193232080,1,52,52,1360771824632,1360771824632,1193206712,1193206712,0
1360771862,1193244076,47,2564,54.55319149,1360771835706,1360771840570,1193217782,1193222646,4864
1360771874,1193256124,1,158,158,1360771849290,1360771849290,1193231414,1193231414,0
1360771898,1193280044,39,2052,52.61538462,1360771870616,1360771872536,1193252660,1193254580,1920
1360771930,1193312048,41,2180,53.17073171,1360771902485,1360771905365,1193284533,1193287413,2880
1360771934,1193316144,2,236,118,1360771909238,1360771911670,1193291382,1193293814,2432
1360771950,1193332160,3,897,299,1360771922084,1360771922148,1193304244,1193304308,64
1360771954,1193336156,4,2112,528,1360771926184,1360771926184,1193308340,1193308340,0
1360771962,1193344220,39,2052,52.61538462,1360771936423,1360771938215,1193318643,1193320435,1792
1360771978,1193360188,7,2129,304.1428571,1360771949831,1360771950087,1193332019,1193332275,256
1360771988,1193370124,12,4552,379.3333333,1360771986183,1360771987783,1193368307,1193369907,1600
1360771988,1193370180,9,3629,403.2222222,1360771985550,1360771987726,1193367730,1193369906,2176
1360771994,1193376204,40,2116,52.9,1360771968249,1360771970553,1193350453,1193352757,2304
1360772010,1193392252,1,89,89,1360771984777,1360771984777,1193367029,1193367029,0
1360772014,1193396280,2,120,60,1360771985898,1360771986346,1193368178,1193368626,448
1360772026,1193408224,42,2244,53.42857143,1360772000549,1360772003365,1193382773,1193385589,2816
1360772026,1193408272,2,210,105,1360771999091,1360771999091,1193381363,1193381363,0
1360772058,1193440620,43,2308,53.6744186,1360772032983,1360772036183,1193415603,1193418803,3200
1360772074,1193456592,1,89,89,1360772046643,1360772046643,1193429235,1193429235,0
1360772086,1193468520,1,158,158,1360772058873,1360772058873,1193441393,1193441393,0
1360772094,1193476504,47,2589,55.08510638,1360772066314,1360772092106,1193448818,1193474610,25792
1360772126,1193508548,41,2180,53.17073171,1360772099871,1360772102239,1193482419,1193484787,2368
1360772146,1193528644,2,316,158,1360772118718,1360772118974,1193501362,1193501618,256
1360772158,1193540684,41,2180,53.17073171,1360772132694,1360772134998,1193515378,1193517682,2304
1360772180,1193562380,2,98,49,1360772161926,1360772171974,1193544306,1193554354,10048
1360772180,1193562452,2,98,49,1360772165885,1360772171901,1193548337,1193554353,6016
1360772190,1193572760,37,1924,52,1360772164938,1360772166154,1193547698,1193548914,1216
1360772206,1193588684,2,316,158,1360772178707,1360772178963,1193561391,1193561647,256
1360772223,1193604932,37,1924,52,1360772196995,1360772198275,1193578927,1193580207,1280
1360772243,1193625020,1,78,78,1360772214830,1360772214830,1193596850,1193596850,0
1360772255,1193637104,37,1924,52,1360772228120,1360772229400,1193610224,1193611504,1280
1360772276,1193658444,9,3762,418,1360772274436,1360772274756,1193656880,1193657200,320
1360772276,1193658460,9,3847,427.4444444,1360772275446,1360772275702,1193657906,1193658162,256
1360772284,1193666524,9,3865,429.4444444,1360772276469,1360772276661,1193658993,1193659185,192
1360772284,1193666536,9,3651,405.6666667,1360772277352,1360772277992,1193659888,1193660528,640
1360772287,1193669056,37,1924,52,1360772259400,1360772260680,1193641456,1193642736,1280
1360772295,1193677012,1,158,158,1360772269363,1360772269363,1193651375,1193651375,0
1360772315,1193697080,38,1988,52.31578947,1360772290798,1360772292334,1193672878,1193674414,1536
1360772347,1193729204,41,2180,53.17073171,1360772322226,1360772325042,1193704430,1193707246,2816
1360772355,1193737188,1,158,158,1360772329154,1360772329154,1193711342,1193711342,0
1360772375,1193757552,1,89,89,1360772349783,1360772349783,1193732335,1193732335,0
1360772383,1193765544,40,2116,52.9,1360772354717,1360772357021,1193737261,1193739565,2304
1360772415,1193797556,1,158,158,1360772388819,1360772388819,1193771375,1193771375,0
1360772415,1193797628,40,2141,53.525,1360772386954,1360772394250,1193769582,1193776878,7296
1360772443,1193825620,37,1924,52,1360772418834,1360772420050,1193801454,1193802670,1216
1360772475,1193857724,1,158,158,1360772448618,1360772448618,1193831342,1193831342,0
1360772476,1193857840,40,2104,52.6,1360772450398,1360772452382,1193832238,1193834222,1984
1360772503,1193885736,10,5817,581.7,1360772474845,1360772474973,1193857581,1193857709,128
1360772508,1193889892,38,1988,52.31578947,1360772482345,1360772484073,1193864237,1193865965,1728
1360772536,1193917988,2,236,118,1360772509383,1360772518151,1193891371,1193900139,8768
1360772540,1193921908,38,1988,52.31578947,1360772514071,1360772516119,1193895979,1193898027,2048
1360772556,1193937904,1,52,52,1360772529884,1360772529884,1193911788,1193911788,0
1360772572,1193953964,37,1924,52,1360772546077,1360772547741,1193928041,1193929705,1664
1360772572,1193954012,1,48,48,1360772544305,1360772544305,1193926317,1193926317,0
1360772596,1193978044,1,158,158,1360772569293,1360772569293,1193951337,1193951337,0
1360772604,1193986048,37,1924,52,1360772577676,1360772579084,1193959724,1193961132,1408
1360772636,1194018104,44,2372,53.90909091,1360772608978,1360772614546,1193991082,1193996650,5568
1360772644,1194025992,5,3261,652.2,1360772616769,1360772616961,1193998761,1193998953,192
1360772669,1194051040,12,6497,541.4166667,1360772663377,1360772663697,1194045417,1194045737,320
1360772669,1194051120,10,3832,383.2,1360772663363,1360772663619,1194045483,1194045739,256
1360772672,1194054000,38,1988,52.31578947,1360772644665,1360772646137,1194026665,1194028137,1472
1360772680,1194062000,1,89,89,1360772653241,1360772653241,1194035241,1194035241,0
1360772684,1194066400,2,210,105,1360772658987,1360772658987,1194041387,1194041387,0
1360772685,1194067088,116,138042,1190.017241,1360772436515,1360772676899,1193818603,1194058987,240384
1360772688,1194070376,23,13197,573.7826087,1360772663363,1360772663747,1194045739,1194046123,384
1360772688,1194070456,21,20643,983,1360772663282,1360772663602,1194045738,1194046058,320
1360772700,1194082400,41,2205,53.7804878,1360772675754,1360772696426,1194058154,1194078826,20672
1360772725,1194107064,3,193,64.33333333,1360772724153,1360772724153,1194106217,1194106217,0
1360772725,1194107144,4,220,55,1360772723241,1360772723305,1194105385,1194105449,64
1360772732,1194114400,17,9210,541.7647059,1360772706154,1360772706474,1194088554,1194088874,320
1360772736,1194118476,38,1988,52.31578947,1360772710427,1360772712027,1194092903,1194094503,1600
1360772748,1194130436,1,52,52,1360772722947,1360772722947,1194105383,1194105383,0
1360772748,1194130464,15,3650,243.3333333,1360772723753,1360772724393,1194106217,1194106857,640
1360772748,1194130464,1,60,60,1360772723815,1360772723815,1194106279,1194106279,0
1360772768,1194150548,37,1924,52,1360772741972,1360772743252,1194124520,1194125800,1280
1360772776,1194158532,1,158,158,1360772748837,1360772748837,1194131369,1194131369,0
1360772800,1194182620,39,2052,52.61538462,1360772773197,1360772775053,1194155817,1194157673,1856
1360772832,1194214652,44,2372,53.90909091,1360772804971,1360772808747,1194187623,1194191399,3776
1360772836,1194218536,2,236,118,1360772808799,1360772820383,1194191335,1194202919,11584
1360772865,1194246956,42,2244,53.42857143,1360772839396,1360772842468,1194221352,1194224424,3072
1360772897,1194278944,1,158,158,1360772869360,1360772869360,1194251304,1194251304,0
1360772897,1194279016,43,2308,53.6744186,1360772872360,1360772875560,1194254376,1194257576,3200
1360772933,1194314996,40,2116,52.9,1360772905592,1360772907704,1194287588,1194289700,2112
1360772957,1194339020,1,158,158,1360772929315,1360772929315,1194311335,1194311335,0
1360772965,1194346964,37,1924,52,1360772937753,1360772938969,1194319717,1194320933,1216
1360772981,1194363068,2,178,89,1360772956016,1360772956272,1194338084,1194338340,256
1360772997,1194379260,38,1988,52.31578947,1360772968688,1360772970288,1194350948,1194352548,1600
1360773017,1194399012,2,359,179.5,1360772989351,1360772990567,1194371363,1194372579,1216
1360773025,1194407072,38,2013,52.97368421,1360772998763,1360773001707,1194380835,1194383779,2944
1360773057,1194439092,44,2372,53.90909091,1360773031702,1360773035478,1194413794,1194417570,3776
1360773077,1194459156,1,158,158,1360773049176,1360773049176,1194431332,1194431332,0
1360773093,1194475152,38,1988,52.31578947,1360773065433,1360773066969,1194447585,1194449121,1536
1360773125,1194507056,42,2244,53.42857143,1360773097082,1360773102330,1194479138,1194484386,5248
1360773137,1194519156,2,236,118,1360773109142,1360773122966,1194491298,1194505122,13824
1360773157,1194539164,37,1924,52,1360773132239,1360773133519,1194514403,1194515683,1280
1360773185,1194567356,1,391,391,1360773158606,1360773158606,1194540962,1194540962,0
1360773189,1194571316,43,2308,53.6744186,1360773163382,1360773166518,1194545698,1194548834,3136
1360773197,1194579588,3,144,48,1360773193446,1360773193510,1194576034,1194576098,64
1360773197,1194579608,3,267,89,1360773193553,1360773194769,1194576161,1194577377,1216
1360773225,1194607392,3,267,89,1360773197287,1360773211495,1194579679,1194593887,14208
1360773257,1194639408,1,89,89,1360773230360,1360773230360,1194612768,1194612768,0
1360773285,1194667408,6,534,89,1360773258200,1360773266584,1194640608,1194648992,8384
1360773293,1194675456,1,89,89,1360773268136,1360773268136,1194650592,1194650592,0
1360773325,1194707488,6,534,89,1360773300040,1360773309448,1194682528,1194691936,9408
1360773689,1195071724,1,46,46,1360773661910,1360773661910,1195044634,1195044634,0
1360773899,1195281024,3,144,48,1360773874637,1360773883661,1195256661,1195265685,9024
1360776111,1197493272,1,46,46,1360776083766,1360776083766,1197466038,1197466038,0
1360776163,1197545052,1,144,144,1360776135631,1360776135631,1197517683,1197517683,0
1360776644,1198025852,1,48,48,1360776618705,1360776618705,1198000557,1198000557,0
1360776644,1198025856,1,48,48,1360776618895,1360776618895,1198000751,1198000751,0
1360776644,1198025936,1,48,48,1360776618686,1360776618686,1198000622,1198000622,0
1360777409,1198791204,9,3780,420,1360777407269,1360777407845,1198789473,1198790049,576
1360777409,1198791204,10,3832,383.2,1360777407077,1360777407781,1198789281,1198789985,704
1360777409,1198791292,8,2747,343.375,1360777404622,1360777404942,1198786914,1198787234,320
1360777430,1198812004,17,4676,275.0588235,1360777404013,1360777405357,1198786017,1198787361,1344
1360777430,1198812012,5,380,76,1360777404772,1360777408740,1198786784,1198790752,3968
1360777430,1198812052,8,951,118.875,1360777402686,1360777402878,1198784738,1198784930,192
1360777430,1198812052,1,46,46,1360777402876,1360777402876,1198784928,1198784928,0
1360777434,1198816012,18,5839,324.3888889,1360777407782,1360777408614,1198789794,1198790626,832
1360777434,1198816012,24,21655,902.2916667,1360777407972,1360777408996,1198789984,1198791008,1024
1360777434,1198816100,17,12029,707.5882353,1360777407950,1360777408398,1198790050,1198790498,448
1360777498,1198880112,7,623,89,1360777470464,1360777485440,1198852576,1198867552,14976
1360777614,1198996552,7,623,89,1360777585928,1360777600840,1198968480,1198983392,14912
1360777649,1199031452,7,710,101.4285714,1360777642476,1360777646124,1199024928,1199028576,3648
1360777649,1199031496,3,156,52,1360777647997,1360777648701,1199030493,1199031197,704
1360777649,1199031576,2,104,52,1360777648430,1360777648686,1199031006,1199031262,256
1360777657,1199039420,3,156,52,1360777649290,1360777651978,1199031710,1199034398,2688
1360777657,1199039428,2,104,52,1360777649732,1360777651652,1199032160,1199034080,1920
1360777831,1199213168,1,46,46,1360777805636,1360777805636,1199187804,1199187804,0
1360778076,1199457924,1,46,46,1360778049651,1360778049651,1199431575,1199431575,0
1360780596,1201977848,1,48,48,1360780565464,1360780565464,1201947312,1201947312,0
1360781098,1202479828,1,46,46,1360781072164,1360781072164,1202453992,1202453992,0
1360782749,1204131248,1,46,46,1360782721064,1360782721064,1204103312,1204103312,0
1360782885,4137547764,2,96,48,1360782860631,1360782863575,4137523395,4137526339,2944
1360783704,1205086676,1,46,46,1360783676334,1360783676334,1205059010,1205059010,0
1360783937,1205319320,1,46,46,1360783911120,1360783911120,1205293440,1205293440,0
1360785186,1206568380,1,46,46,1360785161151,1360785161151,1206543531,1206543531,0
1360785499,1206881524,1,46,46,1360785474666,1360785474666,1206857190,1206857190,0
1360786862,1208244320,1,46,46,1360786834272,1360786834272,1208216592,1208216592,0
1360786898,1208280060,1,48,48,1360786867107,1360786867107,1208249167,1208249167,0
1360787324,1208706196,1,46,46,1360787296087,1360787296087,1208678283,1208678283,0
1360787716,1209098748,1,46,46,1360787689128,1360787689128,1209071876,1209071876,0
1360794772,1216154292,1,46,46,1360794742402,1360794742402,1216124694,1216124694,0
1360795468,1216850424,1,46,46,1360795439221,1360795439221,1216821645,1216821645,0
1360795468,1216850428,1,46,46,1360795439215,1360795439215,1216821643,1216821643,0
1360795468,1216850484,1,46,46,1360795439226,1360795439226,1216821710,1216821710,0
1360795469,1216851644,1,46,46,1360795439066,1360795439066,1216821710,1216821710,0
1360795469,1216851676,1,46,46,1360795439033,1360795439033,1216821709,1216821709,0
1360795469,1216851676,1,46,46,1360795439032,1360795439032,1216821708,1216821708,0
1360795469,1216851700,1,46,46,1360795439073,1360795439073,1216821773,1216821773,0
1360795469,1216851704,1,46,46,1360795439071,1360795439071,1216821775,1216821775,0
1360795469,1216851732,1,46,46,1360795439041,1360795439041,1216821773,1216821773,0
1360796332,1217713876,1,46,46,1360796305358,1360796305358,1217687234,1217687234,0
1360796905,1218287648,1,46,46,1360796878910,1360796878910,1218261558,1218261558,0
1360797022,1218404064,1,46,46,1360796994119,1360796994119,1218376183,1218376183,0
1360797203,1218585500,1,46,46,1360797176335,1360797176335,1218558835,1218558835,0
1360797319,1218700996,1,48,48,1360797292483,1360797292483,1218674479,1218674479,0
1360798891,1220272780,1,46,46,1360798862918,1360798862918,1220244698,1220244698,0
1360799647,1221029480,6,570,95,1360799619646,1360799641278,1221002126,1221023758,21632
1360799819,1221201376,1,46,46,1360799790819,1360799790819,1221173195,1221173195,0
1360800389,1221771228,1,46,46,1360800363758,1360800363758,1221745986,1221745986,0
1360801372,1222754076,1,48,48,1360801347511,1360801347511,1222729587,1222729587,0
1360804799,1226181232,1,46,46,1360804774119,1360804774119,1226156351,1226156351,0
1360805835,1227217532,1,46,46,1360805809774,1360805809774,1227192306,1227192306,0
1360806239,1227621668,1,46,46,1360806212768,1360806212768,1227595436,1227595436,0
1360806911,1228292920,1,46,46,1360806883328,1360806883328,1228265248,1228265248,0
1360806911,1228292928,1,46,46,1360806883322,1360806883322,1228265250,1228265250,0
1360806911,1228292964,1,46,46,1360806883350,1360806883350,1228265314,1228265314,0
1360806911,1228293004,1,46,46,1360806883310,1360806883310,1228265314,1228265314,0
1360806912,1228294352,1,46,46,1360806882895,1360806882895,1228265247,1228265247,0
1360806912,1228294392,1,46,46,1360806882920,1360806882920,1228265312,1228265312,0
1360806912,1228294432,1,46,46,1360806882879,1360806882879,1228265311,1228265311,0
1360806912,1228294440,1,46,46,1360806882938,1360806882938,1228265378,1228265378,0
1360807092,1228474372,1,46,46,1360807063099,1360807063099,1228445471,1228445471,0
1360807206,1228588232,1,46,46,1360807181123,1360807181123,1228563355,1228563355,0
1360807680,1229061808,1,48,48,1360807654118,1360807654118,1229035926,1229035926,0
1360808972,1230354132,1,46,46,1360808945614,1360808945614,1230327746,1230327746,0
1360810261,1231643356,1,46,46,1360810236505,1360810236505,1231618861,1231618861,0
1360811411,1232793240,1,434,434,1360811383228,1360811383228,1232765468,1232765468,0
1360811993,1233374776,1,46,46,1360811965572,1360811965572,1233347348,1233347348,0
1360812707,1234089288,1,48,48,1360812679035,1360812679035,1234061323,1234061323,0
1360812830,1234212632,1,46,46,1360812801823,1360812801823,1234184455,1234184455,0
1360815080,1236461732,1,52,52,1360815055296,1360815055296,1236437028,1236437028,0
1360815244,1236626152,1,78,78,1360815219099,1360815219099,1236601251,1236601251,0
1360815585,1236967300,1,46,46,1360815558467,1360815558467,1236940767,1236940767,0
1361375071,1796450992,1,46,46,1361375044907,1361375044907,1796424899,1796424899,0
1361375348,1796727924,1,46,46,1361375320488,1361375320488,1796700412,1796700412,0
1361375673,1797052996,10,3832,383.2,1361375671131,1361375671707,1797051127,1797051703,576
1361375673,1797053000,10,3832,383.2,1361375671130,1361375671706,1797051130,1797051706,576
1361375680,1797060876,59,53796,911.7966102,1361375670826,1361375673642,1797051702,1797054518,2816
1361375681,1797061012,41,30651,747.5853659,1361375671690,1361375672906,1797051702,1797052918,1216
1361375682,435376048,12,6482,540.1666667,1361375679232,1361375679424,435373280,435373472,192
1361375682,435376048,17,16171,951.2352941,1361375679232,1361375679488,435373280,435373536,256
1361375682,435376048,8,2306,288.25,1361375679231,1361375679423,435373279,435373471,192
1361375682,435376048,7,1614,230.5714286,1361375679231,1361375679423,435373279,435373471,192
1361375682,435376048,9,2326,258.4444444,1361375679423,1361375679615,435373471,435373663,192
1361375682,435376048,8,1634,204.25,1361375679423,1361375679615,435373471,435373663,192
1361375682,435376048,9,2630,292.2222222,1361375679423,1361375679615,435373471,435373663,192
1361375682,435376052,9,4134,459.3333333,1361375679486,1361375679678,435373538,435373730,192
1361375682,435376052,35,42594,1216.971429,1361375679614,1361375679870,435373666,435373922,256
1361375682,435376052,8,1448,181,1361375680125,1361375680189,435374177,435374241,64
1361375682,435376052,13,9642,741.6923077,1361375680125,1361375680317,435374177,435374369,192
1361375682,435376052,9,5132,570.2222222,1361375680125,1361375680317,435374177,435374369,192
1361375682,435376052,8,1384,173,1361375680125,1361375680317,435374177,435374369,192
1361375682,435376052,11,6129,557.1818182,1361375680125,1361375680317,435374177,435374369,192
1361375682,435376052,9,2406,267.3333333,1361375680380,1361375680444,435374432,435374496,64
1361375682,435376052,18,18309,1017.166667,1361375680444,1361375680572,435374496,435374624,128
1361375682,435376052,30,34945,1164.833333,1361375680444,1361375680572,435374496,435374624,128
1361375682,435376056,12,7218,601.5,1361375677562,1361375677946,435371618,435372002,384
1361375682,435376056,36,42468,1179.666667,1361375678009,1361375678201,435372065,435372257,192
1361375682,435376056,29,32339,1115.137931,1361375678009,1361375678201,435372065,435372257,192
1361375682,435376056,9,3782,420.2222222,1361375678009,1361375678265,435372065,435372321,256
1361375682,435376056,9,2070,230,1361375678009,1361375678073,435372065,435372129,64
1361375682,435376056,14,12703,907.3571429,1361375678073,1361375678265,435372129,435372321,192
1361375682,435376056,9,4598,510.8888889,1361375678137,1361375678329,435372193,435372385,192
1361375682,435376056,10,6458,645.8,1361375678265,1361375678329,435372321,435372385,64
1361375682,435376056,8,4130,516.25,1361375678200,1361375678328,435372256,435372384,128
1361375682,435376056,24,26708,1112.833333,1361375681336,1361375681336,435375392,435375392,0
1361375682,435376060,15,13047,869.8,1361375674294,1361375676726,435368354,435370786,2432
1361375682,435376060,8,1314,164.25,1361375679221,1361375679413,435373281,435373473,192
1361375682,435376060,8,2322,290.25,1361375679285,1361375679413,435373345,435373473,128
1361375682,435376060,8,1906,238.25,1361375679413,1361375679605,435373473,435373665,192
1361375682,435376060,9,4822,535.7777778,1361375679412,1361375679604,435373472,435373664,192
1361375682,435376060,21,22544,1073.52381,1361375679604,1361375679860,435373664,435373920,256
1361375682,435376072,9,3196,355.1111111,1361375680106,1361375680170,435374178,435374242,64
1361375682,435376072,11,6737,612.4545455,1361375680106,1361375680426,435374178,435374498,320
1361375682,435376072,16,15357,959.8125,1361375680106,1361375680298,435374178,435374370,192
1361375682,435376072,8,1192,149,1361375680106,1361375680298,435374178,435374370,192
1361375682,435376072,13,8883,683.3076923,1361375680425,1361375680489,435374497,435374561,64
1361375682,435376072,9,5724,636,1361375680425,1361375680553,435374497,435374625,128
1361375682,435376072,10,5193,519.3,1361375676968,1361375677160,435371040,435371232,192
1361375682,435376072,24,26548,1106.166667,1361375681064,1361375681192,435375136,435375264,128
1361375682,435376072,24,25166,1048.583333,1361375681064,1361375681192,435375136,435375264,128
1361375682,435376072,12,7149,595.75,1361375681384,1361375681384,435375456,435375456,0
1361375682,435376072,5,864,172.8,1361375676775,1361375676903,435370847,435370975,128
1361375682,435376072,9,1467,163,1361375677163,1361375677739,435371235,435371811,576
1361375682,435376072,9,2566,285.1111111,1361375677994,1361375678122,435372066,435372194,128
1361375682,435376072,11,5374,488.5454545,1361375677994,1361375678122,435372066,435372194,128
1361375682,435376076,11,8238,748.9090909,1361375678118,1361375678310,435372194,435372386,192
1361375682,435376076,9,5670,630,1361375678117,1361375678245,435372193,435372321,128
1361375682,435376076,11,7726,702.3636364,1361375678373,1361375679205,435372449,435373281,832
1361375682,435376076,9,2246,249.5555556,1361375678245,1361375678373,435372321,435372449,128
1361375682,435376076,13,9883,760.2307692,1361375678373,1361375678885,435372449,435372961,512
1361375690,435384048,12,5835,486.25,1361375674305,1361375683201,435368353,435377249,8896
1361375690,435384048,14,11523,823.0714286,1361375674305,1361375683329,435368353,435377377,9024
1361375690,435384048,8,1656,207,1361375684095,1361375684159,435378143,435378207,64
1361375690,435384052,8,1442,180.25,1361375684350,1361375684798,435378402,435378850,448
1361375690,435384052,11,7086,644.1818182,1361375688446,1361375688830,435382498,435382882,384
1361375690,435384052,9,2566,285.1111111,1361375684350,1361375684670,435378402,435378722,320
1361375690,435384052,8,1490,186.25,1361375684349,1361375684541,435378401,435378593,192
1361375690,435384052,9,2326,258.4444444,1361375684605,1361375684797,435378657,435378849,192
1361375690,435384052,8,1714,214.25,1361375684541,1361375684797,435378593,435378849,256
1361375690,435384052,9,2284,253.7777778,1361375684797,1361375684797,435378849,435378849,0
1361375690,435384052,8,1474,184.25,1361375684669,1361375684797,435378721,435378849,128
1361375690,435384056,9,2284,253.7777778,1361375689850,1361375689914,435383906,435383970,64
1361375690,435384056,11,5863,533,1361375674296,1361375683192,435368352,435377248,8896
1361375690,435384056,16,13915,869.6875,1361375674296,1361375683576,435368352,435377632,9280
1361375690,435384056,15,12327,821.8,1361375674296,1361375683640,435368352,435377696,9344
1361375690,435384060,8,1656,207,1361375684086,1361375684150,435378146,435378210,64
1361375690,435384060,9,2422,269.1111111,1361375684341,1361375684597,435378401,435378657,256
1361375690,435384060,8,1506,188.25,1361375684341,1361375684789,435378401,435378849,448
1361375690,435384060,8,1426,178.25,1361375684341,1361375684789,435378401,435378849,448
1361375690,435384060,8,1240,155,1361375684852,1361375684852,435378912,435378912,0
1361375690,435384060,8,1538,192.25,1361375688947,1361375689651,435383007,435383711,704
1361375690,435384060,11,7902,718.3636364,1361375688947,1361375689139,435383007,435383199,192
1361375693,1797072924,11,4570,415.4545455,1361375668901,1361375674789,1797048825,1797054713,5888
1361375693,1797073000,15,3650,243.3333333,1361375667032,1361375668056,1797047032,1797048056,1024
1361375693,1797073088,9,3398,377.5555556,1361375668160,1361375668480,1797048248,1797048568,320
1361375696,1797076836,11,5353,486.6363636,1361375689941,1361375690581,1797070777,1797071417,640
1361375696,1797076876,8,4205,525.625,1361375688235,1361375688747,1797069111,1797069623,512
1361375697,1797076988,8,2673,334.125,1361375690019,1361375690403,1797070007,1797070391,384
1361375697,1797077044,22,6471,294.1363636,1361375669227,1361375673195,1797049271,1797053239,3968
1361375697,1797077056,13,3181,244.6923077,1361375670431,1361375673119,1797050487,1797053175,2688
1361375697,1797077088,1,60,60,1361375671041,1361375671041,1797051129,1797051129,0
1361375697,1797077096,92,100915,1096.902174,1361375671928,1361375673848,1797052024,1797053944,1920
1361375697,1797077132,9,3265,362.7777778,1361375669779,1361375670035,1797049911,1797050167,256
1361375698,435392052,8,1442,180.25,1361375691069,1361375691261,435385121,435385313,192
1361375698,435392052,12,8434,702.8333333,1361375691069,1361375691261,435385121,435385313,192
1361375698,435392052,8,1506,188.25,1361375691069,1361375691197,435385121,435385249,128
1361375698,435392052,8,1576,197,1361375691261,1361375691325,435385313,435385377,64
1361375698,435392052,8,1576,197,1361375691261,1361375691325,435385313,435385377,64
1361375698,435392052,8,1730,216.25,1361375691325,1361375691453,435385377,435385505,128
1361375698,435392052,8,1576,197,1361375691260,1361375691324,435385312,435385376,64
1361375698,435392052,8,1298,162.25,1361375691324,1361375691388,435385376,435385440,64
1361375698,435392056,9,2284,253.7777778,1361375695739,1361375695867,435389795,435389923,128
1361375698,435392056,13,10603,815.6153846,1361375695866,1361375696250,435389922,435390306,384
1361375698,435392056,8,1554,194.25,1361375690170,1361375690234,435384226,435384290,64
1361375698,435392056,15,14403,960.2,1361375690234,1361375690618,435384290,435384674,384
1361375698,435392056,8,1298,162.25,1361375696632,1361375696888,435390688,435390944,256
1361375698,435392060,4,232,58,1361375681077,1361375692213,435375137,435386273,11136
1361375698,435392060,10,7098,709.8,1361375694261,1361375694389,435388321,435388449,128
1361375698,435392060,11,7902,718.3636364,1361375694452,1361375694580,435388512,435388640,128
1361375698,435392060,8,1554,194.25,1361375689652,1361375690164,435383712,435384224,512
1361375698,435392060,8,1666,208.25,1361375694708,1361375695732,435388768,435389792,1024
1361375698,435392064,8,1240,155,1361375690930,1361375690994,435384994,435385058,64
1361375698,435392064,9,2138,237.5555556,1361375690930,1361375691314,435384994,435385378,384
1361375698,435392064,8,1458,182.25,1361375691058,1361375691186,435385122,435385250,128
1361375698,435392064,8,1298,162.25,1361375691186,1361375691250,435385250,435385314,64
1361375698,435392064,8,1576,197,1361375691250,1361375691314,435385314,435385378,64
1361375698,435392076,8,1298,162.25,1361375692964,1361375693028,435387040,435387104,64
1361375698,435392076,8,1240,155,1361375696355,1361375696611,435390431,435390687,256
1361375698,435392080,8,1378,172.25,1361375694176,1361375694240,435388256,435388320,64
1361375698,435392080,9,1630,181.1111111,1361375694432,1361375695840,435388512,435389920,1408
1361375701,1797081020,14,7978,569.8571429,1361375672900,1361375675140,1797052920,1797055160,2240
1361375701,1797081056,9,5132,570.2222222,1361375674529,1361375674785,1797054585,1797054841,256
1361375701,1797081088,59,73720,1249.491525,1361375676737,1361375676993,1797056825,1797057081,256
1361375704,1797084876,39,49116,1259.384615,1361375684523,1361375699691,1797065399,1797080567,15168
1361375705,1797085124,17,4676,275.0588235,1361375677787,1361375690587,1797057911,1797070711,12800
1361375706,435400060,8,1139,142.375,1361375698291,1361375698611,435392351,435392671,320
1361375709,1797088976,35,38011,1086.028571,1361375680942,1361375681198,1797060918,1797061174,256
1361375714,435408060,1735,2466840,1421.809798,1361375698611,1361375707187,435392671,435401247,8576
1361375733,1797113104,1,52,52,1361375705648,1361375705648,1797085752,1797085752,0
1361375733,1797113152,39,2052,52.61538462,1361375707776,1361375710720,1797087928,1797090872,2944
1361375753,1797133260,5,2014,402.8,1361375728529,1361375728529,1797108789,1797108789,0
1361375757,1797137148,2,104,52,1361375730884,1361375730884,1797111032,1797111032,0
1361375757,1797137160,2,104,52,1361375730870,1361375730870,1797111030,1797111030,0
1361375765,1797145240,38,1988,52.31578947,1361375740648,1361375742696,1797120888,1797122936,2048
1361375797,1797177432,37,1924,52,1361375772517,1361375774117,1797152949,1797154549,1600
1361375829,1797209384,37,1924,52,1361375804244,1361375805844,1797184628,1797186228,1600
1361375861,1797241440,38,2013,52.97368421,1361375835868,1361375860636,1797216308,1797241076,24768
1361375893,1797273648,37,1924,52,1361375867662,1361375869582,1797248310,1797250230,1920
1361375897,1797277544,1,46,46,1361375870902,1361375870902,1797251446,1797251446,0
1361375909,1797289552,1,46,46,1361375884653,1361375884653,1797265205,1797265205,0
1361375913,1797293008,4,310,77.5,1361375910157,1361375910541,1797290165,1797290549,384
1361375913,1797293044,4,274,68.5,1361375908521,1361375908649,1797288565,1797288693,128
1361375921,1797301060,4,310,77.5,1361375913113,1361375913177,1797293173,1797293237,64
1361375921,1797301132,132,142163,1076.992424,1361375676880,1361375918032,1797057012,1797298164,241152
1361375921,1797301132,254,298702,1175.992126,1361375669070,1361375917006,1797049202,1797297138,247936
1361375921,1797301136,4,310,77.5,1361375913805,1361375913933,1797293941,1797294069,128
1361375921,1797301144,4,310,77.5,1361375914564,1361375914756,1797294708,1797294900,192
1361375925,1797305660,37,1924,52,1361375899583,1361375901695,1797280243,1797282355,2112
1361375929,1797309188,4,274,68.5,1361375920920,1361375921048,1797301108,1797301236,128
1361375958,1797337892,37,1924,52,1361375932478,1361375934142,1797312370,1797314034,1664
1361375969,1797349076,4,310,77.5,1361375968713,1361375968841,1797348789,1797348917,128
1361375989,1797369796,38,1988,52.31578947,1361375963254,1361375965366,1797344050,1797346162,2112
1361375989,1797369808,1,89,89,1361375964522,1361375964522,1797345330,1797345330,0
1361375989,1797369868,1,76,76,1361375963057,1361375963057,1797343925,1797343925,0
1361376022,1797401900,39,2052,52.61538462,1361375996279,1361375998519,1797376179,1797378419,2240
1361376053,1797433852,38,1988,52.31578947,1361376027582,1361376029758,1797408434,1797410610,2176
1361376053,1797433856,3,896,298.6666667,1361376027771,1361376027835,1797408627,1797408691,64
1361376058,1797437920,5,3111,622.2,1361376032866,1361376032930,1797412786,1797412850,64
1361376086,1797465868,39,2052,52.61538462,1361376060756,1361376062996,1797440624,1797442864,2240
1361376118,1797498064,37,1924,52,1361376092817,1361376094737,1797472881,1797474801,1920
1361376150,1797529960,37,1924,52,1361376124857,1361376126521,1797504817,1797506481,1664
1361376169,1797549140,195,244572,1254.215385,1361375927620,1361376168644,1797307760,1797548784,241024
1361376182,1797562068,42,2269,54.02380952,1361376156429,1361376163725,1797536497,1797543793,7296
1361376214,1797594100,40,2116,52.9,1361376189549,1361376192557,1797569649,1797572657,3008
1361376250,1797630068,40,2116,52.9,1361376222603,1361376225163,1797602671,1797605231,2560
1361376281,1797661268,2,98,49,1361376268417,1361376278465,1797648685,1797658733,10048
1361376281,1797661280,2,98,49,1361376272568,1361376278456,1797652848,1797658736,5888
1361376282,1797662208,38,1988,52.31578947,1361376255038,1361376257278,1797635246,1797637486,2240
1361376294,1797674256,1,89,89,1361376267600,1361376267600,1797647856,1797647856,0
1361376314,1797694248,37,1924,52,1361376287255,1361376289111,1797667503,1797669359,1856
1361376329,1797709152,9,3865,429.4444444,1361376326520,1361376326904,1797706672,1797707056,384
1361376329,1797709180,9,3762,418,1361376324377,1361376324633,1797704557,1797704813,256
1361376329,1797709232,9,3651,405.6666667,1361376327336,1361376327976,1797707568,1797708208,640
1361376329,1797709236,10,5086,508.6,1361376325409,1361376325665,1797705645,1797705901,256
1361376346,1797726216,38,1988,52.31578947,1361376319093,1361376321141,1797699309,1797701357,2048
1361376374,1797754316,1,46,46,1361376346130,1361376346130,1797726446,1797726446,0
1361376378,1797758364,37,1924,52,1361376351010,1361376352546,1797731374,1797732910,1536
1361376410,1797790388,37,1924,52,1361376382537,1361376384137,1797762925,1797764525,1600
1361376442,1797822508,37,1924,52,1361376414033,1361376415697,1797794541,1797796205,1664
1361376454,1797834516,17,7017,412.7647059,1361376427591,1361376427847,1797808107,1797808363,256
1361376470,1797850504,39,2077,53.25641026,1361376445715,1361376465299,1797826219,1797845803,19584
1361376506,1797886648,37,1924,52,1361376478532,1361376480452,1797859180,1797861100,1920
1361376538,1797918608,37,1924,52,1361376510444,1361376512300,1797891052,1797892908,1856
1361376561,1797941784,10,3832,383.2,1361376556473,1361376556665,1797937257,1797937449,192
1361376561,1797941788,11,3931,357.3636364,1361376556471,1361376556919,1797937259,1797937707,448
1361376570,1797950624,41,2180,53.17073171,1361376542299,1361376545499,1797922923,1797926123,3200
1361376582,1797962680,22,13573,616.9545455,1361376556771,1361376557667,1797937451,1797938347,896
1361376582,1797962684,21,20643,983,1361376557020,1361376557276,1797937704,1797937960,256
1361376594,1797974664,1,89,89,1361376569715,1361376569715,1797950379,1797950379,0
1361376594,1797974696,2,141,70.5,1361376566994,1361376566994,1797947690,1797947690,0
1361376603,1797983056,42,2244,53.42857143,1361376576016,1361376579792,1797956072,1797959848,3776
1361376617,1797997836,4,220,55,1361376616453,1361376616581,1797997289,1797997417,128
1361376618,1797997920,2,104,52,1361376617369,1361376617625,1797997289,1797997545,256
1361376635,1798015004,46,2500,54.34782609,1361376609799,1361376616135,1797989803,1797996139,6336
1361376671,1798051124,38,1988,52.31578947,1361376646031,1361376648079,1798026155,1798028203,2048
1361376674,1798053868,4,310,77.5,1361376668492,1361376668684,1798048360,1798048552,192
1361376703,1798083104,37,1924,52,1361376678112,1361376679840,1798058216,1798059944,1728
1361376714,1798093956,8,2673,334.125,1361376712243,1361376712563,1798092199,1798092519,320
1361376714,1798094028,43,2703,62.86046512,1361376708653,1361376711789,1798088681,1798091817,3136
1361376735,1798115184,1,553,553,1361376709264,1361376709264,1798089448,1798089448,0
1361376739,1798119056,18,4765,264.7222222,1361376711759,1361376728911,1798091815,1798108967,17152
1361376767,1798147464,37,1924,52,1361376741687,1361376743671,1798122151,1798124135,1984
1361376799,1798179628,38,1988,52.31578947,1361376773524,1361376775572,1798154152,1798156200,2048
1361376831,1798211580,40,2577,64.425,1361376805635,1361376829571,1798186215,1798210151,23936
1361376855,1798235604,1,553,553,1361376828844,1361376828844,1798209448,1798209448,0
1361376863,1798243688,43,2308,53.6744186,1361376837589,1361376841045,1798218277,1798221733,3456
1361376899,1798279708,37,1924,52,1361376870977,1361376872897,1798251685,1798253605,1920
1361376899,1798279760,1,89,89,1361376872589,1361376872589,1798253349,1798253349,0
1361376927,1798307848,40,2116,52.9,1361376902771,1361376905395,1798283619,1798286243,2624
1361376964,1798344072,39,2052,52.61538462,1361376936125,1361376938557,1798316197,1798318629,2432
1361376996,1798376028,38,1988,52.31578947,1361376968617,1361376970921,1798348645,1798350949,2304
1361377028,1798408088,37,1924,52,1361377000874,1361377003370,1798380962,1798383458,2496
1361377056,1798436140,39,2077,53.25641026,1361377031159,1361377036023,1798411299,1798416163,4864
1361377060,1798440204,1,52,52,1361377034934,1361377034934,1798415138,1798415138,0
1361377092,1798472456,37,1924,52,1361377065722,1361377067770,1798446178,1798448226,2048
1361377124,1798504608,38,1988,52.31578947,1361377098592,1361377101216,1798479200,1798481824,2624
1361377156,1798536672,37,1924,52,1361377131171,1361377132771,1798511843,1798513443,1600
1361377188,1798568568,41,2180,53.17073171,1361377162890,1361377166090,1798543458,1798546658,3200
1361377200,1798580648,1,89,89,1361377175032,1361377175032,1798555680,1798555680,0
1361377225,1798604924,37,1924,52,1361377196684,1361377198348,1798576608,1798578272,1664
1361377253,1798633008,37,1924,52,1361377228281,1361377230329,1798608289,1798610337,2048
1361377285,1798664960,41,2180,53.17073171,1361377260390,1361377263526,1798640350,1798643486,3136
1361377321,1798701032,43,2308,53.6744186,1361377293470,1361377297118,1798673502,1798677150,3648
1361377353,1798732992,38,2013,52.97368421,1361377327176,1361377333896,1798707168,1798713888,6720
1361377385,1798765476,38,1988,52.31578947,1361377358627,1361377362147,1798739103,1798742623,3520
1361377417,1798797576,38,1988,52.31578947,1361377392060,1361377394172,1798772636,1798774748,2112
1361377437,437131160,1,46,46,1361377410781,1361377410781,437104941,437104941,0
1361377449,1798829496,38,1988,52.31578947,1361377424269,1361377426253,1798804765,1798806749,1984
1361377458,1798838604,10,3832,383.2,1361377455584,1361377455776,1798836188,1798836380,192
1361377458,1798838684,10,3832,383.2,1361377455505,1361377455697,1798836189,1798836381,192
1361377481,1798861568,19,12133,638.5789474,1361377455813,1361377456069,1798836381,1798836637,256
1361377481,1798861596,26,21759,836.8846154,1361377455786,1361377456106,1798836382,1798836702,320
1361377481,1798861672,37,1924,52,1361377455773,1361377457501,1798836445,1798838173,1728
1361377493,1798873668,1,89,89,1361377466975,1361377466975,1798847643,1798847643,0
1361377505,1798885584,1,89,89,1361377477109,1361377477109,1798857693,1798857693,0
1361377513,1798893600,37,1924,52,1361377487589,1361377489317,1798868189,1798869917,1728
1361377541,1798921780,2,104,52,1361377515377,1361377515377,1798896157,1798896157,0
1361377542,1798921892,2,104,52,1361377516264,1361377516264,1798896156,1798896156,0
1361377545,1798925812,40,2116,52.9,1361377519118,1361377521678,1798899930,1798902490,2560
1361377577,1798957856,37,1924,52,1361377551653,1361377553509,1798932509,1798934365,1856
1361377610,1798989872,37,1924,52,1361377584505,1361377586553,1798964377,1798966425,2048
1361377642,1799022032,39,2077,53.25641026,1361377616409,1361377635801,1798996441,1799015833,19392
1361377674,1799053924,9,4215,468.3333333,1361377647750,1361377647878,1799027674,1799027802,128
1361377674,1799053924,23,18720,813.9130435,1361377647876,1361377648196,1799027800,1799028120,320
1361377674,1799054044,37,1924,52,1361377649037,1361377650701,1799029081,1799030745,1664
1361377706,1799086336,38,1988,52.31578947,1361377680554,1361377684906,1799060890,1799065242,4352
1361377742,1799122272,39,2052,52.61538462,1361377714986,1361377717482,1799095258,1799097754,2496
1361377774,1799154276,39,2052,52.61538462,1361377747941,1361377751717,1799128217,1799131993,3776
1361377806,1799186324,38,1988,52.31578947,1361377781682,1361377783858,1799162006,1799164182,2176
1361377806,1799186372,1,89,89,1361377780036,1361377780036,1799160408,1799160408,0
1361377842,1799222264,37,1924,52,1361377813937,1361377815729,1799194201,1799195993,1792
1361377870,1799250520,39,2052,52.61538462,1361377845488,1361377847984,1799226008,1799228504,2496
1361377891,1799271008,4,310,77.5,1361377887789,1361377887917,1799267797,1799267925,128
1361377891,1799271108,4,310,77.5,1361377888008,1361377888008,1799268116,1799268116,0
1361377906,1799286364,39,2052,52.61538462,1361377878153,1361377881353,1799258517,1799261717,3200
1361377938,1799318540,38,1988,52.31578947,1361377911192,1361377913240,1799291732,1799293780,2048
1361377966,1799346516,41,2205,53.7804878,1361377938159,1361377946095,1799318675,1799326611,7936
1361378002,1799382612,40,2104,52.6,1361377976015,1361377997903,1799356627,1799378515,21888
1361378034,1799414660,40,2116,52.9,1361378008607,1361378011487,1799389267,1799392147,2880
1361378035,1799415256,21,25226,1201.238095,1361378031923,1361378032179,1799412179,1799412435,256
1361378035,1799415348,9,2929,325.4444444,1361378030041,1361378032345,1799410389,1799412693,2304
1361378043,1799423268,9,3549,394.3333333,1361378036967,1361378038951,1799417235,1799419219,1984
1361378043,1799423276,13,4896,376.6153846,1361378037278,1361378038942,1799417554,1799419218,1664
1361378051,1799431228,8,2576,322,1361378050190,1361378050510,1799430418,1799430738,320
1361378051,1799431280,8,2684,335.5,1361378049754,1361378050138,1799430034,1799430418,384
1361378066,1799446736,39,2052,52.61538462,1361378041429,1361378043925,1799422165,1799424661,2496
1361378074,1799454736,17,6033,354.8823529,1361378049043,1361378050323,1799429779,1799431059,1280
1361378102,1799482688,44,2372,53.90909091,1361378073922,1361378078210,1799454610,1799458898,4288
1361378110,1799490716,1,89,89,1361378082535,1361378082535,1799463251,1799463251,0
1361378134,1799514712,41,2180,53.17073171,1361378108204,1361378111916,1799488916,1799492628,3712
1361378138,1799518712,1,46,46,1361378109995,1361378109995,1799490707,1799490707,0
1361378166,1799546768,42,2244,53.42857143,1361378141809,1361378145905,1799522577,1799526673,4096
1361378203,1799582924,43,2308,53.6744186,1361378176766,1361378180926,1799556690,1799560850,4160
1361378239,1799619028,38,1988,52.31578947,1361378210835,1361378212947,1799590863,1799592975,2112
1361378267,1799647004,38,2013,52.97368421,1361378241582,1361378245166,1799621586,1799625170,3584
1361378303,1799682976,38,1988,52.31578947,1361378275143,1361378277447,1799655119,1799657423,2304
1361378335,1799714996,42,2244,53.42857143,1361378307444,1361378311028,1799687440,1799691024,3584
1361378355,1799735852,10,3832,383.2,1361378354269,1361378354525,1799735121,1799735377,256
1361378355,1799735852,10,3832,383.2,1361378354268,1361378354588,1799735120,1799735440,320
1361378363,1799743000,1,52,52,1361378335278,1361378335278,1799715278,1799715278,0
1361378367,1799747148,38,1988,52.31578947,1361378340956,1361378343068,1799721104,1799723216,2112
1361378383,1799763044,19,12133,638.5789474,1361378355394,1361378355714,1799735438,1799735758,320
1361378383,1799763140,24,21655,902.2916667,1361378355236,1361378355620,1799735376,1799735760,384
1361378395,1799775096,1,89,89,1361378367501,1361378367501,1799747597,1799747597,0
1361378399,1799779088,38,1988,52.31578947,1361378373272,1361378375640,1799753360,1799755728,2368
1361378411,1799791172,1,89,89,1361378386113,1361378386113,1799766285,1799766285,0
1361378419,1799799736,2,104,52,1361378414416,1361378414608,1799795152,1799795344,192
1361378431,1799811104,38,1988,52.31578947,1361378405638,1361378408390,1799785742,1799788494,2752
1361378443,1799823096,3,156,52,1361378415052,1361378415436,1799795148,1799795532,384
1361378463,1799843288,38,1988,52.31578947,1361378438413,1361378442445,1799818701,1799822733,4032
1361378499,1799879172,40,2116,52.9,1361378472511,1361378475263,1799852683,1799855435,2752
1361378531,1799911244,37,1924,52,1361378505207,1361378506935,1799885451,1799887179,1728
1361378563,1799943244,39,2077,53.25641026,1361378536951,1361378543415,1799917195,1799923659,6464
1361378575,1799955388,1,131,131,1361378548585,1361378548585,1799928973,1799928973,0
1361378595,1799975316,38,1988,52.31578947,1361378569008,1361378570992,1799949324,1799951308,1984
1361378627,1800007440,38,1988,52.31578947,1361378600882,1361378602802,1799981322,1799983242,1920
1361378659,1800039368,37,1924,52,1361378632889,1361378635833,1800013257,1800016201,2944
1361378691,1800071524,38,1988,52.31578947,1361378665567,1361378668255,1800046091,1800048779,2688
1361378715,1800095664,1,89,89,1361378687379,1361378687379,1800068043,1800068043,0
1361378723,1800103756,37,1924,52,1361378698037,1361378699701,1800078793,1800080457,1664
1361378741,1800121740,1,48,48,1361378714695,1361378714695,1800095435,1800095435,0
1361378755,1800135696,38,1988,52.31578947,1361378729777,1361378731953,1800110473,1800112649,2176
1361378787,1800167740,37,1924,52,1361378761989,1361378764165,1800142729,1800144905,2176
1361378819,1800199780,38,1988,52.31578947,1361378794205,1361378797021,1800174985,1800177801,2816
1361378855,1800235772,38,2013,52.97368421,1361378826979,1361378845155,1800207751,1800225927,18176
1361378881,1800261296,1,46,46,1361378853758,1361378853758,1800234054,1800234054,0
1361378888,1800267900,38,1988,52.31578947,1361378860170,1361378864330,1800240070,1800244230,4160
1361378920,1800299872,38,1988,52.31578947,1361378894374,1361378896422,1800274246,1800276294,2048
1361378952,1800331900,38,1988,52.31578947,1361378926410,1361378928778,1800306310,1800308678,2368
1361378984,1800363952,39,2052,52.61538462,1361378958677,1361378961173,1800338629,1800341125,2496
1361379016,1800395944,39,2052,52.61538462,1361378991134,1361378993502,1800371078,1800373446,2368
1361379016,1800396016,1,89,89,1361378990807,1361378990807,1800370823,1800370823,0
1361379037,1800417156,2,178,89,1361379029323,1361379029323,1800409479,1800409479,0
1361379048,1800428056,37,1924,52,1361379023406,1361379025134,1800403462,1800405190,1728
1361379176,1800556228,7,623,89,1361379148031,1361379161855,1800528259,1800542083,13824
1361379320,1800700700,6,534,89,1361379292646,1361379303014,1800673346,1800683714,10368
1361379453,1800832924,2,96,48,1361379426985,1361379430057,1800806909,1800809981,3072
1361380153,1801533504,1,48,48,1361380126812,1361380126812,1801507316,1801507316,0
1361380323,1801703680,1,131,131,1361380298281,1361380298281,1801678961,1801678961,0
1361383248,1804628100,1,78,78,1361383220930,1361383220930,1804601030,1804601030,0
1361385857,1807236976,1,48,48,1361385827540,1361385827540,1807207516,1807207516,0
1361387633,447327292,1,46,46,1361387606237,1361387606237,447300529,447300529,0
1361389723,1811103772,1,46,46,1361389695294,1361389695294,1811076066,1811076066,0
1361390498,1811878452,1,46,46,1361390471601,1361390471601,1811852053,1811852053,0
1361390499,1811879652,1,46,46,1361390471338,1361390471338,1811851990,1811851990,0
1361392301,1813681692,2,122,61,1361392275561,1361392277673,1813656253,1813658365,2112
1361392658,1814038480,1,48,48,1361392632631,1361392632631,1814013111,1814013111,0
1361392967,1814347012,2,122,61,1361392939142,1361392941382,1814319154,1814321394,2240
1361393259,1814639716,1,446,446,1361393230978,1361393230978,1814611694,1814611694,0
1361395408,1816788272,3,180,60,1361395381405,1361395390429,1816761677,1816770701,9024
1361396238,1817618340,3,144,48,1361396212042,1361396221002,1817592382,1817601342,8960
1361401238,1822617860,1,46,46,1361401210208,1361401210208,1822590068,1822590068,0
1361805691,2227069860,1,46,46,1361805664901,1361805664901,2227043761,2227043761,0
1361805980,2227358992,1,60,60,1361805952571,1361805952571,2227331563,2227331563,0
1361806974,2228352952,1,46,46,1361806947606,1361806947606,2228326558,2228326558,0
1361807302,2228680968,1,48,48,1361807273663,1361807273663,2228652631,2228652631,0
1361807802,2229181080,11,4580,416.3636364,1361807794698,1361807795466,2229173778,2229174546,768
1361807802,2229181084,41,37197,907.2439024,1361807795206,1361807797254,2229174290,2229176338,2048
1361807802,2229181108,61,52094,854,1361807795435,1361807798955,2229174543,2229178063,3520
1361807802,2229181128,10,3832,383.2,1361807794650,1361807795162,2229173778,2229174290,512
1361807809,867502200,11,5304,482.1818182,1361807801490,1361807802450,867494690,867495650,960
1361807809,867502200,11,7726,702.3636364,1361807804886,1361807805526,867498086,867498726,640
1361807809,867502204,9,1581,175.6666667,1361807805457,1361807806993,867498661,867500197,1536
1361807809,867502204,9,2358,262,1361807805457,1361807805521,867498661,867498725,64
1361807809,867502204,9,2326,258.4444444,1361807805585,1361807805649,867498789,867498853,64
1361807809,867502204,35,42594,1216.971429,1361807805585,1361807805777,867498789,867498981,192
1361807809,867502204,9,4822,535.7777778,1361807805585,1361807805713,867498789,867498917,128
1361807809,867502204,13,9642,741.6923077,1361807806032,1361807806608,867499236,867499812,576
1361807809,867502204,31,37099,1196.741935,1361807806096,1361807806800,867499300,867500004,704
1361807809,867502204,8,3144,393,1361807806095,1361807806223,867499299,867499427,128
1361807809,867502204,11,6737,612.4545455,1361807806095,1361807806735,867499299,867499939,640
1361807809,867502204,18,19037,1057.611111,1361807806095,1361807806799,867499299,867500003,704
1361807809,867502204,10,7114,711.4,1361807802511,1361807802831,867495715,867496035,320
1361807809,867502204,9,2070,230,1361807802895,1361807802959,867496099,867496163,64
1361807809,867502204,45,44163,981.4,1361807802895,1361807803023,867496099,867496227,128
1361807809,867502204,9,3782,420.2222222,1361807802895,1361807803023,867496099,867496227,128
1361807809,867502204,35,41042,1172.628571,1361807802894,1361807803342,867496098,867496546,448
1361807809,867502204,9,2391,265.6666667,1361807802958,1361807804878,867496162,867498082,1920
1361807809,867502204,14,12703,907.3571429,1361807803022,1361807803214,867496226,867496418,192
1361807809,867502204,11,8238,748.9090909,1361807803022,1361807803214,867496226,867496418,192
1361807809,867502208,24,26548,1106.166667,1361807807181,1361807807309,867500389,867500517,128
1361807809,867502208,24,26708,1112.833333,1361807807181,1361807807373,867500389,867500581,192
1361807809,867502208,11,5723,520.2727273,1361807807500,1361807807500,867500708,867500708,0
1361807809,867502208,9,2428,269.7777778,1361807807564,1361807807628,867500772,867500836,64
1361807809,867502212,6,916,152.6666667,1361807801289,1361807801737,867494501,867494949,448
1361807809,867502212,5,859,171.8,1361807801289,1361807802121,867494501,867495333,832
1361807809,867502212,12,9847,820.5833333,1361807804872,1361807805384,867498084,867498596,512
1361807809,867502212,8,1378,172.25,1361807801671,1361807802503,867494883,867495715,832
1361807809,867502212,7,1262,180.2857143,1361807805447,1361807805511,867498659,867498723,64
1361807809,867502212,11,6430,584.5454545,1361807805447,1361807805511,867498659,867498723,64
1361807809,867502212,17,16171,951.2352941,1361807805447,1361807805575,867498659,867498787,128
1361807809,867502212,9,2374,263.7777778,1361807805514,1361807805578,867498726,867498790,64
1361807809,867502212,8,1634,204.25,1361807805578,1361807805706,867498790,867498918,128
1361807809,867502212,8,1666,208.25,1361807805450,1361807805578,867498662,867498790,128
1361807809,867502212,9,2630,292.2222222,1361807805513,1361807805577,867498725,867498789,64
1361807809,867502224,8,1906,238.25,1361807805565,1361807805629,867498789,867498853,64
1361807809,867502224,21,22544,1073.52381,1361807805629,1361807805757,867498853,867498981,128
1361807809,867502224,11,5208,473.4545455,1361807802109,1361807802301,867495333,867495525,192
1361807809,867502224,15,13063,870.8666667,1361807802173,1361807802493,867495397,867495717,320
1361807809,867502224,9,4134,459.3333333,1361807806013,1361807806013,867499237,867499237,0
1361807809,867502224,16,15357,959.8125,1361807806077,1361807806589,867499301,867499813,512
1361807809,867502224,14,11037,788.3571429,1361807806076,1361807806780,867499300,867500004,704
1361807809,867502224,11,6129,557.1818182,1361807806076,1361807806652,867499300,867499876,576
1361807809,867502224,10,5921,592.1,1361807806012,1361807806972,867499236,867500196,960
1361807809,867502224,8,1448,181,1361807806076,1361807806588,867499300,867499812,512
1361807809,867502224,9,1256,139.5555556,1361807806076,1361807806652,867499300,867499876,576
1361807809,867502224,9,5132,570.2222222,1361807806587,1361807806779,867499811,867500003,192
1361807809,867502224,9,2566,285.1111111,1361807802875,1361807802939,867496099,867496163,64
1361807809,867502224,9,5270,585.5555556,1361807802875,1361807803003,867496099,867496227,128
1361807809,867502224,9,5670,630,1361807803003,1361807803195,867496227,867496419,192
1361807809,867502224,10,4242,424.2,1361807803003,1361807804219,867496227,867497443,1216
1361807809,867502224,12,6707,558.9166667,1361807802939,1361807804859,867496163,867498083,1920
1361807809,867502224,10,4650,465,1361807803194,1361807803386,867496418,867496610,192
1361807809,867502224,21,22262,1060.095238,1361807807166,1361807807358,867500390,867500582,192
1361807809,867502228,9,2406,267.3333333,1361807807480,1361807807544,867500708,867500772,64
1361807810,2229189112,12,4045,337.0833333,1361807791145,1361807802025,2229170257,2229181137,10880
1361807810,2229189116,7,2627,375.2857143,1361807803749,1361807804069,2229182865,2229183185,320
1361807816,2229194720,15,3650,243.3333333,1361807791087,1361807792111,2229169807,2229170831,1024
1361807816,2229194724,6,3163,527.1666667,1361807791534,1361807791790,2229170258,2229170514,256
1361807816,2229194724,6,3163,527.1666667,1361807791532,1361807791788,2229170256,2229170512,256
1361807816,2229194724,6,2465,410.8333333,1361807791532,1361807792364,2229170256,2229171088,832
1361807816,2229194724,6,2560,426.6666667,1361807791532,1361807791980,2229170256,2229170704,448
1361807816,2229194800,6,2465,410.8333333,1361807791458,1361807792162,2229170258,2229170962,704
1361807816,2229194800,6,2465,410.8333333,1361807791458,1361807792290,2229170258,2229171090,832
1361807816,2229194800,6,2465,410.8333333,1361807791457,1361807792033,2229170257,2229170833,576
1361807816,2229194800,6,2465,410.8333333,1361807791457,1361807792225,2229170257,2229171025,768
1361807816,2229194800,6,3163,527.1666667,1361807791457,1361807791777,2229170257,2229170577,320
1361807816,2229194800,6,2560,426.6666667,1361807791457,1361807791969,2229170257,2229170769,512
1361807817,867510212,8,1656,207,1361807810248,1361807810376,867503460,867503588,128
1361807817,867510212,8,1656,207,1361807810248,1361807810440,867503460,867503652,192
1361807817,867510212,9,2566,285.1111111,1361807810568,1361807811080,867503780,867504292,512
1361807817,867510212,8,1506,188.25,1361807810568,1361807811208,867503780,867504420,640
1361807817,867510212,8,1442,180.25,1361807810568,1361807811144,867503780,867504356,576
1361807817,867510212,10,2378,237.8,1361807810951,1361807811335,867504163,867504547,384
1361807817,867510212,16,13915,869.6875,1361807802119,1361807809671,867495331,867502883,7552
1361807817,867510212,14,11523,823.0714286,1361807802183,1361807809287,867495395,867502499,7104
1361807817,867510212,11,5863,533,1361807802183,1361807809223,867495395,867502435,7040
1361807817,867510212,9,1558,173.1111111,1361807802310,1361807809158,867495522,867502370,6848
1361807817,867510232,9,2422,269.1111111,1361807810546,1361807810930,867503778,867504162,384
1361807817,867510236,8,1714,214.25,1361807810737,1361807810993,867503973,867504229,256
1361807817,867510236,8,1490,186.25,1361807810545,1361807810737,867503781,867503973,192
1361807817,867510236,8,1426,178.25,1361807810545,1361807811185,867503781,867504421,640
1361807817,867510236,9,1526,169.5555556,1361807810993,1361807811313,867504229,867504549,320
1361807817,867510236,9,2284,253.7777778,1361807811056,1361807811248,867504292,867504484,192
1361807817,867510236,15,12327,821.8,1361807802160,1361807809712,867495396,867502948,7552
1361807817,867510236,8,1240,155,1361807811374,1361807811438,867504610,867504674,64
1361807820,2229198668,5,380,76,1361807791972,1361807795940,2229170640,2229174608,3968
1361807820,2229198724,42,17814,424.1428571,1361807794283,1361807800747,2229173007,2229179471,6464
1361807820,2229198764,9,3398,377.5555556,1361807793094,1361807793286,2229171858,2229172050,192
1361807824,2229202780,14,7978,569.8571429,1361807797554,1361807800306,2229176334,2229179086,2752
1361807824,2229202812,6,1322,220.3333333,1361807799254,1361807799830,2229178066,2229178642,576
1361807828,2229206684,59,73714,1249.389831,1361807800532,1361807800724,2229179216,2229179408,192
1361807828,2229206688,19,4780,251.5789474,1361807803088,1361807804880,2229181776,2229183568,1792
1361807832,2229210720,7,3103,443.2857143,1361807806386,1361807806962,2229185106,2229185682,576
1361807834,2229213096,30,35473,1182.433333,1361807810934,1361807832054,2229190030,2229211150,21120
1361807841,867534208,8,1730,216.25,1361807836109,1361807836301,867529317,867529509,192
1361807841,867534212,8,1554,194.25,1361807834183,1361807834759,867527395,867527971,576
1361807841,867534212,8,1538,192.25,1361807834055,1361807834119,867527267,867527331,64
1361807841,867534216,8,1554,194.25,1361807834757,1361807834885,867527973,867528101,128
1361807841,867534216,9,2284,253.7777778,1361807834757,1361807834821,867527973,867528037,64
1361807841,867534216,15,14403,960.2,1361807834884,1361807835268,867528100,867528484,384
1361807841,867534216,12,8674,722.8333333,1361807835651,1361807835971,867528867,867529187,320
1361807841,867534216,8,1506,188.25,1361807835650,1361807835970,867528866,867529186,320
1361807841,867534216,8,1458,182.25,1361807835650,1361807835970,867528866,867529186,320
1361807841,867534216,8,1298,162.25,1361807835714,1361807835778,867528930,867528994,64
1361807841,867534216,8,1576,197,1361807835714,1361807835778,867528930,867528994,64
1361807841,867534216,9,1628,180.8888889,1361807835778,1361807835970,867528994,867529186,192
1361807841,867534216,10,1402,140.2,1361807838914,1361807839490,867532130,867532706,576
1361807841,867534220,9,1362,151.3333333,1361807836095,1361807837503,867529315,867530723,1408
1361807841,867534236,10,7034,703.4,1361807833841,1361807833969,867527077,867527205,128
1361807841,867534236,11,7902,718.3636364,1361807834032,1361807834224,867527268,867527460,192
1361807841,867534240,8,1240,155,1361807835564,1361807835628,867528804,867528868,64
1361807841,867534240,8,1442,180.25,1361807835628,1361807835884,867528868,867529124,256
1361807841,867534240,8,1346,168.25,1361807835564,1361807835628,867528804,867528868,64
1361807841,867534240,8,1576,197,1361807835755,1361807835883,867528995,867529123,128
1361807841,867534240,8,1576,197,1361807835883,1361807836075,867529123,867529315,192
1361807842,2229221172,3,156,52,1361807840810,1361807841066,2229219982,2229220238,256
1361807849,867542208,8,1240,155,1361807848267,1361807848331,867541475,867541539,64
1361807849,867542208,9,1575,175,1361807844810,1361807845450,867538018,867538658,640
1361807849,867542212,8,1298,162.25,1361807848330,1361807848394,867541542,867541606,64
1361807849,867542212,8,1570,196.25,1361807845767,1361807847431,867538979,867540643,1664
1361807849,867542220,9,2284,253.7777778,1361807847425,1361807847489,867540645,867540709,64
1361807849,867542236,10,7098,709.8,1361807845426,1361807845618,867538662,867538854,192
1361807849,867542236,8,1666,208.25,1361807845681,1361807845745,867538917,867538981,64
1361807849,867542236,11,7902,718.3636364,1361807845680,1361807845872,867538916,867539108,192
1361807849,867542240,13,10603,815.6153846,1361807847403,1361807848043,867540643,867541283,640
1361807856,2229234704,1,46,46,1361807828990,1361807828990,2229207694,2229207694,0
1361807857,867550220,1372,1941633,1415.184402,1361807850178,1361807852930,867543398,867546150,2752
1361807857,867550240,8,1139,142.375,1361807850092,1361807850156,867543332,867543396,64
1361807860,2229238772,39,2052,52.61538462,1361807831995,1361807834555,2229210767,2229213327,2560
1361807864,2229242836,1,89,89,1361807838202,1361807838202,2229217038,2229217038,0
1361807868,2229246944,2,104,52,1361807841040,1361807841040,2229219984,2229219984,0
1361807892,2229270740,40,2141,53.525,1361807864605,1361807868317,2229243345,2229247057,3712
1361807924,2229302880,38,1988,52.31578947,1361807896591,1361807898447,2229275471,2229277327,1856
1361807930,2229309276,9,3549,394.3333333,1361807925826,1361807927810,2229305102,2229307086,1984
1361807930,2229309328,11,3207,291.5454545,1361807926414,1361807927758,2229305742,2229307086,1344
1361807956,2229334804,39,2052,52.61538462,1361807928537,1361807931353,2229307341,2229310157,2816
1361807986,2229365316,43,2380,55.34883721,1361807960795,1361807982299,2229340111,2229361615,21504
1361807986,2229365352,8,2673,334.125,1361807983670,1361807983990,2229363022,2229363342,320
1361808008,2229387368,16,4624,289,1361807982949,1361807984165,2229362317,2229363533,1216
1361808034,2229413280,4,274,68.5,1361808032764,1361808033020,2229412044,2229412300,256
1361808034,2229413328,4,310,77.5,1361808031375,1361808031887,2229410703,2229411215,512
1361808034,2229413328,4,310,77.5,1361808031182,1361808031886,2229410510,2229411214,704
1361808034,2229413328,4,274,68.5,1361808031694,1361808031886,2229411022,2229411214,192
1361808034,2229413328,3,228,76,1361808031758,1361808031758,2229411086,2229411086,0
1361808034,2229413328,3,228,76,1361808031758,1361808031758,2229411086,2229411086,0
1361808034,2229413328,5,423,84.6,1361808031437,1361808031885,2229410765,2229411213,448
1361808034,2229413396,4,310,77.5,1361808031175,1361808031815,2229410571,2229411211,640
1361808034,2229413400,4,274,68.5,1361808031431,1361808031815,2229410831,2229411215,384
1361808034,2229413400,4,310,77.5,1361808031110,1361808031814,2229410510,2229411214,704
1361808034,2229413400,4,274,68.5,1361808031622,1361808031814,2229411022,2229411214,192
1361808040,2229419444,39,2077,53.25641026,1361808011863,1361808019415,2229391307,2229398859,7552
1361808042,2229421324,229,148097,646.7117904,1361807790929,1361808040785,2229170253,2229420109,249856
1361808042,2229421332,4,310,77.5,1361808040073,1361808040201,2229419405,2229419533,128
1361808050,2229429296,3,228,76,1361808046382,1361808046382,2229425678,2229425678,0
1361808069,2229447692,1,46,46,1361808042441,1361808042441,2229421133,2229421133,0
1361808069,2229447692,1,46,46,1361808042441,1361808042441,2229421133,2229421133,0
1361808069,2229447780,39,2052,52.61538462,1361808044466,1361808047986,2229423246,2229426766,3520
1361808077,2229455644,70,80590,1151.285714,1361808049975,1361808050487,2229428619,2229429131,512
1361808077,2229455684,1,46,46,1361808052561,1361808052561,2229431245,2229431245,0
1361808077,2229455720,11,6952,632,1361808049518,1361808049774,2229428238,2229428494,256
1361808098,2229477364,256,166963,652.1992188,1361807793641,1361808096937,2229173005,2229476301,303296
1361808105,2229483732,37,1924,52,1361808078047,1361808079455,2229456779,2229458187,1408
1361808125,2229503840,16,6253,390.8125,1361808098676,1361808100724,2229477516,2229479564,2048
1361808129,2229507820,11,3576,325.0909091,1361808103751,1361808111751,2229482571,2229490571,8000
1361808137,2229515784,37,1924,52,1361808109421,1361808110893,2229488205,2229489677,1472
1361808165,2229543856,1,89,89,1361808139813,1361808139813,2229518669,2229518669,0
1361808169,2229547776,37,1924,52,1361808140913,1361808142321,2229519689,2229521097,1408
1361808181,2229559864,3,897,299,1361808153181,1361808153245,2229532045,2229532109,64
1361808185,2229563904,4,1826,456.5,1361808157233,1361808157233,2229536137,2229536137,0
1361808197,2229575932,40,2116,52.9,1361808172184,1361808174424,2229551116,2229553356,2240
1361808229,2229608000,37,1924,52,1361808204051,1361808205459,2229583051,2229584459,1408
1361808261,2229640016,38,1988,52.31578947,1361808235457,1361808237121,2229614473,2229616137,1664
1361808275,2229653596,9,3762,418,1361808273700,1361808273956,2229652296,2229652552,256
1361808283,2229661632,9,3865,429.4444444,1361808275714,1361808275970,2229654346,2229654602,256
1361808283,2229661708,9,3847,427.4444444,1361808274612,1361808274868,2229653320,2229653576,256
1361808283,2229661736,12,3866,322.1666667,1361808276570,1361808277658,2229655306,2229656394,1088
1361808291,2229669552,5,423,84.6,1361808290449,1361808290577,2229669001,2229669129,128
1361808291,2229669592,4,310,77.5,1361808289832,1361808289960,2229668424,2229668552,128
1361808293,2229672328,37,1924,52,1361808266824,1361808268104,2229646152,2229647432,1280
1361808325,2229704292,38,2013,52.97368421,1361808298156,1361808321644,2229677448,2229700936,23488
1361808347,2229725672,4,310,77.5,1361808340888,1361808341016,2229719560,2229719688,128
1361808355,2229733616,6,597,99.5,1361808352015,1361808353871,2229730631,2229732487,1856
1361808357,2229736440,37,1924,52,1361808329623,1361808331031,2229709063,2229710471,1408
1361808381,2229760436,1,113,113,1361808355227,1361808355227,2229734663,2229734663,0
1361808390,2229768524,37,1924,52,1361808361963,1361808363691,2229740487,2229742215,1728
1361808411,2229789652,2,98,49,1361808393450,1361808403498,2229772102,2229782150,10048
1361808411,2229789696,2,98,49,1361808397440,1361808403456,2229776136,2229782152,6016
1361808418,2229796544,37,1924,52,1361808393686,1361808395030,2229772230,2229773574,1344
1361808426,2229804544,12,4601,383.4166667,1361808401111,1361808401495,2229779655,2229780039,384
1361808450,2229828720,39,2052,52.61538462,1361808424870,1361808427238,2229803590,2229805958,2368
1361808470,2229848696,2,178,89,1361808442304,1361808442560,2229821000,2229821256,256
1361808482,2229860740,37,1924,52,1361808457233,1361808458641,2229835973,2229837381,1408
1361808507,2229885712,3,193,64.33333333,1361808501613,1361808501677,2229880325,2229880389,64
1361808514,2229892736,37,1924,52,1361808488599,1361808490071,2229867335,2229868807,1472
1361808526,2229904960,19,3941,207.4210526,1361808501430,1361808503734,2229880390,2229882694,2304
1361808546,2229924852,40,2116,52.9,1361808520034,1361808522466,2229898886,2229901318,2432
1361808578,2229957028,40,2104,52.6,1361808552240,1361808556848,2229931268,2229935876,4608
1361808587,2229965808,3,193,64.33333333,1361808585614,1361808585614,2229964422,2229964422,0
1361808610,2229989092,16,3840,240,1361808585328,1361808586672,2229964420,2229965764,1344
1361808610,2229989196,39,2052,52.61538462,1361808585097,1361808587209,2229964293,2229966405,2112
1361808619,2229997792,3,193,64.33333333,1361808614685,1361808614685,2229993477,2229993477,0
1361808642,2230021108,39,2077,53.25641026,1361808617313,1361808623585,2229996421,2230002693,6272
1361808642,2230021144,14,3610,257.8571429,1361808614395,1361808615419,2229993539,2229994563,1024
1361808643,2230021832,4,310,77.5,1361808640949,1361808641077,2230019781,2230019909,128
1361808674,2230053348,40,2116,52.9,1361808648753,1361808653233,2230028101,2230032581,4480
1361808683,2230061848,10,3832,383.2,1361808680229,1361808680549,2230059077,2230059397,320
1361808683,2230061900,10,3832,383.2,1361808680560,1361808680752,2230059460,2230059652,192
1361808706,2230085160,2,120,60,1361808680106,1361808680618,2230059266,2230059778,512
1361808706,2230085164,21,13093,623.4761905,1361808680229,1361808680933,2230059393,2230060097,704
1361808706,2230085164,23,23447,1019.434783,1361808680485,1361808680741,2230059649,2230059905,256
1361808706,2230085240,2,120,60,1361808679898,1361808680346,2230059138,2230059586,448
1361808707,2230085844,8,2576,322,1361808700584,1361808700648,2230079428,2230079492,64
1361808707,2230085924,8,2684,335.5,1361808700249,1361808700633,2230079173,2230079557,384
1361808710,2230089236,42,2244,53.42857143,1361808683360,1361808689376,2230062596,2230068612,6016
1361808715,2230093924,5,346,69.2,1361808707863,1361808708183,2230086787,2230087107,320
1361808715,2230093924,2,112,56,1361808708245,1361808708373,2230087169,2230087297,128
1361808726,2230105280,20,6853,342.65,1361808699378,1361808714034,2230078658,2230093314,14656
1361808726,2230105324,12,4463,371.9166667,1361808700871,1361808700999,2230080195,2230080323,128
1361808734,2230113192,17,3892,228.9411765,1361808707916,1361808712972,2230087108,2230092164,5056
1361808746,2230125208,37,1924,52,1361808719355,1361808720891,2230098563,2230100099,1536
1361808747,2230125860,4,220,55,1361808740183,1361808740183,2230119043,2230119043,0
1361808766,2230145272,2,104,52,1361808739770,1361808739770,2230119042,2230119042,0
1361808766,2230145312,1,46,46,1361808741458,1361808741458,2230120770,2230120770,0
1361808770,2230149284,4,356,89,1361808743340,1361808745132,2230122624,2230124416,1792
1361808778,2230157256,39,2052,52.61538462,1361808750856,1361808753032,2230130112,2230132288,2176
1361808810,2230189276,41,2180,53.17073171,1361808783031,1361808785975,2230162307,2230165251,2944
1361808842,2230221332,38,1988,52.31578947,1361808815934,1361808817598,2230195266,2230196930,1664
1361808874,2230253344,39,2052,52.61538462,1361808847602,1361808849842,2230226946,2230229186,2240
1361808883,2230261916,2,141,70.5,1361808876445,1361808876445,2230255361,2230255361,0
1361808902,2230281208,1,60,60,1361808875255,1361808875255,2230254463,2230254463,0
1361808902,2230281288,15,5024,334.9333333,1361808875111,1361808876199,2230254399,2230255487,1088
1361808906,2230285324,38,1988,52.31578947,1361808879875,1361808881603,2230259199,2230260927,1728
1361808939,2230317756,40,2141,53.525,1361808912186,1361808925946,2230290942,2230304702,13760
1361808947,2230325728,1,52,52,1361808921175,1361808921175,2230299903,2230299903,0
1361808947,2230326072,1,46,46,1361808921473,1361808921473,2230300545,2230300545,0
1361808947,2230326236,4,310,77.5,1361808941082,1361808941146,2230320318,2230320382,64
1361808971,2230349572,42,2244,53.42857143,1361808944820,1361808949748,2230323392,2230328320,4928
1361809007,2230385584,41,2180,53.17073171,1361808979752,1361808982504,2230358336,2230361088,2752
1361809027,2230405568,11,4380,398.1818182,1361809001782,1361809001910,2230380350,2230380478,128
1361809039,2230417648,38,1988,52.31578947,1361809012452,1361809014692,2230391100,2230393340,2240
1361809043,2230422112,3,193,64.33333333,1361809038549,1361809038549,2230417661,2230417661,0
1361809071,2230449664,39,2052,52.61538462,1361809044693,1361809046805,2230423357,2230425469,2112
1361809071,2230449724,14,3598,257,1361809043866,1361809044570,2230422590,2230423294,704
1361809071,2230449788,1,89,89,1361809045914,1361809045914,2230424702,2230424702,0
1361809103,2230481972,37,1924,52,1361809076577,1361809078497,2230455549,2230457469,1920
1361809135,2230513940,40,2116,52.9,1361809108482,1361809112770,2230487422,2230491710,4288
1361809167,2230546100,37,1924,52,1361809142624,1361809144160,2230521724,2230523260,1536
1361809199,2230578064,37,1924,52,1361809174210,1361809175682,2230553274,2230554746,1472
1361809231,2230609940,38,2013,52.97368421,1361809205823,1361809228159,2230584763,2230607099,22336
1361809244,2230622692,4,310,77.5,1361809241782,1361809241910,2230620474,2230620602,128
1361809263,2230642124,37,1924,52,1361809236999,1361809238343,2230616123,2230617467,1344
1361809295,2230674020,40,2116,52.9,1361809268461,1361809271277,2230647481,2230650297,2816
1361809327,2230706164,37,1924,52,1361809301085,1361809302429,2230680249,2230681593,1344
1361809327,2230706168,12,4659,388.25,1361809301338,1361809301530,2230680506,2230680698,192
1361809359,2230738060,37,1924,52,1361809332548,1361809333956,2230711608,2230713016,1408
1361809375,2230754136,1,89,89,1361809347450,1361809347450,2230726586,2230726586,0
1361809391,2230770128,37,1924,52,1361809363905,1361809365505,2230743033,2230744633,1600
1361809423,2230802132,39,2052,52.61538462,1361809395514,1361809397562,2230774646,2230776694,2048
1361809455,2230834156,37,1924,52,1361809427554,1361809429026,2230806710,2230808182,1472
1361809487,2230866212,38,1988,52.31578947,1361809459049,1361809460777,2230838261,2230839989,1728
1361809515,2230894416,38,1988,52.31578947,1361809490591,1361809492703,2230870007,2230872119,2112
1361809547,2230926456,43,2333,54.25581395,1361809522677,1361809530485,2230902133,2230909941,7808
1361809548,2230926776,4,310,77.5,1361809541856,1361809541984,2230920632,2230920760,128
1361809580,2230958880,10,3832,383.2,1361809579062,1361809579254,2230957942,2230958134,192
1361809580,2230958880,10,3832,383.2,1361809579062,1361809579254,2230957942,2230958134,192
1361809583,2230962468,39,2052,52.61538462,1361809556264,1361809558568,2230935732,2230938036,2304
1361809604,2230982652,18,12771,709.5,1361809579545,1361809580121,2230958197,2230958773,576
1361809604,2230982656,27,23161,857.8148148,1361809579542,1361809580182,2230958198,2230958838,640
1361809604,2230982800,1,60,60,1361809579395,1361809579395,2230958195,2230958195,0
1361809616,2230994692,37,1924,52,1361809589360,1361809590640,2230968052,2230969332,1280
1361809628,2231006880,10,1702,170.2,1361809601780,1361809601972,2230980660,2230980852,192
1361809644,2231022988,2,116,58,1361809638919,1361809639239,2231017907,2231018227,320
1361809648,2231026700,40,2116,52.9,1361809620649,1361809623081,2230999349,2231001781,2432
1361809664,2231042744,1,52,52,1361809639547,1361809639547,2231018291,2231018291,0
1361809676,2231054812,1,89,89,1361809650554,1361809650554,2231029366,2231029366,0
1361809680,2231058712,40,2116,52.9,1361809653085,1361809655645,2231031797,2231034357,2560
1361809712,2231090716,40,2116,52.9,1361809685654,1361809688022,2231064370,2231066738,2368
1361809744,2231123216,37,1924,52,1361809717538,1361809719010,2231096754,2231098226,1472
1361809776,2231155060,37,1924,52,1361809749184,1361809750656,2231128244,2231129716,1472
1361809804,2231183200,3,193,64.33333333,1361809796080,1361809796080,2231175280,2231175280,0
1361809809,2231188060,37,1924,52,1361809780672,1361809782016,2231159732,2231161076,1344
1361809810,2231189176,1,48,48,1361809782475,1361809782475,2231161651,2231161651,0
1361809824,2231203120,16,3771,235.6875,1361809796225,1361809797313,2231175345,2231176433,1088
1361809824,2231203124,1,60,60,1361809796288,1361809796288,2231175412,2231175412,0
1361809836,2231215348,41,2205,53.7804878,1361809811679,1361809833055,2231191027,2231212403,21376
1361809844,2231223220,4,310,77.5,1361809841631,1361809841759,2231220851,2231220979,128
1361809868,2231247372,27,19609,726.2592593,1361809840709,1361809840965,2231220081,2231220337,256
1361809872,2231251308,38,1988,52.31578947,1361809844100,1361809846084,2231223408,2231225392,1984
1361809901,2231279708,37,1924,52,1361809876702,1361809878046,2231255410,2231256754,1344
1361809929,2231307588,10,1735,173.5,1361809902294,1361809902422,2231280882,2231281010,128
1361809933,2231311676,37,1924,52,1361809908093,1361809909501,2231286769,2231288177,1408
1361809965,2231343764,40,2104,52.6,1361809938403,1361809941475,2231317167,2231320239,3072
1361809977,2231355832,1,89,89,1361809952610,1361809952610,2231331442,2231331442,0
1361809997,2231375844,38,1988,52.31578947,1361809971346,1361809972882,2231350190,2231351726,1536
1361810025,2231403884,1,52,52,1361810000555,1361810000555,2231379439,2231379439,0
1361810029,2231407712,39,2052,52.61538462,1361810003033,1361810004953,2231381745,2231383665,1920
1361810061,2231440128,37,1924,52,1361810034551,1361810035895,2231413679,2231415023,1344
1361810084,2231463196,4,310,77.5,1361810081136,1361810081328,2231460332,2231460524,192
1361810093,2231472072,37,1924,52,1361810065966,1361810068078,2231445038,2231447150,2112
1361810125,2231504080,38,1988,52.31578947,1361810098021,1361810099685,2231477101,2231478765,1664
1361810148,2231527280,4,310,77.5,1361810141790,1361810141854,2231521070,2231521134,64
1361810157,2231536104,38,2013,52.97368421,1361810129804,1361810135372,2231508908,2231514476,5568
1361810189,2231568160,39,2052,52.61538462,1361810161110,1361810163158,2231540270,2231542318,2048
1361810200,869892820,1,46,46,1361810172062,1361810172062,869864882,869864882,0
1361810221,2231600456,38,1988,52.31578947,1361810192878,1361810194414,2231572334,2231573870,1536
1361810229,2231608468,9,1681,186.7777778,1361810201567,1361810201695,2231581035,2231581163,128
1361810250,2231628612,39,2052,52.61538462,1361810225337,1361810227961,2231603949,2231606573,2624
1361810282,2231660680,1,89,89,1361810255028,1361810255028,2231633708,2231633708,0
1361810286,2231664560,39,2052,52.61538462,1361810258027,1361810260203,2231636587,2231638763,2176
1361810318,2231696780,46,2500,54.34782609,1361810289997,1361810294733,2231668777,2231673513,4736
1361810350,2231728708,39,2052,52.61538462,1361810324820,1361810326740,2231703528,2231705448,1920
1361810382,2231760908,37,1924,52,1361810356557,1361810357965,2231735465,2231736873,1408
1361810402,2231781108,1,48,48,1361810377732,1361810377732,2231756840,2231756840,0
1361810414,2231793036,37,1924,52,1361810387854,1361810389262,2231766890,2231768298,1408
1361810445,2231823572,4,310,77.5,1361810442590,1361810442718,2231821162,2231821290,128
1361810446,2231825164,38,2013,52.97368421,1361810419148,1361810437452,2231798312,2231816616,18304
1361810478,2231857060,39,2052,52.61538462,1361810450547,1361810452531,2231829607,2231831591,1984
1361810485,2231863584,10,3832,383.2,1361810478288,1361810478544,2231856872,2231857128,256
1361810485,2231863636,10,3832,383.2,1361810478236,1361810478428,2231856872,2231857064,192
1361810502,2231881252,24,21655,902.2916667,1361810477812,1361810478196,2231857064,2231857448,384
1361810506,2231885116,17,12029,707.5882353,1361810478010,1361810478330,2231857126,2231857446,320
1361810510,2231889184,37,1924,52,1361810482422,1361810483830,2231861606,2231863014,1408
1361810527,2231905724,10,4328,432.8,1361810502466,1361810502658,2231881190,2231881382,192
1361810528,2231906536,1,46,46,1361810499328,1361810499328,2231877864,2231877864,0
1361810539,2231917592,37,1924,52,1361810514440,1361810515720,2231893032,2231894312,1280
1361810543,2231921524,1,60,60,1361810518730,1361810518730,2231897254,2231897254,0
1361810554,2231933376,1,60,60,1361810527093,1361810527093,2231906469,2231906469,0
1361810562,2231941464,2,104,52,1361810537376,1361810537376,2231916840,2231916840,0
1361810563,2231941568,2,104,52,1361810538269,1361810538269,2231916837,2231916837,0
1361810571,2231949608,42,2244,53.42857143,1361810545719,1361810548791,2231924327,2231927399,3072
1361810582,2231961464,1,89,89,1361810556512,1361810556512,2231935976,2231935976,0
1361810603,2231981600,43,2308,53.6744186,1361810578815,1361810582847,2231957415,2231961447,4032
1361810639,2232017696,38,1988,52.31578947,1361810612767,1361810616095,2231991463,2231994791,3328
1361810671,2232049596,37,1924,52,1361810646208,1361810647808,2232024804,2232026404,1600
1361810675,2232053764,1,60,60,1361810649819,1361810649819,2232028583,2232028583,0
1361810703,2232081616,39,2052,52.61538462,1361810677804,1361810679660,2232056420,2232058276,1856
1361810723,2232101616,1,89,89,1361810697323,1361810697323,2232075939,2232075939,0
1361810735,2232113620,38,1988,52.31578947,1361810709609,1361810711401,2232088229,2232090021,1792
1361810749,2232127744,4,310,77.5,1361810742636,1361810742700,2232121380,2232121444,64
1361810767,2232145620,38,2013,52.97368421,1361810740200,1361810742888,2232118820,2232121508,2688
1361810799,2232177664,37,1924,52,1361810772857,1361810774201,2232151521,2232152865,1344
1361810827,2232205768,13,3562,274,1361810802644,1361810803092,2232181412,2232181860,448
1361810831,2232209744,42,2244,53.42857143,1361810804141,1361810807597,2232182885,2232186341,3456
1361810863,2232241864,37,1924,52,1361810837490,1361810838962,2232216354,2232217826,1472
1361810887,2232265828,1,89,89,1361810859350,1361810859350,2232238178,2232238178,0
1361810895,2232273804,37,1924,52,1361810869038,1361810870382,2232247842,2232249186,1344
1361810927,2232305812,39,2052,52.61538462,1361810900391,1361810902311,2232279203,2232281123,1920
1361810941,2232319836,2,178,89,1361810935820,1361810935820,2232314656,2232314656,0
1361810959,2232337868,38,1988,52.31578947,1361810932267,1361810934187,2232311135,2232313055,1920
1361811045,2232423888,6,597,99.5,1361811042647,1361811044311,2232421535,2232423199,1664
1361811067,2232446236,6,534,89,1361811041597,1361811051261,2232420833,2232430497,9664
1361811071,2232450336,1,113,113,1361811045654,1361811045654,2232424990,2232424990,0
1361811188,2232566724,7,623,89,1361811162043,1361811173755,2232540767,2232552479,11712
1361814612,2235990500,1,449,449,1361814587494,1361814587494,2235965994,2235965994,0
1361814701,2236079496,1,46,46,1361814674410,1361814674410,2236052906,2236052906,0
1361816007,2237385852,2,120,60,1361815981935,1361815984943,2237360787,2237363795,3008
1361819941,2241319876,1,52,52,1361819913630,1361819913630,2241292506,2241292506,0
1361820310,2241688788,1,127,127,1361820282866,1361820282866,2241661654,2241661654,0
1361820735,2242113556,1,46,46,1361820708561,1361820708561,2242087117,2242087117,0
1361822564,2243942856,1,46,46,1361822536267,1361822536267,2243915123,2243915123,0
1361822620,2243998844,1,46,46,1361822593555,1361822593555,2243972399,2243972399,0
1361822782,2244160652,1,46,46,1361822756883,1361822756883,2244135535,2244135535,0
1361825699,2247077720,1,46,46,1361825671523,1361825671523,2247050243,2247050243,0
1361825700,2247078512,1,46,46,1361825671668,1361825671668,2247050180,2247050180,0
1361825700,2247078588,1,46,46,1361825671718,1361825671718,2247050306,2247050306,0
1361825907,2247286128,1,46,46,1361825879943,1361825879943,2247259071,2247259071,0
1361828809,2250187604,1,48,48,1361828781289,1361828781289,2250159893,2250159893,0
1361830322,2251700800,1,48,48,1361830294286,1361830294286,2251673086,2251673086,0
1361834360,2255738952,1,46,46,1361834332023,1361834332023,2255710975,2255710975,0
1361977362,1037055264,1,46,46,1361977335196,1361977335196,1037028460,1037028460,0
1361979233,2400611796,1,46,46,1361979206802,1361979206802,2400585598,2400585598,0
1361979515,2400893476,1,46,46,1361979485453,1361979485453,2400863929,2400863929,0
1361979744,2401122628,1,46,46,1361979717298,1361979717298,2401095926,2401095926,0
1361980494,2401872868,1,46,46,1361980466871,1361980466871,2401845739,2401845739,0
1361980768,1040461056,16,13483,842.6875,1361980766721,1361980767745,1040459777,1040460801,1024
1361980770,2402148596,16,6747,421.6875,1361980768643,1361980769795,2402147239,2402148391,1152
1361980770,2402148672,12,5328,444,1361980768376,1361980769656,2402147048,2402148328,1280
1361980778,2402156544,18,3912,217.3333333,1361980765431,1361980771383,2402143975,2402149927,5952
1361980778,2402156548,67,57008,850.8656716,1361980769778,1361980777586,2402148326,2402156134,7808
1361980778,2402156596,11,3015,274.0909091,1361980765381,1361980776645,2402143977,2402155241,11264
1361980778,2402156600,46,38569,838.4565217,1361980769729,1361980771649,2402148329,2402150249,1920
1361980778,2402156640,3,164,54.66666667,1361980767766,1361980777750,2402146406,2402156390,9984
1361980784,1040477020,12,9490,790.8333333,1361980777894,1361980778150,1040470914,1040471170,256
1361980784,1040477020,10,7034,703.4,1361980782053,1361980782245,1040475073,1040475265,192
1361980784,1040477024,8,1538,192.25,1361980782372,1361980782564,1040475396,1040475588,192
1361980784,1040477024,8,1656,207,1361980778659,1361980778787,1040471683,1040471811,128
1361980784,1040477024,10,2344,234.4,1361980782563,1361980783651,1040475587,1040476675,1088
1361980784,1040477024,12,5835,486.25,1361980766754,1361980777314,1040459778,1040470338,10560
1361980784,1040477024,7,1454,207.7142857,1361980779169,1361980779809,1040472193,1040472833,640
1361980784,1040477024,9,2422,269.1111111,1361980779169,1361980779617,1040472193,1040472641,448
1361980784,1040477024,8,1426,178.25,1361980779169,1361980779809,1040472193,1040472833,640
1361980784,1040477028,8,1474,184.25,1361980779679,1361980779871,1040472707,1040472899,192
1361980784,1040477028,9,1437,159.6666667,1361980779870,1361980780254,1040472898,1040473282,384
1361980784,1040477028,8,1490,186.25,1361980777373,1361980777373,1040470401,1040470401,0
1361980784,1040477032,10,7098,709.8,1361980777372,1361980777564,1040470404,1040470596,192
1361980784,1040477048,11,7902,718.3636364,1361980777868,1361980778252,1040470916,1040471300,384
1361980784,1040477048,11,7902,718.3636364,1361980782347,1361980782731,1040475395,1040475779,384
1361980784,1040477048,8,1656,207,1361980778635,1361980778763,1040471683,1040471811,128
1361980784,1040477052,8,1554,194.25,1361980783176,1361980783752,1040476228,1040476804,576
1361980784,1040477052,9,2566,285.1111111,1361980779143,1361980779655,1040472195,1040472707,512
1361980784,1040477052,8,1490,186.25,1361980779143,1361980779399,1040472195,1040472451,256
1361980784,1040477052,7,1390,198.5714286,1361980779143,1361980779783,1040472195,1040472835,640
1361980784,1040477052,7,1662,237.4285714,1361980779398,1361980779718,1040472450,1040472770,320
1361980784,1040477052,9,2326,258.4444444,1361980779589,1361980779781,1040472641,1040472833,192
1361980784,1040477052,8,2232,279,1361980779653,1361980779717,1040472705,1040472769,64
1361980786,2402164624,8,2673,334.125,1361980778278,1361980778598,2402156902,2402157222,320
1361980786,2402164632,10,4202,420.2,1361980779039,1361980779487,2402157671,2402158119,448
1361980790,1040482648,7,1406,200.8571429,1361980785884,1361980786332,1040478532,1040478980,448
1361980792,1040485032,13,8726,671.2307692,1361980785628,1361980786140,1040478660,1040479172,512
1361980792,1040485032,8,1576,197,1361980785947,1361980786139,1040478979,1040479171,192
1361980792,1040485032,9,1782,198,1361980786138,1361980786970,1040479170,1040480002,832
1361980792,1040485032,8,1298,162.25,1361980786266,1361980786458,1040479298,1040479490,192
1361980792,1040485032,15,14403,960.2,1361980784346,1361980784794,1040477378,1040477826,448
1361980792,1040485036,8,1666,208.25,1361980790678,1361980791766,1040483714,1040484802,1088
1361980792,1040485040,8,1240,155,1361980785299,1361980785491,1040478339,1040478531,192
1361980792,1040485040,8,1298,162.25,1361980788177,1361980788241,1040481217,1040481281,64
1361980792,1040485044,7,1454,207.7142857,1361980785487,1361980785999,1040478531,1040479043,512
1361980792,1040485044,8,1442,180.25,1361980785487,1361980785935,1040478531,1040478979,448
1361980792,1040485044,10,1402,140.2,1361980785615,1361980785935,1040478659,1040478979,320
1361980792,1040485044,7,1524,217.7142857,1361980785615,1361980785807,1040478659,1040478851,192
1361980792,1040485044,8,1554,194.25,1361980784014,1361980784334,1040477058,1040477378,320
1361980792,1040485044,8,1576,197,1361980785806,1361980786126,1040478850,1040479170,320
1361980792,1040485044,8,1576,197,1361980785933,1361980786125,1040478977,1040479169,192
1361980792,1040485112,8,1378,172.25,1361980789772,1361980789964,1040482884,1040483076,192
1361980792,1040485112,12,7202,600.1666667,1361980789963,1361980790411,1040483075,1040483523,448
1361980792,1040485116,14,9432,673.7142857,1361980790600,1361980791752,1040483716,1040484868,1152
1361980792,1040485120,9,1406,156.2222222,1361980783684,1361980785540,1040476804,1040478660,1856
1361980793,2402171840,81,67327,831.1975309,1361980765134,1361980769358,2402143974,2402148198,4224
1361980793,2402171884,17,4676,275.0588235,1361980767524,1361980778724,2402146408,2402157608,11200
1361980793,2402171884,8,802,100.25,1361980767331,1361980767715,2402146215,2402146599,384
1361980793,2402171888,1,60,60,1361980768350,1361980768350,2402147238,2402147238,0
1361980793,2402171924,58,22885,394.5689655,1361980764925,1361980767869,2402143849,2402146793,2944
1361980794,2402172000,20,4917,245.85,1361980768920,1361980770200,2402146920,2402148200,1280
1361980797,2402175868,24,12519,521.625,1361980769524,1361980769972,2402148392,2402148840,448
1361980797,2402175896,14,7978,569.8571429,1361980771352,1361980778456,2402150248,2402157352,7104
1361980798,2402175976,18,3965,220.2777778,1361980772014,1361980779886,2402149990,2402157862,7872
1361980800,1040493036,8,1240,155,1361980794198,1361980794390,1040487234,1040487426,192
1361980800,1040493036,8,1147,143.375,1361980794390,1361980795926,1040487426,1040488962,1536
1361980800,1040493040,8,1298,162.25,1361980794708,1361980794900,1040487748,1040487940,192
1361980800,1040493044,1740,2471811,1420.581034,1361980795919,1361980798991,1040488963,1040492035,3072
1361980800,1040493064,13,10619,816.8461538,1361980792507,1361980794043,1040485571,1040487107,1536
1361980800,1040493072,9,2284,253.7777778,1361980791859,1361980792051,1040484931,1040485123,192
1361980800,1040493072,8,1570,196.25,1361980791731,1361980792947,1040484803,1040486019,1216
1361980805,2402183900,8,3893,486.625,1361980777300,1361980777620,2402156200,2402156520,320
1361980805,2402183908,38,27382,720.5789474,1361980778508,1361980793164,2402157416,2402172072,14656
1361980818,1040510660,1,52,52,1361980792784,1361980792784,1040485444,1040485444,0
1361980834,2402211980,39,2077,53.25641026,1361980808490,1361980825962,2402186470,2402203942,17472
1361980854,2402232072,4,1166,291.5,1361980828111,1361980840271,2402206183,2402218343,12160
1361980854,2402232080,3,156,52,1361980828999,1361980829255,2402207079,2402207335,256
1361980854,2402232080,2,104,52,1361980828999,1361980828999,2402207079,2402207079,0
1361980862,2402240256,13,5961,458.5384615,1361980836566,1361980836950,2402214822,2402215206,384
1361980866,2402244192,41,2180,53.17073171,1361980840084,1361980842708,2402218276,2402220900,2624
1361980874,2402252252,1,89,89,1361980847323,1361980847323,2402225575,2402225575,0
1361980898,2402276316,39,2052,52.61538462,1361980872602,1361980874586,2402250918,2402252902,1984
1361980914,2402292232,1,158,158,1361980887916,1361980887916,2402266148,2402266148,0
1361980930,2402308268,39,2040,52.30769231,1361980904714,1361980912842,2402282982,2402291110,8128
1361980962,2402340360,41,2180,53.17073171,1361980936238,1361980939246,2402314598,2402317606,3008
1361980974,2402352388,1,158,158,1361980947791,1361980947791,2402326179,2402326179,0
1361980994,2402372424,39,2052,52.61538462,1361980969197,1361980971245,2402347621,2402349669,2048
1361981010,2402388368,8,3912,489,1361980982949,1361980998501,2402361317,2402376869,15552
1361981010,2402388996,3,258,86,1361981009838,1361981009838,2402388834,2402388834,0
1361981010,2402389028,4,310,77.5,1361981007503,1361981007631,2402386531,2402386659,128
1361981010,2402389040,4,274,68.5,1361981009220,1361981009284,2402388260,2402388324,64
1361981026,2402404548,38,1988,52.31578947,1361981001137,1361981002737,2402379685,2402381285,1600
1361981038,2402416456,1,52,52,1361981010507,1361981010507,2402388963,2402388963,0
1361981058,2402436516,37,1924,52,1361981032781,1361981034061,2402411297,2402412577,1280
1361981062,2402440508,1,477,477,1361981034201,1361981034201,2402412709,2402412709,0
1361981082,2402460416,1,76,76,1361981057906,1361981057906,2402436322,2402436322,0
1361981083,2402461104,4,310,77.5,1361981076843,1361981076971,2402454947,2402455075,128
1361981090,2402468580,39,2052,52.61538462,1361981064017,1361981066577,2402442597,2402445157,2560
1361981094,2402472628,3,655,218.3333333,1361981067552,1361981091936,2402446180,2402470564,24384
1361981122,2402500580,40,2116,52.9,1361981096592,1361981098896,2402475172,2402477476,2304
1361981154,2402532620,1,158,158,1361981127524,1361981127524,2402506144,2402506144,0
1361981154,2402532724,40,2166,54.15,1361981127550,1361981130430,2402506274,2402509154,2880
1361981174,2402552708,1,89,89,1361981149197,1361981149197,2402527905,2402527905,0
1361981186,2402564812,38,1988,52.31578947,1361981160357,1361981162533,2402539169,2402541345,2176
1361981206,2402584732,2,971,485.5,1361981180085,1361981184885,2402558817,2402563617,4800
1361981218,2402596800,39,2052,52.61538462,1361981192560,1361981194480,2402571360,2402573280,1920
1361981242,2402620744,2,316,158,1361981217384,1361981217704,2402596128,2402596448,320
1361981250,2402628856,39,2052,52.61538462,1361981224442,1361981226426,2402603298,2402605282,1984
1361981282,2402660896,40,2116,52.9,1361981256399,1361981259087,2402635295,2402637983,2688
1361981303,2402680936,2,236,118,1361981278289,1361981285265,2402656225,2402663201,6976
1361981314,2402692872,37,1924,52,1361981289129,1361981290409,2402668001,2402669281,1280
1361981347,2402724944,37,1924,52,1361981321351,1361981322567,2402699295,2402700511,1216
1361981363,2402741376,2,652,326,1361981337749,1361981361237,2402716125,2402739613,23488
1361981379,2402757144,37,1924,52,1361981352384,1361981353664,2402730528,2402731808,1280
1361981411,2402789132,37,1924,52,1361981383753,1361981385033,2402761885,2402763165,1280
1361981423,2402801148,2,620,310,1361981398011,1361981402619,2402776159,2402780767,4608
1361981435,2402813220,63,58740,932.3809524,1361981409585,1361981410097,2402787805,2402788317,512
1361981443,2402821164,39,2077,53.25641026,1361981415019,1361981430251,2402793183,2402808415,15232
1361981471,2402849192,37,1924,52,1361981446475,1361981447691,2402824667,2402825883,1216
1361981479,2402857124,1,89,89,1361981451729,1361981451729,2402829853,2402829853,0
1361981483,2402861292,1,158,158,1361981457831,1361981457831,2402836123,2402836123,0
1361981503,2402881220,37,1924,52,1361981477680,1361981478896,2402855900,2402857116,1216
1361981535,2402913252,37,1924,52,1361981508880,1361981510096,2402887132,2402888348,1216
1361981543,2402921184,1,158,158,1361981517972,1361981517972,2402896156,2402896156,0
1361981567,2402945212,37,1924,52,1361981540152,1361981541432,2402918364,2402919644,1280
1361981599,2402977288,38,1988,52.31578947,1361981571434,1361981574250,2402949722,2402952538,2816
1361981603,2402981204,3,681,227,1361981577920,1361981587392,2402956124,2402965596,9472
1361981631,2403009208,38,1988,52.31578947,1361981604347,1361981605883,2402982555,2402984091,1536
1361981652,2403030304,4,310,77.5,1361981650009,1361981650201,2403028313,2403028505,192
1361981659,2403037592,10,3832,383.2,1361981654841,1361981655033,2403033433,2403033625,192
1361981659,2403037592,10,3832,383.2,1361981654777,1361981655033,2403033369,2403033625,256
1361981663,2403041216,37,1924,52,1361981635891,1361981637235,2403014107,2403015451,1344
1361981663,2403041248,1,158,158,1361981637905,1361981637905,2403016153,2403016153,0
1361981683,2403061212,17,12029,707.5882353,1361981655413,1361981655861,2403033625,2403034073,448
1361981683,2403061212,26,21759,836.8846154,1361981655413,1361981655925,2403033625,2403034137,512
1361981695,2403073328,38,1988,52.31578947,1361981667138,1361981668674,2403045466,2403047002,1536
1361981699,2403077332,2,141,70.5,1361981672958,1361981672958,2403051290,2403051290,0
1361981723,2403101432,1,158,158,1361981697688,1361981697688,2403076120,2403076120,0
1361981723,2403101516,37,1924,52,1361981698502,1361981699782,2403077018,2403078298,1280
1361981743,2403121400,2,104,52,1361981715002,1361981715002,2403093402,2403093402,0
1361981743,2403121400,2,104,52,1361981714937,1361981715001,2403093337,2403093401,64
1361981755,2403133568,42,2269,54.02380952,1361981729809,1361981732945,2403108377,2403111513,3136
1361981759,2403137556,1,462,462,1361981734558,1361981734558,2403113114,2403113114,0
1361981779,2403157620,1,89,89,1361981753053,1361981753053,2403131673,2403131673,0
1361981791,2403169540,37,1924,52,1361981762925,1361981764205,2403141465,2403142745,1280
1361981815,2403193576,1,158,158,1361981787527,1361981787527,2403166103,2403166103,0
1361981819,2403197612,38,1988,52.31578947,1361981794083,1361981795683,2403172695,2403174295,1600
1361981851,2403229704,38,1988,52.31578947,1361981825609,1361981827273,2403204313,2403205977,1664
1361981876,2403254032,11,5941,540.0909091,1361981848101,1361981855077,2403226133,2403233109,6976
1361981884,2403261996,38,1988,52.31578947,1361981857996,1361981859724,2403235992,2403237720,1728
1361981912,2403289984,4,1158,289.5,1361981884629,1361981887189,2403262613,2403265173,2560
1361981912,2403290024,13,5721,440.0769231,1361981886000,1361981886128,2403264024,2403264152,128
1361981912,2403290076,39,2962,75.94871795,1361981885563,1361981891259,2403263639,2403269335,5696
1361981916,2403294108,1,78,78,1361981889820,1361981889820,2403267928,2403267928,0
1361981948,2403326116,37,1924,52,1361981921234,1361981922450,2403299350,2403300566,1216
1361981964,2403342148,3,474,158,1361981937970,1361981938290,2403316118,2403316438,320
1361981980,2403358140,37,1924,52,1361981952442,1361981953722,2403330582,2403331862,1280
1361982012,2403390104,37,1924,52,1361981984347,1361981985627,2403362451,2403363731,1280
1361982024,2403402376,1,158,158,1361981997708,1361981997708,2403376084,2403376084,0
1361982040,2403418412,38,2013,52.97368421,1361982015337,1361982034793,2403393749,2403413205,19456
1361982072,2403450428,39,2052,52.61538462,1361982046550,1361982048790,2403424978,2403427218,2240
1361982080,2403458440,1,89,89,1361982055243,1361982055243,2403433683,2403433683,0
1361982084,2403462732,5,3261,652.2,1361982056488,1361982056744,2403435220,2403435476,256
1361982104,2403482468,37,1924,52,1361982078769,1361982079985,2403457237,2403458453,1216
1361982112,2403490500,2,210,105,1361982087566,1361982087566,2403466066,2403466066,0
1361982132,2403510456,5,403,80.6,1361982125692,1361982125948,2403504148,2403504404,256
1361982136,2403514668,37,1924,52,1361982109797,1361982111013,2403488465,2403489681,1216
1361982168,2403546620,37,1924,52,1361982141078,1361982142358,2403519698,2403520978,1280
1361982172,2403550740,1,158,158,1361982147358,1361982147358,2403526098,2403526098,0
1361982201,2403578992,37,1924,52,1361982173001,1361982174217,2403550993,2403552209,1216
1361982217,2403595040,7,3860,551.4285714,1361982192089,1361982206361,2403570129,2403584401,14272
1361982229,2403607084,37,1924,52,1361982204141,1361982205485,2403582225,2403583569,1344
1361982261,2403639132,37,1924,52,1361982235451,1361982236731,2403613583,2403614863,1280
1361982265,2403643032,1,158,158,1361982238050,1361982238050,2403616082,2403616082,0
1361982293,2403671036,37,1924,52,1361982266846,1361982268126,2403644882,2403646162,1280
1361982321,2403699052,1,477,477,1361982293899,1361982293899,2403671951,2403671951,0
1361982325,2403703064,40,2104,52.6,1361982298112,1361982305536,2403676176,2403683600,7424
1361982353,2403731420,1,494,494,1361982326045,1361982326045,2403704465,2403704465,0
1361982357,2403735376,38,2013,52.97368421,1361982329672,1361982336840,2403708048,2403715216,7168
1361982385,2403763308,1,89,89,1361982357644,1361982357644,2403735952,2403735952,0
1361982385,2403763384,1,158,158,1361982357697,1361982357697,2403736081,2403736081,0
1361982389,2403767388,37,1924,52,1361982361021,1361982362301,2403739409,2403740689,1280
1361982417,2403795396,37,1924,52,1361982392305,1361982393521,2403770701,2403771917,1216
1361982445,2403823364,1,158,158,1361982417681,1361982417681,2403796045,2403796045,0
1361982449,2403827392,37,1924,52,1361982423541,1361982424821,2403801933,2403803213,1280
1361982481,2403859400,37,1924,52,1361982454830,1361982456110,2403833230,2403834510,1280
1361982501,2403879436,2,476,238,1361982473544,1361982493768,2403851980,2403872204,20224
1361982513,2403891440,37,1924,52,1361982486085,1361982487429,2403864525,2403865869,1344
1361982545,2403923408,38,1988,52.31578947,1361982517475,1361982519139,2403895883,2403897547,1664
1361982553,2403931472,11,3478,316.1818182,1361982526630,1361982527014,2403905102,2403905486,384
1361982556,2403934652,11,3884,353.0909091,1361982553647,1361982554223,2403932299,2403932875,576
1361982556,2403934728,10,3832,383.2,1361982553637,1361982553893,2403932365,2403932621,256
1361982577,2403955608,37,1924,52,1361982548957,1361982550237,2403927565,2403928845,1280
1361982581,2403959592,17,12029,707.5882353,1361982554028,1361982554540,2403932620,2403933132,512
1361982581,2403959676,26,21759,836.8846154,1361982553946,1361982554394,2403932622,2403933070,448
1361982585,2403963620,1,56,56,1361982560462,1361982560462,2403939082,2403939082,0
1361982593,2403971596,1,158,158,1361982567466,1361982567466,2403946062,2403946062,0
1361982597,2403975748,1,89,89,1361982572432,1361982572432,2403951180,2403951180,0
1361982605,2403983552,38,1988,52.31578947,1361982580306,1361982581906,2403958858,2403960458,1600
1361982637,2404015672,38,1988,52.31578947,1361982611805,1361982613277,2403990477,2403991949,1472
1361982641,2404019656,2,104,52,1361982613674,1361982613674,2403992330,2403992330,0
1361982641,2404019660,3,156,52,1361982613673,1361982613993,2403992333,2403992653,320
1361982653,2404031776,1,158,158,1361982627252,1361982627252,2404006028,2404006028,0
1361982665,2404043604,38,2013,52.97368421,1361982638559,1361982644703,2404017163,2404023307,6144
1361982685,2404063664,1,89,89,1361982659490,1361982659490,2404038154,2404038154,0
1361982701,2404079676,37,1924,52,1361982674646,1361982676054,2404053322,2404054730,1408
1361982713,2404091836,2,573,286.5,1361982687220,1361982696500,2404066056,2404075336,9280
1361982733,2404111740,37,1924,52,1361982705942,1361982707158,2404084682,2404085898,1216
1361982765,2404143796,37,1924,52,1361982737118,1361982738398,2404115914,2404117194,1280
1361982773,2404151844,10,5889,588.9,1361982747245,1361982759917,2404126089,2404138761,12672
1361982793,2404171868,39,2052,52.61538462,1361982768404,1361982770836,2404147272,2404149704,2432
1361982822,2404200068,1,78,78,1361982795955,1361982795955,2404174023,2404174023,0
1361982826,2404203944,37,1924,52,1361982801776,1361982802992,2404179720,2404180936,1216
1361982858,2404236224,38,1988,52.31578947,1361982832727,1361982834327,2404210951,2404212551,1600
1361982866,2404244132,1,158,158,1361982837874,1361982837874,2404216006,2404216006,0
1361982890,2404268168,38,1988,52.31578947,1361982864401,1361982865937,2404242569,2404244105,1536
1361982902,2404280284,1,52,52,1361982875931,1361982875931,2404254215,2404254215,0
1361982922,2404300136,1,158,158,1361982897902,1361982897902,2404276038,2404276038,0
1361982922,2404300180,40,2116,52.9,1361982895937,1361982898177,2404274117,2404276357,2240
1361982954,2404332228,40,2141,53.525,1361982928146,1361982941010,2404306374,2404319238,12864
1361982986,2404364356,37,1924,52,1361982960083,1361982961363,2404338439,2404339719,1280
1361982986,2404364396,1,89,89,1361982961580,1361982961580,2404339976,2404339976,0
1361983014,2404392648,1,158,158,1361982987372,1361982987372,2404366020,2404366020,0
1361983018,2404396544,38,1988,52.31578947,1361982991190,1361982992854,2404369734,2404371398,1664
1361983050,2404428592,39,2052,52.61538462,1361983022821,1361983024613,2404401413,2404403205,1792
1361983074,2404452724,1,158,158,1361983047330,1361983047330,2404426054,2404426054,0
1361983082,2404460636,37,1924,52,1361983054586,1361983055802,2404433222,2404434438,1216
1361983110,2404488732,37,1924,52,1361983085720,1361983087064,2404464452,2404465796,1344
1361983122,2404500832,1,78,78,1361983097459,1361983097459,2404476291,2404476291,0
1361983142,2404520788,37,1924,52,1361983117023,1361983118239,2404495811,2404497027,1216
1361983159,2404536984,6,2722,453.6666667,1361983131267,1361983131395,2404509251,2404509379,128
1361983175,2404553176,38,1988,52.31578947,1361983148867,1361983150403,2404527043,2404528579,1536
1361983195,2404573052,1,158,158,1361983167934,1361983167934,2404545986,2404545986,0
1361983207,2404585232,37,1924,52,1361983180363,1361983181579,2404558595,2404559811,1216
1361983235,2404613116,25,17832,713.28,1361983209151,1361983209407,2404587267,2404587523,256
1361983239,2404617192,38,1988,52.31578947,1361983211636,1361983213236,2404589828,2404591428,1600
1361983255,2404633220,1,158,158,1361983227796,1361983227796,2404606016,2404606016,0
1361983271,2404649120,38,2013,52.97368421,1361983243320,1361983244664,2404621440,2404622784,1344
1361983291,2404669268,1,89,89,1361983264484,1361983264484,2404642752,2404642752,0
1361983299,2404677212,37,1924,52,1361983274590,1361983275806,2404652802,2404654018,1216
1361983315,2404693516,1,158,158,1361983287467,1361983287467,2404665983,2404665983,0
1361983331,2404709480,37,1924,52,1361983305554,1361983306770,2404684034,2404685250,1216
1361983363,2404741584,38,1988,52.31578947,1361983336681,1361983338345,2404715265,2404716929,1664
1361983375,2404753468,1,158,158,1361983347549,1361983347549,2404726017,2404726017,0
1361983395,2404773516,38,1976,52,1361983368491,1361983392427,2404747007,2404770943,23936
1361983421,2404799304,9,3827,425.2222222,1361983419902,1361983420158,2404798206,2404798462,256
1361983421,2404799340,9,3742,415.7777778,1361983417820,1361983418076,2404796160,2404796416,256
1361983421,2404799416,9,3828,425.3333333,1361983418703,1361983418959,2404797119,2404797375,256
1361983423,2404801648,11,4566,415.0909091,1361983395558,1361983395750,2404774206,2404774398,192
1361983427,2404805548,38,1988,52.31578947,1361983399949,1361983401677,2404778497,2404780225,1728
1361983427,2404805624,1,78,78,1361983399485,1361983399485,2404778109,2404778109,0
1361983429,2404807368,9,3651,405.6666667,1361983420735,1361983421375,2404799103,2404799743,640
1361983453,2404831328,4,310,77.5,1361983449189,1361983449253,2404827517,2404827581,64
1361983455,2404833708,10,6834,683.4,1361983430379,1361983446763,2404809087,2404825471,16384
1361983459,2404837872,38,1988,52.31578947,1361983431368,1361983433288,2404810240,2404812160,1920
1361983461,2404839328,10,3832,383.2,1361983453030,1361983453286,2404831358,2404831614,256
1361983461,2404839328,10,3832,383.2,1361983453029,1361983453285,2404831357,2404831613,256
1361983480,2404857988,19,12133,638.5789474,1361983453628,1361983454076,2404831616,2404832064,448
1361983480,2404857988,26,21759,836.8846154,1361983453627,1361983454139,2404831615,2404832127,512
1361983484,2404861932,1,470,470,1361983457588,1361983457588,2404835520,2404835520,0
1361983492,2404870000,37,1924,52,1361983464109,1361983465517,2404842109,2404843517,1408
1361983500,2404878608,1,89,89,1361983472528,1361983472528,2404851136,2404851136,0
1361983501,2404879244,1,48,48,1361983475707,1361983475707,2404853951,2404853951,0
1361983520,2404898020,37,1924,52,1361983495512,1361983496856,2404873532,2404874876,1344
1361983524,2404901988,2,210,105,1361983497977,1361983497977,2404875965,2404875965,0
1361983540,2404918048,2,104,52,1361983513214,1361983513214,2404891262,2404891262,0
1361983540,2404918048,2,104,52,1361983513212,1361983513212,2404891260,2404891260,0
1361983552,2404930044,38,2013,52.97368421,1361983526848,1361983544896,2404904892,2404922940,18048
1361983580,2404958200,1,487,487,1361983555044,1361983555044,2404933244,2404933244,0
1361983584,2404962188,37,1924,52,1361983558000,1361983559280,2404936188,2404937468,1280
1361983592,2404970152,1,89,89,1361983566742,1361983566742,2404944894,2404944894,0
1361983616,2404994400,1,158,158,1361983587610,1361983587610,2404966010,2404966010,0
1361983616,2404994404,38,1988,52.31578947,1361983589081,1361983590681,2404967485,2404969085,1600
1361983637,2405015448,4,310,77.5,1361983635950,1361983636014,2405014398,2405014462,64
1361983648,2405026364,37,1924,52,1361983620737,1361983622017,2404999101,2405000381,1280
1361983672,2405050504,1,158,158,1361983647475,1361983647475,2405025979,2405025979,0
1361983680,2405058372,37,1924,52,1361983652023,1361983653239,2405030395,2405031611,1216
1361983708,2405086536,37,1924,52,1361983683091,1361983684435,2405061627,2405062971,1344
1361983728,2405106504,2,156,78,1361983701617,1361983701873,2405080121,2405080377,256
1361983740,2405118660,37,1924,52,1361983714325,1361983715541,2405092985,2405094201,1216
1361983764,2405142644,1,158,158,1361983737320,1361983737320,2405115964,2405115964,0
1361983772,2405150744,39,2052,52.61538462,1361983745474,1361983747458,2405124218,2405126202,1984
1361983781,2405159664,3,144,48,1361983780498,1361983780498,2405159162,2405159162,0
1361983781,2405159664,2,178,89,1361983780624,1361983780688,2405159288,2405159352,64
1361983804,2405182860,39,2052,52.61538462,1361983777358,1361983779342,2405156218,2405158202,1984
1361983808,2405186912,5,445,89,1361983781145,1361983802905,2405160057,2405181817,21760
1361983853,2405231064,1,89,89,1361983826986,1361983826986,2405205050,2405205050,0
1361983873,2405250992,6,534,89,1361983847023,1361983856431,2405225015,2405234423,9408
1361983897,2405275084,6,534,89,1361983869270,1361983878550,2405247354,2405256634,9280
1361983901,2405279044,1,89,89,1361983873469,1361983873469,2405251513,2405251513,0
1361985284,2406662304,1,60,60,1361985258595,1361985258595,2406636899,2406636899,0
1361986029,2407407552,1,48,48,1361986004255,1361986004255,2407382807,2407382807,0
1361986518,2407896592,1,46,46,1361986493041,1361986493041,2407871633,2407871633,0
1361987067,2408445456,1,48,48,1361987041330,1361987041330,2408419786,2408419786,0
1361989124,2410502364,1,46,46,1361989099371,1361989099371,2410477735,2410477735,0
1361989284,2410662384,1,56,56,1361989258455,1361989258455,2410636839,2410636839,0
1361989897,2411275176,1,46,46,1361989870429,1361989870429,2411248605,2411248605,0
1361990109,2411487536,1,46,46,1361990082483,1361990082483,2411461019,2411461019,0
1361991513,2412891280,1,46,46,1361991487836,1361991487836,2412866116,2412866116,0
1361991513,2412891352,1,46,46,1361991487830,1361991487830,2412866182,2412866182,0
1361991513,2412891684,1,46,46,1361991487498,1361991487498,2412866182,2412866182,0
1361991572,2412950792,1,46,46,1361991544541,1361991544541,2412923333,2412923333,0
1361991768,2413146572,1,46,46,1361991742580,1361991742580,2413121152,2413121152,0
1361992009,2413387820,1,48,48,1361991981369,1361991981369,2413360189,2413360189,0
1361992859,2414237852,1,46,46,1361992832270,1361992832270,2414211122,2414211122,0
1361995065,2416443300,1,71,71,1361995038100,1361995038100,2416416400,2416416400,0
1361995474,2416852516,1,46,46,1361995449526,1361995449526,2416828042,2416828042,0
1361996781,2418159716,1,144,144,1361996756185,1361996756185,2418134901,2418134901,0
1361997434,2418812052,1,46,46,1361997424230,1361997424230,2418802282,2418802282,0
1361997682,2419060240,1,48,48,1361997654311,1361997654311,2419032551,2419032551,0
1361998333,2419711680,1,46,46,1361998307173,1361998307173,2419685853,2419685853,0
1362000675,2422053152,1,52,52,1362000648594,1362000648594,2422026746,2422026746,0
1362000831,2422209692,1,46,46,1362000805811,1362000805811,2422184503,2422184503,0
1362001000,2422378112,1,46,46,1362000974327,1362000974327,2422352439,2422352439,0
1362001661,2423039484,2,96,48,1362001634810,1362001658874,2423013294,2423037358,24064
1362001714,2423091968,1,48,48,1362001688315,1362001688315,2423066283,2423066283,0
1362002146,2423524548,1,46,46,1362002121393,1362002121393,2423499941,2423499941,0
1362002230,2423608784,1,46,46,1362002205572,1362002205572,2423584356,2423584356,0
1362002677,2424055356,1,46,46,1362002651434,1362002651434,2424029790,2424029790,0
1362002678,2424056280,1,46,46,1362002651443,1362002651443,2424029723,2424029723,0
1362002678,2424056296,1,46,46,1362002651430,1362002651430,2424029726,2424029726,0
1362002678,2424056368,1,46,46,1362002651419,1362002651419,2424029787,2424029787,0
1362002782,2424160324,1,46,46,1362002755335,1362002755335,2424133659,2424133659,0
1362005719,2427097796,1,46,46,1362005692545,1362005692545,2427071341,2427071341,0
1362005929,2427306976,1,60,60,1362005902197,1362005902197,2427280173,2427280173,0
1362006357,2427734920,1,46,46,1362006329317,1362006329317,2427707237,2427707237,0
