unix_secs,sysuptime,dpkts,doctets,doctets/dpkts,Real First Packet,Real End Packet,first,last,Duration
1359739904,161289712,1,46,46,1359739876707,1359739876707,161262419,161262419,0
1359740096,161481840,1,46,46,1359740069282,1359740069282,161455122,161455122,0
1359740417,161802672,1,46,46,1359740390916,1359740390916,161776588,161776588,0
1359741551,162936968,1,46,46,1359741525577,1359741525577,162911545,162911545,0
1359742322,3096986372,1,46,46,1359742293898,1359742293898,3096958270,3096958270,0
1359742575,163960104,1,48,48,1359742548893,1359742548893,163933997,163933997,0
1359742770,164155664,3,230,76.66666667,1359742767911,1359742769255,164153575,164154919,1344
1359742797,164183032,3,267,89,1359742771642,1359742787770,164157674,164173802,16128
1359742837,164222956,1,89,89,1359742809410,1359742809410,164195366,164195366,0
1359742878,164263344,1,89,89,1359742853094,1359742853094,164238438,164238438,0
1359742966,164351716,11,3246,295.0909091,1359742940464,1359742941808,164326180,164327524,1344
1359743042,164427940,2,141,70.5,1359743038351,1359743038351,164424291,164424291,0
1359743062,164448088,9,3142,349.1111111,1359743036218,1359743039354,164422306,164425442,3136
1359743808,165194048,1,46,46,1359743782551,1359743782551,165168599,165168599,0
1359744077,165462708,1,46,46,1359744051560,1359744051560,165437268,165437268,0
1359746403,167788360,1,86,86,1359746377954,1359746377954,167763314,167763314,0
1359746459,167844452,1,46,46,1359746433731,1359746433731,167819183,167819183,0
1359746631,168016868,1,46,46,1359746604258,1359746604258,167990126,167990126,0
1359746648,168033520,6,497,82.83333333,1359746639935,1359746646719,168025455,168032239,6784
1359746680,168065372,2,178,89,1359746654097,1359746668625,168039469,168053997,14528
1359746724,168109620,1,89,89,1359746697495,1359746697495,168083115,168083115,0
1359746784,168169140,16,6327,395.4375,1359746777782,1359746778358,168162922,168163498,576
1359746784,168169140,16,6330,395.625,1359746777782,1359746778422,168162922,168163562,640
1359746784,168169144,16,5946,371.625,1359746778100,1359746778420,168163244,168163564,320
1359746784,168169144,14,3090,220.7142857,1359746778291,1359746778803,168163435,168163947,512
1359746784,168169144,4,369,92.25,1359746778737,1359746778801,168163881,168163945,64
1359746784,168169148,4,369,92.25,1359746778733,1359746778797,168163881,168163945,64
1359746784,168169148,4,369,92.25,1359746778737,1359746778801,168163885,168163949,64
1359746784,168169212,16,6329,395.5625,1359746777710,1359746778350,168162922,168163562,640
1359746784,168169212,15,6210,414,1359746777710,1359746778158,168162922,168163370,448
1359746784,168169212,21,9836,468.3809524,1359746777773,1359746778093,168162985,168163305,320
1359746784,168169216,14,4970,355,1359746781740,1359746782124,168166956,168167340,384
1359746784,168169216,16,6334,395.875,1359746777708,1359746778284,168162924,168163500,576
1359746784,168169216,16,6327,395.4375,1359746777708,1359746778348,168162924,168163564,640
1359746804,168189564,1,131,131,1359746777293,1359746777293,168162857,168162857,0
1359746804,168189564,11,3104,282.1818182,1359746777361,1359746777489,168162925,168163053,128
1359746804,168189564,1,111,111,1359746777296,1359746777296,168162860,168162860,0
1359746804,168189564,1,249,249,1359746777296,1359746777296,168162860,168162860,0
1359746804,168189564,1,88,88,1359746777487,1359746777487,168163051,168163051,0
1359746804,168189564,10,5910,591,1359746777550,1359746797454,168163114,168183018,19904
1359746804,168189564,1,163,163,1359746777614,1359746777614,168163178,168163178,0
1359746804,168189584,2,160,80,1359746778233,1359746796409,168163817,168181993,18176
1359746804,168189588,1,87,87,1359746778293,1359746778293,168163881,168163881,0
1359746804,168189588,1,146,146,1359746778293,1359746778293,168163881,168163881,0
1359746804,168189588,1,139,139,1359746778297,1359746778297,168163885,168163885,0
1359746804,168189588,1,79,79,1359746778297,1359746778297,168163885,168163885,0
1359746804,168189588,1,217,217,1359746778233,1359746778233,168163821,168163821,0
1359746804,168189588,1,87,87,1359746778297,1359746778297,168163885,168163885,0
1359746804,168189588,1,120,120,1359746778297,1359746778297,168163885,168163885,0
1359746804,168189588,1,147,147,1359746778296,1359746778296,168163884,168163884,0
1359746804,168189588,1,147,147,1359746778296,1359746778296,168163884,168163884,0
1359746804,168189588,1,146,146,1359746778296,1359746778296,168163884,168163884,0
1359746804,168189588,1,138,138,1359746778296,1359746778296,168163884,168163884,0
1359746804,168189588,1,121,121,1359746778296,1359746778296,168163884,168163884,0
1359746804,168189588,1,156,156,1359746778296,1359746778296,168163884,168163884,0
1359746804,168189600,1,76,76,1359746779371,1359746779371,168164971,168164971,0
1359746804,168189636,1,121,121,1359746777222,1359746777222,168162858,168162858,0
1359746804,168189636,1,120,120,1359746777222,1359746777222,168162858,168162858,0
1359746804,168189636,19,3996,210.3157895,1359746777286,1359746778118,168162922,168163754,832
1359746804,168189636,1,251,251,1359746777285,1359746777285,168162921,168162921,0
1359746804,168189668,1,102,102,1359746777704,1359746777704,168163372,168163372,0
1359746804,168189668,1,146,146,1359746778215,1359746778215,168163883,168163883,0
1359746804,168189668,1,147,147,1359746778215,1359746778215,168163883,168163883,0
1359746804,168189668,1,145,145,1359746778214,1359746778214,168163882,168163882,0
1359746804,168189668,1,139,139,1359746778214,1359746778214,168163882,168163882,0
1359746804,168189668,1,121,121,1359746778214,1359746778214,168163882,168163882,0
1359746804,168189668,1,120,120,1359746778214,1359746778214,168163882,168163882,0
1359746804,168189672,1,209,209,1359746778147,1359746778147,168163819,168163819,0
1359746804,168189672,2,212,106,1359746778147,1359746790563,168163819,168176235,12416
1359746804,168189672,1,186,186,1359746778147,1359746778147,168163819,168163819,0
1359746804,168189672,1,87,87,1359746778210,1359746778210,168163882,168163882,0
1359746804,168189672,1,146,146,1359746778210,1359746778210,168163882,168163882,0
1359746804,168189672,1,145,145,1359746778210,1359746778210,168163882,168163882,0
1359746804,168189672,1,146,146,1359746778210,1359746778210,168163882,168163882,0
1359746804,168189672,1,138,138,1359746778210,1359746778210,168163882,168163882,0
1359746804,168189672,1,139,139,1359746778210,1359746778210,168163882,168163882,0
1359746804,168189672,10,3045,304.5,1359746778274,1359746778338,168163946,168164010,64
1359746808,168193608,1,270,270,1359746779811,1359746779811,168165419,168165419,0
1359746808,168193624,1,129,129,1359746781267,1359746781267,168166891,168166891,0
1359746808,168193652,87,39534,454.4137931,1359746781752,1359746785592,168167404,168171244,3840
1359746808,168193656,19,6094,320.7368421,1359746782259,1359746783411,168167915,168169067,1152
1359746808,168193660,1,78,78,1359746782575,1359746782575,168168235,168168235,0
1359746808,168193664,1,90,90,1359746783084,1359746783084,168168748,168168748,0
1359746808,168193664,1,136,136,1359746782891,1359746782891,168168555,168168555,0
1359746808,168193732,1,98,98,1359746782181,1359746782181,168167913,168167913,0
1359746808,168193736,1,90,90,1359746782563,1359746782563,168168299,168168299,0
1359746808,168193736,1,83,83,1359746782689,1359746782689,168168425,168168425,0
1359746808,168193740,1,78,78,1359746783008,1359746783008,168168748,168168748,0
1359746816,168201620,1,84,84,1359746790616,1359746790616,168176236,168176236,0
1359746820,168205572,1,237,237,1359746792837,1359746792837,168178409,168178409,0
1359746820,168205608,6,1578,263,1359746793827,1359746794275,168179435,168179883,448
1359746824,168209672,1,265,265,1359746799716,1359746799716,168185388,168185388,0
1359746832,168217184,3,138,46,1359746827148,1359746827340,168212332,168212524,192
1359746832,168217752,2,212,106,1359746804692,1359746823828,168190444,168209580,19136
1359746836,168221872,2,603,301.5,1359746810523,1359746810587,168196395,168196459,64
1359746840,168225832,1,118,118,1359746814849,1359746814849,168200681,168200681,0
1359746840,168225832,9,3172,352.4444444,1359746814849,1359746814913,168200681,168200745,64
1359746844,168229884,1,209,209,1359746817423,1359746817423,168203307,168203307,0
1359746852,168237796,1,84,84,1359746826341,1359746826341,168212137,168212137,0
1359746852,168237804,1,80,80,1359746826848,1359746826848,168212652,168212652,0
1359746856,168241796,1,89,89,1359746829605,1359746829605,168215401,168215401,0
1359746864,168249944,4,1207,301.75,1359746838675,1359746840211,168224619,168226155,1536
1359746872,168257788,2,212,106,1359746843949,1359746864877,168229737,168250665,20928
1359746880,168265912,1,80,80,1359746855601,1359746855601,168241513,168241513,0
1359746884,168269900,1,137,137,1359746857149,1359746857149,168243049,168243049,0
1359746884,168269900,1,137,137,1359746857212,1359746857212,168243112,168243112,0
1359746904,168289976,1,209,209,1359746878897,1359746878897,168264873,168264873,0
1359746908,168293900,4,1092,273,1359746880255,1359746886143,168266155,168272043,5888
1359746912,168297796,2,212,106,1359746884579,1359746904547,168270375,168290343,19968
1359746912,168297912,1,80,80,1359746886576,1359746886576,168272488,168272488,0
1359746920,168305276,3,183,61,1359746914475,1359746918187,168299751,168303463,3712
1359746928,168313904,1,137,137,1359746901113,1359746901113,168287017,168287017,0
1359746940,168325904,1,80,80,1359746915512,1359746915512,168301416,168301416,0
1359746952,168337896,2,212,106,1359746924607,1359746944639,168310503,168330535,20032
1359746952,168337940,2,489,244.5,1359746926870,1359746926934,168312810,168312874,64
1359746964,168349948,1,209,209,1359746938827,1359746938827,168324775,168324775,0
1359746968,168353836,1,137,137,1359746940028,1359746940028,168325864,168325864,0
1359746972,168357844,1,80,80,1359746944693,1359746944693,168330537,168330537,0
1359746980,168365840,1,221,221,1359746951992,1359746951992,168337832,168337832,0
1359746980,168365840,3,395,131.6666667,1359746952056,1359746952056,168337896,168337896,0
1359746984,168369256,9,10495,1166.111111,1359746983041,1359746983297,168368297,168368553,256
1359746993,168378152,4,1093,273.25,1359746968680,1359746976360,168353832,168361512,7680
1359746993,168378164,2,212,106,1359746965340,1359746985180,168350504,168370344,19840
1359746993,168378232,9,3264,362.6666667,1359746967448,1359746967576,168352680,168352808,128
1359746993,168378288,1,258,258,1359746966754,1359746966754,168352042,168352042,0
1359746993,168378312,1,148,148,1359746967369,1359746967369,168352681,168352681,0
1359747005,168390236,1,80,80,1359746977107,1359746977107,168362343,168362343,0
1359747009,168394184,1,137,137,1359746981065,1359746981065,168366249,168366249,0
1359747009,168394224,1,159,159,1359746982880,1359746982880,168368104,168368104,0
1359747009,168394224,1,98,98,1359746983008,1359746983008,168368232,168368232,0
1359747009,168394224,3,390,130,1359746982942,1359746982942,168368166,168368166,0
1359747009,168394308,1,221,221,1359746982731,1359746982731,168368039,168368039,0
1359747009,168394308,3,395,131.6666667,1359746982731,1359746982795,168368039,168368103,64
1359747024,168409500,4,310,77.5,1359747018509,1359747018637,168404009,168404137,128
1359747025,168410364,1,209,209,1359746999380,1359746999380,168384744,168384744,0
1359747033,168418404,2,212,106,1359747004907,1359747025067,168390311,168410471,20160
1359747033,168418404,1,80,80,1359747004907,1359747004907,168390311,168390311,0
1359747037,168422396,1,52,52,1359747012533,1359747012533,168397929,168397929,0
1359747041,168426224,2,489,244.5,1359747016287,1359747016479,168401511,168401703,192
1359747045,168430376,1,217,217,1359747018758,1359747018758,168404134,168404134,0
1359747053,168438336,1,137,137,1359747025391,1359747025391,168410727,168410727,0
1359747056,168441568,4,310,77.5,1359747055174,1359747055302,168440742,168440870,128
1359747061,168446436,1,80,80,1359747036363,1359747036363,168421799,168421799,0
1359747073,168458368,2,212,106,1359747045071,1359747065231,168430439,168450599,20160
1359747081,168466296,4,1894,473.5,1359747056597,1359747059861,168441893,168445157,3264
1359747085,168470420,1,209,209,1359747059290,1359747059290,168444710,168444710,0
1359747088,168473516,18,6348,352.6666667,1359747085177,1359747085881,168470693,168471397,704
1359747089,168474284,1,169,169,1359747064227,1359747064227,168449511,168449511,0
1359747089,168474364,9,7504,833.7777778,1359747064146,1359747064978,168449510,168450342,832
1359747089,168474376,1,137,137,1359747064710,1359747064710,168450086,168450086,0
1359747093,168478336,1,80,80,1359747067375,1359747067375,168452711,168452711,0
1359747113,168498300,2,212,106,1359747085329,1359747105169,168470629,168490469,19840
1359747113,168498304,1,79,79,1359747085392,1359747085392,168470696,168470696,0
1359747113,168498388,1,156,156,1359747085305,1359747085305,168470693,168470693,0
1359747121,168506380,1,137,137,1359747095363,1359747095363,168480743,168480743,0
1359747121,168506388,1,80,80,1359747096123,1359747096123,168481511,168481511,0
1359747125,168510372,2,489,244.5,1359747100041,1359747100169,168485413,168485541,128
1359747129,168514376,1,52,52,1359747102663,1359747102663,168488039,168488039,0
1359747129,168514464,1,52,52,1359747102830,1359747102830,168488294,168488294,0
1359747144,168529576,18,9233,512.9444444,1359747142269,1359747143165,168527845,168528741,896
1359747145,168530832,1,209,209,1359747118975,1359747118975,168504807,168504807,0
1359747149,168534796,2,212,106,1359747124705,1359747144737,168510501,168530533,20032
1359747152,168537552,10,6173,617.3,1359747147222,1359747147990,168532774,168533542,768
1359747152,168537632,71,73750,1038.732394,1359747143173,1359747145989,168528805,168531621,2816
1359747153,168538712,1,80,80,1359747125111,1359747125111,168510823,168510823,0
1359747153,168538860,1,137,137,1359747127008,1359747127008,168512868,168512868,0
1359747157,168542756,1,89,89,1359747131978,1359747131978,168517734,168517734,0
1359747160,168545564,22,9309,423.1363636,1359747145673,1359747154185,168531237,168539749,8512
1359747160,168545648,12,1985,165.4166667,1359747154103,1359747154615,168539751,168540263,512
1359747165,168550876,4,1090,272.5,1359747139536,1359747150032,168525412,168535908,10496
1359747168,168553572,8,646,80.75,1359747145410,1359747165954,168530982,168551526,20544
1359747169,168554872,1,84,84,1359747141846,1359747141846,168527718,168527718,0
1359747173,168558736,41,54541,1330.268293,1359747144923,1359747145627,168530659,168531363,704
1359747173,168558740,1,303,303,1359747145243,1359747145243,168530983,168530983,0
1359747173,168558740,7,4817,688.1428571,1359747145307,1359747145627,168531047,168531367,320
1359747173,168558740,45,60734,1349.644444,1359747145624,1359747146008,168531364,168531748,384
1359747173,168558740,6,1974,329,1359747145624,1359747145752,168531364,168531492,128
1359747173,168558740,5,2244,448.8,1359747145624,1359747145944,168531364,168531684,320
1359747173,168558740,1,193,193,1359747145624,1359747145624,168531364,168531364,0
1359747173,168558776,1,118,118,1359747146932,1359747146932,168532708,168532708,0
1359747173,168558780,7,2584,369.1428571,1359747146991,1359747147055,168532771,168532835,64
1359747173,168558816,1,185,185,1359747144845,1359747144845,168530661,168530661,0
1359747173,168558820,7,4524,646.2857143,1359747145226,1359747145546,168531046,168531366,320
1359747173,168558820,1,293,293,1359747145352,1359747145352,168531172,168531172,0
1359747173,168558820,9,5532,614.6666667,1359747145543,1359747146887,168531363,168532707,1344
1359747173,168558824,9,6524,724.8888889,1359747145543,1359747146887,168531367,168532711,1344
1359747173,168558824,10,10072,1007.2,1359747145543,1359747145991,168531367,168531815,448
1359747173,168558864,1,170,170,1359747146846,1359747146846,168532710,168532710,0
1359747181,168566760,1,123,123,1359747153925,1359747153925,168539685,168539685,0
1359747181,168566912,1,80,80,1359747156460,1359747156460,168542372,168542372,0
1359747184,168569600,9,4721,524.5555556,1359747182372,1359747182628,168567972,168568228,256
1359747184,168569640,9,3571,396.7777778,1359747177787,1359747178107,168563427,168563747,320
1359747185,168570860,1,137,137,1359747157279,1359747157279,168543139,168543139,0
1359747189,168574924,2,212,106,1359747164386,1359747184546,168550310,168570470,20160
1359747192,168577580,16,11037,689.8125,1359747185146,1359747189882,168570726,168575462,4736
1359747192,168577580,8,3543,442.875,1359747185146,1359747185402,168570726,168570982,256
1359747192,168577580,18,13989,777.1666667,1359747185146,1359747189882,168570726,168575462,4736
1359747192,168577584,8,2061,257.625,1359747185462,1359747185654,168571046,168571238,192
1359747192,168577584,8,851,106.375,1359747185653,1359747185781,168571237,168571365,128
1359747192,168577584,20,10646,532.3,1359747184372,1359747184948,168569956,168570532,576
1359747192,168577592,8,1133,141.625,1359747184751,1359747184879,168570343,168570471,128
1359747192,168577592,10,9637,963.7,1359747182380,1359747187500,168567972,168573092,5120
1359747192,168577620,15,9524,634.9333333,1359747183377,1359747189521,168568997,168575141,6144
1359747192,168577628,8,1869,233.625,1359747185608,1359747185736,168571236,168571364,128
1359747192,168577628,7,735,105,1359747185607,1359747185735,168571235,168571363,128
1359747192,168577632,82,103353,1260.402439,1359747178245,1359747189637,168563877,168575269,11392
1359747192,168577664,9,1745,193.8888889,1359747182310,1359747184678,168567974,168570342,2368
1359747192,168577664,9,3442,382.4444444,1359747184870,1359747185126,168570534,168570790,256
1359747192,168577664,28,22579,806.3928571,1359747182373,1359747189541,168568037,168575205,7168
1359747192,168577668,60,73889,1231.483333,1359747182879,1359747189535,168568547,168575203,6656
1359747200,168585660,15,9777,651.8,1359747182568,1359747195880,168568228,168581540,13312
1359747200,168585736,19,12487,657.2105263,1359747183579,1359747195803,168569315,168581539,12224
1359747205,168590788,1,69,69,1359747177322,1359747177322,168563110,168563110,0
1359747205,168590788,37,45591,1232.189189,1359747177321,1359747185193,168563109,168570981,7872
1359747205,168590804,23,23564,1024.521739,1359747178647,1359747179799,168564451,168565603,1152
1359747205,168590804,70,87746,1253.514286,1359747178647,1359747182615,168564451,168568419,3968
1359747205,168590868,5,3331,666.2,1359747177242,1359747177370,168563110,168563238,128
1359747205,168590872,1,104,104,1359747177555,1359747177555,168563427,168563427,0
1359747205,168590872,1,140,140,1359747177558,1359747177558,168563430,168563430,0
1359747205,168590872,1,129,129,1359747177875,1359747177875,168563747,168563747,0
1359747205,168590880,1,115,115,1359747178510,1359747178510,168564390,168564390,0
1359747205,168590904,44,52120,1184.545455,1359747178547,1359747179891,168564451,168565795,1344
1359747205,168590908,1,209,209,1359747178927,1359747178927,168564835,168564835,0
1359747205,168590912,5,346,69.2,1359747179628,1359747179692,168565540,168565604,64
1359747208,168593596,35,34868,996.2285714,1359747201130,1359747202538,168586726,168588134,1408
1359747208,168593600,7,586,83.71428571,1359747184294,1359747205926,168569894,168591526,21632
1359747208,168593640,3,164,54.66666667,1359747183675,1359747202427,168569315,168588067,18752
1359747208,168593644,3,164,54.66666667,1359747185399,1359747202423,168571043,168588067,17024
1359747208,168593684,8,799,99.875,1359747182671,1359747205839,168568355,168591523,23168
1359747209,168594788,1,84,84,1359747184103,1359747184103,168569891,168569891,0
1359747209,168594792,14,10946,781.8571429,1359747184101,1359747203749,168569893,168589541,19648
1359747209,168594796,15,8923,594.8666667,1359747184352,1359747206496,168570148,168592292,22144
1359747209,168594820,1,262,262,1359747182089,1359747182089,168567909,168567909,0
1359747209,168594820,1,80,80,1359747184649,1359747184649,168570469,168570469,0
1359747209,168594820,1,116,116,1359747182089,1359747182089,168567909,168567909,0
1359747209,168594820,1,105,105,1359747184713,1359747184713,168570533,168570533,0
1359747209,168594820,1,130,130,1359747184713,1359747184713,168570533,168570533,0
1359747209,168594820,9,3627,403,1359747184712,1359747184840,168570532,168570660,128
1359747209,168594820,1,138,138,1359747182215,1359747182215,168568035,168568035,0
1359747209,168594824,1,148,148,1359747182086,1359747182086,168567910,168567910,0
1359747209,168594824,1,162,162,1359747182086,1359747182086,168567910,168567910,0
1359747209,168594824,11,8633,784.8181818,1359747182278,1359747182598,168568102,168568422,320
1359747209,168594824,1,148,148,1359747182341,1359747182341,168568165,168568165,0
1359747209,168594828,1,150,150,1359747183040,1359747183040,168568868,168568868,0
1359747209,168594828,7,4986,712.2857143,1359747183103,1359747183679,168568931,168569507,576
1359747209,168594832,9,4657,517.4444444,1359747183163,1359747183803,168568995,168569635,640
1359747209,168594832,1,105,105,1359747183038,1359747183038,168568870,168568870,0
1359747209,168594832,1,148,148,1359747183101,1359747183101,168568933,168568933,0
1359747209,168594860,9,6779,753.2222222,1359747183586,1359747184930,168569446,168570790,1344
1359747209,168594872,1,168,168,1359747184085,1359747184085,168569957,168569957,0
1359747209,168594900,3,1926,642,1359747184312,1359747184376,168570212,168570276,64
1359747209,168594908,1,264,264,1359747184624,1359747184624,168570532,168570532,0
1359747209,168594908,1,157,157,1359747182000,1359747182000,168567908,168567908,0
1359747209,168594908,42,55887,1330.642857,1359747181999,1359747182511,168567907,168568419,512
1359747209,168594912,48,65408,1362.666667,1359747182059,1359747183851,168567971,168569763,1792
1359747209,168594912,55,79199,1439.981818,1359747182059,1359747182443,168567971,168568355,384
1359747209,168594912,8,5691,711.375,1359747184685,1359747184813,168570597,168570725,128
1359747209,168594912,1,115,115,1359747182251,1359747182251,168568163,168568163,0
1359747209,168594912,1,154,154,1359747184747,1359747184747,168570659,168570659,0
1359747209,168594912,1,130,130,1359747182251,1359747182251,168568163,168568163,0
1359747209,168594916,14,3637,259.7857143,1359747182314,1359747184618,168568230,168570534,2304
1359747209,168594916,86,108435,1260.872093,1359747182505,1359747184873,168568421,168570789,2368
1359747209,168594916,1,105,105,1359747182568,1359747182568,168568484,168568484,0
1359747209,168594940,1,156,156,1359747182928,1359747182928,168568868,168568868,0
1359747209,168594940,8,4958,619.75,1359747182992,1359747183568,168568932,168569508,576
1359747209,168594944,1,190,190,1359747183115,1359747183115,168569059,168569059,0
1359747213,168598784,1,97,97,1359747184877,1359747184877,168570661,168570661,0
1359747213,168598868,10,3843,384.3,1359747184856,1359747205528,168570724,168591396,20672
1359747216,168601596,4,276,69,1359747214055,1359747214247,168599651,168599843,192
1359747217,168602792,1,137,137,1359747189604,1359747189604,168575396,168575396,0
1359747217,168602792,1,46,46,1359747192228,1359747192228,168578020,168578020,0
1359747217,168602828,1,77,77,1359747190654,1359747190654,168576482,168576482,0
1359747217,168602828,2,489,244.5,1359747190402,1359747190530,168576230,168576358,128
1359747217,168602832,7,3902,557.4285714,1359747190718,1359747190846,168576550,168576678,128
1359747217,168602912,7,3902,557.4285714,1359747190638,1359747190702,168576550,168576614,64
1359747221,168606856,1,46,46,1359747195750,1359747195750,168581606,168581606,0
1359747221,168606856,1,46,46,1359747195750,1359747195750,168581606,168581606,0
1359747221,168606856,1,46,46,1359747195750,1359747195750,168581606,168581606,0
1359747221,168606928,1,46,46,1359747195675,1359747195675,168581603,168581603,0
1359747221,168606928,1,46,46,1359747195675,1359747195675,168581603,168581603,0
1359747221,168606928,1,46,46,1359747195675,1359747195675,168581603,168581603,0
1359747224,168609692,3,164,54.66666667,1359747204361,1359747222409,168590053,168608101,18048
1359747229,168614888,11,11946,1086,1359747202884,1359747203588,168588772,168589476,704
1359747229,168614888,5,6275,1255,1359747202884,1359747203652,168588772,168589540,768
1359747229,168614888,1,84,84,1359747202947,1359747202947,168588835,168588835,0
1359747229,168614972,27,19313,715.2962963,1359747203186,1359747212082,168589158,168598054,8896
1359747229,168615004,2,212,106,1359747204432,1359747224336,168590436,168610340,19904
1359747237,168622908,19,27302,1436.947368,1359747211823,1359747211887,168597731,168597795,64
1359747237,168622916,1,193,193,1359747212456,1359747212456,168598372,168598372,0
1359747237,168622916,7,1500,214.2857143,1359747212456,1359747235624,168598372,168621540,23168
1359747237,168622948,16,7398,462.375,1359747210441,1359747234889,168596389,168620837,24448
1359747241,168626920,6,471,78.5,1359747215330,1359747235490,168601250,168621410,20160
1359747241,168626964,1,80,80,1359747216439,1359747216439,168602403,168602403,0
1359747248,168633656,3,193,64.33333333,1359747245035,1359747245867,168630691,168631523,832
1359747256,168641620,2,141,70.5,1359747250190,1359747250190,168635810,168635810,0
1359747256,168641628,2,141,70.5,1359747251016,1359747251016,168636644,168636644,0
1359747256,168641628,2,141,70.5,1359747251015,1359747251015,168636643,168636643,0
1359747257,168642984,2,489,244.5,1359747230565,1359747230757,168616549,168616741,192
1359747257,168643008,1,137,137,1359747231243,1359747231243,168617251,168617251,0
1359747265,168650864,2,104,52,1359747237340,1359747245660,168623204,168631524,8320
1359747265,168650988,1,209,209,1359747238815,1359747238815,168624803,168624803,0
1359747265,168650992,15,7415,494.3333333,1359747238941,1359747263581,168624933,168649573,24640
1359747273,168658872,1,80,80,1359747245203,1359747245203,168631075,168631075,0
1359747273,168658876,9,2941,326.7777778,1359747245390,1359747266318,168631266,168652194,20928
1359747273,168658956,2,212,106,1359747245119,1359747267519,168631075,168653475,22400
1359747273,168659008,2,601,300.5,1359747246925,1359747247181,168632933,168633189,256
1359747281,168666884,1,52,52,1359747255625,1359747255625,168641509,168641509,0
1359747281,168666884,1,52,52,1359747255689,1359747255689,168641573,168641573,0
1359747281,168666884,1,52,52,1359747255625,1359747255625,168641509,168641509,0
1359747293,168679036,13,6304,484.9230769,1359747267632,1359747289584,168653668,168675620,21952
1359747298,168683204,2,489,244.5,1359747270833,1359747270897,168656037,168656101,64
1359747302,168687172,1,80,80,1359747277838,1359747277838,168663010,168663010,0
1359747302,168687292,1,137,137,1359747274967,1359747274967,168660259,168660259,0
1359747302,168687344,8,5556,694.5,1359747276836,1359747293924,168662180,168679268,17088
1359747304,168689712,2,157,78.5,1359747297331,1359747297331,168683043,168683043,0
1359747314,168699292,2,212,106,1359747287384,1359747306648,168672676,168691940,19264
1359747320,168705740,6,1054,175.6666667,1359747312470,1359747312662,168698210,168698402,192
1359747322,168707260,12,5314,442.8333333,1359747294457,1359747317945,168679717,168703205,23488
1359747326,168711156,2,1416,708,1359747298141,1359747298205,168683297,168683361,64
1359747326,168711288,1,209,209,1359747299803,1359747299803,168685091,168685091,0
1359747330,168715304,6,471,78.5,1359747303883,1359747323979,168689187,168709283,20096
1359747334,168719156,1,80,80,1359747306784,1359747306784,168691940,168691940,0
1359747334,168719324,1,52,52,1359747306232,1359747306232,168691556,168691556,0
1359747334,168719348,2,434,217,1359747306589,1359747318941,168691937,168704289,12352
1359747336,168721732,3,209,69.66666667,1359747333341,1359747335773,168719073,168721505,2432
1359747338,168723156,1,133,133,1359747312926,1359747312926,168698082,168698082,0
1359747338,168723156,3,540,180,1359747312990,1359747313054,168698146,168698210,64
1359747338,168723160,1,76,76,1359747313051,1359747313051,168698211,168698211,0
1359747338,168723224,1,137,137,1359747312025,1359747312025,168697249,168697249,0
1359747354,168739316,2,212,106,1359747327229,1359747347389,168712545,168732705,20160
1359747354,168739352,4,3022,755.5,1359747327899,1359747347995,168713251,168733347,20096
1359747362,168747256,6,471,78.5,1359747333947,1359747353979,168719203,168739235,20032
1359747362,168747288,1,80,80,1359747337113,1359747337113,168722401,168722401,0
1359747366,168751184,4,1291,322.75,1359747338691,1359747347075,168723875,168732259,8384
1359747368,168753740,3,159,53,1359747365333,1359747365781,168751073,168751521,448
1359747368,168753740,3,159,53,1359747365333,1359747365781,168751073,168751521,448
1359747368,168753748,154,216995,1409.058442,1359747177679,1359747365775,168563427,168751523,188096
1359747368,168753752,2,157,78.5,1359747366282,1359747366282,168752034,168752034,0
1359747369,168754108,3,159,53,1359747364175,1359747366415,168749283,168751523,2240
1359747369,168754108,2,131,65.5,1359747368013,1359747368013,168753121,168753121,0
1359747370,168755176,3,209,69.66666667,1359747365898,1359747366346,168751074,168751522,448
1359747374,168759212,1,137,137,1359747345956,1359747345956,168731168,168731168,0
1359747386,168771208,8,3230,403.75,1359747358250,1359747379626,168743458,168764834,21376
1359747386,168771368,1,209,209,1359747359691,1359747359691,168745059,168745059,0
1359747390,168775336,6,471,78.5,1359747363880,1359747383912,168749216,168769248,20032
1359747392,168777792,2,157,78.5,1359747391266,1359747391266,168777058,168777058,0
1359747394,168779196,1,80,80,1359747365943,1359747365943,168751139,168751139,0
1359747394,168779236,2,212,106,1359747367436,1359747387404,168752672,168772640,19968
1359747400,168785820,6,524,87.33333333,1359747394244,1359747395972,168780064,168781792,1728
1359747400,168785832,15,6210,414,1359747398907,1359747399291,168784739,168785123,384
1359747402,168787196,2,104,52,1359747374005,1359747382837,168759201,168768033,8832
1359747402,168787276,1,52,52,1359747376356,1359747376356,168761632,168761632,0
1359747402,168787312,1,52,52,1359747376834,1359747376834,168762146,168762146,0
1359747406,168791248,2,1472,736,1359747380673,1359747380801,168765921,168766049,128
1359747406,168791248,1,84,84,1359747380737,1359747380737,168765985,168765985,0
1359747406,168791292,2,109,54.5,1359747378772,1359747386260,168764064,168771552,7488
1359747406,168791360,6,741,123.5,1359747380689,1359747381073,168766049,168766433,384
1359747414,168799224,1,137,137,1359747386649,1359747386649,168771873,168771873,0
1359747414,168799232,1,156,156,1359747387409,1359747387409,168772641,168772641,0
1359747414,168799292,6,3126,521,1359747389591,1359747410839,168774883,168796131,21248
1359747414,168799336,1,79,79,1359747387304,1359747387304,168772640,168772640,0
1359747422,168807232,10,891,89.1,1359747393938,1359747414098,168779170,168799330,20160
1359747422,168807284,1,60,60,1359747396828,1359747396828,168782112,168782112,0
1359747422,168807284,1,52,52,1359747396828,1359747396828,168782112,168782112,0
1359747422,168807408,1,80,80,1359747397155,1359747397155,168782563,168782563,0
1359747424,168809764,782,1136038,1452.734015,1359747182142,1359747423742,168567906,168809506,241600
1359747426,168811348,1,95,95,1359747398363,1359747398363,168783711,168783711,0
1359747432,168817760,4,310,77.5,1359747424767,1359747424767,168810527,168810527,0
1359747432,168817764,4,310,77.5,1359747424894,1359747424894,168810658,168810658,0
1359747434,168819272,1,52,52,1359747406249,1359747406249,168791521,168791521,0
1359747434,168819420,2,212,106,1359747407253,1359747426517,168792673,168811937,19264
1359747446,168831432,5,3074,614.8,1359747420810,1359747440906,168806242,168826338,20096
1359747446,168831508,1,209,209,1359747419709,1359747419709,168805217,168805217,0
1359747446,168831548,2,490,245,1359747421267,1359747421331,168806815,168806879,64
1359747448,168833808,2,157,78.5,1359747445714,1359747445714,168831522,168831522,0
1359747450,168835384,1,137,137,1359747424377,1359747424377,168809761,168809761,0
1359747450,168835548,6,471,78.5,1359747423638,1359747443798,168809186,168829346,20160
1359747454,168839656,1,80,80,1359747426280,1359747426280,168811936,168811936,0
1359747456,168841764,39,31788,815.0769231,1359747434878,1359747447998,168820642,168833762,13120
1359747456,168841792,2,157,78.5,1359747455715,1359747455715,168841507,168841507,0
1359747458,168843744,1,89,89,1359747433554,1359747433554,168819298,168819298,0
1359747462,168847692,1,248,248,1359747436612,1359747436612,168822304,168822304,0
1359747462,168847720,1,117,117,1359747436650,1359747436650,168822370,168822370,0
1359747462,168847768,1,84,84,1359747434809,1359747434809,168820577,168820577,0
1359747462,168847784,1,84,84,1359747436138,1359747436138,168821922,168821922,0
1359747462,168847784,13,10432,802.4615385,1359747436138,1359747436266,168821922,168822050,128
1359747462,168847808,7,3562,508.8571429,1359747436560,1359747436688,168822368,168822496,128
1359747462,168847808,8,882,110.25,1359747436559,1359747436687,168822367,168822495,128
1359747474,168859712,7,7985,1140.714286,1359747448049,1359747448241,168833761,168833953,192
1359747474,168859760,2,212,106,1359747446722,1359747466754,168832482,168852514,20032
1359747478,168863784,10,5910,591,1359747453418,1359747474346,168839202,168860130,20928
1359747478,168863796,5,3074,614.8,1359747450650,1359747475738,168836446,168861534,25088
1359747482,168867732,162,210863,1301.623457,1359747178716,1359747180124,168564448,168565856,1408
1359747482,168867784,1,80,80,1359747457191,1359747457191,168842975,168842975,0
1359747482,168867788,1,137,137,1359747457254,1359747457254,168843042,168843042,0
1359747486,168871816,4,1956,489,1359747461578,1359747476810,168847394,168862626,15232
1359747486,168871856,1,52,52,1359747459362,1359747459362,168845218,168845218,0
1359747488,168873820,2,157,78.5,1359747485701,1359747485701,168871521,168871521,0
1359747488,168873820,2,157,78.5,1359747485701,1359747485701,168871521,168871521,0
1359747488,168873820,2,157,78.5,1359747485701,1359747485701,168871521,168871521,0
1359747488,168873820,2,157,78.5,1359747485701,1359747485701,168871521,168871521,0
1359747488,168873820,2,157,78.5,1359747485701,1359747485701,168871521,168871521,0
1359747488,168873856,260,342790,1318.423077,1359747178594,1359747485666,168564450,168871522,307072
1359747496,168881824,7,457,65.28571429,1359747491714,1359747492674,168877538,168878498,960
1359747496,168881828,16,6280,392.5,1359747492029,1359747493629,168877857,168879457,1600
1359747496,168881828,3,209,69.66666667,1359747484284,1359747489084,168870112,168874912,4800
1359747496,168881828,16,6256,391,1359747492347,1359747493883,168878175,168879711,1536
1359747496,168881880,15,6237,415.8,1359747491847,1359747493575,168877727,168879455,1728
1359747496,168881880,15,6234,415.6,1359747491975,1359747493575,168877855,168879455,1600
1359747496,168881880,15,6241,416.0666667,1359747491910,1359747493574,168877790,168879454,1664
1359747496,168881880,15,4782,318.8,1359747492038,1359747493830,168877918,168879710,1792
1359747502,168887792,2,379,189.5,1359747476831,1359747477087,168862623,168862879,256
1359747504,168889752,6,349,58.16666667,1359747496200,1359747503368,168881952,168889120,7168
1359747506,168891908,1,209,209,1359747479723,1359747479723,168865631,168865631,0
1359747510,168895836,1,46,46,1359747485682,1359747485682,168871518,168871518,0
1359747510,168895836,1,46,46,1359747485682,1359747485682,168871518,168871518,0
1359747510,168895928,1,46,46,1359747485590,1359747485590,168871518,168871518,0
1359747510,168895928,1,46,46,1359747485590,1359747485590,168871518,168871518,0
1359747512,168897876,2,104,52,1359747505547,1359747510155,168891423,168896031,4608
1359747514,168899752,2,1042,521,1359747485830,1359747485830,168871582,168871582,0
1359747514,168899840,1,106,106,1359747485872,1359747485872,168871712,168871712,0
1359747514,168899840,1,80,80,1359747485872,1359747485872,168871712,168871712,0
1359747518,168903772,5,1059,211.8,1359747491188,1359747517364,168876960,168903136,26176
1359747518,168903896,2,274,137,1359747492151,1359747492983,168878047,168878879,832
1359747518,168903928,3,180,60,1359747492953,1359747492953,168878881,168878881,0
1359747520,168905844,11,2550,231.8181818,1359747495789,1359747518317,168881633,168904161,22528
1359747522,168907764,12,7094,591.1666667,1359747496060,1359747516540,168881824,168902304,20480
1359747522,168907920,1,149,149,1359747495585,1359747495585,168881505,168881505,0
1359747544,168929828,2,104,52,1359747519483,1359747537915,168905311,168923743,18432
1359747544,168929880,6,312,52,1359747535750,1359747543174,168921630,168929054,7424
1359747546,168931796,5,2190,438,1359747517916,1359747536284,168903712,168922080,18368
1359747546,168931844,3,267,89,1359747521069,1359747537709,168906913,168923553,16640
1359747560,168945856,6,447,74.5,1359747556192,1359747559520,168942048,168945376,3328
1359747560,168945904,2,442,221,1359747536943,1359747556079,168922847,168941983,19136
1359747568,168953812,2,104,52,1359747550988,1359747566348,168936800,168952160,15360
1359747576,168961880,2,158,79,1359747563079,1359747570183,168948959,168956063,7104
1359747582,168967840,1,438,438,1359747555821,1359747555821,168941661,168941661,0
1359747586,168971964,1,89,89,1359747559731,1359747559731,168945695,168945695,0
1359747600,168985872,5,368,73.6,1359747596944,1359747599376,168982816,168985248,2432
1359747606,168991808,1,390,390,1359747578125,1359747578125,168963933,168963933,0
1359747608,168993888,2,158,79,1359747602175,1359747607743,168988063,168993631,5568
1359747611,168996220,1,79,79,1359747585115,1359747585115,168970335,168970335,0
1359747622,169007932,1,438,438,1359747594836,1359747594836,168980768,168980768,0
1359747622,169007968,1,52,52,1359747596973,1359747596973,168982941,168982941,0
1359747630,169015856,1,89,89,1359747604062,1359747604062,168989918,168989918,0
1359747638,169023928,1,79,79,1359747612886,1359747612886,168998814,168998814,0
1359747646,169032016,2,158,79,1359747618816,1359747641152,169004832,169027168,22336
1359747680,169066000,7,710,101.4285714,1359747676493,1359747679821,169062493,169065821,3328
1359747713,169098236,2,157,78.5,1359747712519,1359747712519,169097755,169097755,0
1359747714,169099980,1,79,79,1359747685923,1359747685923,169071903,169071903,0
1359747738,169124004,6,630,105,1359747712073,1359747730505,169098077,169116509,18432
1359747763,169148148,6,534,89,1359747736607,1359747745439,169121755,169130587,8832
1359747763,169148192,1,46,46,1359747737651,1359747737651,169122843,169122843,0
1359747775,169160180,1,105,105,1359747750399,1359747750399,169135579,169135579,0
1359747815,169200148,1,105,105,1359747788513,1359747788513,169173661,169173661,0
1359747871,169256516,2,104,52,1359747845485,1359747848493,169231001,169234009,3008
1359747871,169256528,2,104,52,1359747846562,1359747849634,169232090,169235162,3072
1359747875,169260352,2,104,52,1359747847891,1359747850899,169233243,169236251,3008
1359747875,169260432,2,104,52,1359747847810,1359747850818,169233242,169236250,3008
1359747923,169308424,418,118461,283.3995215,1359746779979,1359747621323,168165403,169006747,841344
1359747931,169316416,303,101070,333.5643564,1359746814739,1359747630227,168200155,169015643,815488
1359747953,169338288,5,472,94.4,1359747948690,1359747951058,169333978,169336346,2368
1359747979,169364552,3,315,105,1359747953546,1359747970122,169339098,169355674,16576
1359748019,169404704,1,105,105,1359747991984,1359747991984,169377688,169377688,0
1359748063,169448616,1,105,105,1359748036232,1359748036232,169421848,169421848,0
1359748197,169582376,1,46,46,1359748168501,1359748168501,169553877,169553877,0
1359749198,170583872,2,96,48,1359749171318,1359749174326,170557190,170560198,3008
1359750193,3104856876,1,46,46,1359750165808,1359750165808,3104829684,3104829684,0
1359750236,171621904,5,250,50,1359750208452,1359750229828,171594356,171615732,21376
1359750280,171665880,1,48,48,1359750253981,1359750253981,171639861,171639861,0
1359750308,171693948,1,48,48,1359750282968,1359750282968,171668916,171668916,0
1359751964,173349996,1,48,48,1359751937681,1359751937681,173323677,173323677,0
1359752471,173856608,1,46,46,1359752442890,1359752442890,173828498,173828498,0
1359753015,174400548,1,64,64,1359752988226,1359752988226,174373774,174373774,0
1359753054,3107718096,1,48,48,1359753025637,1359753025637,3107689733,3107689733,0
1359753624,175009440,1,48,48,1359753596259,1359753596259,174981699,174981699,0
1359755400,176785936,1,46,46,1359755374808,1359755374808,176760744,176760744,0
1359987885,409269420,1,52,52,1359987857627,1359987857627,409242047,409242047,0
1359989752,411136760,1,46,46,1359989724007,1359989724007,411108767,411108767,0
1359989824,411209144,64,84825,1325.390625,1359989817767,1359989818215,411202911,411203359,448
1359989832,411217116,9,4413,490.3333333,1359989817157,1359989824325,411202273,411209441,7168
1359989832,411217116,7,4088,584,1359989825412,1359989829444,411210528,411214560,4032
1359989832,411217160,5,704,140.8,1359989828183,1359989829271,411213343,411214431,1088
1359989832,411217164,7,4120,588.5714286,1359989825300,1359989829396,411210464,411214560,4096
1359989840,411224900,1,76,76,1359989814812,1359989814812,411199712,411199712,0
1359989840,411225144,9,4368,485.3333333,1359989839334,1359989839782,411224478,411224926,448
1359989840,411225144,12,5776,481.3333333,1359989835943,1359989837991,411221087,411223135,2048
1359989840,411225152,4,216,54,1359989833314,1359989838242,411218466,411223394,4928
1359989840,411225152,6,1448,241.3333333,1359989833696,1359989835296,411218848,411220448,1600
1359989840,411225156,11,5708,518.9090909,1359989834525,1359989835869,411219681,411221025,1344
1359989844,411228840,9,3729,414.3333333,1359989816280,1359989834584,411201120,411219424,18304
1359989844,411228848,1,76,76,1359989817744,1359989817744,411202592,411202592,0
1359989844,411228852,1,76,76,1359989817994,1359989817994,411202846,411202846,0
1359989844,411228884,29,27574,950.8275862,1359989819756,1359989842028,411204640,411226912,22272
1359989844,411228928,11,5420,492.7272727,1359989819713,1359989820353,411204641,411205281,640
1359989848,411232940,58,18097,312.0172414,1359989822898,1359989836146,411207838,411221086,13248
1359989848,411233104,11,3894,354,1359989839632,1359989840656,411224736,411225760,1024
1359989848,411233120,4,216,54,1359989837759,1359989846143,411222879,411231263,8384
1359989848,411233148,13,4522,347.8461538,1359989838501,1359989841061,411223649,411226209,2560
1359989848,411233148,13,4630,356.1538462,1359989839267,1359989841571,411224415,411226719,2304
1359989848,411233152,10,1093,109.3,1359989847070,1359989847646,411232222,411232798,576
1359989848,411233188,12,3169,264.0833333,1359989838394,1359989841082,411223582,411226270,2688
1359989848,411233188,13,5158,396.7692308,1359989838458,1359989841082,411223646,411226270,2624
1359989848,411233196,10,2022,202.2,1359989847093,1359989847605,411232289,411232801,512
1359989852,411236876,10,4696,469.6,1359989823858,1359989839026,411208734,411223902,15168
1359989852,411236928,14,4861,347.2142857,1359989825408,1359989827264,411210336,411212192,1856
1359989856,411241132,11,2802,254.7272727,1359989852981,1359989854005,411238113,411239137,1024
1359989856,411241140,11,2694,244.9090909,1359989854125,1359989855213,411239265,411240353,1088
1359989856,411241168,11,2932,266.5454545,1359989851726,1359989852750,411236894,411237918,1024
1359989856,411241168,12,3367,280.5833333,1359989848144,1359989851600,411233312,411236768,3456
1359989864,411248892,6,4036,672.6666667,1359989837282,1359989839586,411222174,411224478,2304
1359989864,411248940,10,6430,643,1359989837171,1359989852019,411222111,411236959,14848
1359989864,411248980,37,37090,1002.432432,1359989839434,1359989858378,411224414,411243358,18944
1359989864,411249132,216,302716,1401.462963,1359989860788,1359989861812,411245920,411246944,1024
1359989864,411249168,4,1452,363,1359989860431,1359989860623,411245599,411245791,192
1359989868,411252896,11,4117,374.2727273,1359989841440,1359989842528,411226336,411227424,1088
1359989868,411252928,14,7210,515,1359989843264,1359989845248,411228192,411230176,1984
1359989872,411256936,5,1232,246.4,1359989845815,1359989868279,411230751,411253215,22464
1359989872,411257184,4,1436,359,1359989871294,1359989871486,411256478,411256670,192
1359989876,411261000,6,1134,189,1359989851318,1359989853110,411236318,411238110,1792
1359989880,411265160,507,716852,1413.90927,1359989873047,1359989874327,411258207,411259487,1280
1359989884,411268892,70,80164,1145.2,1359989856228,1359989868260,411241120,411253152,12032
1359989896,411281144,2,1197,598.5,1359989868200,1359989869032,411253344,411254176,832
1359989896,411281192,1,52,52,1359989868725,1359989868725,411253917,411253917,0
1359989897,411281372,212,264062,1245.575472,1359989828523,1359989896747,411212895,411281119,68224
1359989900,411285236,1,52,52,1359989874890,1359989874890,411260126,411260126,0
1359989916,411301196,13,1804,138.7692308,1359989888370,1359989902834,411273566,411288030,14464
1359989925,411309400,2,1197,598.5,1359989900623,1359989901391,411285023,411285791,768
1359989928,411313280,1,52,52,1359989900254,1359989900254,411285534,411285534,0
1359989989,411373404,2,1197,598.5,1359989962057,1359989962761,411346461,411347165,704
1359989997,411381420,1,46,46,1359989972730,1359989972730,411357150,411357150,0
1359990065,411449620,2,104,52,1359990060657,1359990060913,411445277,411445533,256
1359990089,411473648,4,216,54,1359990088276,1359990088788,411472924,411473436,512
1359990101,411485872,1,52,52,1359990074550,1359990074550,411459422,411459422,0
1359990101,411485880,1,52,52,1359990076202,1359990076202,411461082,411461082,0
1359990105,411489892,1,52,52,1359990079006,1359990079006,411463898,411463898,0
1359990109,411493840,4,3487,871.75,1359990083091,1359990084947,411467931,411469787,1856
1359990113,411497904,1,52,52,1359990086677,1359990086677,411471581,411471581,0
1359990113,411497908,6,4036,672.6666667,1359990087054,1359990088718,411471962,411473626,1664
1359990113,411497932,3,164,54.66666667,1359990088054,1359990088502,411472986,411473434,448
1359990113,411497968,8,2272,284,1359990086036,1359990086612,411471004,411471580,576
1359990113,411497976,9,5265,585,1359990087181,1359990100173,411472157,411485149,12992
1359990141,411525956,2,1181,590.5,1359990115744,1359990116512,411500700,411501468,768
1359990153,411537988,15,9162,610.8,1359990126654,1359990127422,411511642,411512410,768
1359990169,411554028,1,52,52,1359990143001,1359990143001,411528029,411528029,0
1359990173,411557980,2,1181,590.5,1359990147206,1359990147910,411532186,411532890,704
1359990193,411577732,2,131,65.5,1359990188735,1359990188735,411573467,411573467,0
1359990233,411618200,2,1181,590.5,1359990208297,1359990209065,411593497,411594265,768
1359990245,411630228,1,46,46,1359990217614,1359990217614,411602842,411602842,0
1359990326,411710300,1,52,52,1359990298412,1359990298412,411682712,411682712,0
1359990326,411710348,2,112,56,1359990298108,1359990298364,411682456,411682712,256
1359990358,411742612,2,1181,590.5,1359990330355,1359990331059,411714967,411715671,704
1359990362,411746656,10,4480,448,1359990334856,1359990337608,411719512,411722264,2752
1359990362,411746664,1,186,186,1359990336190,1359990336190,411720854,411720854,0
1359990490,411874804,1,46,46,1359990462257,1359990462257,411847061,411847061,0
1359990598,411983256,7,4100,585.7142857,1359990570733,1359990572141,411955989,411957397,1408
1359990602,411987272,1,52,52,1359990577054,1359990577054,411962326,411962326,0
1359990673,412057884,11,6380,580,1359990670622,1359990671838,412055506,412056722,1216
1359990673,412057932,12,3110,259.1666667,1359990669999,1359990670447,412054931,412055379,448
1359990673,412057980,12,3100,258.3333333,1359990670016,1359990670464,412054996,412055444,448
1359990681,412065940,16,6480,405,1359990669863,1359990673831,412054803,412058771,3968
1359990689,412074004,12,5805,483.75,1359990672165,1359990685541,412057169,412070545,13376
1359990695,412079808,1,46,46,1359990669996,1359990669996,412054804,412054804,0
1359990695,412079808,9,5042,560.2222222,1359990670123,1359990670763,412054931,412055571,640
1359990695,412079808,9,3768,418.6666667,1359990670251,1359990672235,412055059,412057043,1984
1359990699,412083720,3,1982,660.6666667,1359990671940,1359990671940,412056660,412056660,0
1359990727,412111672,1,46,46,1359990702642,1359990702642,412087314,412087314,0
1359990751,412135760,6,2030,338.3333333,1359990726746,1359990727322,412111506,412112082,576
1359990793,412178024,2,131,65.5,1359990787091,1359990787091,412172115,412172115,0
1359990839,412224068,7,4084,583.4285714,1359990812709,1359990814117,412197777,412199185,1408
1359990891,412276088,1,46,46,1359990865807,1359990865807,412250895,412250895,0
1359990939,412324200,1,52,52,1359990911838,1359990911838,412297038,412297038,0
1359990971,412356228,1,46,46,1359990944324,1359990944324,412329552,412329552,0
1359991008,412392576,1,46,46,1359990983244,1359990983244,412367820,412367820,0
1359991080,412464632,6,4036,672.6666667,1359991054995,1359991056403,412439627,412441035,1408
1359991212,412597004,1,46,46,1359991187869,1359991187869,412572873,412572873,0
1359991264,412649036,2,129,64.5,1359991235965,1359991235965,412621001,412621001,0
1359991325,412709376,85,92620,1089.647059,1359991297040,1359991323152,412681416,412707528,26112
1359991353,412737568,2,1405,702.5,1359991325841,1359991326225,412710409,412710793,384
1359991370,412754416,3,1329,443,1359991363046,1359991363558,412747462,412747974,512
1359991389,412773632,7,3992,570.2857143,1359991363407,1359991365583,412748039,412750215,2176
1359991457,412841864,1,60,60,1359991432741,1359991432741,412817605,412817605,0
1359991541,412926028,1,60,60,1359991514627,1359991514627,412899655,412899655,0
1359991750,413134400,7,4200,600,1359991724275,1359991726707,413108675,413111107,2432
1359991750,413134404,6,3940,656.6666667,1359991724272,1359991725040,413108676,413109444,768
1359991750,413134456,1,52,52,1359991724027,1359991724027,413108483,413108483,0
1359991862,413246504,1,1209,1209,1359991835145,1359991835145,413219649,413219649,0
1359991882,413266580,1,46,46,1359991855677,1359991855677,413240257,413240257,0
1359991902,413286648,1,95,95,1359991876791,1359991876791,413261439,413261439,0
1359991906,413290952,3,138,46,1359991904329,1359991904329,413289281,413289281,0
1359991930,413314576,2,372,186,1359991904319,1359991904831,413288895,413289407,512
1359991930,413314580,17,6108,359.2941176,1359991904700,1359991907900,413289280,413292480,3200
1359991938,413322584,7,3063,437.5714286,1359991912310,1359991912758,413296894,413297342,448
1359991938,413322648,8,3820,477.5,1359991911288,1359991912376,413295936,413297024,1088
1359991982,413366588,1,46,46,1359991955251,1359991955251,413339839,413339839,0
1359992126,413510676,1,52,52,1359992098136,1359992098136,413482812,413482812,0
1359992174,413558860,1,52,52,1359992147617,1359992147617,413532477,413532477,0
1359992178,413562812,1,52,52,1359992152208,1359992152208,413537020,413537020,0
1359992178,413562948,1,52,52,1359992152456,1359992152456,413537404,413537404,0
1359992195,413579456,7,4104,586.2857143,1359992192947,1359992193651,413577403,413578107,704
1359992195,413579464,8,4168,521,1359992190762,1359992191466,413575226,413575930,704
1359992195,413579472,7,4104,586.2857143,1359992191461,1359992192229,413575933,413576701,768
1359992195,413579500,6,4052,675.3333333,1359992192201,1359992192841,413576701,413577341,640
1359992195,413579508,6,4052,675.3333333,1359992193600,1359992194304,413578108,413578812,704
1359992203,413587432,6,4052,675.3333333,1359992194378,1359992195018,413578810,413579450,640
1359992203,413587432,6,4052,675.3333333,1359992195018,1359992195722,413579450,413580154,704
1359992203,413587432,6,4052,675.3333333,1359992198537,1359992199113,413582969,413583545,576
1359992203,413587440,6,4052,675.3333333,1359992199109,1359992199685,413583549,413584125,576
1359992203,413587440,7,4104,586.2857143,1359992195715,1359992196419,413580155,413580859,704
1359992203,413587440,7,4104,586.2857143,1359992199681,1359992200385,413584121,413584825,704
1359992203,413587444,7,4104,586.2857143,1359992196479,1359992197183,413580923,413581627,704
1359992203,413587448,7,4104,586.2857143,1359992200380,1359992200956,413584828,413585404,576
1359992203,413587512,6,4052,675.3333333,1359992197179,1359992197819,413581691,413582331,640
1359992203,413587516,7,4104,586.2857143,1359992197816,1359992198392,413582332,413582908,576
1359992203,413587516,7,4104,586.2857143,1359992200950,1359992201654,413585466,413586170,704
1359992203,413587520,6,4052,675.3333333,1359992201653,1359992202293,413586173,413586813,640
1359992211,413595440,6,4052,675.3333333,1359992203074,1359992203714,413587514,413588154,640
1359992211,413595448,7,4104,586.2857143,1359992203708,1359992204348,413588156,413588796,640
1359992211,413595452,6,4052,675.3333333,1359992207735,1359992208439,413592187,413592891,704
1359992211,413595452,6,4052,675.3333333,1359992205109,1359992205749,413589561,413590201,640
1359992211,413595456,7,4104,586.2857143,1359992208433,1359992209073,413592889,413593529,640
1359992211,413595492,6,4052,675.3333333,1359992206351,1359992206991,413590843,413591483,640
1359992211,413595492,6,4052,675.3333333,1359992202383,1359992202959,413586875,413587451,576
1359992211,413595496,7,4104,586.2857143,1359992206985,1359992207625,413591481,413592121,640
1359992211,413595500,7,4104,586.2857143,1359992204358,1359992205062,413588858,413589562,704
1359992211,413595528,7,4104,586.2857143,1359992205674,1359992206314,413590202,413590842,640
1359992211,413595532,7,4104,586.2857143,1359992209062,1359992209766,413593594,413594298,704
1359992211,413595536,7,4104,586.2857143,1359992209763,1359992210467,413594299,413595003,704
1359992218,413602800,2,1261,630.5,1359992190171,1359992190299,413574971,413575099,128
1359992219,413603428,7,4104,586.2857143,1359992214288,1359992214992,413598716,413599420,704
1359992219,413603436,6,4052,675.3333333,1359992212039,1359992212743,413596475,413597179,704
1359992219,413603440,6,4052,675.3333333,1359992212740,1359992213444,413597180,413597884,704
1359992219,413603440,6,4052,675.3333333,1359992216322,1359992216962,413600762,413601402,640
1359992219,413603444,7,4104,586.2857143,1359992213439,1359992214271,413597883,413598715,832
1359992219,413603444,6,4052,675.3333333,1359992216957,1359992217661,413601401,413602105,704
1359992219,413603472,7,4104,586.2857143,1359992217763,1359992218339,413602235,413602811,576
1359992219,413603476,7,4104,586.2857143,1359992210528,1359992211232,413595004,413595708,704
1359992219,413603476,6,4052,675.3333333,1359992211229,1359992211997,413595705,413596473,768
1359992219,413603480,7,4104,586.2857143,1359992215004,1359992215644,413599484,413600124,640
1359992219,413603484,6,4052,675.3333333,1359992215702,1359992216278,413600186,413600762,576
1359992227,413611436,7,4104,586.2857143,1359992222662,1359992223366,413607098,413607802,704
1359992227,413611452,7,4104,586.2857143,1359992221943,1359992222647,413606395,413607099,704
1359992227,413611452,7,4104,586.2857143,1359992224693,1359992225397,413609145,413609849,704
1359992227,413611476,6,4052,675.3333333,1359992225374,1359992226078,413609850,413610554,704
1359992227,413611476,7,4104,586.2857143,1359992218397,1359992218973,413602873,413603449,576
1359992227,413611480,7,4104,586.2857143,1359992219036,1359992219740,413603516,413604220,704
1359992227,413611484,7,4104,586.2857143,1359992219735,1359992220439,413604219,413604923,704
1359992227,413611484,6,4052,675.3333333,1359992223317,1359992223957,413607801,413608441,640
1359992227,413611488,6,4052,675.3333333,1359992220500,1359992221204,413604988,413605692,704
1359992227,413611492,6,4052,675.3333333,1359992223952,1359992224656,413608444,413609148,704
1359992227,413611492,7,4104,586.2857143,1359992221199,1359992221839,413605691,413606331,640
1359992230,413614828,6,4052,675.3333333,1359992225789,1359992226365,413610617,413611193,576
1359992235,413619436,7,4104,586.2857143,1359992226759,1359992227399,413611195,413611835,640
1359992235,413619440,7,4104,586.2857143,1359992231618,1359992232386,413616058,413616826,768
1359992235,413619444,7,4104,586.2857143,1359992232381,1359992233085,413616825,413617529,704
1359992235,413619452,7,4104,586.2857143,1359992230136,1359992230840,413614588,413615292,704
1359992235,413619452,7,4104,586.2857143,1359992233080,1359992233720,413617532,413618172,640
1359992235,413619480,7,4104,586.2857143,1359992230873,1359992231577,413615353,413616057,704
1359992235,413619484,7,4104,586.2857143,1359992227351,1359992229399,413611835,413613883,2048
1359992235,413619492,7,4104,586.2857143,1359992229390,1359992230094,413613882,413614586,704
1359992235,413619520,6,4052,675.3333333,1359992233716,1359992234484,413618236,413619004,768
1359992243,413627464,7,4104,586.2857143,1359992234537,1359992235241,413619001,413619705,704
1359992243,413627468,7,4104,586.2857143,1359992235240,1359992235944,413619708,413620412,704
1359992243,413627472,7,4104,586.2857143,1359992239395,1359992240035,413623867,413624507,640
1359992243,413627504,7,4104,586.2857143,1359992241345,1359992241985,413625849,413626489,640
1359992243,413627508,6,4052,675.3333333,1359992241983,1359992242559,413626491,413627067,576
1359992243,413627512,7,4104,586.2857143,1359992238652,1359992239292,413623164,413623804,640
1359992243,413627516,7,4104,586.2857143,1359992235895,1359992236791,413620411,413621307,896
1359992243,413627536,7,4104,586.2857143,1359992239971,1359992240611,413624507,413625147,640
1359992243,413627536,6,4052,675.3333333,1359992236835,1359992237411,413621371,413621947,576
1359992243,413627544,7,4104,586.2857143,1359992237402,1359992238042,413621946,413622586,640
1359992243,413627544,7,4104,586.2857143,1359992240601,1359992241241,413625145,413625785,640
1359992243,413627548,6,4052,675.3333333,1359992238040,1359992238616,413622588,413623164,576
1359992251,413635452,7,4104,586.2857143,1359992243319,1359992244023,413627771,413628475,704
1359992251,413635456,6,4052,675.3333333,1359992244082,1359992244722,413628538,413629178,640
1359992251,413635460,7,4104,586.2857143,1359992244782,1359992245486,413629242,413629946,704
1359992251,413635464,7,4104,586.2857143,1359992248363,1359992249067,413632827,413633531,704
1359992251,413635468,7,4104,586.2857143,1359992246184,1359992246888,413630652,413631356,704
1359992251,413635488,7,4104,586.2857143,1359992249748,1359992250452,413634236,413634940,704
1359992251,413635492,7,4104,586.2857143,1359992242575,1359992243279,413627067,413627771,704
1359992251,413635492,7,4104,586.2857143,1359992246863,1359992247567,413631355,413632059,704
1359992251,413635500,6,4052,675.3333333,1359992247623,1359992248327,413632123,413632827,704
1359992251,413635524,7,4104,586.2857143,1359992245421,1359992246125,413629945,413630649,704
1359992251,413635528,7,4104,586.2857143,1359992249002,1359992249706,413633530,413634234,704
1359992259,413643452,6,4052,675.3333333,1359992255221,1359992255925,413639673,413640377,704
1359992259,413643464,6,4052,675.3333333,1359992253929,1359992254569,413638393,413639033,640
1359992259,413643488,7,4104,586.2857143,1359992257297,1359992258001,413641785,413642489,704
1359992259,413643496,6,4052,675.3333333,1359992254538,1359992255178,413639034,413639674,640
1359992259,413643496,6,4052,675.3333333,1359992250442,1359992251146,413634938,413635642,704
1359992259,413643496,6,4052,675.3333333,1359992251144,1359992251784,413635640,413636280,640
1359992259,413643504,7,4104,586.2857143,1359992251780,1359992252484,413636284,413636988,704
1359992259,413643508,6,4052,675.3333333,1359992252540,1359992253116,413637048,413637624,576
1359992259,413643508,7,4104,586.2857143,1359992255872,1359992256576,413640380,413641084,704
1359992259,413643508,7,4104,586.2857143,1359992253117,1359992253821,413637625,413638329,704
1359992259,413643512,7,4104,586.2857143,1359992256572,1359992257276,413641084,413641788,704
1359992262,413646868,6,4052,675.3333333,1359992257621,1359992258389,413642489,413643257,768
1359992267,413651496,6,4052,675.3333333,1359992262408,1359992262984,413646904,413647480,576
1359992267,413651500,7,4104,586.2857143,1359992258759,1359992259463,413643259,413643963,704
1359992267,413651500,7,4104,586.2857143,1359992262982,1359992263622,413647482,413648122,640
1359992267,413651508,7,4104,586.2857143,1359992261628,1359992262332,413646136,413646840,704
1359992267,413651544,6,4052,675.3333333,1359992259417,1359992260121,413643961,413644665,704
1359992267,413651548,7,4104,586.2857143,1359992260181,1359992260949,413644729,413645497,768
1359992267,413651576,7,4104,586.2857143,1359992260923,1359992261563,413645499,413646139,640
1359992275,413659496,6,4052,675.3333333,1359992270411,1359992270987,413654907,413655483,576
1359992275,413659504,7,4104,586.2857143,1359992271617,1359992272257,413656121,413656761,640
1359992275,413659508,7,4104,586.2857143,1359992268736,1359992269760,413653244,413654268,1024
1359992275,413659508,7,4104,586.2857143,1359992272255,1359992272959,413656763,413657467,704
1359992275,413659532,7,4104,586.2857143,1359992269733,1359992270373,413654265,413654905,640
1359992275,413659540,7,4104,586.2857143,1359992274206,1359992274782,413658746,413659322,576
1359992275,413659544,7,4104,586.2857143,1359992267290,1359992267930,413651834,413652474,640
1359992275,413659548,6,4052,675.3333333,1359992270936,1359992271576,413655484,413656124,640
1359992275,413659548,7,4104,586.2857143,1359992267927,1359992268631,413652475,413653179,704
1359992275,413659552,8,4164,520.5,1359992263570,1359992267282,413648122,413651834,3712
1359992275,413659580,6,4052,675.3333333,1359992272887,1359992273527,413657467,413658107,640
1359992275,413659584,6,4052,675.3333333,1359992273523,1359992274099,413658107,413658683,576
1359992283,413667532,7,4104,586.2857143,1359992274791,1359992275495,413659323,413660027,704
1359992283,413667532,7,4104,586.2857143,1359992279078,1359992279782,413663610,413664314,704
1359992283,413667536,6,4052,675.3333333,1359992276258,1359992276962,413660794,413661498,704
1359992283,413667536,6,4052,675.3333333,1359992279777,1359992280417,413664313,413664953,640
1359992283,413667540,6,4052,675.3333333,1359992280414,1359992280990,413664954,413665530,576
1359992283,413667564,6,4052,675.3333333,1359992280967,1359992281735,413665531,413666299,768
1359992283,413667568,6,4052,675.3333333,1359992281731,1359992282435,413666299,413667003,704
1359992283,413667568,7,4104,586.2857143,1359992278337,1359992279041,413662905,413663609,704
1359992283,413667576,6,4052,675.3333333,1359992275450,1359992276154,413660026,413660730,704
1359992283,413667608,7,4104,586.2857143,1359992276891,1359992277595,413661499,413662203,704
1359992283,413667612,6,4052,675.3333333,1359992277590,1359992278294,413662202,413662906,704
1359992291,413675556,6,4052,675.3333333,1359992282445,1359992283149,413667001,413667705,704
1359992291,413675564,7,4104,586.2857143,1359992287239,1359992287943,413671803,413672507,704
1359992291,413675564,7,4104,586.2857143,1359992283846,1359992284550,413668410,413669114,704
1359992291,413675568,7,4104,586.2857143,1359992288002,1359992288642,413672570,413673210,640
1359992291,413675568,7,4104,586.2857143,1359992284610,1359992285314,413669178,413669882,704
1359992291,413675572,7,4104,586.2857143,1359992288637,1359992289405,413673209,413673977,768
1359992291,413675596,7,4104,586.2857143,1359992285863,1359992286631,413670459,413671227,768
1359992291,413675600,6,4052,675.3333333,1359992290081,1359992290785,413674681,413675385,704
1359992291,413675604,7,4104,586.2857143,1359992283102,1359992283806,413667706,413668410,704
1359992291,413675604,6,4052,675.3333333,1359992286622,1359992287198,413671226,413671802,576
1359992291,413675640,6,4052,675.3333333,1359992285240,1359992285816,413669880,413670456,576
1359992291,413675644,6,4052,675.3333333,1359992289334,1359992290038,413673978,413674682,704
1359992299,413683536,7,4104,586.2857143,1359992294369,1359992295073,413678905,413679609,704
1359992299,413683540,7,4104,586.2857143,1359992295069,1359992295773,413679609,413680313,704
1359992299,413683548,7,4104,586.2857143,1359992292310,1359992292950,413676858,413677498,640
1359992299,413683552,7,4104,586.2857143,1359992292947,1359992293523,413677499,413678075,576
1359992299,413683552,6,4052,675.3333333,1359992293520,1359992294288,413678072,413678840,768
1359992299,413683556,6,4052,675.3333333,1359992297230,1359992297934,413681786,413682490,704
1359992299,413683576,6,4052,675.3333333,1359992297912,1359992298488,413682488,413683064,576
1359992299,413683588,6,4052,675.3333333,1359992290863,1359992291631,413675451,413676219,768
1359992299,413683588,6,4052,675.3333333,1359992291629,1359992292205,413676217,413676793,576
1359992299,413683588,7,4104,586.2857143,1359992295725,1359992296493,413680313,413681081,768
1359992299,413683608,7,4104,586.2857143,1359992296472,1359992297112,413681080,413681720,640
1359992307,413691552,7,4104,586.2857143,1359992301266,1359992302034,413685818,413686586,768
1359992307,413691556,6,4052,675.3333333,1359992302029,1359992302605,413686585,413687161,576
1359992307,413691572,7,4104,586.2857143,1359992305467,1359992306171,413690039,413690743,704
1359992307,413691580,7,4104,586.2857143,1359992298485,1359992299253,413683065,413683833,768
1359992307,413691580,7,4104,586.2857143,1359992302645,1359992303285,413687225,413687865,640
1359992307,413691580,7,4104,586.2857143,1359992299253,1359992299957,413683833,413684537,704
1359992307,413691588,7,4104,586.2857143,1359992303343,1359992304047,413687931,413688635,704
1359992307,413691588,6,4052,675.3333333,1359992299951,1359992300527,413684539,413685115,576
1359992307,413691588,7,4104,586.2857143,1359992300588,1359992301228,413685176,413685816,640
1359992307,413691592,7,4104,586.2857143,1359992304043,1359992304683,413688635,413689275,640
1359992307,413691616,7,4104,586.2857143,1359992304656,1359992305424,413689272,413690040,768
1359992307,413691624,6,4052,675.3333333,1359992306122,1359992306826,413690746,413691450,704
1359992315,413699564,7,4104,586.2857143,1359992306951,1359992307847,413691515,413692411,896
1359992315,413699576,7,4104,586.2857143,1359992311547,1359992312251,413696123,413696827,704
1359992315,413699576,7,4104,586.2857143,1359992308537,1359992309369,413693113,413693945,832
1359992315,413699580,7,4104,586.2857143,1359992312246,1359992313014,413696826,413697594,768
1359992315,413699612,6,4052,675.3333333,1359992310804,1359992311444,413695416,413696056,640
1359992315,413699616,6,4052,675.3333333,1359992307795,1359992308499,413692411,413693115,704
1359992315,413699640,6,4052,675.3333333,1359992309306,1359992310010,413693946,413694650,704
1359992315,413699644,6,4052,675.3333333,1359992310006,1359992310710,413694650,413695354,704
1359992315,413699644,6,4052,675.3333333,1359992312948,1359992313716,413697592,413698360,768
1359992315,413699648,7,4104,586.2857143,1359992313714,1359992314418,413698362,413699066,704
1359992323,413707552,6,4052,675.3333333,1359992314513,1359992315217,413699065,413699769,704
1359992323,413707552,7,4104,586.2857143,1359992318672,1359992319440,413703224,413703992,768
1359992323,413707552,6,4052,675.3333333,1359992315279,1359992315855,413699831,413700407,576
1359992323,413707556,7,4104,586.2857143,1359992319500,1359992320140,413704056,413704696,640
1359992323,413707560,7,4104,586.2857143,1359992316554,1359992317258,413701114,413701818,704
1359992323,413707564,7,4104,586.2857143,1359992317319,1359992317959,413701883,413702523,640
1359992323,413707592,6,4052,675.3333333,1359992321578,1359992322154,413706170,413706746,576
1359992323,413707600,6,4052,675.3333333,1359992315809,1359992316513,413700409,413701113,704
1359992323,413707628,7,4104,586.2857143,1359992320070,1359992320710,413704698,413705338,640
1359992323,413707632,7,4104,586.2857143,1359992320703,1359992321471,413705335,413706103,768
1359992323,413707632,7,4104,586.2857143,1359992317952,1359992318592,413702584,413703224,640
1359992323,413707636,7,4104,586.2857143,1359992322109,1359992322813,413706745,413707449,704
1359992331,413715576,6,4052,675.3333333,1359992326394,1359992326970,413710970,413711546,576
1359992331,413715580,7,4104,586.2857143,1359992323573,1359992324213,413708153,413708793,640
1359992331,413715588,7,4104,586.2857143,1359992324973,1359992325613,413709561,413710201,640
1359992331,413715588,6,4052,675.3333333,1359992328301,1359992328941,413712889,413713529,640
1359992331,413715588,7,4104,586.2857143,1359992325676,1359992326316,413710264,413710904,640
1359992331,413715616,7,4104,586.2857143,1359992329618,1359992330322,413714234,413714938,704
1359992331,413715620,5,4000,800,1359992330318,1359992330830,413714938,413715450,512
1359992331,413715620,3,138,46,1359992326541,1359992326541,413711161,413711161,0
1359992331,413715624,7,4104,586.2857143,1359992322826,1359992323530,413707450,413708154,704
1359992331,413715624,7,4104,586.2857143,1359992326920,1359992327560,413711544,413712184,640
1359992331,413715628,7,4104,586.2857143,1359992324167,1359992324871,413708795,413709499,704
1359992331,413715628,7,4104,586.2857143,1359992327621,1359992328261,413712249,413712889,640
1359992331,413715652,6,4052,675.3333333,1359992328941,1359992329581,413713593,413714233,640
1359992339,413723556,7,4104,586.2857143,1359992331086,1359992331790,413715642,413716346,704
1359992339,413723560,8,5121,640.125,1359992331594,1359992332810,413716154,413717370,1216
1359992339,413723560,6,4052,675.3333333,1359992331848,1359992332424,413716408,413716984,576
1359992339,413723568,7,4104,586.2857143,1359992336385,1359992337089,413720953,413721657,704
1359992339,413723568,7,4104,586.2857143,1359992333249,1359992333953,413717817,413718521,704
1359992339,413723572,6,4052,675.3333333,1359992337086,1359992337726,413721658,413722298,640
1359992339,413723604,7,4104,586.2857143,1359992334940,1359992335644,413719544,413720248,704
1359992339,413723608,8,5121,640.125,1359992331483,1359992333211,413716091,413717819,1728
1359992339,413723608,7,4104,586.2857143,1359992335640,1359992336344,413720248,413720952,704
1359992339,413723636,8,5121,640.125,1359992333756,1359992334908,413718392,413719544,1152
1359992339,413723636,7,4104,586.2857143,1359992333884,1359992334588,413718520,413719224,704
1359992339,413723640,7,4104,586.2857143,1359992337657,1359992338361,413722297,413723001,704
1359992347,413731576,6,4052,675.3333333,1359992343163,1359992343739,413727739,413728315,576
1359992347,413731576,7,4104,586.2857143,1359992339833,1359992340473,413724409,413725049,640
1359992347,413731576,6,4052,675.3333333,1359992343735,1359992344439,413728311,413729015,704
1359992347,413731612,7,4104,586.2857143,1359992345111,1359992345879,413729723,413730491,768
1359992347,413731612,6,4052,675.3333333,1359992345941,1359992346645,413730553,413731257,704
1359992347,413731616,7,4104,586.2857143,1359992342415,1359992343119,413727031,413727735,704
1359992347,413731616,6,4052,675.3333333,1359992338447,1359992338959,413723063,413723575,512
1359992347,413731616,7,4104,586.2857143,1359992339026,1359992339730,413723642,413724346,704
1359992347,413731628,7,4104,586.2857143,1359992340483,1359992341059,413725111,413725687,576
1359992347,413731628,6,4052,675.3333333,1359992344389,1359992345093,413729017,413729721,704
1359992347,413731648,7,4104,586.2857143,1359992341040,1359992341744,413725688,413726392,704
1359992347,413731652,6,4052,675.3333333,1359992341740,1359992342380,413726392,413727032,640
1359992354,413739004,10,4101,410.1,1359992326157,1359992328589,413711161,413713593,2432
1359992354,413739040,1,186,186,1359992327082,1359992327082,413712122,413712122,0
1359992355,413739564,7,4104,586.2857143,1359992350982,1359992351686,413735546,413736250,704
1359992355,413739564,7,4104,586.2857143,1359992346694,1359992347334,413731258,413731898,640
1359992355,413739568,7,4104,586.2857143,1359992351682,1359992352322,413736250,413736890,640
1359992355,413739568,7,4104,586.2857143,1359992348224,1359992348864,413732792,413733432,640
1359992355,413739572,7,4104,586.2857143,1359992352382,1359992353022,413736954,413737594,640
1359992355,413739572,7,4104,586.2857143,1359992348925,1359992349629,413733497,413734201,704
1359992355,413739604,5,4000,800,1359992354269,1359992354781,413738873,413739385,512
1359992355,413739608,6,4052,675.3333333,1359992347415,1359992348183,413732023,413732791,768
1359992355,413739636,7,4104,586.2857143,1359992349564,1359992350204,413734200,413734840,640
1359992355,413739636,7,4104,586.2857143,1359992352956,1359992353596,413737592,413738232,640
1359992355,413739640,6,4052,675.3333333,1359992350201,1359992350841,413734841,413735481,640
1359992355,413739640,6,4052,675.3333333,1359992353591,1359992354231,413738231,413738871,640
1359992358,413742956,1,52,52,1359992330686,1359992330686,413715642,413715642,0
1359992358,413742964,13,6149,473,1359992331188,1359992333492,413716152,413718456,2304
1359992358,413743036,9,4785,531.6666667,1359992330862,1359992331182,413715898,413716218,320
1359992363,413747600,6,4052,675.3333333,1359992354977,1359992355745,413739577,413740345,768
1359992363,413747604,7,4104,586.2857143,1359992358622,1359992359326,413743226,413743930,704
1359992363,413747608,7,4104,586.2857143,1359992359322,1359992360026,413743930,413744634,704
1359992363,413747612,7,4104,586.2857143,1359992360020,1359992360724,413744632,413745336,704
1359992363,413747616,7,4104,586.2857143,1359992357070,1359992357838,413741686,413742454,768
1359992363,413747616,7,4104,586.2857143,1359992360720,1359992361360,413745336,413745976,640
1359992363,413747640,7,4104,586.2857143,1359992361336,1359992362040,413745976,413746680,704
1359992363,413747644,6,4052,675.3333333,1359992362038,1359992362742,413746682,413747386,704
1359992363,413747652,6,4052,675.3333333,1359992355694,1359992356270,413740346,413740922,576
1359992363,413747656,7,4104,586.2857143,1359992356330,1359992356970,413740986,413741626,640
1359992363,413747684,7,4104,586.2857143,1359992357838,1359992358478,413742522,413743162,640
1359992371,413755576,7,4104,586.2857143,1359992366393,1359992367097,413750969,413751673,704
1359992371,413755580,6,4052,675.3333333,1359992363572,1359992364212,413748152,413748792,640
1359992371,413755580,6,4052,675.3333333,1359992367092,1359992367796,413751672,413752376,704
1359992371,413755584,7,4104,586.2857143,1359992364911,1359992365551,413749495,413750135,640
1359992371,413755588,7,4104,586.2857143,1359992365612,1359992366380,413750200,413750968,768
1359992371,413755624,6,4052,675.3333333,1359992369225,1359992369929,413753849,413754553,704
1359992371,413755632,7,4104,586.2857143,1359992362753,1359992363457,413747385,413748089,704
1359992371,413755636,6,4052,675.3333333,1359992364156,1359992364796,413748792,413749432,640
1359992371,413755640,7,4104,586.2857143,1359992367738,1359992368442,413752378,413753082,704
1359992371,413755668,6,4052,675.3333333,1359992368414,1359992369182,413753082,413753850,768
1359992371,413755672,6,4052,675.3333333,1359992369881,1359992370521,413754553,413755193,640
1359992379,413763576,7,4104,586.2857143,1359992374393,1359992375097,413758969,413759673,704
1359992379,413763580,6,4052,675.3333333,1359992371317,1359992372021,413755897,413756601,704
1359992379,413763580,7,4104,586.2857143,1359992375092,1359992375732,413759672,413760312,640
1359992379,413763584,7,5213,744.7142857,1359992372017,1359992372977,413756601,413757561,960
1359992379,413763624,7,4104,586.2857143,1359992370568,1359992371272,413755192,413755896,704
1359992379,413763632,7,4104,586.2857143,1359992375681,1359992376385,413760313,413761017,704
1359992379,413763632,7,4104,586.2857143,1359992372927,1359992373631,413757559,413758263,704
1359992379,413763660,6,4052,675.3333333,1359992376354,1359992376930,413761014,413761590,576
1359992379,413763660,7,4104,586.2857143,1359992373606,1359992374310,413758266,413758970,704
1359992379,413763664,7,4104,586.2857143,1359992376930,1359992377698,413761594,413762362,768
1359992379,413763664,6,4052,675.3333333,1359992377696,1359992378272,413762360,413762936,576
1359992382,413767116,1,52,52,1359992354460,1359992354460,413739576,413739576,0
1359992387,413771576,7,4104,586.2857143,1359992378361,1359992379065,413762937,413763641,704
1359992387,413771576,7,4104,586.2857143,1359992379128,1359992379768,413763704,413764344,640
1359992387,413771576,7,4104,586.2857143,1359992382902,1359992383606,413767478,413768182,704
1359992387,413771584,6,4052,675.3333333,1359992380526,1359992381230,413765110,413765814,704
1359992387,413771596,7,4104,586.2857143,1359992382114,1359992382882,413766710,413767478,768
1359992387,413771616,7,4104,586.2857143,1359992385615,1359992386319,413770231,413770935,704
1359992387,413771628,6,4052,675.3333333,1359992379778,1359992380482,413764406,413765110,704
1359992387,413771628,7,4104,586.2857143,1359992383558,1359992384326,413768186,413768954,768
1359992387,413771632,6,4052,675.3333333,1359992384321,1359992384961,413768953,413769593,640
1359992387,413771632,7,4104,586.2857143,1359992381185,1359992382017,413765817,413766649,832
1359992387,413771660,6,4052,675.3333333,1359992384934,1359992385574,413769594,413770234,640
1359992395,413779592,6,4052,675.3333333,1359992390570,1359992391274,413775162,413775866,704
1359992395,413779592,6,4052,675.3333333,1359992387048,1359992387816,413771640,413772408,768
1359992395,413779600,7,4104,586.2857143,1359992392031,1359992392799,413776631,413777399,768
1359992395,413779608,6,4052,675.3333333,1359992389210,1359992389850,413773818,413774458,640
1359992395,413779608,7,4104,586.2857143,1359992389847,1359992390551,413774455,413775159,704
1359992395,413779636,7,4104,586.2857143,1359992386300,1359992387004,413770936,413771640,704
1359992395,413779640,7,4104,586.2857143,1359992391223,1359992391927,413775863,413776567,704
1359992395,413779644,6,4052,675.3333333,1359992387762,1359992388402,413772406,413773046,640
1359992395,413779644,6,4052,675.3333333,1359992388403,1359992389171,413773047,413773815,768
1359992395,413779668,7,4104,586.2857143,1359992392731,1359992393371,413777399,413778039,640
1359992395,413779676,6,4052,675.3333333,1359992393428,1359992394132,413778104,413778808,704
1359992398,413783020,6,4052,675.3333333,1359992393786,1359992394426,413778806,413779446,640
1359992403,413787596,6,4052,675.3333333,1359992402341,1359992402853,413786937,413787449,512
1359992403,413787600,7,4104,586.2857143,1359992394848,1359992395488,413779448,413780088,640
1359992403,413787604,6,4052,675.3333333,1359992396123,1359992396763,413780727,413781367,640
1359992403,413787612,6,4052,675.3333333,1359992397460,1359992398036,413782072,413782648,576
1359992403,413787680,7,4104,586.2857143,1359992401616,1359992402256,413786296,413786936,640
1359992403,413787688,6,4052,675.3333333,1359992395463,1359992396039,413780151,413780727,576
1359992403,413787696,7,4104,586.2857143,1359992396672,1359992397312,413781368,413782008,640
1359992403,413787720,8,4164,520.5,1359992397993,1359992401577,413782713,413786297,3584
1359992411,413795608,6,4052,675.3333333,1359992407192,1359992407960,413791800,413792568,768
1359992411,413795612,7,5478,782.5714286,1359992404243,1359992405139,413788855,413789751,896
1359992411,413795612,7,4104,586.2857143,1359992407955,1359992409747,413792567,413794359,1792
1359992411,413795616,7,4104,586.2857143,1359992405135,1359992405775,413789751,413790391,640
1359992411,413795648,6,4052,675.3333333,1359992402927,1359992403503,413787575,413788151,576
1359992411,413795648,7,4104,586.2857143,1359992406510,1359992407150,413791158,413791798,640
1359992411,413795656,7,4104,586.2857143,1359992403495,1359992404199,413788151,413788855,704
1359992411,413795688,7,4104,586.2857143,1359992405767,1359992406407,413790455,413791095,640
1359992411,413795692,7,4104,586.2857143,1359992409668,1359992410372,413794360,413795064,704
1359992419,413803596,7,4104,586.2857143,1359992410467,1359992411171,413795063,413795767,704
1359992419,413803596,7,4104,586.2857143,1359992414498,1359992415138,413799094,413799734,640
1359992419,413803600,6,4052,675.3333333,1359992411168,1359992411808,413795768,413796408,640
1359992419,413803604,6,4052,675.3333333,1359992411868,1359992412444,413796472,413797048,576
1359992419,413803640,6,4052,675.3333333,1359992416696,1359992417336,413801336,413801976,640
1359992419,413803640,6,4052,675.3333333,1359992413880,1359992414456,413798520,413799096,576
1359992419,413803652,7,4104,586.2857143,1359992415146,1359992415786,413799798,413800438,640
1359992419,413803660,6,4052,675.3333333,1359992412450,1359992413090,413797110,413797750,640
1359992419,413803676,7,4104,586.2857143,1359992415826,1359992416658,413800502,413801334,832
1359992419,413803676,6,4052,675.3333333,1359992413074,1359992413778,413797750,413798454,704
1359992419,413803684,6,4052,675.3333333,1359992417292,1359992417996,413801976,413802680,704
1359992419,413803684,7,4104,586.2857143,1359992418058,1359992418570,413802742,413803254,512
1359992427,413811612,7,4104,586.2857143,1359992422739,1359992423379,413807351,413807991,640
1359992427,413811616,7,4104,586.2857143,1359992418702,1359992419342,413803318,413803958,640
1359992427,413811620,7,4104,586.2857143,1359992423433,1359992424073,413808053,413808693,640
1359992427,413811620,7,4104,586.2857143,1359992419981,1359992420621,413804601,413805241,640
1359992427,413811620,6,4052,675.3333333,1359992420618,1359992421194,413805238,413805814,576
1359992427,413811628,7,4104,586.2857143,1359992424837,1359992425541,413809465,413810169,704
1359992427,413811652,7,4104,586.2857143,1359992421996,1359992422636,413806648,413807288,640
1359992427,413811660,6,4052,675.3333333,1359992419299,1359992419939,413803959,413804599,640
1359992427,413811668,7,4104,586.2857143,1359992424091,1359992424795,413808759,413809463,704
1359992427,413811672,7,4104,586.2857143,1359992421206,1359992421910,413805878,413806582,704
1359992427,413811700,7,4104,586.2857143,1359992425469,1359992426173,413810169,413810873,704
1359992430,413815112,1,52,52,1359992402462,1359992402462,413787574,413787574,0
1359992435,413819624,6,4052,675.3333333,1359992427783,1359992428423,413812407,413813047,640
1359992435,413819624,7,4104,586.2857143,1359992431303,1359992432007,413815927,413816631,704
1359992435,413819628,6,4052,675.3333333,1359992428420,1359992429124,413813048,413813752,704
1359992435,413819660,7,4104,586.2857143,1359992426275,1359992427043,413810935,413811703,768
1359992435,413819664,7,4104,586.2857143,1359992427040,1359992427744,413811704,413812408,704
1359992435,413819664,6,4052,675.3333333,1359992430559,1359992431199,413815223,413815863,640
1359992435,413819676,6,4052,675.3333333,1359992431955,1359992432595,413816631,413817271,640
1359992435,413819692,7,4104,586.2857143,1359992432579,1359992433219,413817271,413817911,640
1359992435,413819692,6,4052,675.3333333,1359992429123,1359992429763,413813815,413814455,640
1359992435,413819696,7,4104,586.2857143,1359992429759,1359992430463,413814455,413815159,704
1359992442,413827048,2,372,186,1359992415005,1359992419421,413800053,413804469,4416
1359992442,413827088,17,4123,242.5294118,1359992414137,1359992421689,413799225,413806777,7552
1359992459,413843304,6,4036,672.6666667,1359992434119,1359992434695,413818423,413818999,576
1359992459,413843388,6,5129,854.8333333,1359992434293,1359992450037,413818681,413834425,15744
1359992507,413891432,2,1197,598.5,1359992480452,1359992481284,413864884,413865716,832
1359992539,413923456,12,2936,244.6666667,1359992513775,1359992516655,413898231,413901111,2880
1359992539,413923500,2,372,186,1359992513282,1359992513922,413897782,413898422,640
1359992567,413951460,1,1145,1145,1359992541609,1359992541609,413926069,413926069,0
1359992587,413971472,1,46,46,1359992561310,1359992561310,413945782,413945782,0
1359992599,413983488,1,52,52,1359992573964,1359992573964,413958452,413958452,0
1359992599,413983500,1,52,52,1359992571711,1359992571711,413956211,413956211,0
1359992687,414071736,5,400,80,1359992660499,1359992683219,414045235,414067955,22720
1359992687,414071776,1,52,52,1359992659117,1359992659117,414043893,414043893,0
1359992687,414071808,1,52,52,1359992660428,1359992660428,414045236,414045236,0
1359992691,414075772,2,112,56,1359992665583,1359992666095,414050355,414050867,512
1359992691,414075816,1,1145,1145,1359992664645,1359992664645,414049461,414049461,0
1359992723,414107800,8,1368,171,1359992697876,1359992718036,414082676,414102836,20160
1359992723,414108092,12,3204,267,1359992721775,1359992722799,414106867,414107891,1024
1359992723,414108136,4,216,54,1359992721924,1359992722500,414107060,414107636,576
1359992739,414124116,17,3667,215.7058824,1359992731477,1359992735829,414116593,414120945,4352
1359992743,414127800,10,2500,250,1359992717524,1359992718612,414102324,414103412,1088
1359992747,414131824,3,164,54.66666667,1359992722363,1359992722811,414107187,414107635,448
1359992747,414131824,1,52,52,1359992722554,1359992722554,414107378,414107378,0
1359992747,414131868,7,3501,500.1428571,1359992722510,1359992722830,414107378,414107698,320
1359992763,414148068,4,208,52,1359992756038,1359992758150,414141106,414143218,2112
1359992779,414163868,1,80,80,1359992751566,1359992751566,414136434,414136434,0
1359992823,414208036,1,46,46,1359992798503,1359992798503,414183539,414183539,0
1359992931,414316128,2,120,60,1359992904841,1359992909961,414289969,414295089,5120
1359992935,414320104,6,4036,672.6666667,1359992909854,1359992910366,414294958,414295470,512
1359992935,414320108,3,297,99,1359992909981,1359992910237,414295089,414295345,256
1359992964,414348700,3,156,52,1359992962996,1359992963700,414347696,414348400,704
1359992972,414356720,2,104,52,1359992964577,1359992966369,414349297,414351089,1792
1359993045,3347708600,11,5192,472,1359993039870,1359993040062,3347703470,3347703662,192
1359993045,3347708600,15,12935,862.3333333,1359993040065,1359993040257,3347703665,3347703857,192
1359993045,3347708624,5,859,171.8,1359993039720,1359993039848,3347703344,3347703472,128
1359993047,414432172,1,52,52,1359993019290,1359993019290,414404462,414404462,0
1359993047,414432220,1,52,52,1359993019564,1359993019564,414404784,414404784,0
1359993047,414432220,1,52,52,1359993019243,1359993019243,414404463,414404463,0
1359993051,414436208,10,3414,341.4,1359993026168,1359993027256,414411376,414412464,1088
1359993051,414436276,31,19566,631.1612903,1359993026096,1359993038512,414411372,414423788,12416
1359993049,3347713144,14,11251,803.6428571,1359993048865,1359993049057,3347713009,3347713201,192
1359993053,3347716612,12,7017,584.75,1359993049268,1359993049396,3347712880,3347713008,128
1359993053,3347716704,12,5659,471.5833333,1359993048535,1359993049175,3347712239,3347712879,640
1359993055,414440192,3,704,234.6666667,1359993028868,1359993028868,414414060,414414060,0
1359993055,414440220,7,2949,421.2857143,1359993027560,1359993027752,414412780,414412972,192
1359993055,414440260,16,19642,1227.625,1359993029570,1359993029634,414414830,414414894,64
1359993055,414440260,17,13748,808.7058824,1359993029632,1359993038080,414414892,414423340,8448
1359993060,414444708,10,3923,392.3,1359993038123,1359993056683,414422831,414441391,18560
1359993060,414444748,175,239986,1371.348571,1359993029441,1359993056705,414414189,414441453,27264
1359993067,414452292,1,46,46,1359993041379,1359993041379,414426671,414426671,0
1359993069,3347732680,15,13079,871.9333333,1359993064047,1359993064367,3347727727,3347728047,320
1359993077,3347740680,14,11251,803.6428571,1359993073712,1359993073904,3347737392,3347737584,192
1359993077,3347740680,12,9579,798.25,1359993074031,1359993074351,3347737711,3347738031,320
1359993077,3347740680,12,8059,671.5833333,1359993074030,1359993074350,3347737710,3347738030,320
1359993077,3347740680,17,16964,997.8823529,1359993074030,1359993074350,3347737710,3347738030,320
1359993077,3347740684,15,12087,805.8,1359993074860,1359993075244,3347738544,3347738928,384
1359993077,3347740688,11,5837,530.6363636,1359993076008,1359993076264,3347739696,3347739952,256
1359993077,3347740688,12,6811,567.5833333,1359993076327,1359993076903,3347740015,3347740591,576
1359993077,3347740688,11,5767,524.2727273,1359993076327,1359993076775,3347740015,3347740463,448
1359993077,3347740692,11,5591,508.2727273,1359993073573,1359993073701,3347737265,3347737393,128
1359993077,3347740704,16,13691,855.6875,1359993074840,1359993075160,3347738544,3347738864,320
1359993077,3347740708,11,5837,530.6363636,1359993075987,1359993076243,3347739695,3347739951,256
1359993077,3347740708,11,6093,553.9090909,1359993076307,1359993076691,3347740015,3347740399,384
1359993077,3347740708,12,6715,559.5833333,1359993076307,1359993076819,3347740015,3347740527,512
1359993077,3347740708,12,5643,470.25,1359993073234,1359993073554,3347736942,3347737262,320
1359993083,414468232,1,52,52,1359993056157,1359993056157,414441389,414441389,0
1359993083,414468232,1,52,52,1359993056221,1359993056221,414441453,414441453,0
1359993084,414468308,1,52,52,1359993057081,1359993057081,414441389,414441389,0
1359993085,3347748684,14,11219,801.3571429,1359993082730,1359993082986,3347746414,3347746670,256
1359993085,3347748688,11,5623,511.1818182,1359993083112,1359993083304,3347746800,3347746992,192
1359993085,3347748688,12,5675,472.9166667,1359993083304,1359993083944,3347746992,3347747632,640
1359993085,3347748688,11,5192,472,1359993084007,1359993084135,3347747695,3347747823,128
1359993085,3347748688,15,14179,945.2666667,1359993084135,1359993084711,3347747823,3347748399,576
1359993085,3347748688,12,5851,487.5833333,1359993076326,1359993077030,3347740014,3347740718,704
1359993085,3347748688,9,1686,187.3333333,1359993076902,1359993077094,3347740590,3347740782,192
1359993085,3347748692,10,2298,229.8,1359993076966,1359993077094,3347740658,3347740786,128
1359993085,3347748692,9,1446,160.6666667,1359993077029,1359993077093,3347740721,3347740785,64
1359993085,3347748692,11,5437,494.2727273,1359993077285,1359993077413,3347740977,3347741105,128
1359993085,3347748708,15,12087,805.8,1359993083092,1359993083476,3347746800,3347747184,384
1359993085,3347748708,12,5675,472.9166667,1359993083922,1359993084114,3347747630,3347747822,192
1359993085,3347748712,12,5771,480.9166667,1359993076305,1359993077009,3347740017,3347740721,704
1359993085,3347748712,9,1414,157.1111111,1359993076689,1359993077009,3347740401,3347740721,320
1359993093,3347756676,12,6863,571.9166667,1359993085556,1359993085748,3347749232,3347749424,192
1359993093,3347756676,12,5691,474.25,1359993085748,1359993086068,3347749424,3347749744,320
1359993093,3347756676,12,5771,480.9166667,1359993085875,1359993086259,3347749551,3347749935,384
1359993093,3347756676,12,5803,483.5833333,1359993085875,1359993086259,3347749551,3347749935,384
1359993093,3347756676,8,1400,175,1359993086258,1359993086322,3347749934,3347749998,64
1359993093,3347756676,11,5773,524.8181818,1359993086130,1359993086322,3347749806,3347749998,192
1359993093,3347756676,8,1202,150.25,1359993086514,1359993086578,3347750190,3347750254,64
1359993093,3347756680,11,5591,508.2727273,1359993091887,1359993092015,3347755567,3347755695,128
1359993093,3347756684,17,15044,884.9411765,1359993089963,1359993090923,3347753647,3347754607,960
1359993093,3347756688,10,1514,151.4,1359993085865,1359993086249,3347749553,3347749937,384
1359993093,3347756688,17,15947,938.0588235,1359993085865,1359993086313,3347749553,3347750001,448
1359993093,3347756688,8,1218,152.25,1359993086057,1359993086121,3347749745,3347749809,64
1359993093,3347756688,8,819,102.375,1359993086057,1359993086121,3347749745,3347749809,64
1359993093,3347756688,11,5192,472,1359993086120,1359993086312,3347749808,3347750000,192
1359993093,3347756688,12,6075,506.25,1359993086376,1359993086696,3347750064,3347750384,320
1359993093,3347756700,11,5192,472,1359993091677,1359993091805,3347755377,3347755505,128
1359993100,414484784,42,49297,1173.738095,1359993077151,1359993097823,414461935,414482607,20672
1359993101,3347765292,2,892,446,1359993076364,1359993076428,3347740656,3347740720,64
1359993109,3347772692,11,5384,489.4545455,1359993108066,1359993108194,3347771758,3347771886,128
1359993125,3347788712,6782,9657704,1424.020053,1359993112144,1359993120144,3347775856,3347783856,8000
1359993180,414564772,6,4020,670,1359993154406,1359993155750,414539178,414540522,1344
1359993293,414677364,1,52,52,1359993268671,1359993268671,414653035,414653035,0
1359993293,414677404,1,52,52,1359993267798,1359993267798,414652202,414652202,0
1359993305,414689316,1,52,52,1359993279470,1359993279470,414663786,414663786,0
1359993316,414701260,1,46,46,1359993288190,1359993288190,414673450,414673450,0
1359993406,3348069704,546,771974,1413.871795,1359993108187,1359993108955,3347771891,3347772659,768
1359993421,414805600,7,4100,585.7142857,1359993396303,1359993397647,414780903,414782247,1344
1359993461,414845664,10,1361,136.1,1359993452367,1359993453391,414837031,414838055,1024
1359993553,414937892,1,46,46,1359993528489,1359993528489,414913381,414913381,0
1359993646,415030320,2,129,64.5,1359993619622,1359993619622,415003942,415003942,0
1359993665,415050232,6,4036,672.6666667,1359993637395,1359993638867,415022627,415024099,1472
1359993669,415054276,1,48,48,1359993642792,1359993642792,415028068,415028068,0
1359993733,415117680,3,138,46,1359993727291,1359993727291,415111971,415111971,0
1359993754,415138604,13,4969,382.2307692,1359993727367,1359993728967,415111971,415113571,1600
1359993754,415138684,1,186,186,1359993726711,1359993726711,415111395,415111395,0
1359993798,415182624,1,46,46,1359993771504,1359993771504,415156128,415156128,0
1359993813,415197656,1524,100613,66.01902887,1359993541712,1359993806800,414926368,415191456,265088
1359993906,415291032,11,9972,906.5454545,1359993879449,1359993880345,415264481,415265377,896
1359993934,415319060,1,186,186,1359993906300,1359993906300,415291360,415291360,0
1359993934,415319100,3,567,189,1359993907220,1359993907604,415292320,415292704,384
1359993946,415331008,1,52,52,1359993918191,1359993918191,415303199,415303199,0
1359994051,415435488,11,5654,514,1359994026486,1359994027446,415410974,415411934,960
1359994175,415559660,1,52,52,1359994148039,1359994148039,415532699,415532699,0
1359994269,415653988,2,104,52,1359994266943,1359994267135,415651931,415652123,192
1359994349,3349013032,15,12935,862.3333333,1359994342104,1359994342296,3349006136,3349006328,192
1359994357,3349021008,10,2298,229.8,1359994355058,1359994355250,3349019066,3349019258,192
1359994357,3349021024,11,5639,512.6363636,1359994352736,1359994352864,3349016760,3349016888,128
1359994357,3349021024,15,12087,805.8,1359994353311,1359994353695,3349017335,3349017719,384
1359994357,3349021028,16,13691,855.6875,1359994353309,1359994353629,3349017337,3349017657,320
1359994357,3349021028,10,2394,239.4,1359994354778,1359994355034,3349018806,3349019062,256
1359994357,3349021028,9,1398,155.3333333,1359994354778,1359994355546,3349018806,3349019574,768
1359994357,3349021032,12,5819,484.9166667,1359994355162,1359994355418,3349019194,3349019450,256
1359994357,3349021032,11,5192,472,1359994355417,1359994355545,3349019449,3349019577,128
1359994357,3349021032,12,5595,466.25,1359994351962,1359994352730,3349015994,3349016762,768
1359994357,3349021044,15,11303,753.5333333,1359994352843,1359994353035,3349016887,3349017079,192
1359994357,3349021048,11,5256,477.8181818,1359994354439,1359994354567,3349018487,3349018615,128
1359994357,3349021048,11,5256,477.8181818,1359994354438,1359994354630,3349018486,3349018678,192
1359994357,3349021048,11,5192,472,1359994354694,1359994354822,3349018742,3349018870,128
1359994357,3349021048,10,2490,249,1359994354758,1359994355142,3349018806,3349019190,384
1359994357,3349021048,9,1446,160.6666667,1359994354758,1359994354950,3349018806,3349018998,192
1359994357,3349021048,9,1414,157.1111111,1359994354822,1359994355846,3349018870,3349019894,1024
1359994357,3349021048,12,5851,487.5833333,1359994354694,1359994355270,3349018742,3349019318,576
1359994357,3349021052,9,1654,183.7777778,1359994354950,1359994355142,3349019002,3349019194,192
1359994364,415748460,24,25173,1048.875,1359994337231,1359994340687,415721691,415725147,3456
1359994365,3349029024,15,11271,751.4,1359994360094,1359994360286,3349024118,3349024310,192
1359994365,3349029028,12,5675,472.9166667,1359994360540,1359994360796,3349024568,3349024824,256
1359994365,3349029032,9,1430,158.8888889,1359994364378,1359994364698,3349028410,3349028730,320
1359994365,3349029032,9,1462,162.4444444,1359994364377,1359994364697,3349028409,3349028729,320
1359994365,3349029032,11,5192,472,1359994364504,1359994364696,3349028536,3349028728,192
1359994365,3349029032,11,5192,472,1359994364568,1359994364696,3349028600,3349028728,128
1359994365,3349029032,8,819,102.375,1359994364696,1359994364760,3349028728,3349028792,64
1359994365,3349029036,20,20030,1001.5,1359994362389,1359994363477,3349026425,3349027513,1088
1359994365,3349029048,15,12087,805.8,1359994360519,1359994360967,3349024567,3349025015,448
1359994365,3349029048,12,5675,472.9166667,1359994360778,1359994362122,3349024826,3349026170,1344
1359994365,3349029052,11,5192,472,1359994364101,1359994364293,3349028153,3349028345,192
1359994365,3349029052,12,5691,474.25,1359994364229,1359994364485,3349028281,3349028537,256
1359994365,3349029052,9,1398,155.3333333,1359994364356,1359994364676,3349028408,3349028728,320
1359994365,3349029052,8,819,102.375,1359994361347,1359994361411,3349025399,3349025463,64
1359994365,3349029052,8,1218,152.25,1359994364483,1359994364483,3349028535,3349028535,0
1359994365,3349029056,8,819,102.375,1359994364674,1359994364738,3349028730,3349028794,64
1359994365,3349029056,12,5675,472.9166667,1359994362114,1359994362370,3349026170,3349026426,256
1359994368,415752308,1,46,46,1359994341733,1359994341733,415726041,415726041,0
1359994368,415752324,9,3874,430.4444444,1359994340631,1359994341719,415724955,415726043,1088
1359994368,415752436,13,7192,553.2307692,1359994340963,1359994342179,415725399,415726615,1216
1359994373,3349037020,12,6075,506.25,1359994365283,1359994365539,3349029303,3349029559,256
1359994373,3349037024,17,15028,884,1359994368545,1359994369505,3349032569,3349033529,960
1359994373,3349037024,12,8722,726.8333333,1359994364383,1359994365215,3349028407,3349029239,832
1359994373,3349037028,12,5643,470.25,1359994370460,1359994370588,3349034488,3349034616,128
1359994373,415758024,14,13401,957.2142857,1359994355353,1359994370521,415740377,415755545,15168
1359994373,3349037044,8,1202,150.25,1359994365325,1359994365389,3349029369,3349029433,64
1359994373,3349037048,11,5192,472,1359994370247,1359994370375,3349034295,3349034423,128
1359994381,3349045028,11,5384,489.4545455,1359994374941,1359994375133,3349038969,3349039161,192
1359994381,3349045032,12,5537,461.4166667,1359994375130,1359994375322,3349039162,3349039354,192
1359994389,3349053028,6940,9881638,1423.867147,1359994375965,1359994382237,3349039993,3349046265,6272
1359994404,415788464,1,52,52,1359994378570,1359994378570,415763034,415763034,0
1359994404,415788560,1,52,52,1359994378474,1359994378474,415763034,415763034,0
1359994412,415796412,9,4328,480.8888889,1359994385085,1359994387965,415769497,415772377,2880
1359994412,415796496,2,1261,630.5,1359994384746,1359994385002,415769242,415769498,256
1359994485,415870120,3,138,46,1359994481975,1359994481975,415867095,415867095,0
1359994508,415892600,2,372,186,1359994482046,1359994482366,415866646,415866966,320
1359994508,415892692,20,9663,483.15,1359994482402,1359994487266,415867094,415871958,4864
1359994589,415974116,2,104,52,1359994581563,1359994581819,415966679,415966935,256
1359994753,416137760,1,52,52,1359994727196,1359994727196,416111956,416111956,0
1359994825,416209568,1,52,52,1359994800154,1359994800154,416184722,416184722,0
1359994825,416209652,5,400,80,1359994800070,1359994814918,416184722,416199570,14848
1359994833,416217656,2,112,56,1359994805187,1359994805443,416189843,416190099,256
1359994857,416241812,1,80,80,1359994830631,1359994830631,416215443,416215443,0
1359994889,416273872,1,80,80,1359994862376,1359994862376,416247248,416247248,0
1359994921,416305876,1,52,52,1359994896101,1359994896101,416280977,416280977,0
1359995038,416422564,3,3627,1209,1359995036505,1359995037401,416421069,416421965,896
1359995065,416450196,3,1204,401.3333333,1359995037923,1359995039459,416423119,416424655,1536
1359995065,416450232,6,2955,492.5,1359995039486,1359995039934,416424718,416425166,448
1359995407,416791432,2,129,64.5,1359995382490,1359995382490,416766922,416766922,0
1359995871,417255720,6,4831,805.1666667,1359995865648,1359995869360,417250368,417254080,3712
1359995896,417280632,5,2891,578.2,1359995869451,1359995869835,417254083,417254467,384
1359995911,417295724,3,138,46,1359995905069,1359995905069,417289793,417289793,0
1359995928,417312992,6,1116,186,1359995900770,1359995904354,417285762,417289346,3584
1359995932,417316968,17,6694,393.7647059,1359995904826,1359995908730,417289794,417293698,3904
1359995996,417381156,3,558,186,1359995969851,1359995971195,417355007,417356351,1344
1359996000,417385112,11,4162,378.3636364,1359995975142,1359995978086,417360254,417363198,2944
1359996060,417445192,2,368,184,1359996034905,1359996036633,417420097,417421825,1728
1359996064,417449188,13,5833,448.6923077,1359996039195,1359996041051,417424383,417426239,1856
1359996223,417607856,4,208,52,1359996218342,1359996220774,417603198,417605630,2432
1359996229,417613712,5,930,186,1359996201780,1359996220916,417586492,417605628,19136
1359996249,417633924,1,52,52,1359996223454,1359996223454,417608378,417608378,0
1359996257,417641868,3,558,186,1359996230742,1359996250774,417615610,417635642,20032
1359996285,417670008,1,186,186,1359996260620,1359996260620,417645628,417645628,0
1359996287,417671860,5,260,52,1359996281374,1359996284894,417666234,417669754,3520
1359996879,418264208,4,4203,1050.75,1359996876410,1359996878522,418261618,418263730,2112
1359996887,418272168,3,2994,998,1359996879776,1359996883360,418264944,418268528,3584
1359996903,418288208,2,1255,627.5,1359996888120,1359996897720,418273328,418282928,9600
1359997264,418648628,4,216,54,1359997256950,1359997257590,418641578,418642218,640
1359997283,418668076,1,46,46,1359997256313,1359997256313,418641389,418641389,0
1359997283,418668100,10,2500,250,1359997256287,1359997256863,418641387,418641963,576
1359997283,418668104,2,112,56,1359997256605,1359997256861,418641709,418641965,256
1359997283,418668200,1,52,52,1359997256572,1359997256572,418641772,418641772,0
1359997283,418668204,18,9530,529.4444444,1359997257017,1359997260601,418642221,418645805,3584
1359997375,418760184,6,4036,672.6666667,1359997348362,1359997349898,418733546,418735082,1536
1359997375,418760184,9,5297,588.5555556,1359997348489,1359997366409,418733673,418751593,17920
1359997387,418772248,1,95,95,1359997361674,1359997361674,418746922,418746922,0
1359997395,418780276,2,104,52,1359997367340,1359997367596,418752616,418752872,256
1359997395,418780280,3,164,54.66666667,1359997367081,1359997367529,418752361,418752809,448
1359997428,418812364,2,1197,598.5,1359997400956,1359997401788,418785320,418786152,832
1359997492,418876440,2,1197,598.5,1359997465456,1359997466160,418849896,418850600,704
1359997504,418888796,3,156,52,1359997500878,1359997503182,418885674,418887978,2304
1359997508,418892460,1,46,46,1359997482780,1359997482780,418867240,418867240,0
1359997604,418988628,3,172,57.33333333,1359997576241,1359997580849,418960869,418965477,4608
1359997608,418992640,1,52,52,1359997580841,1359997580841,418965481,418965481,0
1359997616,419000668,2,1197,598.5,1359997589898,1359997590602,418974566,418975270,704
1359997672,419056932,3,138,46,1359997665666,1359997665666,419050598,419050598,0
1359997688,419072720,4,752,188,1359997661847,1359997663511,419046567,419048231,1664
1359997692,419076780,14,8409,600.6428571,1359997665817,1359997667545,419050597,419052325,1728
1359997748,419132980,1,52,52,1359997721296,1359997721296,419106276,419106276,0
1359997752,419136956,1,46,46,1359997724072,1359997724072,419109028,419109028,0
1359997860,419245068,6,4036,672.6666667,1359997833657,1359997835065,419218725,419220133,1408
1359997869,419253436,2,372,186,1359997842157,1359997842989,419226593,419227425,832
1359997872,419257088,4,1193,298.25,1359997845348,1359997846180,419230436,419231268,832
1359997996,419381280,1,46,46,1359997968481,1359997968481,419353761,419353761,0
1359998089,419473592,4,208,52,1359998086609,1359998088401,419471201,419472993,1792
1359998105,419489332,6,4036,672.6666667,1359998079316,1359998080788,419463648,419465120,1472
1359998105,419489336,16,6843,427.6875,1359998079376,1359998080720,419463712,419465056,1344
1359998145,419529724,3,210,70,1359998140363,1359998141771,419525087,419526495,1408
1359998237,419621888,1,46,46,1359998211683,1359998211683,419596571,419596571,0
1359998349,419734084,8,4211,526.375,1359998323485,1359998325469,419708569,419710553,1984
1359998486,419870572,1,46,46,1359998458524,1359998458524,419843096,419843096,0
1359998598,419982724,7,4100,585.7142857,1359998569412,1359998570820,419954136,419955544,1408
1359998726,420110908,1,46,46,1359998700361,1359998700361,420085269,420085269,0
1359998774,420158896,5,321,64.2,1359998749139,1359998749139,420134035,420134035,0
1359998778,420162560,11,6332,575.6363636,1359998771235,1359998772067,420155795,420156627,832
1359998786,420170488,13,5923,455.6153846,1359998772458,1359998783850,420156946,420168338,11392
1359998794,420178504,3,138,46,1359998786714,1359998786714,420171218,420171218,0
1359998798,420182916,3,1982,660.6666667,1359998771646,1359998771710,420156562,420156626,64
1359998798,420182980,9,3768,418.6666667,1359998769791,1359998771839,420154771,420156819,2048
1359998838,420223060,7,4100,585.7142857,1359998813613,1359998815085,420198673,420200145,1472
1359998970,420355264,1,46,46,1359998945379,1359998945379,420330643,420330643,0
1359999018,420402644,4,208,52,1359999012238,1359999013902,420396882,420398546,1664
1359999087,420471420,6,4036,672.6666667,1359999059307,1359999060779,420443727,420445199,1472
1359999098,420482716,3,138,46,1359999092036,1359999095108,420476752,420479824,3072
1359999207,420591952,1,46,46,1359999179415,1359999179415,420564367,420564367,0
1359999219,420603880,1,46,46,1359999191262,1359999191262,420576142,420576142,0
1359999319,420704084,1,95,95,1359999293647,1359999293647,420678731,420678731,0
1359999331,420716024,7,4100,585.7142857,1359999303628,1359999305036,420688652,420690060,1408
1359999464,420848628,1,46,46,1359999439509,1359999439509,420824137,420824137,0
1359999576,420960800,9,5297,588.5555556,1359999549034,1359999552362,420933834,420937162,3328
1359999672,421057176,1,46,46,1359999644014,1359999644014,421029190,421029190,0
1359999676,421061224,2,129,64.5,1359999648382,1359999648382,421033606,421033606,0
1359999705,421089336,1,46,46,1359999679989,1359999679989,421064325,421064325,0
1359999821,421205828,6,4036,672.6666667,1359999793866,1359999795274,421178694,421180102,1408
1360079606,500990980,1,46,46,1360079579615,1360079579615,500964595,500964595,0
1360080448,501832644,1,46,46,1360080420769,1360080420769,501805413,501805413,0
1360080520,501904996,2,92,46,1360080492224,1360080495168,501877220,501880164,2944
1360080869,502253680,1,46,46,1360080841269,1360080841269,502225949,502225949,0
1360081230,502614280,1,64,64,1360081204674,1360081204674,502588954,502588954,0
1360081230,502614288,1,64,64,1360081205175,1360081205175,502589463,502589463,0
1360081258,502642352,1,46,46,1360081230713,1360081230713,502615065,502615065,0
1360082184,503568792,1,46,46,1360082159026,1360082159026,503543818,503543818,0
1360082353,503737168,1,46,46,1360082327582,1360082327582,503711750,503711750,0
1360099774,521158580,1,46,46,1360099746417,1360099746417,521130997,521130997,0
1360099854,521238948,1,77,77,1360099826627,1360099826627,521211575,521211575,0
1360099887,521271092,7,3617,516.7142857,1360099861851,1360099862811,521245943,521246903,960
1360100019,521403508,1,46,46,1360099991733,1360099991733,521376241,521376241,0
1360100131,521515792,6,3565,594.1666667,1360100105239,1360100106007,521490031,521490799,768
1360100252,521636396,2,104,52,1360100239842,1360100245218,521624238,521629614,5376
1360100264,521648108,11,2449,222.6363636,1360100238017,1360100242049,521622125,521626157,4032
1360100264,521648192,1,46,46,1360100237424,1360100237424,521621616,521621616,0
1360100268,521652248,2,112,56,1360100242551,1360100242807,521626799,521627055,256
1360100268,521652452,1,52,52,1360100242604,1360100242604,521627056,521627056,0
1360100300,521684248,2,112,56,1360100272565,1360100272821,521656813,521657069,256
1360100300,521684252,2,104,52,1360100272818,1360100273010,521657070,521657262,192
1360100372,3455036024,18,20496,1138.666667,1360100365333,1360100366037,3455029357,3455030061,704
1360100376,521760344,3,164,54.66666667,1360100349013,1360100349461,521733357,521733805,448
1360100376,521760348,2,104,52,1360100349199,1360100349455,521733547,521733803,256
1360100376,521760460,6,3549,591.5,1360100349984,1360100350816,521734444,521735276,832
1360100380,3455044028,8,2173,271.625,1360100366673,1360100373393,3455030701,3455037421,6720
1360100388,3455052028,18,20495,1138.611111,1360100385492,1360100385684,3455049520,3455049712,192
1360100388,3455052028,18,20495,1138.611111,1360100385747,1360100385875,3455049775,3455049903,128
1360100388,3455052028,6,3450,575,1360100366098,1360100385554,3455030126,3455049582,19456
1360100388,3455052028,18,20495,1138.611111,1360100386322,1360100386450,3455050350,3455050478,128
1360100388,3455052048,28,31745,1133.75,1360100366016,1360100385472,3455030064,3455049520,19456
1360100388,3455052048,18,20495,1138.611111,1360100385855,1360100386047,3455049903,3455050095,192
1360100388,3455052048,5,1727,345.4,1360100366845,1360100383357,3455030893,3455047405,16512
1360100388,3455052052,5,2216,443.2,1360100367100,1360100381820,3455031152,3455045872,14720
1360100392,521776416,25,6751,270.04,1360100367566,1360100387598,521751982,521772014,20032
1360100392,521776456,6,482,80.33333333,1360100365285,1360100365989,521749741,521750445,704
1360100392,521776456,7,563,80.42857143,1360100365285,1360100366181,521749741,521750637,896
1360100393,3455056580,8,3804,475.5,1360100368529,1360100392849,3455032109,3455056429,24320
1360100396,521780676,2,131,65.5,1360100395339,1360100395339,521780015,521780015,0
1360100396,521780752,2,131,65.5,1360100395197,1360100395197,521779949,521779949,0
1360100396,3455060024,4,1334,333.5,1360100391317,1360100392405,3455055341,3455056429,1088
1360100396,3455060044,4,1576,394,1360100392066,1360100392386,3455056110,3455056430,320
1360100400,521784344,18,1948,108.2222222,1360100372627,1360100393043,521756971,521777387,20416
1360100404,3455068024,4,1555,388.75,1360100392408,1360100401240,3455056432,3455065264,8832
1360100404,3455068024,5,2144,428.8,1360100392599,1360100401239,3455056623,3455065263,8640
1360100404,3455068024,5,2144,428.8,1360100392663,1360100401239,3455056687,3455065263,8576
1360100404,3455068024,5,2370,474,1360100392535,1360100401239,3455056559,3455065263,8704
1360100404,3455068024,4,1655,413.75,1360100392726,1360100401238,3455056750,3455065262,8512
1360100404,3455068024,5,1793,358.6,1360100392854,1360100401238,3455056878,3455065262,8384
1360100404,3455068024,4,1204,301,1360100393174,1360100401238,3455057198,3455065262,8064
1360100404,3455068024,4,1391,347.75,1360100401109,1360100401301,3455065133,3455065325,192
1360100404,3455068024,5,1890,378,1360100401172,1360100402324,3455065196,3455066348,1152
1360100404,3455068028,5,1751,350.2,1360100401491,1360100402323,3455065519,3455066351,832
1360100404,3455068028,5,2009,401.8,1360100401746,1360100402322,3455065774,3455066350,576
1360100404,3455068028,5,1727,345.4,1360100401810,1360100402322,3455065838,3455066350,512
1360100404,3455068028,4,1190,297.5,1360100401873,1360100402321,3455065901,3455066349,448
1360100404,3455068028,4,1058,264.5,1360100401937,1360100402385,3455065965,3455066413,448
1360100404,3455068028,4,1312,328,1360100402128,1360100402384,3455066156,3455066412,256
1360100404,3455068032,4,1576,394,1360100402064,1360100402384,3455066096,3455066416,320
1360100404,3455068032,5,2081,416.2,1360100392464,1360100401232,3455056496,3455065264,8768
1360100404,3455068036,5,2011,402.2,1360100392652,1360100401228,3455056688,3455065264,8576
1360100404,3455068036,4,1408,352,1360100392779,1360100401227,3455056815,3455065263,8448
1360100404,3455068036,4,1334,333.5,1360100392971,1360100401227,3455057007,3455065263,8256
1360100404,3455068036,5,1853,370.6,1360100393034,1360100401226,3455057070,3455065262,8192
1360100404,3455068036,5,1783,356.6,1360100400906,1360100401226,3455064942,3455065262,320
1360100404,3455068036,4,1609,402.25,1360100393226,1360100401290,3455057262,3455065326,8064
1360100404,3455068036,5,2011,402.2,1360100400970,1360100401290,3455065006,3455065326,320
1360100404,3455068048,5,1852,370.4,1360100401279,1360100402303,3455065327,3455066351,1024
1360100404,3455068048,5,2056,411.2,1360100401407,1360100402303,3455065455,3455066351,896
1360100404,3455068048,5,1950,390,1360100401598,1360100402302,3455065646,3455066350,704
1360100404,3455068048,4,1334,333.5,1360100401981,1360100402365,3455066029,3455066413,384
1360100404,3455068052,4,1312,328,1360100392122,1360100401210,3455056174,3455065262,9088
1360100404,3455068052,5,1727,345.4,1360100392250,1360100401210,3455056302,3455065262,8960
1360100404,3455068052,4,1190,297.5,1360100392377,1360100401209,3455056429,3455065261,8832
1360100409,3455072632,1,46,46,1360100382303,1360100382303,3455045935,3455045935,0
1360100412,521796384,3,254,84.66666667,1360100385774,1360100385838,521770158,521770222,64
1360100412,3455076024,5,2009,401.8,1360100408536,1360100409688,3455072560,3455073712,1152
1360100412,3455076024,5,1727,345.4,1360100408599,1360100409687,3455072623,3455073711,1088
1360100412,3455076024,4,1190,297.5,1360100408662,1360100409686,3455072686,3455073710,1024
1360100412,3455076024,4,1058,264.5,1360100408790,1360100409686,3455072814,3455073710,896
1360100412,3455076024,4,1334,333.5,1360100408854,1360100409686,3455072878,3455073710,832
1360100412,3455076024,4,1576,394,1360100408981,1360100409685,3455073005,3455073709,704
1360100412,3455076024,6,3390,565,1360100404117,1360100406613,3455068141,3455070637,2496
1360100412,3455076024,5,1727,345.4,1360100409108,1360100409684,3455073132,3455073708,576
1360100412,3455076024,4,1555,388.75,1360100409300,1360100409684,3455073324,3455073708,384
1360100412,3455076028,5,2370,474,1360100409492,1360100409684,3455073520,3455073712,192
1360100412,3455076028,5,1950,390,1360100405523,1360100406611,3455069551,3455070639,1088
1360100412,3455076028,5,2009,401.8,1360100405651,1360100406611,3455069679,3455070639,960
1360100412,3455076028,4,1312,328,1360100406225,1360100406609,3455070253,3455070637,384
1360100412,3455076028,4,1576,394,1360100406161,1360100406609,3455070189,3455070637,448
1360100412,3455076028,4,1555,388.75,1360100406481,1360100408145,3455070509,3455072173,1664
1360100412,3455076028,4,1190,297.5,1360100406420,1360100406612,3455070448,3455070640,192
1360100412,3455076032,5,2144,428.8,1360100406991,1360100408143,3455071023,3455072175,1152
1360100412,3455076032,5,1727,345.4,1360100402255,1360100403983,3455066287,3455068015,1728
1360100412,3455076032,5,2370,474,1360100406735,1360100408143,3455070767,3455072175,1408
1360100412,3455076032,5,1793,358.6,1360100407247,1360100408143,3455071279,3455072175,896
1360100412,3455076032,5,2144,428.8,1360100406799,1360100408143,3455070831,3455072175,1344
1360100412,3455076032,5,2144,428.8,1360100402766,1360100403982,3455066798,3455068014,1216
1360100412,3455076032,4,1204,301,1360100407502,1360100408142,3455071534,3455072174,640
1360100412,3455076032,5,2144,428.8,1360100402958,1360100403982,3455066990,3455068014,1024
1360100412,3455076032,5,1853,370.6,1360100407437,1360100408141,3455071469,3455072173,704
1360100412,3455076032,4,1391,347.75,1360100407885,1360100408141,3455071917,3455072173,256
1360100412,3455076032,5,1890,378,1360100407949,1360100408141,3455071981,3455072173,192
1360100412,3455076032,5,1853,370.6,1360100403405,1360100403981,3455067437,3455068013,576
1360100412,3455076032,4,1204,301,1360100403469,1360100404045,3455067501,3455068077,576
1360100412,3455076032,4,1609,402.25,1360100403597,1360100404045,3455067629,3455068077,448
1360100412,3455076032,5,1783,356.6,1360100403661,1360100404045,3455067693,3455068077,384
1360100412,3455076032,5,2056,411.2,1360100408204,1360100409676,3455072236,3455073708,1472
1360100412,3455076032,5,1950,390,1360100408400,1360100409680,3455072432,3455073712,1280
1360100412,3455076036,4,1312,328,1360100409033,1360100409673,3455073069,3455073709,640
1360100412,3455076036,4,1190,297.5,1360100409225,1360100409673,3455073261,3455073709,448
1360100412,3455076036,5,1852,370.4,1360100405257,1360100406601,3455069293,3455070637,1344
1360100412,3455076036,5,2056,411.2,1360100405384,1360100406600,3455069420,3455070636,1216
1360100412,3455076036,5,2081,416.2,1360100409416,1360100409736,3455073452,3455073772,320
1360100412,3455076040,5,1751,350.2,1360100405448,1360100406600,3455069488,3455070640,1152
1360100412,3455076052,5,1727,345.4,1360100405755,1360100406587,3455069807,3455070639,832
1360100412,3455076052,4,1190,297.5,1360100405819,1360100406587,3455069871,3455070639,768
1360100412,3455076052,4,1058,264.5,1360100405946,1360100406586,3455069998,3455070638,640
1360100412,3455076052,4,1334,333.5,1360100406010,1360100406586,3455070062,3455070638,576
1360100412,3455076052,5,1727,345.4,1360100406265,1360100406585,3455070317,3455070637,320
1360100412,3455076052,5,2081,416.2,1360100406584,1360100408120,3455070636,3455072172,1536
1360100412,3455076052,5,2011,402.2,1360100406908,1360100408124,3455070960,3455072176,1216
1360100412,3455076056,4,1655,413.75,1360100407095,1360100408119,3455071151,3455072175,1024
1360100412,3455076056,4,1408,352,1360100407159,1360100408119,3455071215,3455072175,960
1360100412,3455076056,4,1190,297.5,1360100402359,1360100403959,3455066415,3455068015,1600
1360100412,3455076056,4,1555,388.75,1360100402487,1360100403959,3455066543,3455068015,1472
1360100412,3455076056,5,2081,416.2,1360100402551,1360100403959,3455066607,3455068015,1408
1360100412,3455076056,5,2370,474,1360100402679,1360100403959,3455066735,3455068015,1280
1360100412,3455076056,4,1334,333.5,1360100407351,1360100408119,3455071407,3455072175,768
1360100412,3455076056,5,2011,402.2,1360100402806,1360100403958,3455066862,3455068014,1152
1360100412,3455076056,5,1783,356.6,1360100407670,1360100408118,3455071726,3455072174,448
1360100412,3455076056,4,1609,402.25,1360100407606,1360100408118,3455071662,3455072174,512
1360100412,3455076056,5,2011,402.2,1360100407798,1360100408118,3455071854,3455072174,320
1360100412,3455076056,4,1655,413.75,1360100402997,1360100403957,3455067053,3455068013,960
1360100412,3455076056,4,1408,352,1360100403125,1360100403957,3455067181,3455068013,832
1360100412,3455076056,5,1793,358.6,1360100403189,1360100403957,3455067245,3455068013,768
1360100412,3455076056,4,1334,333.5,1360100403253,1360100403957,3455067309,3455068013,704
1360100412,3455076056,5,2011,402.2,1360100403765,1360100404021,3455067821,3455068077,256
1360100412,3455076056,4,1391,347.75,1360100403893,1360100406581,3455067949,3455070637,2688
1360100412,3455076056,5,1852,370.4,1360100408053,1360100409653,3455072109,3455073709,1600
1360100412,3455076056,5,1751,350.2,1360100408309,1360100409653,3455072365,3455073709,1344
1360100416,521800528,8,719,89.875,1360100390238,1360100392734,521774766,521777262,2496
1360100420,3455084028,4,1391,347.75,1360100416532,1360100417044,3455080560,3455081072,512
1360100420,3455084028,5,1751,350.2,1360100416850,1360100417042,3455080878,3455081070,192
1360100420,3455084028,5,2009,401.8,1360100417041,1360100418897,3455081069,3455082925,1856
1360100420,3455084028,4,1334,333.5,1360100417428,1360100418900,3455081456,3455082928,1472
1360100420,3455084032,4,1576,394,1360100417488,1360100418896,3455081520,3455082928,1408
1360100420,3455084032,4,1312,328,1360100417615,1360100418895,3455081647,3455082927,1280
1360100420,3455084032,5,1727,345.4,1360100417679,1360100418895,3455081711,3455082927,1216
1360100420,3455084032,5,2144,428.8,1360100409871,1360100416975,3455073903,3455081007,7104
1360100420,3455084032,4,1555,388.75,1360100417870,1360100418894,3455081902,3455082926,1024
1360100420,3455084032,5,2081,416.2,1360100417998,1360100418894,3455082030,3455082926,896
1360100420,3455084032,4,1204,301,1360100410380,1360100416972,3455074412,3455081004,6592
1360100420,3455084036,5,2011,402.2,1360100410636,1360100417036,3455074672,3455081072,6400
1360100420,3455084040,5,1890,378,1360100416648,1360100417032,3455080688,3455081072,384
1360100420,3455084040,5,1852,370.4,1360100416712,1360100417032,3455080752,3455081072,320
1360100420,3455084040,5,2056,411.2,1360100416839,1360100417031,3455080879,3455081071,192
1360100420,3455084040,5,1950,390,1360100416903,1360100418887,3455080943,3455082927,1984
1360100420,3455084040,5,1727,345.4,1360100417158,1360100418886,3455081198,3455082926,1728
1360100420,3455084040,4,1190,297.5,1360100417222,1360100418886,3455081262,3455082926,1664
1360100420,3455084040,4,1058,264.5,1360100417350,1360100418886,3455081390,3455082926,1536
1360100420,3455084040,5,2144,428.8,1360100409541,1360100416965,3455073581,3455081005,7424
1360100420,3455084040,5,2011,402.2,1360100409736,1360100416968,3455073776,3455081008,7232
1360100420,3455084052,4,1190,297.5,1360100417787,1360100418875,3455081839,3455082927,1088
1360100420,3455084052,4,1408,352,1360100409979,1360100416955,3455074031,3455081007,6976
1360100420,3455084052,5,2370,474,1360100418042,1360100418874,3455082094,3455082926,832
1360100420,3455084052,4,1655,413.75,1360100409914,1360100416954,3455073966,3455081006,7040
1360100420,3455084052,5,2144,428.8,1360100418106,1360100418938,3455082158,3455082990,832
1360100420,3455084052,5,2011,402.2,1360100418106,1360100418938,3455082158,3455082990,832
1360100420,3455084052,5,1853,370.6,1360100410298,1360100416954,3455074350,3455081006,6656
1360100420,3455084052,5,2144,428.8,1360100418170,1360100418938,3455082222,3455082990,768
1360100420,3455084052,5,1793,358.6,1360100410105,1360100416953,3455074157,3455081005,6848
1360100420,3455084052,4,1609,402.25,1360100410425,1360100417017,3455074477,3455081069,6592
1360100420,3455084052,4,1334,333.5,1360100410169,1360100416953,3455074221,3455081005,6784
1360100420,3455084052,4,1655,413.75,1360100418745,1360100418937,3455082797,3455082989,192
1360100420,3455084052,5,1783,356.6,1360100410553,1360100417017,3455074605,3455081069,6464
1360100428,521812632,1,46,46,1360100401011,1360100401011,521785643,521785643,0
1360100428,521812824,1,46,46,1360100400819,1360100400819,521785643,521785643,0
1360100428,3455092024,5,1950,390,1360100419992,1360100420504,3455084016,3455084528,512
1360100428,3455092024,5,2009,401.8,1360100420055,1360100420503,3455084079,3455084527,448
1360100428,3455092024,4,1312,328,1360100420695,1360100422231,3455084719,3455086255,1536
1360100428,3455092024,5,1727,345.4,1360100420182,1360100420502,3455084206,3455084526,320
1360100428,3455092024,4,1555,388.75,1360100420950,1360100422230,3455084974,3455086254,1280
1360100428,3455092024,4,1190,297.5,1360100420246,1360100420502,3455084270,3455084526,256
1360100428,3455092024,5,2081,416.2,1360100421013,1360100422229,3455085037,3455086253,1216
1360100428,3455092024,5,2011,402.2,1360100421333,1360100422229,3455085357,3455086253,896
1360100428,3455092024,5,2370,474,1360100421141,1360100422229,3455085165,3455086253,1088
1360100428,3455092024,4,1058,264.5,1360100420309,1360100420501,3455084333,3455084525,192
1360100428,3455092024,5,2144,428.8,1360100421205,1360100422229,3455085229,3455086253,1024
1360100428,3455092024,5,2144,428.8,1360100421397,1360100422229,3455085421,3455086253,832
1360100428,3455092028,4,1655,413.75,1360100421588,1360100422228,3455085616,3455086256,640
1360100428,3455092028,4,1408,352,1360100421652,1360100422228,3455085680,3455086256,576
1360100428,3455092028,5,1853,370.6,1360100421971,1360100422227,3455085999,3455086255,256
1360100428,3455092028,4,1204,301,1360100422034,1360100422226,3455086062,3455086254,192
1360100428,3455092032,4,1408,352,1360100418832,1360100420496,3455082864,3455084528,1664
1360100428,3455092032,5,1793,358.6,1360100418960,1360100420496,3455082992,3455084528,1536
1360100428,3455092032,4,1334,333.5,1360100419024,1360100420496,3455083056,3455084528,1472
1360100428,3455092032,5,1853,370.6,1360100419087,1360100420495,3455083119,3455084527,1408
1360100428,3455092032,4,1204,301,1360100419215,1360100420495,3455083247,3455084527,1280
1360100428,3455092032,5,2011,402.2,1360100419470,1360100420494,3455083502,3455084526,1024
1360100428,3455092032,5,1852,370.4,1360100419726,1360100420494,3455083758,3455084526,768
1360100428,3455092036,4,1576,394,1360100420555,1360100422219,3455084591,3455086255,1664
1360100428,3455092036,5,1727,345.4,1360100420746,1360100422218,3455084782,3455086254,1472
1360100428,3455092036,4,1190,297.5,1360100420874,1360100422218,3455084910,3455086254,1344
1360100428,3455092048,4,1334,333.5,1360100420416,1360100422208,3455084464,3455086256,1792
1360100428,3455092048,5,1793,358.6,1360100421695,1360100422207,3455085743,3455086255,512
1360100428,3455092048,4,1334,333.5,1360100421886,1360100422206,3455085934,3455086254,320
1360100428,3455092052,5,1783,356.6,1360100419322,1360100420474,3455083374,3455084526,1152
1360100428,3455092052,4,1609,402.25,1360100419258,1360100420474,3455083310,3455084526,1216
1360100428,3455092052,4,1391,347.75,1360100419514,1360100420474,3455083566,3455084526,960
1360100428,3455092052,5,1751,350.2,1360100419897,1360100420473,3455083949,3455084525,576
1360100428,3455092052,5,1890,378,1360100419641,1360100420473,3455083693,3455084525,832
1360100428,3455092052,5,2056,411.2,1360100419769,1360100420473,3455083821,3455084525,704
1360100429,521812984,4,223,55.75,1360100422972,1360100423036,521806956,521807020,64
1360100429,521813060,4,223,55.75,1360100422896,1360100422960,521806956,521807020,64
1360100449,3455112608,3,1557,519,1360100422583,1360100422647,3455086191,3455086255,64
1360100449,3455112608,4,1731,432.75,1360100422710,1360100422710,3455086318,3455086318,0
1360100449,3455112608,4,1959,489.75,1360100422776,1360100422776,3455086384,3455086384,0
1360100449,3455112620,4,1838,459.5,1360100422955,1360100422955,3455086575,3455086575,0
1360100449,3455112620,4,1800,450,1360100423019,1360100423019,3455086639,3455086639,0
1360100449,3455112620,4,2004,501,1360100423082,1360100423146,3455086702,3455086766,64
1360100449,3455112620,4,1699,424.75,1360100423210,1360100423210,3455086830,3455086830,0
1360100449,3455112656,3,1339,446.3333333,1360100422791,1360100422855,3455086447,3455086511,64
1360100460,521844896,11,1471,133.7272727,1360100433838,1360100452462,521818734,521837358,18624
1360100504,521888932,1,46,46,1360100479109,1360100479109,521864041,521864041,0
1360100597,521981304,4,184,46,1360100594364,1360100596412,521978668,521980716,2048
1360100605,521989212,2,92,46,1360100598804,1360100603476,521983016,521987688,4672
1360100629,522012960,6,2736,456,1360100603536,1360100624016,521987496,522007976,20480
1360100629,522013204,2,92,46,1360100612766,1360100624478,521996970,522008682,11712
1360100645,522028984,4,232,58,1360100619833,1360100636153,522003817,522020137,16320
1360100653,522037048,5,3188,637.6,1360100624953,1360100625401,522009001,522009449,448
1360100661,522045056,1,52,52,1360100636083,1360100636083,522020139,522020139,0
1360100673,522057036,1,456,456,1360100645123,1360100645123,522029159,522029159,0
1360100677,522061340,3,138,46,1360100675798,1360100676502,522060138,522060842,704
1360100709,522093012,1,46,46,1360100683227,1360100683227,522067239,522067239,0
1360100757,522141092,8,2817,352.125,1360100732813,1360100733709,522116905,522117801,896
1360100765,522149092,1,46,46,1360100737674,1360100737674,522121766,522121766,0
1360100785,522169092,1,46,46,1360100759309,1360100759309,522143401,522143401,0
1360100885,522269092,4,1081,270.25,1360100857290,1360100883594,522241382,522267686,26304
1360100893,522277204,1,46,46,1360100868121,1360100868121,522252325,522252325,0
1360100893,522277300,5,3188,637.6,1360100868665,1360100869113,522252965,522253413,448
1360100893,522277456,26,3899,149.9615385,1360100885471,1360100886111,522269927,522270567,640
1360100893,522277536,55,5345,97.18181818,1360100886220,1360100886796,522270756,522271332,576
1360100909,522293300,7,3444,492,1360100884665,1360100885241,522268965,522269541,576
1360100913,522297232,1,46,46,1360100887743,1360100887743,522271975,522271975,0
1360100917,522301468,11,5284,480.3636364,1360100909266,1360100912786,522293734,522297254,3520
1360100929,522313564,18,4152,230.6666667,1360100900979,1360100902323,522285543,522286887,1344
1360100950,3455613312,1,52,52,1360100923104,1360100923104,3455586416,3455586416,0
1360100950,3455613312,1,52,52,1360100923168,1360100923168,3455586480,3455586480,0
1360100950,3455613328,1,52,52,1360100923346,1360100923346,3455586674,3455586674,0
1360100950,3455613328,1,52,52,1360100923472,1360100923472,3455586800,3455586800,0
1360100950,3455613356,1,52,52,1360100922868,1360100922868,3455586224,3455586224,0
1360100950,3455613356,1,52,52,1360100923000,1360100923000,3455586356,3455586356,0
1360100950,3455613360,1,52,52,1360100923184,1360100923184,3455586544,3455586544,0
1360100950,3455613364,1,52,52,1360100923373,1360100923373,3455586737,3455586737,0
1360100965,522349476,9,3464,384.8888889,1360100936968,1360100937608,522321444,522322084,640
1360100981,522365764,5,260,52,1360100973034,1360100976810,522357798,522361574,3776
1360101021,522405808,1,52,52,1360100995965,1360100995965,522380773,522380773,0
1360101025,522409772,1,46,46,1360100997088,1360100997088,522381860,522381860,0
1360101029,522413596,3,254,84.66666667,1360101002702,1360101004110,522387298,522388706,1408
1360101062,522446060,4,256,64,1360101057766,1360101058278,522441826,522442338,512
1360101101,522485892,2,192,96,1360101073573,1360101073573,522458465,522458465,0
1360101118,522502264,5,230,46,1360101111513,1360101116377,522495777,522500641,4864
1360101120,3455783648,1,46,46,1360101091282,1360101091282,3455754930,3455754930,0
1360101126,522510412,2,104,52,1360101125126,1360101125318,522509538,522509730,192
1360101134,522518280,3,156,52,1360101125896,1360101128584,522510176,522512864,2688
1360101134,522518316,2,92,46,1360101120996,1360101130276,522505312,522514592,9280
1360101166,522550012,2,129,64.5,1360101140628,1360101140628,522524640,522524640,0
1360101166,522550044,1,46,46,1360101141748,1360101141748,522525792,522525792,0
1360101170,522553980,5,3188,637.6,1360101142134,1360101142518,522526114,522526498,384
1360101298,522682584,1,46,46,1360101270807,1360101270807,522655391,522655391,0
1360101302,522686456,4,208,52,1360101298777,1360101301529,522683233,522685985,2752
1360101314,522698792,1,52,52,1360101289223,1360101289223,522674015,522674015,0
1360101386,522770780,1,46,46,1360101358482,1360101358482,522743262,522743262,0
1360101410,522794900,6,3565,594.1666667,1360101384409,1360101385241,522769309,522770141,832
1360101542,522926932,1,46,46,1360101517688,1360101517688,522902620,522902620,0
1360101655,523039384,6,3565,594.1666667,1360101628891,1360101629851,523013275,523014235,960
1360101787,523171660,1,46,46,1360101760580,1360101760580,523145240,523145240,0
1360101899,523283872,6,3565,594.1666667,1360101872686,1360101873646,523257558,523258518,960
1360102028,523412036,1,46,46,1360102001584,1360102001584,523385620,523385620,0
1360102068,523452040,4,308,77,1360102040620,1360102042412,523424660,523426452,1792
1360102144,523528188,6,3549,591.5,1360102117335,1360102118295,523501523,523502483,960
1360102272,523656364,1,46,46,1360102244899,1360102244899,523629263,523629263,0
1360102388,523772584,6,3565,594.1666667,1360102360901,1360102361669,523745485,523746253,768
1360102447,523831776,1,46,46,1360102417990,1360102417990,523802766,523802766,0
1360102516,523900796,1,46,46,1360102489585,1360102489585,523874381,523874381,0
1360102543,523927416,12,3367,280.5833333,1360102535917,1360102537005,523920333,523921421,1088
1360102632,524016928,6,3565,594.1666667,1360102604585,1360102605417,523989513,523990345,832
1360102653,524037040,2,122,61,1360102626019,1360102626787,524010059,524010827,768
1360102765,524149324,1,46,46,1360102737542,1360102737542,524121866,524121866,0
1360102873,524257680,6,3549,591.5,1360102848799,1360102849631,524233479,524234311,832
1360102965,524349824,3,218,72.66666667,1360102939982,1360102943054,524324806,524327878,3072
1360103009,524393848,1,46,46,1360102982387,1360102982387,524367235,524367235,0
1360103041,524425868,1,52,52,1360103014816,1360103014816,524399684,524399684,0
1360103078,524462000,1,52,52,1360103053379,1360103053379,524437379,524437379,0
1360103117,524501924,6,3565,594.1666667,1360103092647,1360103093479,524477571,524478403,832
1360103250,524634252,1,46,46,1360103224644,1360103224644,524608896,524608896,0
1360103296,524679980,4,216,54,1360103290132,1360103290900,524674112,524674880,768
1360103314,524698304,9,2325,258.3333333,1360103287824,1360103290064,524672128,524674368,2240
1360103314,524698340,1,52,52,1360103288490,1360103288490,524672830,524672830,0
1360103318,524702180,1,52,52,1360103290187,1360103290187,524674367,524674367,0
1360103318,524702184,3,164,54.66666667,1360103290249,1360103290761,524674433,524674945,512
1360103362,524746332,6,3549,591.5,1360103337778,1360103338738,524722110,524723070,960
1360103490,524874796,1,46,46,1360103464160,1360103464160,524848956,524848956,0
1360103927,525311840,8,1504,188,1360103898864,1360103923440,525283704,525308280,24576
1360103960,525344012,3,564,188,1360103934314,1360103954282,525318326,525338294,19968
1360105061,526445224,1,46,46,1360105035395,1360105035395,526419619,526419619,0
1360105870,527254768,1,46,46,1360105842521,1360105842521,527227289,527227289,0
1360108255,529639012,1,48,48,1360108228004,1360108228004,529612016,529612016,0
1360108667,530051000,1,48,48,1360108639149,1360108639149,530023149,530023149,0
1360109540,530924620,1,60,60,1360109515568,1360109515568,530900188,530900188,0
1360110518,531902032,1,52,52,1360110490991,1360110490991,531875023,531875023,0
1360110594,531978196,1,52,52,1360110565835,1360110565835,531950031,531950031,0
1360110632,532016648,1,46,46,1360110603015,1360110603015,531987663,531987663,0
1360110666,532050436,1,52,52,1360110640600,1360110640600,532025036,532025036,0
1360110742,532126560,1,52,52,1360110715482,1360110715482,532100042,532100042,0
1360110818,532202784,1,52,52,1360110790268,1360110790268,532175052,532175052,0
1360110890,532274808,1,52,52,1360110865251,1360110865251,532250059,532250059,0
1360110966,532350924,1,52,52,1360110940139,1360110940139,532325063,532325063,0
1360111043,532427224,1,52,52,1360111015846,1360111015846,532400070,532400070,0
1360111115,532499500,1,52,52,1360111090514,1360111090514,532475014,532475014,0
1360111191,532575856,1,52,52,1360111165165,1360111165165,532550021,532550021,0
1360115915,537299832,1,78,78,1360115887930,1360115887930,537272762,537272762,0
1360117153,538537448,2,122,61,1360117125606,1360117128038,538510054,538512486,2432
1360117289,538673540,2,122,61,1360117263049,1360117265417,538647589,538649957,2368
1360121479,542863604,1,48,48,1360121450825,1360121450825,542835429,542835429,0
1360121880,543264616,1,48,48,1360121853111,1360121853111,543237727,543237727,0
1360123812,545196464,1,48,48,1360123787315,1360123787315,545171779,545171779,0
1360125054,546438504,1,46,46,1360125028215,1360125028215,546412719,546412719,0
1360126019,547403604,1,46,46,1360125990402,1360125990402,547375006,547375006,0
1360127459,548842988,1,52,52,1360127430869,1360127430869,548814857,548814857,0
1360128886,550269860,1,64,64,1360128858752,1360128858752,550242612,550242612,0
1360133841,555225604,5,250,50,1360133816842,1360133838794,555201446,555223398,21952
1360133889,555273688,1,48,48,1360133862774,1360133862774,555247462,555247462,0
1360133917,555301728,1,48,48,1360133891852,1360133891852,555276580,555276580,0
1360135715,557099808,1,48,48,1360135685923,1360135685923,557070731,557070731,0
1360135734,557118092,1,60,60,1360135709549,1360135709549,557093641,557093641,0
1360136119,557503308,1,48,48,1360136092239,1360136092239,557476547,557476547,0
1360136205,557588868,1,48,48,1360136179334,1360136179334,557563202,557563202,0
1360136454,3491117236,1,46,46,1360136426903,1360136426903,3491090139,3491090139,0
1360136821,558205480,1,46,46,1360136793817,1360136793817,558178297,558178297,0
1360136993,558377024,2,122,61,1360136965151,1360136967583,558349175,558351607,2432
1360138051,559435488,1,46,46,1360138025790,1360138025790,559410278,559410278,0
1360138212,559595912,1,60,60,1360138187131,1360138187131,559571043,559571043,0
1360138381,559765324,1,46,46,1360138353115,1360138353115,559737439,559737439,0
1360139712,561096376,1,46,46,1360139685398,1360139685398,561069774,561069774,0
1360140340,561724148,1,46,46,1360140312942,1360140312942,561697090,561697090,0
1360147960,569344800,1,46,46,1360147934190,1360147934190,569318990,569318990,0
1360148675,570059272,1,48,48,1360148646515,1360148646515,570030787,570030787,0
1360154273,575657032,1,46,46,1360154246415,1360154246415,575630447,575630447,0
1360154794,576178376,2,120,60,1360154766767,1360154769775,576151143,576154151,3008
1360159260,580644168,4,216,54,1360159258488,1360159259256,580642656,580643424,768
1360159282,580665980,9,2325,258.3333333,1360159255990,1360159257014,580639970,580640994,1024
1360159282,580665988,6,3268,544.6666667,1360159257199,1360159258543,580641187,580642531,1344
1360159282,580666024,10,4062,406.2,1360159257225,1360159276489,580641249,580660513,19264
1360159286,580670044,3,164,54.66666667,1360159258932,1360159259380,580642976,580643424,448
1360159334,580718080,4,826,206.5,1360159305936,1360159308304,580690016,580692384,2368
1360159394,580778400,4,826,206.5,1360159367248,1360159369360,580751648,580753760,2112
1360159414,580798416,1,46,46,1360159386303,1360159386303,580770719,580770719,0
1360159515,580898844,4,826,206.5,1360159489465,1360159491513,580873309,580875357,2048
1360159519,580902816,2,112,56,1360159494677,1360159494933,580878493,580878749,256
1360159523,580906820,1,52,52,1360159494931,1360159494931,580878751,580878751,0
1360159587,580971028,1,74,74,1360159560066,1360159560066,580944094,580944094,0
1360159595,580979048,1,46,46,1360159570603,1360159570603,580954651,580954651,0
1360159623,581007080,1,74,74,1360159596878,1360159596878,580980958,580980958,0
1360159628,581012648,4,216,54,1360159626130,1360159626770,581010778,581011418,640
1360159651,581035076,9,2325,258.3333333,1360159625169,1360159626129,581009245,581010205,960
1360159651,581035080,1,52,52,1360159625677,1360159625677,581009757,581009757,0
1360159651,581035104,1,46,46,1360159623026,1360159623026,581007130,581007130,0
1360159655,581039028,3,164,54.66666667,1360159626943,1360159627455,581010971,581011483,512
1360159655,581039028,1,52,52,1360159627006,1360159627006,581011034,581011034,0
1360159679,581063376,1,74,74,1360159652004,1360159652004,581036380,581036380,0
1360159755,581139484,8,3665,458.125,1360159730039,1360159732727,581114523,581117211,2688
1360159860,581243824,2,112,56,1360159835658,1360159835914,581219482,581219738,256
1360159863,581247760,1,52,52,1360159834977,1360159834977,581219737,581219737,0
1360159876,581260760,11,5761,523.7272727,1360159859360,1360159870240,581244120,581255000,10880
1360159884,581267892,8,3079,384.875,1360159859717,1360159860037,581243609,581243929,320
1360159892,581275856,1,46,46,1360159864681,1360159864681,581248537,581248537,0
1360160000,581384176,8,3649,456.125,1360159972390,1360159973862,581356566,581358038,1472
1360160124,581508396,1,52,52,1360160099590,1360160099590,581483986,581483986,0
1360160128,581512372,1,46,46,1360160101216,1360160101216,581485588,581485588,0
1360160241,581624792,9,3729,414.3333333,1360160214180,1360160215972,581597972,581599764,1792
1360160285,581669132,237,232972,983.0042194,1360160218316,1360160284172,581602448,581668304,65856
1360160349,581733240,12,3367,280.5833333,1360160345376,1360160346656,581729616,581730896,1280
1360160373,581757092,1,46,46,1360160347123,1360160347123,581731215,581731215,0
1360160461,581845592,8,3384,423,1360160454847,1360160455679,581839439,581840271,832
1360160489,581873160,12,4491,374.25,1360160462127,1360160480047,581846287,581864207,17920
1360160489,581873232,6,3236,539.3333333,1360160462184,1360160463080,581846416,581847312,896
1360160537,581921248,4,826,206.5,1360160509780,1360160510868,581894028,581895116,1088
1360160545,581929216,1,46,46,1360160516918,1360160516918,581901134,581901134,0
1360160545,581929216,11,5923,538.4545455,1360160516981,1360160517429,581901197,581901645,448
1360160553,581937232,2,129,64.5,1360160525796,1360160525796,581910028,581910028,0
1360160581,581965652,2,131,65.5,1360160577026,1360160577026,581961678,581961678,0
1360160597,581981336,4,826,206.5,1360160570682,1360160571834,581955018,581956170,1152
1360160617,582001352,1,46,46,1360160590635,1360160590635,581974987,581974987,0
1360160717,582101492,4,826,206.5,1360160691743,1360160692831,582076235,582077323,1088
1360160725,582109476,15,8975,598.3333333,1360160700528,1360160701680,582085004,582086156,1152
1360160725,582109476,7,2986,426.5714286,1360160700589,1360160700973,582085065,582085449,384
1360160850,582233892,1,46,46,1360160824118,1360160824118,582208010,582208010,0
1360160958,582342384,8,3665,458.125,1360160932743,1360160934215,582317127,582318599,1472
1360160966,582350392,1,52,52,1360160941821,1360160941821,582326213,582326213,0
1360160966,582350436,1,52,52,1360160941009,1360160941009,582325445,582325445,0
1360161090,582474500,1,46,46,1360161062866,1360161062866,582447366,582447366,0
1360161199,582582804,6,3561,593.5,1360161174599,1360161175431,582558403,582559235,832
1360161335,582719212,1,46,46,1360161308462,1360161308462,582692674,582692674,0
1360161439,582823604,6,3545,590.8333333,1360161414754,1360161415778,582799358,582800382,1024
1360161451,582835712,1,77,77,1360161425400,1360161425400,582810112,582810112,0
1360161576,582960112,1,46,46,1360161549133,1360161549133,582933245,582933245,0
1360161664,583048200,1,52,52,1360161636019,1360161636019,583020219,583020219,0
1360161684,583068228,6,3561,593.5,1360161656278,1360161657430,583040506,583041658,1152
1360161812,583196700,1,46,46,1360161784636,1360161784636,583169336,583169336,0
1360161917,583301124,2,230,115,1360161890557,1360161890557,583274681,583274681,0
1360161925,583309060,8,3665,458.125,1360161897596,1360161900540,583281656,583284600,2944
1360162057,583441528,1,46,46,1360162032166,1360162032166,583416694,583416694,0
1360162085,583469600,2,160,80,1360162059295,1360162072223,583443895,583456823,12928
1360162085,583469600,1,52,52,1360162059295,1360162059295,583443895,583443895,0
1360162109,583493612,2,112,56,1360162082515,1360162082771,583467127,583467383,256
1360162125,583509556,1,80,80,1360162098185,1360162098185,583482741,583482741,0
1360162166,583549752,8,3665,458.125,1360162139884,1360162142892,583523636,583526644,3008
1360162177,583561744,1,80,80,1360162149901,1360162149901,583534645,583534645,0
1360162204,583588680,1,46,46,1360162175307,1360162175307,583559987,583559987,0
1360162204,583588724,1,46,46,1360162175325,1360162175325,583560049,583560049,0
1360162205,583589076,1,46,46,1360162177064,1360162177064,583561140,583561140,0
1360162207,583590972,1,48,48,1360162181199,1360162181199,583565171,583565171,0
1360162207,583591008,1,48,48,1360162181356,1360162181356,583565364,583565364,0
1360162210,583594592,1,48,48,1360162184545,1360162184545,583569137,583569137,0
1360162286,583670056,2,96,48,1360162261372,1360162264508,583645428,583648564,3136
1360162290,583673984,2,96,48,1360162262594,1360162265410,583646578,583649394,2816
1360162290,583674032,3,144,48,1360162263696,1360162272720,583647728,583656752,9024
1360162290,583674036,2,96,48,1360162263628,1360162266572,583647664,583650608,2944
1360162298,583682068,1,46,46,1360162273007,1360162273007,583657075,583657075,0
1360162354,583738388,1,77,77,1360162325742,1360162325742,583710130,583710130,0
1360162406,583790440,8,3665,458.125,1360162381178,1360162384314,583765618,583768754,3136
1360162539,583922916,1,46,46,1360162513920,1360162513920,583897836,583897836,0
1360162575,583959140,4,216,54,1360162567392,1360162568416,583951532,583952556,1024
1360162575,583959176,12,3367,280.5833333,1360162566269,1360162567485,583950445,583951661,1216
1360162595,583978928,9,2325,258.3333333,1360162567476,1360162568628,583951404,583952556,1152
1360162595,583978932,1,52,52,1360162567857,1360162567857,583951789,583951789,0
1360162595,583978984,3,164,54.66666667,1360162568126,1360162568574,583952110,583952558,448
1360162595,583979012,1,52,52,1360162568355,1360162568355,583952367,583952367,0
1360162615,583998960,11,3246,295.0909091,1360162588500,1360162592148,583972460,583976108,3648
1360162647,584031200,2,104,52,1360162641379,1360162642211,584025579,584026411,832
1360162667,584051304,2,120,60,1360162640893,1360162641405,584025197,584025709,512
1360162667,584051308,1,46,46,1360162641081,1360162641081,584025389,584025389,0
1360162667,584051312,1,60,60,1360162641716,1360162641716,584026028,584026028,0
1360162667,584051316,1,64,64,1360162642352,1360162642352,584026668,584026668,0
1360162667,584051356,2,112,56,1360162640903,1360162641223,584025259,584025579,320
1360162667,584051384,4,256,64,1360162642412,1360162663404,584026796,584047788,20992
1360162703,584087304,14,6654,475.2857143,1360162697083,1360162698107,584081387,584082411,1024
1360162711,584095280,4,216,54,1360162690260,1360162705556,584074540,584089836,15296
1360162715,584099444,3,172,57.33333333,1360162690031,1360162705135,584074475,584089579,15104
1360162715,584099448,1,52,52,1360162690666,1360162690666,584075114,584075114,0
1360162715,584099452,9,3491,387.8888889,1360162690856,1360162693032,584075308,584077484,2176
1360162715,584099492,11,2429,220.8181818,1360162689790,1360162691006,584074282,584075498,1216
1360162715,584099496,11,4786,435.0909091,1360162690298,1360162691194,584074794,584075690,896
1360162715,584099496,1,52,52,1360162690298,1360162690298,584074794,584074794,0
1360162719,584103536,15,4745,316.3333333,1360162690898,1360162710098,584075434,584094634,19200
1360162719,584103568,15,8439,562.6,1360162693299,1360162695859,584077867,584080427,2560
1360162723,584107540,14,5827,416.2142857,1360162698510,1360162700686,584083050,584085226,2176
1360162723,584107584,4,1172,293,1360162698021,1360162698469,584082605,584083053,448
1360162727,584111520,1,52,52,1360162701285,1360162701285,584085805,584085805,0
1360162727,584111556,11,4430,402.7272727,1360162698881,1360162702337,584083437,584086893,3456
1360162727,584111588,17,11077,651.5882353,1360162701150,1360162703902,584085738,584088490,2752
1360162759,584143312,2,104,52,1360162758132,1360162758388,584142444,584142700,256
1360162767,584151556,3,806,268.6666667,1360162742655,1360162743295,584127211,584127851,640
1360162771,584155580,1,52,52,1360162744165,1360162744165,584128745,584128745,0
1360162795,584179652,1,46,46,1360162769952,1360162769952,584154604,584154604,0
1360162828,584211836,8,5113,639.125,1360162803724,1360162820492,584187560,584204328,16768
1360162828,584211836,1,60,60,1360162803724,1360162803724,584187560,584187560,0
1360162828,584211844,2,120,60,1360162803911,1360162804103,584187755,584187947,192
1360162828,584211848,8,2141,267.625,1360162800640,1360162803712,584184488,584187560,3072
1360162828,584211892,1,60,60,1360162803862,1360162803862,584187754,584187754,0
1360162848,584231892,1,46,46,1360162822294,1360162822294,584206186,584206186,0
1360162879,584263364,2,104,52,1360162863167,1360162872191,584247531,584256555,9024
1360162895,584279384,2,104,52,1360162882153,1360162892137,584266537,584276521,9984
1360162896,584279928,1,46,46,1360162870128,1360162870128,584254056,584254056,0
1360162919,584303436,2,104,52,1360162902067,1360162912115,584286503,584296551,10048
1360162935,584319492,5,260,52,1360162931196,1360162934716,584315688,584319208,3520
1360162943,584327424,3,156,52,1360162940479,1360162942079,584324903,584326503,1600
1360162943,584327456,2,104,52,1360162942111,1360162942431,584326567,584326887,320
1360162943,584327464,5,260,52,1360162935895,1360162940119,584320359,584324583,4224
1360162948,584332092,1,52,52,1360162922445,1360162922445,584306537,584306537,0
1360162951,584335412,3,156,52,1360162943116,1360162946956,584327528,584331368,3840
1360162951,584335468,4,208,52,1360162943957,1360162947477,584328425,584331945,3520
1360162951,584335468,2,104,52,1360162944213,1360162948501,584328681,584332969,4288
1360162960,584344080,1,46,46,1360162934551,1360162934551,584318631,584318631,0
1360162975,584359460,2,104,52,1360162957148,1360162967132,584341608,584351592,9984
1360162980,584364368,1,46,46,1360162953527,1360162953527,584337895,584337895,0
1360163004,584388296,1,52,52,1360162977280,1360162977280,584361576,584361576,0
1360163060,584444428,1,60,60,1360163034683,1360163034683,584419111,584419111,0
1360163095,584479556,4,216,54,1360163089656,1360163093560,584474212,584478116,3904
1360163095,584479596,61,81001,1327.885246,1360163092240,1360163093008,584476836,584477604,768
1360163116,584500500,9,2325,258.3333333,1360163089135,1360163093871,584473635,584478371,4736
1360163116,584500500,2,112,56,1360163089330,1360163093362,584473830,584477862,4032
1360163116,584500504,8,3974,496.75,1360163089965,1360163091565,584474469,584476069,1600
1360163116,584500504,12,4816,401.3333333,1360163090029,1360163110637,584474533,584495141,20608
1360163120,584504424,1,52,52,1360163093308,1360163093308,584477732,584477732,0
1360163183,584567688,4,216,54,1360163181046,1360163182326,584565734,584567014,1280
1360163183,584567696,2,104,52,1360163182316,1360163182572,584567012,584567268,256
1360163209,584592924,1,52,52,1360163184623,1360163184623,584568547,584568547,0
1360163209,584592928,1,52,52,1360163182059,1360163182059,584565987,584565987,0
1360163209,584592952,3,164,54.66666667,1360163182546,1360163183058,584566498,584567010,512
1360163209,584592956,6,3268,544.6666667,1360163182609,1360163183377,584566565,584567333,768
1360163209,584592996,11,2571,233.7272727,1360163181800,1360163183848,584565796,584567844,2048
1360163209,584593004,15,5725,381.6666667,1360163182815,1360163207199,584566819,584591203,24384
1360163223,584607688,3,800,266.6666667,1360163208885,1360163220917,584593573,584605605,12032
1360163240,584623752,3,164,54.66666667,1360163238812,1360163239708,584622564,584623460,896
1360163245,584629032,1,46,46,1360163219777,1360163219777,584603809,584603809,0
1360163265,584648996,10,4046,404.6,1360163239785,1360163257257,584623781,584641253,17472
1360163265,584649024,9,2325,258.3333333,1360163238282,1360163250570,584622306,584634594,12288
1360163265,584649032,3,164,54.66666667,1360163239172,1360163239684,584623204,584623716,512
1360163265,584649032,1,52,52,1360163239236,1360163239236,584623268,584623268,0
1360163265,584649032,6,3268,544.6666667,1360163239490,1360163240194,584623522,584624226,704
1360163265,584649036,1,52,52,1360163239680,1360163239680,584623716,584623716,0
1360163265,584649088,1,52,52,1360163238665,1360163238665,584622753,584622753,0
1360163269,584653032,1,46,46,1360163243522,1360163243522,584627554,584627554,0
1360163313,584697276,4,810,202.5,1360163286797,1360163288013,584671073,584672289,1216
1360163341,584725296,1,46,46,1360163313849,1360163313849,584698145,584698145,0
1360163373,584757312,4,810,202.5,1360163347625,1360163348713,584731937,584733025,1088
1360163397,584781300,1,46,46,1360163372598,1360163372598,584756898,584756898,0
1360163464,584847796,14,4102,293,1360163458795,1360163460843,584842591,584844639,2048
1360163486,584869752,9,5044,560.4444444,1360163458904,1360163459736,584842656,584843488,832
1360163486,584869788,1,76,76,1360163460916,1360163460916,584844704,584844704,0
1360163494,584877792,4,810,202.5,1360163469169,1360163470321,584852961,584854113,1152
1360163518,584901808,2,112,56,1360163492958,1360163493214,584876766,584877022,256
1360163518,584901852,1,52,52,1360163493169,1360163493169,584877021,584877021,0
1360163520,584903872,2,131,65.5,1360163519712,1360163519712,584903584,584903584,0
1360163550,584933812,1,46,46,1360163523163,1360163523163,584906975,584906975,0
1360163550,584933812,15,9167,611.1333333,1360163523227,1360163523931,584907039,584907743,704
1360163592,584975880,2,131,65.5,1360163583895,1360163583895,584967775,584967775,0
1360163630,585014180,1,46,46,1360163603370,1360163603370,584987550,584987550,0
1360163670,585054220,1,60,60,1360163641920,1360163641920,585026140,585026140,0
1360163734,585118272,9,3713,412.5555556,1360163709515,1360163712331,585093787,585096603,2816
1360163867,585250944,1,46,46,1360163842320,1360163842320,585226264,585226264,0
1360163960,585344188,37,37169,1004.567568,1360163946333,1360163953565,585330521,585337753,7232
1360163979,585363032,1,60,60,1360163954874,1360163954874,585338906,585338906,0
1360163979,585363084,8,3665,458.125,1360163952004,1360163954820,585336088,585338904,2816
1360164075,585459480,1,46,46,1360164048631,1360164048631,585433111,585433111,0
1360164115,585499224,1,46,46,1360164088695,1360164088695,585472919,585472919,0
1360164167,585551332,2,129,64.5,1360164139463,1360164139463,585523795,585523795,0
1360164219,585603356,9,3729,414.3333333,1360164193905,1360164196785,585578261,585581141,2880
1360164351,585735528,1,46,46,1360164324291,1360164324291,585708819,585708819,0
1360164464,585847884,6,3561,593.5,1360164436357,1360164437317,585820241,585821201,960
1360164532,585915912,1,345,345,1360164506920,1360164506920,585890832,585890832,0
1360164552,585936520,12,3971,330.9166667,1360164549127,1360164549959,585933647,585934479,832
1360164568,585952536,1082,1533366,1417.158965,1360164563703,1360164565111,585948239,585949647,1408
1360164568,585952584,4,1436,359,1360164563208,1360164563464,585947792,585948048,256
1360164576,585960172,14,6010,429.2857143,1360164549028,1360164558372,585933200,585942544,9344
1360164576,585960280,77,81026,1052.285714,1360164550966,1360164559990,585935246,585944270,9024
1360164576,585960516,10,3591,359.1,1360164551113,1360164552713,585935629,585937229,1600
1360164580,585963928,9,3606,400.6666667,1360164552280,1360164553752,585936208,585937680,1472
1360164580,585963932,11,4117,374.2727273,1360164553235,1360164555923,585937167,585939855,2688
1360164584,585967912,12,5487,457.25,1360164556391,1360164557159,585940303,585941071,768
1360164584,585967948,9,5071,563.4444444,1360164558849,1360164559873,585942797,585943821,1024
1360164584,585967960,9,4631,514.5555556,1360164556406,1360164557302,585940366,585941262,896
1360164588,585971932,2,754,377,1360164561233,1360164576913,585945165,585960845,15680
1360164604,585988060,29,3056,105.3793103,1360164577042,1360164603474,585961102,585987534,26432
1360164612,585996048,1,52,52,1360164587230,1360164587230,585971278,585971278,0
1360164616,586000000,1,52,52,1360164588877,1360164588877,585972877,585972877,0
1360164616,586000080,1,52,52,1360164589440,1360164589440,585973520,585973520,0
1360164616,586000084,1,52,52,1360164590012,1360164590012,585974096,585974096,0
1360164616,586000112,2,754,377,1360164591200,1360164601120,585975312,585985232,9920
1360164688,586072260,11,4643,422.0909091,1360164663049,1360164665993,586047309,586050253,2944
1360164692,586076120,1,186,186,1360164664468,1360164664468,586048588,586048588,0
1360164756,586140260,1,46,46,1360164729482,1360164729482,586113742,586113742,0
1360164820,586204216,1,52,52,1360164793076,1360164793076,586177292,586177292,0
1360164824,586208228,1,52,52,1360164796841,1360164796841,586181069,586181069,0
1360164824,586208228,1,52,52,1360164797032,1360164797032,586181260,586181260,0
1360164868,586252340,1,52,52,1360164843192,1360164843192,586227532,586227532,0
1360164876,586260308,1,186,186,1360164849621,1360164849621,586233929,586233929,0
1360164876,586260312,8,1796,224.5,1360164850001,1360164851281,586234313,586235593,1280
1360165052,586436636,1,186,186,1360165023947,1360165023947,586408583,586408583,0
1360165052,586436684,3,567,189,1360165024346,1360165024794,586409030,586409478,448
1360165065,586448900,12,3096,258,1360165062443,1360165063211,586446343,586447111,768
1360165065,586448900,12,3732,311,1360165062442,1360165063402,586446342,586447302,960
1360165065,586448900,12,3204,267,1360165062506,1360165063530,586446406,586447430,1024
1360165065,586448972,12,3169,264.0833333,1360165062307,1360165063075,586446279,586447047,768
1360165081,586465088,12,3367,280.5833333,1360165072238,1360165073710,586456326,586457798,1472
1360165173,586558592,1,46,46,1360165145615,1360165145615,586531207,586531207,0
1360165174,586558956,1,46,46,1360165146824,1360165146824,586531780,586531780,0
1360165204,586589416,4,783,195.75,1360165178812,1360165203644,586564228,586589060,24832
1360165228,586613468,1,186,186,1360165203143,1360165203143,586588611,586588611,0
1360165233,586617620,3,597,199,1360165204633,1360165204953,586589253,586589573,320
1360165265,586648980,10,1104,110.4,1360165258649,1360165259161,586642629,586643141,512
1360165265,586649048,10,1094,109.4,1360165258517,1360165259093,586642565,586643141,576
1360165305,586689036,3,168,56,1360165293023,1360165302047,586677059,586686083,9024
1360165329,586713444,4,320,80,1360165301639,1360165321607,586686083,586706051,19968
1360165333,586717540,2,112,56,1360165306664,1360165308072,586691204,586692612,1408
1360165369,586753624,1,80,80,1360165344211,1360165344211,586728835,586728835,0
1360165418,586801900,1,80,80,1360165390439,1360165390439,586774339,586774339,0
1360165470,586853888,1,52,52,1360165445359,1360165445359,586829247,586829247,0
1360165614,586998320,4,244,61,1360165586304,1360165589632,586970624,586973952,3328
1360165625,587009236,4,216,54,1360165619282,1360165620434,587003518,587004670,1152
1360165646,587030328,9,2325,258.3333333,1360165619124,1360165620340,587003452,587004668,1216
1360165646,587030392,1,52,52,1360165619319,1360165619319,587003711,587003711,0
1360165646,587030396,3,164,54.66666667,1360165619763,1360165620275,587004159,587004671,512
1360165646,587030396,1,52,52,1360165619890,1360165619890,587004286,587004286,0
1360165775,587158772,3,172,57.33333333,1360165748511,1360165752671,587132283,587136443,4160
1360165779,587162860,1,52,52,1360165752582,1360165752582,587136442,587136442,0
1360165799,587183624,1,48,48,1360165771084,1360165771084,587155708,587155708,0
1360165803,587187632,1,48,48,1360165775749,1360165775749,587160381,587160381,0
1360166170,587554108,11,2086,189.6363636,1360166167242,1360166168778,587551350,587552886,1536
1360166234,587618092,4,216,54,1360166227992,1360166228760,587612084,587612852,768
1360166251,587635548,12,3889,324.0833333,1360166226000,1360166226960,587610548,587611508,960
1360166251,587635556,1,52,52,1360166226697,1360166226697,587611253,587611253,0
1360166255,587639556,3,176,58.66666667,1360166227720,1360166229384,587612276,587613940,1664
1360166255,587639560,1,52,52,1360166227783,1360166227783,587612343,587612343,0
1360166506,587890628,4,216,54,1360166503550,1360166504190,587888178,587888818,640
1360166528,587912080,9,2325,258.3333333,1360166502431,1360166503263,587886511,587887343,832
1360166528,587912164,1,52,52,1360166502987,1360166502987,587887151,587887151,0
1360166532,587916076,3,164,54.66666667,1360166504292,1360166504804,587888368,587888880,512
1360166532,587916080,1,52,52,1360166504354,1360166504354,587888434,587888434,0
1360166728,588112348,2,112,56,1360166701456,1360166701968,588085804,588086316,512
1360166728,588112352,1,52,52,1360166701965,1360166701965,588086317,588086317,0
1360166768,588152336,2,96,48,1360166742236,1360166745244,588126572,588129580,3008
1360166776,588160276,2,96,48,1360166748506,1360166751514,588132782,588135790,3008
1360166969,588353212,1,48,48,1360166944214,1360166944214,588328426,588328426,0
1360167017,588401256,2,122,61,1360166992042,1360166994282,588376298,588378538,2240
1360167073,588457224,2,96,48,1360167046215,1360167049223,588430439,588433447,3008
1360167113,588497364,1,46,46,1360167087741,1360167087741,588472105,588472105,0
1360167430,588813760,2,129,64.5,1360167403473,1360167403473,588787233,588787233,0
1360167433,588817632,1,52,52,1360167408428,1360167408428,588793060,588793060,0
1360167485,588869760,5,250,50,1360167460136,1360167482216,588844896,588866976,22080
1360167518,588902028,1,60,60,1360167489862,1360167489862,588873890,588873890,0
1360167522,588905960,1,60,60,1360167495432,1360167495432,588879392,588879392,0
1360167794,589178512,1,60,60,1360167766558,1360167766558,589151070,589151070,0
1360167838,589222664,1,46,46,1360167810371,1360167810371,589195035,589195035,0
1360168332,589715840,4,269,67.25,1360168306421,1360168306421,589690261,589690261,0
1360169017,590401256,1,46,46,1360168992584,1360168992584,590376840,590376840,0
1360169017,590401644,1,46,46,1360168992132,1360168992132,590376776,590376776,0
1360169023,590406844,1,46,46,1360168994788,1360168994788,590378632,590378632,0
1360169233,590617616,6,424,70.66666667,1360169205664,1360169208864,590590280,590593480,3200
1360169718,591102320,4,216,54,1360169709759,1360169712191,591094079,591096511,2432
1360169735,591118972,4,224,56,1360169708444,1360169712540,591092416,591096512,4096
1360169735,591119012,1,52,52,1360169710643,1360169710643,591094655,591094655,0
1360169735,591119016,9,2325,258.3333333,1360169707439,1360169709039,591091455,591093055,1600
1360169735,591119052,1,52,52,1360169708810,1360169708810,591092862,591092862,0
1360169782,591166336,12,3367,280.5833333,1360169777580,1360169778412,591161916,591162748,832
1360170036,591419844,3,172,57.33333333,1360170007892,1360170012244,591391736,591396088,4352
1360170040,591423776,1,52,52,1360170012314,1360170012314,591396090,591396090,0
1360170132,591516176,10,5294,529.4,1360170105034,1360170105930,591489210,591490106,896
1360170166,591550688,2,131,65.5,1360170165447,1360170165447,591550135,591550135,0
1360170192,591576160,2,158,79,1360170167064,1360170169240,591551224,591553400,2176
1360170200,591584168,2,126,63,1360170174926,1360170174990,591559094,591559158,64
1360170231,591614788,2,104,52,1360170225417,1360170225417,591609205,591609205,0
1360170247,591630848,32,5788,180.875,1360170226380,1360170240716,591610228,591624564,14336
1360170252,591636656,4,584,146,1360170224548,1360170242212,591609204,591626868,17664
1360170268,591652672,26,4857,186.8076923,1360170240852,1360170245396,591625524,591630068,4544
1360170304,591688716,1,52,52,1360170276394,1360170276394,591661110,591661110,0
1360170332,591716680,1,146,146,1360170304269,1360170304269,591688949,591688949,0
1360170333,591716760,4,422,105.5,1360170305189,1360170329829,591688949,591713589,24640
1360170360,3525023296,3,603,201,1360170353399,1360170353463,3525016695,3525016759,64
1360170373,591756828,2,296,148,1360170345056,1360170345248,591728884,591729076,192
1360170381,3525043992,1,52,52,1360170354025,1360170354025,3525017017,3525017017,0
1360170437,591821080,1,46,46,1360170410402,1360170410402,591794482,591794482,0
1360170437,591821188,1,46,46,1360170410232,1360170410232,591794420,591794420,0
1360170437,591821188,58,45501,784.5,1360170410359,1360170417655,591794547,591801843,7296
1360170551,591935220,31,6050,195.1612903,1360170541142,1360170546070,591925362,591930290,4928
1360170551,591935224,3,369,123,1360170545809,1360170545937,591930033,591930161,128
1360170569,3525232040,4,766,191.5,1360170541115,1360170541435,3525204155,3525204475,320
1360170569,3525232040,5,882,176.4,1360170541114,1360170542266,3525204154,3525205306,1152
1360170569,3525232056,1,505,505,1360170542058,1360170542058,3525205114,3525205114,0
1360170569,591953492,23,4648,202.0869565,1360170541830,1360170548038,591926322,591932530,6208
1360170569,591953580,1,146,146,1360170542060,1360170542060,591926640,591926640,0
1360170569,591953580,2,603,301.5,1360170542060,1360170542060,591926640,591926640,0
1360170573,591957484,26,4976,191.3846154,1360170546765,1360170551309,591931249,591935793,4544
1360170573,591957540,18,17512,972.8888889,1360170545491,1360170546195,591930031,591930735,704
1360170573,591957544,28,8226,293.7857143,1360170546065,1360170549393,591930609,591933937,3328
1360170577,591961668,3,304,101.3333333,1360170551254,1360170551318,591935922,591935986,64
1360170621,592005596,12,1260,105,1360170595547,1360170619675,591980143,592004271,24128
1360170621,592005680,6,2514,419,1360170595464,1360170603144,591980144,591987824,7680
1360170633,592017616,6,424,70.66666667,1360170608646,1360170611654,591993262,591996270,3008
1360170671,592055308,6,427,71.16666667,1360170666426,1360170669754,592050734,592054062,3328
1360170701,592085684,3,225,75,1360170672963,1360170694339,592057647,592079023,21376
1360170750,592134004,1,75,75,1360170723561,1360170723561,592107565,592107565,0
1360170799,592183460,5,260,52,1360170791519,1360170794975,592175979,592179435,3456
1360171015,592399472,2,189,94.5,1360171014738,1360171014738,592399210,592399210,0
1360171032,3525695404,7,3076,439.4285714,1360171011663,1360171030607,3525675067,3525694011,18944
1360171043,592426820,6,660,110,1360171015775,1360171036703,592399595,592420523,20928
1360171083,592466880,1,110,110,1360171058271,1360171058271,592442151,592442151,0
1360171127,592510988,1,110,110,1360171101426,1360171101426,592485414,592485414,0
1360171151,592535652,4,409,102.25,1360171149276,1360171150108,592533928,592534760,832
1360171179,592563328,4,440,110,1360171151454,1360171166430,592535782,592550758,14976
1360171211,592595320,1,110,110,1360171183526,1360171183526,592567846,592567846,0
1360171243,592627472,1,110,110,1360171217551,1360171217551,592602023,592602023,0
1360171287,592671660,4,208,52,1360171279057,1360171283153,592663717,592667813,4096
1360171303,592687636,2,104,52,1360171287914,1360171297386,592672550,592682022,9472
1360171320,592703732,2,104,52,1360171308274,1360171318258,592692006,592701990,9984
1360171344,592727864,2,104,52,1360171328174,1360171338158,592712038,592722022,9984
1360171352,592736032,2,488,244,1360171324482,1360171325506,592708514,592709538,1024
1360171560,592943884,4,208,52,1360171555924,1360171558612,592939808,592942496,2688
1360171568,592951912,2,104,52,1360171561593,1360171567673,592945505,592951585,6080
1360171592,592975956,2,104,52,1360171577614,1360171587662,592961570,592971618,10048
1360171624,593008404,1,52,52,1360171597198,1360171597198,592981602,592981602,0
1360172142,593526028,3,144,48,1360172114683,1360172123771,593498711,593507799,9088
1360172258,593642408,2,129,64.5,1360172230528,1360172230528,593614936,593614936,0
1360172723,594107492,1,48,48,1360172696481,1360172696481,594080973,594080973,0
1360172723,594107588,1,48,48,1360172696517,1360172696517,594081105,594081105,0
1360172728,594111836,1,48,48,1360172700657,1360172700657,594084493,594084493,0
1360172967,594351656,2,122,61,1360172942715,1360172944763,594327371,594329419,2048
1360173156,594540264,1,77,77,1360173130689,1360173130689,594514953,594514953,0
1360173313,594697532,1,48,48,1360173286128,1360173286128,594670660,594670660,0
1360173313,594697536,1,48,48,1360173286125,1360173286125,594670661,594670661,0
1360173501,594885244,1,46,46,1360173474255,1360173474255,594858499,594858499,0
1360173722,595106000,4,744,186,1360173697471,1360173713535,595081471,595097535,16064
1360173742,595126160,11,3246,295.0909091,1360173716703,1360173719583,595100863,595103743,2880
1360173750,595134168,3,558,186,1360173723352,1360173743384,595107520,595127552,20032
1360173778,595162060,1,186,186,1360173753475,1360173753475,595137535,595137535,0
1360173906,595289772,4,216,54,1360173896990,1360173898590,595280762,595282362,1600
1360173922,595306556,3,164,54.66666667,1360173897166,1360173897806,595281722,595282362,640
1360173922,595306608,10,2501,250.1,1360173896156,1360173897436,595280764,595282044,1280
1360173926,595310532,15,5809,387.2666667,1360173899625,1360173902825,595284157,595287357,3200
1360174026,595409932,2,141,70.5,1360174024509,1360174024509,595408441,595408441,0
1360174051,595434944,11,3246,295.0909091,1360174023220,1360174024436,595407164,595408380,1216
1360174103,595486880,3,172,57.33333333,1360174075503,1360174079727,595459383,595463607,4224
1360174107,595490892,1,52,52,1360174079718,1360174079718,595463610,595463610,0
1360174146,595530268,4,208,52,1360174143083,1360174144939,595527351,595529207,1856
1360174163,595546972,1,46,46,1360174137365,1360174137365,595521337,595521337,0
1360174210,595594264,4,216,54,1360174207213,1360174207853,595591477,595592117,640
1360174231,595614992,10,2399,239.9,1360174204413,1360174205501,595588405,595589493,1088
1360174231,595615020,1,52,52,1360174205220,1360174205220,595589240,595589240,0
1360174235,595619008,3,164,54.66666667,1360174207663,1360174208111,595591671,595592119,448
1360174235,595619008,1,52,52,1360174207726,1360174207726,595591734,595591734,0
1360174338,595722340,2,141,70.5,1360174336992,1360174336992,595721332,595721332,0
1360174363,595747416,11,3246,295.0909091,1360174335764,1360174337044,595720180,595721460,1280
1360174383,595767444,3,172,57.33333333,1360174357241,1360174361657,595741685,595746101,4416
1360174387,595771408,1,52,52,1360174361692,1360174361692,595746100,595746100,0
1360174391,595775496,1,48,48,1360174366214,1360174366214,595750710,595750710,0
1360174522,595906660,4,216,54,1360174520414,1360174521630,595905074,595906290,1216
1360174544,595927780,9,2325,258.3333333,1360174519439,1360174520527,595903219,595904307,1088
1360174547,595931684,3,164,54.66666667,1360174520644,1360174521604,595905328,595906288,960
1360174548,595931728,1,52,52,1360174520192,1360174520192,595903920,595903920,0
1360174548,595931772,1,52,52,1360174521558,1360174521558,595905330,595905330,0
1360174658,596042656,2,141,70.5,1360174650592,1360174650592,596035248,596035248,0
1360174676,596059828,1,46,46,1360174651803,1360174651803,596035631,596035631,0
1360174676,596059928,11,3246,295.0909091,1360174649590,1360174651702,596033518,596035630,2112
1360174780,596164288,2,120,60,1360174751885,1360174755981,596136173,596140269,4096
1360174784,596168284,3,297,99,1360174755987,1360174756499,596140271,596140783,512
1360174843,596226860,2,104,52,1360174842041,1360174842297,596225901,596226157,256
1360174843,596226948,4,216,54,1360174838560,1360174840096,596222508,596224044,1536
1360174864,596248620,3,164,54.66666667,1360174838720,1360174839424,596223340,596224044,704
1360174864,596248700,1,52,52,1360174838321,1360174838321,596223021,596223021,0
1360174868,596252664,10,2476,247.6,1360174840723,1360174842003,596225387,596226667,1280
1360174971,596354980,2,141,70.5,1360174964285,1360174964285,596348265,596348265,0
1360174989,596372976,11,3246,295.0909091,1360174962561,1360174964481,596346537,596348457,1920
1360174997,596381104,1,56,56,1360174968705,1360174968705,596352809,596352809,0
1360175155,596539144,4,216,54,1360175153432,1360175154072,596537576,596538216,640
1360175155,596539192,4,224,56,1360175135207,1360175153639,596519399,596537831,18432
1360175165,596549564,1,52,52,1360175139188,1360175139188,596523752,596523752,0
1360175177,596561492,9,2325,258.3333333,1360175150716,1360175151804,596535208,596536296,1088
1360175177,596561496,1,52,52,1360175151542,1360175151542,596536038,596536038,0
1360175179,596563072,11,6380,580,1360175170975,1360175172063,596555047,596556135,1088
1360175181,596565544,3,164,54.66666667,1360175153222,1360175153670,596537766,596538214,448
1360175193,596577640,11,3242,294.7272727,1360175165798,1360175169126,596550438,596553766,3328
1360175197,596581512,8,4240,530,1360175168999,1360175170343,596553511,596554855,1344
1360175283,596667196,2,141,70.5,1360175276449,1360175276449,596660645,596660645,0
1360175302,596685876,11,3246,295.0909091,1360175275426,1360175276706,596659302,596660582,1280
1360175371,596755372,15,6015,401,1360175353650,1360175367538,596738022,596751910,13888
1360175378,596762172,2,766,383,1360175353655,1360175353719,596737827,596737891,64
1360175378,596762176,3,1982,660.6666667,1360175353332,1360175353396,596737508,596737572,64
1360175434,596818184,1,52,52,1360175409642,1360175409642,596793826,596793826,0
1360175462,596846220,3,172,57.33333333,1360175437640,1360175441992,596821860,596826212,4352
1360175466,596850460,1,52,52,1360175441750,1360175441750,596826210,596826210,0
1360175475,596859480,4,216,54,1360175469507,1360175470659,596853987,596855139,1152
1360175494,596878504,9,2325,258.3333333,1360175469291,1360175470379,596853795,596854883,1088
1360175494,596878616,1,52,52,1360175469625,1360175469625,596854241,596854241,0
1360175498,596882448,3,164,54.66666667,1360175470178,1360175470690,596854626,596855138,512
1360175498,596882540,1,52,52,1360175470087,1360175470087,596854627,596854627,0
1360175546,596930484,1,60,60,1360175518973,1360175518973,596903457,596903457,0
1360175546,596930640,1,60,60,1360175520547,1360175520547,596905187,596905187,0
1360175595,596979536,2,141,70.5,1360175588745,1360175588745,596973281,596973281,0
1360175595,596979572,3,156,52,1360175593315,1360175594083,596977887,596978655,768
1360175614,596998544,11,3246,295.0909091,1360175587521,1360175588865,596972065,596973409,1344
1360175623,597006952,1,52,52,1360175595663,1360175595663,596979615,596979615,0
1360175627,597011464,2,92,46,1360175624144,1360175625168,597008608,597009632,1024
1360175655,597038736,1,46,46,1360175627944,1360175627944,597011680,597011680,0
1360175719,597102848,2,112,56,1360175694325,1360175694773,597078173,597078621,448
1360175722,597106644,1,52,52,1360175693978,1360175693978,597078622,597078622,0
1360175787,597171600,4,216,54,1360175784200,1360175784840,597168800,597169440,640
1360175807,597190916,1,60,60,1360175779378,1360175779378,597163294,597163294,0
1360175811,597194792,9,2325,258.3333333,1360175783020,1360175783852,597166812,597167644,832
1360175811,597194800,1,52,52,1360175783719,1360175783719,597167519,597167519,0
1360175811,597194836,3,164,54.66666667,1360175785090,1360175785602,597168926,597169438,512
1360175811,597194836,1,52,52,1360175785154,1360175785154,597168990,597168990,0
1360175907,597291560,2,141,70.5,1360175901485,1360175901485,597286045,597286045,0
1360175927,597310960,11,3246,295.0909091,1360175900996,1360175902212,597284956,597286172,1216
1360175987,597371272,2,112,56,1360175961293,1360175961741,597345565,597346013,448
1360175987,597371384,1,52,52,1360175961626,1360175961626,597346010,597346010,0
1360176108,597491768,4,216,54,1360176099585,1360176100865,597483353,597484633,1280
1360176124,597507948,9,2325,258.3333333,1360176097484,1360176098572,597481432,597482520,1088
1360176124,597507956,1,52,52,1360176098372,1360176098372,597482328,597482328,0
1360176127,597511664,3,164,54.66666667,1360176098943,1360176099967,597483607,597484631,1024
1360176127,597511664,1,52,52,1360176098942,1360176098942,597483606,597483606,0
1360176132,597515864,7,3231,461.5714286,1360176107616,1360176107936,597491480,597491800,320
1360176180,597563792,9,2325,258.3333333,1360176155176,1360176156520,597538968,597540312,1344
1360176180,597563792,1,60,60,1360176155238,1360176155238,597539030,597539030,0
1360176184,597567824,2,112,56,1360176156102,1360176156358,597539926,597540182,256
1360176184,597567852,1,52,52,1360176156269,1360176156269,597540121,597540121,0
1360176184,597567852,1,52,52,1360176156332,1360176156332,597540184,597540184,0
1360176212,597595956,2,104,52,1360176187588,1360176188100,597571544,597572056,512
1360176212,597595992,1,52,52,1360176187551,1360176187551,597571543,597571543,0
1360176220,597604044,2,141,70.5,1360176214892,1360176214892,597598936,597598936,0
1360176240,597623808,11,3246,295.0909091,1360176213911,1360176215255,597597719,597599063,1344
1360176348,597732204,2,104,52,1360176347592,1360176347848,597731796,597732052,256
1360176356,597740200,2,104,52,1360176348364,1360176349324,597732564,597733524,960
1360176456,597840116,4,224,56,1360176429984,1360176434848,597814100,597818964,4864
1360176460,597844044,2,104,52,1360176434405,1360176434853,597818449,597818897,448
1360176476,597860452,4,216,54,1360176472528,1360176473936,597856980,597858388,1408
1360176496,597880188,1,52,52,1360176470934,1360176470934,597855122,597855122,0
1360176496,597880276,10,2476,247.6,1360176470271,1360176471295,597854547,597855571,1024
1360176500,597884136,3,164,54.66666667,1360176473547,1360176481163,597857683,597865299,7616
1360176500,597884224,1,52,52,1360176473265,1360176473265,597857489,597857489,0
1360176500,597884260,1,60,60,1360176474126,1360176474126,597858386,597858386,0
1360176504,597888108,1,60,60,1360176475880,1360176475880,597859988,597859988,0
1360176532,597916604,2,141,70.5,1360176527284,1360176527284,597911888,597911888,0
1360176552,597936324,11,3246,295.0909091,1360176526284,1360176527564,597910608,597911888,1280
1360176712,598096644,3,172,57.33333333,1360176684426,1360176688842,598069070,598073486,4416
1360176716,598100648,1,52,52,1360176688839,1360176688839,598073487,598073487,0
1360176745,598128720,1,60,60,1360176717925,1360176717925,598101645,598101645,0
1360176845,598229288,2,141,70.5,1360176840238,1360176840238,598224526,598224526,0
1360176865,598249360,11,3246,295.0909091,1360176839013,1360176840293,598223373,598224653,1280
1360177157,598541396,2,141,70.5,1360177153340,1360177153340,598537736,598537736,0
1360177178,598561732,11,3246,295.0909091,1360177152850,1360177154066,598536582,598537798,1216
1360177238,598621804,1,52,52,1360177212620,1360177212620,598596424,598596424,0
1360177314,598697920,1,52,52,1360177287511,1360177287511,598671431,598671431,0
1360177390,598774100,1,52,52,1360177362335,1360177362335,598746435,598746435,0
1360177466,598850224,1,52,52,1360177437218,1360177437218,598821442,598821442,0
1360177469,598853672,2,141,70.5,1360177466210,1360177466210,598850882,598850882,0
1360177490,598874384,11,3246,295.0909091,1360177465282,1360177466562,598849666,598850946,1280
1360177538,598922504,1,52,52,1360177511947,1360177511947,598896451,598896451,0
1360177615,598998940,1,52,52,1360177587516,1360177587516,598971456,598971456,0
1360177687,599070988,1,52,52,1360177662477,1360177662477,599046465,599046465,0
1360177763,599147296,1,52,52,1360177737175,1360177737175,599121471,599121471,0
1360177782,599165788,2,141,70.5,1360177779794,1360177779794,599163582,599163582,0
1360177803,599187436,11,3246,295.0909091,1360177778057,1360177779273,599162493,599163709,1216
1360177839,599223408,1,52,52,1360177812070,1360177812070,599196478,599196478,0
1360177912,599295820,1,52,52,1360177887665,1360177887665,599271485,599271485,0
1360178094,599478116,2,141,70.5,1360178092291,1360178092291,599476407,599476407,0
1360178116,599500100,11,3246,295.0909091,1360178091220,1360178092436,599475320,599476536,1216
1360178414,599798352,2,141,70.5,1360178406162,1360178406162,599790514,599790514,0
1360178432,599816660,11,3246,295.0909091,1360178404702,1360178405918,599789362,599790578,1216
1360178726,600110544,2,141,70.5,1360178717903,1360178717903,600102447,600102447,0
1360178745,600129228,11,3246,295.0909091,1360178717066,1360178718346,600101294,600102574,1280
1360179039,600422832,2,141,70.5,1360179031634,1360179031634,600415466,600415466,0
1360179057,600441484,11,3246,295.0909091,1360179029831,1360179031111,600414315,600415595,1280
1360179351,600735056,2,141,70.5,1360179344364,1360179344364,600728420,600728420,0
1360179370,600754440,11,3246,295.0909091,1360179342893,1360179344109,600727333,600728549,1216
1360179527,600910924,2,92,46,1360179499117,1360179503149,600883041,600887073,4032
1360181674,603058472,1,46,46,1360181645863,1360181645863,603030335,603030335,0
1360184019,605403116,1,46,46,1360183991080,1360183991080,605375196,605375196,0
1360184273,605657172,1,46,46,1360184247787,1360184247787,605631959,605631959,0
1360185359,606743576,1,46,46,1360185333063,1360185333063,606717639,606717639,0
1360185420,606803864,1,46,46,1360185394446,1360185394446,606778310,606778310,0
1360185556,606940240,3,144,48,1360185529170,1360185538130,606913410,606922370,8960
1360186830,608214260,1,440,440,1360186805545,1360186805545,608189805,608189805,0
1360187135,608519196,1,46,46,1360187108518,1360187108518,608492714,608492714,0
1360188319,609703608,1,48,48,1360188289655,1360188289655,609674263,609674263,0
1360188911,610295532,1,60,60,1360188886395,1360188886395,610270927,610270927,0
1360190315,611698712,1,46,46,1360190286614,1360190286614,611670326,611670326,0
1360190811,612195632,1,52,52,1360190784120,1360190784120,612168752,612168752,0
1360191496,612880572,1,48,48,1360191466154,1360191466154,612850726,612850726,0
1360192131,613514880,1,60,60,1360192104021,1360192104021,613487901,613487901,0
1360192291,613675236,1,60,60,1360192263854,1360192263854,613648090,613648090,0
1360192311,613695288,1,60,60,1360192285688,1360192285688,613669976,613669976,0
1360192339,613723496,1,60,60,1360192312617,1360192312617,613697113,613697113,0
1360195546,616929920,1,52,52,1360195520500,1360195520500,616904420,616904420,0
1360196694,618077812,1,46,46,1360196666961,1360196666961,618050773,618050773,0
1360196957,618340776,1,60,60,1360196930414,1360196930414,618314190,618314190,0
1360196985,618368920,1,46,46,1360196957792,1360196957792,618341712,618341712,0
1360197339,618723124,1,46,46,1360197313678,1360197313678,618697802,618697802,0
1360197715,619099224,2,326,163,1360197687201,1360197687201,619071425,619071425,0
1360198737,620121232,2,96,48,1360198712713,1360198715657,620096945,620099889,2944
1360198993,620377096,1,48,48,1360198964367,1360198964367,620348463,620348463,0
1360199291,620675028,1,448,448,1360199265805,1360199265805,620649833,620649833,0
1360199491,620875516,2,96,48,1360199466017,1360199468705,620850533,620853221,2688
1360199563,620947548,4,202,50.5,1360199535425,1360199556161,620919973,620940709,20736
1360199608,620991916,1,48,48,1360199580793,1360199580793,620964709,620964709,0
1360199636,621020144,1,48,48,1360199609619,1360199609619,620993763,620993763,0
1360200069,621452820,2,104,52,1360200043856,1360200046800,621427676,621430620,2944
1360201653,623036808,1,46,46,1360201626883,1360201626883,623010691,623010691,0
1360203333,624716752,1,78,78,1360203305379,1360203305379,624689131,624689131,0
1360204888,626271756,1,48,48,1360204859205,1360204859205,626242961,626242961,0
1360205326,626709888,1,60,60,1360205298940,1360205298940,626682828,626682828,0
1360205522,626906316,1,48,48,1360205497421,1360205497421,626881737,626881737,0
1360205522,626906316,1,48,48,1360205497421,1360205497421,626881737,626881737,0
1360205522,626906520,1,48,48,1360205497217,1360205497217,626881737,626881737,0
1360205522,626906520,1,48,48,1360205497216,1360205497216,626881736,626881736,0
1360205582,626966216,1,60,60,1360205555950,1360205555950,626940166,626940166,0
1360205582,626966288,1,60,60,1360205555367,1360205555367,626939655,626939655,0
1360205682,627066288,1,60,60,1360205656357,1360205656357,627040645,627040645,0
1360206705,628089532,1,48,48,1360206677858,1360206677858,628062390,628062390,0
1360207078,628461896,1,60,60,1360207051798,1360207051798,628435694,628435694,0
1360208146,629529624,1,46,46,1360208117654,1360208117654,629501278,629501278,0
1360208381,629765576,1,48,48,1360208352730,1360208352730,629737306,629737306,0
1360209340,630723812,1,48,48,1360209312265,1360209312265,630696077,630696077,0
1360210168,3564831032,1,46,46,1360210140743,1360210140743,3564803775,3564803775,0
1360210971,632355296,2,96,48,1360210943498,1360210946442,632327794,632330738,2944
1360214448,635831956,1,46,46,1360214420010,1360214420010,635803966,635803966,0
1360215377,636761484,1,46,46,1360215348553,1360215348553,636733037,636733037,0
1360217819,639203224,2,96,48,1360217792937,1360217796009,639177161,639180233,3072
1360218232,639616124,1,433,433,1360218203975,1360218203975,639588099,639588099,0
1360218450,639833940,1,46,46,1360218424570,1360218424570,639808510,639808510,0
1360218709,640092968,1,439,439,1360218682009,1360218682009,640065977,640065977,0
1360219058,640442140,1,440,440,1360219033255,1360219033255,640417395,640417395,0
1360220278,641662092,1,46,46,1360220250247,1360220250247,641634339,641634339,0
1360222822,644206184,1,60,60,1360222796353,1360222796353,644180537,644180537,0
1360223549,644933188,1,46,46,1360223522481,1360223522481,644906669,644906669,0
1360224417,645801340,1,436,436,1360224388941,1360224388941,645773281,645773281,0
1360225047,646431356,1,48,48,1360225018547,1360225018547,646402903,646402903,0
1360226649,648033288,1,60,60,1360226622046,1360226622046,648006334,648006334,0
1360227397,3582060828,1,60,60,1360227370009,1360227370009,3582033837,3582033837,0
1360227397,3582060836,1,60,60,1360227371412,1360227371412,3582035248,3582035248,0
1360227399,3582062648,1,60,60,1360227374990,1360227374990,3582038638,3582038638,0
1360227401,3582064816,1,60,60,1360227374888,1360227374888,3582038704,3582038704,0
1360227401,3582064816,1,60,60,1360227373671,1360227373671,3582037487,3582037487,0
1360227401,3582064816,1,60,60,1360227373991,1360227373991,3582037807,3582037807,0
1360227401,3582064816,1,60,60,1360227374501,1360227374501,3582038317,3582038317,0
1360227401,3582064820,1,60,60,1360227375204,1360227375204,3582039024,3582039024,0
1360235012,656395908,1,60,60,1360234984729,1360234984729,656368637,656368637,0
1360235360,656744096,1,48,48,1360235332056,1360235332056,656716152,656716152,0
1360236054,657438224,1,46,46,1360236026061,1360236026061,657410285,657410285,0
1360236916,658299692,1,84,84,1360236890454,1360236890454,658274146,658274146,0
1360238325,3592988448,1,46,46,1360238298654,1360238298654,3592962102,3592962102,0
1360240416,661799800,1,52,52,1360240391090,1360240391090,661774890,661774890,0
1360241318,662702356,1,60,60,1360241291127,1360241291127,662675483,662675483,0
1360241976,663359556,2,122,61,1360241948302,1360241949774,663331858,663333330,1472
1360242315,663698964,1,46,46,1360242288048,1360242288048,663672012,663672012,0
1360243921,665305044,1,52,52,1360243894726,1360243894726,665278770,665278770,0
1360243982,665365784,1,52,52,1360243954890,1360243954890,665338674,665338674,0
1360244060,665444076,1,440,440,1360244033572,1360244033572,665417648,665417648,0
1360244336,665720444,1,448,448,1360244309488,1360244309488,665693932,665693932,0
1360244733,666117464,1,46,46,1360244707671,1360244707671,666092135,666092135,0
1360247038,668422048,1,71,71,1360247013267,1360247013267,668397315,668397315,0
1360247856,669240180,2,96,48,1360247828672,1360247831680,669212852,669215860,3008
1360249090,670474048,6,298,49.66666667,1360249062000,1360249083056,670446048,670467104,21056
1360249226,670610152,2,96,48,1360249197960,1360249200968,670582112,670585120,3008
1360249467,670850900,6,298,49.66666667,1360249441535,1360249463487,670825435,670847387,21952
1360249515,670898860,1,48,48,1360249487784,1360249487784,670871644,670871644,0
1360249543,670927008,1,48,48,1360249517012,1360249517012,670901020,670901020,0
1360251223,672607192,1,46,46,1360251195329,1360251195329,672579521,672579521,0
1360252129,3606791872,1,46,46,1360252101238,1360252101238,3606764110,3606764110,0
1360252354,673737700,5,250,50,1360252326235,1360252348059,673709935,673731759,21824
1360252398,673781872,1,48,48,1360252372011,1360252372011,673755883,673755883,0
1360252426,673809984,1,48,48,1360252401339,1360252401339,673785323,673785323,0
1360253509,674893152,1,46,46,1360253484164,1360253484164,674868316,674868316,0
1360253513,674897056,1,46,46,1360253485988,1360253485988,674870044,674870044,0
1360254246,3608909308,1,46,46,1360254223890,1360254223890,3608887198,3608887198,0
1360254423,675806632,10,7026,702.6,1360254417852,1360254419132,675801484,675802764,1280
1360254442,675826084,6,981,163.5,1360254417399,1360254417591,675801483,675801675,192
1360254442,675826168,8,3159,394.875,1360254417317,1360254417637,675801485,675801805,320
1360254446,675830104,9,4743,527,1360254420386,1360254422690,675804490,675806794,2304
1360254455,675838660,5,406,81.2,1360254451743,1360254451807,675835403,675835467,64
1360254455,675838660,5,406,81.2,1360254451806,1360254451934,675835466,675835594,128
1360254502,675886300,4,372,93,1360254476768,1360254478496,675861068,675862796,1728
1360254535,675918796,3,159,53,1360254530519,1360254530519,675914315,675914315,0
1360254535,675918796,3,159,53,1360254530518,1360254530518,675914314,675914314,0
1360254535,675918796,3,159,53,1360254530518,1360254530518,675914314,675914314,0
1360254679,676063236,5,354,70.8,1360254673371,1360254677595,676057607,676061831,4224
1360254695,676079320,2,154,77,1360254682312,1360254692040,676066632,676076360,9728
1360254740,676123460,1,77,77,1360254712226,1360254712226,676095686,676095686,0
1360254760,676143588,1,46,46,1360254732261,1360254732261,676115849,676115849,0
1360254776,676159644,5,1710,342,1360254748588,1360254763692,676132232,676147336,15104
1360254776,676159684,1,77,77,1360254750723,1360254750723,676134407,676134407,0
1360254804,676187816,1,342,342,1360254779583,1360254779583,676163399,676163399,0
1360254836,676219984,1,342,342,1360254811542,1360254811542,676195526,676195526,0
1360254856,676239920,1,77,77,1360254827925,1360254827925,676211845,676211845,0
1360254976,676360068,1,46,46,1360254948928,1360254948928,676332996,676332996,0
1360255128,676511664,7,793,113.2857143,1360255119761,1360255121873,676503425,676505537,2112
1360255145,3609808124,3,448,149.3333333,1360255120079,1360255120207,3609783203,3609783331,128
1360255145,3609808172,3,1085,361.6666667,1360255120031,1360255120159,3609783203,3609783331,128
1360255145,3609808172,4,2329,582.25,1360255120031,1360255120159,3609783203,3609783331,128
1360255177,3609840040,2,96,48,1360255152867,1360255155811,3609815907,3609818851,2944
1360255273,676656572,6,1434,239,1360255246123,1360255246443,676629695,676630015,320
1360255360,676743852,5,276,55.2,1360255351698,1360255355474,676735550,676739326,3776
1360255360,676743860,3,159,53,1360255357002,1360255357002,676740862,676740862,0
1360255377,676760940,13,2570,197.6923077,1360255351482,1360255355322,676735422,676739262,3840
1360255381,676764836,3,164,54.66666667,1360255354977,1360255355489,676738813,676739325,512
1360255577,676961112,3,172,57.33333333,1360255552267,1360255555915,676936379,676940027,3648
1360255581,676965148,1,52,52,1360255555876,1360255555876,676940024,676940024,0
1360256082,677466252,2,96,48,1360256057717,1360256060725,677441969,677444977,3008
1360256339,677722584,1,46,46,1360256313997,1360256313997,677697581,677697581,0
1360256576,677959600,1,46,46,1360256550459,1360256550459,677934059,677934059,0
1360256713,678096932,1,48,48,1360256685229,1360256685229,678069161,678069161,0
1360257177,678560812,1,46,46,1360257149082,1360257149082,678532894,678532894,0
1360257218,678601544,1,52,52,1360257190119,1360257190119,678573663,678573663,0
1360257219,678602768,1,52,52,1360257192393,1360257192393,678576161,678576161,0
1360257282,678666228,1,52,52,1360257253115,1360257253115,678637343,678637343,0
1360257283,678666640,1,52,52,1360257256004,1360257256004,678639644,678639644,0
1360257337,678721060,1,46,46,1360257311842,1360257311842,678695902,678695902,0
1360257974,679358432,14,7746,553.2857143,1360257947618,1360257950370,679332050,679334802,2752
1360258107,679490820,1,46,46,1360258079876,1360258079876,679463696,679463696,0
1360258259,679643304,2,141,70.5,1360258256288,1360258256288,679640592,679640592,0
1360258283,679667044,11,3246,295.0909091,1360258255204,1360258256612,679639248,679640656,1408
1360258656,680039696,1,48,48,1360258627961,1360258627961,680011657,680011657,0
1360258756,680139976,1,46,46,1360258728928,1360258728928,680112904,680112904,0
1360258828,680212264,2,141,70.5,1360258824510,1360258824510,680208774,680208774,0
1360258848,680232128,11,3246,295.0909091,1360258823366,1360258824774,680207494,680208902,1408
1360259049,680432524,1,46,46,1360259021536,1360259021536,680405060,680405060,0
1360259273,680657344,2,104,52,1360259248680,1360259251688,680633024,680636032,3008
1360259334,680718168,1,48,48,1360259305303,1360259305303,680689471,680689471,0
1360259335,680719340,1,48,48,1360259305963,1360259305963,680690303,680690303,0
1360259751,681135340,1,46,46,1360259722148,1360259722148,681106488,681106488,0
1360259753,681136764,1,46,46,1360259724195,1360259724195,681107959,681107959,0
1360260014,681397656,41,52122,1271.268293,1360260012621,1360260012941,681396277,681396597,320
1360260043,681426848,17,22384,1316.705882,1360260017420,1360260017548,681401268,681401396,128
1360260244,681627700,1,46,46,1360260219741,1360260219741,681603441,681603441,0
1360260518,681901936,2,104,52,1360260517420,1360260517612,681901356,681901548,192
1360260544,681928328,1,52,52,1360260517731,1360260517731,681902059,681902059,0
1360260621,682004520,1,95,95,1360260593034,1360260593034,681976554,681976554,0
1360261126,682509512,4,244,61,1360261101576,1360261112008,682485088,682495520,10432
1360261126,682509512,3,152,50.66666667,1360261101576,1360261110088,682485088,682493600,8512
1360261979,683363048,5,250,50,1360261950885,1360261972197,683334933,683356245,21312
1360262023,683407252,1,48,48,1360261996056,1360261996056,683380308,683380308,0
1360262028,683411496,1,46,46,1360262001357,1360262001357,683384853,683384853,0
1360262052,683435472,1,48,48,1360262026275,1360262026275,683409747,683409747,0
1360262280,683664044,2,96,48,1360262255394,1360262258338,683639438,683642382,2944
1360262842,684225828,2,96,48,1360262814643,1360262817651,684198471,684201479,3008
1360262842,684225828,2,96,48,1360262814642,1360262817650,684198470,684201478,3008
1360265032,686415648,1,46,46,1360265003717,1360265003717,686387365,686387365,0
1360265102,686485516,1,46,46,1360265076038,1360265076038,686459554,686459554,0
1360266183,687566564,1,46,46,1360266154505,1360266154505,687538069,687538069,0
1360266291,687674560,2,96,48,1360266264136,1360266267208,687647696,687650768,3072
1360267814,689197560,1,46,46,1360267789683,1360267789683,689173243,689173243,0
1360267926,689309780,2,96,48,1360267900438,1360267903318,689284218,689287098,2880
1360270541,691924956,2,96,48,1360270514106,1360270517114,691898062,691901070,3008
1360270774,692157488,2,96,48,1360270747594,1360270750538,692131082,692134026,2944
1360275485,696868480,1,46,46,1360275455629,1360275455629,696839109,696839109,0
1360276580,697964124,1,48,48,1360276550583,1360276550583,697934707,697934707,0
1360277117,698501328,1,46,46,1360277088163,1360277088163,698472491,698472491,0
1360277275,698658672,1,445,445,1360277250799,1360277250799,698634471,698634471,0
1360277446,698830004,1,48,48,1360277416866,1360277416866,698800870,698800870,0
1360278469,699852992,1,46,46,1360278441243,1360278441243,699825235,699825235,0
1360279633,701017032,1,48,48,1360279606497,1360279606497,700990529,700990529,0
1360280529,701913376,1,46,46,1360280503167,1360280503167,701887543,701887543,0
1360280875,702258824,2,96,48,1360280849057,1360280852065,702232881,702235889,3008
1360282476,703859900,1,46,46,1360282448891,1360282448891,703832791,703832791,0
1360282747,704130584,1,46,46,1360282720242,1360282720242,704103826,704103826,0
1360285300,706683572,1,48,48,1360285272408,1360285272408,706655980,706655980,0
1360287153,708537340,1,46,46,1360287125948,1360287125948,708510288,708510288,0
1360287346,708729896,1,48,48,1360287315701,1360287315701,708699597,708699597,0
1360288262,709645416,1,46,46,1360288233799,1360288233799,709617215,709617215,0
1360288678,710061892,1,46,46,1360288650789,1360288650789,710034681,710034681,0
1360290201,711585324,1,48,48,1360290176285,1360290176285,711560609,711560609,0
1360290202,711585416,1,48,48,1360290177193,1360290177193,711560609,711560609,0
1360290651,712035292,1,46,46,1360290622264,1360290622264,712006556,712006556,0
1360290747,712130592,1,58,58,1360290721907,1360290721907,712105499,712105499,0
1360291400,712784244,1,46,46,1360291373147,1360291373147,712757391,712757391,0
1360291718,713101440,1,447,447,1360291692157,1360291692157,713075597,713075597,0
1360292628,714011720,1,46,46,1360292601301,1360292601301,713985021,713985021,0
1360294854,716238284,1,46,46,1360294826049,1360294826049,716210333,716210333,0
1360295614,716997948,1,46,46,1360295586435,1360295586435,716970383,716970383,0
1360298052,719435344,1,46,46,1360298023739,1360298023739,719407083,719407083,0
1360298412,719796240,1,46,46,1360298387128,1360298387128,719771368,719771368,0
1360298412,719796244,1,46,46,1360298387380,1360298387380,719771624,719771624,0
1360302754,724137904,2,122,61,1360302728003,1360302730179,724111907,724114083,2176
1360303390,724773484,1,48,48,1360303360864,1360303360864,724744348,724744348,0
1360304410,725793460,1,46,46,1360304381926,1360304381926,725765386,725765386,0
1360304857,726240324,1,48,48,1360304829479,1360304829479,726212803,726212803,0
1360305184,726567484,1,148,148,1360305157509,1360305157509,726540993,726540993,0
1360306279,727662612,1,46,46,1360306253748,1360306253748,727637360,727637360,0
1360309721,731105104,1,52,52,1360309696017,1360309696017,731080121,731080121,0
1360310699,732083136,2,120,60,1360310674275,1360310677283,732058411,732061419,3008
1360311457,732840704,1,60,60,1360311432136,1360311432136,732815840,732815840,0
1360311782,733165656,2,122,61,1360311754356,1360311756468,733138012,733140124,2112
1360311838,733221648,1,46,46,1360311812027,1360311812027,733195675,733195675,0
1360318215,3672878096,1,56,56,1360318189639,1360318189639,3672852735,3672852735,0
1360319639,741022376,1,48,48,1360319611925,1360319611925,740995301,740995301,0
1360320048,741432092,1,46,46,1360320020932,1360320020932,741405024,741405024,0
1360320324,741707452,1,46,46,1360320298497,1360320298497,741681949,741681949,0
1360328820,750203252,1,48,48,1360328791432,1360328791432,750174684,750174684,0
1360329420,750803376,1,46,46,1360329395137,1360329395137,750778513,750778513,0
1360329973,751356804,1,48,48,1360329947852,1360329947852,751331656,751331656,0
1360330932,752315596,1,46,46,1360330903886,1360330903886,752287482,752287482,0
1360332543,753926768,1,46,46,1360332518857,1360332518857,753902625,753902625,0
1360332579,753962520,1,46,46,1360332569155,1360332569155,753952675,753952675,0
1360332908,754291908,1,46,46,1360332881081,1360332881081,754264989,754264989,0
1360332912,754295876,11,3246,295.0909091,1360332884890,1360332886234,754268766,754270110,1344
1360333028,754412064,1,46,46,1360333000669,1360333000669,754384733,754384733,0
1360333037,754420400,1,60,60,1360333010932,1360333010932,754394332,754394332,0
1360333071,754454240,1,46,46,1360333045137,1360333045137,754428377,754428377,0
1360333071,754454516,1,46,46,1360333043901,1360333043901,754427417,754427417,0
1360333091,754474868,2,141,70.5,1360333085407,1360333085407,754469275,754469275,0
1360333097,754480464,11,3246,295.0909091,1360333069554,1360333085938,754453018,754469402,16384
1360334405,755788440,1,78,78,1360334378421,1360334378421,755761861,755761861,0
1360334457,755840572,1,78,78,1360334430131,1360334430131,755813703,755813703,0
1360337344,758727496,1,60,60,1360337316689,1360337316689,758700185,758700185,0
1360338218,759601968,1,46,46,1360338190638,1360338190638,759574606,759574606,0
1360338304,759687372,1,46,46,1360338276542,1360338276542,759659914,759659914,0
1360338998,760382060,1,48,48,1360338968451,1360338968451,760352511,760352511,0
1360339985,761368536,2,131,65.5,1360339982084,1360339982084,761365620,761365620,0
1360340097,761480604,5,456,91.2,1360340089150,1360340089278,761472754,761472882,128
1360340122,761505380,10,4724,472.4,1360340094621,1360340094813,761478001,761478193,192
1360340129,761512740,2,157,78.5,1360340124595,1360340124595,761508335,761508335,0
1360340313,761696784,5,456,91.2,1360340308422,1360340308486,761692206,761692270,64
1360340337,761720700,9,2739,304.3333333,1360340330074,1360340330394,761713774,761714094,320
1360340337,761720700,9,2739,304.3333333,1360340329049,1360340329305,761712749,761713005,256
1360340337,761720756,26,12405,477.1153846,1360340330144,1360340333024,761713900,761716780,2880
1360340345,761728696,50,27983,559.66,1360340330459,1360340342683,761714155,761726379,12224
1360340353,761736736,36,38339,1064.972222,1360340350900,1360340352308,761734636,761736044,1408
1360340353,761736736,46,27117,589.5,1360340332020,1360340349748,761715756,761733484,17728
1360340353,761736760,158,179388,1135.367089,1360340340380,1360340351324,761724140,761735084,10944
1360340353,761736760,32,34868,1089.625,1360340351452,1360340351964,761735212,761735724,512
1360340353,761736764,7,3451,493,1360340351511,1360340351639,761735275,761735403,128
1360340353,761736764,43,42535,989.1860465,1360340351578,1360340352602,761735342,761736366,1024
1360340353,761736764,42,32039,762.8333333,1360340351959,1360340352663,761735723,761736427,704
1360340353,761736768,33,29935,907.1212121,1360340352087,1360340352727,761735855,761736495,640
1360340353,761736768,7,3451,493,1360340352276,1360340352660,761736044,761736428,384
1360340353,761736772,30,30191,1006.366667,1360340352271,1360340352783,761736043,761736555,512
1360340353,761736772,10,6503,650.3,1360340352465,1360340352657,761736237,761736429,192
1360340353,761736832,127,138317,1089.110236,1360340335254,1360340352150,761719086,761735982,16896
1360340353,761736832,158,178849,1131.955696,1360340335253,1360340352149,761719085,761735981,16896
1360340353,761736832,151,173480,1148.874172,1360340335317,1360340351509,761719149,761735341,16192
1360340353,761736856,116,122753,1058.215517,1360340340285,1360340351357,761724141,761735213,11072
1360340353,761736860,36,32879,913.3055556,1360340351675,1360340352187,761735535,761736047,512
1360340353,761736860,36,30337,842.6944444,1360340351674,1360340352314,761735534,761736174,640
1360340353,761736860,15,10005,667,1360340351673,1360340351993,761735533,761735853,320
1360340354,761737860,10,3026,302.6,1360340329209,1360340330361,761713069,761714221,1152
1360340354,761738020,23,4422,192.2608696,1360340328664,1360340330328,761712684,761714348,1664
1360340354,761738028,11,3099,281.7272727,1360340329042,1360340330322,761713070,761714350,1280
1360340358,761741788,12,7344,612,1360340330112,1360340330880,761713900,761714668,768
1360340358,761741788,7,925,132.1428571,1360340330176,1360340330624,761713964,761714412,448
1360340358,761741792,11,3415,310.4545455,1360340330366,1360340330878,761714158,761714670,512
1360340358,761741800,26,9882,380.0769231,1360340331255,1360340334199,761715055,761717999,2944
1360340358,761741804,80,78403,980.0375,1360340331953,1360340354673,761715757,761738477,22720
1360340358,761741868,11,3328,302.5454545,1360340330224,1360340330736,761714092,761714604,512
1360340358,761741868,15,8390,559.3333333,1360340330224,1360340330928,761714092,761714796,704
1360340358,761741868,12,3973,331.0833333,1360340330288,1360340331056,761714156,761714924,768
1360340358,761741884,82,90431,1102.817073,1360340331873,1360340357601,761715757,761741485,25728
1360340361,761744824,17,10128,595.7647059,1360340352606,1360340354526,761736430,761738350,1920
1360340362,761745832,13,5358,412.1538462,1360340334228,1360340358548,761718060,761742380,24320
1360340366,761749844,18,17778,987.6666667,1360340341511,1360340341767,761725355,761725611,256
1360340366,761749948,16,13890,868.125,1360340341409,1360340341985,761725357,761725933,576
1360340367,3695029736,23,19893,864.9130435,1360340340867,1360340359043,3695003603,3695021779,18176
1360340378,761761796,27,33162,1228.222222,1360340353016,1360340354040,761736812,761737836,1024
1360340378,761761840,19,18530,975.2631579,1360340351435,1360340351947,761735275,761735787,512
1360340378,761761840,3,180,60,1360340351693,1360340359117,761735533,761742957,7424
1360340378,761761844,3,180,60,1360340352456,1360340358920,761736300,761742764,6464
1360340378,761761844,22,21052,956.9090909,1360340352520,1360340354440,761736364,761738284,1920
1360340378,761761848,3,4500,1500,1360340352900,1360340354564,761736748,761738412,1664
1360340378,761761848,4,6000,1500,1360340352963,1360340358915,761736811,761742763,5952
1360340378,761761876,9,5586,620.6666667,1360340352936,1360340354728,761736812,761738604,1792
1360340378,761761880,24,22587,941.125,1360340350114,1360340350754,761733994,761734634,640
1360340378,761761884,4,6000,1500,1360340353249,1360340368865,761737133,761752749,15616
1360340378,761761888,25,24701,988.04,1360340350362,1360340350810,761734250,761734698,448
1360340378,761761888,21,19712,938.6666667,1360340350430,1360340350750,761734318,761734638,320
1360340378,761761896,21,16783,799.1904762,1360340351254,1360340352150,761735150,761736046,896
1360340378,761761896,2,120,60,1360340351381,1360340352277,761735277,761736173,896
1360340378,761761912,3,180,60,1360340351619,1360340358851,761735531,761742763,7232
1360340382,761766012,9,6329,703.2222222,1360340357599,1360340357727,761741611,761741739,128
1360340386,761769904,24,14347,597.7916667,1360340358154,1360340382218,761742058,761766122,24064
1360340386,761769908,29,17294,596.3448276,1360340358280,1360340384520,761742188,761768428,26240
1360340386,761769952,70,57481,821.1571429,1360340359452,1360340382492,761743404,761766444,23040
1360340390,3695052804,5,325,65,1360340389758,1360340389758,3695052562,3695052562,0
1360340390,761773896,15,12743,849.5333333,1360340362454,1360340362646,761746350,761746542,192
1360340390,761773896,32,34464,1077,1360340362518,1360340379670,761746414,761763566,17152
1360340390,761773896,26,27012,1038.923077,1360340362518,1360340379542,761746414,761763438,17024
1360340393,761776824,9,603,67,1360340389274,1360340392666,761773098,761776490,3392
1360340393,761776824,5,287,57.4,1360340389342,1360340389406,761773166,761773230,64
1360340393,761776824,5,287,57.4,1360340389341,1360340389405,761773165,761773229,64
1360340393,761776824,5,287,57.4,1360340389276,1360340389340,761773100,761773164,64
1360340393,761776824,8,524,65.5,1360340389276,1360340391260,761773100,761775084,1984
1360340393,761776824,5,287,57.4,1360340389276,1360340389404,761773100,761773228,128
1360340393,761776824,5,287,57.4,1360340389276,1360340389404,761773100,761773228,128
1360340393,761776824,5,287,57.4,1360340389340,1360340389404,761773164,761773228,64
1360340393,761776824,5,287,57.4,1360340389340,1360340389404,761773164,761773228,64
1360340393,761776824,5,287,57.4,1360340389339,1360340389403,761773163,761773227,64
1360340393,761776900,5,325,65,1360340389198,1360340389262,761773098,761773162,64
1360340393,761776904,5,287,57.4,1360340389262,1360340389326,761773166,761773230,64
1360340393,761776904,3,209,69.66666667,1360340389195,1360340389195,761773099,761773099,0
1360340393,761776904,5,325,65,1360340389195,1360340389259,761773099,761773163,64
1360340393,761776908,5,287,57.4,1360340389258,1360340389322,761773166,761773230,64
1360340394,761777960,20,6217,310.85,1360340368212,1360340392596,761752172,761776556,24384
1360340394,761778040,17,8731,513.5882353,1360340368132,1360340392708,761752172,761776748,24576
1360340409,761792832,2,158,79,1360340396243,1360340403411,761780075,761787243,7168
1360340414,761797916,1,1500,1500,1360340386687,1360340386687,761770603,761770603,0
1360340414,761798036,29,23463,809.0689655,1360340388169,1360340409801,761772205,761793837,21632
1360340417,761800744,2,92,46,1360340412012,1360340412012,761795756,761795756,0
1360340417,761800788,2,92,46,1360340410815,1360340410815,761794603,761794603,0
1360340417,761800788,22,18647,847.5909091,1360340410814,1360340411326,761794602,761795114,512
1360340418,761801940,1,79,79,1360340393448,1360340393448,761777388,761777388,0
1360340418,761801976,11,3508,318.9090909,1360340392130,1360340409858,761776106,761793834,17728
1360340418,761801976,10,3778,377.8,1360340392130,1360340409730,761776106,761793706,17600
1360340425,761808808,9,603,67,1360340419374,1360340423662,761803182,761807470,4288
1360340434,761817924,8,4357,544.625,1360340409399,1360340432503,761793323,761816427,23104
1360340434,761818004,10,3877,387.7,1360340409319,1360340432231,761793323,761816235,22912
1360340441,761824772,2,158,79,1360340428239,1360340437327,761812011,761821099,9088
1360340442,761825948,1,79,79,1360340417694,1360340417694,761801642,761801642,0
1360340442,761826060,23,16123,701,1360340416174,1360340437102,761800234,761821162,20928
1360340450,761833944,1,1500,1500,1360340422370,1360340422370,761806314,761806314,0
1360340458,761841996,12,4791,399.25,1360340431793,1360340437297,761815789,761821293,5504
1360340458,761842072,12,3293,274.4166667,1360340431717,1360340436901,761815789,761820973,5184
1360340462,761846072,6,1642,273.6666667,1360340436515,1360340437027,761820587,761821099,512
1360340462,761846072,5,3118,623.6,1360340436515,1360340437155,761820587,761821227,640
1360340466,761850080,3,282,94,1360340439837,1360340449821,761823917,761833901,9984
1360340474,761858020,18,4855,269.7222222,1360340447255,1360340464535,761831275,761848555,17280
1360340474,761858060,1,79,79,1360340446318,1360340446318,761830378,761830378,0
1360340482,761866112,1,79,79,1360340455164,1360340455164,761839276,761839276,0
1360340490,761874000,4,2151,537.75,1360340462314,1360340462954,761846314,761846954,640
1360340490,761874068,9,2467,274.1111111,1360340462245,1360340464421,761846313,761848489,2176
1360340490,761874068,5,1868,373.6,1360340462245,1360340462693,761846313,761846761,448
1360340490,761874068,5,1872,374.4,1360340462245,1360340462757,761846313,761846825,512
1360340494,761877988,26,27594,1061.307692,1360340467381,1360340470645,761851369,761854633,3264
1360340502,761886108,42,50522,1202.904762,1360340477183,1360340494527,761861291,761878635,17344
1360340507,761890208,1,405,405,1360340481156,1360340481156,761864364,761864364,0
1360340513,761896804,5,287,57.4,1360340509488,1360340509680,761893292,761893484,192
1360340513,761896804,4,235,58.75,1360340509488,1360340509488,761893292,761893292,0
1360340513,761896804,5,287,57.4,1360340509488,1360340509680,761893292,761893484,192
1360340513,761896880,5,287,57.4,1360340509409,1360340509601,761893289,761893481,192
1360340513,761896884,5,287,57.4,1360340509404,1360340509596,761893288,761893480,192
1360340518,761902104,1,79,79,1360340491456,1360340491456,761875560,761875560,0
1360340526,761910136,52,67131,1290.980769,1360340499748,1360340514148,761883884,761898284,14400
1360340534,761918108,17,20496,1205.647059,1360340506685,1360340518717,761890793,761902825,12032
1360340555,761938216,23,28062,1220.086957,1360340529723,1360340552827,761912939,761936043,23104
1360340562,761946140,17,15422,907.1764706,1360340534108,1360340549916,761918248,761934056,15808
1360340562,761946144,14,11234,802.4285714,1360340534106,1360340534746,761918250,761918890,640
1360340562,761946144,16,11432,714.5,1360340534106,1360340534618,761918250,761918762,512
1360340562,761946144,14,8725,623.2142857,1360340534106,1360340534490,761918250,761918634,384
1360340563,761946220,16,11698,731.125,1360340534967,1360340535287,761918187,761918507,320
1360340563,761946220,24,24178,1007.416667,1360340534967,1360340550647,761918187,761933867,15680
1360340563,761946220,23,22430,975.2173913,1360340534966,1360340551030,761918186,761934250,16064
1360340563,761946260,29,13423,462.862069,1360340538703,1360340560399,761921963,761943659,21696
1360340563,761946260,23,10782,468.7826087,1360340538702,1360340560590,761921962,761943850,21888
1360340567,761950296,29,38290,1320.344828,1360340540328,1360340553000,761923624,761936296,12672
1360340577,761960792,5,325,65,1360340569530,1360340569594,761953322,761953386,64
1360340577,761960792,9,603,67,1360340569594,1360340573690,761953386,761957482,4096
1360340577,761960868,9,603,67,1360340569454,1360340572782,761953322,761956650,3328
1360340577,761960868,5,287,57.4,1360340569517,1360340569581,761953385,761953449,64
1360340583,761966528,17,3693,217.2352941,1360340557314,1360340574082,761940842,761957610,16768
1360340583,761966612,13,4531,348.5384615,1360340557228,1360340574252,761940840,761957864,17024
1360340583,761966616,16,3868,241.75,1360340557225,1360340573993,761940841,761957609,16768
1360340591,761974592,30,8926,297.5333333,1360340564290,1360340584578,761947882,761968170,20288
1360340591,761974592,19,8514,448.1052632,1360340564288,1360340584832,761947880,761968424,20544
1360340593,761976848,2,158,79,1360340578048,1360340586944,761961896,761970792,8896
1360340595,761978524,2,131,65.5,1360340570436,1360340570436,761953960,761953960,0
1360340599,761982536,44,63339,1439.522727,1360340573687,1360340573879,761957223,761957415,192
1360340601,761984792,7,445,63.57142857,1360340599609,1360340600441,761983401,761984233,832
1360340601,761984868,5,325,65,1360340599531,1360340599531,761983399,761983399,0
1360340609,761992788,3,237,79,1360340601597,1360340608381,761985385,761992169,6784
1360340615,761998492,25,26535,1061.4,1360340588645,1360340592741,761972137,761976233,4096
1360340615,761998492,22,25052,1138.727273,1360340588836,1360340592612,761972328,761976104,3776
1360340615,761998560,12,8150,679.1666667,1360340588512,1360340588640,761972072,761972200,128
1360340625,762008860,5,456,91.2,1360340622899,1360340622963,762006759,762006823,64
1360340627,762010580,3,426,142,1360340601868,1360340602060,761985448,761985640,192
1360340627,762010612,16,8143,508.9375,1360340602220,1360340603500,761985832,761987112,1280
1360340631,762014504,14,13266,947.5714286,1360340604185,1360340604441,761987689,761987945,256
1360340631,762014508,1,79,79,1360340604947,1360340604947,761988455,761988455,0
1360340631,3695293996,25,30323,1212.92,1360340603775,1360340603903,3695266771,3695266899,128
1360340631,3695294048,35,44720,1277.714286,1360340603724,1360340603916,3695266772,3695266964,192
1360340631,762014580,18,16284,904.6666667,1360340604109,1360340604365,761987689,761987945,256
1360340631,762014580,11,8934,812.1818182,1360340604108,1360340604300,761987688,761987880,192
1360340631,762014580,18,15676,870.8888889,1360340604108,1360340604364,761987688,761987944,256
1360340631,762014580,13,9166,705.0769231,1360340604108,1360340604300,761987688,761987880,192
1360340633,762016796,971,1339182,1379.178167,1360340398774,1360340629622,761782570,762013418,230848
1360340633,762016796,3,183,61,1360340627893,1360340627893,762011689,762011689,0
1360340633,762016796,388,507660,1308.402062,1360340419445,1360340629621,761803241,762013417,210176
1360340633,762016828,779,1055869,1355.415918,1360340343381,1360340629653,761727209,762013481,286272
1360340633,762016828,1476,2024267,1371.454607,1360340343443,1360340629651,761727271,762013479,286208
1360340633,762016832,3,183,61,1360340629584,1360340629584,762013416,762013416,0
1360340633,762016836,435,577665,1327.965517,1360340392334,1360340629646,761776170,762013482,237312
1360340633,762016836,2,157,78.5,1360340629581,1360340629581,762013417,762013417,0
1360340633,762016836,3,183,61,1360340629645,1360340629645,762013481,762013481,0
1360340633,762016872,9,2739,304.3333333,1360340627818,1360340628266,762011690,762012138,448
1360340633,762016872,1620,2205158,1361.208642,1360340342505,1360340629545,761726377,762013417,287040
1360340633,762016912,3,183,61,1360340629505,1360340629505,762013417,762013417,0
1360340633,762016912,3,183,61,1360340629569,1360340629569,762013481,762013481,0
1360340633,762016912,2,157,78.5,1360340629503,1360340629503,762013415,762013415,0
1360340633,762016912,3,183,61,1360340629567,1360340629567,762013479,762013479,0
1360340633,762016912,3,183,61,1360340629567,1360340629567,762013479,762013479,0
1360340633,762016916,2437,3426506,1406.034469,1360340341438,1360340629566,761725354,762013482,288128
1360340633,762016916,1249,1703411,1363.819856,1360340357694,1360340629502,761741610,762013418,271808
1360340641,762024856,2,158,79,1360340617401,1360340635449,762001257,762019305,18048
1360340655,762038624,15,3214,214.2666667,1360340628512,1360340629344,762012136,762012968,832
1360340665,762048808,4,247,61.75,1360340659750,1360340659814,762043558,762043622,64
1360340665,762048844,2,157,78.5,1360340661634,1360340661634,762045478,762045478,0
1360340665,762048844,2,157,78.5,1360340661634,1360340661634,762045478,762045478,0
1360340665,762048848,2,157,78.5,1360340661630,1360340661630,762045478,762045478,0
1360340665,762048848,2,157,78.5,1360340661630,1360340661630,762045478,762045478,0
1360340665,762048848,2,104,52,1360340661697,1360340661697,762045545,762045545,0
1360340665,762048928,3,183,61,1360340661617,1360340661617,762045545,762045545,0
1360340665,762048928,2,157,78.5,1360340661553,1360340661553,762045481,762045481,0
1360340667,762050596,1,79,79,1360340640253,1360340640253,762023849,762023849,0
1360340670,3695332848,2,157,78.5,1360340662101,1360340662101,3695324949,3695324949,0
1360340670,3695332848,2,157,78.5,1360340662101,1360340662101,3695324949,3695324949,0
1360340681,762064808,10,6369,636.9,1360340675815,1360340678119,762059623,762061927,2304
1360340689,762072836,9,2739,304.3333333,1360340681738,1360340682122,762065574,762065958,384
1360340689,762072836,8,1403,175.375,1360340687117,1360340687629,762070953,762071465,512
1360340689,762072836,23,13631,592.6521739,1360340682186,1360340683338,762066022,762067174,1152
1360340689,762072840,8,1403,175.375,1360340683785,1360340684361,762067625,762068201,576
1360340689,762072864,8,1403,175.375,1360340684400,1360340684912,762068264,762068776,512
1360340689,762072912,8,1403,175.375,1360340683265,1360340683649,762067177,762067561,384
1360340689,762072944,8,1403,175.375,1360340687583,1360340688095,762071527,762072039,512
1360340689,762072980,8,1403,175.375,1360340686331,1360340686843,762070311,762070823,512
1360340697,762080796,8,1403,175.375,1360340695157,1360340695669,762078953,762079465,512
1360340697,762080800,8,1403,175.375,1360340689903,1360340690415,762073703,762074215,512
1360340697,762080804,8,1403,175.375,1360340690474,1360340690922,762074278,762074726,448
1360340697,762080868,8,1403,175.375,1360340689197,1360340689709,762073065,762073577,512
1360340697,762080876,8,1403,175.375,1360340695651,1360340696163,762079527,762080039,512
1360340697,762080916,8,1403,175.375,1360340696251,1360340696763,762080167,762080679,512
1360340699,762082696,1,79,79,1360340671831,1360340671831,762055527,762055527,0
1360340703,762086596,17,16609,977,1360340676029,1360340681213,762059625,762064809,5184
1360340703,762086596,9,2762,306.8888889,1360340676092,1360340676732,762059688,762060328,640
1360340703,762086640,12,8493,707.75,1360340678286,1360340681166,762061926,762064806,2880
1360340703,762086640,38,45075,1186.184211,1360340678286,1360340681358,762061926,762064998,3072
1360340703,762086672,27,27538,1019.925926,1360340675950,1360340700334,762059622,762084006,24384
1360340703,762086712,11,4861,441.9090909,1360340677766,1360340680326,762061478,762064038,2560
1360340705,762088992,8,1403,175.375,1360340703854,1360340704366,762087846,762088358,512
1360340707,3695370076,17,17137,1008.058824,1360340681201,1360340681713,3695344277,3695344789,512
1360340707,762090656,15,9746,649.7333333,1360340681216,1360340681472,762064872,762065128,256
1360340707,762090684,22,22701,1031.863636,1360340682147,1360340682467,762065831,762066151,320
1360340707,762090688,61,80891,1326.081967,1360340682143,1360340700319,762065831,762084007,18176
1360340707,762090688,12,10368,864,1360340682207,1360340682463,762065895,762066151,256
1360340711,762094612,7,1152,164.5714286,1360340683373,1360340704045,762066985,762087657,20672
1360340713,762096852,8,1403,175.375,1360340705210,1360340705722,762089062,762089574,512
1360340713,762096920,8,1403,175.375,1360340704505,1360340705017,762088425,762088937,512
1360340719,762102660,37,23174,626.3243243,1360340694201,1360340708281,762077861,762091941,14080
1360340727,762110636,21,22696,1080.761905,1360340700371,1360340701075,762084007,762084711,704
1360340734,3695396860,3,209,69.66666667,1360340731400,1360340731400,3695394260,3695394260,0
1360340737,762120816,2,157,78.5,1360340730976,1360340730976,762114792,762114792,0
1360340737,762120816,2,157,78.5,1360340730976,1360340730976,762114792,762114792,0
1360340737,762120816,2,157,78.5,1360340730976,1360340730976,762114792,762114792,0
1360340737,762120816,3,183,61,1360340730976,1360340730976,762114792,762114792,0
1360340737,762120816,3,183,61,1360340730976,1360340730976,762114792,762114792,0
1360340737,762120816,2,104,52,1360340730976,1360340730976,762114792,762114792,0
1360340737,762120820,13,1231,94.69230769,1360340729243,1360340730971,762113063,762114791,1728
1360340737,762120864,2,157,78.5,1360340730928,1360340730928,762114792,762114792,0
1360340737,762120864,2,157,78.5,1360340730928,1360340730928,762114792,762114792,0
1360340737,762120864,2,157,78.5,1360340730927,1360340730927,762114791,762114791,0
1360340737,762120864,3,183,61,1360340730927,1360340730927,762114791,762114791,0
1360340737,762120864,3,183,61,1360340730927,1360340730927,762114791,762114791,0
1360340737,762120864,3,183,61,1360340730927,1360340730927,762114791,762114791,0
1360340737,762120868,6,991,165.1666667,1360340729196,1360340730924,762113064,762114792,1728
1360340739,762122848,496,682659,1376.328629,1360340357761,1360340438657,761741609,761822505,80896
1360340751,762134928,4,202,50.5,1360340723373,1360340744365,762107301,762128293,20992
1360340759,762142848,1,46,46,1360340730943,1360340730943,762114791,762114791,0
1360340937,762320980,5,456,91.2,1360340932985,1360340933049,762316965,762317029,64
1360341017,762401048,9,2739,304.3333333,1360341013172,1360341013620,762397220,762397668,448
1360341017,762401052,9,2739,304.3333333,1360341013681,1360341014129,762397733,762398181,448
1360341017,762401052,8,602,75.25,1360341014381,1360341014637,762398433,762398689,256
1360341040,762423568,27,4608,170.6666667,1360341013649,1360341015313,762397217,762398881,1664
1360341040,762423576,24,6664,277.6666667,1360341014920,1360341022792,762398496,762406368,7872
1360341040,762423580,12,4832,402.6666667,1360341014920,1360341019464,762398500,762403044,4544
1360341040,762423580,13,3768,289.8461538,1360341014919,1360341019527,762398499,762403107,4608
1360341040,762423580,50,37349,746.98,1360341014982,1360341022342,762398562,762405922,7360
1360341040,762423580,15,8389,559.2666667,1360341015173,1360341015877,762398753,762399457,704
1360341040,762423584,12,3934,327.8333333,1360341015168,1360341016064,762398752,762399648,896
1360341040,762423652,13,3575,275,1360341014845,1360341019389,762398497,762403041,4544
1360341043,3695706564,17,14185,834.4117647,1360341018314,1360341022602,3695681878,3695686166,4288
1360341044,762427728,5,2006,401.2,1360341017523,1360341017587,762401251,762401315,64
1360341044,762427760,13,11011,847,1360341016915,1360341018643,762400675,762402403,1728
1360341044,762427768,25,27697,1107.88,1360341018762,1360341019146,762402530,762402914,384
1360341044,762427768,35,42700,1220,1360341018697,1360341019145,762402465,762402913,448
1360341044,762427804,26,9903,380.8846154,1360341015975,1360341018023,762399779,762401827,2048
1360341044,762427808,11,2953,268.4545455,1360341017634,1360341018338,762401442,762402146,704
1360341044,762427844,20,18418,920.9,1360341016959,1360341020543,762400803,762404387,3584
1360341044,762427844,16,12447,777.9375,1360341016831,1360341018623,762400675,762402467,1792
1360341044,762427844,15,13323,888.2,1360341016831,1360341022911,762400675,762406755,6080
1360341044,762427844,81,106372,1313.234568,1360341018620,1360341022844,762402464,762406688,4224
1360341044,762427848,34,41152,1210.352941,1360341018619,1360341019131,762402467,762402979,512
1360341044,762427848,46,56345,1224.891304,1360341018683,1360341019259,762402531,762403107,576
1360341078,3695740912,335,488330,1457.701493,1360341040150,1360341075094,3695703062,3695738006,34944
1360341078,3695740920,2,157,78.5,1360341075087,1360341075087,3695738007,3695738007,0
1360341080,762463932,3,1489,496.3333333,1360341054373,1360341054373,762438305,762438305,0
1360341080,762463932,27,27545,1020.185185,1360341054117,1360341066341,762438049,762450273,12224
1360341080,762463936,4,554,138.5,1360341054497,1360341054689,762438433,762438625,192
1360341081,762465112,5,287,57.4,1360341074482,1360341074546,762458594,762458658,64
1360341081,762465112,5,287,57.4,1360341074482,1360341074546,762458594,762458658,64
1360341081,762465112,3,209,69.66666667,1360341074416,1360341074416,762458528,762458528,0
1360341081,762465112,3,209,69.66666667,1360341074416,1360341074416,762458528,762458528,0
1360341081,762465116,5,287,57.4,1360341074476,1360341074540,762458592,762458656,64
1360341081,762465192,5,287,57.4,1360341074403,1360341074467,762458595,762458659,64
1360341081,762465192,9,603,67,1360341074403,1360341078691,762458595,762462883,4288
1360341081,762465192,5,287,57.4,1360341074403,1360341074467,762458595,762458659,64
1360341081,762465192,5,287,57.4,1360341074403,1360341074467,762458595,762458659,64
1360341081,762465192,3,209,69.66666667,1360341074337,1360341074337,762458529,762458529,0
1360341081,762465192,5,325,65,1360341074337,1360341074337,762458529,762458529,0
1360341084,762467900,6,3351,558.5,1360341056006,1360341066502,762439906,762450402,10496
1360341092,762475860,5,1946,389.2,1360341065710,1360341066542,762449570,762450402,832
1360341092,762475896,58,85206,1469.068966,1360341066250,1360341066570,762450146,762450466,320
1360341092,762475980,18,24126,1340.333333,1360341066166,1360341066358,762450146,762450338,192
1360341092,762475980,3,836,278.6666667,1360341066166,1360341066294,762450146,762450274,128
1360341098,762481180,2,158,79,1360341084308,1360341093524,762467488,762476704,9216
1360341105,762489104,262,356008,1358.80916,1360341095865,1360341098937,762479969,762483041,3072
1360341105,762489108,246,332124,1350.097561,1360341095860,1360341098932,762479968,762483040,3072
1360341105,762489116,5,287,57.4,1360341104559,1360341104687,762488675,762488803,128
1360341105,762489116,291,406792,1397.910653,1360341016557,1360341104813,762400673,762488929,88256
1360341106,762489184,269,365492,1358.70632,1360341096784,1360341104976,762479968,762488160,8192
1360341106,762489184,273,367822,1347.333333,1360341096784,1360341099856,762479968,762483040,3072
1360341106,762489196,6,366,61,1360341105414,1360341105734,762488610,762488930,320
1360341106,762489196,6,366,61,1360341105413,1360341105733,762488609,762488929,320
1360341106,762489196,5,287,57.4,1360341105477,1360341105605,762488673,762488801,128
1360341112,762495968,16,2870,179.375,1360341086273,1360341092161,762470241,762476129,5888
1360341113,762497092,3,237,79,1360341105350,1360341108742,762489442,762492834,3392
1360341113,762497092,3,237,79,1360341105414,1360341108870,762489506,762492962,3456
1360341114,762497176,3,237,79,1360341106331,1360341109851,762489507,762493027,3520
1360341114,762497212,721,1072956,1488.149792,1360341100023,1360341111927,762483235,762495139,11904
1360341116,762499864,3,1574,524.6666667,1360341088231,1360341088231,762472095,762472095,0
1360341116,762499864,3,490,163.3333333,1360341088362,1360341088618,762472226,762472482,256
1360341116,762499984,5,439,87.8,1360341091122,1360341091570,762475106,762475554,448
1360341116,762499984,11,971,88.27272727,1360341091569,1360341092017,762475553,762476001,448
1360341120,3695782768,3,498,166,1360341095207,1360341095207,3695757975,3695757975,0
1360341120,3695782768,49,69496,1418.285714,1360341095206,1360341095270,3695757974,3695758038,64
1360341120,3695782816,3,498,166,1360341095160,1360341095160,3695757976,3695757976,0
1360341120,762503888,43,55677,1294.813953,1360341095119,1360341116047,762479007,762499935,20928
1360341120,762503956,14,8191,585.0714286,1360341094092,1360341094412,762478048,762478368,320
1360341120,762503960,13,7240,556.9230769,1360341094155,1360341094411,762478115,762478371,256
1360341129,762513120,2,158,79,1360341113447,1360341122663,762497567,762506783,9216
1360341129,762513156,553,822479,1487.303797,1360341114630,1360341121030,762498786,762505186,6400
1360341130,762513188,2,158,79,1360341114189,1360341123149,762497377,762506337,8960
1360341130,762513196,2,158,79,1360341114503,1360341123847,762497699,762507043,9344
1360341138,762521788,1,79,79,1360341111349,1360341111349,762495137,762495137,0
1360341139,762522900,2,104,52,1360341134789,1360341134789,762518689,762518689,0
1360341139,762522980,5,287,57.4,1360341134709,1360341134837,762518689,762518817,128
1360341139,762522980,5,287,57.4,1360341134709,1360341134837,762518689,762518817,128
1360341139,762522980,5,287,57.4,1360341134708,1360341134836,762518688,762518816,128
1360341140,762523908,1,46,46,1360341114877,1360341114877,762498785,762498785,0
1360341148,762531956,1,52,52,1360341121165,1360341121165,762505121,762505121,0
1360341156,762539868,1,46,46,1360341129380,1360341129380,762513248,762513248,0
1360341161,762545124,3,138,46,1360341153957,1360341154021,762538081,762538145,64
1360341162,762545200,5,325,65,1360341155009,1360341155009,762538209,762538209,0
1360341168,762551884,1,79,79,1360341140499,1360341140499,762524383,762524383,0
1360341168,762551976,1,79,79,1360341141688,1360341141688,762525664,762525664,0
1360341176,762559900,1,79,79,1360341148038,1360341148038,762531938,762531938,0
1360341180,3695842740,1,52,52,1360341154949,1360341154949,3695817689,3695817689,0
1360341180,3695842752,1,52,52,1360341154936,1360341154936,3695817688,3695817688,0
1360341180,3695842780,1,52,52,1360341154906,1360341154906,3695817686,3695817686,0
1360341192,762575996,1,541,541,1360341164772,1360341164772,762548768,762548768,0
1360341193,762577164,140,204128,1458.057143,1360341183422,1360341188990,762567586,762573154,5568
1360341202,762585200,15,13843,922.8666667,1360341184769,1360341199233,762567969,762582433,14464
1360341204,762588152,1,79,79,1360341176262,1360341176262,762560414,762560414,0
1360341205,762588276,1,79,79,1360341179701,1360341179701,762562977,762562977,0
1360341208,762592144,1,52,52,1360341183758,1360341183758,762567902,762567902,0
1360341217,762601168,726,1080777,1488.673554,1360341197944,1360341213496,762582112,762597664,15552
1360341217,762601176,15,15153,1010.2,1360341198255,1360341213935,762582431,762598111,15680
1360341225,762608196,1,46,46,1360341198914,1360341198914,762582110,762582110,0
1360341226,762609244,2,92,46,1360341224531,1360341224531,762607775,762607775,0
1360341234,762617204,3056,4575710,1497.287304,1360341219965,1360341231869,762603169,762615073,11904
1360341249,762632208,19,18851,992.1578947,1360341224569,1360341242041,762607777,762625249,17472
1360341249,762633180,409,605625,1480.745721,1360341230892,1360341241004,762615072,762625184,10112
1360341249,762633180,5,456,91.2,1360341243946,1360341244010,762628126,762628190,64
1360341273,762656244,8,934,116.75,1360341245010,1360341245138,762628254,762628382,128
1360341282,762665272,2,157,78.5,1360341275256,1360341275256,762658528,762658528,0
1360341298,762681256,5,456,91.2,1360341290311,1360341290375,762673567,762673631,64
1360341341,762724384,1,521,521,1360341315399,1360341315399,762698783,762698783,0
1360341437,762820412,1,46,46,1360341411112,1360341411112,762794524,762794524,0
1360341466,762849368,5,456,91.2,1360341459669,1360341459797,762843037,762843165,128
1360341474,762857336,5,1490,298,1360341461045,1360341466101,762844381,762849437,5056
1360341474,762857336,9,3073,341.4444444,1360341461045,1360341466101,762844381,762849437,5056
1360341474,762857352,2,131,65.5,1360341470564,1360341470564,762853916,762853916,0
1360341489,762872416,1,60,60,1360341461027,1360341461027,762844443,762844443,0
1360341725,763109132,1,46,46,1360341700563,1360341700563,763084695,763084695,0
1360341818,763201732,5,456,91.2,1360341812580,1360341812644,763196312,763196376,64
1360342010,763393840,5,456,91.2,1360342005810,1360342005938,763389650,763389778,128
1360342337,3697000528,2,116,58,1360342312437,1360342315509,3696975965,3696979037,3072
1360342349,3697012452,1,60,60,1360342321603,1360342321603,3696985055,3696985055,0
1360342427,763810852,2,120,60,1360342399330,1360342402338,763783182,763786190,3008
1360343445,764829120,1,46,46,1360343417798,1360343417798,764801918,764801918,0
1360343460,764843176,4,591,147.75,1360343454324,1360343454516,764837500,764837692,192
1360343460,764843180,64,84409,1318.890625,1360343454384,1360343454960,764837564,764838140,576
1360343460,764843220,4,216,54,1360343453066,1360343454922,764836286,764838142,1856
1360343467,764851108,10,3842,384.2,1360343462929,1360343463313,764847037,764847421,384
1360343475,3698138176,1,76,76,1360343449246,1360343449246,3698112422,3698112422,0
1360343475,764859096,4,216,54,1360343453597,1360343468061,764837693,764852157,14464
1360343478,764861336,10,2502,250.2,1360343452822,1360343454742,764836158,764838078,1920
1360343482,764865312,52,44182,849.6538462,1360343454252,1360343458476,764837564,764841788,4224
1360343482,764865348,10,5694,569.4,1360343455499,1360343468427,764838847,764851775,12928
1360343482,764865480,18,12231,679.5,1360343457543,1360343467079,764841023,764850559,9536
1360343486,764869340,12,5495,457.9166667,1360343458707,1360343460947,764842047,764844287,2240
1360343486,764869376,9,4632,514.6666667,1360343461614,1360343462382,764844990,764845758,768
1360343494,764877316,11,4013,364.8181818,1360343466283,1360343467115,764849599,764850431,832
1360343494,764877440,63,76776,1218.666667,1360343468909,1360343471917,764852349,764855357,3008
1360343515,764899132,11,6348,577.0909091,1360343506809,1360343507769,764890941,764891901,960
1360343523,764907088,2,131,65.5,1360343517797,1360343517797,764901885,764901885,0
1360343523,764907124,11,5745,522.2727273,1360343508288,1360343518784,764892412,764902908,10496
1360343534,764917348,9,3682,409.1111111,1360343506376,1360343508936,764889724,764892284,2560
1360343534,764917460,7,5754,822,1360343508376,1360343508440,764891836,764891900,64
1360343590,764973476,11,5918,538,1360343561991,1360343562439,764945467,764945915,448
1360343590,764973560,1,46,46,1360343561844,1360343561844,764945404,764945404,0
1360343628,765011176,2,131,65.5,1360343622834,1360343622834,765006010,765006010,0
1360343676,765059196,4,216,54,1360343674207,1360343674847,765057403,765058043,640
1360343676,765059244,3,164,54.66666667,1360343651312,1360343674416,765034556,765057660,23104
1360343694,765077936,1,52,52,1360343669052,1360343669052,765052988,765052988,0
1360343694,765078004,9,2326,258.4444444,1360343668277,1360343669749,765052281,765053753,1472
1360343698,765082000,3,164,54.66666667,1360343673594,1360343674042,765057594,765058042,448
1360343726,765109984,1,52,52,1360343700298,1360343700298,765084282,765084282,0
1360343730,765113800,1,52,52,1360343701952,1360343701952,765085752,765085752,0
1360343734,765117948,1,52,52,1360343707823,1360343707823,765091771,765091771,0
1360343734,765117948,1,46,46,1360343706476,1360343706476,765090424,765090424,0
1360343734,765118032,1,52,52,1360343706523,1360343706523,765090555,765090555,0
1360343738,765121920,1,52,52,1360343711434,1360343711434,765095354,765095354,0
1360343775,765158356,1,46,46,1360343748924,1360343748924,765132280,765132280,0
1360343803,765186304,2,112,56,1360343775730,1360343775922,765159034,765159226,192
1360343803,765186376,1,52,52,1360343775849,1360343775849,765159225,765159225,0
1360343835,765218480,1,46,46,1360343809665,1360343809665,765193145,765193145,0
1360344127,765511000,1,46,46,1360344099506,1360344099506,765483506,765483506,0
1360344215,765599104,7,3004,429.1428571,1360344189196,1360344189516,765573300,765573620,320
1360344437,765820256,4,184,46,1360344430360,1360344432088,765813616,765815344,1728
1360344525,765908236,4,216,54,1360344521131,1360344521771,765904367,765905007,640
1360344536,765919776,1,46,46,1360344508046,1360344508046,765891822,765891822,0
1360344544,765927908,9,2326,258.4444444,1360344519111,1360344519687,765903019,765903595,576
1360344544,765927908,1,52,52,1360344519496,1360344519496,765903404,765903404,0
1360344548,765931796,3,164,54.66666667,1360344520699,1360344521211,765904495,765905007,512
1360344548,765931796,1,52,52,1360344520762,1360344520762,765904558,765904558,0
1360344613,765996468,12,3169,264.0833333,1360344607871,1360344608575,765991339,765992043,704
1360344613,765996548,12,3367,280.5833333,1360344607790,1360344608942,765991338,765992490,1152
1360344631,766014352,1,125,125,1360344601781,1360344601781,765985133,765985133,0
1360344631,766014820,1,125,125,1360344602975,1360344602975,765986795,765986795,0
1360344757,766140636,2,112,56,1360344732439,1360344732631,766116075,766116267,192
1360345434,766817508,1,46,46,1360345406989,1360345406989,766790497,766790497,0
1360345446,766829624,2,129,64.5,1360345419737,1360345419737,766803361,766803361,0
1360345602,766985824,1,148,148,1360345576141,1360345576141,766959965,766959965,0
1360346208,767591580,8,1488,186,1360346181945,1360346207225,767565525,767590805,25280
1360346244,767627280,3,558,186,1360346217509,1360346237541,767600789,767620821,20032
1360346287,767671008,4,216,54,1360346282699,1360346283659,767666707,767667667,960
1360346308,767691524,10,2502,250.2,1360346283056,1360346284272,767666580,767667796,1216
1360346308,767691528,3,164,54.66666667,1360346283691,1360346284139,767667219,767667667,448
1360346308,767691528,1,52,52,1360346283434,1360346283434,767666962,767666962,0
1360346312,767695576,11,4615,419.5454545,1360346284537,1360346286585,767668113,767670161,2048
1360346408,767791328,4,216,54,1360346405107,1360346406067,767788435,767789395,960
1360346432,767815624,9,2326,258.4444444,1360346404680,1360346405512,767788304,767789136,832
1360346432,767815656,3,164,54.66666667,1360346405287,1360346405735,767788943,767789391,448
1360346432,767815744,1,52,52,1360346404943,1360346404943,767788687,767788687,0
1360346432,767815744,1,52,52,1360346405200,1360346405200,767788944,767788944,0
1360346553,767936180,1,52,52,1360346526978,1360346526978,767910158,767910158,0
1360346637,768020260,2,112,56,1360346609200,1360346609392,767992460,767992652,192
1360346637,768020264,1,52,52,1360346609389,1360346609389,767992653,767992653,0
1360346905,768288180,4,216,54,1360346898495,1360346899071,768281675,768282251,576
1360346921,768305100,9,2326,258.4444444,1360346896103,1360346897063,768280203,768281163,960
1360346925,768308976,1,52,52,1360346896995,1360346896995,768280971,768280971,0
1360346925,768309064,3,164,54.66666667,1360346897739,1360346898251,768281803,768282315,512
1360346925,768309064,1,52,52,1360346897865,1360346897865,768281929,768281929,0
1360347089,768472240,2,104,52,1360347079358,1360347081022,768462598,768464262,1664
1360347106,768489468,2,112,56,1360347078876,1360347079132,768462344,768462600,256
1360347122,768505644,1,46,46,1360347095144,1360347095144,768478788,768478788,0
1360347450,768834060,8,1504,188,1360347422595,1360347447939,768806655,768831999,25344
1360347575,768958228,1,48,48,1360347548482,1360347548482,768931710,768931710,0
1360350039,771423004,1,46,46,1360350012311,1360350012311,771396315,771396315,0
1360350416,771799884,1,46,46,1360350391049,1360350391049,771774933,771774933,0
1360351046,772429412,1,46,46,1360351021398,1360351021398,772404810,772404810,0
1360351371,772754660,2,96,48,1360351343321,1360351346201,772726981,772729861,2880
1360351519,772902988,2,96,48,1360351493902,1360351496846,772877890,772880834,2944
1360351990,773373732,1,46,46,1360351962441,1360351962441,773346173,773346173,0
1360352073,773456600,1,46,46,1360352046731,1360352046731,773430331,773430331,0
1360353016,3707679596,1,52,52,1360352988921,1360352988921,3707652517,3707652517,0
1360353781,775164140,1,443,443,1360353753979,1360353753979,775137119,775137119,0
1360356345,777728284,1,48,48,1360356316167,1360356316167,777699451,777699451,0
1360356571,777954324,1,48,48,1360356543900,1360356543900,777927224,777927224,0
1360357148,778531964,2,96,48,1360357121362,1360357124306,778505326,778508270,2944
1360364959,786342728,1,46,46,1360364929288,1360364929288,786313016,786313016,0
1360366383,787766660,1,46,46,1360366355957,1360366355957,787739617,787739617,0
1360372101,793484116,4,202,50.5,1360372076864,1360372086144,793459980,793469260,9280
1360373852,795236028,1,46,46,1360373824021,1360373824021,795208049,795208049,0
1360374272,795655540,1,46,46,1360374241974,1360374241974,795625514,795625514,0
1360375127,796510704,1,440,440,1360375099335,1360375099335,796483039,796483039,0
1360378163,799546388,1,92,92,1360378138516,1360378138516,799521904,799521904,0
1360378195,799578612,1,46,46,1360378164533,1360378164533,799548145,799548145,0
1360378263,799646664,1,148,148,1360378235840,1360378235840,799619504,799619504,0
1360378646,800029336,1,46,46,1360378619456,1360378619456,800002792,800002792,0
1360381967,803350932,1,46,46,1360381940348,1360381940348,803324280,803324280,0
1360384144,805527524,1,46,46,1360384118706,1360384118706,805502230,805502230,0
1360385239,806622224,1,46,46,1360385211916,1360385211916,806595140,806595140,0
1360387419,808802896,1,46,46,1360387393420,1360387393420,808777316,808777316,0
1360387443,808826960,1,46,46,1360387416713,1360387416713,808800673,808800673,0
1360391953,813336964,1,46,46,1360391925186,1360391925186,813309150,813309150,0
1360392890,814273244,1,1022,1022,1360392863109,1360392863109,814246353,814246353,0
1360393988,815371328,1,60,60,1360393963361,1360393963361,815346689,815346689,0
1360395248,816631972,1,46,46,1360395220619,1360395220619,816604591,816604591,0
1360395659,817042496,1,445,445,1360395631008,1360395631008,817014504,817014504,0
1360395809,3750471904,1,46,46,1360395784139,1360395784139,3750447043,3750447043,0
1360399102,820485100,1,148,148,1360399075892,1360399075892,820458992,820458992,0
1360399919,821302200,1,60,60,1360399894341,1360399894341,821277541,821277541,0
1360400306,821689788,1,48,48,1360400276470,1360400276470,821660258,821660258,0
1360404458,825841140,1,444,444,1360404433722,1360404433722,825816862,825816862,0
1360404514,825897268,1,60,60,1360404486522,1360404486522,825869790,825869790,0
1360404724,826107544,1,48,48,1360404695268,1360404695268,826078812,826078812,0
1360405495,826878788,2,96,48,1360405467685,1360405470629,826851473,826854417,2944
1360407668,829051596,1,46,46,1360407641797,1360407641797,829025393,829025393,0
1360409714,831097004,1,48,48,1360409687285,1360409687285,831070289,831070289,0
1360411614,832997728,1,48,48,1360411587714,1360411587714,832971442,832971442,0
1360415713,837096348,1,46,46,1360415688898,1360415688898,837072246,837072246,0
1360416221,837604044,1,46,46,1360416191595,1360416191595,837574639,837574639,0
1360417745,839128056,1,48,48,1360417716234,1360417716234,839099290,839099290,0
1360418043,839426944,1,48,48,1360418015114,1360418015114,839399058,839399058,0
1360418096,839479008,1,46,46,1360418069491,1360418069491,839452499,839452499,0
1360418156,839539788,1,46,46,1360418126885,1360418126885,839510673,839510673,0
1360418224,839607224,1,46,46,1360418195928,1360418195928,839579152,839579152,0
1360418655,840038388,1,48,48,1360418627247,1360418627247,840010635,840010635,0
1360418796,840179508,1,46,46,1360418767670,1360418767670,840151178,840151178,0
1360418827,840210272,1,46,46,1360418802591,1360418802591,840185863,840185863,0
1360419696,841079284,2,122,61,1360419670150,1360419672198,841053434,841055482,2048
1360419708,841091340,1,46,46,1360419679949,1360419679949,841063289,841063289,0
1360421452,842835400,1,46,46,1360421426361,1360421426361,842809761,842809761,0
1360421596,842979536,1,435,435,1360421571312,1360421571312,842954848,842954848,0
1360421873,843256376,1,127,127,1360421846730,1360421846730,843230106,843230106,0
1360424430,845813304,1,148,148,1360424400364,1360424400364,845783668,845783668,0
1360425149,846532024,1,46,46,1360425122106,1360425122106,846505130,846505130,0
1360426512,847895880,1,46,46,1360426484429,1360426484429,847868309,847868309,0
1360427803,849186520,2,106,53,1360427783457,1360427799457,849166977,849182977,16000
1360427865,849248584,1,60,60,1360427837217,1360427837217,849220801,849220801,0
1360427869,849252504,1,60,60,1360427841201,1360427841201,849224705,849224705,0
1360429741,851124584,1,46,46,1360429713346,1360429713346,851096930,851096930,0
1360432137,853520684,1,46,46,1360432110586,1360432110586,853494270,853494270,0
1360432476,853859796,2,120,60,1360432447944,1360432450952,853831740,853834748,3008
1360433306,854689192,1,60,60,1360433280724,1360433280724,854663916,854663916,0
1360434750,856133008,2,122,61,1360434723192,1360434725496,856106200,856108504,2304
1360434787,856170788,1,46,46,1360434760939,1360434760939,856144727,856144727,0
1360436155,857538012,1,46,46,1360436127198,1360436127198,857510210,857510210,0
1360436641,858024800,1,46,46,1360436614851,1360436614851,857998651,857998651,0
1360437557,858940020,1,46,46,1360437529535,1360437529535,858912555,858912555,0
1360437588,858971080,1,46,46,1360437560389,1360437560389,858943469,858943469,0
1360438513,859896332,2,120,60,1360438485947,1360438488891,859869279,859872223,2944
1360439133,860516668,1,46,46,1360439104610,1360439104610,860488278,860488278,0
1360439302,860685792,1,46,46,1360439274017,1360439274017,860657809,860657809,0
1360439824,861207260,3,144,48,1360439796847,1360439805871,861180107,861189131,9024
1360439824,861207428,2,96,48,1360439796677,1360439799685,861180105,861183113,3008
1360440349,861732736,1,48,48,1360440322697,1360440322697,861706433,861706433,0
1360441764,863147264,1,46,46,1360441736462,1360441736462,863119726,863119726,0
1360443059,864442668,1,46,46,1360443030500,1360443030500,864414168,864414168,0
1360445334,866717236,1,46,46,1360445305845,1360445305845,866689081,866689081,0
1360446134,867517664,1,46,46,1360446104892,1360446104892,867488556,867488556,0
1360447719,869102260,1,46,46,1360447691512,1360447691512,869074772,869074772,0
1360447769,869152580,1,46,46,1360447741432,1360447741432,869125012,869125012,0
1360450930,872313024,1,46,46,1360450905588,1360450905588,872288612,872288612,0
1360451324,872707724,1,46,46,1360451294834,1360451294834,872678558,872678558,0
1360451744,873127480,1,46,46,1360451718366,1360451718366,873101846,873101846,0
1360452253,873636076,3,144,48,1360452227181,1360452236077,873610257,873619153,8896
1360452410,873793504,1,52,52,1360452384380,1360452384380,873767884,873767884,0
1360452471,873854740,1,52,52,1360452444625,1360452444625,873828365,873828365,0
1360453151,874533832,1,46,46,1360453122835,1360453122835,874505667,874505667,0
1360453609,874992264,1,46,46,1360453583835,1360453583835,874967099,874967099,0
1360453756,875139772,1,46,46,1360453727004,1360453727004,875110776,875110776,0
1360454885,3809548056,1,52,52,1360454857275,1360454857275,3809520331,3809520331,0
1360455769,877152048,1,48,48,1360455738642,1360455738642,877121690,877121690,0
1360456336,877719576,1,46,46,1360456310587,1360456310587,877694163,877694163,0
1360458287,879669932,1,48,48,1360458258849,1360458258849,879641781,879641781,0
1360459593,880976360,1,46,46,1360459564003,1360459564003,880947363,880947363,0
1360459680,881062844,1,46,46,1360459654819,1360459654819,881037663,881037663,0
1360460146,881529784,1,46,46,1360460118897,1360460118897,881502681,881502681,0
1360464333,885716192,1,46,46,1360464304387,1360464304387,885687579,885687579,0
1360465000,886383308,1,46,46,1360464973059,1360464973059,886356367,886356367,0
1360465328,886710932,1,46,46,1360465299129,1360465299129,886682061,886682061,0
1360465581,886964320,1,78,78,1360465554994,1360465554994,886938314,886938314,0
1360466735,888118008,1,48,48,1360466710040,1360466710040,888093048,888093048,0
1360467128,888511412,1,46,46,1360467101437,1360467101437,888484849,888484849,0
1360467154,888536916,1,46,46,1360467125099,1360467125099,888508015,888508015,0
1360467848,889231432,1,46,46,1360467821470,1360467821470,889204902,889204902,0
1360468390,889773652,1,449,449,1360468362170,1360468362170,889745822,889745822,0
1360470023,891406024,1,441,441,1360469997206,1360469997206,891380230,891380230,0
1360471748,893131496,1,46,46,1360471722083,1360471722083,893105579,893105579,0
1360471888,893271144,1,46,46,1360471860035,1360471860035,893243179,893243179,0
1360472011,893393844,1,443,443,1360471983082,1360471983082,893365926,893365926,0
1360474160,895543504,1,46,46,1360474132217,1360474132217,895515721,895515721,0
1360474275,895658032,1,60,60,1360474247823,1360474247823,895630855,895630855,0
1360475118,896501352,1,46,46,1360475089218,1360475089218,896472570,896472570,0
1360475170,896553404,1,46,46,1360475141835,1360475141835,896525239,896525239,0
1360476101,897483756,1,46,46,1360476075656,1360476075656,897458412,897458412,0
1360476855,898238332,1,46,46,1360476827644,1360476827644,898210976,898210976,0
1360477418,898802252,1,46,46,1360477390042,1360477390042,898774294,898774294,0
1360478567,899950620,3,156,52,1360478541699,1360478550659,899925319,899934279,8960
1360479480,900863280,1,46,46,1360479450504,1360479450504,900833784,900833784,0
1360481174,902557668,1,46,46,1360481148586,1360481148586,902532254,902532254,0
1360482628,904011592,1,446,446,1360482602274,1360482602274,903985866,903985866,0
1360482871,904254336,1,46,46,1360482843615,1360482843615,904226951,904226951,0
1360483093,904476236,1,60,60,1360483065598,1360483065598,904448834,904448834,0
1360483327,904710380,1,46,46,1360483300588,1360483300588,904683968,904683968,0
1360484349,905732416,1,46,46,1360484320952,1360484320952,905704368,905704368,0
1360486121,907504572,1,60,60,1360486094079,1360486094079,907477651,907477651,0
1360486149,907532572,1,60,60,1360486123329,1360486123329,907506901,907506901,0
1360487050,908433320,1,48,48,1360487020204,1360487020204,908403524,908403524,0
1360490903,912286100,1,48,48,1360490876624,1360490876624,912259724,912259724,0
1360492146,3846809328,1,52,52,1360492121249,1360492121249,3846784577,3846784577,0
1360493169,914552292,1,447,447,1360493144239,1360493144239,914527531,914527531,0
1360494420,915802848,1,60,60,1360494394904,1360494394904,915777752,915777752,0
1360495606,916989148,2,106,53,1360495581465,1360495601241,916964613,916984389,19776
1360496123,917506132,1,46,46,1360496096994,1360496096994,917480126,917480126,0
1360497852,919235024,4,202,50.5,1360497825907,1360497848371,919208931,919231395,22464
1360497900,919283016,1,48,48,1360497872893,1360497872893,919255909,919255909,0
1360497928,919311064,1,48,48,1360497902089,1360497902089,919285153,919285153,0
1360498497,919880228,2,92,46,1360498469917,1360498473565,919853145,919856793,3648
1360500501,921884536,2,122,61,1360500473549,1360500475981,921857085,921859517,2432
1360503582,924965152,1,60,60,1360503557279,1360503557279,924940431,924940431,0
1360504059,925442472,2,104,52,1360504032023,1360504035031,925415495,925418503,3008
1360505575,926957900,1,60,60,1360505549499,1360505549499,926932399,926932399,0
1360506161,927544128,1,46,46,1360506134413,1360506134413,927517541,927517541,0
1360506649,928032576,2,96,48,1360506625671,1360506628679,928009247,928012255,3008
1360508465,929848212,1,48,48,1360508440534,1360508440534,929823746,929823746,0
1360509182,930564732,1,61,61,1360509156780,1360509156780,930539512,930539512,0
1360509290,930673172,1,74,74,1360509263281,1360509263281,930646453,930646453,0
1360509694,931077604,1,46,46,1360509667711,1360509667711,931051315,931051315,0
1360509828,3864490376,1,52,52,1360509801421,1360509801421,3864463797,3864463797,0
1360509995,931378592,2,120,60,1360509970306,1360509973314,931353898,931356906,3008
1360511675,933058548,1,46,46,1360511647320,1360511647320,933030868,933030868,0
1360512176,933559320,1,46,46,1360512150645,1360512150645,933533965,933533965,0
1360512618,934001176,1,46,46,1360512590782,1360512590782,933973958,933973958,0
1360517129,938512204,1,46,46,1360517101082,1360517101082,938484286,938484286,0
1360517693,939076084,1,46,46,1360517665356,1360517665356,939048440,939048440,0
1360518404,939787148,1,446,446,1360518377345,1360518377345,939760493,939760493,0
1360519206,940588840,2,120,60,1360519178728,1360519181736,940561568,940564576,3008
1360521012,942395340,1,48,48,1360520985433,1360520985433,942368773,942368773,0
1360521042,942425520,2,96,48,1360521013858,1360521016802,942397378,942400322,2944
1360521558,942940840,1,46,46,1360521531011,1360521531011,942913851,942913851,0
1360523818,945201584,1,48,48,1360523788986,1360523788986,945172570,945172570,0
1360523833,945215840,1,46,46,1360523805282,1360523805282,945188122,945188122,0
1360524042,945424640,1,46,46,1360524015526,1360524015526,945398166,945398166,0
1360524242,945625104,5,250,50,1360524216788,1360524237780,945599892,945620884,20992
1360525850,947233348,2,96,48,1360525822152,1360525825224,947205500,947208572,3072
1360526243,947626104,5,250,50,1360526217527,1360526239351,947600631,947622455,21824
1360526291,947674120,1,48,48,1360526263714,1360526263714,947646834,947646834,0
1360526319,947702296,1,48,48,1360526292789,1360526292789,947676085,947676085,0
1360526800,948183288,1,60,60,1360526771954,1360526771954,948155242,948155242,0
1360526824,948207404,2,96,48,1360526798783,1360526801855,948182187,948185259,3072
1360527029,948411596,1,46,46,1360527002532,1360527002532,948385128,948385128,0
1360529011,950393672,1,46,46,1360528983418,1360528983418,950366090,950366090,0
1360529915,951298400,1,46,46,1360529889108,1360529889108,951272508,951272508,0
1360530653,952035976,1,46,46,1360530626994,1360530626994,952009970,952009970,0
1360530874,952257300,1,46,46,1360530846059,1360530846059,952229359,952229359,0
1360531041,952424276,1,46,46,1360531014591,1360531014591,952397867,952397867,0
1360531387,952770388,1,46,46,1360531361416,1360531361416,952744804,952744804,0
1360531415,952797640,1,46,46,1360531387317,1360531387317,952769957,952769957,0
1360532817,954200128,1,46,46,1360532790714,1360532790714,954173842,954173842,0
1360535213,956596260,1,48,48,1360535185745,1360535185745,956569005,956569005,0
1360535537,956919912,1,52,52,1360535509990,1360535509990,956892902,956892902,0
1360535594,956976712,1,52,52,1360535566828,1360535566828,956949540,956949540,0
1360535872,957255144,1,46,46,1360535843131,1360535843131,957226275,957226275,0
1360539229,960612188,1,46,46,1360539203992,1360539203992,960587180,960587180,0
1360540560,961942552,1,46,46,1360540530946,1360540530946,961913498,961913498,0
1360541344,962726856,1,46,46,1360541318343,1360541318343,962701199,962701199,0
1360541531,962914280,1,46,46,1360541505372,1360541505372,962888652,962888652,0
1360541704,963087380,1,48,48,1360541676275,1360541676275,963059655,963059655,0
1360545206,966589024,1,48,48,1360545178274,1360545178274,966561298,966561298,0
1360545982,967365008,2,96,48,1360545957480,1360545960360,967340488,967343368,2880
1360547718,969100732,1,46,46,1360547691745,1360547691745,969074477,969074477,0
1360548759,970142420,2,122,61,1360548733472,1360548735456,970116892,970118876,1984
1360549106,970489104,1,46,46,1360549080279,1360549080279,970463383,970463383,0
1360549233,970615776,2,112,56,1360549206366,1360549206366,970589142,970589142,0
1360550560,971943068,2,96,48,1360550532198,1360550535206,971915266,971918274,3008
1360552128,973510544,2,96,48,1360552101721,1360552104601,973484265,973487145,2880
1360552288,973670860,1,60,60,1360552262874,1360552262874,973645734,973645734,0
1360552997,974380452,1,78,78,1360552971199,1360552971199,974354651,974354651,0
1360554423,975806388,1,46,46,1360554396332,1360554396332,975779720,975779720,0
1360554504,975886692,1,46,46,1360554474849,1360554474849,975857541,975857541,0
1360554630,976013012,1,46,46,1360554604576,1360554604576,975987588,975987588,0
1360557673,979056000,1,46,46,1360557646719,1360557646719,979029719,979029719,0
1360559096,980478584,1,442,442,1360559069641,1360559069641,980452225,980452225,0
1360560272,981655224,1,46,46,1360560244984,1360560244984,981628208,981628208,0
1360560771,982153660,1,52,52,1360560744547,1360560744547,982127207,982127207,0
1360561219,982602280,2,96,48,1360561193202,1360561196146,982576482,982579426,2944
1360562335,983717688,2,96,48,1360562308144,1360562311024,983690832,983693712,2880
1360562380,983763160,1,46,46,1360562354519,1360562354519,983737679,983737679,0
1360564200,985582700,1,46,46,1360564172361,1360564172361,985555061,985555061,0
1360568275,989657744,2,122,61,1360568247391,1360568249823,989630135,989632567,2432
1360569902,991285116,1,46,46,1360569875859,1360569875859,991258975,991258975,0
1360571283,992666364,1,46,46,1360571256836,1360571256836,992640200,992640200,0
1360571534,992917024,5,250,50,1360571508117,1360571530133,992891141,992913157,22016
1360571582,992965044,1,48,48,1360571554691,1360571554691,992937735,992937735,0
1360571610,992993108,1,48,48,1360571584130,1360571584130,992967238,992967238,0
1360573097,994479644,1,60,60,1360573069818,1360573069818,994452462,994452462,0
1360574014,995397440,1,46,46,1360573987283,1360573987283,995370723,995370723,0
1360574818,996200624,1,48,48,1360574790388,1360574790388,996173012,996173012,0
1360575128,996510516,1,46,46,1360575099227,1360575099227,996481743,996481743,0
1360576342,997725364,1,46,46,1360576315896,1360576315896,997699260,997699260,0
1360578746,1000128892,1,48,48,1360578716589,1360578716589,1000099481,1000099481,0
1360580179,1001561628,1,46,46,1360580151842,1360580151842,1001534470,1001534470,0
1360580179,1001561672,1,46,46,1360580152115,1360580152115,1001534787,1001534787,0
1360580588,1001970892,1,46,46,1360580560337,1360580560337,1001943229,1001943229,0
1360581494,1002877012,1,148,148,1360581468939,1360581468939,1002851951,1002851951,0
1360584654,1006036416,1,46,46,1360584628403,1360584628403,1006010819,1006010819,0
1360585656,1007038840,1,46,46,1360585630906,1360585630906,1007013746,1007013746,0
1360586593,1007975976,1,60,60,1360586567715,1360586567715,1007950691,1007950691,0
1360586928,1008310852,1,46,46,1360586901339,1360586901339,1008284191,1008284191,0
1360588295,1009677668,1,46,46,1360588265918,1360588265918,1009648586,1009648586,0
1360589074,1010457068,1,148,148,1360589048868,1360589048868,1010431936,1010431936,0
1360589134,1010517264,2,122,61,1360589109468,1360589109532,1010492732,1010492796,64
1360589535,1010918172,1,46,46,1360589509874,1360589509874,1010893046,1010893046,0
1360591453,1012836088,1,46,46,1360591427949,1360591427949,1012811037,1012811037,0
1360591474,1012857272,1,46,46,1360591445361,1360591445361,1012828633,1012828633,0
1360591512,1012895376,1,48,48,1360591484620,1360591484620,1012867996,1012867996,0
1360591702,1013084708,1,46,46,1360591676961,1360591676961,1013059669,1013059669,0
1360591798,1013180432,1,60,60,1360591771447,1360591771447,1013153879,1013153879,0
1360593141,1014523424,1,60,60,1360593113388,1360593113388,1014495812,1014495812,0
1360594178,1015561100,1,60,60,1360594149942,1360594149942,1015533042,1015533042,0
1360595136,1016518964,2,122,61,1360595110255,1360595112751,1016493219,1016495715,2496
1360595501,1016883432,1,445,445,1360595475647,1360595475647,1016858079,1016858079,0
1360595826,1017208404,2,122,61,1360595798613,1360595800597,1017181017,1017183001,1984
1360596476,1017859096,1,48,48,1360596449239,1360596449239,1017832335,1017832335,0
1360596708,1018090684,1,71,71,1360596680175,1360596680175,1018062859,1018062859,0
1360597862,1019244608,1,46,46,1360597834091,1360597834091,1019216699,1019216699,0
1360598347,1019729584,1,46,46,1360598319995,1360598319995,1019702579,1019702579,0
1360600513,1021895684,1,48,48,1360600502773,1360600502773,1021885457,1021885457,0
1360603412,1024794808,3,144,48,1360603384079,1360603393039,1024766887,1024775847,8960
1360603488,1024870800,3,144,48,1360603461781,1360603470741,1024844581,1024853541,8960
1360603890,1025272472,1,46,46,1360603861720,1360603861720,1025244192,1025244192,0
1360604462,1025844740,1,46,46,1360604435329,1360604435329,1025818069,1025818069,0
1360604790,1026172980,1,46,46,1360604765388,1360604765388,1026148368,1026148368,0
1360605632,1027015232,1,46,46,1360605607300,1360605607300,1026990532,1026990532,0
1360606411,1027793340,1,46,46,1360606382964,1360606382964,1027765304,1027765304,0
1360610448,1031830764,5,250,50,1360610419792,1360610442384,1031802556,1031825148,22592
1360610492,1031875220,1,48,48,1360610466505,1360610466505,1031849725,1031849725,0
1360610524,1031907048,1,48,48,1360610496178,1360610496178,1031879226,1031879226,0
1360610887,1032270228,1,46,46,1360610859577,1360610859577,1032242805,1032242805,0
1360613507,1034889924,1,46,46,1360613482433,1360613482433,1034865357,1034865357,0
1360616208,1037590640,1,46,46,1360616179571,1360616179571,1037562211,1037562211,0
1360616449,1037831980,1,48,48,1360616435483,1360616435483,1037818463,1037818463,0
1360616576,1037958328,1,60,60,1360616548006,1360616548006,1037930334,1037930334,0
1360617911,1039293668,1,60,60,1360617883453,1360617883453,1039266121,1039266121,0
1360618047,1039429752,1,60,60,1360618019562,1360618019562,1039402314,1039402314,0
1360621420,1042802556,1,437,437,1360621395833,1360621395833,1042778389,1042778389,0
1360621564,1042946768,1,46,46,1360621554914,1360621554914,1042937682,1042937682,0
1360622194,1043576904,1,438,438,1360622167951,1360622167951,1043550855,1043550855,0
1360622302,1043685140,1,46,46,1360622277281,1360622277281,1043660421,1043660421,0
1360623329,1044711552,1,48,48,1360623304221,1360623304221,1044686773,1044686773,0
1360623383,1044765784,1,46,46,1360623354485,1360623354485,1044737269,1044737269,0
1360623830,1045212588,1,46,46,1360623803570,1360623803570,1045186158,1045186158,0
1360624070,1045453196,1,60,60,1360624042574,1360624042574,1045425770,1045425770,0
1360624347,1045730148,1,48,48,1360624322554,1360624322554,1045705702,1045705702,0
1360625625,1047007852,1,48,48,1360625595215,1360625595215,1046978067,1046978067,0
1360628360,1049742876,1,46,46,1360628335568,1360628335568,1049718444,1049718444,0
1360629026,1050408776,3,138,46,1360628997928,1360629007016,1050380704,1050389792,9088
1360629276,3983939044,1,125,125,1360629248901,1360629248901,3983911945,3983911945,0
1360629430,1050813204,1,46,46,1360629404535,1360629404535,1050787739,1050787739,0
1360629459,1050841332,1,60,60,1360629432287,1360629432287,1050814619,1050814619,0
1360629610,3984272904,1,48,48,1360629583189,1360629583189,3984246093,3984246093,0
1360630032,1051414396,1,46,46,1360630004884,1360630004884,1051387280,1051387280,0
1360630686,1052068276,1,48,48,1360630661251,1360630661251,1052043527,1052043527,0
1360633030,1054412948,1,443,443,1360633003774,1360633003774,1054386722,1054386722,0
1360633088,1054470812,1,46,46,1360633060869,1360633060869,1054443681,1054443681,0
1360634165,1055547408,1,46,46,1360634138443,1360634138443,1055520851,1055520851,0
1360635476,1056858992,1,61,61,1360635448368,1360635448368,1056831360,1056831360,0
1360636330,1057712388,1,60,60,1360636302654,1360636302654,1057685042,1057685042,0
1360636390,1057772644,1,60,60,1360636363389,1360636363389,1057746033,1057746033,0
1360636619,1058001520,1,60,60,1360636590837,1360636590837,1057973357,1057973357,0
1360636663,1058045712,1,60,60,1360636635060,1360636635060,1058017772,1058017772,0
1360638458,1059840776,1,60,60,1360638432986,1360638432986,1059815762,1059815762,0
1360640345,1061727512,1,48,48,1360640333315,1360640333315,1061715827,1061715827,0
1360640415,1061797916,1,58,58,1360640388141,1360640388141,1061771057,1061771057,0
1360640656,1062038536,1,46,46,1360640628648,1360640628648,1062011184,1062011184,0
1360641718,3996380936,1,46,46,1360641690564,1360641690564,3996353500,3996353500,0
1360642045,1063427932,1,48,48,1360642019590,1360642019590,1063402522,1063402522,0
1360643660,1065042692,3,138,46,1360643635488,1360643636448,1065018180,1065019140,960
1360644983,3999645292,1,48,48,1360644956063,1360644956063,3999618355,3999618355,0
1360647889,1069271772,1,56,56,1360647862670,1360647862670,1069245442,1069245442,0
1360648976,1070358404,2,122,61,1360648948975,1360648951151,1070331379,1070333555,2176
1360653035,1074418100,1,48,48,1360653006009,1360653006009,1074389109,1074389109,0
1360653590,1074972532,1,46,46,1360653565544,1360653565544,1074948076,1074948076,0
1360655903,1077285812,1,447,447,1360655875502,1360655875502,1077258314,1077258314,0
1360656098,4010760640,1,52,52,1360656071246,1360656071246,4010733886,4010733886,0
1360656272,1077654672,1,60,60,1360656247602,1360656247602,1077630274,1077630274,0
1360657802,1079185064,1,46,46,1360657772372,1360657772372,1079155436,1079155436,0
1360658272,1079654688,1,60,60,1360658244101,1360658244101,1079626789,1079626789,0
1360658308,1079690628,1,60,60,1360658281089,1360658281089,1079663717,1079663717,0
1360658328,1079710680,1,60,60,1360658302604,1360658302604,1079685284,1079685284,0
1360658588,1079970668,1,48,48,1360658558612,1360658558612,1079941280,1079941280,0
1360661363,1082745380,1,48,48,1360661335948,1360661335948,1082718328,1082718328,0
1360662262,1083644496,1,52,52,1360662235146,1360662235146,1083617642,1083617642,0
1360662283,1083665480,1,46,46,1360662256730,1360662256730,1083639210,1083639210,0
1360662606,1083989136,2,104,52,1360662579012,1360662582020,1083962148,1083965156,3008
1360663293,1084675700,1,46,46,1360663265964,1360663265964,1084648664,1084648664,0
1360665432,1086814180,1,46,46,1360665407508,1360665407508,1086789688,1086789688,0
1360666270,1087652360,1,46,46,1360666242771,1360666242771,1087625131,1087625131,0
1360666466,1087848896,2,120,60,1360666441146,1360666444154,1087824042,1087827050,3008
1360666623,1088005268,5,1746,349.2,1360666595243,1360666617259,1087977511,1087999527,22016
1360666667,1088049252,1,422,422,1360666641403,1360666641403,1088023655,1088023655,0
1360666695,1088077376,1,48,48,1360666670719,1360666670719,1088053095,1088053095,0
1360666805,1088188132,1,46,46,1360666777034,1360666777034,1088160166,1088160166,0
1360667087,1088470008,1,46,46,1360667060607,1360667060607,1088443615,1088443615,0
1360667871,1089254020,1,48,48,1360667843434,1360667843434,1089226454,1089226454,0
1360668354,1089736968,1,46,46,1360668327062,1360668327062,1089710030,1089710030,0
1360671700,1093082564,1,46,46,1360671673208,1360671673208,1093055772,1093055772,0
1360671784,1093166784,1,48,48,1360671756188,1360671756188,1093138972,1093138972,0
1360672366,1093748808,1,60,60,1360672337655,1360672337655,1093720463,1093720463,0
1360672739,1094121480,1,46,46,1360672714362,1360672714362,1094096842,1094096842,0
1360673357,1094739380,1,46,46,1360673330326,1360673330326,1094712706,1094712706,0
1360674713,1096095120,1,48,48,1360674688004,1360674688004,1096070124,1096070124,0
1360675004,1096387088,1,48,48,1360674978681,1360674978681,1096361769,1096361769,0
1360676323,1097706020,1,60,60,1360676296105,1360676296105,1097679125,1097679125,0
1360679628,4034290356,1,46,46,1360679602052,1360679602052,4034264408,4034264408,0
1360680530,1101912760,2,122,61,1360680502446,1360680504558,1101885206,1101887318,2112
1360681907,1103289704,1,46,46,1360681879442,1360681879442,1103262146,1103262146,0
1360682639,1104022088,1,46,46,1360682611400,1360682611400,1103994488,1103994488,0
1360683815,1105197772,1,48,48,1360683786546,1360683786546,1105169318,1105169318,0
1360684122,1105504948,1,78,78,1360684096252,1360684096252,1105479200,1105479200,0
1360684243,1105625092,1,46,46,1360684216209,1360684216209,1105598301,1105598301,0
1360684953,1106336040,1,46,46,1360684925972,1360684925972,1106309012,1106309012,0
1360685028,1106410692,1,52,52,1360685001453,1360685001453,1106384145,1106384145,0
1360687922,1109304996,1,60,60,1360687897360,1360687897360,1109280356,1109280356,0
1360689041,1110423628,1,48,48,1360689014194,1360689014194,1110396822,1110396822,0
1360689646,1111028920,1,46,46,1360689620354,1360689620354,1111003274,1111003274,0
1360692417,1113799952,1,46,46,1360692388858,1360692388858,1113771810,1113771810,0
1360696219,1117601752,1,60,60,1360696192517,1360696192517,1117575269,1117575269,0
1360697795,1119177676,1,46,46,1360697766843,1360697766843,1119149519,1119149519,0
1360699055,1120437288,2,96,48,1360699028331,1360699031275,1120410619,1120413563,2944
1360700887,1122269760,1,148,148,1360700862647,1360700862647,1122245407,1122245407,0
1360700919,1122301552,1,148,148,1360700892873,1360700892873,1122275425,1122275425,0
1360703025,1124407456,1,46,46,1360702995717,1360702995717,1124378173,1124378173,0
1360703629,1125011628,1,48,48,1360703601874,1360703601874,1124984502,1124984502,0
1360704601,1125983180,1,46,46,1360704576514,1360704576514,1125958694,1125958694,0
1360704922,1126304156,1,60,60,1360704897365,1360704897365,1126279521,1126279521,0
1360705547,1126929752,1,60,60,1360705518907,1360705518907,1126901659,1126901659,0
1360707207,1128589276,2,128,64,1360707179132,1360707182140,1128561408,1128564416,3008
1360707785,1129167344,1,60,60,1360707760369,1360707760369,1129142713,1129142713,0
1360707929,1129311728,1,60,60,1360707901996,1360707901996,1129284724,1129284724,0
1360708001,1129383852,1,60,60,1360707974577,1360707974577,1129357429,1129357429,0
1360708005,1129387904,1,60,60,1360707978747,1360707978747,1129361651,1129361651,0
1360708827,1130209436,1,60,60,1360708801859,1360708801859,1130184295,1130184295,0
1360709415,1130797708,1,48,48,1360709384938,1360709384938,1130767646,1130767646,0
1360711149,1132531736,1,46,46,1360711120053,1360711120053,1132502789,1132502789,0
1360711152,1132534276,1,46,46,1360711127680,1360711127680,1132509956,1132509956,0
1360714306,1135688404,1,48,48,1360714279248,1360714279248,1135661652,1135661652,0
1360717143,1138525472,1,46,46,1360717114852,1360717114852,1138497324,1138497324,0
1360718189,1139571812,1,46,46,1360718160832,1360718160832,1139543644,1139543644,0
1360719194,1140576764,1,46,46,1360719167649,1360719167649,1140550413,1140550413,0
1360720734,1142116168,1,443,443,1360720707484,1360720707484,1142089652,1142089652,0
1360720958,1142340436,2,122,61,1360720932558,1360720934670,1142314994,1142317106,2112
1360723056,1144438084,1,46,46,1360723028492,1360723028492,1144410576,1144410576,0
1360724876,1146258100,1,60,60,1360724850851,1360724850851,1146232951,1146232951,0
1360725225,1146607216,1,46,46,1360725199848,1360725199848,1146582064,1146582064,0
1360725479,1146861776,1,46,46,1360725450613,1360725450613,1146833389,1146833389,0
1360725647,1147029104,1,46,46,1360725618581,1360725618581,1147000685,1147000685,0
1360725680,1147062188,1,48,48,1360725651901,1360725651901,1147034089,1147034089,0
1360726220,1147601952,2,122,61,1360726193444,1360726193444,1147575396,1147575396,0
1360727832,1149214044,1,92,92,1360727805357,1360727805357,1149187401,1149187401,0
1360728228,1149610628,1,46,46,1360728201569,1360728201569,1149584197,1149584197,0
1360729929,1151311432,1,46,46,1360729904074,1360729904074,1151286506,1151286506,0
1360730429,1151811108,1,46,46,1360730403078,1360730403078,1151785186,1151785186,0
1360730505,1151887204,1,60,60,1360730477222,1360730477222,1151859426,1151859426,0
1360734234,1155616588,5,250,50,1360734208812,1360734231084,1155591400,1155613672,22272
1360734282,1155664732,1,48,48,1360734255390,1360734255390,1155638122,1155638122,0
1360734311,1155692924,1,48,48,1360734285510,1360734285510,1155667434,1155667434,0
1360737490,1158872180,1,46,46,1360737463191,1360737463191,1158845371,1158845371,0
1360738324,1159706660,2,120,60,1360738296167,1360738299175,1159678827,1159681835,3008
1360738734,1160116812,1,46,46,1360738705545,1360738705545,1160088357,1160088357,0
1360739499,1160881592,5,250,50,1360739473051,1360739495259,1160855643,1160877851,22208
1360739547,1160929692,1,48,48,1360739519607,1360739519607,1160902299,1160902299,0
1360739575,1160957908,1,48,48,1360739548894,1360739548894,1160931802,1160931802,0
1360740770,1162152476,3,152,50.66666667,1360740741948,1360740750972,1162124424,1162133448,9024
1360742065,1163447088,1,46,46,1360742036780,1360742036780,1163418868,1163418868,0
1360742352,1163734812,1,46,46,1360742324693,1360742324693,1163707505,1163707505,0
1360744138,1165519980,1,64,64,1360744110587,1360744110587,1165492567,1165492567,0
1360747276,1168658356,1,52,52,1360747251155,1360747251155,1168633511,1168633511,0
1360749380,1170762876,1,48,48,1360749352109,1360749352109,1170734985,1170734985,0
1360749928,1171310380,1,78,78,1360749901332,1360749901332,1171283712,1171283712,0
1360751861,1173243296,1,46,46,1360751834057,1360751834057,1173216353,1173216353,0
1360752816,1174198832,1,48,48,1360752785763,1360752785763,1174168595,1174168595,0
1360752917,1174299804,1,64,64,1360752892542,1360752892542,1174275346,1174275346,0
1360756147,1177529772,1,46,46,1360756119727,1360756119727,1177502499,1177502499,0
1360756216,1177598012,1,48,48,1360756186214,1360756186214,1177568226,1177568226,0
1360758306,1179687928,1,56,56,1360758280344,1360758280344,1179662272,1179662272,0
1360760466,1181848144,1,52,52,1360760440160,1360760440160,1181822304,1181822304,0
1360760802,1182184576,2,230,115,1360760776044,1360760776044,1182158620,1182158620,0
1360761933,1183315304,1,46,46,1360761906283,1360761906283,1183288587,1183288587,0
1360763619,1185000848,3,138,46,1360763591451,1360763600603,1184973299,1184982451,9152
1360763963,1185345740,2,122,61,1360763937816,1360763939864,1185320556,1185322604,2048
1360764581,1185962932,1,46,46,1360764551287,1360764551287,1185933219,1185933219,0
1360766333,1187715420,1,46,46,1360766306998,1360766306998,1187689418,1187689418,0
1360766814,1188196072,1,46,46,1360766788489,1360766788489,1188170561,1188170561,0
1360767292,1188674200,1,60,60,1360767268034,1360767268034,1188650234,1188650234,0
1360770474,1191856560,1,48,48,1360770449386,1360770449386,1191831946,1191831946,0
1360770474,1191856560,1,48,48,1360770449449,1360770449449,1191832009,1191832009,0
1360770474,1191856632,1,48,48,1360770449188,1360770449188,1191831820,1191831820,0
1360771541,1192922948,1,127,127,1360771513664,1360771513664,1192895612,1192895612,0
1360773689,1195071468,1,46,46,1360773661140,1360773661140,1195043608,1195043608,0
1360773766,1195148656,1,46,46,1360773738586,1360773738586,1195121242,1195121242,0
1360776108,1197490020,1,46,46,1360776082352,1360776082352,1197464372,1197464372,0
1360779531,1200912948,1,60,60,1360779505735,1360779505735,1200887683,1200887683,0
1360780594,1201976268,1,48,48,1360780564790,1360780564790,1201947058,1201947058,0
1360781440,4136101904,2,96,48,1360781413292,1360781416364,4136075196,4136078268,3072
1360784803,1206184972,1,46,46,1360784776604,1360784776604,1206158576,1206158576,0
1360786896,1208278408,1,48,48,1360786866569,1360786866569,1208248977,1208248977,0
1360794772,1216153980,1,46,46,1360794742141,1360794742141,1216124121,1216124121,0
1360796705,1218087112,2,96,48,1360796679706,1360796682586,1218061818,1218064698,2880
1360797191,1218572828,1,46,46,1360797166573,1360797166573,1218548401,1218548401,0
1360797199,1218581700,1,46,46,1360797173253,1360797173253,1218555953,1218555953,0
1360798569,1219951016,1,52,52,1360798542687,1360798542687,1219924703,1219924703,0
1360798890,1220272484,1,46,46,1360798861574,1360798861574,1220244058,1220244058,0
1360799818,1221201048,1,46,46,1360799789508,1360799789508,1221172556,1221172556,0
1360800181,1221562988,1,46,46,1360800156193,1360800156193,1221538181,1221538181,0
1360805196,1226578416,1,46,46,1360805169129,1360805169129,1226551545,1226551545,0
1360805469,1226851092,1,576,576,1360805442475,1360805442475,1226824567,1226824567,0
1360805838,1227219764,1,46,46,1360805809963,1360805809963,1227191727,1227191727,0
1360806488,1227870332,1,46,46,1360806462571,1360806462571,1227844903,1227844903,0
1360807092,1228474052,1,46,46,1360807062649,1360807062649,1228444701,1228444701,0
1360807286,1228668448,1,48,48,1360807258540,1360807258540,1228640988,1228640988,0
1360807676,1229058160,1,48,48,1360807648134,1360807648134,1229030294,1229030294,0
1360808973,1230355188,1,46,46,1360808944917,1360808944917,1230327105,1230327105,0
1360809199,1230580928,1,46,46,1360809173332,1360809173332,1230555260,1230555260,0
1360810778,1232160336,1,46,46,1360810753189,1360810753189,1232135525,1232135525,0
1360811311,1232693260,1,437,437,1360811284394,1360811284394,1232666654,1232666654,0
1360812703,1234085552,1,48,48,1360812677681,1360812677681,1234060233,1234060233,0
1360813111,1234493144,1,52,52,1360813084484,1360813084484,1234466628,1234466628,0
1360815236,1236618012,1,78,78,1360815209769,1360815209769,1236591781,1236591781,0
1360815380,1236762624,1,48,48,1360815354242,1360815354242,1236736866,1236736866,0
1360815983,1237365584,1,46,46,1360815955487,1360815955487,1237338071,1237338071,0
1360816453,1237835492,1,48,48,1360816426038,1360816426038,1237808530,1237808530,0
1360818611,1239993548,1,56,56,1360818583647,1360818583647,1239966195,1239966195,0
1360819089,1240471172,1,60,60,1360819064461,1360819064461,1240446633,1240446633,0
1360819314,1240695816,1,60,60,1360819287471,1360819287471,1240669287,1240669287,0
1360819314,1240695872,1,56,56,1360819289591,1360819289591,1240671463,1240671463,0
1360819366,1240748020,1,46,46,1360819341283,1360819341283,1240723303,1240723303,0
1360819404,1240786644,1,46,46,1360819374386,1360819374386,1240757030,1240757030,0
1360821579,1242961036,2,122,61,1360821551601,1360821554033,1242933637,1242936069,2432
1360821889,1243271140,1,46,46,1360821863043,1360821863043,1243245183,1243245183,0
1360828611,1249992856,1,46,46,1360828582586,1360828582586,1249964442,1249964442,0
1360829080,1250462424,5,250,50,1360829052990,1360829074366,1250435414,1250456790,21376
1360829124,1250506508,1,48,48,1360829098406,1360829098406,1250480914,1250480914,0
1360829678,1251059728,1,48,48,1360829650221,1360829650221,1251031949,1251031949,0
1360831493,1252874868,1,46,46,1360831465092,1360831465092,1252846960,1252846960,0
1360832723,1254105472,1,71,71,1360832697494,1360832697494,1254079966,1254079966,0
1360833000,1254382316,3,152,50.66666667,1360832974831,1360832983855,1254357147,1254366171,9024
1360834065,1255446844,1,46,46,1360834036279,1360834036279,1255418123,1255418123,0
1360834468,1255849712,1,46,46,1360834443059,1360834443059,1255824771,1255824771,0
1360834616,1255997796,1,46,46,1360834590876,1360834590876,1255972672,1255972672,0
1360835069,1256450808,1,60,60,1360835041674,1360835041674,1256423482,1256423482,0
1360835257,1256639048,2,92,46,1360835229785,1360835230297,1256611833,1256612345,512
1360835946,1257328344,1,46,46,1360835918182,1360835918182,1257300526,1257300526,0
1360836483,1257865248,1,48,48,1360836458110,1360836458110,1257840358,1257840358,0
1360836487,1257869228,1,48,48,1360836459153,1360836459153,1257841381,1257841381,0
1360837882,1259264176,1,48,48,1360837856752,1360837856752,1259238928,1259238928,0
1360839767,1261148972,1,60,60,1360839740767,1360839740767,1261122739,1261122739,0
1360843329,1264710928,1,48,48,1360843300949,1360843300949,1264682877,1264682877,0
1360843396,1264778240,1,48,48,1360843369309,1360843369309,1264751549,1264751549,0
1360846454,1267836288,2,122,61,1360846429505,1360846431617,1267811793,1267813905,2112
1360849075,1270456976,1,48,48,1360849046992,1360849046992,1270428968,1270428968,0
1360849497,1270878804,1,78,78,1360849469620,1360849469620,1270851424,1270851424,0
1360851168,1272550180,2,122,61,1360851141347,1360851141667,1272523527,1272523847,320
1360853758,4208420016,1,46,46,1360853732759,1360853732759,4208394775,4208394775,0
1360854367,1275748720,1,46,46,1360854341375,1360854341375,1275723095,1275723095,0
1360857041,1278422576,1,46,46,1360857015912,1360857015912,1278397488,1278397488,0
1360857894,1279275936,1,46,46,1360857864948,1360857864948,1279246884,1279246884,0
1360858706,1280088072,1,46,46,1360858677599,1360858677599,1280059671,1280059671,0
1360858934,1280315936,1,74,74,1360858906084,1360858906084,1280288020,1280288020,0
1360859547,1280929500,1,89,89,1360859522341,1360859522341,1280904841,1280904841,0
1360859551,1280933476,2,152,76,1360859526717,1360859541693,1280909193,1280924169,14976
1360859583,1280965532,2,152,76,1360859556679,1360859571655,1280939211,1280954187,14976
1360859612,1280993568,1,76,76,1360859587657,1360859587657,1280969225,1280969225,0
1360859616,1280997664,1,46,46,1360859589352,1360859589352,1280971016,1280971016,0
1360860217,1281598972,2,152,76,1360860192299,1360860207275,1281574271,1281589247,14976
1360860227,4214889424,18,22578,1254.333333,1360860202472,1360860202536,4214864896,4214864960,64
1360860229,1281610952,14,7172,512.2857143,1360860203007,1360860203327,1281584959,1281585279,320
1360860249,1281631016,2,152,76,1360860222206,1360860237182,1281604222,1281619198,14976
1360860287,1281668852,2,126,63,1360860285668,1360860286692,1281667520,1281668544,1024
1360860317,1281699308,2,92,46,1360860290843,1360860290843,1281673151,1281673151,0
1360860315,4214977508,1,52,52,1360860290776,1360860290776,4214953284,4214953284,0
1360860422,1281803584,1,48,48,1360860393838,1360860393838,1281775422,1281775422,0
1360860474,1281855844,1,48,48,1360860446695,1360860446695,1281828539,1281828539,0
1360860570,1281951980,1,46,46,1360860542238,1360860542238,1281924218,1281924218,0
1360861877,1283259180,1,52,52,1360861851458,1360861851458,1283233638,1283233638,0
1360861881,1283263232,1,52,52,1360861854349,1360861854349,1283236581,1283236581,0
1360861941,1283323272,1,52,52,1360861915303,1360861915303,1283297575,1283297575,0
1360861945,1283327256,1,52,52,1360861918262,1360861918262,1283300518,1283300518,0
1360861993,1283374640,1,46,46,1360861967963,1360861967963,1283349603,1283349603,0
1360862257,1283638992,11,3246,295.0909091,1360862230392,1360862231608,1283612384,1283613600,1216
1360862546,1283928048,2,141,70.5,1360862540925,1360862540925,1283922973,1283922973,0
1360862566,1283947680,11,3246,295.0909091,1360862539117,1360862541421,1283920797,1283923101,2304
1360863319,1284701508,1,443,443,1360863294310,1360863294310,1284676818,1284676818,0
1360864603,1285984804,1,46,46,1360864576272,1360864576272,1285958076,1285958076,0
1360865344,1286726392,1,48,48,1360865315770,1360865315770,1286698162,1286698162,0
1360865721,1287102944,1,46,46,1360865695221,1360865695221,1287077165,1287077165,0
1360866855,1288237156,1,48,48,1360866828558,1360866828558,1288210714,1288210714,0
1360867480,1288862140,1,60,60,1360867452501,1360867452501,1288834641,1288834641,0
1360868335,1289716656,1,60,60,1360868308779,1360868308779,1289690435,1289690435,0
1360868579,1289961160,1,60,60,1360868551150,1360868551150,1289933310,1289933310,0
1360868579,1289961224,1,60,60,1360868551982,1360868551982,1289934206,1289934206,0
1360871312,1292693600,2,92,46,1360871285364,1360871286324,1292666964,1292667924,960
1360872759,1294140824,1,46,46,1360872734781,1360872734781,1294116605,1294116605,0
1360872843,1294225024,2,92,46,1360872817590,1360872821558,1294199614,1294203582,3968
1360875199,1296581040,1,46,46,1360875171200,1360875171200,1296553240,1296553240,0
1360877614,1298996188,1,46,46,1360877586118,1360877586118,1298968306,1298968306,0
1360878065,1299447444,1,52,52,1360878038657,1360878038657,1299421101,1299421101,0
1360878166,1299547576,1,437,437,1360878138723,1360878138723,1299520299,1299520299,0
1360882078,1303460240,1,48,48,1360882050573,1360882050573,1303432813,1303432813,0
1360882323,1303704988,1,46,46,1360882298182,1360882298182,1303680170,1303680170,0
1360882924,1304306200,1,52,52,1360882899434,1360882899434,1304281634,1304281634,0
1360883389,1304771116,1,46,46,1360883363829,1360883363829,1304745945,1304745945,0
1360883764,1305145924,1,48,48,1360883737072,1360883737072,1305118996,1305118996,0
1360886139,1307521064,2,122,61,1360886112064,1360886112256,1307494128,1307494320,192
1360887895,1309276540,1,48,48,1360887865136,1360887865136,1309246676,1309246676,0
1360888325,1309706852,1,60,60,1360888298096,1360888298096,1309679948,1309679948,0
1360888425,1309807016,1,46,46,1360888398350,1360888398350,1309780366,1309780366,0
1360890776,1312158244,1,46,46,1360890747781,1360890747781,1312130025,1312130025,0
1360891225,1312606528,1,46,46,1360891198220,1360891198220,1312579748,1312579748,0
1360891504,1312886052,3,144,48,1360891477496,1360891486328,1312859548,1312868380,8832
1360891557,1312939272,1,46,46,1360891528414,1360891528414,1312910686,1312910686,0
1360891718,1313100388,1,48,48,1360891690151,1360891690151,1313072539,1313072539,0
1360892539,1313921052,1,46,46,1360892512297,1360892512297,1313894349,1313894349,0
1360892787,1314169380,1,46,46,1360892760414,1360892760414,1314142794,1314142794,0
1360893100,1314481856,1,46,46,1360893072039,1360893072039,1314453895,1314453895,0
1360893825,1315206896,1,60,60,1360893798067,1360893798067,1315179963,1315179963,0
1360895350,4250012008,1,46,46,1360895323629,1360895323629,4249985637,4249985637,0
1360896252,1317634284,1,46,46,1360896225864,1360896225864,1317608148,1317608148,0
1360896880,1318261760,1,46,46,1360896855691,1360896855691,1318237451,1318237451,0
1360897244,1318626244,1,60,60,1360897217506,1360897217506,1318599750,1318599750,0
1360899093,1320475096,1,48,48,1360899065947,1360899065947,1320448043,1320448043,0
1360899823,1321205376,1,46,46,1360899795895,1360899795895,1321178271,1321178271,0
1360900098,1321480368,1,46,46,1360900069754,1360900069754,1321452122,1321452122,0
1360902629,1324010832,1,78,78,1360902602345,1360902602345,1323984177,1323984177,0
1360902637,1324018632,1,52,52,1360902611121,1360902611121,1323992753,1323992753,0
1360903032,1324413860,1,46,46,1360903004103,1360903004103,1324385963,1324385963,0
1360903639,1325020920,1,60,60,1360903612420,1360903612420,1324994340,1324994340,0
1360903959,1325341204,1,46,46,1360903932834,1360903932834,1325315038,1325315038,0
1360904312,1325694236,1,46,46,1360904287678,1360904287678,1325669914,1325669914,0
1360905176,1326557724,1,48,48,1360905149614,1360905149614,1326531338,1326531338,0
1360905964,1327345800,1,60,60,1360905936727,1360905936727,1327318527,1327318527,0
1360912987,1334368552,2,96,48,1360912959589,1360912962533,1334341141,1334344085,2944
1360913498,1334879444,1,48,48,1360913471752,1360913471752,1334853196,1334853196,0
1360914851,1336232696,1,56,56,1360914826742,1360914826742,1336208438,1336208438,0
1360915656,1337038080,1,46,46,1360915629994,1360915629994,1337012074,1337012074,0
1360918081,1339463284,1,46,46,1360918051961,1360918051961,1339434245,1339434245,0
1360918728,1340109372,2,120,60,1360918700993,1360918704001,1340082365,1340085373,3008
1360920928,1342310256,1,46,46,1360920903465,1360920903465,1342285721,1342285721,0
1360922264,1343645664,2,122,61,1360922238695,1360922240679,1343620359,1343622343,1984
1360923029,1344410812,2,120,60,1360923002310,1360923003270,1344384122,1344385082,960
1360923646,1345027828,1,46,46,1360923620588,1360923620588,1345002416,1345002416,0
1360924331,1345713168,1,46,46,1360924306189,1360924306189,1345688357,1345688357,0
1360927406,1348787952,3,180,60,1360927379191,1360927388215,1348761143,1348770167,9024
1360930040,1351422160,1,46,46,1360930013696,1360930013696,1351395856,1351395856,0
1360930574,1351955852,3,138,46,1360930548397,1360930557549,1351930249,1351939401,9152
1360931287,1352668484,1,48,48,1360931257614,1360931257614,1352639098,1352639098,0
1360934133,1355515208,1,52,52,1360934108368,1360934108368,1355490576,1355490576,0
1360934646,1356027920,1,46,46,1360934618279,1360934618279,1356000199,1356000199,0
1360937549,1358930848,1,46,46,1360937523077,1360937523077,1358904925,1358904925,0
1360938624,1360005380,1,46,46,1360938598471,1360938598471,1359979851,1359979851,0
1360941896,1363277624,1,46,46,1360941867937,1360941867937,1363249561,1363249561,0
1360942055,1363436612,1,46,46,1360942026027,1360942026027,1363407639,1363407639,0
1360942842,1364224156,2,96,48,1360942816960,1360942821824,1364199116,1364203980,4864
1360944286,1365667984,5,250,50,1360944261396,1360944282900,1365643380,1365664884,21504
1360944334,1365715992,1,48,48,1360944307147,1360944307147,1365689139,1365689139,0
1360944362,1365744124,1,48,48,1360944336326,1360944336326,1365718450,1365718450,0
1360945299,1366680380,1,46,46,1360945269346,1360945269346,1366650726,1366650726,0
1360945533,1366914348,2,120,60,1360945508287,1360945511295,1366889635,1366892643,3008
1360946326,1367708024,1,71,71,1360946298318,1360946298318,1367680342,1367680342,0
1360946668,1368049740,1,48,48,1360946641443,1360946641443,1368023183,1368023183,0
1360947517,1368898776,1,60,60,1360947492659,1360947492659,1368874435,1368874435,0
1360948079,1369460576,1,46,46,1360948051569,1360948051569,1369433145,1369433145,0
1360951086,1372468228,1,46,46,1360951058167,1360951058167,1372440395,1372440395,0
1360951335,1372716396,1,46,46,1360951310134,1360951310134,1372691530,1372691530,0
1360955010,1376391620,1,46,46,1360954982555,1360954982555,1376364175,1376364175,0
1360956601,1377982328,2,92,46,1360956576552,1360956577000,1377957880,1377958328,448
1360957458,1378839904,1,46,46,1360957433561,1360957433561,1378815465,1378815465,0
1360959122,1380503324,1,46,46,1360959092614,1360959092614,1380473938,1380473938,0
1360959814,1381195992,1,46,46,1360959787230,1360959787230,1381169222,1381169222,0
1360961572,1382953564,1,46,46,1360961544494,1360961544494,1382926058,1382926058,0
1360964587,1385968664,1,47,47,1360964562525,1360964562525,1385944189,1385944189,0
1360966436,1387817896,1,46,46,1360966409881,1360966409881,1387791777,1387791777,0
1360968782,1390163584,1,46,46,1360968755822,1360968755822,1390137406,1390137406,0
1360970282,1391664044,1,46,46,1360970253002,1360970253002,1391635046,1391635046,0
1360970503,1391885016,1,48,48,1360970475428,1360970475428,1391857444,1391857444,0
1360971118,1392499196,1,48,48,1360971088461,1360971088461,1392469657,1392469657,0
1360971195,1392576484,1,48,48,1360971170156,1360971170156,1392551640,1392551640,0
1360971215,1392596556,6,298,49.66666667,1360971188387,1360971210083,1392569943,1392591639,21696
1360972366,1393747532,1,46,46,1360972338793,1360972338793,1393720325,1393720325,0
1360973616,1394997808,1,52,52,1360973590339,1360973590339,1394972147,1394972147,0
1360974114,1395495448,1,46,46,1360974085857,1360974085857,1395467305,1395467305,0
1360974236,1395618164,1,64,64,1360974206227,1360974206227,1395588391,1395588391,0
1360975941,1397322436,2,122,61,1360975914517,1360975916885,1397295953,1397298321,2368
1360976229,1397610852,1,60,60,1360976202285,1360976202285,1397584137,1397584137,0
1360976229,1397610892,1,60,60,1360976203464,1360976203464,1397585356,1397585356,0
1360976377,1397759032,1,60,60,1360976350839,1360976350839,1397732871,1397732871,0
1360977947,1399328692,1,46,46,1360977920820,1360977920820,1399302512,1399302512,0
1360978037,1399418348,1,46,46,1360978010057,1360978010057,1399391405,1399391405,0
1360980610,1401992116,1,46,46,1360980582754,1360980582754,1401964870,1401964870,0
1360980715,1402096220,1,46,46,1360980687201,1360980687201,1402068421,1402068421,0
1360980715,1402096224,1,46,46,1360980687456,1360980687456,1402068680,1402068680,0
1360981740,1403121704,1,46,46,1360981712622,1360981712622,1403094326,1403094326,0
1360982508,1403889816,1,46,46,1360982480944,1360982480944,1403862760,1403862760,0
1360982670,1404051936,1,46,46,1360982644855,1360982644855,1404026791,1404026791,0
1360983384,1404766132,1,48,48,1360983356903,1360983356903,1404739035,1404739035,0
1360985481,1406862628,1,46,46,1360985454143,1360985454143,1406835771,1406835771,0
1360990023,1411404564,1,58,58,1360989995005,1360989995005,1411376569,1411376569,0
1360990480,1411861768,1,46,46,1360990454377,1360990454377,1411836145,1411836145,0
1360991257,1412638676,1,46,46,1360991228730,1360991228730,1412610406,1412610406,0
1360991406,1412787180,1,46,46,1360991377956,1360991377956,1412759136,1412759136,0
1360991826,1413207628,2,122,61,1360991799134,1360991801566,1413180762,1413183194,2432
1360992709,1414090412,1,48,48,1360992680619,1360992680619,1414062031,1414062031,0
1360993732,1415113244,1,48,48,1360993705730,1360993705730,1415086974,1415086974,0
1360996588,1417969972,2,120,60,1360996563454,1360996563454,1417945426,1417945426,0
1360998300,1419681256,1,46,46,1360998275056,1360998275056,1419656312,1419656312,0
1360998370,1419751272,1,48,48,1360998342112,1360998342112,1419723384,1419723384,0
1361005753,1427134884,1,46,46,1361005725384,1361005725384,1427107268,1427107268,0
1361008758,1430139912,1,48,48,1361008731713,1361008731713,1430113625,1430113625,0
1361010304,1431685616,1,60,60,1361010279057,1361010279057,1431660673,1431660673,0
1361010526,1431907100,1,48,48,1361010497360,1361010497360,1431878460,1431878460,0
1361010841,1432222528,1,46,46,1361010813151,1361010813151,1432194679,1432194679,0
1361011844,1433225584,1,46,46,1361011817944,1361011817944,1433199528,1433199528,0
1361012169,1433550128,1,46,46,1361012142876,1361012142876,1433524004,1433524004,0
1361013920,1435301064,1,60,60,1361013892161,1361013892161,1435273225,1435273225,0
1361013920,1435301068,1,60,60,1361013892478,1361013892478,1435273546,1435273546,0
1361015981,1437362160,1,60,60,1361015955458,1361015955458,1437336618,1437336618,0
1361016231,1437612672,1,48,48,1361016205308,1361016205308,1437586980,1437586980,0
1361016339,1437720524,1,46,46,1361016310992,1361016310992,1437692516,1437692516,0
1361018598,1439979616,1,52,52,1361018570897,1361018570897,1439952513,1439952513,0
1361019718,1441099084,1,46,46,1361019689494,1361019689494,1441070578,1441070578,0
1361023891,1445272412,1,46,46,1361023861963,1361023861963,1445243375,1445243375,0
1361025018,1446399808,2,122,61,1361024989872,1361024992048,1446371680,1446373856,2176
1361025796,1447177128,2,122,61,1361025769931,1361025772363,1447151059,1447153491,2432
1361026289,1447670128,1,46,46,1361026262019,1361026262019,1447643147,1447643147,0
1361026373,1447754428,5,250,50,1361026346711,1361026368407,1447728139,1447749835,21696
1361026417,1447798468,1,48,48,1361026392494,1361026392494,1447773962,1447773962,0
1361026449,1447830784,1,48,48,1361026421681,1361026421681,1447803465,1447803465,0
1361026878,1448259488,1,46,46,1361026853715,1361026853715,1448235203,1448235203,0
1361028297,1449678432,1,48,48,1361028271732,1361028271732,1449653164,1449653164,0
1361028297,1449678668,3,142,47.33333333,1361028274507,1361028293323,1449656175,1449674991,18816
1361029072,1450453660,1,46,46,1361029046215,1361029046215,1450427875,1450427875,0
1361029476,1450857004,1,60,60,1361029448399,1361029448399,1450829403,1450829403,0
1361029724,1451105548,1,46,46,1361029696429,1361029696429,1451077977,1451077977,0
1361030527,1451908216,1,46,46,1361030500588,1361030500588,1451881804,1451881804,0
1361030590,1451971020,1,46,46,1361030563565,1361030563565,1451944585,1451944585,0
1361031064,1452445968,1,46,46,1361031038258,1361031038258,1452420226,1452420226,0
1361031921,1453302056,1,46,46,1361031896056,1361031896056,1453277112,1453277112,0
1361032749,1454130004,1,48,48,1361032721631,1361032721631,1454102635,1454102635,0
1361033716,1455097932,1,78,78,1361033690799,1361033690799,1455072731,1455072731,0
1361033802,1455183768,1,48,48,1361033775186,1361033775186,1455156954,1455156954,0
1361035140,1456521832,1,46,46,1361035114239,1361035114239,1456496071,1456496071,0
1361035140,1456521900,1,46,46,1361035113851,1361035113851,1456495751,1456495751,0
1361037894,1459275784,1,60,60,1361037869380,1361037869380,1459251164,1459251164,0
1361039249,1460629980,1,46,46,1361039221074,1361039221074,1460602054,1460602054,0
1361039273,98967708,1,46,46,1361039248157,1361039248157,98942865,98942865,0
1361040263,1461643972,2,96,48,1361040236685,1361040239693,1461617657,1461620665,3008
1361040286,1461667912,2,120,60,1361040260129,1361040263137,1461642041,1461645049,3008
1361040306,1461687940,1,60,60,1361040277889,1361040277889,1461659829,1461659829,0
1361040423,1461804084,1,46,46,1361040396121,1361040396121,1461777205,1461777205,0
1361040701,1462082496,1,46,46,1361040671930,1361040671930,1462053426,1462053426,0
1361043210,1464591168,1,48,48,1361043185688,1361043185688,1464566856,1464566856,0
1361043214,1464595300,1,48,48,1361043188438,1361043188438,1464569738,1464569738,0
1361043266,1464647220,5,250,50,1361043238118,1361043260838,1464619338,1464642058,22720
1361043310,1464691380,1,48,48,1361043284868,1361043284868,1464666248,1464666248,0
1361043342,1464723304,1,48,48,1361043314192,1361043314192,1464695496,1464695496,0
1361045238,1466619520,1,46,46,1361045212250,1361045212250,1466593770,1466593770,0
1361045298,1466679556,1,46,46,1361045272437,1361045272437,1466653993,1466653993,0
1361045811,1467192412,1,46,46,1361045782973,1361045782973,1467164385,1467164385,0
1361046945,1468326576,1,46,46,1361046918857,1361046918857,1468300433,1468300433,0
1361051624,1473005372,5,250,50,1361051598031,1361051619855,1472979403,1473001227,21824
1361051672,1473053476,1,48,48,1361051644197,1361051644197,1473025673,1473025673,0
1361051700,1473081472,1,48,48,1361051673450,1361051673450,1473054922,1473054922,0
1361052185,1473566828,1,52,52,1361052158204,1361052158204,1473540032,1473540032,0
1361053521,1474902212,5,250,50,1361053493776,1361053515536,1474874988,1474896748,21760
1361053565,1474946416,1,48,48,1361053539780,1361053539780,1474921196,1474921196,0
1361053597,1474978496,1,48,48,1361053569141,1361053569141,1474950637,1474950637,0
1361053836,1475217436,1,46,46,1361053807468,1361053807468,1475188904,1475188904,0
1361053871,1475252768,1,46,46,1361053844639,1361053844639,1475226407,1475226407,0
1361056890,1478271360,1,52,52,1361056862411,1361056862411,1478243771,1478243771,0
1361056943,1478324148,1,52,52,1361056917725,1361056917725,1478298873,1478298873,0
1361057194,1478575496,1,46,46,1361057169344,1361057169344,1478550840,1478550840,0
1361057194,1478575572,1,46,46,1361057169523,1361057169523,1478551095,1478551095,0
1361058112,1479493544,1,60,60,1361058087679,1361058087679,1479469223,1479469223,0
1361058216,1479597752,1,46,46,1361058191405,1361058191405,1479573157,1479573157,0
1361058232,1479613612,1,60,60,1361058204216,1361058204216,1479585828,1479585828,0
1361060729,1482110520,1,60,60,1361060703792,1361060703792,1482085312,1482085312,0
1361060805,1482186540,1,60,60,1361060777626,1361060777626,1482159166,1482159166,0
1361062032,1483413604,1,48,48,1361062004554,1361062004554,1483386158,1483386158,0
1361062036,1483417560,1,48,48,1361062008627,1361062008627,1483390187,1483390187,0
1361063804,1485185840,1,46,46,1361063779007,1361063779007,1485160847,1485160847,0
1361064355,1485736368,1,46,46,1361064329169,1361064329169,1485710537,1485710537,0
1361065179,1486559976,1,46,46,1361065153419,1361065153419,1486534395,1486534395,0
1361065307,1486688136,1,60,60,1361065280041,1361065280041,1486661177,1486661177,0
1361065347,1486728220,1,60,60,1361065319064,1361065319064,1486700284,1486700284,0
1361066570,1487951400,1,48,48,1361066540110,1361066540110,1487921510,1487921510,0
1361066847,1488228664,2,120,60,1361066820227,1361066823235,1488201891,1488204899,3008
1361067537,1488917868,1,46,46,1361067510103,1361067510103,1488890971,1488890971,0
1361069924,1491305176,1,48,48,1361069894332,1361069894332,1491275508,1491275508,0
1361072194,1493575708,1,60,60,1361072166662,1361072166662,1493548370,1493548370,0
1361072519,1493900096,1,60,60,1361072491621,1361072491621,1493872717,1493872717,0
1361073285,1494666476,1,445,445,1361073260637,1361073260637,1494642113,1494642113,0
1361077193,1498574124,1,46,46,1361077167233,1361077167233,1498548357,1498548357,0
1361077414,1498794852,1,92,92,1361077388047,1361077388047,1498768899,1498768899,0
1361079080,1500460928,2,96,48,1361079054633,1361079057769,1500435561,1500438697,3136
1361082406,1503787248,1,46,46,1361082378487,1361082378487,1503759735,1503759735,0
1361084931,1506312552,1,52,52,1361084903071,1361084903071,1506284623,1506284623,0
1361085965,1507346704,1,56,56,1361085940087,1361085940087,1507321791,1507321791,0
1361086006,1507386872,5,250,50,1361085978231,1361085999863,1507359103,1507380735,21632
1361086050,1507430808,1,48,48,1361086024120,1361086024120,1507404928,1507404928,0
1361086079,1507460248,1,48,48,1361086053374,1361086053374,1507434622,1507434622,0
1361086090,1507470852,1,46,46,1361086063050,1361086063050,1507443902,1507443902,0
1361088371,1509751796,1,46,46,1361088345440,1361088345440,1509726236,1509726236,0
1361088810,1510191208,1,60,60,1361088784191,1361088784191,1510165399,1510165399,0
1361090265,1511646716,1,48,48,1361090237997,1361090237997,1511619713,1511619713,0
1361091453,1512834588,1,48,48,1361091426267,1361091426267,1512807855,1512807855,0
1361091692,1513073484,1,46,46,1361091667388,1361091667388,1513048872,1513048872,0
1361091692,1513073488,1,46,46,1361091667706,1361091667706,1513049194,1513049194,0
1361091696,1513077424,1,46,46,1361091671097,1361091671097,1513052521,1513052521,0
1361091700,1513081452,1,46,46,1361091674076,1361091674076,1513055528,1513055528,0
1361091704,1513085368,1,46,46,1361091677171,1361091677171,1513058539,1513058539,0
1361091708,1513089440,1,46,46,1361091680105,1361091680105,1513061545,1513061545,0
1361092239,1513620680,1,46,46,1361092212977,1361092212977,1513594657,1513594657,0
1361092318,1513699272,1,60,60,1361092291527,1361092291527,1513672799,1513672799,0
1361095107,1516488620,1,52,52,1361095080068,1361095080068,1516461688,1516461688,0
1361096054,1517434968,1,46,46,1361096028224,1361096028224,1517409192,1517409192,0
1361096831,1518211896,3,180,60,1361096803770,1361096806778,1518184666,1518187674,3008
1361097204,1518584768,1,52,52,1361097178040,1361097178040,1518558808,1518558808,0
1361101810,1523191512,1,46,46,1361101783176,1361101783176,1523164688,1523164688,0
1361104874,1526255492,1,48,48,1361104847661,1361104847661,1526229153,1526229153,0
1361105931,1527312184,1,46,46,1361105903442,1361105903442,1527284626,1527284626,0
1361107374,1528754972,2,120,60,1361107347345,1361107350289,1528728317,1528731261,2944
1361108095,1529476684,1,46,46,1361108068543,1361108068543,1529450227,1529450227,0
1361108416,1529797016,1,46,46,1361108388245,1361108388245,1529769261,1529769261,0
1361109090,1530470804,1,48,48,1361109061854,1361109061854,1530442658,1530442658,0
1361111768,1533148800,2,120,60,1361111740922,1361111741946,1533121722,1533122746,1024
1361113756,1535137564,1,46,46,1361113725920,1361113725920,1535107484,1535107484,0
1361114140,1535521372,1,48,48,1361114111130,1361114111130,1535492502,1535492502,0
1361114266,1535647464,1,46,46,1361114238653,1361114238653,1535620117,1535620117,0
1361116382,1537762836,2,96,48,1361116354383,1361116357391,1537735219,1537738227,3008
1361117476,1538857268,1,46,46,1361117450385,1361117450385,1538831653,1538831653,0
1361118409,1539789716,1,48,48,1361118380009,1361118380009,1539760725,1539760725,0
1361120991,1542372356,1,46,46,1361120963648,1361120963648,1542345004,1542345004,0
1361121111,1542492632,1,127,127,1361121083500,1361121083500,1542465132,1542465132,0
1361121236,1542616924,1,46,46,1361121209326,1361121209326,1542590250,1542590250,0
1361122140,181834820,1,46,46,1361122114953,1361122114953,181809773,181809773,0
1361126195,1547576596,1,46,46,1361126168770,1361126168770,1547550366,1547550366,0
1361126519,1547900044,1,437,437,1361126493860,1361126493860,1547874904,1547874904,0
1361126535,1547916036,1,48,48,1361126509039,1361126509039,1547890075,1547890075,0
1361126579,1547960004,1,46,46,1361126554382,1361126554382,1547935386,1547935386,0
1361127910,1549291264,1,46,46,1361127884211,1361127884211,1549265475,1549265475,0
1361128244,1549625592,1,46,46,1361128217509,1361128217509,1549599101,1549599101,0
1361128883,1550264652,2,122,61,1361128855139,1361128857443,1550236791,1550239095,2304
1361130586,1551967240,1,46,46,1361130559458,1361130559458,1551940698,1551940698,0
1361130586,1551967312,1,46,46,1361130559132,1361130559132,1551940444,1551940444,0
1361131324,191018628,1,46,46,1361131298693,1361131298693,190993321,190993321,0
1361131412,1552793576,5,250,50,1361131384263,1361131405959,1552765839,1552787535,21696
1361132643,1554024192,1,48,48,1361132618614,1361132618614,1553999806,1553999806,0
1361133337,1554717776,1,60,60,1361133309259,1361133309259,1554690035,1554690035,0
1361135751,1557131864,1,46,46,1361135724047,1361135724047,1557104911,1557104911,0
1361136015,1557396404,1,46,46,1361135988525,1361135988525,1557369929,1557369929,0
1361136724,1558105576,1,48,48,1361136693879,1361136693879,1558075455,1558075455,0
1361138749,1560130412,1,48,48,1361138721017,1361138721017,1560102429,1560102429,0
1361139936,1561317080,1,52,52,1361139908598,1361139908598,1561289678,1561289678,0
1361139988,1561369532,1,52,52,1361139963184,1361139963184,1561344716,1561344716,0
1361143559,1564940252,1,68,68,1361143534611,1361143534611,1564915863,1564915863,0
1361145821,1567202208,1,68,68,1361145793308,1361145793308,1567174516,1567174516,0
1361148507,1569888108,1,68,68,1361148479958,1361148479958,1569861066,1569861066,0
1361148545,1569925820,1,48,48,1361148518837,1361148518837,1569899657,1569899657,0
1361148591,1569972304,1,95,95,1361148566286,1361148566286,1569947590,1569947590,0
1361150492,1571872768,1,46,46,1361150466890,1361150466890,1571847658,1571847658,0
1361150673,1572054056,1,46,46,1361150647274,1361150647274,1572028330,1572028330,0
1361151235,1572615904,1,46,46,1361151206648,1361151206648,1572587552,1572587552,0
1361151628,1573008816,1,46,46,1361151601737,1361151601737,1572982553,1572982553,0
1361151704,1573084836,1,46,46,1361151678003,1361151678003,1573058839,1573058839,0
1361151935,1573315720,1,68,68,1361151908902,1361151908902,1573289622,1573289622,0
1361153988,1575368732,5,250,50,1361153963195,1361153985339,1575343927,1575366071,22144
1361154036,1575416784,1,48,48,1361154009860,1361154009860,1575390644,1575390644,0
1361154753,1576134032,6,298,49.66666667,1361154727811,1361154749315,1576108843,1576130347,21504
1361154801,1576182308,1,48,48,1361154773359,1361154773359,1576154667,1576154667,0
1361154829,1576210296,1,48,48,1361154802809,1361154802809,1576184105,1576184105,0
1361155283,1576663652,1,46,46,1361155257015,1361155257015,1576637667,1576637667,0
1361157618,1578999216,1,46,46,1361157593248,1361157593248,1578974464,1578974464,0
1361159246,1580627132,1,46,46,1361159221016,1361159221016,1580602148,1580602148,0
1361162526,1583907052,1,46,46,1361162497974,1361162497974,1583879026,1583879026,0
1361162747,1584127940,1,46,46,1361162721636,1361162721636,1584102576,1584102576,0
1361163825,1585206136,2,122,61,1361163799696,1361163802000,1585180832,1585183136,2304
1361164735,1586116064,1,48,48,1361164710152,1361164710152,1586091216,1586091216,0
1361164807,1586187884,1,78,78,1361164780413,1361164780413,1586161297,1586161297,0
1361165999,1587380020,1,46,46,1361165974176,1361165974176,1587355196,1587355196,0
1361168010,1589391112,1,46,46,1361167981030,1361167981030,1589362142,1589362142,0
1361168615,1589995540,1,46,46,1361168587931,1361168587931,1589968471,1589968471,0
1361169552,1590933092,1,46,46,1361169524197,1361169524197,1590905289,1590905289,0
1361170587,1591967984,1,46,46,1361170560702,1361170560702,1591941686,1591941686,0
1361173581,1594961776,1,52,52,1361173554720,1361173554720,1594935496,1594935496,0
1361176077,1597457600,1,46,46,1361176047917,1361176047917,1597428517,1597428517,0
1361178163,1599543628,1,46,46,1361178137007,1361178137007,1599517635,1599517635,0
1361178271,1599651808,1,46,46,1361178243067,1361178243067,1599623875,1599623875,0
1361178309,1599689608,1,46,46,1361178281282,1361178281282,1599661890,1599661890,0
1361178784,1600165160,1,443,443,1361178758098,1361178758098,1600139258,1600139258,0
1361179265,1600645788,1,46,46,1361179239423,1361179239423,1600620211,1600620211,0
1361179517,1600898476,1,64,64,1361179492106,1361179492106,1600873582,1600873582,0
1361180283,1601663916,5,250,50,1361180257841,1361180279345,1601638757,1601660261,21504
1361180592,1601973252,1,46,46,1361180563868,1361180563868,1601945120,1601945120,0
1361180606,1601987280,1,48,48,1361180578237,1361180578237,1601959517,1601959517,0
1361182263,1603644068,5,250,50,1361182238009,1361182259961,1603619077,1603641029,21952
1361182311,1603692228,1,48,48,1361182284183,1361182284183,1603665411,1603665411,0
1361182339,1603720392,1,48,48,1361182313523,1361182313523,1603694915,1603694915,0
1361183822,1605203376,5,250,50,1361183794861,1361183816365,1605176237,1605197741,21504
1361183866,1605247392,1,48,48,1361183840542,1361183840542,1605221934,1605221934,0
1361183895,1605275508,1,48,48,1361183870800,1361183870800,1605251308,1605251308,0
1361184235,1605615792,1,48,48,1361184209584,1361184209584,1605590376,1605590376,0
1361184600,1605980720,1,52,52,1361184573169,1361184573169,1605953889,1605953889,0
1361185791,1607172356,1,48,48,1361185764450,1361185764450,1607145806,1607145806,0
1361187045,1608425804,1,46,46,1361187019191,1361187019191,1608399995,1608399995,0
1361187386,1608766668,1,46,46,1361187358140,1361187358140,1608738808,1608738808,0
1361187739,1609120104,1,46,46,1361187710467,1361187710467,1609091571,1609091571,0
1361190908,1612288964,2,122,61,1361190882716,1361190885020,1612263680,1612265984,2304
1361192526,1613906720,1,46,46,1361192498234,1361192498234,1613878954,1613878954,0
1361193902,1615282488,1,48,48,1361193874892,1361193874892,1615255380,1615255380,0
1361201148,1622529308,1,46,46,1361201121832,1361201121832,1622503140,1622503140,0
1361202426,1623807108,1,46,46,1361202397530,1361202397530,1623778638,1623778638,0
1361202431,1623811972,1,46,46,1361202406565,1361202406565,1623787537,1623787537,0
1361202435,1623815952,1,46,46,1361202407737,1361202407737,1623788689,1623788689,0
1361204482,1625862744,1,48,48,1361204455272,1361204455272,1625836016,1625836016,0
1361204632,1626012720,1,46,46,1361204605183,1361204605183,1625985903,1625985903,0
1361205258,1626639048,1,46,46,1361205230572,1361205230572,1626611620,1626611620,0
1361206464,1627844632,1,46,46,1361206437115,1361206437115,1627817747,1627817747,0
1361208502,1629882720,1,74,74,1361208476737,1361208476737,1629857457,1629857457,0
1361208528,1629908424,1,48,48,1361208501609,1361208501609,1629882033,1629882033,0
1361212912,1634292672,1,48,48,1361212884269,1361212884269,1634264941,1634264941,0
1361213216,1634596764,1,46,46,1361213187914,1361213187914,1634568678,1634568678,0
1361214006,273700060,1,46,46,1361213979861,1361213979861,273673921,273673921,0
1361214186,1635566684,1,48,48,1361214159115,1361214159115,1635539799,1635539799,0
1361216938,1638319196,1,46,46,1361216911329,1361216911329,1638292525,1638292525,0
1361219997,1641377488,2,122,61,1361219970681,1361219972985,1641351169,1641353473,2304
1361220201,1641582336,1,60,60,1361220174756,1361220174756,1641556092,1641556092,0
1361222294,1643675204,1,46,46,1361222266950,1361222266950,1643648154,1643648154,0
1361222316,1643696636,1,46,46,1361222289469,1361222289469,1643670105,1643670105,0
1361222835,1644215704,1,46,46,1361222809908,1361222809908,1644190612,1644190612,0
1361222903,1644283816,2,104,52,1361222875523,1361222878531,1644256339,1644259347,3008
1361223604,1644985248,2,122,61,1361223578632,1361223580616,1644959880,1644961864,1984
1361226893,1648273932,1,46,46,1361226864528,1361226864528,1648245460,1648245460,0
1361227271,1648652208,1,46,46,1361227245046,1361227245046,1648626254,1648626254,0
1361227294,1648674584,1,60,60,1361227268776,1361227268776,1648649360,1648649360,0
1361227380,1648760588,1,48,48,1361227353441,1361227353441,1648734029,1648734029,0
1361228176,1649556672,1,46,46,1361228148543,1361228148543,1649529215,1649529215,0
1361231767,1653147760,3,144,48,1361231740080,1361231752496,1653120840,1653133256,12416
1361231783,1653163912,1,448,448,1361231757272,1361231757272,1653138184,1653138184,0
1361234196,1655576652,1,46,46,1361234168120,1361234168120,1655548772,1655548772,0
1361235059,1656440224,1,46,46,1361235031408,1361235031408,1656412632,1656412632,0
1361235789,1657169964,1,46,46,1361235764583,1361235764583,1657145547,1657145547,0
1361237137,1658517824,1,48,48,1361237108063,1361237108063,1658488887,1658488887,0
1361240664,1662044708,1,46,46,1361240637661,1361240637661,1662018369,1662018369,0
1361240868,1662248796,1,46,46,1361240841860,1361240841860,1662222656,1662222656,0
1361243883,1665263532,2,122,61,1361243856476,1361243856604,1665237008,1665237136,128
1361244595,1665975944,1,46,46,1361244565559,1361244565559,1665946503,1665946503,0
1361244884,1666264556,1,46,46,1361244854327,1361244854327,1666234883,1666234883,0
1361245927,1667307864,1,60,60,1361245901168,1361245901168,1667282032,1667282032,0
1361246357,1667737424,1,46,46,1361246329060,1361246329060,1667709484,1667709484,0
1361247663,1669043588,2,96,48,1361247638637,1361247641645,1669019225,1669022233,3008
1361247663,1669043676,2,96,48,1361247638548,1361247641556,1669019224,1669022232,3008
1361247920,1669300368,1,46,46,1361247895170,1361247895170,1669275538,1669275538,0
1361247920,1669300448,1,46,46,1361247894068,1361247894068,1669274516,1669274516,0
1361249323,1670703912,2,96,48,1361249297358,1361249300238,1670678270,1670681150,2880
1361250891,1672271552,1,46,46,1361250862876,1361250862876,1672243428,1672243428,0
1361252199,1673579352,1,78,78,1361252173329,1361252173329,1673553681,1673553681,0
1361253018,1674399212,1,46,46,1361252989097,1361252989097,1674370309,1674370309,0
1361253971,1675351636,1,48,48,1361253946267,1361253946267,1675326903,1675326903,0
1361255283,1676663716,1,46,46,1361255254008,1361255254008,1676634724,1676634724,0
1361257282,1678662624,1,46,46,1361257256247,1361257256247,1678636871,1678636871,0
1361258833,1680213756,1,46,46,1361258807191,1361258807191,1680187947,1680187947,0
1361260172,1681552620,1,56,56,1361260145804,1361260145804,1681526424,1681526424,0
1361264141,1685521736,3,152,50.66666667,1361264116315,1361264125467,1685497051,1685506203,9152
1361264374,1685755104,1,46,46,1361264347176,1361264347176,1685728280,1685728280,0
1361265196,1686576352,1,46,46,1361265167946,1361265167946,1686548298,1686548298,0
1361266170,1687550436,1,46,46,1361266143787,1361266143787,1687524223,1687524223,0
1361271900,1693280964,2,122,61,1361271873602,1361271875970,1693254566,1693256934,2368
1361272346,1693726932,1,46,46,1361272320860,1361272320860,1693701792,1693701792,0
1361272446,1693826840,1,46,46,1361272418868,1361272418868,1693799708,1693799708,0
1361273697,1695077256,2,92,46,1361273669096,1361273669608,1695049352,1695049864,512
1361274402,1695783020,1,46,46,1361274374242,1361274374242,1695755262,1695755262,0
1361276214,1697595120,3,144,48,1361276189413,1361276198373,1697570533,1697579493,8960
1361281630,1703010300,2,122,61,1361281604293,1361281606789,1702984593,1702987089,2496
1361282884,1704264592,2,122,61,1361282857996,1361282860492,1704238588,1704241084,2496
1361283409,1704789984,1,46,46,1361283382527,1361283382527,1704763511,1704763511,0
1361287013,1708393608,2,96,48,1361286986944,1361286990080,1708367552,1708370688,3136
1361287013,1708393656,2,96,48,1361286986893,1361286989901,1708367549,1708370557,3008
1361287696,1709076728,1,46,46,1361287667902,1361287667902,1709048630,1709048630,0
1361288513,1709893368,1,46,46,1361288484888,1361288484888,1709865256,1709865256,0
1361289174,1710554824,1,60,60,1361289147461,1361289147461,1710528285,1710528285,0
1361291352,1712733108,3,144,48,1361291323913,1361291332937,1712705021,1712714045,9024
1361291830,351523880,1,48,48,1361291800965,1361291800965,351494845,351494845,0
1361292032,1713412656,1,48,48,1361292003972,1361292003972,1713384628,1713384628,0
1361292607,1713987812,6,298,49.66666667,1361292580126,1361292602398,1713960938,1713983210,22272
1361294456,1715836428,1,448,448,1361294428610,1361294428610,1715809038,1715809038,0
1361295738,1717118972,2,120,60,1361295710286,1361295713230,1717091258,1717094202,2944
1361295899,1717279492,1,71,71,1361295872364,1361295872364,1717252856,1717252856,0
1361297426,1718806352,1,46,46,1361297398817,1361297398817,1718779169,1718779169,0
1361298529,1719909656,2,122,61,1361298503201,1361298505441,1719883857,1719886097,2240
1361298780,1720160304,1,48,48,1361298752570,1361298752570,1720132874,1720132874,0
1361298822,1720202624,1,46,46,1361298795641,1361298795641,1720176265,1720176265,0
1361299098,1720478488,1,46,46,1361299068224,1361299068224,1720448712,1720448712,0
1361300454,1721834888,1,60,60,1361300426393,1361300426393,1721807281,1721807281,0
1361301220,1722600920,2,120,60,1361301192109,1361301195053,1722573029,1722575973,2944
1361303057,1724437656,3,144,48,1361303030168,1361303039192,1724410824,1724419848,9024
1361304134,1725514396,1,46,46,1361304106060,1361304106060,1725486456,1725486456,0
1361307825,1729205984,1,48,48,1361307797898,1361307797898,1729178882,1729178882,0
1361309717,1731097736,1,60,60,1361309690405,1361309690405,1731071141,1731071141,0
1361309981,1731362164,1,60,60,1361309955251,1361309955251,1731336415,1731336415,0
1361311529,1732909568,2,92,46,1361311504048,1361311505968,1732884616,1732886536,1920
1361313598,1734978380,1,46,46,1361313572172,1361313572172,1734952552,1734952552,0
1361313622,1735002364,1,46,46,1361313595100,1361313595100,1734975464,1734975464,0
1361313702,1735082508,1,46,46,1361313677642,1361313677642,1735058150,1735058150,0
1361315542,1736922624,1,46,46,1361315516093,1361315516093,1736896717,1736896717,0
1361316087,1737467888,1,46,46,1361316061677,1361316061677,1737442565,1737442565,0
1361316358,1737738260,1,46,46,1361316331548,1361316331548,1737711808,1737711808,0
1361317342,1738722752,1,46,46,1361317315680,1361317315680,1738696432,1738696432,0
1361317528,1738908936,1,48,48,1361317501543,1361317501543,1738882479,1738882479,0
1361318760,1740140948,3,152,50.66666667,1361318733831,1361318742855,1740114779,1740123803,9024
1361322661,1744041900,1,46,46,1361322634809,1361322634809,1744015709,1744015709,0
1361324393,1745773208,1,56,56,1361324366614,1361324366614,1745746822,1745746822,0
1361331584,1752964048,1,48,48,1361331557255,1361331557255,1752937303,1752937303,0
1361335844,1757224948,1,404,404,1361335818880,1361335818880,1757199828,1757199828,0
1361337608,1758988844,1,60,60,1361337583246,1361337583246,1758964090,1758964090,0
1361339593,1760973504,1,58,58,1361339568580,1361339568580,1760949084,1760949084,0
1361340367,1761747640,2,122,61,1361340339183,1361340339311,1761719823,1761719951,128
1361341314,401008208,1,46,46,1361341287041,1361341287041,400981249,400981249,0
1361343060,1764440400,1,46,46,1361343033657,1361343033657,1764414057,1764414057,0
1361344062,1765442928,1,46,46,1361344034839,1361344034839,1765415767,1765415767,0
1361344157,1765537540,2,122,61,1361344131099,1361344133147,1765511639,1765513687,2048
1361344330,1765710192,1,46,46,1361344305398,1361344305398,1765685590,1765685590,0
1361348158,1769537988,1,46,46,1361348129415,1361348129415,1769509403,1769509403,0
1361349130,1770510068,1,46,46,1361349104233,1361349104233,1770484301,1770484301,0
1361349370,1770750280,1,46,46,1361349345550,1361349345550,1770725830,1770725830,0
1361349558,1770938768,1,46,46,1361349531430,1361349531430,1770912198,1770912198,0
1361349959,1771339084,2,122,61,1361349933643,1361349935819,1771313727,1771315903,2176
1361350881,1772261352,3,152,50.66666667,1361350855666,1361350864690,1772236018,1772245042,9024
1361352350,1773730620,1,46,46,1361352323087,1361352323087,1773703707,1773703707,0
1361353346,1774726136,1,48,48,1361353320164,1361353320164,1774700300,1774700300,0
1361354872,1776252304,2,122,61,1361354845410,1361354847778,1776225714,1776228082,2368
1361355397,1776777564,1,52,52,1361355371736,1361355371736,1776752300,1776752300,0
1361355554,1776934696,1,46,46,1361355525777,1361355525777,1776906473,1776906473,0
1361356964,1778344180,1,46,46,1361356935745,1361356935745,1778315925,1778315925,0
1361358126,1779506192,1,48,48,1361358099619,1361358099619,1779479811,1779479811,0
1361358126,1779506240,1,48,48,1361358098610,1361358098610,1779478850,1779478850,0
1361358380,1779760684,1,48,48,1361358352691,1361358352691,1779733375,1779733375,0
1361359440,1780820840,1,48,48,1361359412229,1361359412229,1780793069,1780793069,0
1361360418,1781798520,1,46,46,1361360390649,1361360390649,1781771169,1781771169,0
1361361635,1783015624,1,48,48,1361361608893,1361361608893,1782989517,1782989517,0
1361363050,1784430716,1,46,46,1361363023946,1361363023946,1784404662,1784404662,0
1361363116,1784496272,1,46,46,1361363087112,1361363087112,1784467384,1784467384,0
1361363287,1784667076,1,46,46,1361363259718,1361363259718,1784639794,1784639794,0
1361364930,1786310620,1,60,60,1361364903888,1361364903888,1786284508,1786284508,0
1361367423,1788803732,1,46,46,1361367396025,1361367396025,1788776757,1788776757,0
1361368300,1789680276,1,46,46,1361368271157,1361368271157,1789651433,1789651433,0
1361369091,1790471716,1,64,64,1361369063856,1361369063856,1790444572,1790444572,0
1361369585,1790965056,1,46,46,1361369559550,1361369559550,1790939606,1790939606,0
1361373298,1794677880,1,46,46,1361373273331,1361373273331,1794653211,1794653211,0
1361374810,1796190104,1,46,46,1361374782974,1361374782974,1796163078,1796163078,0
1361378619,1799999372,1,46,46,1361378593849,1361378593849,1799974221,1799974221,0
1361378619,1799999444,1,46,46,1361378593456,1361378593456,1799973900,1799973900,0
1361378742,1800122692,1,48,48,1361378714551,1361378714551,1800095243,1800095243,0
1361378881,1800261040,1,46,46,1361378852286,1361378852286,1800232326,1800232326,0
1361378952,1800331864,32,23330,729.0625,1361378924591,1361378939759,1800304455,1800319623,15168
1361378957,1800337108,56,72405,1292.946429,1361378945148,1361378953916,1800325256,1800334024,8768
1361378960,1800339904,31,7335,236.6129032,1361378934215,1361378958151,1800314119,1800338055,23936
1361378960,1800339904,5,356,71.2,1361378934342,1361378959046,1800314246,1800338950,24704
1361378960,1800339904,6,479,79.83333333,1361378934341,1361378959813,1800314245,1800339717,25472
1361378972,1800351888,1,46,46,1361378944150,1361378944150,1800324038,1800324038,0
1361378972,1800351976,2,104,52,1361378944125,1361378944573,1800324101,1800324549,448
1361378980,1800359988,31,22635,730.1612903,1361378954096,1361378978032,1800334084,1800358020,23936
1361378981,1800361036,3,421,140.3333333,1361378976961,1361378977025,1800356997,1800357061,64
1361378981,1800361040,2,92,46,1361378973823,1361378974847,1800353863,1800354887,1024
1361378981,1800361108,2,92,46,1361378973753,1361378974777,1800353861,1800354885,1024
1361378981,1800361116,104,138886,1335.442308,1361378969587,1361378976499,1800349703,1800356615,6912
1361378984,1800363948,2,178,89,1361378958488,1361378958744,1800338436,1800338692,256
1361378988,1800367888,1,94,94,1361378960532,1361378960532,1800340420,1800340420,0
1361378988,1800367892,6,449,74.83333333,1361378960848,1361378961424,1800340740,1800341316,576
1361378989,1800369084,383,537906,1404.454308,1361378969618,1361378983954,1800349702,1800364038,14336
1361378989,1800369100,5,480,96,1361378977793,1361378983937,1800357893,1800364037,6144
1361378989,1800369148,17,15259,897.5882353,1361378976275,1361378987731,1800356423,1800367879,11456
1361378989,1800369164,4,325,81.25,1361378977923,1361378981123,1800358087,1800361287,3200
1361378991,1800371844,109,151300,1388.073394,1361378672536,1361378685720,1800053380,1800066564,13184
1361378992,1800371932,6,1820,303.3333333,1361378967080,1361378976936,1800347012,1800356868,9856
1361378992,1800371932,6,1497,249.5,1361378967080,1361378972456,1800347012,1800352388,5376
1361378992,1800372024,8,1592,199,1361378966862,1361378972430,1800346886,1800352454,5568
1361378997,1800377180,2,92,46,1361378995120,1361378996144,1800375300,1800376324,1024
1361379005,1800385136,3,421,140.3333333,1361379004510,1361379004574,1800384646,1800384710,64
1361379008,1800388008,2,92,46,1361378982749,1361378984029,1800362757,1800364037,1280
1361379011,438705308,3,164,54.66666667,1361378988241,1361379003345,438682549,438697653,15104
1361379011,438705308,3,164,54.66666667,1361378988241,1361379003345,438682549,438697653,15104
1361379011,438705320,2,112,56,1361378988230,1361379003334,438682550,438697654,15104
1361379012,1800391908,1,46,46,1361378984128,1361378984128,1800364036,1800364036,0
1361379012,1800391984,1,46,46,1361378984054,1361378984054,1800364038,1800364038,0
1361379013,1800393068,57,72690,1275.263158,1361379004192,1361379008480,1800384260,1800388548,4288
1361379013,1800393072,37,44839,1211.864865,1361379004191,1361379008479,1800384263,1800388551,4288
1361379013,1800393072,64,74231,1159.859375,1361379004445,1361379010333,1800384517,1800390405,5888
1361379013,1800393072,41,44337,1081.390244,1361379004445,1361379009885,1800384517,1800389957,5440
1361379013,1800393076,11,6940,630.9090909,1361379004440,1361379008600,1800384516,1800388676,4160
1361379013,1800393076,69,83470,1209.710145,1361379004440,1361379009688,1800384516,1800389764,5248
1361379013,1800393076,44,47310,1075.227273,1361379004439,1361379009495,1800384515,1800389571,5056
1361379013,1800393076,6,3267,544.5,1361379004507,1361379008539,1800384583,1800388615,4032
1361379013,1800393124,12,9829,819.0833333,1361379004200,1361379008424,1800384324,1800388548,4224
1361379013,1800393148,46,51832,1126.782609,1361379004370,1361379010194,1800384518,1800390342,5824
1361379013,1800393148,12,9509,792.4166667,1361379004370,1361379008466,1800384518,1800388614,4096
1361379013,1800393148,45,46481,1032.911111,1361379004370,1361379012370,1800384518,1800392518,8000
1361379016,1800395932,22,19769,898.5909091,1361378988970,1361379006250,1800368902,1800386182,17280
1361379016,1800396008,9,6226,691.7777778,1361378988891,1361379005467,1800368899,1800385475,16576
1361379016,1800396008,58,37991,655.0172414,1361378990237,1361379015453,1800370245,1800395461,25216
1361379016,1800396020,2,92,46,1361378991378,1361378994002,1800371398,1800374022,2624
1361379020,438713480,8,7745,968.125,1361378993743,1361378993871,438687223,438687351,128
1361379020,1800399936,2,92,46,1361378992869,1361378994085,1800372805,1800374021,1216
1361379020,1800399936,2,92,46,1361378992869,1361378994085,1800372805,1800374021,1216
1361379020,1800399940,2,92,46,1361378993250,1361378994082,1800373190,1800374022,832
1361379020,1800399940,2,92,46,1361378993250,1361378994082,1800373190,1800374022,832
1361379020,1800399944,38,50111,1318.710526,1361378993694,1361378994014,1800373638,1800373958,320
1361379020,1800399944,15,12237,815.8,1361378993758,1361379006238,1800373702,1800386182,12480
1361379020,1800399944,14,16613,1186.642857,1361378993758,1361378994014,1800373702,1800373958,256
1361379020,1800399972,10,4694,469.4,1361378993983,1361378994495,1800373955,1800374467,512
1361379020,1800399972,9,2745,305,1361378993983,1361378994367,1800373955,1800374339,384
1361379020,1800399976,1,52,52,1361378994047,1361378994047,1800374023,1800374023,0
1361379020,1800399980,2,92,46,1361378994744,1361379004024,1800374724,1800384004,9280
1361379020,1800399984,2,92,46,1361378994803,1361379004083,1800374787,1800384067,9280
1361379020,1800400016,2,92,46,1361378992660,1361378994004,1800372676,1800374020,1344
1361379020,1800400016,2,92,46,1361378992660,1361378994004,1800372676,1800374020,1344
1361379020,1800400016,2,92,46,1361378992787,1361378994003,1800372803,1800374019,1216
1361379020,1800400020,2,92,46,1361378992787,1361378994003,1800372807,1800374023,1216
1361379020,1800400020,14,3314,236.7142857,1361378993041,1361378994193,1800373061,1800374213,1152
1361379020,1800400024,18,22896,1272,1361378993548,1361378993676,1800373572,1800373700,128
1361379020,1800400028,15,5011,334.0666667,1361378993864,1361378997192,1800373892,1800377220,3328
1361379020,1800400032,9,3086,342.8888889,1361378993987,1361378994307,1800374019,1800374339,320
1361379020,1800400056,2,92,46,1361378994222,1361379004014,1800374278,1800384070,9792
1361379021,1800401072,7,382,54.57142857,1361378997660,1361379016220,1800377732,1800396292,18560
1361379021,1800401104,2,92,46,1361379014781,1361379015101,1800394885,1800395205,320
1361379021,1800401104,2,92,46,1361379014781,1361379015869,1800394885,1800395973,1088
1361379021,1800401104,3,138,46,1361379014845,1361379015933,1800394949,1800396037,1088
1361379021,1800401104,3,138,46,1361379014844,1361379015868,1800394948,1800395972,1024
1361379021,1800401104,10,2649,264.9,1361379002044,1361379016188,1800382148,1800396292,14144
1361379021,1800401108,2,98,49,1361379015482,1361379020346,1800395590,1800400454,4864
1361379021,1800401156,2,92,46,1361379014728,1361379014984,1800394884,1800395140,256
1361379021,1800401156,3,138,46,1361379014792,1361379015048,1800394948,1800395204,256
1361379021,1800401156,2,92,46,1361379014728,1361379015048,1800394884,1800395204,320
1361379021,1800401156,2,92,46,1361379014728,1361379015048,1800394884,1800395204,320
1361379021,1800401156,3,138,46,1361379014728,1361379015880,1800394884,1800396036,1152
1361379021,1800401156,3,138,46,1361379014791,1361379015879,1800394947,1800396035,1088
1361379021,1800401160,3,138,46,1361379014791,1361379015879,1800394951,1800396039,1088
1361379021,1800401160,3,230,76.66666667,1361379015046,1361379015942,1800395206,1800396102,896
1361379024,1800403944,2,92,46,1361378997085,1361379004125,1800377029,1800384069,7040
1361379024,1800403944,2,92,46,1361378997085,1361379004125,1800377029,1800384069,7040
1361379024,1800404036,5,276,55.2,1361378997442,1361379002562,1800377478,1800382598,5120
1361379024,1800404064,2,92,46,1361378996581,1361379004005,1800376645,1800384069,7424
1361379027,438721320,2,112,56,1361379003846,1361379023302,438698166,438717622,19456
1361379027,438721320,3,164,54.66666667,1361379004037,1361379023301,438698357,438717621,19264
1361379027,438721320,2,112,56,1361379003845,1361379023301,438698165,438717621,19456
1361379027,438721320,2,112,56,1361379003845,1361379023301,438698165,438717621,19456
1361379027,438721320,2,112,56,1361379003845,1361379023301,438698165,438717621,19456
1361379027,438721328,8,744,93,1361379006080,1361379026752,438700408,438721080,20672
1361379027,438721332,2,112,56,1361379003834,1361379023290,438698166,438717622,19456
1361379027,438721332,2,112,56,1361379003834,1361379023290,438698166,438717622,19456
1361379027,438721332,3,164,54.66666667,1361379003834,1361379023290,438698166,438717622,19456
1361379027,438721332,2,112,56,1361379003834,1361379023290,438698166,438717622,19456
1361379027,438721332,3,164,54.66666667,1361379004026,1361379023290,438698358,438717622,19264
1361379027,438721404,8,744,93,1361379006003,1361379026675,438700407,438721079,20672
1361379027,438721404,9,957,106.3333333,1361379006003,1361379026739,438700407,438721143,20736
1361379028,1800407980,7,3047,435.2857143,1361379002106,1361379002298,1800382086,1800382278,192
1361379028,1800407988,7,2665,380.7142857,1361379003056,1361379003312,1800383044,1800383300,256
1361379028,1800408056,7,3047,435.2857143,1361379002094,1361379002222,1800382150,1800382278,128
1361379028,1800408056,6,2465,410.8333333,1361379002094,1361379002222,1800382150,1800382278,128
1361379028,1800408096,63,65634,1041.809524,1361379003525,1361379022661,1800383621,1800402757,19136
1361379029,1800409064,8,4289,536.125,1361379016228,1361379024548,1800396292,1800404612,8320
1361379029,1800409064,32,28427,888.34375,1361379016228,1361379027364,1800396292,1800407428,11136
1361379029,1800409068,3,172,57.33333333,1361379004512,1361379023968,1800384580,1800404036,19456
1361379029,1800409068,2,112,56,1361379004512,1361379023968,1800384580,1800404036,19456
1361379029,1800409068,3,164,54.66666667,1361379004575,1361379024031,1800384643,1800404099,19456
1361379029,1800409072,4,216,54,1361379004509,1361379024349,1800384581,1800404421,19840
1361379029,1800409072,2,112,56,1361379004509,1361379023965,1800384581,1800404037,19456
1361379029,1800409072,3,164,54.66666667,1361379004573,1361379024029,1800384645,1800404101,19456
1361379029,1800409072,3,421,140.3333333,1361379021724,1361379022556,1800401796,1800402628,832
1361379029,1800409072,11,2590,235.4545455,1361379004700,1361379028188,1800384772,1800408260,23488
1361379029,1800409072,10,4788,478.8,1361379020508,1361379024540,1800400580,1800404612,4032
1361379029,1800409104,10,1815,181.5,1361379006717,1361379028285,1800386821,1800408389,21568
1361379029,1800409104,10,1815,181.5,1361379006717,1361379028285,1800386821,1800408389,21568
1361379029,1800409144,20,4028,201.4,1361379016532,1361379022868,1800396676,1800403012,6336
1361379029,1800409144,10,2544,254.4,1361379020436,1361379026580,1800400580,1800406724,6144
1361379029,1800409144,7,2763,394.7142857,1361379020435,1361379026515,1800400579,1800406659,6080
1361379029,1800409148,3,164,54.66666667,1361379004434,1361379023890,1800384582,1800404038,19456
1361379029,1800409148,3,164,54.66666667,1361379004434,1361379023890,1800384582,1800404038,19456
1361379029,1800409148,3,164,54.66666667,1361379004434,1361379023890,1800384582,1800404038,19456
1361379029,1800409148,3,164,54.66666667,1361379004434,1361379024018,1800384582,1800404166,19584
1361379029,1800409148,3,164,54.66666667,1361379004498,1361379023954,1800384646,1800404102,19456
1361379029,1800409148,3,164,54.66666667,1361379004498,1361379023954,1800384646,1800404102,19456
1361379029,1800409148,3,164,54.66666667,1361379004498,1361379023954,1800384646,1800404102,19456
1361379029,1800409148,3,164,54.66666667,1361379004498,1361379023954,1800384646,1800404102,19456
1361379029,1800409148,10,4118,411.8,1361379020433,1361379024465,1800400581,1800404613,4032
1361379029,1800409148,13,11575,890.3846154,1361379020433,1361379026513,1800400581,1800406661,6080
1361379029,1800409148,11,2590,235.4545455,1361379004624,1361379028112,1800384772,1800408260,23488
1361379032,1800411936,1,46,46,1361379004131,1361379004131,1800384067,1800384067,0
1361379032,1800411940,4,2710,677.5,1361379004640,1361379005536,1800384580,1800385476,896
1361379032,1800411940,5,3130,626,1361379004640,1361379005600,1800384580,1800385540,960
1361379032,1800411984,11,6196,563.2727273,1361379006899,1361379024883,1800386883,1800404867,17984
1361379032,1800412008,5,887,177.4,1361379007580,1361379024476,1800387588,1800404484,16896
1361379032,1800412024,5,3082,616.4,1361379004556,1361379005452,1800384580,1800385476,896
1361379032,1800412028,5,3084,616.8,1361379004619,1361379005515,1800384647,1800385543,896
1361379032,1800412048,8,2688,336,1361379004790,1361379022326,1800384838,1800402374,17536
1361379032,1800412056,31,40605,1309.83871,1361379006766,1361379007022,1800386822,1800387078,256
1361379032,1800412056,5,610,122,1361379006830,1361379024110,1800386886,1800404166,17280
1361379037,1800417080,2,112,56,1361379021716,1361379033940,1800401796,1800414020,12224
1361379037,1800417080,5,292,58.4,1361379021716,1361379033940,1800401796,1800414020,12224
1361379037,1800417084,4,224,56,1361379020688,1361379033936,1800400772,1800414020,13248
1361379037,1800417112,2,624,312,1361379030773,1361379030773,1800410885,1800410885,0
1361379037,1800417112,2,112,56,1361379023219,1361379033907,1800403331,1800414019,10688
1361379037,1800417124,4,190,47.5,1361379028904,1361379028904,1800409028,1800409028,0
1361379037,1800417128,6,3035,505.8333333,1361379028965,1361379033893,1800409093,1800414021,4928
1361379037,1800417156,3,140,46.66666667,1361379021640,1361379033864,1800401796,1800414020,12224
1361379037,1800417160,7,404,57.71428571,1361379021638,1361379034886,1800401798,1800415046,13248
1361379037,1800417160,8,3291,411.375,1361379021638,1361379032134,1800401798,1800412294,10496
1361379040,1800419988,1,76,76,1361379014578,1361379014578,1800394566,1800394566,0
1361379044,1800423924,44,33055,751.25,1361379016048,1361379031664,1800395972,1800411588,15616
1361379045,1800425088,3,164,54.66666667,1361379024075,1361379043979,1800404163,1800424067,19904
1361379045,1800425088,3,172,57.33333333,1361379024075,1361379043979,1800404163,1800424067,19904
1361379045,1800425088,2,112,56,1361379024075,1361379043979,1800404163,1800424067,19904
1361379045,1800425092,2,112,56,1361379024075,1361379043979,1800404167,1800424071,19904
1361379045,1800425092,4,224,56,1361379024138,1361379043978,1800404230,1800424070,19840
1361379045,1800425092,4,224,56,1361379024138,1361379044042,1800404230,1800424134,19904
1361379045,1800425092,3,138,46,1361379037383,1361379043975,1800417475,1800424067,6592
1361379045,1800425100,3,152,50.66666667,1361379037634,1361379041858,1800417734,1800421958,4224
1361379045,1800425168,4,224,56,1361379023998,1361379043902,1800404166,1800424070,19904
1361379045,1800425168,4,232,58,1361379023998,1361379043902,1800404166,1800424070,19904
1361379045,1800425204,9,5984,664.8888889,1361379023002,1361379043098,1800403206,1800423302,20096
1361379048,1800427936,13,14450,1111.538462,1361379021734,1361379023590,1800401670,1800403526,1856
1361379048,1800427940,6,1547,257.8333333,1361379021859,1361379022691,1800401799,1800402631,832
1361379048,1800427968,14,15506,1107.571429,1361379020868,1361379021956,1800400836,1800401924,1088
1361379048,1800427976,9,4657,517.4444444,1361379022718,1361379023230,1800402694,1800403206,512
1361379048,1800427976,21,4251,202.4285714,1361379022908,1361379031804,1800402884,1800411780,8896
1361379048,1800428016,7,2252,321.7142857,1361379021779,1361379036627,1800401795,1800416643,14848
1361379048,1800428052,12,12526,1043.833333,1361379023153,1361379023793,1800403205,1800403845,640
1361379051,438745324,2,112,56,1361379023427,1361379043331,438717751,438737655,19904
1361379051,438745324,5,284,56.8,1361379023427,1361379043331,438717751,438737655,19904
1361379051,438745324,2,112,56,1361379023427,1361379043331,438717751,438737655,19904
1361379051,438745324,4,232,58,1361379024193,1361379043329,438718517,438737653,19136
1361379051,438745336,5,284,56.8,1361379023415,1361379043319,438717751,438737655,19904
1361379051,438745336,4,232,58,1361379023415,1361379043319,438717751,438737655,19904
1361379051,438745336,4,224,56,1361379023415,1361379043319,438717751,438737655,19904
1361379051,438745336,2,112,56,1361379023415,1361379043319,438717751,438737655,19904
1361379051,438745348,4,232,58,1361379024172,1361379043308,438718520,438737656,19136
1361379053,1800433128,3,156,52,1361379047718,1361379048550,1800427846,1800428678,832
1361379053,1800433176,2,104,52,1361379049652,1361379049908,1800429828,1800430084,256
1361379053,1800433212,3,156,52,1361379047634,1361379048338,1800427846,1800428550,704
1361379053,1800433212,3,156,52,1361379047634,1361379048530,1800427846,1800428742,896
1361379056,438749476,2,157,78.5,1361379028629,1361379032405,438722105,438725881,3776
1361379056,438749512,3,209,69.66666667,1361379028399,1361379032815,438721911,438726327,4416
1361379056,438749512,2,157,78.5,1361379028463,1361379032367,438721975,438725879,3904
1361379056,1800436000,1,52,52,1361379029030,1361379029030,1800409030,1800409030,0
1361379056,1800436000,1,46,46,1361379029030,1361379029030,1800409030,1800409030,0
1361379056,1800436000,1,52,52,1361379029030,1361379029030,1800409030,1800409030,0
1361379056,1800436080,1,46,46,1361379029141,1361379029141,1800409221,1800409221,0
1361379056,1800436092,1,46,46,1361379029770,1361379029770,1800409862,1800409862,0
1361379056,1800436120,3,1467,489,1361379028780,1361379028844,1800408900,1800408964,64
1361379056,1800436124,2,104,52,1361379030506,1361379033898,1800410630,1800414022,3392
1361379056,1800436132,2,104,52,1361379031457,1361379033889,1800411589,1800414021,2432
1361379060,1800439968,1,52,52,1361379032323,1361379032323,1800412291,1800412291,0
1361379060,1800439968,2,104,52,1361379032390,1361379032710,1800412358,1800412678,320
1361379060,1800440004,1,46,46,1361379033888,1361379033888,1800413892,1800413892,0
1361379060,1800440008,1,46,46,1361379034012,1361379034012,1800414020,1800414020,0
1361379060,1800440048,1,52,52,1361379032244,1361379032244,1800412292,1800412292,0
1361379060,1800440048,1,52,52,1361379032244,1361379032244,1800412292,1800412292,0
1361379060,1800440088,1,46,46,1361379033677,1361379033677,1800413765,1800413765,0
1361379060,1800440092,1,46,46,1361379033929,1361379033929,1800414021,1800414021,0
1361379060,1800440120,1,46,46,1361379034859,1361379034859,1800414979,1800414979,0
1361379061,1800441096,4,276,69,1361379053126,1361379053574,1800433222,1800433670,448
1361379061,1800441104,3,156,52,1361379052733,1361379053949,1800432837,1800434053,1216
1361379061,1800441168,2,112,56,1361379035963,1361379053883,1800416131,1800434051,17920
1361379061,1800441180,3,156,52,1361379052721,1361379053873,1800432901,1800434053,1152
1361379064,1800444040,6,2556,426,1361379035966,1361379059262,1800416006,1800439302,23296
1361379068,438761500,66,82607,1251.621212,1361379042428,1361379064572,438735928,438758072,22144
1361379068,1800447988,2,120,60,1361379041266,1361379065330,1800421254,1800445318,24064
1361379069,1800449100,3,150,50,1361379044226,1361379063938,1800424326,1800444038,19712
1361379072,1800451996,17,3175,186.7647059,1361379044201,1361379064745,1800424197,1800444741,20544
1361379072,1800451996,4,2309,577.25,1361379044391,1361379044583,1800424387,1800424579,192
1361379072,1800452000,4,2435,608.75,1361379044387,1361379044387,1800424387,1800424387,0
1361379072,1800452000,7,5163,737.5714286,1361379044390,1361379044518,1800424390,1800424518,128
1361379072,1800452088,7,5158,736.8571429,1361379044107,1361379044299,1800424195,1800424387,192
1361379072,1800452092,5,3012,602.4,1361379044298,1361379044490,1800424390,1800424582,192
1361379072,1800452092,9,7279,808.7777778,1361379044233,1361379064649,1800424325,1800444741,20416
1361379072,1800452092,4,2767,691.75,1361379044296,1361379044296,1800424388,1800424388,0
1361379072,1800452112,4,2890,722.5,1361379044277,1361379044469,1800424389,1800424581,192
1361379072,1800452152,2,104,52,1361379046669,1361379053901,1800426821,1800434053,7232
1361379076,1800456048,1,46,46,1361379051445,1361379051445,1800431493,1800431493,0
1361379076,1800456052,2,104,52,1361379051697,1361379054065,1800431749,1800434117,2368
1361379076,1800456064,1,46,46,1361379048997,1361379048997,1800429061,1800429061,0
1361379077,1800457120,35,42800,1222.857143,1361379068525,1361379073901,1800448645,1800454021,5376
1361379080,1800459980,1,52,52,1361379052279,1361379052279,1800432259,1800432259,0
1361379080,1800459988,36,24288,674.6666667,1361379053554,1361379070706,1800433542,1800450694,17152
1361379080,1800460016,1,46,46,1361379052948,1361379052948,1800432964,1800432964,0
1361379080,1800460020,1,52,52,1361379054033,1361379054033,1800434053,1800434053,0
1361379080,1800460100,1,52,52,1361379053951,1361379053951,1800434051,1800434051,0
1361379080,1800460104,1,52,52,1361379053947,1361379053947,1800434051,1800434051,0
1361379080,1800460104,1,52,52,1361379053946,1361379053946,1800434050,1800434050,0
1361379084,1800464208,1,46,46,1361379058837,1361379058837,1800439045,1800439045,0
1361379084,1800464208,2,104,52,1361379058773,1361379063957,1800438981,1800444165,5184
1361379085,1800465096,2,98,49,1361379064514,1361379083970,1800444610,1800464066,19456
1361379092,1800472012,3,1278,426,1361379064474,1361379089818,1800444486,1800469830,25344
1361379092,1800472092,4,496,124,1361379064521,1361379064585,1800444613,1800444677,64
1361379092,1800472104,1,60,60,1361379065661,1361379065661,1800445765,1800445765,0
1361379093,1800473140,51,64730,1269.215686,1361379081433,1361379092761,1800461573,1800472901,11328
1361379099,438793344,2,112,56,1361379078895,1361379093295,438773239,438787639,14400
1361379099,438793344,2,112,56,1361379078895,1361379093295,438773239,438787639,14400
1361379099,438793364,2,112,56,1361379078875,1361379093275,438773239,438787639,14400
1361379099,438793364,2,112,56,1361379078875,1361379093275,438773239,438787639,14400
1361379100,1800480024,943,1340584,1421.616119,1361378794830,1361378796494,1800174854,1800176518,1664
1361379101,1800481160,2,178,89,1361379099844,1361379099844,1800480004,1800480004,0
1361379101,1800481164,2,98,49,1361379080065,1361379093889,1800460229,1800474053,13824
1361379101,1800481168,2,112,56,1361379080572,1361379093884,1800460740,1800474052,13312
1361379101,1800481168,2,98,49,1361379080572,1361379093884,1800460740,1800474052,13312
1361379101,1800481168,2,98,49,1361379080572,1361379093884,1800460740,1800474052,13312
1361379101,1800481168,2,98,49,1361379080572,1361379093884,1800460740,1800474052,13312
1361379101,1800481168,2,98,49,1361379080572,1361379093884,1800460740,1800474052,13312
1361379101,1800481168,2,98,49,1361379080572,1361379093884,1800460740,1800474052,13312
1361379101,1800481168,2,98,49,1361379080572,1361379093884,1800460740,1800474052,13312
1361379101,1800481168,2,98,49,1361379080572,1361379093884,1800460740,1800474052,13312
1361379101,1800481168,2,112,56,1361379080636,1361379093884,1800460804,1800474052,13248
1361379101,1800481168,2,112,56,1361379080572,1361379093884,1800460740,1800474052,13312
1361379101,1800481168,2,98,49,1361379080571,1361379093883,1800460739,1800474051,13312
1361379101,1800481168,2,98,49,1361379080571,1361379093883,1800460739,1800474051,13312
1361379101,1800481168,2,98,49,1361379080571,1361379093883,1800460739,1800474051,13312
1361379101,1800481168,2,98,49,1361379080571,1361379093883,1800460739,1800474051,13312
1361379101,1800481168,2,98,49,1361379080571,1361379093883,1800460739,1800474051,13312
1361379101,1800481168,2,112,56,1361379080635,1361379093883,1800460803,1800474051,13248
1361379101,1800481172,323,453771,1404.863777,1361379092727,1361379099639,1800472899,1800479811,6912
1361379101,1800481196,3,279,93,1361379093983,1361379094111,1800474179,1800474307,128
1361379101,1800481240,2,98,49,1361379080052,1361379093812,1800460292,1800474052,13760
1361379101,1800481244,3,421,140.3333333,1361379093166,1361379093614,1800473410,1800473858,448
1361379101,1800481244,2,98,49,1361379080495,1361379093807,1800460739,1800474051,13312
1361379101,1800481244,2,98,49,1361379080495,1361379093807,1800460739,1800474051,13312
1361379101,1800481244,2,98,49,1361379080495,1361379093807,1800460739,1800474051,13312
1361379101,1800481244,2,98,49,1361379080495,1361379093807,1800460739,1800474051,13312
1361379101,1800481244,2,98,49,1361379080495,1361379093807,1800460739,1800474051,13312
1361379101,1800481244,2,98,49,1361379080495,1361379093807,1800460739,1800474051,13312
1361379101,1800481244,2,98,49,1361379080495,1361379093807,1800460739,1800474051,13312
1361379101,1800481244,2,98,49,1361379080495,1361379093807,1800460739,1800474051,13312
1361379101,1800481244,2,98,49,1361379080494,1361379093806,1800460738,1800474050,13312
1361379101,1800481244,2,98,49,1361379080494,1361379093806,1800460738,1800474050,13312
1361379101,1800481244,2,98,49,1361379080494,1361379093806,1800460738,1800474050,13312
1361379101,1800481244,2,112,56,1361379080558,1361379093806,1800460802,1800474050,13248
1361379104,1800484124,4,799,199.75,1361379079719,1361379089703,1800459843,1800469827,9984
1361379104,1800484208,8,1592,199,1361379079508,1361379089684,1800459716,1800469892,10176
1361379109,1800489148,3,140,46.66666667,1361379093458,1361379107666,1800473606,1800487814,14208
1361379109,1800489148,18,15214,845.2222222,1361379092496,1361379106000,1800472644,1800486148,13504
1361379109,1800489148,4,216,54,1361379092496,1361379105808,1800472644,1800485956,13312
1361379109,1800489248,4,434,108.5,1361379093806,1361379101358,1800474054,1800481606,7552
1361379112,1800492116,2,104,52,1361379083822,1361379093934,1800463938,1800474050,10112
1361379116,1800496176,14,11564,826,1361379090482,1361379090738,1800470658,1800470914,256
1361379117,1800497176,4,208,52,1361379113589,1361379115637,1800493765,1800495813,2048
1361379117,1800497176,4,208,52,1361379113460,1361379115188,1800493636,1800495364,1728
1361379117,1800497176,4,208,52,1361379113587,1361379115699,1800493763,1800495875,2112
1361379117,1800497200,4,208,52,1361379113883,1361379116059,1800494083,1800496259,2176
1361379117,1800497248,4,208,52,1361379113964,1361379116076,1800494212,1800496324,2112
1361379117,1800497248,4,208,52,1361379113964,1361379115948,1800494212,1800496196,1984
1361379117,1800497248,4,208,52,1361379113962,1361379116074,1800494210,1800496322,2112
1361379120,1800500032,1,426,426,1361379093126,1361379093126,1800473158,1800473158,0
1361379125,1800505140,3,156,52,1361379115993,1361379120729,1800496133,1800500869,4736
1361379125,1800505140,2,104,52,1361379117144,1361379121048,1800497284,1800501188,3904
1361379125,1800505148,2,104,52,1361379118030,1361379122702,1800498178,1800502850,4672
1361379125,1800505152,2,104,52,1361379118540,1361379123276,1800498692,1800503428,4736
1361379125,1800505152,2,104,52,1361379118540,1361379123468,1800498692,1800503620,4928
1361379125,1800505152,2,104,52,1361379118348,1361379122956,1800498500,1800503108,4608
1361379125,1800505172,2,104,52,1361379118584,1361379123384,1800498756,1800503556,4800
1361379125,1800505224,2,104,52,1361379110020,1361379118276,1800490244,1800498500,8256
1361379125,1800505224,2,104,52,1361379110147,1361379118851,1800490371,1800499075,8704
1361379125,1800505224,2,104,52,1361379118083,1361379122947,1800498307,1800503171,4864
1361379133,1800513144,5,260,52,1361379125397,1361379129621,1800505541,1800509765,4224
1361379133,1800513152,2,92,46,1361379113676,1361379125644,1800493828,1800505796,11968
1361379133,1800513224,4,184,46,1361379129474,1361379131074,1800509698,1800511298,1600
1361379140,1800520048,1,60,60,1361379113907,1361379113907,1800493955,1800493955,0
1361379141,1800521156,2,92,46,1361379132935,1361379136647,1800513091,1800516803,3712
1361379141,1800521200,2,104,52,1361379126938,1361379139546,1800507138,1800519746,12608
1361379149,1800529152,2,104,52,1361379128907,1361379144523,1800509059,1800524675,15616
1361379149,1800529200,4,289,72.25,1361379144155,1361379146395,1800524355,1800526595,2240
1361379149,1800529228,119,144120,1211.092437,1361378988733,1361379146557,1800368961,1800526785,157824
1361379149,1800529228,2,104,52,1361379134079,1361379143039,1800514307,1800523267,8960
1361379157,1800537160,2,104,52,1361379132100,1361379150788,1800512260,1800530948,18688
1361379157,1800537160,2,104,52,1361379133315,1361379152963,1800513475,1800533123,19648
1361379157,1800537208,2,104,52,1361379132949,1361379152213,1800513157,1800532421,19264
1361379157,1800537208,2,104,52,1361379132051,1361379150355,1800512259,1800530563,18304
1361379157,1800537236,2,158,79,1361379149367,1361379155383,1800529603,1800535619,6016
1361379157,1800537236,2,104,52,1361379132662,1361379152182,1800512898,1800532418,19520
1361379157,1800537240,2,104,52,1361379132721,1361379151729,1800512961,1800531969,19008
1361379157,1800537240,6,312,52,1361379149428,1361379153524,1800529668,1800533764,4096
1361379157,1800537244,2,104,52,1361379149742,1361379156142,1800529986,1800536386,6400
1361379157,1800537280,3,138,46,1361379154637,1361379155725,1800534917,1800536005,1088
1361379160,1800540224,1,52,52,1361379134788,1361379134788,1800515012,1800515012,0
1361379164,1800544188,1,52,52,1361379136359,1361379136359,1800516547,1800516547,0
1361379165,1800545160,2,92,46,1361379157379,1361379160451,1800537539,1800540611,3072
1361379165,1800545208,2,92,46,1361379143954,1361379158738,1800524162,1800538946,14784
1361379173,1800553160,2,104,52,1361379157828,1361379166340,1800537988,1800546500,8512
1361379176,1800556144,1,46,46,1361379149652,1361379149652,1800529796,1800529796,0
1361379181,1800561172,2,92,46,1361379166518,1361379178742,1800546690,1800558914,12224
1361379188,1800568236,1,52,52,1361379161079,1361379161079,1800541315,1800541315,0
1361379192,1800572128,1,52,52,1361379164835,1361379164835,1800544963,1800544963,0
1361379192,1800572248,2,158,79,1361379167337,1361379191337,1800547585,1800571585,24000
1361379196,1800576384,2,104,52,1361379168865,1361379194529,1800549249,1800574913,25664
1361379200,1800580564,1,52,52,1361379175407,1361379175407,1800555971,1800555971,0
1361379208,1800588620,1,52,52,1361379182839,1361379182839,1800563459,1800563459,0
1361379212,1800592560,1,52,52,1361379186611,1361379186611,1800567171,1800567171,0
1361379216,1800596472,1,46,46,1361379187980,1361379187980,1800568452,1800568452,0
1361379216,1800596516,1,52,52,1361379190368,1361379190368,1800570884,1800570884,0
1361379216,1800596552,1,52,52,1361379187834,1361379187834,1800568386,1800568386,0
1361379216,1800596584,1,52,52,1361379189400,1361379189400,1800569984,1800569984,0
1361379216,1800596624,1,52,52,1361379190770,1361379190770,1800571394,1800571394,0
1361379220,1800600552,1,52,52,1361379191868,1361379191868,1800572420,1800572420,0
1361379224,1800604472,1,52,52,1361379196874,1361379196874,1800577346,1800577346,0
1361379224,1800604588,1,46,46,1361379197271,1361379197271,1800577859,1800577859,0
1361379228,1800608608,1,46,46,1361379202625,1361379202625,1800583233,1800583233,0
1361379240,1800620520,1,52,52,1361379214873,1361379214873,1800595393,1800595393,0
1361379246,1800626320,6,531,88.5,1361379241952,1361379243616,1800622272,1800623936,1664
1361379246,1800626320,6,531,88.5,1361379241954,1361379243618,1800622274,1800623938,1664
1361379246,1800626324,105,89716,854.4380952,1361379001823,1361379244639,1800382147,1800624963,242816
1361379246,1800626328,6,597,99.5,1361379242906,1361379244570,1800623234,1800624898,1664
1361379246,1800626364,6,531,88.5,1361379241908,1361379243572,1800622272,1800623936,1664
1361379253,1800633184,3,138,46,1361379249129,1361379252201,1800629313,1800632385,3072
1361379264,1800644704,1,79,79,1361379238881,1361379238881,1800619585,1800619585,0
1361379269,1800649232,2,92,46,1361379267578,1361379268602,1800647810,1800648834,1024
1361379269,1800649232,2,92,46,1361379256121,1361379264185,1800636353,1800644417,8064
1361379272,1800652584,4,404,101,1361379245274,1361379266714,1800625858,1800647298,21440
1361379272,1800652584,4,404,101,1361379245273,1361379266777,1800625857,1800647361,21504
1361379272,1800652616,1,113,113,1361379246202,1361379246202,1800626818,1800626818,0
1361379272,1800652656,6,606,101,1361379244817,1361379270225,1800625473,1800650881,25408
1361379272,1800652684,4,404,101,1361379245172,1361379266740,1800625856,1800647424,21568
1361379272,1800652688,1,52,52,1361379245616,1361379245616,1800626304,1800626304,0
1361379276,1800656616,1,46,46,1361379251384,1361379251384,1800632000,1800632000,0
1361379277,1800657196,4,184,46,1361379269726,1361379276766,1800649922,1800656962,7040
1361379277,1800657276,2,92,46,1361379270543,1361379274575,1800650819,1800654851,4032
1361379285,1800665252,2,92,46,1361379283748,1361379284772,1800664000,1800665024,1024
1361379285,1800665252,3,156,52,1361379275876,1361379279204,1800656128,1800659456,3328
1361379285,1800665260,4,184,46,1361379276508,1361379283548,1800656768,1800663808,7040
1361379285,1800665324,4,184,46,1361379275998,1361379283102,1800656322,1800663426,7104
1361379288,1800668608,7,623,89,1361379260801,1361379271425,1800641409,1800652033,10624
1361379288,1800668720,8,736,92,1361379261715,1361379287379,1800642435,1800668099,25664
1361379293,1800673212,3,138,46,1361379289167,1361379292239,1800669379,1800672451,3072
1361379293,1800673216,2,92,46,1361379286792,1361379290824,1800667008,1800671040,4032
1361379293,1800673280,3,138,46,1361379289098,1361379292170,1800669378,1800672450,3072
1361379304,1800684588,1,101,101,1361379276758,1361379276758,1800657346,1800657346,0
1361379304,1800684588,1,101,101,1361379276820,1361379276820,1800657408,1800657408,0
1361379304,1800684664,1,101,101,1361379276682,1361379276682,1800657346,1800657346,0
1361379308,1800688652,1,46,46,1361379282260,1361379282260,1800662912,1800662912,0
1361379308,1800688704,1,101,101,1361379280159,1361379280159,1800660863,1800660863,0
1361379309,1800689264,2,92,46,1361379296216,1361379304216,1800676480,1800684480,8000
1361379309,1800689332,2,92,46,1361379296147,1361379304147,1800676479,1800684479,8000
1361379312,1800692632,1,46,46,1361379284328,1361379284328,1800664960,1800664960,0
1361379316,1800696644,1,46,46,1361379290781,1361379290781,1800671425,1800671425,0
1361379316,1800696728,1,46,46,1361379291143,1361379291143,1800671871,1800671871,0
1361379320,1800700624,1,46,46,1361379293232,1361379293232,1800673856,1800673856,0
1361379324,1800704680,1,46,46,1361379296824,1361379296824,1800677504,1800677504,0
1361379324,1800704684,3,276,92,1361379297395,1361379317363,1800678079,1800698047,19968
1361379324,1800704716,1,46,46,1361379298388,1361379298388,1800679104,1800679104,0
1361379332,1800712640,1,46,46,1361379305375,1361379305375,1800686015,1800686015,0
1361379333,1800713272,5,484,96.8,1361379330640,1361379332240,1800710912,1800712512,1600
1361379341,1800721328,3,156,52,1361379332823,1361379336279,1800713151,1800716607,3456
1361379353,1800732900,3,276,92,1361379328197,1361379348165,1800708097,1800728065,19968
1361379361,1800740936,1,113,113,1361379334688,1361379334688,1800714624,1800714624,0
1361379385,1800764936,2,184,92,1361379358112,1361379368160,1800738048,1800748096,10048
1361379500,439193644,3,156,52,1361379493615,1361379494319,439187259,439187963,704
1361379525,1800905596,4,367,91.75,1361379523209,1361379524233,1800903805,1800904829,1024
1361379525,1800905628,2,104,52,1361379521191,1361379522215,1800901819,1800902843,1024
1361379525,1800905636,3,156,52,1361379522528,1361379524128,1800903164,1800904764,1600
1361379553,1800933368,4,420,105,1361379525868,1361379545068,1800906236,1800925436,19200
1361379572,439265644,2,104,52,1361379564400,1361379566128,439258044,439259772,1728
1361379593,1800973492,1,105,105,1361379566895,1361379566895,1800947387,1800947387,0
1361379637,1801017596,1,105,105,1361379610631,1361379610631,1800991227,1800991227,0
1361379894,1801274360,1,48,48,1361379865905,1361379865905,1801246265,1801246265,0
1361380152,1801532612,1,48,48,1361380126449,1361380126449,1801507061,1801507061,0
1361380154,1801534560,1,48,48,1361380126627,1361380126627,1801507187,1801507187,0
1361380296,1801676356,3,156,52,1361380294958,1361380295662,1801675314,1801676018,704
1361380304,1801684356,3,156,52,1361380296685,1361380302573,1801677041,1801682929,5888
1361380328,1801708344,2,104,52,1361380310522,1361380320506,1801690866,1801700850,9984
1361380355,1801735756,1,52,52,1361380330077,1361380330077,1801710833,1801710833,0
1361380460,1801840192,1,56,56,1361380432271,1361380432271,1801812463,1801812463,0
1361380761,1802141388,3,156,52,1361380758536,1361380760136,1802138924,1802140524,1600
1361380769,1802149256,2,104,52,1361380762444,1361380766796,1802142700,1802147052,4352
1361380769,1802149296,3,156,52,1361380759011,1361380764195,1802139307,1802144491,5184
1361380785,1802165352,2,104,52,1361380771051,1361380781099,1802151403,1802161451,10048
1361380793,1802173344,2,104,52,1361380775345,1361380785393,1802155689,1802165737,10048
1361380809,1802189308,2,104,52,1361380791126,1361380801110,1802171434,1802181418,9984
1361380821,1802201056,1,52,52,1361380795667,1361380795667,1802175723,1802175723,0
1361381057,1802437772,1,46,46,1361381031170,1361381031170,1802411942,1802411942,0
1361381258,1802638440,1,46,46,1361381232140,1361381232140,1802612580,1802612580,0
1361381707,1803087700,1,46,46,1361381680511,1361381680511,1803061211,1803061211,0
1361381751,1803131792,1,46,46,1361381725794,1361381725794,1803106586,1803106586,0
1361382750,1804130620,1,46,46,1361382722370,1361382722370,1804102990,1804102990,0
1361383292,1804672176,1,78,78,1361383265077,1361383265077,1804645253,1804645253,0
1361383344,1804724568,1,46,46,1361383319339,1361383319339,1804699907,1804699907,0
1361385012,1806391892,1,48,48,1361384985783,1361384985783,1806365675,1806365675,0
1361385856,1807236724,1,48,48,1361385826537,1361385826537,1807207261,1807207261,0
1361387633,447327112,1,46,46,1361387605904,1361387605904,447300016,447300016,0
1361388487,1809867388,3,152,50.66666667,1361388459536,1361388468560,1809839924,1809848948,9024
1361388575,1809955788,2,96,48,1361388549953,1361388552897,1809930741,1809933685,2944
1361389721,1811101244,1,46,46,1361389694735,1361389694735,1811074979,1811074979,0
1361390753,1812133452,1,68,68,1361390725423,1361390725423,1812105875,1812105875,0
1361391937,1813317296,1,68,68,1361391910519,1361391910519,1813290815,1813290815,0
1361392029,1813409468,1,68,68,1361392004620,1361392004620,1813385088,1813385088,0
1361392421,1813801712,2,122,61,1361392395732,1361392398164,1813776444,1813778876,2432
1361392454,1813833972,1,46,46,1361392428790,1361392428790,1813808762,1813808762,0
1361392895,1814275084,1,68,68,1361392868608,1361392868608,1814248692,1814248692,0
1361393075,1814455008,1,447,447,1361393048456,1361393048456,1814428464,1814428464,0
1361393612,1814992212,2,96,48,1361393586482,1361393589426,1814966694,1814969638,2944
1361394133,1815513500,1,48,48,1361394108429,1361394108429,1815488929,1815488929,0
1361394826,1816206792,1,68,68,1361394800476,1361394800476,1816181268,1816181268,0
1361395359,1816739632,1,68,68,1361395331446,1361395331446,1816712078,1816712078,0
1361395500,1816880064,2,96,48,1361395473450,1361395476458,1816853514,1816856522,3008
1361395689,1817069108,1,68,68,1361395662589,1361395662589,1817042697,1817042697,0
1361397461,1818841420,1,68,68,1361397434409,1361397434409,1818814829,1818814829,0
1361397621,1819001664,1,46,46,1361397592884,1361397592884,1818973548,1818973548,0
1361397858,1819238192,1,68,68,1361397831688,1361397831688,1819211880,1819211880,0
1361398019,1819398860,2,128,64,1361397992465,1361397995537,1819372325,1819375397,3072
1361398512,1819892224,2,122,61,1361398487644,1361398490076,1819867868,1819870300,2432
1361399154,1820534300,1,68,68,1361399128520,1361399128520,1820508820,1820508820,0
1361399783,1821163384,1,68,68,1361399755115,1361399755115,1821135499,1821135499,0
1361400586,1821966128,1,46,46,1361400559327,1361400559327,1821939455,1821939455,0
1361400642,1822022308,1,68,68,1361400615530,1361400615530,1821995838,1821995838,0
1361401237,1822617604,1,46,46,1361401208951,1361401208951,1822589555,1822589555,0
1361402029,1823409112,1,68,68,1361402003161,1361402003161,1823383273,1823383273,0
1361405917,1827297500,2,122,61,1361405891291,1361405893595,1827271791,1827274095,2304
1361407714,1829094288,1,52,52,1361407688467,1361407688467,1829068755,1829068755,0
1361407721,1829101404,1,48,48,1361407693790,1361407693790,1829074194,1829074194,0
1361412636,1834016676,1,48,48,1361412608963,1361412608963,1833989639,1833989639,0
1361412684,1834063800,1,48,48,1361412656624,1361412656624,1834036424,1834036424,0
1361413519,1834899660,5,250,50,1361413494789,1361413516293,1834875449,1834896953,21504
1361413568,1834947920,1,48,48,1361413541416,1361413541416,1834921336,1834921336,0
1361413596,1834975856,1,48,48,1361413570600,1361413570600,1834950456,1834950456,0
1361414287,1835666896,1,46,46,1361414260214,1361414260214,1835640110,1835640110,0
1361414546,1835926732,1,46,46,1361414518382,1361414518382,1835899114,1835899114,0
1361419283,1840663448,1,46,46,1361419255618,1361419255618,1840636066,1840636066,0
1361419767,1841147224,1,46,46,1361419741212,1361419741212,1841121436,1841121436,0
1361419835,1841215160,1,46,46,1361419807130,1361419807130,1841187290,1841187290,0
1361423025,1844405172,1,60,60,1361422999326,1361422999326,1844379498,1844379498,0
1361424059,483752640,1,46,46,1361424033367,1361424033367,483727007,483727007,0
1361424249,1845629088,1,46,46,1361424222623,1361424222623,1845602711,1845602711,0
1361424696,1846075896,1,46,46,1361424667739,1361424667739,1846047635,1846047635,0
1361425445,1846825324,1,442,442,1361425417378,1361425417378,1846797702,1846797702,0
1361425445,1846825324,1,442,442,1361425417442,1361425417442,1846797766,1846797766,0
1361425445,1846825324,1,442,442,1361425417442,1361425417442,1846797766,1846797766,0
1361425445,1846825324,1,442,442,1361425417441,1361425417441,1846797765,1846797765,0
1361425445,1846825324,1,442,442,1361425417441,1361425417441,1846797765,1846797765,0
1361425445,1846825324,1,442,442,1361425417505,1361425417505,1846797829,1846797829,0
1361425445,1846825324,1,440,440,1361425417441,1361425417441,1846797765,1846797765,0
1361425445,1846825324,1,442,442,1361425417505,1361425417505,1846797829,1846797829,0
1361425445,1846825324,1,442,442,1361425417505,1361425417505,1846797829,1846797829,0
1361425445,1846825324,1,442,442,1361425417504,1361425417504,1846797828,1846797828,0
1361425445,1846825328,1,442,442,1361425417436,1361425417436,1846797764,1846797764,0
1361425445,1846825328,1,442,442,1361425417500,1361425417500,1846797828,1846797828,0
1361425445,1846825328,1,442,442,1361425417504,1361425417504,1846797832,1846797832,0
1361425445,1846825328,1,442,442,1361425417504,1361425417504,1846797832,1846797832,0
1361425445,1846825328,1,442,442,1361425417503,1361425417503,1846797831,1846797831,0
1361425445,1846825328,1,442,442,1361425417503,1361425417503,1846797831,1846797831,0
1361425445,1846825328,1,441,441,1361425417503,1361425417503,1846797831,1846797831,0
1361425445,1846825440,1,442,442,1361425417262,1361425417262,1846797702,1846797702,0
1361425445,1846825440,1,442,442,1361425417326,1361425417326,1846797766,1846797766,0
1361425445,1846825440,1,438,438,1361425417326,1361425417326,1846797766,1846797766,0
1361425445,1846825440,1,441,441,1361425417326,1361425417326,1846797766,1846797766,0
1361425445,1846825440,1,443,443,1361425417261,1361425417261,1846797701,1846797701,0
1361425445,1846825440,1,440,440,1361425417261,1361425417261,1846797701,1846797701,0
1361425445,1846825440,1,442,442,1361425417325,1361425417325,1846797765,1846797765,0
1361425445,1846825440,1,442,442,1361425417388,1361425417388,1846797828,1846797828,0
1361425445,1846825444,1,442,442,1361425417320,1361425417320,1846797764,1846797764,0
1361425445,1846825444,1,442,442,1361425417320,1361425417320,1846797764,1846797764,0
1361425445,1846825444,1,440,440,1361425417388,1361425417388,1846797832,1846797832,0
1361425445,1846825444,1,442,442,1361425417387,1361425417387,1846797831,1846797831,0
1361425445,1846825444,1,442,442,1361425417451,1361425417451,1846797895,1846797895,0
1361426988,1848368492,1,92,92,1361426960995,1361426960995,1848341487,1848341487,0
1361427349,1848729072,1,46,46,1361427321216,1361427321216,1848701288,1848701288,0
1361432520,1853900672,1,46,46,1361432491675,1361432491675,1853872347,1853872347,0
1361434328,1855707712,1,46,46,1361434303678,1361434303678,1855683390,1855683390,0
1361435400,1856779896,1,48,48,1361435372406,1361435372406,1856752302,1856752302,0
1361435655,1857035164,1,46,46,1361435626794,1361435626794,1857006958,1857006958,0
1361435956,1857335816,1,46,46,1361435930494,1361435930494,1857310310,1857310310,0
1361437410,1858790520,1,46,46,1361437381801,1361437381801,1858762321,1858762321,0
1361437715,1859094696,1,445,445,1361437688028,1361437688028,1859067724,1859067724,0
1361437763,1859142980,2,96,48,1361437735105,1361437738049,1859115085,1859118029,2944
1361439730,1861110344,1,46,46,1361439702712,1361439702712,1861083056,1861083056,0
1361441990,1863370484,1,60,60,1361441964039,1361441964039,1863344523,1863344523,0
1361443762,1865141732,1,46,46,1361443735775,1361443735775,1865115507,1865115507,0
1361444163,1865542880,1,46,46,1361444135429,1361444135429,1865515309,1865515309,0
1361444215,1865594908,1,46,46,1361444188711,1361444188711,1865568619,1865568619,0
1361444505,1865885064,1,60,60,1361444477445,1361444477445,1865857509,1865857509,0
1361445987,1867367360,4,202,50.5,1361445961736,1361445971016,1867342096,1867351376,9280
1361447775,1869154820,1,60,60,1361447749834,1361447749834,1869129654,1869129654,0
1361450649,510342524,1,48,48,1361450623289,1361450623289,510316813,510316813,0
1361450697,1872076840,1,46,46,1361450670088,1361450670088,1872049928,1872049928,0
1361450821,1872200948,1,64,64,1361450792924,1361450792924,1872172872,1872172872,0
1361451181,1872561556,1,46,46,1361451153077,1361451153077,1872533633,1872533633,0
1361451459,1872839336,1,46,46,1361451432974,1361451432974,1872813310,1872813310,0
1361451510,1872889812,1,46,46,1361451479959,1361451479959,1872859771,1872859771,0
1361452307,1873686624,1,48,48,1361452279561,1361452279561,1873659185,1873659185,0
1361452720,1874100320,1,46,46,1361452693517,1361452693517,1874073837,1874073837,0
1361453617,1874997424,1,46,46,1361453592726,1361453592726,1874973150,1874973150,0
1361454074,1875453776,2,104,52,1361454049624,1361454052696,1875429400,1875432472,3072
1361454434,1875813624,1,48,48,1361454404778,1361454404778,1875784402,1875784402,0
1361454976,1876356208,1,437,437,1361454950937,1361454950937,1876331145,1876331145,0
1361457628,1879008424,3,180,60,1361457600539,1361457609563,1878980963,1878989987,9024
1361460423,1881802652,1,46,46,1361460395313,1361460395313,1881774965,1881774965,0
1361460423,1881802652,1,46,46,1361460395634,1361460395634,1881775286,1881775286,0
1361460610,1881989596,1,48,48,1361460582569,1361460582569,1881962165,1881962165,0
1361461132,1882511644,1,46,46,1361461107313,1361461107313,1882486957,1882486957,0
1361461464,1882844132,1,64,64,1361461436676,1361461436676,1882816808,1882816808,0
1361462983,1884362728,1,48,48,1361462956096,1361462956096,1884335824,1884335824,0
1361464479,1885859456,1,64,64,1361464451793,1361464451793,1885832249,1885832249,0
1361465279,1886659176,1,48,48,1361465250846,1361465250846,1886631022,1886631022,0
1361465280,1886659748,1,48,48,1361465251595,1361465251595,1886631343,1886631343,0
1361465995,1887374920,1,52,52,1361465969683,1361465969683,1887349603,1887349603,0
1361465999,1887379484,1,52,52,1361465971358,1361465971358,1887351842,1887351842,0
1361466062,1887442320,1,52,52,1361466033540,1361466033540,1887413860,1887413860,0
1361466063,1887442792,1,52,52,1361466036500,1361466036500,1887416292,1887416292,0
1361466422,1887802168,1,64,64,1361466394263,1361466394263,1887774431,1887774431,0
1361466711,1888091040,1,64,64,1361466683791,1361466683791,1888063831,1888063831,0
1361467356,1888736236,1,48,48,1361467331458,1361467331458,1888711694,1888711694,0
1361468611,1889991272,1,64,64,1361468586125,1361468586125,1889966397,1889966397,0
1361470083,1891463228,6,298,49.66666667,1361470056352,1361470078240,1891436580,1891458468,21888
1361470127,1891507236,1,48,48,1361470102490,1361470102490,1891482726,1891482726,0
1361470159,1891539140,1,48,48,1361470132024,1361470132024,1891512164,1891512164,0
1361470684,1892064068,1,127,127,1361470657595,1361470657595,1892037663,1892037663,0
1361470740,1892120188,1,127,127,1361470712961,1361470712961,1892093149,1892093149,0
1361470764,1892144320,1,46,46,1361470738685,1361470738685,1892119005,1892119005,0
1361470788,1892168516,3,152,50.66666667,1361470763382,1361470772406,1892143898,1892152922,9024
1361470792,1892172372,3,152,50.66666667,1361470764615,1361470773767,1892144987,1892154139,9152
1361470792,1892172408,3,152,50.66666667,1361470765730,1361470774754,1892146138,1892155162,9024
1361470792,1892172408,3,152,50.66666667,1361470765731,1361470774755,1892146139,1892155163,9024
1361470852,1892232448,3,152,50.66666667,1361470826875,1361470835835,1892207323,1892216283,8960
1361470853,1892232612,1,46,46,1361470828414,1361470828414,1892208026,1892208026,0
1361470856,1892236424,3,152,50.66666667,1361470829075,1361470838099,1892209499,1892218523,9024
1361470856,1892236424,3,152,50.66666667,1361470829139,1361470838099,1892209563,1892218523,8960
1361470856,1892236500,3,152,50.66666667,1361470827912,1361470836936,1892208412,1892217436,9024
1361471045,1892425036,3,152,50.66666667,1361471018964,1361471025556,1892399000,1892405592,6592
1361471045,1892425044,3,152,50.66666667,1361471020042,1361471021194,1892400086,1892401238,1152
1361471045,1892425044,3,152,50.66666667,1361471020042,1361471029066,1892400086,1892409110,9024
1361471045,1892425084,3,152,50.66666667,1361471017826,1361471021346,1892397910,1892401430,3520
1361471045,1892425120,11,3246,295.0909091,1361471019134,1361471020542,1892399254,1892400662,1408
1361471049,1892429012,3,152,50.66666667,1361471024043,1361471025195,1892404055,1892405207,1152
1361471049,1892429080,3,152,50.66666667,1361471022822,1361471024038,1892402902,1892404118,1216
1361471053,1892433052,3,152,50.66666667,1361471025090,1361471026306,1892405142,1892406358,1216
1361471053,1892433140,3,152,50.66666667,1361471025004,1361471033964,1892405144,1892414104,8960
1361471289,1892669548,2,112,56,1361471261201,1361471261265,1892641749,1892641813,64
1361471318,1892697868,1,52,52,1361471291894,1361471291894,1892671762,1892671762,0
1361471582,1892961716,2,141,70.5,1361471578445,1361471578445,1892958161,1892958161,0
1361471602,1892982468,10,3194,319.4,1361471575515,1361471577755,1892955983,1892958223,2240
1361471894,1893273788,2,141,70.5,1361471890175,1361471890175,1893269963,1893269963,0
1361471915,1893295464,9,3142,349.1111111,1361471887322,1361471889562,1893267786,1893270026,2240
1361472188,1893568232,1,52,52,1361472160767,1361472160767,1893540999,1893540999,0
1361472206,1893586020,2,141,70.5,1361472202193,1361472202193,1893582213,1893582213,0
1361472228,1893608252,11,3246,295.0909091,1361472200555,1361472202155,1893580807,1893582407,1600
1361472814,1894193996,12,3310,275.8333333,1361472788895,1361472792031,1894168891,1894172027,3136
1361472818,1894198020,2,141,70.5,1361472792010,1361472792010,1894172030,1894172030,0
1361472878,1894258544,2,141,70.5,1361472874366,1361472874366,1894254910,1894254910,0
1361472898,1894278452,11,3246,295.0909091,1361472873304,1361472874520,1894253756,1894254972,1216
1361473191,1894571420,2,141,70.5,1361473188082,1361473188082,1894568502,1894568502,0
1361473215,1894595200,11,3246,295.0909091,1361473186958,1361473188430,1894567158,1894568630,1472
1361473488,1894868080,1,60,60,1361473461316,1361473461316,1894841396,1894841396,0
1361473521,1894900944,1,46,46,1361473493706,1361473493706,1894873650,1894873650,0
1361473525,1894904604,1,46,46,1361473498974,1361473498974,1894878578,1894878578,0
1361473797,1895176888,1,60,60,1361473771775,1361473771775,1895151663,1895151663,0
1361475717,1897097180,9,3318,368.6666667,1361475689854,1361475711230,1897070034,1897091410,21376
1361476078,1897457716,1,64,64,1361476052039,1361476052039,1897431755,1897431755,0
1361476771,1898151544,1,46,46,1361476743681,1361476743681,1898124225,1898124225,0
1361476965,1898345400,1,46,46,1361476936783,1361476936783,1898317183,1898317183,0
1361476966,1898345892,2,122,61,1361476939148,1361476941452,1898319040,1898321344,2304
1361476966,1898346172,1,46,46,1361476936115,1361476936115,1898316287,1898316287,0
1361478905,1900285160,1,46,46,1361478877857,1361478877857,1900258017,1900258017,0
1361479022,1900401944,3,150,50,1361479007671,1361479017655,1900387615,1900397599,9984
1361479046,1900425696,1,46,46,1361479018802,1361479018802,1900398498,1900398498,0
1361479294,1900674328,1,46,46,1361479265974,1361479265974,1900646302,1900646302,0
1361480634,1902014520,1,46,46,1361480606624,1361480606624,1901987144,1901987144,0
1361480635,1902015260,1,46,46,1361480605667,1361480605667,1901985927,1901985927,0
1361482043,1903423440,1,46,46,1361482017434,1361482017434,1903397874,1903397874,0
1361482864,1904244096,1,48,48,1361482835496,1361482835496,1904215592,1904215592,0
1361483892,1905271828,1,60,60,1361483867365,1361483867365,1905247193,1905247193,0
1361487554,1908933544,1,88,88,1361487529225,1361487529225,1908908769,1908908769,0
1361488863,1910243180,1,46,46,1361488833591,1361488833591,1910213771,1910213771,0
1361489459,1910839252,1,48,48,1361489432678,1361489432678,1910812930,1910812930,0
1361492160,1913540236,1,46,46,1361492135695,1361492135695,1913515931,1913515931,0
1361492228,1913608292,1,46,46,1361492203289,1361492203289,1913583581,1913583581,0
1361492256,1913636340,1,46,46,1361492228328,1361492228328,1913608668,1913608668,0
1361495836,1917215628,1,48,48,1361495810169,1361495810169,1917189797,1917189797,0
1361495976,1917356012,1,60,60,1361495950007,1361495950007,1917330019,1917330019,0
1361496060,1917440200,1,60,60,1361496033016,1361496033016,1917413216,1917413216,0
1361496080,1917460308,1,48,48,1361496052173,1361496052173,1917432481,1917432481,0
1361498266,1919645764,1,46,46,1361498238924,1361498238924,1919618688,1919618688,0
1361500415,1921794808,1,46,46,1361500389119,1361500389119,1921768927,1921768927,0
1361504502,1925881692,3,180,60,1361504473784,1361504476792,1925853476,1925856484,3008
1361505174,1926553836,1,46,46,1361505145244,1361505145244,1926525080,1926525080,0
1361509897,1931276532,2,122,61,1361509870086,1361509872454,1931249618,1931251986,2368
1361510047,1931427032,1,46,46,1361510021009,1361510021009,1931401041,1931401041,0
1361511881,1933261080,1,46,46,1361511853700,1361511853700,1933233780,1933233780,0
1361513563,1934942560,1,46,46,1361513536436,1361513536436,1934915996,1934915996,0
1361514379,1935759364,1,78,78,1361514353474,1361514353474,1935733838,1935733838,0
1361517845,1939224480,1,60,60,1361517817093,1361517817093,1939196573,1939196573,0
1361518933,1940312624,1,46,46,1361518905317,1361518905317,1940284941,1940284941,0
1361519404,1940783800,1,46,46,1361519376555,1361519376555,1940756355,1940756355,0
1361521213,1942593216,1,46,46,1361521185393,1361521185393,1942565609,1942565609,0
1361523114,1944493444,1,48,48,1361523088409,1361523088409,1944467853,1944467853,0
1361524117,1945496780,1,60,60,1361524091770,1361524091770,1945471550,1945471550,0
1361524269,1945649100,1,60,60,1361524242551,1361524242551,1945622651,1945622651,0
1361524321,1945701160,1,60,60,1361524294586,1361524294586,1945674746,1945674746,0
1361525148,1946527524,1,60,60,1361525120232,1361525120232,1946499756,1946499756,0
1361527544,1948924368,1,60,60,1361527516857,1361527516857,1948897225,1948897225,0
1361527950,1949329644,1,46,46,1361527923719,1361527923719,1949303363,1949303363,0
1361530460,1951839724,1,48,48,1361530431890,1361530431890,1951811614,1951811614,0
1361531436,1952816132,1,46,46,1361531407979,1361531407979,1952788111,1952788111,0
1361532714,1954093504,1,46,46,1361532685133,1361532685133,1954064637,1954064637,0
1361534199,593892448,1,46,46,1361534171877,1361534171877,593865325,593865325,0
1361534392,1955772032,1,60,60,1361534365348,1361534365348,1955745380,1955745380,0
1361536476,1957855580,1,46,46,1361536450120,1361536450120,1957829700,1957829700,0
1361538043,1959422476,1,48,48,1361538017432,1361538017432,1959396908,1959396908,0
1361538104,1959483880,1,46,46,1361538077446,1361538077446,1959457326,1959457326,0
1361539169,1960548388,3,180,60,1361539143778,1361539146786,1960523166,1960526174,3008
1361540775,1962155000,1,46,46,1361540750631,1361540750631,1962130631,1962130631,0
1361541086,1962465572,1,48,48,1361541057613,1361541057613,1962437185,1962437185,0
1361541229,1962608776,1,46,46,1361541201471,1361541201471,1962581247,1962581247,0
1361542897,1964276752,1,46,46,1361542869308,1361542869308,1964249060,1964249060,0
1361544049,1965429308,1,46,46,1361544024638,1361544024638,1965404946,1965404946,0
1361544182,1965561760,1,46,46,1361544153954,1361544153954,1965533714,1965533714,0
1361544616,1965995716,1,46,46,1361544588423,1361544588423,1965968139,1965968139,0
1361544828,1966207500,1,60,60,1361544800090,1361544800090,1966179590,1966179590,0
1361546066,1967445864,1,60,60,1361546040477,1361546040477,1967420341,1967420341,0
1361546066,1967445864,2,120,60,1361546040541,1361546041565,1967420405,1967421429,1024
1361550307,1971687068,1,46,46,1361550280466,1361550280466,1971660534,1971660534,0
1361553614,1974993628,1,60,60,1361553586775,1361553586775,1974966403,1974966403,0
1361554291,1975670856,1,52,52,1361554263722,1361554263722,1975643578,1975643578,0
1361554291,1975670884,1,52,52,1361554264717,1361554264717,1975644601,1975644601,0
1361555161,1976540660,1,443,443,1361555135263,1361555135263,1976514923,1976514923,0
1361555293,1976672760,1,46,46,1361555265851,1361555265851,1976645611,1976645611,0
1361555385,1976765216,1,46,46,1361555360433,1361555360433,1976740649,1976740649,0
1361555491,1976870980,1,48,48,1361555462939,1361555462939,1976842919,1976842919,0
1361558057,1979436360,2,120,60,1361558031523,1361558032547,1979410883,1979411907,1024
1361558077,1979456684,1,74,74,1361558050399,1361558050399,1979430083,1979430083,0
1361559371,1980751204,1,46,46,1361559343426,1361559343426,1980723630,1980723630,0
1361560882,1982261468,1,48,48,1361560854602,1361560854602,1982234070,1982234070,0
1361561185,1982564396,1,60,60,1361561159821,1361561159821,1982539217,1982539217,0
1361561794,1983174196,1,46,46,1361561768228,1361561768228,1983148424,1983148424,0
1361562576,1983955552,1,46,46,1361562549407,1361562549407,1983928959,1983928959,0
1361563077,1984456588,1,46,46,1361563048947,1361563048947,1984428535,1984428535,0
1361563522,1984902132,1,46,46,1361563496074,1361563496074,1984876206,1984876206,0
1361564628,1986008084,3,144,48,1361564600555,1361564609515,1985980639,1985989599,8960
1361566716,1988096120,2,128,64,1361566688104,1361566692136,1988068224,1988072256,4032
1361567627,1989006268,1,60,60,1361567602476,1361567602476,1988981744,1988981744,0
1361567915,1989295160,1,60,60,1361567889198,1361567889198,1989269358,1989269358,0
1361567988,1989367348,1,60,60,1361567960216,1361567960216,1989339564,1989339564,0
1361568069,1989448324,1,46,46,1361568042415,1361568042415,1989421739,1989421739,0
1361571232,1992611540,1,46,46,1361571207016,1361571207016,1992586556,1992586556,0
1361572580,1993960136,1,48,48,1361572553728,1361572553728,1993933864,1993933864,0
1361573308,1994688168,1,46,46,1361573281301,1361573281301,1994661469,1994661469,0
1361573465,1994844692,1,60,60,1361573440364,1361573440364,1994820056,1994820056,0
1361573617,1994997168,1,60,60,1361573591121,1361573591121,1994971289,1994971289,0
1361573621,1995000984,1,60,60,1361573595337,1361573595337,1994975321,1994975321,0
1361573629,1995009184,1,60,60,1361573601985,1361573601985,1994982169,1994982169,0
1361573653,1995033204,1,60,60,1361573627308,1361573627308,1995007512,1995007512,0
1361573806,1995185628,1,60,60,1361573781865,1361573781865,1995161493,1995161493,0
1361574058,1995437984,1,60,60,1361574031107,1361574031107,1995411091,1995411091,0
1361574238,1995618160,1,46,46,1361574211728,1361574211728,1995591888,1995591888,0
1361576199,1997578544,1,46,46,1361576171738,1361576171738,1997551282,1997551282,0
1361576801,1998180344,1,60,60,1361576776665,1361576776665,1998156009,1998156009,0
1361576994,1998374032,1,48,48,1361576967076,1361576967076,1998347108,1998347108,0
1361577247,1998626652,1,46,46,1361577218716,1361577218716,1998598368,1998598368,0
1361581452,2002831984,1,46,46,1361581424977,1361581424977,2002804961,2002804961,0
1361582266,2003645516,1,46,46,1361582240922,1361582240922,2003620438,2003620438,0
1361584486,2005865904,1,76,76,1361584458037,1361584458037,2005837941,2005837941,0
1361585593,2006972756,1,446,446,1361585565880,1361585565880,2006945636,2006945636,0
1361586100,2007479688,1,48,48,1361586070774,1361586070774,2007450462,2007450462,0
1361586768,2008147540,1,46,46,1361586742079,1361586742079,2008121619,2008121619,0
1361587193,2008572668,1,46,46,1361587167672,1361587167672,2008547340,2008547340,0
1361589105,2010484952,1,64,64,1361589078208,1361589078208,2010458160,2010458160,0
1361590345,2011724288,1,46,46,1361590318338,1361590318338,2011697626,2011697626,0
1361590672,2012051708,1,60,60,1361590647387,1361590647387,2012027095,2012027095,0
1361590676,2012055736,1,60,60,1361590649341,1361590649341,2012029077,2012029077,0
1361591337,2012716960,1,46,46,1361591311766,1361591311766,2012691726,2012691726,0
1361592135,2013514624,1,60,60,1361592107735,1361592107735,2013487359,2013487359,0
1361592446,2013825416,1,48,48,1361592417188,1361592417188,2013796604,2013796604,0
1361595919,2017298592,1,48,48,1361595888575,1361595888575,2017268167,2017268167,0
1361596606,2017985584,1,60,60,1361596580029,1361596580029,2017959613,2017959613,0
1361596670,2018049732,1,60,60,1361596641962,1361596641962,2018021694,2018021694,0
1361596774,2018153924,1,60,60,1361596747944,1361596747944,2018127868,2018127868,0
1361597530,2018909796,1,48,48,1361597502940,1361597502940,2018882736,2018882736,0
1361599227,2020606444,1,46,46,1361599199651,1361599199651,2020579095,2020579095,0
1361599687,2021067044,1,46,46,1361599661124,1361599661124,2021041168,2021041168,0
1361601775,2023154276,1,78,78,1361601746979,1361601746979,2023126255,2023126255,0
1361603523,2024902404,2,122,61,1361603496651,1361603499147,2024876055,2024878551,2496
1361603531,2024910276,1,56,56,1361603504010,1361603504010,2024883286,2024883286,0
1361606440,2027819984,1,46,46,1361606414362,1361606414362,2027794346,2027794346,0
1361606777,2028156412,1,46,46,1361606751891,1361606751891,2028131303,2028131303,0
1361607313,2028692980,1,46,46,1361607287058,1361607287058,2028667038,2028667038,0
1361608781,2030160772,2,104,52,1361608754508,1361608758156,2030134280,2030137928,3648
1361612575,2033955084,1,46,46,1361612548505,1361612548505,2033928589,2033928589,0
1361613387,2034766996,1,68,68,1361613361702,1361613361702,2034741698,2034741698,0
1361616065,2037444592,1,60,60,1361616036946,1361616036946,2037416538,2037416538,0
1361619821,2041200604,1,46,46,1361619793932,1361619793932,2041173536,2041173536,0
1361620214,2041593280,1,52,52,1361620189897,1361620189897,2041569177,2041569177,0
1361622794,2044174008,3,144,48,1361622766603,1361622775627,2044146611,2044155635,9024
1361623617,2044996288,1,46,46,1361623592271,1361623592271,2044971559,2044971559,0
1361626897,2048276988,1,46,46,1361626868387,1361626868387,2048248375,2048248375,0
1361627782,2049161652,1,46,46,1361627756451,1361627756451,2049136103,2049136103,0
1361631775,2053154688,1,48,48,1361631745478,1361631745478,2053125166,2053125166,0
1361631832,2053211356,1,46,46,1361631806223,1361631806223,2053185579,2053185579,0
1361632374,2053753828,1,48,48,1361632345329,1361632345329,2053725157,2053725157,0
1361642621,2064000856,1,443,443,1361642593018,1361642593018,2063972874,2063972874,0
1361644101,2065480596,1,46,46,1361644072997,1361644072997,2065452593,2065452593,0
1361644297,2065676860,1,46,46,1361644270045,1361644270045,2065649905,2065649905,0
1361644427,2065806592,1,46,46,1361644398502,1361644398502,2065778094,2065778094,0
1361645235,2066614872,1,60,60,1361645207490,1361645207490,2066587362,2066587362,0
1361645468,2066847452,1,71,71,1361645443042,1361645443042,2066822494,2066822494,0
1361645488,2066867564,1,444,444,1361645463538,1361645463538,2066843102,2066843102,0
1361646269,2067648056,1,46,46,1361646244068,1361646244068,2067623124,2067623124,0
1361650516,2071895096,1,48,48,1361650486841,1361650486841,2071865937,2071865937,0
1361652260,2073639288,1,48,48,1361652231007,1361652231007,2073610295,2073610295,0
1361653189,2074568044,1,46,46,1361653161669,1361653161669,2074540713,2074540713,0
1361656274,2077653804,1,46,46,1361656246303,1361656246303,2077626107,2077626107,0
1361658401,2079780856,1,52,52,1361658375756,1361658375756,2079755612,2079755612,0
1361661042,2082421496,1,46,46,1361661013389,1361661013389,2082392885,2082392885,0
1361661617,2082996736,1,52,52,1361661591955,1361661591955,2082971691,2082971691,0
1361661682,2083061236,1,52,52,1361661654725,1361661654725,2083033961,2083033961,0
1361662268,2083647656,1,46,46,1361662241178,1361662241178,2083620834,2083620834,0
1361662495,2083873952,5,250,50,1361662468375,1361662490263,2083847327,2083869215,21888
1361662539,2083918088,1,48,48,1361662514255,1361662514255,2083893343,2083893343,0
1361662571,2083950000,1,48,48,1361662543781,1361662543781,2083922781,2083922781,0
1361666734,2088113492,2,104,52,1361666707644,1361666710588,2088087136,2088090080,2944
1361668518,2089897124,1,46,46,1361668492048,1361668492048,2089871172,2089871172,0
1361670911,2092290552,1,52,52,1361670884799,1361670884799,2092264351,2092264351,0
1361673004,2094383264,1,60,60,1361672976577,1361672976577,2094355841,2094355841,0
1361673100,2094479868,1,46,46,1361673073186,1361673073186,2094453054,2094453054,0
1361675646,2097024968,1,46,46,1361675621698,1361675621698,2097000666,2097000666,0
1361676047,2097426212,1,48,48,1361676021126,1361676021126,2097400338,2097400338,0
1361676419,2097798584,1,46,46,1361676391117,1361676391117,2097770701,2097770701,0
1361677033,2098412572,1,60,60,1361677004944,1361677004944,2098384516,2098384516,0
1361677234,2098613148,2,120,60,1361677208052,1361677209076,2098587200,2098588224,1024
1361680721,2102100584,1,46,46,1361680696011,1361680696011,2102075595,2102075595,0
1361681274,2102653716,1,46,46,1361681246528,1361681246528,2102626244,2102626244,0
1361681563,2102942272,1,46,46,1361681538807,1361681538807,2102918079,2102918079,0
1361682456,2103835684,2,122,61,1361682429519,1361682429711,2103809203,2103809395,192
1361684673,2106052040,2,120,60,1361684663027,1361684663987,2106042067,2106043027,960
1361684673,2106052332,2,120,60,1361684664779,1361684665739,2106044111,2106045071,960
1361686102,2107481076,1,46,46,1361686077302,1361686077302,2107456378,2107456378,0
1361689165,2110544088,1,58,58,1361689139583,1361689139583,2110518671,2110518671,0
1361690472,2111850964,3,144,48,1361690446437,1361690455333,2111825401,2111834297,8896
1361691219,2112598804,2,92,46,1361691216209,1361691216465,2112596013,2112596269,256
1361692885,2114264640,1,46,46,1361692860252,1361692860252,2114239892,2114239892,0
1361693214,2114593668,1,60,60,1361693189053,1361693189053,2114568721,2114568721,0
1361695555,2116934732,1,46,46,1361695527770,1361695527770,2116907502,2116907502,0
1361695904,2117283324,1,46,46,1361695877484,1361695877484,2117256808,2117256808,0
1361696528,2117907236,1,48,48,1361696498684,1361696498684,2117877920,2117877920,0
1361697115,2118494152,1,48,48,1361697087749,1361697087749,2118466901,2118466901,0
1361699095,2120474568,1,46,46,1361699067144,1361699067144,2120446712,2120446712,0
1361699627,2121005872,1,446,446,1361699602231,1361699602231,2120981103,2120981103,0
1361699791,2121169964,1,46,46,1361699763417,1361699763417,2121142381,2121142381,0
1361700637,2122015872,5,320,64,1361700611818,1361700614314,2121990690,2121993186,2496
1361702702,2124080872,1,60,60,1361702675272,1361702675272,2124054144,2124054144,0
1361703677,2125056668,1,46,46,1361703650400,1361703650400,2125030068,2125030068,0
1361704473,2125852200,1,68,68,1361704447719,1361704447719,2125826919,2125826919,0
1361705202,2126581512,1,46,46,1361705176418,1361705176418,2126555930,2126555930,0
1361709259,2130638180,2,122,61,1361709234033,1361709236273,2130613213,2130615453,2240
1361714489,2135868624,1,48,48,1361714461865,1361714461865,2135841489,2135841489,0
1361716125,2137504408,1,60,60,1361716097894,1361716097894,2137477302,2137477302,0
1361717139,776832120,1,46,46,1361717113430,1361717113430,776806550,776806550,0
1361717788,2139167204,1,46,46,1361717763224,1361717763224,2139142428,2139142428,0
1361717919,2139298008,1,46,46,1361717892123,1361717892123,2139271131,2139271131,0
1361718722,2140101048,1,46,46,1361718694569,1361718694569,2140073617,2140073617,0
1361720133,2141512536,1,46,46,1361720107820,1361720107820,2141487356,2141487356,0
1361720518,2141897428,2,122,61,1361720490322,1361720492370,2141869750,2141871798,2048
1361721789,2143168260,1,60,60,1361721762021,1361721762021,2143141281,2143141281,0
1361722025,2143404344,1,60,60,1361721998029,1361721998029,2143377373,2143377373,0
1361722077,2143456488,1,60,60,1361722050046,1361722050046,2143429534,2143429534,0
1361722105,2143484536,1,60,60,1361722077517,1361722077517,2143457053,2143457053,0
1361722116,2143495264,1,46,46,1361722087516,1361722087516,2143466780,2143466780,0
1361722129,2143508536,1,60,60,1361722101965,1361722101965,2143481501,2143481501,0
1361722555,2143933756,1,60,60,1361722530643,1361722530643,2143909399,2143909399,0
1361723788,2145167240,1,46,46,1361723763546,1361723763546,2145142786,2145142786,0
1361725731,2147110552,2,122,61,1361725703495,1361725705799,2147083047,2147085351,2304
1361727557,2148936444,1,48,48,1361727531541,1361727531541,2148910985,2148910985,0
1361730935,2152314164,1,46,46,1361730909562,1361730909562,2152288726,2152288726,0
1361732860,2154239456,1,78,78,1361732835387,1361732835387,2154214843,2154214843,0
1361734001,2155379928,1,46,46,1361733973240,1361733973240,2155352168,2155352168,0
1361735301,2156680300,1,46,46,1361735272817,1361735272817,2156652117,2156652117,0
1361735318,2156697516,1,46,46,1361735290136,1361735290136,2156669652,2156669652,0
1361736996,2158375428,1,46,46,1361736968920,1361736968920,2158348348,2158348348,0
1361737784,2159163672,1,46,46,1361737758554,1361737758554,2159138226,2159138226,0
1361738027,2159405840,1,46,46,1361738000597,1361738000597,2159379437,2159379437,0
1361738542,2159921144,1,46,46,1361738516382,1361738516382,2159895526,2159895526,0
1361739062,798755756,2,128,64,1361739036711,1361739037735,798730467,798731491,1024
1361739087,2160466000,1,46,46,1361739061222,1361739061222,2160440222,2160440222,0
1361740222,2161601680,1,46,46,1361740195948,1361740195948,2161575628,2161575628,0
1361740902,2162280868,1,446,446,1361740874062,1361740874062,2162252930,2162252930,0
1361741491,2162870448,1,52,52,1361741466433,1361741466433,2162845881,2162845881,0
1361741821,2163199912,1,48,48,1361741796243,1361741796243,2163175155,2163175155,0
1361741860,2163239428,2,230,115,1361741835664,1361741835664,2163215092,2163215092,0
1361742742,2164120988,1,46,46,1361742717113,1361742717113,2164096101,2164096101,0
1361744575,2165954056,1,52,52,1361744547481,1361744547481,2165926537,2165926537,0
1361744627,2166006240,1,52,52,1361744599393,1361744599393,2165978633,2165978633,0
1361746461,2167840184,1,48,48,1361746432638,1361746432638,2167811822,2167811822,0
1361746972,2168351504,1,60,60,1361746947700,1361746947700,2168327204,2168327204,0
1361746980,2168359544,1,60,60,1361746953294,1361746953294,2168332838,2168332838,0
1361747786,2169165396,1,46,46,1361747758804,1361747758804,2169138200,2169138200,0
1361750449,2171827868,1,46,46,1361750422335,1361750422335,2171801203,2171801203,0
1361750722,2172100664,1,46,46,1361750695367,1361750695367,2172074031,2172074031,0
1361750722,2172100668,1,46,46,1361750695682,1361750695682,2172074350,2172074350,0
1361752768,2174147648,1,46,46,1361752738765,1361752738765,2174118413,2174118413,0
1361753252,2174630852,1,60,60,1361753226980,1361753226980,2174605832,2174605832,0
1361754330,2175709100,1,46,46,1361754304732,1361754304732,2175683832,2175683832,0
1361756079,2177457652,1,46,46,1361756050754,1361756050754,2177429406,2177429406,0
1361757937,2179316168,1,46,46,1361757912418,1361757912418,2179291586,2179291586,0
1361759360,2180738864,1,46,46,1361759335163,1361759335163,2180714027,2180714027,0
1361766772,2188151244,1,60,60,1361766747598,1361766747598,2188126842,2188126842,0
1361767364,2188742880,1,46,46,1361767336625,1361767336625,2188715505,2188715505,0
1361767960,2189339116,1,48,48,1361767932991,1361767932991,2189312107,2189312107,0
1361768578,2189957556,1,46,46,1361768548540,1361768548540,2189928096,2189928096,0
1361771530,2192908976,3,152,50.66666667,1361771505042,1361771514194,2192884018,2192893170,9152
1361774472,2195850756,6,298,49.66666667,1361774444419,1361774466627,2195823175,2195845383,22208
1361774516,2195894836,1,48,48,1361774490804,1361774490804,2195869640,2195869640,0
1361774548,2195926744,1,48,48,1361774520400,1361774520400,2195899144,2195899144,0
1361774716,2196094984,1,52,52,1361774688346,1361774688346,2196067330,2196067330,0
1361776560,2197938896,1,92,92,1361776532183,1361776532183,2197911079,2197911079,0
1361778836,2200215196,1,46,46,1361778808202,1361778808202,2200187398,2200187398,0
1361779016,2200395392,1,46,46,1361778988866,1361778988866,2200368258,2200368258,0
1361779994,2201372684,1,46,46,1361779968439,1361779968439,2201347123,2201347123,0
1361780899,2202278252,1,46,46,1361780874162,1361780874162,2202253414,2202253414,0
1361784195,2205573864,1,46,46,1361784167111,1361784167111,2205545975,2205545975,0
1361784427,2205805552,1,46,46,1361784402553,1361784402553,2205781105,2205781105,0
1361785435,2206814044,1,48,48,1361785408383,1361785408383,2206787427,2206787427,0
1361786545,2207923724,1,48,48,1361786518763,1361786518763,2207897487,2207897487,0
1361791394,2212772976,2,120,60,1361791367272,1361791370280,2212746248,2212749256,3008
1361792733,2214112456,1,48,48,1361792706994,1361792706994,2214086450,2214086450,0
1361792896,2214274968,1,46,46,1361792867419,1361792867419,2214246387,2214246387,0
1361794540,2215919108,1,46,46,1361794513205,1361794513205,2215892313,2215892313,0
1361795695,2217074388,2,120,60,1361795668813,1361795671821,2217048201,2217051209,3008
1361795813,2217192288,1,48,48,1361795785452,1361795785452,2217164740,2217164740,0
1361796036,2217414656,3,154,51.33333333,1361796010722,1361796020514,2217389378,2217399170,9792
1361796112,2217490924,1,48,48,1361796086356,1361796086356,2217465280,2217465280,0
1361797120,2218499152,1,48,48,1361797093987,1361797093987,2218473139,2218473139,0
1361802681,2224060108,1,46,46,1361802655483,1361802655483,2224034591,2224034591,0
1361803216,2224594960,1,46,46,1361803187396,1361803187396,2224566356,2224566356,0
1361803216,2224595360,1,46,46,1361803187892,1361803187892,2224567252,2224567252,0
1361803944,2225323076,1,60,60,1361803918600,1361803918600,2225297676,2225297676,0
1361804581,2225960040,1,46,46,1361804555811,1361804555811,2225934851,2225934851,0
1361805968,2227346960,1,60,60,1361805943195,1361805943195,2227322155,2227322155,0
1361807302,2228680692,1,48,48,1361807273878,1361807273878,2228652570,2228652570,0
1361808943,2230322196,1,46,46,1361808916802,1361808916802,2230295998,2230295998,0
1361809812,2231190712,1,48,48,1361809782618,1361809782618,2231161330,2231161330,0
1361810196,869889148,1,46,46,1361810170903,1361810170903,869864051,869864051,0
1361810322,2231700824,1,60,60,1361810295201,1361810295201,2231674025,2231674025,0
1361810350,2231728872,1,60,60,1361810325490,1361810325490,2231704362,2231704362,0
1361810524,2231902564,1,46,46,1361810498786,1361810498786,2231877350,2231877350,0
1361813854,2235232916,12,3276,273,1361813826384,1361813850704,2235205300,2235229620,24320
1361813862,2235240772,1,52,52,1361813833951,1361813833951,2235212723,2235212723,0
1361813862,2235240784,1,52,52,1361813834582,1361813834582,2235213366,2235213366,0
1361813862,2235240984,1,52,52,1361813836493,1361813836493,2235215477,2235215477,0
1361813879,2235258156,5,359,71.8,1361813853986,1361813876642,2235233142,2235255798,22656
1361813879,2235258224,48,50409,1050.1875,1361813853917,1361813876573,2235233141,2235255797,22656
1361813879,2235258224,5,359,71.8,1361813853980,1361813876572,2235233204,2235255796,22592
1361813879,2235258224,5,359,71.8,1361813853980,1361813876572,2235233204,2235255796,22592
1361813879,2235258228,5,359,71.8,1361813853978,1361813876570,2235233206,2235255798,22592
1361813879,2235258228,5,359,71.8,1361813853978,1361813876570,2235233206,2235255798,22592
1361813879,2235258228,7,1457,208.1428571,1361813855384,1361813876632,2235234612,2235255860,21248
1361813902,2235280888,1,46,46,1361813876907,1361813876907,2235255795,2235255795,0
1361813902,2235280928,1,46,46,1361813874502,1361813874502,2235253430,2235253430,0
1361813902,2235280992,1,46,46,1361813876803,1361813876803,2235255795,2235255795,0
1361813906,2235285208,6,1417,236.1666667,1361813880491,1361813900779,2235259699,2235279987,20288
1361813934,2235313228,7,2185,312.1428571,1361813905814,1361813931990,2235285042,2235311218,26176
1361813962,2235341216,6,1650,275,1361813936166,1361813961382,2235315382,2235340598,25216
1361813966,2235345220,4,1185,296.25,1361813938912,1361813938912,2235318132,2235318132,0
1361813994,2235373188,7,2069,295.5714286,1361813966333,1361813991485,2235345521,2235370673,25152
1361814022,2235401344,6,1638,273,1361813996325,1361814021541,2235375669,2235400885,25216
1361814054,2235433328,6,1638,273,1361814026610,1361814051826,2235405938,2235431154,25216
1361814082,2235461420,6,1411,235.1666667,1361814056791,1361814076887,2235436211,2235456307,20096
1361814110,2235489372,8,1957,244.625,1361814081990,1361814107142,2235461362,2235486514,25152
1361814139,2235517544,6,1638,273,1361814112960,1361814138240,2235491504,2235516784,25280
1361814158,2235537340,83315,47028361,564.4645142,1361812757925,1361813854501,2234137265,2235233841,1096576
1361814170,2235549364,11,2995,272.2727273,1361814142413,1361814169677,2235521777,2235549041,27264
1361814203,2235581508,2,546,273,1361814175717,1361814180709,2235554225,2235559217,4992
1361814239,2235618432,27000,16320628,604.4677037,1361813858565,1361814232069,2235237997,2235611501,373504
1361814275,2235653496,8,871,108.875,1361814250221,1361814250669,2235628717,2235629165,448
1361814278,2235657440,61,67772,1111.016393,1361814251198,1361814259646,2235630638,2235639086,8448
1361814279,2235657512,7,1690,241.4285714,1361814250911,1361814275807,2235629423,2235654319,24896
1361814307,2235685508,2,92,46,1361814281122,1361814290658,2235659630,2235669166,9536
1361814307,2235685692,7,2161,308.7142857,1361814280618,1361814305770,2235659310,2235684462,25152
1361814323,2235701552,1,52,52,1361814295669,1361814295669,2235674221,2235674221,0
1361814339,2235717580,6,1646,274.3333333,1361814310875,1361814336347,2235689455,2235714927,25472
1361814339,2235717608,1,46,46,1361814311420,1361814311420,2235690028,2235690028,0
1361814367,2235745712,1,52,52,1361814340693,1361814340693,2235719405,2235719405,0
1361814367,2235745720,6,1638,273,1361814341326,1361814366414,2235720046,2235745134,25088
1361814391,2235769704,1,448,448,1361814364316,1361814364316,2235743020,2235743020,0
1361814399,2235777744,6,1638,273,1361814371831,1361814396599,2235750575,2235775343,24768
1361814411,2235789936,1,52,52,1361814385525,1361814385525,2235764461,2235764461,0
1361814427,2235805876,5,1365,273,1361814401583,1361814421871,2235780459,2235800747,20288
1361814455,2235833904,6,1638,273,1361814426898,1361814452178,2235805802,2235831082,25280
1361814455,2235834104,1,52,52,1361814430477,1361814430477,2235809581,2235809581,0
1361814483,2235862004,6,1638,273,1361814457071,1361814482287,2235836075,2235861291,25216
1361814496,2235874736,5,326,65.2,1361814475900,1361814490492,2235854636,2235869228,14592
1361814503,2235882124,1,449,449,1361814477366,1361814477366,2235856490,2235856490,0
1361814515,2235894004,6,1638,273,1361814487279,1361814512495,2235866283,2235891499,25216
1361814543,2235922184,6,1638,273,1361814517372,1361814542780,2235896556,2235921964,25408
1361814547,2235926056,2,96,48,1361814519674,1361814522810,2235898730,2235901866,3136
1361814551,2235930232,2,100,50,1361814526602,1361814532618,2235905834,2235911850,6016
1361814560,2235938764,5,911,182.2,1361814548256,1361814559584,2235927020,2235938348,11328
1361814588,2235966484,6,1417,236.1666667,1361814563764,1361814583860,2235942248,2235962344,20096
1361814588,2235966524,7,825,117.8571429,1361814559886,1361814560014,2235938410,2235938538,128
1361814616,2235994544,6,1638,273,1361814588920,1361814613944,2235967464,2235992488,25024
1361814627,874320060,10,5074,507.4,1361814626508,1361814626636,874319568,874319696,128
1361814627,874320060,8,1710,213.75,1361814626636,1361814626764,874319696,874319824,128
1361814627,874320060,11,8512,773.8181818,1361814626763,1361814626891,874319823,874319951,128
1361814632,2236010524,1,52,52,1361814605003,1361814605003,2235983527,2235983527,0
1361814640,2236018956,9,1180,131.1111111,1361814634269,1361814634717,2236013225,2236013673,448
1361814644,2236022584,6,1638,273,1361814618896,1361814643024,2235997480,2236021608,24128
1361814648,2236026888,73,102303,1401.410959,1361814646882,1361814647074,2236025770,2236025962,192
1361814648,2236026892,73,102307,1401.465753,1361814647135,1361814647263,2236026027,2236026155,128
1361814663,2236042420,8,2240,280,1361814635596,1361814661324,2236015016,2236040744,25728
1361814664,2236042916,9,1179,131,1361814662087,1361814662151,2236041003,2236041067,64
1361814672,2236050976,74,100934,1363.972973,1361814669769,1361814670281,2236048745,2236049257,512
1361814675,2236054468,6,1638,273,1361814647132,1361814672156,2236026600,2236051624,25024
1361814676,2236054516,1,52,52,1361814650197,1361814650197,2236028713,2236028713,0
1361814680,2236058888,74,103047,1392.527027,1361814671521,1361814672737,2236050409,2236051625,1216
1361814680,2236058900,75,105579,1407.72,1361814672982,1361814673110,2236051882,2236052010,128
1361814684,2236062488,1,46,46,1361814656818,1361814656818,2236035306,2236035306,0
1361814688,2236066472,4,1750,437.5,1361814662274,1361814662338,2236040746,2236040810,64
1361814692,2236070548,4,1212,303,1361814664374,1361814687606,2236042922,2236066154,23232
1361814704,2236082512,6,1638,273,1361814678106,1361814703130,2236056618,2236081642,25024
1361814704,2236082912,446,634612,1422.896861,1361814665672,1361814702728,2236044584,2236081640,37056
1361814708,2236086632,1,46,46,1361814682529,1361814682529,2236061161,2236061161,0
1361814720,2236098740,1,46,46,1361814692469,1361814692469,2236071209,2236071209,0
1361814720,2236098908,17,13180,775.2941176,1361814692364,1361814692940,2236071272,2236071848,576
1361814720,2236098956,1,52,52,1361814694812,1361814694812,2236073768,2236073768,0
1361814732,2236110896,1,46,46,1361814704471,1361814704471,2236083367,2236083367,0
1361814732,2236110952,29,36613,1262.517241,1361814706848,1361814719392,2236085800,2236098344,12544
1361814736,2236114836,5,1365,273,1361814708051,1361814723219,2236086887,2236102055,15168
1361814736,2236115240,73,95956,1314.465753,1361814733634,1361814733762,2236112874,2236113002,128
1361814736,2236115244,73,102579,1405.191781,1361814734141,1361814734269,2236113385,2236113513,128
1361814736,2236115244,73,102579,1405.191781,1361814734013,1361814734141,2236113257,2236113385,128
1361814736,2236115244,76,107081,1408.960526,1361814731069,1361814731197,2236110313,2236110441,128
1361814736,2236115284,82,116081,1415.621951,1361814732373,1361814732565,2236111657,2236111849,192
1361814740,2236118808,1,46,46,1361814712366,1361814712366,2236091174,2236091174,0
1361814740,2236118848,4,1210,302.5,1361814713608,1361814713864,2236092456,2236092712,256
1361814740,2236118888,10,11352,1135.2,1361814715104,1361814715232,2236093992,2236094120,128
1361814740,2236118888,36,41868,1163,1361814715168,1361814727648,2236094056,2236106536,12480
1361814740,2236118888,4,500,125,1361814715104,1361814715360,2236093992,2236094248,256
1361814740,2236118888,53,71027,1340.132075,1361814715231,1361814728223,2236094119,2236107111,12992
1361814740,2236118896,17,7645,449.7058824,1361814715734,1361814729814,2236094630,2236108710,14080
1361814740,2236118896,5,3833,766.6,1361814715734,1361814715798,2236094630,2236094694,64
1361814740,2236118940,7,490,70,1361814713964,1361814737004,2236092904,2236115944,23040
1361814740,2236118972,4,500,125,1361814715084,1361814715340,2236094056,2236094312,256
1361814740,2236118972,5,3580,716,1361814715084,1361814715084,2236094056,2236094056,0
1361814740,2236118972,5,4122,824.4,1361814715084,1361814715084,2236094056,2236094056,0
1361814744,2236122856,4,458,114.5,1361814716546,1361814716802,2236095402,2236095658,256
1361814744,2236122980,41,40682,992.2439024,1361814719362,1361814736706,2236098342,2236115686,17344
1361814744,2236123124,9,1180,131.1111111,1361814736821,1361814736885,2236115945,2236116009,64
1361814744,2236123152,9,1180,131.1111111,1361814737942,1361814738006,2236117094,2236117158,64
1361814744,2236123156,9,1188,132,1361814735122,1361814735890,2236114278,2236115046,768
1361814744,2236123160,73,102307,1401.465753,1361814739087,1361814740175,2236118247,2236119335,1088
1361814744,2236123196,9,1180,131.1111111,1361814737003,1361814737131,2236116199,2236116327,128
1361814748,2236126876,9,5807,645.2222222,1361814721002,1361814726186,2236099878,2236105062,5184
1361814748,2236127024,3,271,90.33333333,1361814722585,1361814722649,2236101609,2236101673,64
1361814752,2236130888,12,11885,990.4166667,1361814724513,1361814725025,2236103401,2236103913,512
1361814752,2236130892,3,498,166,1361814724956,1361814725020,2236103848,2236103912,64
1361814752,2236130980,2,636,318,1361814726082,1361814726210,2236105062,2236105190,128
1361814752,2236130984,5,3551,710.2,1361814726336,1361814727808,2236105320,2236106792,1472
1361814752,2236130984,5,2255,451,1361814726334,1361814727742,2236105318,2236106726,1408
1361814752,2236131264,9,1179,131,1361814751206,1361814751334,2236130470,2236130598,128
1361814752,2236131264,9,1179,131,1361814751465,1361814751529,2236130729,2236130793,64
1361814756,2236134944,4,1154,288.5,1361814729704,1361814730024,2236108648,2236108968,320
1361814756,2236134944,13,4209,323.7692308,1361814729768,1361814755048,2236108712,2236133992,25280
1361814756,2236134948,7,2738,391.1428571,1361814729762,1361814735714,2236108710,2236114662,5952
1361814756,2236135040,4,608,152,1361814729672,1361814730120,2236108712,2236109160,448
1361814756,2236135040,5,1454,290.8,1361814729798,1361814754950,2236108838,2236133990,25152
1361814760,2236139156,73,99218,1359.150685,1361814753490,1361814754450,2236132646,2236133606,960
1361814760,2236139224,73,102368,1402.30137,1361814752144,1361814752272,2236131368,2236131496,128
1361814764,2236142936,40,45645,1141.125,1361814736752,1361814760624,2236115688,2236139560,23872
1361814764,2236143012,1,52,52,1361814739810,1361814739810,2236118822,2236118822,0
1361814764,2236143040,36,47026,1306.277778,1361814736648,1361814762440,2236115688,2236141480,25792
1361814768,2236147408,2,504,252,1361814761688,1361814761688,2236141096,2236141096,0
1361814776,2236155252,7,490,70,1361814762802,1361814768562,2236142054,2236147814,5760
1361814776,2236155312,73,102581,1405.219178,1361814762745,1361814768761,2236142057,2236148073,6016
1361814780,2236159040,1,46,46,1361814755528,1361814755528,2236134568,2236134568,0
1361814784,2236163000,2,1112,556,1361814756911,1361814763311,2236135911,2236142311,6400
1361814784,2236163084,6,7372,1228.666667,1361814757658,1361814763930,2236136742,2236143014,6272
1361814784,2236163176,25,17102,684.08,1361814757949,1361814778685,2236137125,2236157861,20736
1361814784,2236163204,2,360,180,1361814758435,1361814764323,2236137639,2236143527,5888
1361814784,2236163280,3,144,48,1361814768406,1361814782358,2236147686,2236161638,13952
1361814788,2236166996,1,52,52,1361814760114,1361814760114,2236139110,2236139110,0
1361814788,2236167000,1,52,52,1361814760045,1361814760045,2236139045,2236139045,0
1361814788,2236167000,1,52,52,1361814760109,1361814760109,2236139109,2236139109,0
1361814788,2236167012,2,510,255,1361814761187,1361814767651,2236140199,2236146663,6464
1361814788,2236167012,9,6468,718.6666667,1361814760995,1361814777635,2236140007,2236156647,16640
1361814788,2236167032,4,1808,452,1361814761486,1361814787534,2236140518,2236166566,26048
1361814788,2236167080,1,52,52,1361814759965,1361814759965,2236139045,2236139045,0
1361814788,2236167084,27,31157,1153.962963,1361814759965,1361814769309,2236139049,2236148393,9344
1361814788,2236167120,10,2490,249,1361814761078,1361814787638,2236140198,2236166758,26560
1361814792,2236171108,3,1430,476.6666667,1361814766020,1361814766212,2236145128,2236145320,192
1361814792,2236171120,11,11833,1075.727273,1361814767478,1361814767926,2236146598,2236147046,448
1361814792,2236171188,13,5052,388.6153846,1361814766129,1361814781425,2236145317,2236160613,15296
1361814792,2236171220,1,52,52,1361814767443,1361814767443,2236146663,2236146663,0
1361814796,2236175008,3,1200,400,1361814768037,1361814768293,2236147045,2236147301,256
1361814796,2236175012,1,46,46,1361814768163,1361814768163,2236147175,2236147175,0
1361814796,2236175028,4,353,88.25,1361814769235,1361814769363,2236148263,2236148391,128
1361814796,2236175060,3,676,225.3333333,1361814771122,1361814777586,2236150182,2236156646,6464
1361814796,2236175104,5,556,111.2,1361814768582,1361814769478,2236147686,2236148582,896
1361814796,2236175132,4,347,86.75,1361814769132,1361814769260,2236148264,2236148392,128
1361814796,2236175132,4,353,88.25,1361814769132,1361814769260,2236148264,2236148392,128
1361814800,2236179128,2,98,49,1361814774637,1361814796845,2236153765,2236175973,22208
1361814800,2236179172,2,98,49,1361814772675,1361814796803,2236151847,2236175975,24128
1361814800,2236179172,2,98,49,1361814772674,1361814796802,2236151846,2236175974,24128
1361814800,2236179196,2,98,49,1361814772969,1361814796777,2236152165,2236175973,23808
1361814800,2236179212,2,98,49,1361814774490,1361814796762,2236153702,2236175974,22272
1361814800,2236179288,2,98,49,1361814784525,1361814796685,2236163813,2236175973,12160
1361814800,2236179296,2,92,46,1361814796680,1361814796680,2236175976,2236175976,0
1361814800,2236179296,4,728,182,1361814777350,1361814796678,2236156646,2236175974,19328
1361814800,2236179324,1270,1883109,1482.762992,1361814762731,1361814796651,2236142055,2236175975,33920
1361814800,2236179380,2,98,49,1361814781298,1361814796594,2236160678,2236175974,15296
1361814824,2236203024,1,46,46,1361814796118,1361814796118,2236175142,2236175142,0
1361814824,2236203032,1,46,46,1361814796942,1361814796942,2236175974,2236175974,0
1361814824,2236203032,1,46,46,1361814796942,1361814796942,2236175974,2236175974,0
1361814824,2236203032,1,46,46,1361814796942,1361814796942,2236175974,2236175974,0
1361814824,2236203032,1,46,46,1361814796942,1361814796942,2236175974,2236175974,0
1361814824,2236203032,1,46,46,1361814796942,1361814796942,2236175974,2236175974,0
1361814824,2236203032,1,46,46,1361814796942,1361814796942,2236175974,2236175974,0
1361814824,2236203032,1,46,46,1361814796942,1361814796942,2236175974,2236175974,0
1361814824,2236203032,1,46,46,1361814796942,1361814796942,2236175974,2236175974,0
1361814824,2236203032,1,46,46,1361814796942,1361814796942,2236175974,2236175974,0
1361814824,2236203032,1,46,46,1361814796942,1361814796942,2236175974,2236175974,0
1361814824,2236203032,1,46,46,1361814796942,1361814796942,2236175974,2236175974,0
1361814824,2236203032,1,46,46,1361814796942,1361814796942,2236175974,2236175974,0
1361814824,2236203116,1,46,46,1361814796857,1361814796857,2236175973,2236175973,0
1361814824,2236203116,1,46,46,1361814796857,1361814796857,2236175973,2236175973,0
1361814824,2236203120,1,46,46,1361814796853,1361814796853,2236175973,2236175973,0
1361814824,2236203120,1,46,46,1361814796853,1361814796853,2236175973,2236175973,0
1361814824,2236203120,1,46,46,1361814796853,1361814796853,2236175973,2236175973,0
1361814824,2236203120,1,46,46,1361814796856,1361814796856,2236175976,2236175976,0
1361814824,2236203120,1,46,46,1361814796856,1361814796856,2236175976,2236175976,0
1361814824,2236203120,1,46,46,1361814796856,1361814796856,2236175976,2236175976,0
1361814824,2236203120,1,46,46,1361814796856,1361814796856,2236175976,2236175976,0
1361814824,2236203120,1,46,46,1361814796856,1361814796856,2236175976,2236175976,0
1361814824,2236203120,1,46,46,1361814796856,1361814796856,2236175976,2236175976,0
1361814964,2236343328,119,167056,1403.831933,1361814660388,1361814661732,2236039716,2236041060,1344
1361815019,2236397724,37054,21341003,575.943299,1361814262913,1361814716737,2235641637,2236095461,453824
1361815037,2236415616,1825,2713028,1486.590685,1361814728619,1361814734251,2236107235,2236112867,5632
1361815045,2236423716,151,220741,1461.860927,1361814739209,1361814739529,2236117925,2236118245,320
1361815055,2236433748,138,201302,1458.710145,1361814752295,1361814752551,2236131043,2236131299,256
1361815065,2236443628,502,730179,1454.539841,1361814756576,1361814762464,2236135204,2236141092,5888
1361815830,2237209444,1,60,60,1361815804324,1361815804324,2237183768,2237183768,0
1361815919,2237297476,2,120,60,1361815894313,1361815897321,2237272789,2237275797,3008
1361816622,2238001028,1,46,46,1361816600441,1361816600441,2237979469,2237979469,0
1361817198,2238577116,3,144,48,1361817171353,1361817180313,2238550469,2238559429,8960
1361817415,2238793868,11,3246,295.0909091,1361817389131,1361817390347,2238767999,2238769215,1216
1361817700,2239078756,2,141,70.5,1361817698037,1361817698037,2239076793,2239076793,0
1361817724,2239102956,12,3298,274.8333333,1361817696496,1361817697840,2239075452,2239076796,1344
1361817764,2239143044,2,141,70.5,1361817757205,1361817757205,2239136249,2239136249,0
1361817784,2239162796,11,3246,295.0909091,1361817756301,1361817757581,2239135097,2239136377,1280
1361818045,2239423464,2,141,70.5,1361818044692,1361818044692,2239423156,2239423156,0
1361818068,2239447268,11,3246,295.0909091,1361818042546,1361818044018,2239421814,2239423286,1472
1361818297,2239675680,1,68,68,1361818269178,1361818269178,2239647858,2239647858,0
1361818437,2239816444,2,141,70.5,1361818433276,1361818433276,2239812720,2239812720,0
1361818457,2239836240,11,3246,295.0909091,1361818432200,1361818433544,2239811440,2239812784,1344
1361818750,2240128668,2,141,70.5,1361818746944,1361818746944,2240125612,2240125612,0
1361818770,2240149088,11,3246,295.0909091,1361818745308,1361818746652,2240124396,2240125740,1344
1361819062,2240441256,2,141,70.5,1361819059632,1361819059632,2240438888,2240438888,0
1361819083,2240462112,11,3246,295.0909091,1361819058496,1361819059840,2240437608,2240438952,1344
1361819115,2240494132,2,120,60,1361819089705,1361819090665,2240468837,2240469797,960
1361819119,2240498120,2,120,60,1361819091703,1361819092727,2240470823,2240471847,1024
1361819607,2240985620,2,141,70.5,1361819606499,1361819606499,2240985119,2240985119,0
1361819633,2241011456,11,3246,295.0909091,1361819605573,1361819606789,2240984029,2240985245,1216
1361819905,2241283804,1,46,46,1361819877157,1361819877157,2241255961,2241255961,0
1361820093,2241472440,1,48,48,1361820068199,1361820068199,2241447639,2241447639,0
1361820111,2241490204,2,141,70.5,1361820107667,1361820107667,2241486871,2241486871,0
1361820129,2241508280,1,46,46,1361820101000,1361820101000,2241480280,2241480280,0
1361820134,2241512584,11,3246,295.0909091,1361820107197,1361820108349,2241485781,2241486933,1152
1361820167,2241546148,2,141,70.5,1361820159690,1361820159690,2241538838,2241538838,0
1361820178,2241556696,1,46,46,1361820152653,1361820152653,2241531349,2241531349,0
1361820186,2241564708,11,3246,295.0909091,1361820158849,1361820160257,2241537557,2241538965,1408
1361820258,2241636716,1,127,127,1361820231543,1361820231543,2241610259,2241610259,0
1361820303,2241682344,17,11580,681.1764706,1361820295938,1361820298946,2241675282,2241678290,3008
1361820314,2241692992,1,46,46,1361820289379,1361820289379,2241668371,2241668371,0
1361820317,880010020,20,19574,978.7,1361820308376,1361820315992,880001396,880009012,7616
1361820317,880010040,74,99339,1342.418919,1361820308293,1361820315973,880001333,880009013,7680
1361820317,880010040,34,44060,1295.882353,1361820308293,1361820315973,880001333,880009013,7680
1361820317,880010040,4,1007,251.75,1361820308357,1361820315973,880001397,880009013,7616
1361820319,2241698236,5,660,132,1361820306801,1361820315633,2241686037,2241694869,8832
1361820319,2241698312,5,516,103.2,1361820306341,1361820315557,2241685653,2241694869,9216
1361820319,2241698320,12,7611,634.25,1361820306973,1361820315549,2241686293,2241694869,8576
1361820349,880042028,84,103630,1233.690476,1361820334288,1361820345296,880027316,880038324,11008
1361820349,880042028,76,93825,1234.539474,1361820334288,1361820345360,880027316,880038388,11072
1361820349,880042040,20,12768,638.4,1361820334407,1361820345351,880027447,880038391,10944
1361820349,880042040,72,93895,1304.097222,1361820334343,1361820345287,880027383,880038327,10944
1361820351,2241730304,5,571,114.2,1361820332715,1361820344875,2241712019,2241724179,12160
1361820351,2241730376,10,3658,365.8,1361820335716,1361820344804,2241715092,2241724180,9088
1361820351,2241730380,47,33496,712.6808511,1361820331550,1361820344862,2241710930,2241724242,13312
1361820357,880050012,9,2308,256.4444444,1361820346720,1361820353568,880039732,880046580,6848
1361820357,880050020,13,6143,472.5384615,1361820345560,1361820353624,880038580,880046644,8064
1361820357,880050020,241,348652,1446.688797,1361820345624,1361820353560,880038644,880046580,7936
1361820357,880050040,8,1292,161.5,1361820346759,1361820353543,880039799,880046583,6784
1361820357,880050048,9,2709,301,1361820345535,1361820353599,880038583,880046647,8064
1361820358,2241736912,1,127,127,1361820330674,1361820330674,2241709586,2241709586,0
1361820359,2241738240,34,27637,812.8529412,1361820345387,1361820353323,2241724627,2241732563,7936
1361820359,2241738244,10,3176,317.6,1361820345509,1361820353189,2241724753,2241732433,7680
1361820359,2241738244,10,3128,312.8,1361820345513,1361820353257,2241724757,2241732501,7744
1361820359,2241738244,28,26342,940.7857143,1361820345575,1361820353191,2241724819,2241732435,7616
1361820359,2241738244,21,16394,780.6666667,1361820345639,1361820353191,2241724883,2241732435,7552
1361820359,2241738316,29,13914,479.7931034,1361820345249,1361820353249,2241724565,2241732565,8000
1361820359,2241738316,33,24832,752.4848485,1361820345375,1361820353247,2241724691,2241732563,7872
1361820359,2241738316,11,3917,356.0909091,1361820345374,1361820353182,2241724690,2241732498,7808
1361820359,2241738320,14,4697,335.5,1361820345433,1361820353177,2241724753,2241732497,7744
1361820359,2241738320,24,18934,788.9166667,1361820345500,1361820353116,2241724820,2241732436,7616
1361820359,2241738320,47,45158,960.8085106,1361820345563,1361820353115,2241724883,2241732435,7552
1361820359,2241738400,31,26206,845.3548387,1361820345227,1361820353163,2241724627,2241732563,7936
1361820367,2241746252,13,5386,414.3076923,1361820353695,1361820359007,2241732947,2241738259,5312
1361820367,2241746380,8,1964,245.5,1361820355872,1361820358880,2241735252,2241738260,3008
1361820373,880066008,9,3008,334.2222222,1361820362532,1361820369636,880055540,880062644,7104
1361820373,880066008,14,9876,705.4285714,1361820362596,1361820369636,880055604,880062644,7040
1361820373,880066032,9,2240,248.8888889,1361820361355,1361820369611,880054387,880062643,8256
1361820375,2241754260,11,4609,419,1361820362070,1361820369174,2241741330,2241748434,7104
1361820375,2241754304,11,3542,322,1361820361003,1361820369195,2241740307,2241748499,8192
1361820375,2241754304,15,5366,357.7333333,1361820361003,1361820369195,2241740307,2241748499,8192
1361820375,2241754304,18,2201,122.2777778,1361820361003,1361820369195,2241740307,2241748499,8192
1361820375,2241754340,28,27182,970.7857143,1361820361992,1361820369096,2241741332,2241748436,7104
1361820375,2241754340,13,5081,390.8461538,1361820361991,1361820369095,2241741331,2241748435,7104
1361820375,2241754340,28,21935,783.3928571,1361820361991,1361820369159,2241741331,2241748499,7168
1361820375,2241754340,15,7908,527.2,1361820361991,1361820369159,2241741331,2241748499,7168
1361820375,2241754340,38,39630,1042.894737,1361820361991,1361820369159,2241741331,2241748499,7168
1361820375,2241754352,16,2884,180.25,1361820370681,1361820373689,2241750033,2241753041,3008
1361820375,2241754384,57,73933,1297.070175,1361820360796,1361820369052,2241740180,2241748436,8256
1361820398,2241776876,9,4935,548.3333333,1361820371158,1361820371862,2241750034,2241750738,704
1361820415,2241794360,6,722,120.3333333,1361820411441,1361820411569,2241790801,2241790929,128
1361820439,2241818388,23,11721,509.6086957,1361820432279,1361820435351,2241811667,2241814739,3072
1361820442,2241820836,9,4935,548.3333333,1361820414910,1361820415998,2241793746,2241794834,1088
1361820447,2241826372,8,2012,251.5,1361820443494,1361820446630,2241822866,2241826002,3136
1361820447,2241826372,9,2272,252.4444444,1361820443493,1361820446629,2241822865,2241826001,3136
1361820447,2241826372,35,35579,1016.542857,1361820443556,1361820446692,2241822928,2241826064,3136
1361820447,2241826376,36,30764,854.5555556,1361820436003,1361820442403,2241815379,2241821779,6400
1361820447,2241826376,10,3144,314.4,1361820436003,1361820441827,2241815379,2241821203,5824
1361820447,2241826376,10,3272,327.2,1361820436066,1361820441890,2241815442,2241821266,5824
1361820447,2241826376,9,2964,329.3333333,1361820436064,1361820441824,2241815440,2241821200,5760
1361820447,2241826376,20,14028,701.4,1361820436192,1361820442464,2241815568,2241821840,6272
1361820447,2241826376,22,14787,672.1363636,1361820436128,1361820441888,2241815504,2241821264,5760
1361820447,2241826376,16,7788,486.75,1361820436192,1361820441952,2241815568,2241821328,5760
1361820448,2241826456,17,14138,831.6470588,1361820444539,1361820447611,2241822995,2241826067,3072
1361820448,2241826456,35,37744,1078.4,1361820444601,1361820447609,2241823057,2241826065,3008
1361820448,2241826460,10,3288,328.8,1361820437046,1361820443062,2241815506,2241821522,6016
1361820448,2241826460,49,51853,1058.22449,1361820437173,1361820443573,2241815633,2241822033,6400
1361820463,2241842364,16,2730,170.625,1361820456303,1361820459439,2241835667,2241838803,3136
1361820464,2241842440,6,722,120.3333333,1361820456971,1361820457163,2241835411,2241835603,192
1361820486,2241865048,9,4935,548.3333333,1361820461034,1361820461802,2241840082,2241840850,768
1361820495,2241874396,67,73403,1095.567164,1361820491149,1361820494733,2241870545,2241874129,3584
1361820495,2241874404,13,3344,257.2307692,1361820491591,1361820494727,2241870995,2241874131,3136
1361820496,2241874444,65,81511,1254.015385,1361820491396,1361820495684,2241869840,2241874128,4288
1361820496,2241874480,19,5520,290.5263158,1361820489823,1361820495647,2241868303,2241874127,5824
1361820501,880194012,11,4530,411.8181818,1361820490082,1361820495266,880183094,880188278,5184
1361820501,880194012,9,2629,292.1111111,1361820490146,1361820495266,880183158,880188278,5120
1361820501,880194024,8,1244,155.5,1361820490134,1361820495254,880183158,880188278,5120
1361820501,880194024,9,2517,279.6666667,1361820490134,1361820495254,880183158,880188278,5120
1361820503,2241882408,6,722,120.3333333,1361820500928,1361820501440,2241880336,2241880848,512
1361820511,2241890352,27,16982,628.962963,1361820501498,1361820504570,2241880850,2241883922,3072
1361820511,2241890400,10,3658,365.8,1361820504647,1361820509959,2241884047,2241889359,5312
1361820519,2241898348,24,12535,522.2916667,1361820511100,1361820514556,2241890448,2241893904,3456
1361820519,2241898352,13,1171,90.07692308,1361820509945,1361820514553,2241889297,2241893905,4608
1361820519,2241898352,9,1860,206.6666667,1361820510071,1361820514487,2241889423,2241893839,4416
1361820519,2241898432,9,1860,206.6666667,1361820509928,1361820514408,2241889360,2241893840,4480
1361820519,2241898432,10,2205,220.5,1361820509927,1361820514407,2241889359,2241893839,4480
1361820519,2241898436,9,1860,206.6666667,1361820510054,1361820514406,2241889490,2241893842,4352
1361820519,2241898436,8,860,107.5,1361820510117,1361820514405,2241889553,2241893841,4288
1361820520,2241898440,8,860,107.5,1361820511305,1361820515401,2241889745,2241893841,4096
1361820520,2241898440,11,1028,93.45454545,1361820511304,1361820515400,2241889744,2241893840,4096
1361820527,2241906392,13,1171,90.07692308,1361820516175,1361820519183,2241895567,2241898575,3008
1361820536,2241914460,23,11731,510.0434783,1361820527734,1361820530806,2241906194,2241909266,3072
1361820538,2241917092,9,4935,548.3333333,1361820510717,1361820511869,2241889809,2241890961,1152
1361820549,880242036,8,1340,167.5,1361820542666,1361820545610,880235702,880238646,2944
1361820549,880242048,8,1308,163.5,1361820542655,1361820545599,880235703,880238647,2944
1361820549,880242048,8,1692,211.5,1361820542591,1361820545535,880235639,880238583,2944
1361820549,880242048,8,1516,189.5,1361820542655,1361820545599,880235703,880238647,2944
1361820551,2241930420,17,3991,234.7647059,1361820540533,1361820545141,2241919953,2241924561,4608
1361820551,2241930420,35,20353,581.5142857,1361820540596,1361820545140,2241920016,2241924560,4544
1361820554,880247052,9,3360,373.3333333,1361820549820,1361820553660,880242872,880246712,3840
1361820557,880250060,8,1548,193.5,1361820549748,1361820553652,880242808,880246712,3904
1361820557,880250060,10,3988,398.8,1361820549811,1361820553651,880242871,880246711,3840
1361820557,880250060,30,34798,1159.933333,1361820549811,1361820553587,880242871,880246647,3776
1361820558,2241937140,1,89,89,1361820532429,1361820532429,2241911569,2241911569,0
1361820559,2241938392,18,4380,243.3333333,1361820549521,1361820556625,2241928913,2241936017,7104
1361820559,2241938392,16,12828,801.75,1361820549584,1361820552976,2241928976,2241932368,3392
1361820559,2241938400,15,2902,193.4666667,1361820549959,1361820553031,2241929359,2241932431,3072
1361820560,2241938476,10,4724,472.4,1361820550499,1361820553891,2241928975,2241932367,3392
1361820560,2241938480,15,11800,786.6666667,1361820550686,1361820553822,2241929166,2241932302,3136
1361820560,2241938484,15,3603,240.2,1361820550811,1361820554011,2241929295,2241932495,3200
1361820560,2241938484,15,2840,189.3333333,1361820550811,1361820554011,2241929295,2241932495,3200
1361820560,2241938492,6,722,120.3333333,1361820552787,1361820552979,2241931279,2241931471,192
1361820568,2241946500,24,12504,521,1361820555467,1361820566283,2241933967,2241944783,10816
1361820573,880266040,8,1980,247.5,1361820562439,1361820565831,880255479,880258871,3392
1361820573,880266044,69,90108,1305.913043,1361820557633,1361820565825,880250677,880258869,8192
1361820573,880266048,16,14177,886.0625,1361820557696,1361820565824,880250744,880258872,8128
1361820573,880266068,17,13055,767.9411765,1361820557612,1361820565804,880250680,880258872,8192
1361820575,2241954436,2,158,79,1361820560420,1361820568164,2241939856,2241947600,7744
1361820583,2241962400,6,486,81,1361820581833,1361820581961,2241961233,2241961361,128
1361820583,2241962404,21,24665,1174.52381,1361820578309,1361820578757,2241957713,2241958161,448
1361820583,2241962404,6,562,93.66666667,1361820582083,1361820582211,2241961487,2241961615,128
1361820583,2241962444,6,562,93.66666667,1361820580508,1361820580700,2241959952,2241960144,192
1361820584,2241962512,6,3125,520.8333333,1361820576960,1361820579136,2241955472,2241957648,2176
1361820591,2241970440,6,2004,334,1361820587296,1361820587424,2241966736,2241966864,128
1361820592,2241970476,5,1291,258.2,1361820589988,1361820590052,2241968464,2241968528,64
1361820599,2241978396,3,396,132,1361820581834,1361820598154,2241961230,2241977550,16320
1361820599,2241978412,87,125932,1447.494253,1361820590522,1361820598074,2241969934,2241977486,7552
1361820599,2241978428,21,25742,1225.809524,1361820590637,1361820598061,2241970065,2241977489,7424
1361820599,2241978436,4,980,245,1361820592994,1361820598050,2241972430,2241977486,5056
1361820600,2241978464,11,7975,725,1361820594542,1361820599022,2241973006,2241977486,4480
1361820600,2241978464,306,443196,1448.352941,1361820594542,1361820599022,2241973006,2241977486,4480
1361820600,2241978468,4,1452,363,1361820594605,1361820599021,2241973073,2241977489,4416
1361820600,2241978468,28,36762,1312.928571,1361820592044,1361820599020,2241970512,2241977488,6976
1361820600,2241978468,5,1781,356.2,1361820586667,1361820599019,2241965135,2241977487,12352
1361820600,2241978472,17,8736,513.8823529,1361820584169,1361820599017,2241962641,2241977489,14848
1361820600,2241978472,13,8580,660,1361820584105,1361820599017,2241962577,2241977489,14912
1361820600,2241978472,3,585,195,1361820584232,1361820599016,2241962704,2241977488,14784
1361820600,2241978472,5,2055,411,1361820587176,1361820599016,2241965648,2241977488,11840
1361820600,2241978480,21,26390,1256.666667,1361820595745,1361820599009,2241974225,2241977489,3264
1361820600,2241978516,5,1881,376.2,1361820593786,1361820598970,2241972302,2241977486,5184
1361820600,2241978528,7,1943,277.5714286,1361820589809,1361820598961,2241968337,2241977489,9152
1361820610,2241989156,1,79,79,1361820583867,1361820583867,2241963023,2241963023,0
1361820626,2242005232,1,46,46,1361820598255,1361820598255,2241977487,2241977487,0
1361820631,2242010440,2,141,70.5,1361820627805,1361820627805,2242007245,2242007245,0
1361820643,2242021440,1,79,79,1361820615494,1361820615494,2241993934,2241993934,0
1361820655,2242033444,11,3246,295.0909091,1361820626949,1361820628933,2242005393,2242007377,1984
1361820800,2242178584,6,419,69.83333333,1361820796406,1361820796598,2242174990,2242175182,192
1361820808,2242186588,9,8800,977.7777778,1361820799922,1361820803058,2242178510,2242181646,3136
1361820816,2242194620,172,220572,1282.395349,1361820803214,1361820814222,2242181834,2242192842,11008
1361820856,2242234692,13,741,57,1361820848070,1361820848646,2242226762,2242227338,576
1361820967,2242346356,11,3246,295.0909091,1361820940396,1361820941996,2242319752,2242321352,1600
1361820967,2242346392,2,141,70.5,1361820941896,1361820941896,2242321288,2242321288,0
1361821232,2242610940,13,4328,332.9230769,1361821207178,1361821225162,2242586118,2242604102,17984
1361821232,2242611032,12,4744,395.3333333,1361821206575,1361821226287,2242585607,2242605319,19712
1361821232,2242611316,9,557,61.88888889,1361821228499,1361821229011,2242607815,2242608327,512
1361821240,2242619224,9,8800,977.7777778,1361821229038,1361821232046,2242608262,2242611270,3008
1361821265,2242643568,2,141,70.5,1361821263292,1361821263292,2242641860,2242641860,0
1361821273,2242651556,2,459,229.5,1361821271563,1361821271563,2242650119,2242650119,0
1361821284,2242663324,11,3246,295.0909091,1361821257800,1361821262728,2242637124,2242642052,4928
1361821609,2242988080,1,46,46,1361821581943,1361821581943,2242961023,2242961023,0
1361821657,2243035816,2,141,70.5,1361821654913,1361821654913,2243033729,2243033729,0
1361821677,2243056260,11,3246,295.0909091,1361821651653,1361821654661,2243030913,2243033921,3008
1361822129,2243508016,2,141,70.5,1361822128623,1361822128623,2243507639,2243507639,0
1361822143,2243521948,11,3246,295.0909091,1361822127475,1361822128755,2243506423,2243507703,1280
1361822449,2243828228,2,141,70.5,1361822441498,1361822441498,2243820726,2243820726,0
1361822468,2243846456,11,3246,295.0909091,1361822441116,1361822442268,2243819572,2243820724,1152
1361822761,2244139460,3,138,46,1361822733649,1361822742737,2244112109,2244121197,9088
1361822762,2244141096,2,141,70.5,1361822755608,1361822755608,2244134704,2244134704,0
1361822778,2244156744,1,46,46,1361822752119,1361822752119,2244130863,2244130863,0
1361822781,2244160260,1,46,46,1361822753970,1361822753970,2244133230,2244133230,0
1361822781,2244160296,11,3246,295.0909091,1361822754189,1361822755469,2244133485,2244134765,1280
1361823074,2244452972,2,141,70.5,1361823071437,1361823071437,2244450409,2244450409,0
1361823079,2244457908,11,3246,295.0909091,1361823070285,1361823071501,2244449193,2244450409,1216
1361825907,2247285836,1,46,46,1361825878957,1361825878957,2247257793,2247257793,0
1361826933,2248311872,1,46,46,1361826906681,1361826906681,2248285553,2248285553,0
1361827089,2248468396,1,46,46,1361827062378,1361827062378,2248441774,2248441774,0
1361828805,2250183704,1,48,48,1361828776964,1361828776964,2250155668,2250155668,0
1361830322,2251700548,1,48,48,1361830294343,1361830294343,2251672891,2251672891,0
1361834717,2256095632,1,46,46,1361834690291,1361834690291,2256068923,2256068923,0
1361836786,2258164804,1,52,52,1361836761127,1361836761127,2258139931,2258139931,0
1361837636,2259014928,20,920,46,1361837608543,1361837608543,2258987471,2258987471,0
1361839011,2260390152,1,48,48,1361838986281,1361838986281,2260365433,2260365433,0
1361840135,2261513436,1,48,48,1361840108965,1361840108965,2261487401,2261487401,0
1361841874,2263252456,1,60,60,1361841847094,1361841847094,2263225550,2263225550,0
1361842054,2263433060,4,202,50.5,1361842026903,1361842048407,2263405963,2263427467,21504
1361842098,2263477092,1,48,48,1361842072631,1361842072631,2263451723,2263451723,0
1361842139,2263517548,2,122,61,1361842114200,1361842116568,2263492748,2263495116,2368
1361842151,2263529464,1,46,46,1361842125673,1361842125673,2263504137,2263504137,0
1361843821,2265199816,1,46,46,1361843792563,1361843792563,2265171379,2265171379,0
1361844127,2265505448,1,60,60,1361844099228,1361844099228,2265477676,2265477676,0
1361844222,2265601360,1,46,46,1361844194701,1361844194701,2265574061,2265574061,0
1361844226,2265605156,1,46,46,1361844198616,1361844198616,2265577772,2265577772,0
1361844748,2266126704,1,444,444,1361844720148,1361844720148,2266098852,2266098852,0
1361848377,2269755712,1,46,46,1361848351767,1361848351767,2269730479,2269730479,0
1361848377,2269755732,1,46,46,1361848352002,1361848352002,2269730734,2269730734,0
1361848382,908075276,1,46,46,1361848357134,1361848357134,908050410,908050410,0
1361849679,2271058236,1,46,46,1361849654391,1361849654391,2271033627,2271033627,0
1361850746,2272124744,1,436,436,1361850721171,1361850721171,2272099915,2272099915,0
1361851540,2272918476,1,49,49,1361851514257,1361851514257,2272892733,2272892733,0
1361855388,2276767268,1,437,437,1361855361919,1361855361919,2276741187,2276741187,0
1361855545,2276923636,1,48,48,1361855519414,1361855519414,2276898050,2276898050,0
1361855545,2276923796,1,48,48,1361855519253,1361855519253,2276898049,2276898049,0
1361855545,2276923796,1,48,48,1361855519253,1361855519253,2276898049,2276898049,0
1361855797,2277175948,5,250,50,1361855772731,1361855794939,2277151679,2277173887,22208
1361855845,2277224048,1,48,48,1361855819413,1361855819413,2277198461,2277198461,0
1361855873,2277251924,1,48,48,1361855848851,1361855848851,2277227775,2277227775,0
1361857067,2278446092,1,46,46,1361857039002,1361857039002,2278418094,2278418094,0
1361857203,2278582256,3,180,60,1361857176945,1361857179953,2278556201,2278559209,3008
1361857223,2278602196,3,180,60,1361857198443,1361857201451,2278577639,2278580647,3008
1361857661,2279039988,1,71,71,1361857634360,1361857634360,2279013348,2279013348,0
1361857801,2279180100,1,71,71,1361857775493,1361857775493,2279154593,2279154593,0
1361858258,2279637076,1,63,63,1361858233044,1361858233044,2279612120,2279612120,0
1361859216,2280594552,1,60,60,1361859190549,1361859190549,2280569101,2280569101,0
1361859256,2280634672,1,60,60,1361859228763,1361859228763,2280607435,2280607435,0
1361859809,2281187816,1,46,46,1361859782147,1361859782147,2281160963,2281160963,0
1361861191,2282570164,1,46,46,1361861165971,1361861165971,2282545135,2282545135,0
1361862247,2283625764,1,48,48,1361862217812,1361862217812,2283596576,2283596576,0
1361863187,2284565908,1,60,60,1361863159411,1361863159411,2284538319,2284538319,0
1361863248,2284626852,1,46,46,1361863223082,1361863223082,2284601934,2284601934,0
1361863490,2284868364,1,48,48,1361863462479,1361863462479,2284840843,2284840843,0
1361863953,2285332244,1,78,78,1361863927193,1361863927193,2285306437,2285306437,0
1361864190,2285568412,1,52,52,1361864162454,1361864162454,2285540866,2285540866,0
1361864864,2286243004,1,46,46,1361864836796,1361864836796,2286215800,2286215800,0
1361865113,2286491616,1,48,48,1361865084219,1361865084219,2286462835,2286462835,0
1361865917,2287295856,1,46,46,1361865890753,1361865890753,2287269609,2287269609,0
1361868409,2289788008,3,180,60,1361868383427,1361868392451,2289762435,2289771459,9024
1361871436,2292815240,1,46,46,1361871408237,1361871408237,2292787477,2292787477,0
1361871496,2292874680,1,46,46,1361871471836,1361871471836,2292850516,2292850516,0
1361871985,2293363372,1,48,48,1361871957897,1361871957897,2293336269,2293336269,0
1361873291,2294669752,2,92,46,1361873265529,1361873266105,2294644281,2294644857,576
1361873880,2295258792,5,250,50,1361873852170,1361873873738,2295230962,2295252530,21568
1361873924,2295302868,1,48,48,1361873897981,1361873897981,2295276849,2295276849,0
1361873952,2295330860,1,48,48,1361873927044,1361873927044,2295305904,2295305904,0
1361874662,2296040324,2,122,61,1361874637775,1361874640079,2296016099,2296018403,2304
1361880884,2302263040,1,404,404,1361880856039,1361880856039,2302235079,2302235079,0
1361883071,2304449952,1,46,46,1361883043297,1361883043297,2304422249,2304422249,0
1361883374,2304752420,1,46,46,1361883347054,1361883347054,2304725474,2304725474,0
1361884774,2305559884,1,46,46,1361884745552,1361884745552,2305531436,2305531436,0
1361886886,2308265184,1,56,56,1361886860989,1361886860989,2308240173,2308240173,0
1361889754,2311133044,1,46,46,1361889726685,1361889726685,2311105729,2311105729,0
1361891542,2312920600,1,46,46,1361891514559,1361891514559,2312893159,2312893159,0
1361892383,2313762136,1,46,46,1361892355482,1361892355482,2313734618,2313734618,0
1361893711,2315090144,1,46,46,1361893682943,1361893682943,2315062087,2315062087,0
1361894292,2315670548,5,1427,285.4,1361894266569,1361894267977,2315645117,2315646525,1408
1361894336,2315714632,3,541,180.3333333,1361894308150,1361894308342,2315686782,2315686974,192
1361894348,2315726632,9,1298,144.2222222,1361894322613,1361894322933,2315701245,2315701565,320
1361894376,2315754876,2,489,244.5,1361894348098,1361894348226,2315726974,2315727102,128
1361894378,2315756356,5,287,57.4,1361894372939,1361894373003,2315751295,2315751359,64
1361894416,2315795056,2,489,244.5,1361894387917,1361894388109,2315766973,2315767165,192
1361894452,2315831164,2,489,244.5,1361894427744,1361894427808,2315806908,2315806972,64
1361894472,2315851068,29,3085,106.3793103,1361894444415,1361894446079,2315823483,2315825147,1664
1361894472,2315851076,2,149,74.5,1361894445176,1361894445304,2315824252,2315824380,128
1361894472,2315851144,6,501,83.5,1361894444340,1361894444788,2315823484,2315823932,448
1361894472,2315851148,21,2446,116.4761905,1361894444656,1361894445360,2315823804,2315824508,704
1361894472,2315851152,2,149,74.5,1361894445100,1361894445164,2315824252,2315824316,64
1361894472,2315851152,2,149,74.5,1361894445036,1361894445164,2315824188,2315824316,128
1361894496,2315875172,2,489,244.5,1361894468567,1361894468695,2315847739,2315847867,128
1361894537,2315915428,2,489,244.5,1361894509568,1361894509760,2315887996,2315888188,192
1361894541,2315919484,1,52,52,1361894513479,1361894513479,2315891963,2315891963,0
1361894577,2315955448,2,489,244.5,1361894549418,1361894549610,2315927866,2315928058,192
1361894617,2315995432,2,489,244.5,1361894590137,1361894590265,2315968569,2315968697,128
1361894657,2316035508,2,489,244.5,1361894629612,1361894629676,2316008120,2316008184,64
1361894697,2316075768,3,926,308.6666667,1361894669224,1361894669672,2316047992,2316048440,448
1361894737,2316115884,2,489,244.5,1361894709810,1361894709938,2316088694,2316088822,128
1361894746,2316124524,391,388543,993.7161125,1361893845980,1361894445084,2315224504,2315823608,599104
1361894765,2316143848,1,89,89,1361894739865,1361894739865,2316118713,2316118713,0
1361894765,2316143848,1,89,89,1361894739929,1361894739929,2316118777,2316118777,0
1361894773,2316151852,2,149,74.5,1361894746131,1361894746259,2316124983,2316125111,128
1361894773,2316151900,24,2860,119.1666667,1361894744929,1361894746913,2316123829,2316125813,1984
1361894773,2316151900,6,501,83.5,1361894744865,1361894745377,2316123765,2316124277,512
1361894773,2316151900,4,1062,265.5,1361894744929,1361894745377,2316123829,2316124277,448
1361894773,2316151916,7,2797,399.5714286,1361894745042,1361894746194,2316123958,2316125110,1152
1361894773,2316151920,2,149,74.5,1361894746063,1361894746191,2316124983,2316125111,128
1361894773,2316151924,14,2145,153.2142857,1361894745420,1361894746316,2316124344,2316125240,896
1361894777,2316155840,2,489,244.5,1361894750365,1361894750493,2316129205,2316129333,128
1361894817,2316195976,2,489,244.5,1361894790550,1361894790742,2316169526,2316169718,192
1361894829,2316207992,11,3116,283.2727273,1361894802759,1361894803143,2316181751,2316182135,384
1361894853,2316231964,1,95,95,1361894826977,1361894826977,2316205941,2316205941,0
1361894857,2316236016,2,489,244.5,1361894829934,1361894830126,2316208950,2316209142,192
1361894858,2316236684,5,287,57.4,1361894852604,1361894852668,2316231288,2316231352,64
1361894882,2316260752,10,3832,383.2,1361894880695,1361894880887,2316259447,2316259639,192
1361894897,2316276084,2,489,244.5,1361894870568,1361894870696,2316249652,2316249780,128
1361894905,2316284124,19,14892,783.7894737,1361894880514,1361894880834,2316259638,2316259958,320
1361894937,2316316024,2,489,244.5,1361894910629,1361894910757,2316289653,2316289781,128
1361894965,2316344120,2,104,52,1361894940355,1361894940355,2316319475,2316319475,0
1361894977,2316356196,2,489,244.5,1361894950840,1361894950968,2316330036,2316330164,128
1361895017,2316396180,2,489,244.5,1361894990982,1361894991110,2316370162,2316370290,128
1361895058,2316436240,2,489,244.5,1361895032114,1361895032306,2316410354,2316410546,192
1361895070,2316448292,30,3173,105.7666667,1361895045181,1361895047229,2316423473,2316425521,2048
1361895070,2316448376,7,598,85.42857143,1361895045099,1361895045803,2316423475,2316424179,704
1361895070,2316448376,2,149,74.5,1361895045099,1361895045227,2316423475,2316423603,128
1361895070,2316448376,14,2145,153.2142857,1361895045417,1361895046505,2316423793,2316424881,1088
1361895074,2316452244,2,149,74.5,1361895046317,1361895046637,2316424561,2316424881,320
1361895074,2316452248,2,149,74.5,1361895046376,1361895046568,2316424624,2316424816,192
1361895074,2316452320,2,149,74.5,1361895046308,1361895046564,2316424628,2316424884,256
1361895098,2316476436,2,489,244.5,1361895072173,1361895072365,2316450609,2316450801,192
1361895138,2316516504,2,489,244.5,1361895111851,1361895112043,2316490355,2316490547,192
1361895178,2316556572,2,489,244.5,1361895151654,1361895151782,2316530226,2316530354,128
1361895210,2316588972,4,585,146.25,1361895197460,1361895207508,2316576432,2316586480,10048
1361895218,2316596660,2,489,244.5,1361895191180,1361895191308,2316569840,2316569968,128
1361895238,2316616636,1,52,52,1361895212709,1361895212709,2316591345,2316591345,0
1361895258,2316636648,2,489,244.5,1361895231640,1361895231768,2316610288,2316610416,128
1361895298,2316676664,2,489,244.5,1361895271559,1361895271687,2316650223,2316650351,128
1361895310,2316688748,8,1054,131.75,1361895283509,1361895283829,2316662257,2316662577,320
1361895338,2316717028,2,489,244.5,1361895311643,1361895311771,2316690671,2316690799,128
1361895339,2316717348,5,287,57.4,1361895332993,1361895332993,2316711341,2316711341,0
1361895370,2316749084,25,2895,115.8,1361895344418,1361895345954,2316723502,2316725038,1536
1361895370,2316749084,6,501,83.5,1361895344417,1361895344865,2316723501,2316723949,448
1361895370,2316749084,2,149,74.5,1361895344417,1361895344545,2316723501,2316723629,128
1361895370,2316749092,2,149,74.5,1361895345115,1361895345243,2316724207,2316724335,128
1361895370,2316749092,2,149,74.5,1361895345115,1361895345243,2316724207,2316724335,128
1361895371,2316749200,15,2134,142.2666667,1361895345624,1361895346328,2316723824,2316724528,704
1361895371,2316749220,2,149,74.5,1361895345986,1361895346114,2316724206,2316724334,128
1361895378,2316757092,2,489,244.5,1361895352474,1361895352666,2316731566,2316731758,192
1361895419,2316797272,2,489,244.5,1361895392973,1361895393101,2316771245,2316771373,128
1361895458,2316837176,2,489,244.5,1361895432004,1361895432196,2316811180,2316811372,192
1361895499,2316877692,2,489,244.5,1361895472743,1361895472935,2316851435,2316851627,192
1361895539,2316917688,2,489,244.5,1361895512492,1361895512620,2316891180,2316891308,128
1361895579,2316957772,2,489,244.5,1361895552342,1361895552470,2316931114,2316931242,128
1361895619,2316997784,2,489,244.5,1361895592267,1361895592395,2316971051,2316971179,128
1361895659,2317038020,2,489,244.5,1361895632413,1361895632477,2317011433,2317011497,64
1361895667,2317045904,1,89,89,1361895639761,1361895639761,2317018665,2317018665,0
1361895667,2317045976,1,89,89,1361895639819,1361895639819,2317018795,2317018795,0
1361895671,2317049900,6,501,83.5,1361895644565,1361895645269,2317023465,2317024169,704
1361895671,2317049900,6,1949,324.8333333,1361895644757,1361895645653,2317023657,2317024553,896
1361895671,2317049928,17,2238,131.6470588,1361895645115,1361895645819,2317024043,2317024747,704
1361895671,2317049928,2,149,74.5,1361895645497,1361895645625,2317024425,2317024553,128
1361895671,2317049932,2,149,74.5,1361895645495,1361895645623,2317024427,2317024555,128
1361895671,2317049972,27,2999,111.0740741,1361895644492,1361895646284,2317023464,2317025256,1792
1361895671,2317049976,4,1062,265.5,1361895644491,1361895644939,2317023467,2317023915,448
1361895683,2317061620,2,178,89,1361895681646,1361895681646,2317060266,2317060266,0
1361895683,2317061620,2,178,89,1361895681710,1361895681710,2317060330,2317060330,0
1361895699,2317077576,10,3832,383.2,1361895697113,1361895697241,2317075689,2317075817,128
1361895699,2317077980,2,489,244.5,1361895672711,1361895672775,2317051691,2317051755,64
1361895707,2317085568,2,131,65.5,1361895700579,1361895700579,2317079147,2317079147,0
1361895707,2317085568,18,4023,223.5,1361895693151,1361895703583,2317071719,2317082151,10432
1361895707,2317085572,18,3951,219.5,1361895693279,1361895703583,2317071851,2317082155,10304
1361895707,2317085628,290,322978,1113.717241,1361893843299,1361895698979,2315221927,2317077607,1855680
1361895719,2317097972,1,52,52,1361895694158,1361895694158,2317073130,2317073130,0
1361895719,2317097972,1,52,52,1361895694156,1361895694156,2317073128,2317073128,0
1361895719,2317097976,5,380,76,1361895694729,1361895698761,2317073705,2317077737,4032
1361895719,2317098052,17,4063,239,1361895694655,1361895699455,2317073707,2317078507,4800
1361895723,2317101936,1,52,52,1361895698672,1361895698672,2317077608,2317077608,0
1361895723,2317101936,1,52,52,1361895698671,1361895698671,2317077607,2317077607,0
1361895723,2317101992,1,52,52,1361895698617,1361895698617,2317077609,2317077609,0
1361895723,2317101992,1,52,52,1361895698616,1361895698616,2317077608,2317077608,0
1361895723,2317101992,16,3778,236.125,1361895698680,1361895699704,2317077672,2317078696,1024
1361895723,2317102028,21,14996,714.0952381,1361895696788,1361895697108,2317075816,2317076136,320
1361895727,2317105956,24,5118,213.25,1361895699742,1361895703646,2317078698,2317082602,3904
1361895727,2317106008,10,5289,528.9,1361895699048,1361895699496,2317078056,2317078504,448
1361895727,2317106044,32,6368,199,1361895701189,1361895719941,2317080233,2317098985,18752
1361895731,2317110004,18,4299,238.8333333,1361895703662,1361895704942,2317082666,2317083946,1280
1361895743,2317121924,1,95,95,1361895714942,1361895714942,2317093866,2317093866,0
1361895755,2317134124,3,342,114,1361895729909,1361895749877,2317109033,2317129001,19968
1361895763,2317142132,7,3059,437,1361895738733,1361895754925,2317117865,2317134057,16192
1361895787,2317166104,3,342,114,1361895759878,1361895779910,2317138982,2317159014,20032
1361895799,2317178120,2,516,258,1361895771319,1361895798775,2317150439,2317177895,27456
1361895816,2317194440,3,342,114,1361895790560,1361895810592,2317169000,2317189032,20032
1361895827,2317205736,6,447,74.5,1361895819767,1361895823991,2317198503,2317202727,4224
1361895832,2317210416,1,437,437,1361895804918,1361895804918,2317183334,2317183334,0
1361895843,2317221788,2,158,79,1361895828419,1361895837379,2317207207,2317216167,8960
1361895880,2317258624,1,79,79,1361895855527,1361895855527,2317234151,2317234151,0
1361895916,2317294492,1,79,79,1361895891562,1361895891562,2317270054,2317270054,0
1361895939,2317317944,4,208,52,1361895937189,1361895938725,2317316133,2317317669,1536
1361895968,2317346896,1,52,52,1361895940566,1361895940566,2317319462,2317319462,0
1361897046,2318425116,1,95,95,1361897020455,1361897020455,2318399571,2318399571,0
1361897452,2318830852,5,260,52,1361897445737,1361897449257,2318824589,2318828109,3520
1361897468,2318846800,2,104,52,1361897453087,1361897460703,2318831887,2318839503,7616
1361897484,2318862860,2,104,52,1361897470628,1361897480612,2318849488,2318859472,9984
1361897508,2318886836,4,208,52,1361897505145,1361897506809,2318883981,2318885645,1664
1361897508,2318886876,5,260,52,1361897503698,1361897507282,2318882574,2318886158,3584
1361897508,2318886876,6,312,52,1361897499793,1361897507153,2318878669,2318886029,7360
1361897516,2318894876,2,104,52,1361897508625,1361897512465,2318887501,2318891341,3840
1361897524,2318902916,2,104,52,1361897511018,1361897518634,2318889934,2318897550,7616
1361897532,2318910852,2,104,52,1361897520043,1361897530027,2318898895,2318908879,9984
1361897532,2318910940,2,104,52,1361897514639,1361897524687,2318893579,2318903627,10048
1361897540,2318918864,2,104,52,1361897528668,1361897538652,2318907532,2318917516,9984
1361897558,2318936632,1,48,48,1361897531077,1361897531077,2318909709,2318909709,0
1361897561,2318939356,1,48,48,1361897532890,1361897532890,2318911246,2318911246,0
1361897561,2318939916,1,52,52,1361897534698,1361897534698,2318913614,2318913614,0
1361897568,2318946804,1,52,52,1361897540120,1361897540120,2318918924,2318918924,0
1361897624,2319002880,3,174,58,1361897599051,1361897608395,2318977931,2318987275,9344
1361897632,2319010920,1,46,46,1361897607394,1361897607394,2318986314,2318986314,0
1361898237,2319616068,1,46,46,1361898211654,1361898211654,2319590722,2319590722,0
1361899572,2320950552,1,46,46,1361899546745,1361899546745,2320925297,2320925297,0
1361899696,2321074940,2,122,61,1361899671279,1361899671407,2321050219,2321050347,128
1361899913,2321291488,1,48,48,1361899888050,1361899888050,2321266538,2321266538,0
1361901729,2323107272,2,122,61,1361901701678,1361901703982,2323079950,2323082254,2304
1361903390,2324768312,1,46,46,1361903362349,1361903362349,2324740661,2324740661,0
1361905379,2326758148,1,48,48,1361905353421,1361905353421,2326732569,2326732569,0
1361905797,2327175852,1,46,46,1361905768941,1361905768941,2327147793,2327147793,0
1361905871,2327249260,1,46,46,1361905842942,1361905842942,2327221202,2327221202,0
1361907486,2328864532,1,46,46,1361907457426,1361907457426,2328835958,2328835958,0
1361907648,2329026772,1,74,74,1361907622881,1361907622881,2329001653,2329001653,0
1361910666,2332044740,1,52,52,1361910639060,1361910639060,2332017800,2332017800,0
1361911287,2332665492,1,48,48,1361911258115,1361911258115,2332636607,2332636607,0
1361911438,2332816396,1,46,46,1361911421023,1361911421023,2332799419,2332799419,0
1361911894,2333272232,1,56,56,1361911867324,1361911867324,2333245556,2333245556,0
1361912287,2333665420,1,46,46,1361912261437,1361912261437,2333639857,2333639857,0
1361912319,2333697352,1,46,46,1361912291328,1361912291328,2333669680,2333669680,0
1361912611,2333989796,2,92,46,1361912585853,1361912585853,2333964649,2333964649,0
1361913784,2335162400,1,46,46,1361913756344,1361913756344,2335134744,2335134744,0
1361915313,975005984,1,46,46,1361915288676,1361915288676,974981660,974981660,0
1361915489,2336867980,1,48,48,1361915458778,1361915458778,2336837758,2336837758,0
1361917900,2339278576,1,52,52,1361917874572,1361917874572,2339253148,2339253148,0
1361919687,2341065616,1,48,48,1361919659336,1361919659336,2341037952,2341037952,0
1361920409,2341787680,3,144,48,1361920381758,1361920390846,2341760438,2341769526,9088
1361925202,2346581012,1,46,46,1361925173417,1361925173417,2346552429,2346552429,0
1361925462,2346840528,1,119,119,1361925435208,1361925435208,2346813736,2346813736,0
1361929251,2350629800,2,122,61,1361929224703,1361929227199,2350603503,2350605999,2496
1361929493,2350872052,1,48,48,1361929464000,1361929464000,2350843052,2350843052,0
1361929614,2350992132,1,46,46,1361929586710,1361929586710,2350964842,2350964842,0
1361934521,2355899880,1,61,61,1361934496160,1361934496160,2355875040,2355875040,0
1361935528,2356906104,1,60,60,1361935500954,1361935500954,2356879058,2356879058,0
1361937417,2358795716,2,120,60,1361937388824,1361937391832,2358767540,2358770548,3008
1361940793,2362171056,1,64,64,1361940768313,1361940768313,2362146369,2362146369,0
1361943205,2364583872,1,48,48,1361943180069,1361943180069,2364558941,2364558941,0
1361943205,2364583872,1,48,48,1361943180069,1361943180069,2364558941,2364558941,0
1361947705,2369083360,1,55,55,1361947677986,1361947677986,2369056346,2369056346,0
1361949776,2371154212,1,46,46,1361949747864,1361949747864,2371126076,2371126076,0
1361951343,2372721808,1,78,78,1361951318058,1361951318058,2372696866,2372696866,0
1361951452,2372830456,1,46,46,1361951423628,1361951423628,2372802084,2372802084,0
1361952775,2374153024,2,120,60,1361952747940,1361952747940,2374125964,2374125964,0
1361954297,2375675336,2,122,61,1361954272792,1361954274840,2375651128,2375653176,2048
1361954772,2376150304,1,46,46,1361954744368,1361954744368,2376122672,2376122672,0
1361955644,2377022172,1,48,48,1361955618214,1361955618214,2376996386,2376996386,0
1361956195,2377573480,1,46,46,1361956186219,1361956186219,2377564699,2377564699,0
1361956874,2378252940,1,447,447,1361956847125,1361956847125,2378226065,2378226065,0
1361957529,2378907580,1,46,46,1361957500978,1361957500978,2378879558,2378879558,0
1361957788,2379166676,1,64,64,1361957762381,1361957762381,2379141057,2379141057,0
1361957957,2379335096,1,46,46,1361957931663,1361957931663,2379309759,2379309759,0
1361958107,2379485752,1,46,46,1361958080957,1361958080957,2379459709,2379459709,0
1361958695,2380073884,1,46,46,1361958668207,1361958668207,2380047091,2380047091,0
1361958743,2380121272,1,48,48,1361958714964,1361958714964,2380093236,2380093236,0
1361961529,2382907740,1,64,64,1361961501270,1361961501270,2382880010,2382880010,0
1361962518,2383896196,1,46,46,1361962490470,1361962490470,2383868666,2383868666,0
1361964272,2385650848,1,46,46,1361964244032,1361964244032,2385622880,2385622880,0
1361966938,2388316188,1,46,46,1361966911021,1361966911021,2388289209,2388289209,0
1361968414,2389792496,2,104,52,1361968389028,1361968392036,2389767524,2389770532,3008
1361971526,2392904620,1,46,46,1361971497590,1361971497590,2392876210,2392876210,0
1361973215,2394593736,1,46,46,1361973188073,1361973188073,2394566809,2394566809,0
1361973443,2394821032,1,46,46,1361973415976,1361973415976,2394794008,2394794008,0
1361975151,2396529572,1,46,46,1361975127343,1361975127343,2396505915,2396505915,0
1361975155,2396533892,1,46,46,1361975138159,1361975138159,2396517051,2396517051,0
1361976341,2397719412,2,122,61,1361976316414,1361976318782,2397694826,2397697194,2368
1361977363,1037055556,1,46,46,1361977334815,1361977334815,1037027371,1037027371,0
1361979233,2400611388,1,46,46,1361979206060,1361979206060,2400584448,2400584448,0
1361979513,2400891908,1,46,46,1361979484384,1361979484384,2400863292,2400863292,0
1361982032,2403410504,1,46,46,1361982005963,1361982005963,2403384467,2403384467,0
1361982899,2404277144,1,46,46,1361982872745,1361982872745,2404250889,2404250889,0
1361983500,2404878552,1,48,48,1361983475206,1361983475206,2404853758,2404853758,0
1361983604,2404982200,1,60,60,1361983579044,1361983579044,2404957244,2404957244,0
1361985284,2406661972,1,60,60,1361985255600,1361985255600,2406633572,2406633572,0
1361986518,2407896436,1,46,46,1361986490702,1361986490702,2407869138,2407869138,0
1361988598,2409976680,1,48,48,1361988570490,1361988570490,2409949170,2409949170,0
1361989264,2410642480,1,56,56,1361989239288,1361989239288,2410617768,2410617768,0
1361989921,2411299264,3,152,50.66666667,1361989895684,1361989904708,2411273948,2411282972,9024
1361991571,2412949464,1,46,46,1361991543014,1361991543014,2412921478,2412921478,0
1361994147,2415525440,2,122,61,1361994121623,1361994123927,2415500063,2415502367,2304
1361995041,2416419196,1,71,71,1361995013885,1361995013885,2416392081,2416392081,0
1361995490,2416868704,1,46,46,1361995461946,1361995461946,2416840650,2416840650,0
1361997683,2419061284,1,48,48,1361997654139,1361997654139,2419032423,2419032423,0
1362002783,2424161348,1,46,46,1362002754800,1362002754800,2424133148,2424133148,0
1362005475,2426853112,1,46,46,1362005450035,1362005450035,2426828147,2426828147,0
1362005925,2427303276,1,60,60,1362005898505,1362005898505,2427276781,2427276781,0
1362006355,2427733240,1,46,46,1362006327653,1362006327653,2427705893,2427705893,0
1362008165,2429543056,1,46,46,1362008136580,1362008136580,2429514636,2429514636,0
1362010188,2431566752,1,404,404,1362010163245,1362010163245,2431541997,2431541997,0
1362010273,2431651148,1,48,48,1362010244551,1362010244551,2431622699,2431622699,0
1362010570,2431948520,1,46,46,1362010542991,1362010542991,2431921511,2431921511,0
1362011516,2432894288,1,46,46,1362011488743,1362011488743,2432867031,2432867031,0
1362014802,2436179916,1,46,46,1362014775785,1362014775785,2436153701,2436153701,0
1362015696,2437074656,1,48,48,1362015666554,1362015666554,2437045210,2437045210,0
1362015843,2437221044,1,46,46,1362015815449,1362015815449,2437193493,2437193493,0
1362017879,2439257768,1,46,46,1362017850984,1362017850984,2439229752,2439229752,0
1362018267,2439645560,1,60,60,1362018239152,1362018239152,2439617712,2439617712,0
1362018500,2439878340,1,46,46,1362018475464,1362018475464,2439853804,2439853804,0
1362021291,2442669788,1,60,60,1362021265825,1362021265825,2442644613,2442644613,0
1362021708,2443086564,1,52,52,1362021681786,1362021681786,2443060350,2443060350,0
1362022553,2443931424,1,48,48,1362022523512,1362022523512,2443901936,2443901936,0
1362024361,2445739000,1,46,46,1362024335045,1362024335045,2445713045,2445713045,0
1362024365,2445742836,1,46,46,1362024336873,1362024336873,2445714709,2445714709,0
1362026394,2447772032,1,46,46,1362026368839,1362026368839,2447746871,2447746871,0
1362027488,2448866492,1,46,46,1362027460457,1362027460457,2448838949,2448838949,0
1362027588,2448966700,1,46,46,1362027560280,1362027560280,2448938980,2448938980,0
1362028674,2450052020,1,48,48,1362028646447,1362028646447,2450024467,2450024467,0
1362028776,2450154528,1,447,447,1362028748849,1362028748849,2450127377,2450127377,0
1362030423,2451208000,1,79,79,1362030397188,1362030397188,2451182188,2451182188,0
1362030423,2451208020,1,58,58,1362030398190,1362030398190,2451183210,2451183210,0
1362030424,1090116920,1,79,79,1362030397265,1362030397265,1090090185,1090090185,0
1362030424,1090116924,1,58,58,1362030398285,1362030398285,1090091209,1090091209,0
1362031314,2452692252,1,46,46,1362031288097,1362031288097,2452666349,2452666349,0
1362032764,2454142524,3,138,46,1362032738108,1362032742140,2454116632,2454120664,4032
1362033590,2454968148,1,46,46,1362033565351,1362033565351,2454943499,2454943499,0
1362034529,2455907576,1,46,46,1362034501035,1362034501035,2455879611,2455879611,0
1362036275,2457653280,1,46,46,1362036249083,1362036249083,2457627363,2457627363,0
1362036275,2457653344,1,46,46,1362036248698,1362036248698,2457627042,2457627042,0
1362037466,2458844428,1,60,60,1362037438355,1362037438355,2458816783,2458816783,0
1362038735,2460113292,1,58,58,1362038708936,1362038708936,2460087228,2460087228,0
1362039917,2461294776,1,52,52,1362039891131,1362039891131,2461268907,2461268907,0
1362040289,2461667684,1,60,60,1362040263592,1362040263592,2461642276,2461642276,0
1362040358,2461735828,1,52,52,1362040333440,1362040333440,2461711268,2461711268,0
1362040358,2461735864,1,52,52,1362040331418,1362040331418,2461709282,2461709282,0
1362042049,2463427332,1,46,46,1362042024814,1362042024814,2463403146,2463403146,0
1362043639,2465017652,1,60,60,1362043612180,1362043612180,2464990832,2464990832,0
1362044401,2465779248,6,298,49.66666667,1362044374240,1362044395296,2465752488,2465773544,21056
1362049061,2470438932,1,46,46,1362049032406,1362049032406,2470410338,2470410338,0
1362049515,2470892740,1,60,60,1362049486668,1362049486668,2470864408,2470864408,0
1362049713,2471090736,1,46,46,1362049685068,1362049685068,2471062804,2471062804,0
1362050242,2471619752,2,122,61,1362050215157,1362050217205,2471592909,2471594957,2048
1362050370,2471747980,1,46,46,1362050342545,1362050342545,2471720525,2471720525,0
1362051408,2472786064,1,46,46,1362051380397,1362051380397,2472758461,2472758461,0
1362051717,2473094932,1,52,52,1362051690413,1362051690413,2473068345,2473068345,0
1362052691,2474069576,1,52,52,1362052665817,1362052665817,2474044393,2474044393,0
1362052691,2474069616,1,52,52,1362052663794,1362052663794,2474042410,2474042410,0
1362053161,2474539440,1,48,48,1362053132634,1362053132634,2474511074,2474511074,0
1362054081,2475459076,1,48,48,1362054050425,1362054050425,2475428501,2475428501,0
1362054367,2475745220,1,60,60,1362054341732,1362054341732,2475719952,2475719952,0
1362055485,2476863632,2,120,60,1362055457911,1362055458935,2476836543,2476837567,1024
1362055485,2476863660,2,120,60,1362055459929,1362055460889,2476838589,2476839549,960
1362055838,2477216624,1,60,60,1362055811770,1362055811770,2477190394,2477190394,0
1362057009,2478387116,2,230,115,1362056983780,1362056983780,2478361896,2478361896,0
1362057910,2478694704,1,46,46,1362057883647,1362057883647,2478668351,2478668351,0
1362057911,1117603976,1,46,46,1362057883659,1362057883659,1117576635,1117576635,0
1362058167,2479545352,1,46,46,1362058141031,1362058141031,2479519383,2479519383,0
1362059142,2480520164,1,46,46,1362059113365,1362059113365,2480491529,2480491529,0
1362059437,2480815532,1,48,48,1362059408992,1362059408992,2480787524,2480787524,0
1362059970,2481348644,1,46,46,1362059941990,1362059941990,2481320634,2481320634,0
1362061453,2482831548,5,250,50,1362061426930,1362061448754,2482805478,2482827302,21824
1362061502,2482879976,1,48,48,1362061473836,1362061473836,2482851812,2482851812,0
1362061530,2482908028,1,48,48,1362061503031,1362061503031,2482881059,2482881059,0
1362062120,2483498436,1,46,46,1362062093269,1362062093269,2483471705,2483471705,0
1362063285,2484663608,1,46,46,1362063259417,1362063259417,2484638025,2484638025,0
1362064416,2485794356,1,46,46,1362064388421,1362064388421,2485766777,2485766777,0
1362068181,2489558684,6,681,113.5,1362068159595,1362068174763,2489537279,2489552447,15168
1362068309,2489686784,2,112,56,1362068302468,1362068307524,2489680252,2489685308,5056
1362068309,2489686816,28,36639,1308.535714,1362068306789,1362068307173,2489684605,2489684989,384
1362068309,2489686820,4,729,182.25,1362068307105,1362068307169,2489684925,2489684989,64
1362068309,2489686820,5,740,148,1362068307104,1362068307168,2489684924,2489684988,64
1362068309,2489686820,4,894,223.5,1362068307232,1362068307296,2489685052,2489685116,64
1362068309,2489686868,2,112,56,1362068302384,1362068307440,2489680252,2489685308,5056
1362068309,2489686896,47,65811,1400.234043,1362068306646,1362068306966,2489684542,2489684862,320
1362068309,2489686900,30,40359,1345.3,1362068306639,1362068306703,2489684539,2489684603,64
1362068309,2489686900,27,36034,1334.592593,1362068306706,1362068307090,2489684606,2489684990,384
1362068317,2489694852,1063,1588773,1494.612418,1362068307265,1362068309633,2489685117,2489687485,2368
1362068325,2489702868,30,4636,154.5333333,1362068302001,1362068324465,2489679869,2489702333,22464
1362068325,2489702868,31,4456,143.7419355,1362068302001,1362068324465,2489679869,2489702333,22464
1362068325,2489702868,166,208589,1256.560241,1362068302064,1362068324464,2489679932,2489702332,22400
1362068325,2489702908,4,628,157,1362068306443,1362068317323,2489684351,2489695231,10880
1362068325,2489702912,11,6539,594.4545455,1362068304006,1362068319430,2489681918,2489697342,15424
1362068325,2489702944,110,83845,762.2272727,1362068301412,1362068324388,2489679356,2489702332,22976
1362068325,2489702948,37,5301,143.2702703,1362068301919,1362068324383,2489679867,2489702331,22464
1362068328,2489706544,60,41219,686.9833333,1362068301323,1362068308427,2489679867,2489686971,7104
1362068328,2489706572,4,725,181.25,1362068301873,1362068302449,2489680445,2489681021,576
1362068329,2489706652,3,427,142.3333333,1362068302791,1362068302791,2489680443,2489680443,0
1362068330,1128022476,4,1949,487.25,1362068302466,1362068306434,1127994942,1127998910,3968
1362068333,2489710664,5,868,173.6,1362068306555,1362068327739,2489684219,2489705403,21184
1362068333,2489710720,7,2483,354.7142857,1362068306819,1362068307267,2489684539,2489684987,448
1362068333,2489710728,16,10418,651.125,1362068308027,1362068329851,2489685755,2489707579,21824
1362068333,2489710760,3,297,99,1362068308382,1362068308382,2489686142,2489686142,0
1362068336,2489714544,3,1311,437,1362068308555,1362068309067,2489687099,2489687611,512
1362068373,2489751152,5,740,148,1362068367445,1362068367509,2489745597,2489745661,64
1362068373,2489751152,4,629,157.25,1362068367764,1362068367828,2489745916,2489745980,64
1362068384,2489762616,1,76,76,1362068356483,1362068356483,2489735099,2489735099,0
1362068384,2489762620,1,46,46,1362068356864,1362068356864,2489735484,2489735484,0
1362068385,2489762660,1,540,540,1362068359937,1362068359937,2489737597,2489737597,0
1362068388,2489766628,1,46,46,1362068360378,1362068360378,2489739006,2489739006,0
1362068388,2489766628,1,46,46,1362068360630,1362068360630,2489739258,2489739258,0
1362068389,2489766664,1,46,46,1362068362877,1362068362877,2489740541,2489740541,0
1362068413,2489791028,113,162569,1438.663717,1362068301905,1362068407697,2489679933,2489785725,105792
1362068429,2489806992,5,287,57.4,1362068422324,1362068422388,2489800316,2489800380,64
1362068429,2489807024,5,740,148,1362068427538,1362068427666,2489805562,2489805690,128
1362068429,2489807028,4,629,157.25,1362068427854,1362068427982,2489805882,2489806010,128
1362068429,2489807032,121,169076,1397.322314,1362068308108,1362068424268,2489686140,2489802300,116160
1362068445,2489823004,6,971,161.8333333,1362068422566,1362068437350,2489800570,2489815354,14784
1362068445,2489823184,1,52,52,1362068418099,1362068418099,2489796283,2489796283,0
1362068445,2489823252,1,52,52,1362068417005,1362068417005,2489795257,2489795257,0
1362068446,1128138996,1,52,52,1362068420798,1362068420798,1128113794,1128113794,0
1362068449,2489827064,1,52,52,1362068423211,1362068423211,2489801275,2489801275,0
1362068457,2489835016,1,540,540,1362068429595,1362068429595,2489807611,2489807611,0
1362068469,2489847048,6,1640,273.3333333,1362068460985,1362068466681,2489839033,2489844729,5696
1362068486,1128179020,3,753,251,1362068460645,1362068460645,1128153665,1128153665,0
1362068486,1128179052,9,9312,1034.666667,1362068460613,1362068460677,1128153665,1128153729,64
1362068493,2489871112,5,740,148,1362068487482,1362068487546,2489865594,2489865658,64
1362068493,2489871116,4,629,157.25,1362068487799,1362068487863,2489865915,2489865979,64
1362068497,2489875288,1,89,89,1362068471817,1362068471817,2489850105,2489850105,0
1362068501,2489878980,1316,1968310,1495.676292,1362068496447,1362068498303,2489874427,2489876283,1856
1362068525,2489903236,5,2613,522.6,1362068497534,1362068497598,2489875770,2489875834,64
1362068537,2489915404,2,92,46,1362068510869,1362068510997,2489889273,2489889401,128
1362068549,2489927080,5,740,148,1362068547994,1362068548058,2489926074,2489926138,64
1362068549,2489927164,4,629,157.25,1362068547911,1362068547975,2489926075,2489926139,64
1362068553,2489931436,4,1787,446.75,1362068526582,1362068526582,2489905018,2489905018,0
1362068557,2489935388,32,43900,1371.875,1362068529255,1362068529319,2489907643,2489907707,64
1362068559,1128252104,15,14225,948.3333333,1362068553360,1362068555152,1128246464,1128248256,1792
1362068565,2489943152,9,5076,564,1362068555153,1362068559825,2489933305,2489937977,4672
1362068569,2489947496,1,52,52,1362068543801,1362068543801,2489922297,2489922297,0
1362068577,2489955384,3,652,217.3333333,1362068549226,1362068549290,2489927610,2489927674,64
1362068581,2489959332,7,1046,149.4285714,1362068557727,1362068572703,2489936059,2489951035,14976
1362068602,1128295044,1,52,52,1362068575501,1362068575501,1128268545,1128268545,0
1362068602,1128295044,1,52,52,1362068575500,1362068575500,1128268544,1128268544,0
1362068613,2489991036,4,629,157.25,1362068608067,1362068608131,2489986103,2489986167,64
1362068613,2489991036,5,740,148,1362068608067,1362068608131,2489986103,2489986167,64
1362068621,2489999108,6,663,110.5,1362068602364,1362068617596,2489980472,2489995704,15232
1362068621,2489999584,94,133430,1419.468085,1362068593119,1362068594335,2489971703,2489972919,1216
1362068669,2490047180,4,629,157.25,1362068667956,1362068668020,2490046136,2490046200,64
1362068670,2490047644,1,52,52,1362068642954,1362068642954,2490020598,2490020598,0
1362068677,2490055124,6,786,131,1362068668012,1362068671596,2490046136,2490049720,3584
1362068690,2490067760,1,52,52,1362068664853,1362068664853,2490042613,2490042613,0
1362068709,2490087220,7,1033,147.5714286,1362068692300,1362068708492,2490070520,2490086712,16192
1362068733,2490111208,4,629,157.25,1362068727959,1362068728023,2490106167,2490106231,64
1362068733,2490111292,1527,2283886,1495.668631,1362068727172,1362068729156,2490105464,2490107448,1984
1362068733,2490111296,6,786,131,1362068727744,1362068731072,2490106040,2490109368,3328
1362068738,2490115868,1,52,52,1362068710763,1362068710763,2490088631,2490088631,0
1362068754,2490132012,4,2845,711.25,1362068728731,1362068728859,2490106743,2490106871,128
1362068783,1128476060,14,14171,1012.214286,1362068768959,1362068777087,1128462019,1128470147,8128
1362068789,2490167320,5,740,148,1362068787748,1362068788260,2490166068,2490166580,512
1362068789,2490167408,4,629,157.25,1362068787727,1362068787855,2490166135,2490166263,128
1362068813,2490191364,14,4119,294.2142857,1362068795064,1362068811768,2490173428,2490190132,16704
1362068821,2490199336,4,518,129.5,1362068795668,1362068816020,2490174004,2490194356,20352
1362068822,2490200044,3,1246,415.3333333,1362068797624,1362068797944,2490175668,2490175988,320
1362068822,2490200112,16,10415,650.9375,1362068796853,1362068817845,2490174965,2490195957,20992
1362068845,2490223480,8,1085,135.625,1362068827076,1362068843204,2490205556,2490221684,16128
1362068874,2490252236,1,540,540,1362068847737,1362068847737,2490225973,2490225973,0
1362068925,2490303572,5,618,123.6,1362068901927,1362068917159,2490280499,2490295731,15232
1362068942,2490320372,1,540,540,1362068917553,1362068917553,2490295925,2490295925,0
1362068982,2490359668,7,989,141.2857143,1362068962862,1362068979054,2490340530,2490356722,16192
1362069059,2490436816,1,52,52,1362069033819,1362069033819,2490411635,2490411635,0
1362069063,2490440772,3,652,217.3333333,1362069038150,1362069038214,2490415922,2490415986,64
1362069067,2490444936,2,92,46,1362069042339,1362069042403,2490420275,2490420339,64
1362069118,2490495872,7,1013,144.7142857,1362069097695,1362069113823,2490475567,2490491695,16128
1362069150,2490527772,9,2924,324.8888889,1362069144454,1362069144902,2490522226,2490522674,448
1362069179,2490557052,1,52,52,1362069153578,1362069153578,2490531630,2490531630,0
1362069222,2490599936,8,2793,349.125,1362069202525,1362069218205,2490580461,2490596141,15680
1362069254,2490631988,7,969,138.4285714,1362069232555,1362069248043,2490610543,2490626031,15488
1362069327,2490705432,1,46,46,1362069302764,1362069302764,2490681196,2490681196,0
1362069374,2490752152,6,1640,273.3333333,1362069361094,1362069366598,2490739246,2490744750,5504
1362069387,1129080064,9,9294,1032.666667,1362069360832,1362069360896,1129053896,1129053960,64
1362069387,1129080064,3,753,251,1362069360833,1362069360833,1129053897,1129053897,0
1362069390,2490768144,7,968,138.2857143,1362069367373,1362069383565,2490745517,2490761709,16192
1362069400,2490777784,1,89,89,1362069372405,1362069372405,2490750189,2490750189,0
1362069416,2490794404,1,48,48,1362069389386,1362069389386,2490767790,2490767790,0
1362069430,2490808180,3,1424,474.6666667,1362069429798,1362069429798,2490807978,2490807978,0
1362069430,2490808256,3,1220,406.6666667,1362069429724,1362069429724,2490807980,2490807980,0
1362069456,1129148232,4,712,178,1362069430656,1362069453568,1129122888,1129145800,22912
1362069456,2490833704,1,52,52,1362069430404,1362069430404,2490808108,2490808108,0
1362069456,2490833708,4,966,241.5,1362069430593,1362069453569,2490808301,2490831277,22976
1362069456,2490833784,5,3209,641.8,1362069430067,1362069430131,2490807851,2490807915,64
1362069456,2490833788,6,5060,843.3333333,1362069430129,1362069430257,2490807917,2490808045,128
1362069456,2490833788,1,52,52,1362069430319,1362069430319,2490808107,2490808107,0
1362069456,2490833792,7,2013,287.5714286,1362069430507,1362069430571,2490808299,2490808363,64
1362069456,2490833796,3,553,184.3333333,1362069430566,1362069430630,2490808362,2490808426,64
1362069456,2490833796,3,553,184.3333333,1362069430633,1362069430697,2490808429,2490808493,64
1362069456,2490833828,10,5398,539.8,1362069428809,1362069430281,2490806637,2490808109,1472
1362069456,2490833872,6,6097,1016.166667,1362069430045,1362069430173,2490807917,2490808045,128
1362069456,2490833872,8,7796,974.5,1362069430045,1362069430173,2490807917,2490808045,128
1362069462,2490840184,3,168,56,1362069453154,1362069458914,2490831338,2490837098,5760
1362069462,2490840268,1192,1781211,1494.30453,1362069453456,1362069455120,2490831724,2490833388,1664
1362069470,2490848224,4,628,157,1362069453050,1362069462778,2490831274,2490841002,9728
1362069476,2490853864,8,1632,204,1362069449956,1362069455204,2490827820,2490833068,5248
1362069476,2490853864,17,8962,527.1764706,1362069449956,1362069470820,2490827820,2490848684,20864
1362069476,2490853896,16,10410,650.625,1362069450821,1362069471813,2490828717,2490849709,20992
1362069480,2490857728,4,2166,541.5,1362069451883,1362069455339,2490829611,2490833067,3456
1362069480,2490857824,3,1246,415.3333333,1362069451980,1362069452108,2490829804,2490829932,128
1362069504,2490881744,2,104,52,1362069476124,1362069476188,2490853868,2490853932,64
1362069504,1129196464,1,52,52,1362069476696,1362069476696,1129169160,1129169160,0
1362069504,1129196464,1,52,52,1362069476696,1362069476696,1129169160,1129169160,0
1362069510,2490888164,4,894,223.5,1362069508023,1362069508087,2490886187,2490886251,64
1362069510,2490888236,5,740,148,1362069507886,1362069507950,2490886122,2490886186,64
1362069516,2490893896,2,104,52,1362069490050,1362069490242,2490867946,2490868138,192
1362069526,2490904196,4,553,138.25,1362069502295,1362069519063,2490880491,2490897259,16768
1362069528,2490905828,1,540,540,1362069501893,1362069501893,2490879721,2490879721,0
1362069532,2490909936,7,2483,354.7142857,1362069507164,1362069507484,2490885100,2490885420,320
1362069572,2490949848,1,46,46,1362069545650,1362069545650,2490923498,2490923498,0
1362069572,2490949848,1,46,46,1362069545650,1362069545650,2490923498,2490923498,0
1362069572,2490949848,1,46,46,1362069545650,1362069545650,2490923498,2490923498,0
1362069572,2490949848,1,46,46,1362069545650,1362069545650,2490923498,2490923498,0
1362069572,2490949932,1,52,52,1362069545568,1362069545568,2490923500,2490923500,0
1362069572,2490949932,1,46,46,1362069545568,1362069545568,2490923500,2490923500,0
1362069572,2490949932,1,52,52,1362069545567,1362069545567,2490923499,2490923499,0
1362069574,2490952408,5,740,148,1362069568384,1362069568448,2490946792,2490946856,64
1362069574,2490952408,4,629,157.25,1362069568323,1362069568451,2490946731,2490946859,128
1362069576,1129268440,15,14332,955.4666667,1362069569906,1362069571826,1129262346,1129264266,1920
1362069583,2490960660,9,5076,564,1362069571821,1362069576685,2490949481,2490954345,4864
1362069596,2490973896,1,52,52,1362069568644,1362069568644,2490946540,2490946540,0
1362069596,1129288460,1,52,52,1362069568861,1362069568861,1129261321,1129261321,0
1362069600,2490977924,1,540,540,1362069572647,1362069572647,2490950571,2490950571,0
1362069614,2490992400,33,44828,1358.424242,1362069610826,1362069610890,2490989226,2490989290,64
1362069614,2490992400,40,54755,1368.875,1362069610826,1362069611146,2490989226,2490989546,320
1362069614,2490992400,34,45689,1343.794118,1362069610890,1362069611274,2490989290,2490989674,384
1362069614,2490992476,38,51676,1359.894737,1362069610749,1362069611069,2490989225,2490989545,320
1362069630,2491008520,5,287,57.4,1362069621840,1362069621904,2491000360,2491000424,64
1362069630,2491008560,5,740,148,1362069628199,1362069628263,2491006759,2491006823,64
1362069630,2491008560,4,629,157.25,1362069628199,1362069628263,2491006759,2491006823,64
1362069636,2491013992,6,4594,765.6666667,1362069611040,1362069611168,2490989032,2490989160,128
1362069654,2491032496,4,444,111,1362069637096,1362069652136,2491015592,2491030632,15040
1362069670,2491048552,355,528124,1487.673239,1362069662640,1362069663664,2491041192,2491042216,1024
1362069680,2491058084,16,4768,298,1362069652101,1362069665029,2491030185,2491043113,12928
1362069686,2491064528,5,508,101.6,1362069663497,1362069678665,2491042025,2491057193,15168
1362069686,2491064528,5,507,101.4,1362069663497,1362069678665,2491042025,2491057193,15168
1362069686,2491064608,2,104,52,1362069679608,1362069679608,2491058216,2491058216,0
1362069692,2491069988,1,46,46,1362069664293,1362069664293,2491042281,2491042281,0
1362069692,2491070000,5,4087,817.4,1362069665241,1362069665369,2491043241,2491043369,128
1362069692,2491070060,1,46,46,1362069667292,1362069667292,2491045352,2491045352,0
1362069692,2491070100,26,11067,425.6538462,1362069665332,1362069665460,2491043432,2491043560,128
1362069692,2491070116,1,46,46,1362069666342,1362069666342,2491044458,2491044458,0
1362069694,2491072556,4,629,157.25,1362069688172,1362069688300,2491066728,2491066856,128
1362069694,2491072636,5,740,148,1362069688157,1362069688221,2491066793,2491066857,64
1362069702,2491080580,1078,1610381,1493.859926,1362069693202,1362069694994,2491071782,2491073574,1792
1362069720,2491098104,5,1826,365.2,1362069694514,1362069694578,2491072618,2491072682,64
1362069736,2491114128,3,298,99.33333333,1362069709913,1362069709913,2491088041,2491088041,0
1362069744,2491122088,1,46,46,1362069719233,1362069719233,2491097321,2491097321,0
1362069750,2491128600,5,740,148,1362069748159,1362069748223,2491126759,2491126823,64
1362069751,2491128676,4,629,157.25,1362069749084,1362069749148,2491126760,2491126824,64
1362069752,2491130120,2,104,52,1362069725088,1362069725152,2491103208,2491103272,64
1362069768,2491146244,2,92,46,1362069741541,1362069741669,2491119785,2491119913,128
1362069776,2491154172,1,46,46,1362069748267,1362069748267,2491126439,2491126439,0
1362069791,2491168688,5,508,101.6,1362069772878,1362069788494,2491150566,2491166182,15616
1362069808,2491186204,1,52,52,1362069779915,1362069779915,2491158119,2491158119,0
1362069815,2491192704,5,740,148,1362069809087,1362069809151,2491186791,2491186855,64
1362069815,2491192772,4,629,157.25,1362069809019,1362069809083,2491186791,2491186855,64
1362069823,2491200768,5,617,123.4,1362069802749,1362069817853,2491180517,2491195621,15104
1362069852,2491230260,1,52,52,1362069825298,1362069825298,2491203558,2491203558,0
1362069871,2491248708,4,629,157.25,1362069869050,1362069869114,2491246758,2491246822,64
1362069871,2491248780,5,740,148,1362069868976,1362069869040,2491246756,2491246820,64
1362069887,2491264812,1850,2770471,1497.551892,1362069883665,1362069886865,2491261477,2491264677,3200
1362069912,2491290620,1,52,52,1362069886121,1362069886121,2491264741,2491264741,0
1362069912,2491290628,9,4721,524.5555556,1362069884258,1362069907362,2491262886,2491285990,23104
1362069927,2491305116,2,104,52,1362069922911,1362069922911,2491301027,2491301027,0
1362069935,2491312996,5,740,148,1362069928793,1362069928857,2491306789,2491306853,64
1362069935,2491312996,4,629,157.25,1362069928792,1362069928856,2491306788,2491306852,64
1362069991,2491369108,4,629,157.25,1362069988650,1362069988714,2491366758,2491366822,64
1362069991,2491369180,5,740,148,1362069988576,1362069988704,2491366756,2491366884,128
1362070651,2492029304,1,46,46,1362070626456,1362070626456,2492004760,2492004760,0
1362070663,2492041412,1,46,46,1362070636781,1362070636781,2492015193,2492015193,0
1362071497,2492875532,1,52,52,1362071469800,1362071469800,2492848332,2492848332,0
1362071501,2492878744,1,52,52,1362071474430,1362071474430,2492852174,2492852174,0
1362071545,2492923240,1,52,52,1362071517132,1362071517132,2492895372,2492895372,0
1362071549,2492926740,1,52,52,1362071521538,1362071521538,2492899278,2492899278,0
1362072242,2493620324,1,46,46,1362072215983,1362072215983,2493594307,2493594307,0
1362072443,2493820876,11,3246,295.0909091,1362072417260,1362072418604,2493795136,2493796480,1344
1362072738,2494116068,2,141,70.5,1362072731430,1362072731430,2494109498,2494109498,0
1362072755,2494133320,11,3246,295.0909091,1362072729899,1362072731307,2494108219,2494109627,1408
1362072978,2494356240,4,319,79.75,1362072971958,1362072972726,2494350198,2494350966,768
1362073050,2494428232,2,141,70.5,1362073044925,1362073044925,2494423157,2494423157,0
1362073072,2494449708,11,3246,295.0909091,1362073044104,1362073045576,2494421812,2494423284,1472
1362073362,2494740548,2,141,70.5,1362073358203,1362073358203,2494736751,2494736751,0
1362073384,2494762496,11,3246,295.0909091,1362073356847,1362073358383,2494735343,2494736879,1536
1362073429,2494806908,1,48,48,1362073403388,1362073403388,2494781296,2494781296,0
1362073675,2495052776,2,141,70.5,1362073671869,1362073671869,2495049645,2495049645,0
1362073697,2495075468,11,3246,295.0909091,1362073670024,1362073671240,2495048492,2495049708,1216
1362073899,2495277052,2,141,70.5,1362073894307,1362073894307,2495272359,2495272359,0
1362073918,2495296244,11,3246,295.0909091,1362073892710,1362073894246,2495270954,2495272490,1536
1362074003,2495381336,2,141,70.5,1362073997637,1362073997637,2495375973,2495375973,0
1362074006,2495384452,11,6142,558.3636364,1362073980628,1362073997652,2495359080,2495376104,17024
1362074388,2495765648,2,141,70.5,1362074381104,1362074381104,2495758752,2495758752,0
1362074399,2495777140,11,3246,295.0909091,1362074371525,1362074383749,2495749665,2495761889,12224
1362074451,2495829348,1,46,46,1362074425652,1362074425652,2495804000,2495804000,0
1362074844,2496222044,2,141,70.5,1362074843676,1362074843676,2496221720,2496221720,0
1362074868,2496246560,11,3246,295.0909091,1362074841946,1362074843290,2496220506,2496221850,1344
1362075436,2496814480,2,141,70.5,1362075431457,1362075431457,2496809937,2496809937,0
1362075458,2496835972,11,3246,295.0909091,1362075430747,1362075432091,2496808719,2496810063,1344
1362075482,2496860260,1,60,60,1362075454845,1362075454845,2496833105,2496833105,0
1362075620,2496998508,2,141,70.5,1362075612033,1362075612033,2496990541,2496990541,0
1362075635,2497012720,11,3246,295.0909091,1362075610773,1362075612885,2496988493,2496990605,2112
1362075651,2497028724,1,60,60,1362075623506,1362075623506,2497001230,2497001230,0
1362076104,2497482024,1,48,48,1362076076512,1362076076512,2497454536,2497454536,0
1362076581,2497958832,1,436,436,1362076556310,1362076556310,2497934142,2497934142,0
1362076689,2498067172,1,437,437,1362076663233,1362076663233,2498041405,2498041405,0
1362076741,2498119136,1,52,52,1362076713316,1362076713316,2498091452,2498091452,0
1362076998,2498376428,1,46,46,1362076971004,1362076971004,2498349432,2498349432,0
1362077379,2498756884,1,46,46,1362077351703,1362077351703,2498729587,2498729587,0
1362079733,2501111524,1,46,46,1362079705971,1362079705971,2501084495,2501084495,0
1362082192,2503570500,1,46,46,1362082165287,1362082165287,2503543787,2503543787,0
1362082432,2503810588,1,78,78,1362082403850,1362082403850,2503782438,2503782438,0
1362083914,2505291684,1,46,46,1362083888125,1362083888125,2505265809,2505265809,0
1362084719,2506097500,1,46,46,1362084693698,1362084693698,2506072198,2506072198,0
1362085794,2507172308,1,48,48,1362085768368,1362085768368,2507146676,2507146676,0
1362086458,2507836236,1,46,46,1362086428527,1362086428527,2507806763,2507806763,0
1362088178,2509555836,1,46,46,1362088148579,1362088148579,2509526415,2509526415,0
1362088516,2509894096,1,52,52,1362088490267,1362088490267,2509868363,2509868363,0
1362088955,2510332656,1,46,46,1362088925517,1362088925517,2510303173,2510303173,0
1362093141,2514518608,1,46,46,1362093111933,1362093111933,2514489541,2514489541,0
1362093526,2514904028,2,106,53,1362093512340,1362093518164,2514890368,2514896192,5824
1362093526,2514904040,2,106,53,1362093514374,1362093520262,2514892414,2514898302,5888
1362093924,2515302148,1,46,46,1362093897301,1362093897301,2515275449,2515275449,0
1362095805,2517183048,1,61,61,1362095778204,1362095778204,2517156252,2517156252,0
1362096667,2518045504,1,404,404,1362096639625,1362096639625,2518018129,2518018129,0
1362097220,2518597808,1,46,46,1362097191608,1362097191608,2518569416,2518569416,0
1362097961,2519339076,1,46,46,1362097932383,1362097932383,2519310459,2519310459,0
1362100423,2521800680,3,138,46,1362100394953,1362100403977,2521772633,2521781657,9024
1362103869,2525247304,1,46,46,1362103841314,1362103841314,2525219618,2525219618,0
1362106217,2527595132,1,48,48,1362106189356,1362106189356,2527567488,2527567488,0
1362106532,2527909748,1,46,46,1362106504873,1362106504873,2527882621,2527882621,0
1362106960,2528338192,1,46,46,1362106935078,1362106935078,2528313270,2528313270,0
1362108208,2529585776,1,60,60,1362108180913,1362108180913,2529558689,2529558689,0
1362113179,2534557232,1,48,48,1362113154209,1362113154209,2534532441,2534532441,0
1362114001,2535378852,1,46,46,1362113973903,1362113973903,2535351755,2535351755,0
1362114370,2535748112,1,436,436,1362114345735,1362114345735,2535723847,2535723847,0
1362115232,2536609840,1,46,46,1362115205190,1362115205190,2536583030,2536583030,0
1362115317,2536694800,1,46,46,1362115291567,1362115291567,2536669367,2536669367,0
1362116741,2538119016,1,46,46,1362116714113,1362116714113,2538092129,2538092129,0
1362117028,2538405796,1,46,46,1362117002713,1362117002713,2538380509,2538380509,0
