unix_secs,sysuptime,dpkts,doctets,doctets/dpkts,Real First Packet,Real End Packet,first,last,Duration
1359700793,122178696,5,230,46,1359700766857,1359700781897,122152553,122167593,15040
1359702872,124257640,2,120,60,1359702845471,1359702848479,124231111,124234119,3008
1359703477,124862624,1,46,46,1359703450280,1359703450280,124835904,124835904,0
1359703585,124970896,5,250,50,1359703557141,1359703579349,124943037,124965245,22208
1359703629,125015020,2,96,48,1359703603290,1359703603290,124989310,124989310,0
1359703687,125072872,1,48,48,1359703658349,1359703658349,125044221,125044221,0
1359703890,125275788,1,46,46,1359703864383,1359703864383,125250171,125250171,0
1359704260,125645752,1,48,48,1359704233372,1359704233372,125619124,125619124,0
1359704844,126230136,2,116,58,1359704819796,1359704822868,126205932,126209004,3072
1359704856,126242196,1,46,46,1359704828823,1359704828823,126215019,126215019,0
1359704920,126306112,3,180,60,1359704892841,1359704901801,126278953,126287913,8960
1359705093,126478412,1,46,46,1359705065378,1359705065378,126450790,126450790,0
1359705197,126582708,5,230,46,1359705172024,1359705187064,126557732,126572772,15040
1359705241,126626776,3,180,60,1359705216883,1359705225843,126602659,126611619,8960
1359705534,126919400,5,230,46,1359705509224,1359705524136,126894624,126909536,14912
1359706372,127757332,1,46,46,1359706343904,1359706343904,127729236,127729236,0
1359706592,127978196,1,46,46,1359706565628,1359706565628,127951824,127951824,0
1359707334,128719660,5,230,46,1359707308810,1359707323786,128694470,128709446,14976
1359707567,128952440,1,46,46,1359707539234,1359707539234,128924674,128924674,0
1359709401,130786520,1,48,48,1359709373814,1359709373814,130759334,130759334,0
1359709973,131358240,1,48,48,1359709948038,1359709948038,131333278,131333278,0
1359710229,131614704,1,46,46,1359710201199,1359710201199,131586903,131586903,0
1359710229,131614708,1,46,46,1359710201516,1359710201516,131587224,131587224,0
1359710935,132320940,5,230,46,1359710909049,1359710924089,132294989,132310029,15040
1359711797,133182460,1,46,46,1359711772492,1359711772492,133157952,133157952,0
1359712597,133982956,1,48,48,1359712568337,1359712568337,133954293,133954293,0
1359714078,135463632,2,104,52,1359714051071,1359714054079,135436703,135439711,3008
1359714571,135956448,1,46,46,1359714545709,1359714545709,135931157,135931157,0
1359714787,136173084,1,46,46,1359714759983,1359714759983,136146067,136146067,0
1359715845,137230656,1,60,60,1359715819916,1359715819916,137205572,137205572,0
1359716430,137815772,1,46,46,1359716403660,1359716403660,137789432,137789432,0
1359717944,139330048,2,106,53,1359717916194,1359717916322,139302242,139302370,128
1359717972,139358064,4,1257,314.25,1359717944336,1359717964752,139330400,139350816,20416
1359718004,139390172,2,806,403,1359717976871,1359718001063,139363043,139387235,24192
1359718056,139442172,1,48,48,1359718028837,1359718028837,139415009,139415009,0
1359718101,139486524,1,46,46,1359718074092,1359718074092,139459616,139459616,0
1359718137,139522404,5,230,46,1359718109028,1359718123940,139494432,139509344,14912
1359718543,139928512,1,48,48,1359718517296,1359718517296,139902808,139902808,0
1359718573,139959092,1,46,46,1359718548267,1359718548267,139934359,139934359,0
1359719208,140593992,1,48,48,1359719179848,1359719179848,140565840,140565840,0
1359719319,140704760,3,180,60,1359719293166,1359719302126,140678926,140687886,8960
1359719644,141029304,3,180,60,1359719617586,1359719626546,141002890,141011850,8960
1359733800,155185824,1,46,46,1359733775890,1359733775890,155161714,155161714,0
1359733920,155305208,1,48,48,1359733891830,1359733891830,155277038,155277038,0
1359734055,155440852,3,168,56,1359734050291,1359734051315,155436143,155437167,1024
1359734055,155440880,4,220,55,1359734051734,1359734052374,155437614,155438254,640
1359734055,155440892,3,168,56,1359734049418,1359734049930,155435310,155435822,512
1359734055,155440928,3,168,56,1359734048550,1359734049126,155434478,155435054,576
1359734063,155448876,4,238,59.5,1359734052569,1359734061593,155438445,155447469,9024
1359734077,155462896,11,3833,348.4545455,1359734051332,1359734063108,155437228,155449004,11776
1359734077,155462896,21,4252,202.4761905,1359734051780,1359734058116,155437676,155444012,6336
1359734077,155462976,2,128,64,1359734051251,1359734054195,155437227,155440171,2944
1359734077,155462980,2,120,60,1359734051699,1359734073971,155437679,155459951,22272
1359734079,155464856,3,168,56,1359734074604,1359734076460,155460460,155462316,1856
1359734079,155464888,3,168,56,1359734076684,1359734077196,155462572,155463084,512
1359734081,155466892,10,3538,353.8,1359734056136,1359734060808,155442028,155446700,4672
1359734087,155472908,6,477,79.5,1359734080954,1359734085562,155466862,155471470,4608
1359734087,155472916,12,3360,280,1359734078000,1359734085488,155463916,155471404,7488
1359734101,155486876,1,64,64,1359734073560,1359734073560,155459436,155459436,0
1359734101,155486884,11,3553,323,1359734074767,1359734077135,155460651,155463019,2368
1359734105,155490880,1,64,64,1359734077267,1359734077267,155463147,155463147,0
1359734105,155490964,9,4569,507.6666667,1359734079745,1359734085441,155465709,155471405,5696
1359734151,155536976,2,104,52,1359734146420,1359734148084,155532396,155534060,1664
1359734159,155544988,2,104,52,1359734151401,1359734158057,155537389,155544045,6656
1359734183,155569004,2,131,65.5,1359734181529,1359734181529,155567533,155567533,0
1359734191,155576996,2,158,79,1359734182945,1359734185633,155568941,155571629,2688
1359734198,155583152,1,52,52,1359734172138,1359734172138,155557290,155557290,0
1359734199,155585036,2,131,65.5,1359734196789,1359734196789,155582825,155582825,0
1359734207,155593008,2,158,79,1359734191121,1359734202065,155577129,155588073,10944
1359734215,155601076,2,158,79,1359734200337,1359734207441,155586413,155593517,7104
1359734226,155611184,1,52,52,1359734198666,1359734198666,155583850,155583850,0
1359734247,155633056,3,168,56,1359734239522,1359734239586,155625578,155625642,64
1359734250,155635220,1,79,79,1359734224807,1359734224807,155610027,155610027,0
1359734250,155635296,1,79,79,1359734222363,1359734222363,155607659,155607659,0
1359734254,155639228,21,5851,278.6190476,1359734228574,1359734230110,155613802,155615338,1536
1359734254,155639232,12,6074,506.1666667,1359734228827,1359734229531,155614059,155614763,704
1359734254,155639236,1,52,52,1359734229272,1359734229272,155614508,155614508,0
1359734258,155643348,1,46,46,1359734230120,1359734230120,155615468,155615468,0
1359734258,155643348,1,64,64,1359734230181,1359734230181,155615529,155615529,0
1359734263,155649032,2,110,55,1359734249721,1359734262329,155635753,155648361,12608
1359734266,155651320,1,64,64,1359734240385,1359734240385,155625705,155625705,0
1359734278,155663256,1,79,79,1359734250818,1359734250818,155636074,155636074,0
1359734296,155681168,3,168,56,1359734292055,1359734292183,155677223,155677351,128
1359734304,155689156,2,110,55,1359734292262,1359734302374,155677418,155687530,10112
1359734312,155697172,25,10201,408.04,1359734302229,1359734304597,155687401,155689769,2368
1359734312,155697172,19,3473,182.7894737,1359734302483,1359734304467,155687655,155689639,1984
1359734318,155703628,1,198,198,1359734292811,1359734292811,155678439,155678439,0
1359734322,155707504,21,4537,216.047619,1359734295751,1359734300487,155681255,155685991,4736
1359734326,155711624,10,5239,523.9,1359734299600,1359734301648,155685224,155687272,2048
1359734326,155711640,1,52,52,1359734301057,1359734301057,155686697,155686697,0
1359734366,155751712,4,1241,310.25,1359734338682,1359734340282,155724394,155725994,1600
1359734370,155755620,1,46,46,1359734341971,1359734341971,155727591,155727591,0
1359734378,155763632,1,46,46,1359734353800,1359734353800,155739432,155739432,0
1359734432,155817196,32,10570,330.3125,1359734429945,1359734431417,155815141,155816613,1472
1359734432,155817244,15,3376,225.0666667,1359734429324,1359734429836,155814568,155815080,512
1359734440,155825156,18,6111,339.5,1359734432098,1359734432738,155817254,155817894,640
1359734440,155825172,17,10261,603.5882353,1359734432915,1359734434643,155818087,155819815,1728
1359734440,155825200,16,3436,214.75,1359734434039,1359734438135,155819239,155823335,4096
1359734440,155825200,23,4040,175.6521739,1359734434359,1359734437879,155819559,155823079,3520
1359734440,155825208,18,3588,199.3333333,1359734434607,1359734437743,155819815,155822951,3136
1359734440,155825240,13,4063,312.5384615,1359734431439,1359734432015,155816679,155817255,576
1359734442,155827784,9,3433,381.4444444,1359734415854,1359734416494,155801638,155802278,640
1359734448,155833148,18,4856,269.7777778,1359734438505,1359734441001,155823653,155826149,2496
1359734448,155833160,14,3965,283.2142857,1359734440926,1359734442718,155826086,155827878,1792
1359734456,155841156,63,64033,1016.396825,1359734442786,1359734448674,155827942,155833830,5888
1359734456,155841228,20,3727,186.35,1359734448602,1359734450266,155833830,155835494,1664
1359734456,155841244,23,3829,166.4782609,1359734450379,1359734452619,155835623,155837863,2240
1359734494,155880104,1,52,52,1359734468655,1359734468655,155854759,155854759,0
1359734494,155880104,1,52,52,1359734468781,1359734468781,155854885,155854885,0
1359734544,155929220,2,131,65.5,1359734536802,1359734536802,155922022,155922022,0
1359734567,155952176,1,52,52,1359734542094,1359734542094,155927270,155927270,0
1359734578,155964084,1,52,52,1359734550658,1359734550658,155936742,155936742,0
1359734640,156025276,255,31937,125.2431373,1359734363494,1359734638758,155748770,156024034,275264
1359734640,156025280,290,128395,442.7413793,1359734361443,1359734636835,155746723,156022115,275392
1359734704,156089428,24,18920,788.3333333,1359734694606,1359734698126,156080034,156083554,3520
1359734715,156100260,10,5157,515.7,1359734690169,1359734692729,156075429,156077989,2560
1359734715,156100300,1,188,188,1359734687505,1359734687505,156072805,156072805,0
1359734747,156132420,2,339,169.5,1359734722263,1359734722263,156107683,156107683,0
1359734783,156168440,1,52,52,1359734757440,1359734757440,156142880,156142880,0
1359734783,156168520,2,110,55,1359734757811,1359734782451,156143331,156167971,24640
1359734784,156169348,3,168,56,1359734783007,1359734783775,156168355,156169123,768
1359734811,156196516,7,2757,393.8571429,1359734783286,1359734785590,156168802,156171106,2304
1359734859,156244532,1,64,64,1359734834083,1359734834083,156219615,156219615,0
1359734859,156244608,1,64,64,1359734834522,1359734834522,156220130,156220130,0
1359734879,156264468,3,374,124.6666667,1359734852643,1359734867363,156238111,156252831,14720
1359734895,156280584,3,732,244,1359734868080,1359734868464,156253664,156254048,384
1359734923,156308564,1,46,46,1359734897348,1359734897348,156282912,156282912,0
1359734923,156308564,1,46,46,1359734897347,1359734897347,156282911,156282911,0
1359734931,156316576,3,455,151.6666667,1359734906297,1359734906745,156291873,156292321,448
1359735011,156396904,1,52,52,1359734983280,1359734983280,156369184,156369184,0
1359735048,156433592,4,184,46,1359735047717,1359735047717,156433309,156433309,0
1359735051,156436960,1,52,52,1359735025144,1359735025144,156411104,156411104,0
1359735056,156441524,3,168,56,1359735048426,1359735049258,156433950,156434782,832
1359735056,156441528,3,168,56,1359735049573,1359735050469,156435101,156435997,896
1359735056,156441532,3,168,56,1359735050720,1359735051296,156436252,156436828,576
1359735056,156441568,3,168,56,1359735051581,1359735052221,156437149,156437789,640
1359735071,156456992,1,188,188,1359735046805,1359735046805,156432797,156432797,0
1359735075,156460944,1,46,46,1359735047748,1359735047748,156433692,156433692,0
1359735075,156460952,10,4099,409.9,1359735047999,1359735050751,156433951,156436703,2752
1359735075,156461032,5,713,142.6,1359735047214,1359735047854,156433246,156433886,640
1359735086,3089750104,1,46,46,1359735060136,1359735060136,3089724240,3089724240,0
1359735176,156561664,2,131,65.5,1359735170907,1359735170907,156556571,156556571,0
1359735304,156689940,2,92,46,1359735301768,1359735301768,156687708,156687708,0
1359735304,156689944,14,3623,258.7857143,1359735299716,1359735301828,156685660,156687772,2112
1359735312,156697892,15,6879,458.6,1359735302068,1359735303924,156687960,156689816,1856
1359735312,156697892,6,276,46,1359735307316,1359735309620,156693208,156695512,2304
1359735312,156698052,1,52,52,1359735287380,1359735287380,156673432,156673432,0
1359735320,156705776,2,92,46,1359735312937,1359735319273,156698713,156705049,6336
1359735324,156709976,12,2775,231.25,1359735298786,1359735321314,156684762,156707290,22528
1359735324,156710080,9,3167,351.8888889,1359735299578,1359735301498,156685658,156687578,1920
1359735332,156717956,19,7586,399.2631579,1359735304311,1359735319543,156690267,156705499,15232
1359735344,156729796,3,138,46,1359735338324,1359735341204,156724120,156727000,2880
1359735353,156738188,5,983,196.6,1359735326647,1359735352119,156711835,156737307,25472
1359735357,156742168,1,46,46,1359735332555,1359735332555,156717723,156717723,0
1359735360,156745832,2,92,46,1359735345010,1359735352690,156730842,156738522,7680
1359735361,156746200,2,1015,507.5,1359735333608,1359735335144,156718808,156720344,1536
1359735368,156753788,16,3436,214.75,1359735364828,1359735367196,156750616,156752984,2368
1359735368,156753792,6,1250,208.3333333,1359735361241,1359735364761,156747033,156750553,3520
1359735368,156753796,19,4532,238.5263158,1359735365589,1359735367189,156751385,156752985,1600
1359735376,156761856,21,10540,501.9047619,1359735364698,1359735367962,156750554,156753818,3264
1359735385,156770172,1,46,46,1359735357957,1359735357957,156743129,156743129,0
1359735388,156774092,2,337,168.5,1359735361195,1359735379563,156747287,156765655,18368
1359735389,156774124,9,4004,444.8888889,1359735363444,1359735365108,156748568,156750232,1664
1359735393,156778216,10,3532,353.2,1359735368090,1359735370650,156753306,156755866,2560
1359735424,156809836,2,131,65.5,1359735420906,1359735420906,156806742,156806742,0
1359735496,156881956,3,183,61,1359735489076,1359735489972,156875032,156875928,896
1359735504,156889948,3,138,46,1359735500410,1359735500410,156886358,156886358,0
1359735504,156889952,16,6981,436.3125,1359735500727,1359735501815,156886679,156887767,1088
1359735504,156889956,3,138,46,1359735498355,1359735498355,156884311,156884311,0
1359735525,156910328,1,619,619,1359735498086,1359735498086,156883414,156883414,0
1359735525,156910440,8,3115,389.375,1359735499189,1359735500661,156884629,156886101,1472
1359735624,157010036,2,131,65.5,1359735619938,1359735619938,157005974,157005974,0
1359735629,157014776,1,52,52,1359735604516,1359735604516,156990292,156990292,0
1359735683,157068376,1,46,46,1359735656307,1359735656307,157041683,157041683,0
1359735715,157100152,1,48,48,1359735687061,1359735687061,157072213,157072213,0
1359735809,157195004,1,46,46,1359735780862,1359735780862,157166866,157166866,0
1359736198,157583704,9,3433,381.4444444,1359736171427,1359736172579,157557131,157558283,1152
1359736297,157682544,2,131,65.5,1359736292676,1359736292676,157678220,157678220,0
1359736305,157690560,13,8732,671.6923077,1359736293618,1359736300850,157679178,157686410,7232
1359736431,157816404,2,129,64.5,1359736404366,1359736404366,157789770,157789770,0
1359736828,158213576,2,574,287,1359736803420,1359736806172,158188996,158191748,2752
1359736868,158253612,1,52,52,1359736841142,1359736841142,158226754,158226754,0
1359736896,158281808,7,1040,148.5714286,1359736871283,1359736874355,158257091,158260163,3072
1359736900,158285828,21,7248,345.1428571,1359736874974,1359736878494,158260802,158264322,3520
1359736945,158330972,3,168,56,1359736942476,1359736943116,158328448,158329088,640
1359736968,158354060,1,64,64,1359736943349,1359736943349,158329409,158329409,0
1359736972,158357936,16,5411,338.1875,1359736944881,1359736950257,158330817,158336193,5376
1359736972,158357940,22,5050,229.5454545,1359736944046,1359736953582,158329986,158339522,9536
1359736972,158357972,1,52,52,1359736945869,1359736945869,158331841,158331841,0
1359736993,158378960,4,271,67.75,1359736989847,1359736990487,158375807,158376447,640
1359736993,158378968,3,168,56,1359736990801,1359736991633,158376769,158377601,832
1359737001,158386884,4,271,67.75,1359736996004,1359736996580,158381888,158382464,576
1359737001,158386944,4,271,67.75,1359736996903,1359736997479,158382847,158383423,576
1359737001,158386976,4,271,67.75,1359736995016,1359736995592,158380992,158381568,576
1359737016,158402020,15,9717,647.8,1359736991259,1359736994139,158377279,158380159,2880
1359737016,158402096,1,193,193,1359736990225,1359736990225,158376321,158376321,0
1359737061,158446320,2,339,169.5,1359737033814,1359737033814,158419134,158419134,0
1359737097,158482336,3,738,246,1359737070600,1359737070984,158455936,158456320,384
1359737097,158482444,1,52,52,1359737071194,1359737071194,158456638,158456638,0
1359737121,158507036,2,104,52,1359737118091,1359737118347,158504127,158504383,256
1359737137,158523040,16,3428,214.25,1359737131077,1359737132549,158517117,158518589,1472
1359737157,158542388,7,3438,491.1428571,1359737130003,1359737131219,158515391,158516607,1216
1359737157,158542424,6,2104,350.6666667,1359737131439,1359737132399,158516863,158517823,960
1359737157,158542464,1,188,188,1359737129288,1359737129288,158514752,158514752,0
1359737161,158546460,1,46,46,1359737134216,1359737134216,158519676,158519676,0
1359737197,158582756,4,644,161,1359737171234,1359737171426,158556990,158557182,192
1359737197,158582832,1,191,191,1359737170453,1359737170453,158556285,158556285,0
1359737241,158627036,3,168,56,1359737236169,1359737236297,158622205,158622333,128
1359737241,158627080,3,168,56,1359737235996,1359737236060,158622076,158622140,64
1359737241,158627080,3,168,56,1359737236315,1359737236507,158622395,158622587,192
1359737265,158650856,2,339,169.5,1359737240443,1359737240443,158626299,158626299,0
1359737281,158666952,9,3433,381.4444444,1359737255835,1359737256219,158641787,158642171,384
1359737321,158706936,3,428,142.6666667,1359737293036,1359737309292,158678972,158695228,16256
1359737321,158706984,6,1299,216.5,1359737295739,1359737310075,158681723,158696059,14336
1359737346,158731420,5,296,59.2,1359737333423,1359737344687,158718843,158730107,11264
1359737362,158747332,4,232,58,1359737346759,1359737360903,158732091,158746235,14144
1359737370,158755332,2,104,52,1359737362503,1359737365639,158747835,158750971,3136
1359737374,158759156,1,46,46,1359737346487,1359737346487,158731643,158731643,0
1359737378,158763404,4,208,52,1359737371197,1359737376701,158756601,158762105,5504
1359737378,158763412,4,289,72.25,1359737376567,1359737377399,158761979,158762811,832
1359737386,158771416,3,168,56,1359737381169,1359737382001,158766585,158767417,832
1359737386,158771424,2,158,79,1359737378410,1359737380586,158763834,158766010,2176
1359737398,158783236,1,52,52,1359737372007,1359737372007,158757243,158757243,0
1359737410,158795420,1,64,64,1359737382252,1359737382252,158767672,158767672,0
1359737410,158795452,21,5592,266.2857143,1359737384207,1359737387983,158769659,158773435,3776
1359737414,158799300,1,52,52,1359737386404,1359737386404,158771704,158771704,0
1359737418,158803496,4,208,52,1359737411680,1359737417056,158797176,158802552,5376
1359737554,158939832,3,156,52,1359737550225,1359737553809,158936057,158939641,3584
1359737570,158955876,3,168,56,1359737562213,1359737563045,158948089,158948921,832
1359737570,158955884,5,272,54.4,1359737563421,1359737569181,158949305,158955065,5760
1359737586,158971692,1,46,46,1359737558620,1359737558620,158944312,158944312,0
1359737683,159068196,4,208,52,1359737674826,1359737682442,159060022,159067638,7616
1359737707,159092244,2,104,52,1359737691035,1359737701083,159076279,159086327,10048
1359737722,159107152,1,52,52,1359737711157,1359737711157,159096309,159096309,0
1359737739,159124264,2,104,52,1359737721027,1359737731011,159106291,159116275,9984
1359737995,159380528,1,46,46,1359737966648,1359737966648,159352176,159352176,0
1359738548,159933784,1,60,60,1359738522863,1359738522863,159908647,159908647,0
1359738572,159957932,1,60,60,1359738547486,1359738547486,159933418,159933418,0
1359738994,160379852,1,46,46,1359738966567,1359738966567,160352419,160352419,0
1359739094,160479216,1,56,56,1359739066911,1359739066911,160452127,160452127,0
1359739905,161290156,1,46,46,1359739877457,1359739877457,161262613,161262613,0
1359740882,162267336,6,384,64,1359740856333,1359740861837,162241669,162247173,5504
1359740882,162267460,1,64,64,1359740857362,1359740857362,162242822,162242822,0
1359740882,162267460,6,384,64,1359740855121,1359740860625,162240581,162246085,5504
1359740882,162267460,5,320,64,1359740857296,1359740861712,162242756,162247172,4416
1359741243,162628396,1,48,48,1359741217099,1359741217099,162602495,162602495,0
1359741408,162793596,5,456,91.2,1359741407234,1359741407362,162792830,162792958,128
1359741641,163026976,2,122,61,1359741624643,1359741626947,163010619,163012923,2304
1359741968,163353592,1,56,56,1359741941501,1359741941501,163327093,163327093,0
1359742049,163434756,5,456,91.2,1359742047769,1359742047897,163433525,163433653,128
1359742321,3096985644,1,46,46,1359742293693,1359742293693,3096958337,3096958337,0
1359742574,163959492,1,48,48,1359742548505,1359742548505,163933997,163933997,0
1360004799,426184232,1,95,95,1360004771813,1360004771813,426157045,426157045,0
1360005120,426505096,4,244,61,1360005092010,1360005102506,426477106,426487602,10496
1360005120,426505096,3,152,50.66666667,1360005091945,1360005100969,426477041,426486065,9024
1360005229,426613752,3,152,50.66666667,1360005201281,1360005210305,426586033,426595057,9024
1360005229,426613752,4,244,61,1360005201281,1360005211841,426586033,426596593,10560
1360005290,426675244,1,46,46,1360005261780,1360005261780,426647024,426647024,0
1360005313,426697600,5,456,91.2,1360005307668,1360005307732,426692268,426692332,64
1360005313,426697844,2,96,48,1360005286433,1360005288993,426671277,426673837,2560
1360005333,426717992,1,46,46,1360005307342,1360005307342,426692334,426692334,0
1360005333,426717992,3,138,46,1360005307342,1360005307342,426692334,426692334,0
1360005333,426718068,1,46,46,1360005307267,1360005307267,426692335,426692335,0
1360005333,426718068,2,92,46,1360005307266,1360005307330,426692334,426692398,64
1360005421,3360084560,1,46,46,1360005391930,1360005391930,3360055490,3360055490,0
1360005497,426882180,4,244,61,1360005471888,1360005482448,426857068,426867628,10560
1360005498,426882252,3,152,50.66666667,1360005472816,1360005474736,426857068,426858988,1920
1360006153,427537744,1,46,46,1360006125562,1360006125562,427510306,427510306,0
1360006251,427635520,1,148,148,1360006225303,1360006225303,427609823,427609823,0
1360007112,428497176,1,46,46,1360007087609,1360007087609,428472785,428472785,0
1360007859,429243616,3,168,56,1360007854816,1360007855648,429239432,429240264,832
1360007859,429243656,4,271,67.75,1360007857015,1360007857911,429241671,429242567,896
1360007867,429251660,3,168,56,1360007862003,1360007862643,429246663,429247303,640
1360007867,429251696,4,232,58,1360007855695,1360007859791,429240391,429244487,4096
1360007867,429251704,3,168,56,1360007860421,1360007861253,429245125,429245957,832
1360007875,429259628,3,168,56,1360007872403,1360007873107,429257031,429257735,704
1360007875,429259664,3,168,56,1360007873327,1360007873967,429257991,429258631,640
1360007883,429267368,22,4467,203.0454545,1360007857560,1360007864600,429241928,429248968,7040
1360007883,429267656,4,271,67.75,1360007876341,1360007877173,429260997,429261829,832
1360007883,429267684,3,168,56,1360007877401,1360007878361,429262085,429263045,960
1360007883,429267772,3,168,56,1360007874179,1360007875203,429258951,429259975,1024
1360007887,429271400,7,4247,606.7142857,1360007861430,1360007862774,429245830,429247174,1344
1360007903,429287356,1,46,46,1360007876002,1360007876002,429260358,429260358,0
1360007991,429375748,9,3451,383.4444444,1360007962906,1360007964314,429347654,429349062,1408
1360008051,429436184,17,3488,205.1764706,1360008039715,1360008042979,429424899,429428163,3264
1360008067,429451856,2,566,283,1360008039210,1360008039402,429424066,429424258,192
1360008091,429476084,2,131,65.5,1360008083911,1360008083911,429468995,429468995,0
1360008195,429580224,3,168,56,1360008191994,1360008192826,429577218,429578050,832
1360008196,429580264,3,168,56,1360008194041,1360008194681,429578305,429578945,640
1360008196,429580276,3,168,56,1360008194989,1360008195693,429579265,429579969,704
1360008203,429588192,3,168,56,1360008195290,1360008195994,429580482,429581186,704
1360008203,429588216,3,168,56,1360008196098,1360008196930,429581314,429582146,832
1360008224,429608504,19,4066,214,1360008195977,1360008198793,429580481,429583297,2816
1360008224,429608520,1,52,52,1360008197177,1360008197177,429581697,429581697,0
1360008304,429688740,1,52,52,1360008279516,1360008279516,429664256,429664256,0
1360008304,429688772,1,186,186,1360008276539,1360008276539,429661311,429661311,0
1360008304,429688812,11,5041,458.2727273,1360008278675,1360008281235,429663487,429666047,2560
1360008460,429845072,4,644,161,1360008432334,1360008456270,429817406,429841342,23936
1360008484,429868528,3,168,56,1360008480431,1360008480623,429864959,429865151,192
1360008484,429868588,3,168,56,1360008480243,1360008480307,429864831,429864895,64
1360008484,429868588,3,168,56,1360008480115,1360008480243,429864703,429864831,128
1360008484,429868612,3,168,56,1360008480474,1360008480602,429865086,429865214,128
1360008484,429869212,3,567,189,1360008456767,1360008456959,429841979,429842171,192
1360008504,429889144,4,812,203,1360008477319,1360008478343,429862463,429863487,1024
1360008532,429916584,3,168,56,1360008527858,1360008528498,429912442,429913082,640
1360008532,429916616,3,168,56,1360008528723,1360008530067,429913339,429914683,1344
1360008532,429916656,3,168,56,1360008530411,1360008530987,429915067,429915643,576
1360008557,429941316,19,4066,214,1360008531263,1360008534975,429915579,429919291,3712
1360008561,429945268,1,52,52,1360008533041,1360008533041,429917309,429917309,0
1360008565,429949260,1,46,46,1360008537592,1360008537592,429921852,429921852,0
1360008636,430020984,3,168,56,1360008634853,1360008635365,430019837,430020349,512
1360008644,430028912,3,168,56,1360008635755,1360008636395,430020667,430021307,640
1360008661,430045344,2,92,46,1360008634593,1360008656545,430018937,430040889,21952
1360008684,430068912,3,168,56,1360008678184,1360008678312,430063096,430063224,128
1360008684,430068916,4,271,67.75,1360008678311,1360008678439,430063227,430063355,128
1360008684,430068940,3,168,56,1360008678544,1360008678672,430063484,430063612,128
1360008684,430068988,3,168,56,1360008678368,1360008678432,430063356,430063420,64
1360008685,430069396,7,2757,393.8571429,1360008657070,1360008658030,430041466,430042426,960
1360008709,430093476,1,46,46,1360008682140,1360008682140,430066616,430066616,0
1360008709,430093572,1,462,462,1360008682494,1360008682494,430067066,430067066,0
1360008725,430109456,1,52,52,1360008697711,1360008697711,430082167,430082167,0
1360008745,430129620,11,4664,424,1360008720015,1360008723279,430104635,430107899,3264
1360008749,430133596,1,186,186,1360008721955,1360008721955,430106551,430106551,0
1360008777,430161472,1,52,52,1360008749345,1360008749345,430133817,430133817,0
1360008853,430237628,2,337,168.5,1360008828802,1360008828802,430213430,430213430,0
1360008868,430253032,3,168,56,1360008862064,1360008862256,430247096,430247288,192
1360008876,430261044,3,168,56,1360008872673,1360008872737,430257717,430257781,64
1360008876,430261088,3,168,56,1360008872374,1360008872502,430257462,430257590,128
1360008876,430261088,3,168,56,1360008872501,1360008872565,430257589,430257653,64
1360008876,430261092,3,168,56,1360008872755,1360008872883,430257847,430257975,128
1360008876,430261116,3,168,56,1360008872921,1360008873113,430258037,430258229,192
1360008876,430261120,4,271,67.75,1360008873048,1360008873176,430258168,430258296,128
1360008876,430261128,2,110,55,1360008862161,1360008872209,430247289,430257337,10048
1360008876,430261156,3,168,56,1360008872178,1360008872242,430257334,430257398,64
1360008893,430277808,1,52,52,1360008866064,1360008866064,430250872,430250872,0
1360008893,430277888,17,4393,258.4117647,1360008865405,1360008871613,430250293,430256501,6208
1360008897,430281824,9,3451,383.4444444,1360008871293,1360008871869,430256117,430256693,576
1360008901,430285900,1,46,46,1360008873073,1360008873073,430257973,430257973,0
1360008925,430309796,1,52,52,1360008897689,1360008897689,430282485,430282485,0
1360008948,430333088,14,3324,237.4285714,1360008940471,1360008940791,430325559,430325879,320
1360008965,430350024,7,3438,491.1428571,1360008939574,1360008940214,430324598,430325238,640
1360008989,430374064,1,52,52,1360008962831,1360008962831,430347895,430347895,0
1360008996,430381192,2,131,65.5,1360008991374,1360008991374,430376566,430376566,0
1360009062,430446324,1,285,285,1360009036913,1360009036913,430421237,430421237,0
1360009180,430565192,4,184,46,1360009172556,1360009172556,430557748,430557748,0
1360009188,430573240,5,260,52,1360009179994,1360009183514,430565234,430568754,3520
1360009198,430582820,9,3451,383.4444444,1360009172926,1360009173182,430557746,430558002,256
1360009301,430685400,6,447,74.5,1360009293538,1360009297378,430677938,430681778,3840
1360009317,430701404,2,158,79,1360009301405,1360009309597,430685809,430694001,8192
1360009318,430702868,8,2264,283,1360009292557,1360009317517,430677425,430702385,24960
1360009325,430709340,4,271,67.75,1360009322843,1360009323035,430707183,430707375,192
1360009325,430709348,3,168,56,1360009323411,1360009323475,430707759,430707823,64
1360009325,430709352,3,168,56,1360009323537,1360009323729,430707889,430708081,192
1360009325,430709420,3,168,56,1360009323020,1360009323212,430707440,430707632,192
1360009349,430733400,2,110,55,1360009332703,1360009342751,430717103,430727151,10048
1360009349,430733432,3,168,56,1360009342720,1360009342784,430727152,430727216,64
1360009350,430735044,1,46,46,1360009322331,1360009322331,430707375,430707375,0
1360009350,430735056,23,6689,290.826087,1360009325136,1360009337552,430710192,430722608,12416
1360009350,430735056,1,79,79,1360009325198,1360009325198,430710254,430710254,0
1360009355,430739260,1,52,52,1360009326507,1360009326507,430710767,430710767,0
1360009365,430749344,11,2458,223.4545455,1360009362903,1360009364439,430747247,430748783,1536
1360009365,430749396,2,110,55,1360009342949,1360009358565,430727345,430742961,15616
1360009389,430773396,10,1160,116,1360009362914,1360009383586,430747310,430767982,20672
1360009390,430774908,1,46,46,1360009362340,1360009362340,430747248,430747248,0
1360009390,430774984,7,3494,499.1428571,1360009361815,1360009362391,430746799,430747375,576
1360009390,430774988,1,116,116,1360009362003,1360009362003,430746991,430746991,0
1360009390,430774988,1,116,116,1360009362002,1360009362002,430746990,430746990,0
1360009605,430989696,2,104,52,1360009602676,1360009602868,430987372,430987564,192
1360009631,431015360,2,116,58,1360009603331,1360009603587,430987691,430987947,256
1360009685,431069912,4,220,55,1360009680410,1360009682586,431065322,431067498,2176
1360009693,431077800,2,104,52,1360009685515,1360009686219,431070315,431071019,704
1360009711,431095704,24,4660,194.1666667,1360009682859,1360009690539,431067563,431075243,7680
1360009711,431095712,1,64,64,1360009683108,1360009683108,431067820,431067820,0
1360009743,431127716,1,46,46,1360009717982,1360009717982,431102698,431102698,0
1360009981,431366072,3,168,56,1360009979063,1360009979639,431364135,431364711,576
1360009981,431366072,3,168,56,1360009975349,1360009975989,431360421,431361061,640
1360009981,431366112,3,168,56,1360009974415,1360009974991,431359527,431360103,576
1360009981,431366120,3,168,56,1360009978117,1360009978757,431363237,431363877,640
1360009981,431366156,3,168,56,1360009976227,1360009976867,431361383,431362023,640
1360009981,431366192,3,168,56,1360009977086,1360009977726,431362278,431362918,640
1360009999,431384196,7,2757,393.8571429,1360009971450,1360009971642,431356646,431356838,192
1360010007,431392176,1,64,64,1360009979917,1360009979917,431365093,431365093,0
1360010045,431430232,3,168,56,1360010040662,1360010041110,431425894,431426342,448
1360010045,431430236,3,168,56,1360010038546,1360010039826,431423782,431425062,1280
1360010054,431438256,4,220,55,1360010047076,1360010048996,431431332,431433252,1920
1360010061,431446120,3,168,56,1360010055814,1360010056390,431440934,431441510,576
1360010061,431446152,5,296,59.2,1360010048420,1360010053476,431433572,431438628,5056
1360010061,431446236,4,271,67.75,1360010053776,1360010054352,431439012,431439588,576
1360010062,431446240,3,168,56,1360010057587,1360010058227,431441827,431442467,640
1360010062,431446252,3,168,56,1360010055658,1360010056234,431439910,431440486,576
1360010068,431452308,1,46,46,1360010042930,1360010042930,431427238,431427238,0
1360010068,431452312,1,46,46,1360010043372,1360010043372,431427684,431427684,0
1360010068,431452360,34,7383,217.1470588,1360010041661,1360010059325,431426021,431443685,17664
1360010069,431454124,15,3760,250.6666667,1360010063681,1360010065217,431448805,431450341,1536
1360010069,431454168,13,3571,274.6923077,1360010065875,1360010067731,431451043,431452899,1856
1360010070,431454332,18,4470,248.3333333,1360010066456,1360010067800,431450788,431452132,1344
1360010070,431454332,13,3571,274.6923077,1360010066711,1360010068503,431451043,431452835,1792
1360010072,431456420,1,52,52,1360010047042,1360010047042,431431462,431431462,0
1360010077,431462192,13,3583,275.6153846,1360010067707,1360010069051,431452899,431454243,1344
1360010095,431480268,9,3463,384.7777778,1360010067183,1360010068463,431452451,431453731,1280
1360010189,431574180,2,131,65.5,1360010188424,1360010188424,431573604,431573604,0
1360010216,431600400,1,46,46,1360010191185,1360010191185,431575585,431575585,0
1360010229,431614160,3,168,56,1360010223195,1360010223771,431608355,431608931,576
1360010240,431624520,1,52,52,1360010212313,1360010212313,431596833,431596833,0
1360010336,431720720,1,46,46,1360010310545,1360010310545,431695265,431695265,0
1360010372,431756876,3,138,46,1360010345077,1360010346165,431729953,431731041,1088
1360010380,431764768,1,46,46,1360010351905,1360010351905,431736673,431736673,0
1360010406,431790268,2,104,52,1360010400340,1360010402964,431784608,431787232,2624
1360010422,431806252,2,104,52,1360010408100,1360010418084,431792352,431802336,9984
1360010446,431830280,2,104,52,1360010428102,1360010438086,431812382,431822366,9984
1360010462,431846272,2,104,52,1360010448080,1360010458064,431832352,431842336,9984
1360011025,432410108,1,46,46,1360010998596,1360010998596,432383704,432383704,0
1360011062,432446824,3,168,56,1360011058527,1360011059103,432443351,432443927,576
1360011070,432454732,3,168,56,1360011065271,1360011065911,432450003,432450643,640
1360011070,432454744,3,168,56,1360011066157,1360011066797,432450901,432451541,640
1360011070,432454748,3,168,56,1360011063401,1360011064041,432448149,432448789,640
1360011070,432454768,3,168,56,1360011067029,1360011067541,432451797,432452309,512
1360011070,432454776,3,168,56,1360011067917,1360011068493,432452693,432453269,576
1360011070,432454812,3,168,56,1360011062313,1360011063017,432447125,432447829,704
1360011070,432454824,3,168,56,1360011064221,1360011064861,432449045,432449685,640
1360011085,432470152,19,4066,214,1360011059094,1360011061910,432444246,432447062,2816
1360011174,432558272,3,458,152.6666667,1360011147717,1360011147973,432531989,432532245,256
1360011254,432638612,2,92,46,1360011228656,1360011228720,432613268,432613332,64
1360011274,432658456,1,46,46,1360011249608,1360011249608,432634064,432634064,0
1360011282,432666404,5,230,46,1360011254590,1360011275070,432638994,432659474,20480
1360011322,432706436,1,46,46,1360011295517,1360011295517,432679953,432679953,0
1360011334,432719172,3,168,56,1360011330683,1360011330747,432715855,432715919,64
1360011334,432719172,3,168,56,1360011330814,1360011330878,432715986,432716050,64
1360011354,432738616,6,1080,180,1360011328809,1360011329577,432713425,432714193,768
1360011422,432806596,1,46,46,1360011394749,1360011394749,432779345,432779345,0
1360011462,432846740,1,46,46,1360011437227,1360011437227,432821967,432821967,0
1360011506,432890804,1,46,46,1360011481323,1360011481323,432866127,432866127,0
1360011575,432959336,3,156,52,1360011570750,1360011572542,432955086,432956878,1792
1360011583,432967428,2,104,52,1360011574817,1360011579553,432959245,432963981,4736
1360011607,432991396,2,104,52,1360011589120,1360011599104,432973516,432983500,9984
1360011623,433007372,2,104,52,1360011609113,1360011619097,432993485,433003469,9984
1360011655,433039348,1,52,52,1360011629166,1360011629166,433013514,433013514,0
1360011883,433268040,1,46,46,1360011857847,1360011857847,433242887,433242887,0
1360011915,433300176,2,92,46,1360011888175,1360011902383,433273351,433287559,14208
1360011962,433347028,1,46,46,1360011933189,1360011933189,433318217,433318217,0
1360011985,3366648872,1,46,46,1360011958892,1360011958892,3366622764,3366622764,0
1360012104,433488604,1,46,46,1360012078955,1360012078955,433463559,433463559,0
1360012197,433581688,1,46,46,1360012168339,1360012168339,433553027,433553027,0
1360012485,433869768,1,46,46,1360012458174,1360012458174,433842942,433842942,0
1360012565,433949852,1,46,46,1360012537195,1360012537195,433922047,433922047,0
1360012858,434242812,1,48,48,1360012833100,1360012833100,434217912,434217912,0
1360013371,434755544,3,138,46,1360013344082,1360013360210,434728626,434744754,16128
1360013467,434852144,1,46,46,1360013442552,1360013442552,434827696,434827696,0
1360013796,435181144,2,122,61,1360013770226,1360013772594,435155370,435157738,2368
1360013816,435201044,3,138,46,1360013788630,1360013812630,435173674,435197674,24000
1360013964,435348808,3,168,56,1360013961409,1360013962049,435346217,435346857,640
1360013964,435348956,3,168,56,1360013960364,1360013961004,435345320,435345960,640
1360013964,435348996,3,168,56,1360013962117,1360013963013,435347113,435348009,896
1360013964,435349008,3,168,56,1360013959353,1360013959993,435344361,435345001,640
1360013972,435356852,3,168,56,1360013967315,1360013968083,435352167,435352935,768
1360013972,435356896,3,168,56,1360013965222,1360013966054,435350118,435350950,832
1360013972,435356924,3,168,56,1360013966285,1360013966925,435351209,435351849,640
1360013972,435356968,3,168,56,1360013963422,1360013964126,435348390,435349094,704
1360013989,435373316,19,4066,214,1360013963307,1360013966571,435347623,435350887,3264
1360013989,435373432,1,46,46,1360013963574,1360013963574,435348006,435348006,0
1360013993,435377276,1,46,46,1360013965142,1360013965142,435349418,435349418,0
1360014189,435574080,3,458,152.6666667,1360014163502,1360014163950,435548582,435549030,448
1360014300,435685048,3,168,56,1360014295500,1360014296140,435680548,435681188,640
1360014300,435685100,3,168,56,1360014294425,1360014295001,435679525,435680101,576
1360014308,435693036,3,168,56,1360014300245,1360014301077,435685281,435686113,832
1360014308,435693072,3,168,56,1360014302642,1360014303410,435687714,435688482,768
1360014308,435693112,3,168,56,1360014301449,1360014301961,435686561,435687073,512
1360014324,435709028,3,168,56,1360014321437,1360014321821,435706465,435706849,384
1360014324,435709072,3,168,56,1360014319539,1360014320115,435704611,435705187,576
1360014324,435709076,3,168,56,1360014320429,1360014321069,435705505,435706145,640
1360014325,435710224,17,3962,233.0588235,1360014297369,1360014300953,435682593,435686177,3584
1360014326,435710296,1,52,52,1360014299897,1360014299897,435684193,435684193,0
1360014326,435710416,1,46,46,1360014300035,1360014300035,435684451,435684451,0
1360014460,435845156,13,6650,511.5384615,1360014457243,1360014458267,435842399,435843423,1024
1360014460,435845188,13,6704,515.6923077,1360014458043,1360014459067,435843231,435844255,1024
1360014460,435845224,11,6391,581,1360014458710,1360014459542,435843934,435844766,832
1360014461,435845232,13,6663,512.5384615,1360014457271,1360014458423,435841503,435842655,1152
1360014468,435853144,13,6683,514.0769231,1360014459817,1360014460649,435844961,435845793,832
1360014468,435853184,16,3428,214.25,1360014458306,1360014460674,435843490,435845858,2368
1360014482,435866796,7,3438,491.1428571,1360014456706,1360014458050,435841502,435842846,1344
1360014486,435870872,1,46,46,1360014460343,1360014460343,435845215,435845215,0
1360014562,435947020,7,2757,393.8571429,1360014534114,1360014536674,435919134,435921694,2560
1360014661,436045252,3,168,56,1360014659873,1360014660513,436044125,436044765,640
1360014661,436045316,3,168,56,1360014658912,1360014659488,436043228,436043804,576
1360014661,436045364,3,168,56,1360014657968,1360014658544,436042332,436042908,576
1360014669,436053256,4,271,67.75,1360014663835,1360014664539,436048091,436048795,704
1360014669,436053284,3,168,56,1360014667906,1360014668546,436052190,436052830,640
1360014669,436053288,3,168,56,1360014664827,1360014665467,436049115,436049755,640
1360014669,436053320,3,168,56,1360014665755,1360014666395,436050075,436050715,640
1360014669,436053408,3,168,56,1360014666565,1360014667461,436050973,436051869,896
1360014677,436061252,3,168,56,1360014668897,1360014669921,436053149,436054173,1024
1360014677,436061372,3,168,56,1360014670057,1360014670697,436054429,436055069,640
1360014687,436071560,1,52,52,1360014662508,1360014662508,436047068,436047068,0
1360014687,436071600,17,3962,233.0588235,1360014661059,1360014664195,436045659,436048795,3136
1360014723,436107680,1,52,52,1360014698163,1360014698163,436082843,436082843,0
1360014803,436187800,1,52,52,1360014776891,1360014776891,436161691,436161691,0
1360014813,436197452,20,4590,229.5,1360014801686,1360014805206,436186138,436189658,3520
1360014813,436197452,15,3691,246.0666667,1360014801686,1360014805078,436186138,436189530,3392
1360014813,436197532,15,3703,246.8666667,1360014801607,1360014805191,436186139,436189723,3584
1360014831,436216012,10,4443,444.3,1360014804837,1360014806565,436189849,436191577,1728
1360014952,436336416,2,131,65.5,1360014926328,1360014926328,436310744,436310744,0
1360015117,436501828,3,168,56,1360015115800,1360015116376,436500628,436501204,576
1360015117,436501840,2,116,58,1360015116559,1360015116623,436501399,436501463,64
1360015117,436501880,3,168,56,1360015114853,1360015115429,436499733,436500309,576
1360015125,436509864,3,168,56,1360015118071,1360015118647,436502935,436503511,576
1360015125,436509912,3,168,56,1360015119812,1360015120452,436504724,436505364,640
1360015125,436509920,3,168,56,1360015120701,1360015121341,436505621,436506261,640
1360015125,436509952,3,168,56,1360015121630,1360015122206,436506582,436507158,576
1360015125,436509956,3,168,56,1360015118872,1360015119448,436503828,436504404,576
1360015125,436509960,3,168,56,1360015122581,1360015123157,436507541,436508117,576
1360015140,436524636,19,4066,214,1360015115033,1360015117913,436499669,436502549,2880
1360015144,436528836,1,46,46,1360015117201,1360015117201,436502037,436502037,0
1360015144,436528864,1,52,52,1360015116342,1360015116342,436501206,436501206,0
1360015144,436528944,1,52,52,1360015116838,1360015116838,436501782,436501782,0
1360015280,436664948,30,35860,1195.333333,1360015252318,1360015255198,436637266,436640146,2880
1360015280,436664952,92,108665,1181.141304,1360015252253,1360015267165,436637205,436652117,14912
1360015293,436678004,2,131,65.5,1360015284903,1360015284903,436669907,436669907,0
1360015301,436685940,2,131,65.5,1360015297192,1360015297192,436682132,436682132,0
1360015325,436710028,5,2395,479,1360015312655,1360015316943,436697683,436701971,4288
1360015333,436718048,5,2189,437.8,1360015327228,1360015331580,436712276,436716628,4352
1360015337,436721444,8,3802,475.25,1360015312149,1360015313685,436696593,436698129,1536
1360015341,436725448,11,5880,534.5454545,1360015316177,1360015336785,436700625,436721233,20608
1360015349,436733936,5,1781,356.2,1360015337068,1360015346028,436722004,436730964,8960
1360015349,436733976,3,138,46,1360015347587,1360015347587,436732563,436732563,0
1360015353,436737284,1,46,46,1360015325558,1360015325558,436709842,436709842,0
1360015373,436757396,86,103130,1199.186047,1360015348357,1360015359877,436732753,436744273,11520
1360015390,436774232,2,131,65.5,1360015389164,1360015389164,436773396,436773396,0
1360015397,436781400,3,1544,514.6666667,1360015371904,1360015372352,436756304,436756752,448
1360015397,436781456,3,458,152.6666667,1360015370761,1360015371017,436755217,436755473,256
1360015413,436797356,16,1311,81.9375,1360015385260,1360015385836,436769616,436770192,576
1360015429,436813396,1,52,52,1360015402373,1360015402373,436786769,436786769,0
1360015473,436857900,1,46,46,1360015447182,1360015447182,436832082,436832082,0
1360015541,436926044,1,46,46,1360015513853,1360015513853,436898897,436898897,0
1360015654,437038272,1,52,52,1360015625918,1360015625918,437010190,437010190,0
1360015750,437134656,3,168,56,1360015746107,1360015746747,437130763,437131403,640
1360015750,437134700,3,168,56,1360015748624,1360015749328,437133324,437134028,704
1360015750,437134772,3,168,56,1360015747463,1360015748039,437132235,437132811,576
1360015758,437142764,3,168,56,1360015751824,1360015752464,437136588,437137228,640
1360015758,437142776,3,168,56,1360015756805,1360015757381,437141581,437142157,576
1360015758,437142780,3,168,56,1360015749695,1360015750207,437134475,437134987,512
1360015758,437142808,3,168,56,1360015750563,1360015751267,437135371,437136075,704
1360015758,437142852,3,168,56,1360015752825,1360015753401,437137677,437138253,576
1360015766,437150796,3,168,56,1360015757680,1360015758256,437142476,437143052,576
1360015774,437158964,1,46,46,1360015746822,1360015746822,437131786,437131786,0
1360015774,437159000,18,5432,301.7777778,1360015748322,1360015751586,437133322,437136586,3264
1360015778,437162772,1,52,52,1360015750153,1360015750153,437134925,437134925,0
1360015802,437186784,1,487,487,1360015777403,1360015777403,437162187,437162187,0
1360015854,437238980,1,52,52,1360015826038,1360015826038,437211018,437211018,0
1360016071,437455404,2,339,169.5,1360016044146,1360016044146,437428550,437428550,0
1360016094,437478940,3,168,56,1360016092124,1360016092764,437477064,437477704,640
1360016094,437478952,3,168,56,1360016093135,1360016093775,437478087,437478727,640
1360016094,437478984,4,271,67.75,1360016091053,1360016091565,437476037,437476549,512
1360016094,437478992,3,168,56,1360016088614,1360016089190,437473606,437474182,576
1360016094,437479024,3,168,56,1360016089479,1360016089927,437474503,437474951,448
1360016094,437479032,3,168,56,1360016090240,1360016090944,437475272,437475976,704
1360016102,437486944,3,168,56,1360016095702,1360016096342,437480646,437481286,640
1360016102,437486972,3,168,56,1360016096633,1360016097337,437481605,437482309,704
1360016102,437487012,3,168,56,1360016094738,1360016095378,437479750,437480390,640
1360016115,437499796,17,3962,233.0588235,1360016088812,1360016092268,437473608,437477064,3456
1360016115,437499832,1,52,52,1360016090247,1360016090247,437475079,437475079,0
1360016119,437503808,1,46,46,1360016094238,1360016094238,437479046,437479046,0
1360016123,437507664,3,138,46,1360016098862,1360016102254,437483526,437486918,3392
1360016131,437515876,1,46,46,1360016105497,1360016105497,437490373,437490373,0
1360016131,437516004,9,3451,383.4444444,1360016106075,1360016107163,437491079,437492167,1088
1360016179,437563920,1,487,487,1360016152365,1360016152365,437537285,437537285,0
1360016230,437615020,2,131,65.5,1360016227017,1360016227017,437612037,437612037,0
1360016351,437736168,1,52,52,1360016325747,1360016325747,437710915,437710915,0
1360016524,437908308,1,46,46,1360016498443,1360016498443,437882751,437882751,0
1360016524,437908340,1,48,48,1360016499436,1360016499436,437883776,437883776,0
1360016564,437948436,1,46,46,1360016535949,1360016535949,437920385,437920385,0
1360016583,437967340,3,168,56,1360016578986,1360016579626,437963326,437963966,640
1360016600,437984616,1,46,46,1360016574038,1360016574038,437958654,437958654,0
1360016608,437992496,1,52,52,1360016583630,1360016583630,437968126,437968126,0
1360016608,437992540,18,4022,223.4444444,1360016581860,1360016585124,437966400,437969664,3264
1360016632,438016668,1,46,46,1360016604320,1360016604320,437988988,437988988,0
1360016680,438064580,1,46,46,1360016654395,1360016654395,438038975,438038975,0
1360016732,438116644,7,2757,393.8571429,1360016706680,1360016707960,438091324,438092604,1280
1360016840,438224756,1,433,433,1360016814086,1360016814086,438198842,438198842,0
1360016884,438268992,4,512,128,1360016856924,1360016878940,438241916,438263932,22016
1360016888,438273008,1,442,442,1360016861002,1360016861002,438246010,438246010,0
1360016940,438324964,1,60,60,1360016912181,1360016912181,438297145,438297145,0
1360016972,438357216,1,52,52,1360016947387,1360016947387,438332603,438332603,0
1360016999,438383560,2,92,46,1360016982664,1360016982984,438367224,438367544,320
1360017048,438433132,4,184,46,1360017021197,1360017030797,438406329,438415929,9600
1360017072,438457184,7,1302,186,1360017045718,1360017069078,438430902,438454262,23360
1360017093,438477364,3,138,46,1360017068236,1360017082572,438452600,438466936,14336
1360017104,438489160,3,558,186,1360017079089,1360017099057,438464249,438484217,19968
1360017164,438549212,1,46,46,1360017136827,1360017136827,438522039,438522039,0
1360017373,438757864,1,46,46,1360017345556,1360017345556,438730420,438730420,0
1360017449,438834096,1,46,46,1360017423594,1360017423594,438808690,438808690,0
1360017574,438958344,1,46,46,1360017549206,1360017549206,438933550,438933550,0
1360017634,439018336,1,46,46,1360017607518,1360017607518,438991854,438991854,0
1360018080,439464728,3,168,56,1360018079054,1360018079694,439463782,439464422,640
1360018080,439464768,3,168,56,1360018076905,1360018077673,439461673,439462441,768
1360018080,439464776,4,214,53.5,1360018066593,1360018076449,439451369,439461225,9856
1360018080,439464820,17,3504,206.1176471,1360018076405,1360018079285,439461225,439464105,2880
1360018080,439464852,3,168,56,1360018077778,1360018078482,439462630,439463334,704
1360018088,439472696,15,3314,220.9333333,1360018086831,1360018087215,439471527,439471911,384
1360018088,439472700,3,168,56,1360018083116,1360018083692,439467816,439468392,576
1360018088,439472704,17,5491,323,1360018083432,1360018084968,439468136,439469672,1536
1360018088,439472712,19,4073,214.3684211,1360018079391,1360018081439,439464103,439466151,2048
1360018088,439472740,19,3815,200.7894737,1360018081540,1360018083332,439466280,439468072,1792
1360018088,439472744,14,6838,488.4285714,1360018085119,1360018086079,439469863,439470823,960
1360018088,439472780,14,3953,282.3571429,1360018087194,1360018087770,439471974,439472550,576
1360018088,439472816,19,3832,201.6842105,1360018085176,1360018086008,439469992,439470824,832
1360018088,439472820,15,3409,227.2666667,1360018086005,1360018086325,439470825,439471145,320
1360018096,439480752,17,3563,209.5882353,1360018089399,1360018089719,439474151,439474471,320
1360018096,439480808,61,62272,1020.852459,1360018087806,1360018089342,439472614,439474150,1536
1360018096,439480836,17,3369,198.1764706,1360018089701,1360018090277,439474537,439475113,576
1360018096,439480844,3,168,56,1360018094169,1360018094297,439479013,439479141,128
1360018099,439483524,19,4066,214,1360018073434,1360018077146,439457958,439461670,3712
1360018099,439483536,8,4908,613.5,1360018074382,1360018075854,439458918,439460390,1472
1360018104,439488732,3,168,56,1360018103627,1360018103755,439488359,439488487,128
1360018104,439488752,2,116,58,1360018103800,1360018103864,439488552,439488616,64
1360018104,439488808,4,271,67.75,1360018103424,1360018103488,439488232,439488296,64
1360018104,439488808,2,110,55,1360018083903,1360018095871,439468711,439480679,11968
1360018127,439511388,1,485,485,1360018099428,1360018099428,439483816,439483816,0
1360018131,439515380,1,52,52,1360018104298,1360018104298,439488678,439488678,0
1360018175,439559528,9,3463,384.7777778,1360018150486,1360018150870,439535014,439535398,384
1360029748,451132496,1,46,46,1360029723651,1360029723651,451108147,451108147,0
1360030514,451898172,1,46,46,1360030487738,1360030487738,451871910,451871910,0
1360030739,452124128,1,46,46,1360030710460,1360030710460,452095588,452095588,0
1360031232,452616228,1,46,46,1360031206264,1360031206264,452590492,452590492,0
1360032304,453688872,5,296,59.2,1360032290212,1360032300900,453675084,453685772,10688
1360032357,453742100,1,52,52,1360032332799,1360032332799,453717899,453717899,0
1360032422,453806628,1,52,52,1360032397397,1360032397397,453782025,453782025,0
1360032464,453848992,3,168,56,1360032459817,1360032460329,453844809,453845321,512
1360032472,453856972,19,4036,212.4210526,1360032465595,1360032466491,453850567,453851463,896
1360032472,453856984,22,3629,164.9545455,1360032466671,1360032466991,453851655,453851975,320
1360032472,453856988,14,3560,254.2857143,1360032466798,1360032467118,453851786,453852106,320
1360032472,453857008,27,8674,321.2592593,1360032467095,1360032467991,453852103,453852999,896
1360032472,453857020,21,5000,238.0952381,1360032471118,1360032471694,453856138,453856714,576
1360032472,453857028,18,3970,220.5555556,1360032468869,1360032469637,453853897,453854665,768
1360032472,453857064,16,3428,214.25,1360032464609,1360032465121,453849673,453850185,512
1360032472,453857104,14,6838,488.4285714,1360032468410,1360032468794,453853514,453853898,384
1360032472,453857104,46,5320,115.6521739,1360032468599,1360032469751,453853703,453854855,1152
1360032480,453864992,3,168,56,1360032473512,1360032473640,453858504,453858632,128
1360032480,453865000,64,66937,1045.890625,1360032472290,1360032474786,453857290,453859786,2496
1360032480,453865008,18,3615,200.8333333,1360032474777,1360032475225,453859785,453860233,448
1360032480,453865072,3,168,56,1360032473624,1360032473752,453858696,453858824,128
1360032480,453865124,2,110,55,1360032463270,1360032473318,453848394,453858442,10048
1360032480,453865124,15,4017,267.8,1360032471587,1360032472163,453856711,453857287,576
1360032486,453870652,1,52,52,1360032461499,1360032461499,453846151,453846151,0
1360032490,453874600,18,4420,245.5555556,1360032463153,1360032470577,453847753,453855177,7424
1360032490,453874716,7,3438,491.1428571,1360032463932,1360032464444,453848648,453849160,512
1360032496,453880968,3,168,56,1360032489472,1360032490048,453874440,453875016,576
1360032496,453880980,3,168,56,1360032490291,1360032490931,453875271,453875911,640
1360032496,453881024,4,232,58,1360032485320,1360032489032,453870344,453874056,3712
1360032498,453882656,1,52,52,1360032472247,1360032472247,453856903,453856903,0
1360032502,453886576,1,64,64,1360032474312,1360032474312,453858888,453858888,0
1360032502,453886656,1,46,46,1360032474103,1360032474103,453858759,453858759,0
1360032518,453902700,1,64,64,1360032491404,1360032491404,453876104,453876104,0
1360032586,453970872,1,52,52,1360032558429,1360032558429,453943301,453943301,0
1360032642,454026992,2,188,94,1360032616487,1360032616487,454001479,454001479,0
1360032658,454043000,1,46,46,1360032631836,1360032631836,454016836,454016836,0
1360032670,454055120,1,46,46,1360032645349,1360032645349,454030469,454030469,0
1360032686,454071084,9,3463,384.7777778,1360032659274,1360032660682,454044358,454045766,1408
1360032702,454087056,8,2809,351.125,1360032677605,1360032701669,454062661,454086725,24064
1360032705,454089220,3,162,54,1360032702762,1360032703018,454086982,454087238,256
1360032706,454091032,8,4565,570.625,1360032679102,1360032701374,454064134,454086406,22272
1360032712,454097164,2,104,52,1360032703992,1360032704248,454089156,454089412,256
1360032713,454097244,2,127,63.5,1360032707152,1360032707152,454091396,454091396,0
1360032727,454111200,2,116,58,1360032702460,1360032702716,454086660,454086916,256
1360032737,454121272,7,1396,199.4285714,1360032733046,1360032735350,454117318,454119622,2304
1360032746,454131072,1,46,46,1360032720726,1360032720726,454105798,454105798,0
1360032753,454137208,10,4433,443.3,1360032746994,1360032747890,454131202,454132098,896
1360032754,454139112,4,1690,422.5,1360032729709,1360032742445,454114821,454127557,12736
1360032759,454143276,7,3181,454.4285714,1360032734128,1360032735344,454118404,454119620,1216
1360032761,454145200,6,2061,343.5,1360032759226,1360032759290,454143426,454143490,64
1360032761,454145212,9,4387,487.4444444,1360032759920,1360032760304,454144132,454144516,384
1360032761,454145292,62,80653,1300.854839,1360032760225,1360032760737,454144517,454145029,512
1360032761,454145320,12,1500,125,1360032754500,1360032757444,454138820,454141764,2944
1360032761,454145324,6,1240,206.6666667,1360032757760,1360032757824,454142084,454142148,64
1360032763,454147200,14,8578,612.7142857,1360032738363,1360032740347,454122563,454124547,1984
1360032769,454153276,28,32333,1154.75,1360032767280,1360032767408,454151556,454151684,128
1360032769,454153280,12,5477,456.4166667,1360032755757,1360032762669,454140037,454146949,6912
1360032769,454153284,30,35697,1189.9,1360032761510,1360032761638,454145794,454145922,128
1360032769,454153316,37,43333,1171.162162,1360032757127,1360032762631,454141443,454146947,5504
1360032769,454153320,27,30764,1139.407407,1360032762629,1360032762693,454146949,454147013,64
1360032769,454153324,60,79376,1322.933333,1360032766081,1360032766209,454150405,454150533,128
1360032769,454153356,23,27143,1180.130435,1360032763679,1360032763871,454148035,454148227,192
1360032769,454153396,22,24868,1130.363636,1360032764856,1360032764984,454149252,454149380,128
1360032769,454153400,11,6081,552.8181818,1360032757301,1360032763701,454141701,454148101,6400
1360032774,454159168,22,6261,284.5909091,1360032746037,1360032766389,454131205,454151557,20352
1360032775,454159176,21,15009,714.7142857,1360032747859,1360032751699,454132035,454135875,3840
1360032775,454159256,17,6782,398.9411765,1360032747011,1360032758083,454131267,454142339,11072
1360032775,454159256,15,13177,878.4666667,1360032747138,1360032747458,454131394,454131714,320
1360032779,454163228,1,116,116,1360032754274,1360032754274,454138502,454138502,0
1360032779,454163248,1,116,116,1360032754250,1360032754250,454138498,454138498,0
1360032779,454163256,1,46,46,1360032754498,1360032754498,454138754,454138754,0
1360032779,454163260,1,116,116,1360032754494,1360032754494,454138754,454138754,0
1360032779,454163336,7,3494,499.1428571,1360032754098,1360032754674,454138434,454139010,576
1360032779,454163344,26,9056,348.3076923,1360032754410,1360032772266,454138754,454156610,17856
1360032779,454163348,1,116,116,1360032754410,1360032754410,454138758,454138758,0
1360032785,454169356,2,131,65.5,1360032780960,1360032780960,454165316,454165316,0
1360032787,454171188,2,112,56,1360032759241,1360032759241,454143429,454143429,0
1360032787,454171284,2,112,56,1360032759080,1360032759144,454143364,454143428,64
1360032787,454171284,2,112,56,1360032759143,1360032759143,454143427,454143427,0
1360032787,454171316,1,585,585,1360032759815,1360032759815,454144131,454144131,0
1360032793,454177360,7,547,78.14285714,1360032787163,1360032788763,454171523,454173123,1600
1360032803,454187332,10,684,68.4,1360032777141,1360032797301,454161473,454181633,20160
1360032817,454201312,3,202,67.33333333,1360032811209,1360032816201,454195521,454200513,4992
1360032817,454201364,4,254,63.5,1360032806549,1360032811733,454190913,454196097,5184
1360032825,454209476,4,277,69.25,1360032817447,1360032822439,454201923,454206915,4992
1360032835,454219348,6,396,66,1360032807080,1360032828264,454191428,454212612,21184
1360032843,454227444,1,52,52,1360032816390,1360032816390,454200834,454200834,0
1360032863,454247500,6,398,66.33333333,1360032837006,1360032857294,454221506,454241794,20288
1360032881,454265452,6,397,66.16666667,1360032867071,1360032875839,454251523,454260291,8768
1360032903,454287404,1,52,52,1360032876332,1360032876332,454260736,454260736,0
1360032903,454287492,1,52,52,1360032876118,1360032876118,454260610,454260610,0
1360032903,454287496,1,52,52,1360032876243,1360032876243,454260739,454260739,0
1360032977,454361500,2,104,52,1360032975116,1360032975884,454359616,454360384,768
1360033001,454385548,2,104,52,1360032994461,1360032994717,454379009,454379265,256
1360033007,454391504,1,52,52,1360032980039,1360032980039,454364543,454364543,0
1360033099,454483588,1,46,46,1360033073137,1360033073137,454457725,454457725,0
1360033099,454483676,1,46,46,1360033073370,1360033073370,454458046,454458046,0
1360033187,454571800,2,337,168.5,1360033159644,1360033159644,454544444,454544444,0
1360033259,454643808,3,387,129,1360033233109,1360033233941,454617917,454618749,832
1360033513,454897752,12,1524,127,1360033507850,1360033511562,454892602,454896314,3712
1360033513,454897752,6,1237,206.1666667,1360033511880,1360033511944,454896632,454896696,64
1360033513,454897808,2,92,46,1360033507601,1360033507793,454892409,454892601,192
1360033521,454905776,28,32494,1160.5,1360033513712,1360033513840,454898488,454898616,128
1360033521,454905780,30,35672,1189.066667,1360033513773,1360033513901,454898553,454898681,128
1360033521,454905848,7,843,120.4285714,1360033511338,1360033516522,454896186,454901370,5184
1360033521,454905848,10,6029,602.9,1360033511337,1360033516713,454896185,454901561,5376
1360033521,454905888,31,36764,1185.935484,1360033513601,1360033513793,454898489,454898681,192
1360033521,454905888,43,54018,1256.232558,1360033513600,1360033513792,454898488,454898680,192
1360033521,454905936,7,4463,637.5714286,1360033511185,1360033516305,454896121,454901241,5120
1360033521,454905936,7,1062,151.7142857,1360033511249,1360033516497,454896185,454901433,5248
1360033532,454916696,1,116,116,1360033506817,1360033506817,454891513,454891513,0
1360033532,454916720,1,46,46,1360033507303,1360033507303,454892023,454892023,0
1360033532,454916780,1,116,116,1360033506667,1360033506667,454891447,454891447,0
1360033536,454920676,31,10847,349.9032258,1360033510294,1360033526486,454894970,454911162,16192
1360033568,454952708,1,329,329,1360033541493,1360033541493,454926201,454926201,0
1360033569,454953924,8,3770,471.25,1360033565917,1360033567261,454950841,454952185,1344
1360033789,455173204,3,460,153.3333333,1360033764776,1360033765608,455148980,455149812,832
1360033817,455202000,4,774,193.5,1360033813833,1360033814153,455198833,455199153,320
1360033817,455202120,107,144325,1348.831776,1360033567314,1360033808914,454952434,455194034,241600
1360033845,455229264,13,4012,308.6153846,1360033817194,1360033819370,455201458,455203634,2176
1360034065,455450100,4,184,46,1360034059108,1360034059108,455444208,455444208,0
1360034085,455469524,1,52,52,1360034059109,1360034059109,455443633,455443633,0
1360034085,455469564,7,2757,393.8571429,1360034059963,1360034061179,455444527,455445743,1216
1360034317,455701776,1,46,46,1360034291618,1360034291618,455676394,455676394,0
1360034329,455713736,1,52,52,1360034301005,1360034301005,455685741,455685741,0
1360034690,456074740,2,129,64.5,1360034665092,1360034665092,456049832,456049832,0
1360034803,456187500,31,22681,731.6451613,1360034786162,1360034795698,456170662,456180198,9536
1360034810,456195120,1,439,439,1360034784707,1360034784707,456169827,456169827,0
1360034823,456207168,51,45445,891.0784314,1360034794941,1360034817341,456179109,456201509,22400
1360034939,456323608,2,131,65.5,1360034936833,1360034936833,456321441,456321441,0
1360035059,456443628,2,92,46,1360035054893,1360035055149,456439521,456439777,256
1360035627,457012112,4,279,69.75,1360035626433,1360035626689,457011545,457011801,256
1360035669,457053544,17,3962,233.0588235,1360035641334,1360035644278,457025878,457028822,2944
1360035697,457081448,1,192,192,1360035669592,1360035669592,457054040,457054040,0
1360035697,457081572,11,6090,553.6363636,1360035671642,1360035674266,457056214,457058838,2624
1360035886,457270360,1,46,46,1360035860650,1360035860650,457245010,457245010,0
1360035942,457326356,1,52,52,1360035914479,1360035914479,457298835,457298835,0
1360036020,457404252,15,3376,225.0666667,1360036014422,1360036016278,457398674,457400530,1856
1360036038,457422708,9,4733,525.8888889,1360036011660,1360036013196,457396368,457397904,1536
1360036188,457572360,7,322,46,1360036185831,1360036186471,457570191,457570831,640
1360036204,457588316,15,6785,452.3333333,1360036200660,1360036202132,457584976,457586448,1472
1360036204,457588368,13,6493,499.4615385,1360036199391,1360036200927,457583759,457585295,1536
1360036207,457591280,6,364,60.66666667,1360036181175,1360036201527,457565455,457585807,20352
1360036212,457596444,20,14086,704.3,1360036201426,1360036208786,457585870,457593230,7360
1360036212,457596452,3,192,64,1360036210378,1360036211466,457594830,457595918,1088
1360036215,457599272,4,240,60,1360036189439,1360036198591,457573711,457582863,9152
1360036220,457604360,2,104,52,1360036212007,1360036218279,457596367,457602639,6272
1360036220,457604400,2,128,64,1360036212991,1360036215999,457597391,457600399,3008
1360036235,457619284,5,300,60,1360036207346,1360036226418,457591630,457610702,19072
1360036247,457631272,1,64,64,1360036222012,1360036222012,457606284,457606284,0
1360036260,457644428,4,208,52,1360036253472,1360036257952,457637900,457642380,4480
1360036471,457855824,1,46,46,1360036445075,1360036445075,457829899,457829899,0
1360036500,457884492,4,208,52,1360036495646,1360036499550,457880138,457884042,3904
1360036516,457900504,2,104,52,1360036503956,1360036512724,457888460,457897228,8768
1360036540,457924584,2,104,52,1360036522688,1360036532672,457907272,457917256,9984
1360036556,457940692,2,104,52,1360036542551,1360036552535,457927243,457937227,9984
1360039155,460539336,1,48,48,1360039126288,1360039126288,460510624,460510624,0
1360082252,503636768,1,46,46,1360082222599,1360082222599,503607367,503607367,0
1360082936,504320108,9,2861,317.8888889,1360082934480,1360082934800,504318588,504318908,320
1360082936,504320112,9,2545,282.7777778,1360082934543,1360082934927,504318655,504319039,384
1360082944,504328168,18,4656,258.6666667,1360082934806,1360082936086,504318974,504320254,1280
1360082952,504336160,24,15129,630.375,1360082936092,1360082944860,504320252,504329020,8768
1360082958,504342520,11,3267,297,1360082933751,1360082934327,504318271,504318847,576
1360082962,504346580,7,2342,334.5714286,1360082934330,1360082934650,504318910,504319230,320
1360082962,504346584,22,4552,206.9090909,1360082934452,1360082936372,504319036,504320956,1920
1360082992,504376140,2,141,70.5,1360082984368,1360082984368,504368508,504368508,0
1360083010,504394628,1,52,52,1360082983753,1360082983753,504368381,504368381,0
1360083032,504416268,9,1044,116,1360083013359,1360083025711,504397627,504409979,12352
1360083038,504422608,30,6176,205.8666667,1360083013211,1360083016091,504397819,504400699,2880
1360083038,504422680,27,8005,296.4814815,1360083012946,1360083015378,504397626,504400058,2432
1360083038,504422684,25,5002,200.08,1360083013010,1360083015826,504397694,504400510,2816
1360083038,504422684,1,60,60,1360083013007,1360083013007,504397691,504397691,0
1360083119,3437782728,8,7207,900.875,1360083101197,1360083113485,3437764925,3437777213,12288
1360083119,3437782728,7,4807,686.7142857,1360083101196,1360083113164,3437764924,3437776892,11968
1360083120,504504316,17,8195,482.0588235,1360083101504,1360083113856,504485820,504498172,12352
1360083127,3437790732,8,7207,900.875,1360083114824,1360083126856,3437778556,3437790588,12032
1360083128,504512276,14,6021,430.0714286,1360083115238,1360083127270,504499514,504511546,12032
1360083144,504528376,30,26598,886.6,1360083138818,1360083140354,504523194,504524730,1536
1360083144,504528420,18,9327,518.1666667,1360083138136,1360083139160,504522556,504523580,1024
1360083152,504536304,9,2883,320.3333333,1360083139273,1360083151241,504523577,504535545,11968
1360083152,504536332,11,6283,571.1818182,1360083140527,1360083151407,504524859,504535739,10880
1360083152,504536332,8,3035,379.375,1360083141358,1360083151406,504525690,504535738,10048
1360083152,504536332,8,1798,224.75,1360083141358,1360083151534,504525690,504535866,10176
1360083152,504536332,8,3024,378,1360083141357,1360083151533,504525689,504535865,10176
1360083152,504536376,15,5300,353.3333333,1360083147843,1360083148099,504532219,504532475,256
1360083152,504536384,13,3847,295.9230769,1360083140473,1360083151353,504524857,504535737,10880
1360083152,504536388,8,1808,226,1360083141304,1360083151480,504525692,504535868,10176
1360083160,504544340,3,238,79.33333333,1360083158182,1360083158310,504542522,504542650,128
1360083160,504544356,4,559,139.75,1360083139221,1360083151829,504523577,504536185,12608
1360083162,504546840,1,52,52,1360083137715,1360083137715,504522555,504522555,0
1360083162,504546924,1,46,46,1360083134623,1360083134623,504519547,504519547,0
1360083168,504552328,2,112,56,1360083163956,1360083164020,504548284,504548348,64
1360083168,504552332,16,7162,447.625,1360083153583,1360083166895,504537915,504551227,13312
1360083168,504552368,7,789,112.7142857,1360083163145,1360083163913,504547513,504548281,768
1360083168,504552372,3,164,54.66666667,1360083163908,1360083163972,504548280,504548344,64
1360083168,504552412,7,2448,349.7142857,1360083166047,1360083166367,504550459,504550779,320
1360083176,504560324,6,1448,241.3333333,1360083171318,1360083172086,504555642,504556410,768
1360083176,504560368,42,50758,1208.52381,1360083160137,1360083172105,504544505,504556473,11968
1360083176,504560376,4,356,89,1360083167104,1360083173888,504551480,504558264,6784
1360083176,504560400,4,351,87.75,1360083172395,1360083172587,504556795,504556987,192
1360083184,504568316,6,1448,241.3333333,1360083180479,1360083180735,504564795,504565051,256
1360083190,504574804,1,60,60,1360083162709,1360083162709,504547513,504547513,0
1360083190,504574840,1,60,60,1360083163440,1360083163440,504548280,504548280,0
1360083190,504574964,1,60,60,1360083162549,1360083162549,504547513,504547513,0
1360083192,504576328,4,356,89,1360083178608,1360083185904,504562936,504570232,7296
1360083192,504576380,12,4865,405.4166667,1360083173503,1360083185535,504557883,504569915,12032
1360083192,504576380,5,681,136.2,1360083178110,1360083185918,504562490,504570298,7808
1360083192,504576456,31,40239,1298.032258,1360083174001,1360083185521,504558457,504569977,11520
1360083192,504576456,60,77302,1288.366667,1360083173745,1360083185521,504558201,504569977,11776
1360083200,504584396,135,179394,1328.844444,1360083163887,1360083192239,504548283,504576635,28352
1360083240,504624376,5,851,170.2,1360083224383,1360083236351,504608759,504620727,11968
1360083240,504624420,11,3860,350.9090909,1360083224341,1360083236309,504608761,504620729,11968
1360083243,504627068,4,244,61,1360083217973,1360083228533,504602041,504612601,10560
1360083251,504635032,19,19536,1028.210526,1360083225049,1360083227033,504609081,504611065,1984
1360083251,504635104,1,60,60,1360083225359,1360083225359,504609463,504609463,0
1360083251,504635108,14,15240,1088.571429,1360083225804,1360083226828,504609912,504610936,1024
1360083256,504640384,8,2304,288,1360083254712,1360083254904,504639096,504639288,192
1360083263,504647116,1,60,60,1360083238086,1360083238086,504622202,504622202,0
1360083328,504712404,62,74091,1195.016129,1360083311650,1360083323618,504696054,504708022,11968
1360083328,504712408,9,7554,839.3333333,1360083313376,1360083323616,504697784,504708024,10240
1360083328,504712448,4,709,177.25,1360083312502,1360083323702,504696950,504708150,11200
1360083328,504712472,4,356,89,1360083312993,1360083323553,504697465,504708025,10560
1360083328,504712480,4,592,148,1360083321625,1360083322841,504706105,504707321,1216
1360083336,504720444,9,3479,386.5555556,1360083321533,1360083333501,504705977,504717945,11968
1360083336,504720452,33,38884,1178.30303,1360083326323,1360083333491,504710775,504717943,7168
1360083336,504720496,6,1448,241.3333333,1360083332617,1360083333385,504717113,504717881,768
1360083339,504723232,1,60,60,1360083312782,1360083312782,504697014,504697014,0
1360083344,504728400,5,681,136.2,1360083328169,1360083339049,504712569,504723449,10880
1360083344,504728400,4,356,89,1360083328294,1360083338982,504712694,504723382,10688
1360083344,504728408,5,483,96.6,1360083328801,1360083339041,504713209,504723449,10240
1360083376,504760436,4,592,148,1360083371075,1360083371523,504755511,504755959,448
1360083376,504760444,5,854,170.8,1360083360572,1360083372476,504745016,504756920,11904
1360083376,504760444,10,1944,194.4,1360083360507,1360083372475,504744951,504756919,11968
1360083376,504760452,5,1777,355.4,1360083361267,1360083372659,504745719,504757111,11392
1360083376,504760480,15,16529,1101.933333,1360083365400,1360083372632,504749880,504757112,7232
1360083376,504760520,6,3351,558.5,1360083361199,1360083372591,504745719,504757111,11392
1360083376,504760524,5,2195,439,1360083361193,1360083372585,504745717,504757109,11392
1360083376,504760524,22,27963,1271.045455,1360083361260,1360083372588,504745784,504757112,11328
1360083376,504760524,27,34990,1295.925926,1360083361580,1360083372588,504746104,504757112,11008
1360083384,504768500,61,83912,1375.606557,1360083366403,1360083378563,504750903,504763063,12160
1360083384,504768536,145,201951,1392.765517,1360083360736,1360083378592,504745272,504763128,17856
1360083419,504803516,11,3267,297,1360083392179,1360083395315,504776695,504779831,3136
1360083423,504807580,7,529,75.57142857,1360083395697,1360083396017,504780277,504780597,320
1360083480,504864580,2,104,52,1360083477683,1360083478323,504862263,504862903,640
1360083824,505208976,9,2861,317.8888889,1360083823199,1360083823647,505208175,505208623,448
1360083824,505208980,9,2543,282.5555556,1360083823450,1360083823834,505208430,505208814,384
1360083832,505216912,17,5155,303.2352941,1360083823711,1360083825183,505208623,505210095,1472
1360083841,505225096,19,13036,686.1052632,1360083826000,1360083834576,505210096,505218672,8576
1360083852,505236840,22,4550,206.8181818,1360083823976,1360083826280,505208816,505211120,2304
1360083873,505257112,39,30171,773.6153846,1360083853631,1360083865983,505237743,505250095,12352
1360083873,505257112,17,4377,257.4705882,1360083853695,1360083866431,505237807,505250543,12736
1360083880,505264868,19,4097,215.6315789,1360083852874,1360083877322,505237742,505262190,24448
1360083880,505264868,22,6115,277.9545455,1360083852937,1360083868105,505237805,505252973,15168
1360083880,505264944,20,5405,270.25,1360083852863,1360083877247,505237807,505262191,24384
1360083880,505264948,30,17587,586.2333333,1360083853117,1360083877245,505238065,505262193,24128
1360083881,505265132,25,4565,182.6,1360083857323,1360083878123,505241455,505262255,20800
1360083881,505265164,18,4168,231.5555556,1360083858701,1360083878093,505242865,505262257,19392
1360083881,505265164,12,1346,112.1666667,1360083867018,1360083878026,505251182,505262190,11008
1360083881,505265172,19,6697,352.4736842,1360083859972,1360083878084,505244144,505262256,18112
1360083881,505265172,14,2667,190.5,1360083859907,1360083878019,505244079,505262191,18112
1360083881,505265172,16,2709,169.3125,1360083859971,1360083878019,505244143,505262191,18048
1360083881,505265200,16,1709,106.8125,1360083864167,1360083877991,505248367,505262191,13824
1360083892,505276956,41,20431,498.3170732,1360083865588,1360083888948,505250544,505273904,23360
1360083897,505281072,28,24494,874.7857143,1360083877478,1360083889766,505261550,505273838,12288
1360083897,505281120,90,108607,1206.744444,1360083877431,1360083893367,505261551,505277487,15936
1360083897,505281148,12,7482,623.5,1360083882521,1360083889689,505266669,505273837,7168
1360083905,505289160,7,3451,493,1360083897232,1360083897424,505281392,505281584,192
1360083912,505296896,36,6612,183.6666667,1360083885295,1360083889391,505270191,505274287,4096
1360083912,505296896,31,5493,177.1935484,1360083885230,1360083889262,505270126,505274158,4032
1360083913,505297148,20,8684,434.2,1360083900826,1360083909082,505284974,505293230,8256
1360083913,505297196,20,14884,744.2,1360083896875,1360083908843,505281071,505293039,11968
1360083913,505297196,33,30292,917.9393939,1360083896811,1360083908843,505281007,505293039,12032
1360083913,505297200,2,158,79,1360083897256,1360083905128,505281456,505289328,7872
1360083913,505297200,13,7614,585.6923077,1360083897701,1360083908837,505281901,505293037,11136
1360083913,505297244,24,11372,473.8333333,1360083900409,1360083912505,505284653,505296749,12096
1360083929,505313228,2,158,79,1360083916490,1360083924362,505300718,505308590,7872
1360083937,505321216,13,1245,95.76923077,1360083918102,1360083930198,505302318,505314414,12096
1360083949,505333040,1,79,79,1360083921094,1360083921094,505305134,505305134,0
1360083951,3438615052,16,10545,659.0625,1360083940750,1360083949710,3438604802,3438613762,8960
1360083953,505337208,11,5494,499.4545455,1360083941469,1360083950429,505325677,505334637,8960
1360083953,505337264,22,5493,249.6818182,1360083938407,1360083950503,505322671,505334767,12096
1360083953,505337288,13,1388,106.7692308,1360083942092,1360083950476,505326380,505334764,8384
1360083965,505349116,1,79,79,1360083940217,1360083940217,505324333,505324333,0
1360083969,505353160,1,146,146,1360083943628,1360083943628,505327788,505327788,0
1360083977,505361104,1,79,79,1360083952580,1360083952580,505336684,505336684,0
1360083977,505361240,12,1205,100.4166667,1360083960316,1360083971388,505344556,505355628,11072
1360083977,505361240,30,10454,348.4666667,1360083952893,1360083971005,505337133,505355245,18112
1360083977,505361276,14,5177,369.7857143,1360083963160,1360083970840,505347436,505355116,7680
1360083977,505361280,20,17183,859.15,1360083963414,1360083970838,505347694,505355118,7424
1360083977,505361280,22,10255,466.1363636,1360083963542,1360083974486,505347822,505358766,10944
1360083977,505361280,26,17331,666.5769231,1360083963478,1360083974550,505347758,505358830,11072
1360083991,3438655048,33,35955,1089.545455,1360083976787,1360083988947,3438640835,3438652995,12160
1360083993,505377576,43,45489,1057.883721,1360083981165,1360083990125,505365741,505374701,8960
1360083993,505377580,2,158,79,1360083978027,1360083985771,505362607,505370351,7744
1360083993,505377584,16,3252,203.25,1360083979111,1360083989351,505363695,505373935,10240
1360083993,505377584,16,3252,203.25,1360083979046,1360083989414,505363630,505373998,10368
1360083993,505377628,23,13583,590.5652174,1360083980407,1360083989367,505365035,505373995,8960
1360083993,505377656,7,2089,298.4285714,1360083978077,1360083989213,505362733,505373869,11136
1360083993,505377660,18,14794,821.8888889,1360083978267,1360083989211,505362927,505373871,10944
1360083993,505377660,40,37300,932.5,1360083978267,1360083992539,505362927,505377199,14272
1360083993,505377660,7,2089,298.4285714,1360083978267,1360083989147,505362927,505373807,10880
1360083997,505381440,1,79,79,1360083971444,1360083971444,505355884,505355884,0
1360084001,505385420,20,16229,811.45,1360083978121,1360083995593,505362541,505380013,17472
1360084005,505389332,1,79,79,1360083978465,1360083978465,505362797,505362797,0
1360084005,505389396,2,131,65.5,1360083980642,1360083980642,505365038,505365038,0
1360084009,505393520,2,158,79,1360083996326,1360084003686,505380846,505388206,7360
1360084017,505401400,21,2317,110.3333333,1360084002588,1360084015132,505386988,505399532,12544
1360084017,505401404,91,114291,1255.945055,1360083998042,1360084015642,505382446,505400046,17600
1360084017,505401404,17,12259,721.1176471,1360083998106,1360084015002,505382510,505399406,16896
1360084017,505401404,29,19884,685.6551724,1360083998042,1360084016026,505382446,505400430,17984
1360084017,505401432,86,105349,1224.988372,1360084004222,1360084016638,505388654,505401070,12416
1360084017,505401440,7,1930,275.7142857,1360084000181,1360084009013,505384621,505393453,8832
1360084017,505401440,13,1178,90.61538462,1360084000820,1360084009076,505385260,505393516,8256
1360084017,505401444,13,1178,90.61538462,1360084001071,1360084009071,505385515,505393515,8000
1360084017,505401472,16,9508,594.25,1360083998035,1360084008915,505382507,505393387,10880
1360084017,505401472,10,4269,426.9,1360083998038,1360084008982,505382510,505393454,10944
1360084017,505401472,15,10295,686.3333333,1360083998038,1360084015254,505382510,505399726,17216
1360084017,505401472,15,6397,426.4666667,1360083998038,1360084008982,505382510,505393454,10944
1360084017,505401480,36,34353,954.25,1360084004366,1360084014926,505388846,505399406,10560
1360084017,505401480,31,23280,750.9677419,1360084004365,1360084016525,505388845,505401005,12160
1360084017,505401512,7,1918,274,1360084000109,1360084008941,505384621,505393453,8832
1360084017,505401516,22,10994,499.7272727,1360084000555,1360084009067,505385071,505393583,8512
1360084025,505409384,2,158,79,1360084018414,1360084022062,505402798,505406446,3648
1360084025,505409384,18,1491,82.83333333,1360084018477,1360084023917,505402861,505408301,5440
1360084025,505409384,2,158,79,1360084018477,1360084022189,505402861,505406573,3712
1360084025,505409452,12,1444,120.3333333,1360084018027,1360084023851,505402479,505408303,5824
1360084029,505413544,1,60,60,1360084004173,1360084004173,505388717,505388717,0
1360084041,505425496,2,158,79,1360084023228,1360084037756,505407724,505422252,14528
1360084045,505429492,1,79,79,1360084018304,1360084018304,505402796,505402796,0
1360084049,505433332,20,4507,225.35,1360084029857,1360084041889,505414189,505426221,12032
1360084049,505433384,2,158,79,1360084029293,1360084043821,505413677,505428205,14528
1360084049,505433388,2,158,79,1360084029542,1360084044326,505413930,505428714,14784
1360084053,505437508,1,52,52,1360084026160,1360084026160,505410668,505410668,0
1360084053,505437512,2,116,58,1360084026732,1360084026732,505411244,505411244,0
1360084053,505437580,1,52,52,1360084026088,1360084026088,505410668,505410668,0
1360084053,505437584,2,104,52,1360084026468,1360084036644,505411052,505421228,10176
1360084057,505441364,17,3724,219.0588235,1360084044095,1360084052991,505428459,505437355,8896
1360084061,505445500,24,5087,211.9583333,1360084033208,1360084036728,505417708,505421228,3520
1360084061,505445500,30,10391,346.3666667,1360084033207,1360084036215,505417707,505420715,3008
1360084061,505445500,41,7567,184.5609756,1360084033271,1360084047543,505417771,505432043,14272
1360084073,505457724,1,79,79,1360084047320,1360084047320,505432044,505432044,0
1360084093,505477564,2,139,69.5,1360084065591,1360084065911,505450155,505450475,320
1360084093,505477676,1,79,79,1360084066694,1360084066694,505451370,505451370,0
1360084097,505481680,1,79,79,1360084072516,1360084072516,505457196,505457196,0
1360084101,505485548,1,79,79,1360084073673,1360084073673,505458221,505458221,0
1360084113,505497324,3,168,56,1360084105192,1360084105192,505489516,505489516,0
1360084113,505497376,2,104,52,1360084105205,1360084105205,505489581,505489581,0
1360084113,505497376,3,168,56,1360084105204,1360084105268,505489580,505489644,64
1360084121,505505624,1,46,46,1360084095613,1360084095613,505480237,505480237,0
1360084353,505737652,4,319,79.75,1360084347293,1360084350941,505731945,505735593,3648
1360084369,505753652,2,178,89,1360084355738,1360084365338,505740390,505749990,9600
1360084410,505794644,1,89,89,1360084384611,1360084384611,505769255,505769255,0
1360084450,505834528,1,89,89,1360084423189,1360084423189,505807717,505807717,0
1360084527,505911084,1,89,89,1360084500560,1360084500560,505884644,505884644,0
1360084617,506001836,6,6144,1024,1360084614497,1360084616161,505999333,506000997,1664
1360084643,506027308,4,5608,1402,1360084618543,1360084639663,506002851,506023971,21120
1360084675,506059380,1,1402,1402,1360084649574,1360084649574,506033954,506033954,0
1360084738,506122016,3,156,52,1360084736850,1360084737618,506120866,506121634,768
1360084745,506129944,3,156,52,1360084737778,1360084744242,506122722,506129186,6464
1360084769,506153948,2,104,52,1360084752878,1360084762926,506137826,506147874,10048
1360084799,506183804,1,52,52,1360084773053,1360084773053,506157857,506157857,0
1360084817,506201984,3,156,52,1360084815368,1360084816136,506200352,506201120,768
1360084818,506202076,3,156,52,1360084816402,1360084817106,506200478,506201182,704
1360084825,506209988,3,156,52,1360084817157,1360084822981,506202145,506207969,5824
1360084826,506210040,3,156,52,1360084818169,1360084824569,506202209,506208609,6400
1360084842,506226032,2,104,52,1360084831746,1360084841730,506215778,506225762,9984
1360084849,506234000,2,104,52,1360084832121,1360084842105,506217121,506227105,9984
1360084879,506263732,1,52,52,1360084851011,1360084851011,506235743,506235743,0
1360084879,506263860,1,52,52,1360084852228,1360084852228,506237088,506237088,0
1360163056,584440380,1,46,46,1360163029483,1360163029483,584413863,584413863,0
1360163682,585066216,1,60,60,1360163656195,1360163656195,585040411,585040411,0
1360165175,586559828,1,46,46,1360165146376,1360165146376,586531204,586531204,0
1360165799,587183628,1,48,48,1360165771272,1360165771272,587155900,587155900,0
1360165833,587217620,5,374,74.8,1360165825295,1360165829583,587209915,587214203,4288
1360165841,587225620,3,168,56,1360165833296,1360165833808,587217916,587218428,512
1360165859,587243200,22,4825,219.3181818,1360165832498,1360165844274,587216698,587228474,11776
1360165871,587254864,1,64,64,1360165844610,1360165844610,587228474,587228474,0
1360165873,587257724,4,232,58,1360165863333,1360165867109,587248057,587251833,3776
1360165881,587265652,3,168,56,1360165876654,1360165876718,587261306,587261370,64
1360165889,587273680,3,168,56,1360165882129,1360165882321,587266809,587267001,192
1360165889,587273688,3,168,56,1360165881802,1360165881930,587266490,587266618,128
1360165889,587273688,4,220,55,1360165881929,1360165883785,587266617,587268473,1856
1360165891,587275008,1,485,485,1360165864179,1360165864179,587248187,587248187,0
1360165903,587286892,1,52,52,1360165875748,1360165875748,587259640,587259640,0
1360165905,587289724,2,110,55,1360165887271,1360165897319,587271995,587282043,10048
1360165911,587294916,7,2757,393.8571429,1360165884175,1360165885327,587268091,587269243,1152
1360165913,587297652,3,174,58,1360165897455,1360165907567,587282107,587292219,10112
1360165975,587358980,3,389,129.6666667,1360165947469,1360165948301,587331449,587332281,832
1360166034,587417940,3,156,52,1360166024307,1360166030515,587408247,587414455,6208
1360166050,587433960,2,104,52,1360166038751,1360166048735,587422711,587432695,9984
1360166074,587457940,2,104,52,1360166058740,1360166068724,587442680,587452664,9984
1360166103,587487304,1,52,52,1360166078406,1360166078406,587462710,587462710,0
1360166123,587507348,20,4661,233.05,1360166095513,1360166101657,587479861,587486005,6144
1360166127,587511332,1,64,64,1360166102377,1360166102377,587486709,587486709,0
1360166139,587523380,1,64,64,1360166112380,1360166112380,587496760,587496760,0
1360166151,587535352,1,52,52,1360166124884,1360166124884,587509236,587509236,0
1360166170,587554148,3,168,56,1360166168544,1360166169312,587552692,587553460,768
1360166175,587559432,3,168,56,1360166147014,1360166171078,587531446,587555510,24064
1360166179,587563356,1,64,64,1360166151443,1360166151443,587535799,587535799,0
1360166195,587579348,1,64,64,1360166169881,1360166169881,587554229,587554229,0
1360166195,587579388,19,4062,213.7894737,1360166169264,1360166173296,587553652,587557684,4032
1360166215,587599476,1,46,46,1360166187736,1360166187736,587572212,587572212,0
1360166283,587667600,3,757,252.3333333,1360166255707,1360166256219,587640307,587640819,512
1360166287,587671608,1,46,46,1360166259603,1360166259603,587644211,587644211,0
1360166306,587690232,14,3324,237.4285714,1360166297739,1360166298443,587681971,587682675,704
1360166323,587707660,9,3463,384.7777778,1360166295521,1360166296737,587680181,587681397,1216
1360166323,587707752,7,3438,491.1428571,1360166295620,1360166296900,587680372,587681652,1280
1360166343,587727736,1,433,433,1360166317461,1360166317461,587702197,587702197,0
1360166400,587784004,1,52,52,1360166374445,1360166374445,587758449,587758449,0
1360166418,587802412,2,131,65.5,1360166416854,1360166416854,587801266,587801266,0
1360166504,587888008,1,188,188,1360166476137,1360166476137,587860145,587860145,0
1360166504,587888132,15,5598,373.2,1360166478253,1360166481133,587862385,587865265,2880
1360166564,587948248,1,52,52,1360166537401,1360166537401,587921649,587921649,0
1360166608,587992208,4,754,188.5,1360166581278,1360166581918,587965486,587966126,640
1360166648,588032296,3,769,256.3333333,1360166620231,1360166620743,588004527,588005039,512
1360166684,588068244,2,238,119,1360166655929,1360166656313,588040173,588040557,384
1360166684,588068276,3,567,189,1360166656602,1360166656794,588040878,588041070,192
1360166732,588116292,2,339,169.5,1360166707339,1360166707339,588091631,588091631,0
1360166788,588172448,2,96,48,1360166761965,1360166764973,588146413,588149421,3008
1360166800,588184472,4,511,127.75,1360166775508,1360166785748,588159980,588170220,10240
1360166812,588196480,7,2757,393.8571429,1360166785931,1360166787211,588170411,588171691,1280
1360166891,588275160,16,7534,470.875,1360166884684,1360166886284,588268844,588270444,1600
1360166891,588275252,3,138,46,1360166884271,1360166884271,588268523,588268523,0
1360166909,588292744,8,3139,392.375,1360166883370,1360166884586,588267114,588268330,1216
1360166909,588292792,1,591,591,1360166882108,1360166882108,588265900,588265900,0
1360166909,588292804,8,2871,358.875,1360166883311,1360166884399,588267115,588268203,1088
1360166913,588296844,9,3463,384.7777778,1360166886982,1360166888070,588270826,588271914,1088
1360166925,588308784,1,52,52,1360166897280,1360166897280,588281064,588281064,0
1360166939,588323308,9,4318,479.7777778,1360166934644,1360166936756,588318952,588321064,2112
1360166939,588323392,16,6938,433.625,1360166934564,1360166935588,588318956,588319980,1024
1360166939,588323392,27,7121,263.7407407,1360166934754,1360166937826,588319146,588322218,3072
1360166945,588328936,1,52,52,1360166920170,1360166920170,588304106,588304106,0
1360166947,588331332,13,2115,162.6923077,1360166946207,1360166946655,588330539,588330987,448
1360166953,588336892,2,337,168.5,1360166926741,1360166926741,588310633,588310633,0
1360166955,588339292,20,3990,199.5,1360166947397,1360166948357,588331689,588332649,960
1360166955,588339328,101,11089,109.7920792,1360166937952,1360166947296,588322280,588331624,9344
1360166955,588339340,12,3173,264.4166667,1360166946453,1360166947093,588330793,588331433,640
1360166955,588339360,21,5483,261.0952381,1360166947072,1360166948224,588331432,588332584,1152
1360166955,588339424,12,3174,264.5,1360166946626,1360166947266,588331050,588331690,640
1360166961,588344812,6,2350,391.6666667,1360166934949,1360166936101,588318761,588319913,1152
1360166961,588344840,12,3935,327.9166667,1360166935114,1360166946250,588318954,588330090,11136
1360166961,588344924,11,4552,413.8181818,1360166935925,1360166937013,588319849,588320937,1088
1360166963,3521626952,14,13095,935.3571429,1360166935314,1360166936402,3521599266,3521600354,1088
1360166963,3521626952,19,22150,1165.789474,1360166935314,1360166935698,3521599266,3521599650,384
1360166963,3521626952,9,5676,630.6666667,1360166935314,1360166935634,3521599266,3521599586,320
1360166963,3521626952,38,47900,1260.526316,1360166935314,1360166936402,3521599266,3521600354,1088
1360166964,3521626988,6,2240,373.3333333,1360166936278,1360166936598,3521599266,3521599586,320
1360166964,3521626988,5,2196,439.2,1360166936342,1360166936598,3521599330,3521599586,256
1360166965,588348812,42,5775,137.5,1360166937320,1360166959208,588321132,588343020,21888
1360166965,588348856,7,3080,440,1360166938873,1360166939129,588322729,588322985,256
1360166965,588348880,9,7220,802.2222222,1360166936931,1360166937059,588320811,588320939,128
1360166972,3521635004,3,704,234.6666667,1360166946951,1360166947015,3521609955,3521610019,64
1360166973,588356816,17,13450,791.1764706,1360166947553,1360166947937,588331369,588331753,384
1360166973,588356820,24,23776,990.6666667,1360166947806,1360166948958,588331626,588332778,1152
1360166973,588356856,14,3093,220.9285714,1360166945784,1360166948664,588329640,588332520,2880
1360167011,588395332,5,334,66.8,1360167006367,1360167008607,588390699,588392939,2240
1360167013,588396844,2,243,121.5,1360166987779,1360166994371,588371623,588378215,6592
1360167013,588396896,13,9114,701.0769231,1360166988819,1360166990675,588372715,588374571,1856
1360167019,588403292,3,202,67.33333333,1360167011395,1360167011651,588395687,588395943,256
1360167019,588403412,2,127,63.5,1360167018316,1360167018316,588402728,588402728,0
1360167037,588421180,55,4433,80.6,1360167012341,1360167014773,588396521,588398953,2432
1360167037,588421264,26,4290,165,1360167012320,1360167016224,588396584,588400488,3904
1360167041,588425164,2,104,52,1360167016835,1360167016899,588400999,588401063,64
1360167045,588429168,4,460,115,1360167017344,1360167017920,588401512,588402088,576
1360167067,588451292,2,131,65.5,1360167065795,1360167065795,588450087,588450087,0
1360167083,588467384,3,183,61,1360167078567,1360167079015,588462951,588463399,448
1360167105,588489468,3,737,245.6666667,1360167078866,1360167079250,588463334,588463718,384
1360167121,588505288,1,238,238,1360167096393,1360167096393,588480681,588480681,0
1360167121,588505288,1,52,52,1360167096710,1360167096710,588480998,588480998,0
1360167153,588537308,2,339,169.5,1360167128179,1360167128179,588512487,588512487,0
1360167193,588577432,2,243,121.5,1360167167223,1360167180407,588551655,588564839,13184
1360167193,588577436,4,649,162.25,1360167167922,1360167168434,588552358,588552870,512
1360167201,588585444,1,52,52,1360167176555,1360167176555,588560999,588560999,0
1360167251,588635720,3,138,46,1360167250324,1360167250324,588635044,588635044,0
1360167273,588657432,4,510,127.5,1360167246389,1360167247349,588630821,588631781,960
1360167277,588661556,2,374,187,1360167249719,1360167249911,588634275,588634467,192
1360167277,588661572,17,7230,425.2941176,1360167250730,1360167254378,588635302,588638950,3648
1360167281,588665440,1,52,52,1360167254507,1360167254507,588638947,588638947,0
1360167281,588665476,1,52,52,1360167256008,1360167256008,588640484,588640484,0
1360167325,588709604,2,188,94,1360167297799,1360167297799,588682403,588682403,0
1360167357,588741672,7,1369,195.5714286,1360167332613,1360167334213,588717285,588718885,1600
1360167361,588745616,2,238,119,1360167333180,1360167341372,588717796,588725988,8192
1360167421,588805588,1,235,235,1360167396056,1360167396056,588780644,588780644,0
1360167433,588817704,1,52,52,1360167407778,1360167407778,588792482,588792482,0
1360167436,3522099768,3,230,76.66666667,1360167435918,1360167436174,3522099686,3522099942,256
1360167439,3522102408,3,230,76.66666667,1360167436277,1360167436533,3522099685,3522099941,256
1360167439,3522102416,3,230,76.66666667,1360167436140,1360167436396,3522099556,3522099812,256
1360167439,3522102420,3,230,76.66666667,1360167436905,1360167437161,3522100325,3522100581,256
1360167439,3522102420,3,230,76.66666667,1360167436969,1360167437161,3522100389,3522100581,192
1360167439,3522102436,3,230,76.66666667,1360167436123,1360167436379,3522099559,3522099815,256
1360167472,3522135820,1,52,52,1360167446171,1360167446171,3522109991,3522109991,0
1360167496,3522159764,3,156,52,1360167468369,1360167475217,3522132133,3522138981,6848
1360167496,3522159764,3,156,52,1360167468433,1360167475217,3522132197,3522138981,6784
1360167496,3522159764,2,104,52,1360167468560,1360167475216,3522132324,3522138980,6656
1360167496,3522159768,2,104,52,1360167468623,1360167475535,3522132391,3522139303,6912
1360167496,3522159816,3,156,52,1360167468383,1360167475167,3522132199,3522138983,6784
1360167496,3522159820,4,208,52,1360167468379,1360167474843,3522132199,3522138663,6464
1360167534,588917956,1,60,60,1360167508302,1360167508302,588892258,588892258,0
1360167556,588940224,7,553,79,1360167546177,1360167552001,588930401,588936225,5824
1360167602,588986056,1,52,52,1360167574823,1360167574823,588958879,588958879,0
1360167831,589214964,2,339,169.5,1360167803839,1360167803839,589187803,589187803,0
1360167854,589238720,9,3463,384.7777778,1360167828045,1360167829069,589212765,589213789,1024
1360167876,589260096,4,184,46,1360167870778,1360167870778,589254874,589254874,0
1360167895,589278860,3,389,129.6666667,1360167870630,1360167879014,589254490,589262874,8384
1360167899,589282748,7,2757,393.8571429,1360167871129,1360167871513,589254877,589255261,384
1360167956,589340244,2,131,65.5,1360167949476,1360167949476,589333720,589333720,0
1360167959,589342872,2,116,58,1360167934618,1360167935066,589318490,589318938,448
1360168116,589500456,2,104,52,1360168110798,1360168111054,589495254,589495510,256
1360168300,589684684,7,1569,224.1428571,1360168293095,1360168294503,589677779,589679187,1408
1360168319,589703404,1,742,742,1360168291842,1360168291842,589676246,589676246,0
1360168340,589724624,10,4433,443.3,1360168332261,1360168332965,589716885,589717589,704
1360168351,589735676,1,46,46,1360168326897,1360168326897,589711573,589711573,0
1360168351,589735724,4,1736,434,1360168326016,1360168346688,589710740,589731412,20672
1360168351,589735728,1,46,46,1360168326460,1360168326460,589711188,589711188,0
1360168359,589743732,30,16903,563.4333333,1360168332152,1360168341368,589716884,589726100,9216
1360168359,589743740,19,13405,705.5263158,1360168332719,1360168334191,589717459,589718931,1472
1360168360,589743816,27,7879,291.8148148,1360168333069,1360168353933,589716885,589737749,20864
1360168360,589743820,68,92563,1361.220588,1360168333511,1360168333767,589717331,589717587,256
1360168380,589764696,9,4387,487.4444444,1360168373979,1360168375963,589758675,589760659,1984
1360168387,589771796,6,396,66,1360168362358,1360168382646,589747154,589767442,20288
1360168396,589780792,2,104,52,1360168392698,1360168392954,589777490,589777746,256
1360168403,589787756,1,52,52,1360168375328,1360168375328,589760084,589760084,0
1360168405,589788852,3,202,67.33333333,1360168394663,1360168399655,589778515,589783507,4992
1360168413,589796808,2,127,63.5,1360168401299,1360168406291,589785107,589790099,4992
1360168420,589803848,6,396,66,1360168393322,1360168413802,589777170,589797650,20480
1360168448,589831856,6,398,66.33333333,1360168423331,1360168443747,589807187,589827603,20416
1360168460,589843852,1,46,46,1360168435112,1360168435112,589818964,589818964,0
1360168477,589860828,3,138,46,1360168472381,1360168472381,589856209,589856209,0
1360168477,589860864,10,4433,443.3,1360168470363,1360168472603,589854227,589856467,2240
1360168477,589860864,3,138,46,1360168470490,1360168470490,589854354,589854354,0
1360168477,589860864,9,4147,460.7777778,1360168470745,1360168470937,589854609,589854801,192
1360168477,589860900,9,576,64,1360168453303,1360168469495,589837203,589853395,16192
1360168477,589860912,9,4147,460.7777778,1360168470697,1360168470889,589854609,589854801,192
1360168477,589860944,21,20251,964.3333333,1360168470923,1360168476043,589854867,589859987,5120
1360168492,589875972,2,188,94,1360168467438,1360168467438,589851410,589851410,0
1360168496,589879884,21,3041,144.8095238,1360168470341,1360168490565,589854225,589874449,20224
1360168496,589879892,15,11733,782.2,1360168470974,1360168471230,589854866,589855122,256
1360168496,589879892,14,13383,955.9285714,1360168470974,1360168471230,589854866,589855122,256
1360168496,589879972,40,24106,602.65,1360168470446,1360168494702,589854418,589878674,24256
1360168496,589879972,12,11335,944.5833333,1360168470573,1360168470829,589854545,589854801,256
1360168496,589879976,15,15685,1045.666667,1360168470890,1360168471082,589854866,589855058,192
1360168500,589883936,26,18324,704.7692308,1360168472273,1360168486353,589856209,589870289,14080
1360168500,589883940,1,46,46,1360168472526,1360168472526,589856466,589856466,0
1360168508,589891948,1,52,52,1360168481223,1360168481223,589865171,589865171,0
1360168509,589892980,9,4387,487.4444444,1360168504101,1360168505125,589888081,589889105,1024
1360168524,589907908,11,10362,942,1360168499691,1360168503019,589883599,589886927,3328
1360168528,589911960,9,6391,710.1111111,1360168501369,1360168501817,589885329,589885777,448
1360168528,589911964,8,540,67.5,1360168500405,1360168520629,589884369,589904593,20224
1360168532,589915904,5,250,50,1360168506928,1360168527984,589890832,589911888,21056
1360168541,589924908,4,282,70.5,1360168531179,1360168536363,589915087,589920271,5184
1360168541,589924912,4,282,70.5,1360168531179,1360168536491,589915091,589920403,5312
1360168541,589924972,3,193,64.33333333,1360168530093,1360168535341,589914065,589919313,5248
1360168548,589931876,1,52,52,1360168521742,1360168521742,589905618,589905618,0
1360168556,589940016,6,396,66,1360168530368,1360168550528,589914384,589934544,20160
1360168573,589957016,2,127,63.5,1360168561089,1360168566081,589945105,589950097,4992
1360168573,589957056,2,127,63.5,1360168562202,1360168567194,589946258,589951250,4992
1360168588,589971940,7,462,66,1360168560460,1360168580492,589944400,589964432,20032
1360168588,589971948,2,104,52,1360168561028,1360168561284,589944976,589945232,256
1360168588,589972032,2,104,52,1360168560943,1360168561199,589944975,589945231,256
1360168588,589972036,2,104,52,1360168560942,1360168561198,589944978,589945234,256
1360168604,589988128,2,188,94,1360168579280,1360168579280,589963408,589963408,0
1360168608,589992004,1,46,46,1360168581838,1360168581838,589965842,589965842,0
1360168616,590000088,10,663,66.3,1360168590327,1360168614391,589974415,589998479,24064
1360168656,590040100,1,52,52,1360168629354,1360168629354,590013454,590013454,0
1360168677,590061004,6,276,46,1360168672972,1360168672972,590056976,590056976,0
1360168677,590061008,15,3758,250.5333333,1360168673222,1360168674502,590057230,590058510,1280
1360168677,590061036,4,184,46,1360168674921,1360168674921,590058957,590058957,0
1360168677,590061200,3,138,46,1360168674759,1360168674759,590058959,590058959,0
1360168677,590061200,18,4468,248.2222222,1360168674759,1360168676167,590058959,590060367,1408
1360168685,590069044,13,3583,275.6153846,1360168675171,1360168676899,590059215,590060943,1728
1360168685,590069044,13,3571,274.6923077,1360168676897,1360168678305,590060941,590062349,1408
1360168685,590069124,13,3571,274.6923077,1360168675089,1360168677201,590059213,590061325,2112
1360168704,590088116,10,4889,488.9,1360168676697,1360168677593,590060813,590061709,896
1360168805,590189064,2,131,65.5,1360168797517,1360168797517,590181581,590181581,0
1360169021,590405600,1,46,46,1360168992304,1360168992304,590376904,590376904,0
1360169358,590741864,1,58,58,1360169331786,1360169331786,590715650,590715650,0
1360169390,590774000,1,48,48,1360169364546,1360169364546,590748546,590748546,0
1360169510,590894504,8,591,73.875,1360169483849,1360169500041,590868353,590884545,16192
1360169538,590922456,1,77,77,1360169510136,1360169510136,590894592,590894592,0
1360169558,590942336,4,208,52,1360169551409,1360169555249,590935745,590939585,3840
1360169574,590958244,2,104,52,1360169559822,1360169568654,590944066,590952898,8832
1360169590,590974304,2,104,52,1360169578578,1360169588626,590962882,590972930,10048
1360169606,590990264,3,168,56,1360169602999,1360169603703,590987263,590987967,704
1360169606,590990296,3,168,56,1360169600600,1360169601304,590984896,590985600,704
1360169606,590990304,3,168,56,1360169602063,1360169602703,590986367,590987007,640
1360169614,590998628,2,104,52,1360169598284,1360169608268,590982912,590992896,9984
1360169627,591010848,1,46,46,1360169602072,1360169602072,590985920,590985920,0
1360169631,591014844,18,4010,222.7777778,1360169603547,1360169606235,590987391,590990079,2688
1360169631,591014960,1,64,64,1360169604327,1360169604327,590988287,590988287,0
1360169646,591030272,3,168,56,1360169638000,1360169638576,591022272,591022848,576
1360169646,591030276,5,284,56.8,1360169638890,1360169643370,591023166,591027646,4480
1360169646,591030364,3,168,56,1360169643668,1360169644244,591028032,591028608,576
1360169663,591047000,1,46,46,1360169638014,1360169638014,591022014,591022014,0
1360169718,591102348,7,1563,223.2857143,1360169711201,1360169712737,591095549,591097085,1536
1360169735,591118932,1,631,631,1360169710339,1360169710339,591094271,591094271,0
1360169758,591142336,2,116,58,1360169756909,1360169757805,591141245,591142141,896
1360169774,591158324,3,168,56,1360169767993,1360169768185,591152317,591152509,192
1360169774,591158392,3,168,56,1360169766711,1360169767351,591151103,591151743,640
1360169774,591158428,3,156,52,1360169760594,1360169766354,591145022,591150782,5760
1360169774,591158432,3,168,56,1360169768718,1360169769422,591153150,591153854,704
1360169791,591175184,1,52,52,1360169766276,1360169766276,591150460,591150460,0
1360169791,591175308,19,4065,213.9473684,1360169763847,1360169768007,591148155,591152315,4160
1360169823,591207196,9,3463,384.7777778,1360169798010,1360169799226,591182206,591183422,1216
1360169831,591215364,8,3390,423.75,1360169805327,1360169806927,591189691,591191291,1600
1360169902,591286400,18,3997,222.0555556,1360169899245,1360169900205,591283645,591284605,960
1360169902,591286412,15,3600,240,1360169900320,1360169900640,591284732,591285052,320
1360169902,591286416,17,6243,367.2352941,1360169900637,1360169901533,591285053,591285949,896
1360169902,591286524,14,3324,237.4285714,1360169898545,1360169898993,591283069,591283517,448
1360169902,591286524,19,3584,188.6315789,1360169898736,1360169899056,591283260,591283580,320
1360169903,591287664,3,735,245,1360169875107,1360169875363,591259771,591260027,256
1360169910,591294400,17,4109,241.7058824,1360169903274,1360169904106,591287674,591288506,832
1360169910,591294412,15,3314,220.9333333,1360169902816,1360169903200,591287228,591287612,384
1360169910,591294448,13,6786,522,1360169901691,1360169901947,591286139,591286395,256
1360169910,591294456,17,3369,198.1764706,1360169906677,1360169906997,591291133,591291453,320
1360169910,591294476,15,3409,227.2666667,1360169901984,1360169902304,591286460,591286780,320
1360169910,591294492,58,62628,1079.793103,1360169904081,1360169906193,591288573,591290685,2112
1360169910,591294492,7,1569,224.1428571,1360169904080,1360169904784,591288572,591289276,704
1360169910,591294516,10,4433,443.3,1360169904504,1360169905080,591289020,591289596,576
1360169910,591294528,29,4364,150.4827586,1360169901738,1360169902186,591286266,591286714,448
1360169910,591294532,18,5033,279.6111111,1360169906152,1360169906536,591290684,591291068,384
1360169923,591307612,9,4004,444.8888889,1360169897623,1360169898455,591282235,591283067,832
1360169926,591310488,2,131,65.5,1360169918803,1360169918803,591303291,591303291,0
1360169931,591315640,33,27651,837.9090909,1360169904507,1360169907643,591289147,591292283,3136
1360169931,591315648,26,22566,867.9230769,1360169904948,1360169906804,591289596,591291452,1856
1360169932,591315732,20,5660,283,1360169905289,1360169926153,591289021,591309885,20864
1360169942,591326500,9,4387,487.4444444,1360169935877,1360169937093,591320377,591321593,1216
1360169959,591343708,6,396,66,1360169934648,1360169954872,591319356,591339580,20224
1360169968,591351760,1,52,52,1360169940841,1360169940841,591324601,591324601,0
1360169974,591358456,4,254,63.5,1360169966513,1360169971761,591350969,591356217,5248
1360169974,591358524,4,254,63.5,1360169967472,1360169972720,591351996,591357244,5248
1360169992,591375804,6,396,66,1360169965565,1360169985981,591349369,591369785,20416
1360170024,591407992,6,398,66.33333333,1360169995649,1360170015873,591379641,591399865,20224
1360170046,591430576,9,611,67.88888889,1360170025144,1360170045240,591409720,591429816,20096
1360170072,591455872,1,52,52,1360170047416,1360170047416,591431288,591431288,0
1360170118,591502636,3,156,52,1360170113852,1360170116156,591498488,591500792,2304
1360170126,591510596,2,104,52,1360170119331,1360170125603,591503927,591510199,6272
1360170142,591526672,5,260,52,1360170138392,1360170141848,591523064,591526520,3456
1360170150,591534644,2,104,52,1360170135538,1360170145522,591520182,591530166,9984
1360170166,591550696,2,104,52,1360170155521,1360170165505,591540217,591550201,9984
1360170866,592250480,3,180,60,1360170839499,1360170842507,592223979,592226987,3008
1360172723,594107588,1,48,48,1360172696579,1360172696579,594081167,594081167,0
1360172724,594107896,1,48,48,1360172697077,1360172697077,594080973,594080973,0
1360173185,594568856,11,4583,416.6363636,1360173180501,1360173181077,594564357,594564933,576
1360173185,594568860,19,6896,362.9473684,1360173181204,1360173183188,594565064,594567048,1984
1360173185,594568972,12,6856,571.3333333,1360173178916,1360173179428,594562888,594563400,512
1360173204,594588284,7,2992,427.4285714,1360173176105,1360173176361,594560389,594560645,256
1360173204,594588296,19,4202,221.1578947,1360173176349,1360173188061,594560645,594572357,11712
1360173204,594588332,3,304,101.3333333,1360173178490,1360173178490,594562822,594562822,0
1360173204,594588340,4,1550,387.5,1360173179185,1360173179633,594563525,594563973,448
1360173204,594588344,2,224,112,1360173179697,1360173179697,594564041,594564041,0
1360173204,594588344,3,336,112,1360173179697,1360173179761,594564041,594564105,64
1360173204,594588364,1,112,112,1360173179612,1360173179612,594563976,594563976,0
1360173204,594588364,6,672,112,1360173179676,1360173179740,594564040,594564104,64
1360173204,594588420,10,6772,677.2,1360173179044,1360173179556,594563464,594563976,512
1360173208,594592336,18,6813,378.5,1360173182902,1360173184566,594567238,594568902,1664
1360173208,594592372,11,5857,532.4545455,1360173180562,1360173182482,594564934,594566854,1920
1360173249,594633032,4,254,63.5,1360173239461,1360173244709,594623493,594628741,5248
1360173417,594801296,2,104,52,1360173416348,1360173416604,594800644,594800900,256
1360173425,594809328,2,104,52,1360173418494,1360173418750,594802822,594803078,256
1360173593,594977532,5,1021,204.2,1360173586347,1360173589355,594970879,594973887,3008
1360173593,594977580,5,562,112.4,1360173592187,1360173592251,594976767,594976831,64
1360173601,594985616,30,37054,1235.133333,1360173590552,1360173596696,594975168,594981312,6144
1360173601,594985652,85,117065,1377.235294,1360173592245,1360173598069,594976897,594982721,5824
1360173609,594993540,32,40764,1273.875,1360173589734,1360173604646,594974274,594989186,14912
1360173614,594997744,14,17050,1217.857143,1360173585986,1360173586306,594969730,594970050,320
1360173617,3528280384,20,24947,1247.35,1360173590836,1360173590964,3528254220,3528254348,128
1360173618,595001808,17,19584,1152,1360173592768,1360173592896,594976576,594976704,128
1360173618,595001844,18,22696,1260.888889,1360173590107,1360173590235,594973951,594974079,128
1360173618,595001892,3,572,190.6666667,1360173592557,1360173592557,594976449,594976449,0
1360173621,3528284444,25,32845,1313.8,1360173593019,1360173593403,3528256463,3528256847,384
1360173622,595005720,15,20020,1334.666667,1360173595544,1360173602968,594979264,594986688,7424
1360173649,595033552,3,1408,469.3333333,1360173643994,1360173644122,595028546,595028674,128
1360173654,595037732,16,22816,1426,1360173628620,1360173629388,595012352,595013120,768
1360173665,595049512,2,104,52,1360173656958,1360173657214,595041470,595041726,256
1360173686,595069760,1,46,46,1360173659055,1360173659055,595042815,595042815,0
1360173686,595069828,1,52,52,1360173657837,1360173657837,595041665,595041665,0
1360173689,595073540,13,3571,274.6923077,1360173686689,1360173687393,595071229,595071933,704
1360173689,595073560,18,4468,248.2222222,1360173686737,1360173687569,595071297,595072129,832
1360173689,595073640,13,3571,274.6923077,1360173686592,1360173687296,595071232,595071936,704
1360173689,595073656,18,4867,270.3888889,1360173684847,1360173686255,595069503,595070911,1408
1360173730,595114080,1,52,52,1360173705647,1360173705647,595089727,595089727,0
1360173746,595130100,1,1426,1426,1360173720921,1360173720921,595105021,595105021,0
1360173750,595134128,1,52,52,1360173722046,1360173722046,595106174,595106174,0
1360173770,595154104,1,52,52,1360173743320,1360173743320,595127424,595127424,0
1360173782,595166068,5,2301,460.2,1360173754746,1360173777850,595138814,595161918,23104
1360173782,595166108,15,6137,409.1333333,1360173756881,1360173781777,595140989,595165885,24896
1360173785,3528448152,4,633,158.25,1360173781281,1360173781793,3528444433,3528444945,512
1360173818,595202180,2,122,61,1360173793161,1360173795273,595177341,595179453,2112
1360173825,595209624,8,1494,186.75,1360173817039,1360173817551,595201663,595202175,512
1360173826,595209756,11,5028,457.0909091,1360173817520,1360173817904,595201276,595201660,384
1360173826,595210092,9,4004,444.8888889,1360173798562,1360173798818,595182654,595182910,256
1360173830,595214180,7,1917,273.8571429,1360173803018,1360173806474,595187198,595190654,3456
1360173834,595217712,4,184,46,1360173831262,1360173831262,595214974,595214974,0
1360173834,595218168,1,198,198,1360173806933,1360173806933,595191101,595191101,0
1360173858,595242212,1,52,52,1360173829864,1360173829864,595214076,595214076,0
1360173858,595242228,7,2992,427.4285714,1360173830746,1360173831002,595214974,595215230,256
1360173874,595257716,5,651,130.2,1360173866266,1360173866906,595249982,595250622,640
1360173874,595258424,15,20777,1385.133333,1360173847252,1360173850132,595231676,595234556,2880
1360173874,595258504,3,430,143.3333333,1360173847301,1360173863877,595231805,595248381,16576
1360175155,596539112,3,168,56,1360175151993,1360175152121,596536105,596536233,128
1360175155,596539192,3,168,56,1360175148711,1360175148775,596532903,596532967,64
1360175177,596561492,17,5084,299.0588235,1360175150779,1360175171195,596535271,596555687,20416
1360175177,596561580,22,5307,241.2272727,1360175150691,1360175158371,596535271,596542951,7680
1360175181,596565472,12,4726,393.8333333,1360175153679,1360175155855,596538151,596540327,2176
1360175203,596587180,13,2067,159,1360175181556,1360175199028,596565736,596583208,17472
1360175209,596593684,1,679,679,1360175183546,1360175183546,596568230,596568230,0
1360175262,596645736,5,572,114.4,1360175235437,1360175236013,596619173,596619749,576
1360175299,596683328,4,220,55,1360175293279,1360175295007,596677607,596679335,1728
1360175307,596691336,3,156,52,1360175300886,1360175302230,596685222,596686566,1344
1360175307,596691356,4,232,58,1360175296193,1360175300161,596680549,596684517,3968
1360175307,596691416,3,168,56,1360175300356,1360175301764,596684772,596686180,1408
1360175318,596701976,18,5651,313.9444444,1360175293822,1360175311998,596677798,596695974,18176
1360175334,596718000,1,52,52,1360175307684,1360175307684,596691684,596691684,0
1360175346,596730176,3,558,186,1360175321654,1360175341686,596705830,596725862,20032
1360175378,596762048,3,558,186,1360175351798,1360175371766,596735846,596755814,19968
1360175387,596771292,3,168,56,1360175385663,1360175386367,596769955,596770659,704
1360175395,596779280,4,271,67.75,1360175387147,1360175387723,596771427,596772003,576
1360175395,596779316,3,168,56,1360175391081,1360175394409,596775397,596778725,3328
1360175403,596787304,5,296,59.2,1360175395635,1360175401139,596779939,596785443,5504
1360175403,596787696,5,260,52,1360175395629,1360175399405,596780325,596784101,3776
1360175410,596794236,17,6389,375.8235294,1360175383224,1360175390136,596767460,596774372,6912
1360175414,596798092,24,4996,208.1666667,1360175386632,1360175402056,596770724,596786148,15424
1360175414,596798184,1,46,46,1360175386666,1360175386666,596770850,596770850,0
1360175434,596818148,9,3463,384.7777778,1360175409041,1360175410321,596793189,596794469,1280
1360175462,596846148,10,4669,466.9,1360175435793,1360175460561,596819941,596844709,24768
1360175467,596851312,3,168,56,1360175462507,1360175462635,596846819,596846947,128
1360175467,596851384,3,168,56,1360175462178,1360175462306,596846562,596846690,128
1360175467,596851388,4,271,67.75,1360175462304,1360175462368,596846692,596846756,64
1360175478,596862420,3,730,243.3333333,1360175450239,1360175450559,596834659,596834979,320
1360175515,596899328,3,168,56,1360175507737,1360175507865,596892065,596892193,128
1360175515,596899416,3,168,56,1360175507779,1360175507907,596892195,596892323,128
1360175534,596918476,2,131,65.5,1360175529861,1360175529861,596914337,596914337,0
1360175538,596922540,1,60,60,1360175513606,1360175513606,596898146,596898146,0
1360175546,596930468,5,1222,244.4,1360175517965,1360175520013,596902433,596904481,2048
1360175546,596930476,5,928,185.6,1360175518405,1360175545733,596902881,596930209,27328
1360175579,596963524,8,1609,201.125,1360175577107,1360175577811,596961631,596962335,704
1360175579,596963524,8,1615,201.875,1360175577110,1360175577814,596961634,596962338,704
1360175579,596963524,10,4433,443.3,1360175577557,1360175578389,596962081,596962913,832
1360175602,596986684,9,4456,495.1111111,1360175577653,1360175578101,596962337,596962785,448
1360175602,596986684,23,6194,269.3043478,1360175577589,1360175598261,596962273,596982945,20672
1360175603,596987664,9,4387,487.4444444,1360175600456,1360175601864,596985120,596986528,1408
1360175606,596990524,27,19840,734.8148148,1360175579414,1360175603478,596963938,596988002,24064
1360175606,596990604,41,34056,830.6341463,1360175577924,1360175600132,596962528,596984736,22208
1360175634,597018652,7,476,68,1360175608021,1360175628117,596992673,597012769,20096
1360175643,597027552,2,127,63.5,1360175637369,1360175642425,597021921,597026977,5056
1360175646,597030528,3,389,129.6666667,1360175618383,1360175633615,597002911,597018143,15232
1360175666,597050632,6,396,66,1360175638056,1360175658920,597022688,597043552,20864
1360175668,597051716,2,127,63.5,1360175660219,1360175665211,597043935,597048927,4992
1360175675,597059444,2,127,63.5,1360175662628,1360175667620,597047072,597052064,4992
1360175695,597078728,6,398,66.33333333,1360175669678,1360175690094,597053406,597073822,20416
1360175702,597086672,3,389,129.6666667,1360175675073,1360175675841,597059745,597060513,768
1360175715,597099616,8,530,66.25,1360175698808,1360175709304,597083424,597093920,10496
1360175787,597170788,1,52,52,1360175760691,1360175760691,597144479,597144479,0
1360175919,597302992,20,4126,206.3,1360175894117,1360175897509,597278109,597281501,3392
1360175919,597303084,1,64,64,1360175894087,1360175894087,597278171,597278171,0
1360175923,597307032,1,52,52,1360175895677,1360175895677,597279709,597279709,0
1360175939,597323524,3,168,56,1360175934801,1360175934993,597319325,597319517,192
1360175939,597323596,3,168,56,1360175934599,1360175934727,597319195,597319323,128
1360175963,597347056,1,46,46,1360175935202,1360175935202,597319258,597319258,0
1360175971,597355556,3,168,56,1360175967021,1360175967085,597351577,597351641,64
1360175971,597355640,3,168,56,1360175966811,1360175966939,597351451,597351579,128
1360175991,597375272,7,2757,393.8571429,1360175965644,1360175965836,597349916,597350108,192
1360175995,597379356,2,110,55,1360175967351,1360175988343,597351707,597372699,20992
1360176011,597395456,1,483,483,1360175986196,1360175986196,597370652,597370652,0
1360176012,597395724,3,168,56,1360176009198,1360176009326,597392922,597393050,128
1360176012,597395812,3,168,56,1360176009430,1360176009558,597393242,597393370,128
1360176012,597395816,2,110,55,1360175999060,1360176009108,597382876,597392924,10048
1360176031,597415376,9,3475,386.1111111,1360176004770,1360176005090,597389146,597389466,320
1360176035,597419392,1,46,46,1360176008978,1360176008978,597393370,597393370,0
1360176115,597499504,5,726,145.2,1360176090656,1360176113120,597475160,597497624,22464
1360176132,597516084,2,131,65.5,1360176125316,1360176125316,597509400,597509400,0
1360176144,597527768,1,186,186,1360176119233,1360176119233,597503001,597503001,0
1360176147,597531684,12,5198,433.1666667,1360176120108,1360176121580,597504792,597506264,1472
1360176204,597587764,3,389,129.6666667,1360176178564,1360176179332,597562328,597563096,768
1360176204,597588060,3,168,56,1360176203418,1360176203546,597587478,597587606,128
1360176204,597588064,3,168,56,1360176203544,1360176203736,597587608,597587800,192
1360176204,597588148,42,4780,113.8095238,1360176202305,1360176203265,597586453,597587413,960
1360176204,597588152,3,168,56,1360176203199,1360176203391,597587351,597587543,192
1360176208,597591740,4,814,203.5,1360176181277,1360176181725,597565017,597565465,448
1360176228,597611788,7,3438,491.1428571,1360176202026,1360176202346,597585814,597586134,320
1360176228,597612056,3,168,56,1360176224863,1360176224991,597608919,597609047,128
1360176228,597612056,3,168,56,1360176224926,1360176225054,597608982,597609110,128
1360176228,597612060,3,168,56,1360176225052,1360176225244,597609112,597609304,192
1360176232,597615816,1,52,52,1360176205648,1360176205648,597589464,597589464,0
1360176232,597615896,21,4727,225.0952381,1360176205245,1360176213245,597589141,597597141,8000
1360176232,597615904,9,3521,391.2222222,1360176206005,1360176206325,597589909,597590229,320
1360176232,597615932,1,52,52,1360176206172,1360176206172,597590104,597590104,0
1360176236,597620052,3,168,56,1360176228385,1360176228449,597612437,597612501,64
1360176236,597620132,3,168,56,1360176228180,1360176228244,597612312,597612376,64
1360176236,597620136,3,168,56,1360176228432,1360176228560,597612568,597612696,128
1360176256,597639884,1,46,46,1360176228812,1360176228812,597612696,597612696,0
1360176316,597699904,1,52,52,1360176290166,1360176290166,597674070,597674070,0
1360176416,597799968,2,337,168.5,1360176388019,1360176388019,597771987,597771987,0
1360176448,597832072,1,52,52,1360176421260,1360176421260,597805332,597805332,0
1360176468,597852196,1,52,52,1360176442000,1360176442000,597826196,597826196,0
1360176472,597856196,1,52,52,1360176445965,1360176445965,597830161,597830161,0
1360176484,597868120,1,285,285,1360176458523,1360176458523,597842643,597842643,0
1360176496,597880128,1,60,60,1360176469331,1360176469331,597853459,597853459,0
1360176524,597908304,2,104,52,1360176498403,1360176518371,597882707,597902675,19968
1360176524,597908532,3,168,56,1360176516732,1360176517628,597901264,597902160,896
1360176544,597928312,19,4066,214,1360176516889,1360176519833,597901201,597904145,2944
1360176620,598004316,20,4138,206.9,1360176593877,1360176597461,597978193,597981777,3584
1360176620,598004356,1,52,52,1360176595629,1360176595629,597979985,597979985,0
1360176720,598104676,23,5478,238.173913,1360176693289,1360176700073,598077965,598084749,6784
1360176721,598104756,1,52,52,1360176696580,1360176696580,598080336,598080336,0
1360176741,598125044,20,4599,229.95,1360176736866,1360176739170,598120910,598123214,2304
1360176741,598125044,15,3702,246.8,1360176736866,1360176739234,598120910,598123278,2368
1360176741,598125044,15,3702,246.8,1360176736929,1360176739297,598120973,598123341,2368
1360176765,598148772,10,3523,352.3,1360176738865,1360176740593,598122637,598124365,1728
1360176789,598173176,3,168,56,1360176785182,1360176785758,598169358,598169934,576
1360176789,598173216,3,168,56,1360176786037,1360176786677,598170253,598170893,640
1360176789,598173224,4,271,67.75,1360176784172,1360176784812,598168396,598169036,640
1360176789,598173252,3,168,56,1360176787666,1360176788306,598171918,598172558,640
1360176797,598181148,3,168,56,1360176788667,1360176789307,598172815,598173455,640
1360176797,598181152,3,168,56,1360176789620,1360176790196,598173772,598174348,576
1360176805,598188992,2,110,55,1360176790679,1360176800983,598174671,598184975,10304
1360176805,598189108,3,168,56,1360176800994,1360176801058,598185102,598185166,64
1360176805,598189112,3,168,56,1360176801119,1360176801247,598185231,598185359,128
1360176813,598197420,1,46,46,1360176786856,1360176786856,598171276,598171276,0
1360176829,598213356,2,512,256,1360176802218,1360176802218,598186574,598186574,0
1360176861,598245232,2,131,65.5,1360176860004,1360176860004,598244236,598244236,0
1360176917,598301332,3,387,129,1360176890112,1360176890752,598274444,598275084,640
1360177061,598445604,5,644,128.8,1360177035181,1360177044909,598419785,598429513,9728
1360177109,598493248,16,4040,252.5,1360177101904,1360177102864,598486152,598487112,960
1360177125,598509644,8,4673,584.125,1360177100739,1360177101251,598485383,598485895,512
1360177126,598509796,1,52,52,1360177100629,1360177100629,598484425,598484425,0
1360177130,598513740,7,2757,393.8571429,1360177102094,1360177102670,598485834,598486410,576
1360177322,598706064,4,757,189.25,1360177295879,1360177296391,598679943,598680455,512
1360177370,598753996,1,52,52,1360177341959,1360177341959,598725955,598725955,0
1360177370,598754004,1,52,52,1360177342401,1360177342401,598726405,598726405,0
1360177390,598774056,1,52,52,1360177363918,1360177363918,598747974,598747974,0
1360177718,599101712,28,20808,743.1428571,1360177692511,1360177714655,599076223,599098367,22144
1360177727,599111156,50,45224,904.48,1360177699812,1360177724388,599083968,599108544,24576
1360177846,599229940,2,131,65.5,1360177844473,1360177844473,599228413,599228413,0
1360178262,599646196,4,256,64,1360178257074,1360178257586,599641270,599641782,512
1360178262,599646216,2,92,46,1360178257693,1360178257885,599641909,599642101,192
1360178292,599676180,19,4066,214,1360178266369,1360178269953,599650549,599654133,3584
1360178300,599684120,8,3129,391.125,1360178272188,1360178273532,599656308,599657652,1344
1360178300,599684208,1,46,46,1360178272356,1360178272356,599656564,599656564,0
1360178350,599734268,4,184,46,1360178345322,1360178345322,599729590,599729590,0
1360178372,599756220,9,3463,384.7777778,1360178345625,1360178346585,599729845,599730805,960
1360178372,599756252,35,5224,149.2571429,1360178346810,1360178351482,599731062,599735734,4672
1360178372,599756252,40,3556,88.9,1360178346810,1360178350650,599731062,599734902,3840
1360178414,599798268,1,485,485,1360178387752,1360178387752,599772020,599772020,0
1360178464,599848656,1,52,52,1360178437540,1360178437540,599822196,599822196,0
1360178470,599854324,2,131,65.5,1360178466416,1360178466416,599850740,599850740,0
1360178497,599880704,3,379,126.3333333,1360178471771,1360178487451,599855475,599871155,15680
1360178517,599900796,21,12491,594.8095238,1360178490815,1360178494207,599874611,599878003,3392
1360178545,599928804,3,240,80,1360178520439,1360178540919,599904243,599924723,20480
1360178609,599993140,4,841,210.25,1360178582501,1360178583077,599966641,599967217,576
1360178617,600001148,1,52,52,1360178589405,1360178589405,599973553,599973553,0
1360178617,600001180,1,52,52,1360178591548,1360178591548,599975728,599975728,0
1360178637,600021116,1,52,52,1360178612156,1360178612156,599996272,599996272,0
1360178693,600077148,3,567,189,1360178667484,1360178667612,600051632,600051760,128
1360178693,600077228,1,193,193,1360178666954,1360178666954,600051182,600051182,0
1360178933,600317400,1,52,52,1360178907355,1360178907355,600291755,600291755,0
1360178975,600358880,12,7669,639.0833333,1360178966628,1360178967140,600350508,600351020,512
1360178975,600358892,7,3898,556.8571429,1360178969045,1360178969557,600352937,600353449,512
1360178981,600365412,2,339,169.5,1360178953230,1360178953230,600337642,600337642,0
1360178983,600366760,2,112,56,1360178967004,1360178981276,600350764,600365036,14272
1360178983,600366772,2,112,56,1360178970576,1360178981264,600354348,600365036,10688
1360178983,600366800,2,112,56,1360178968628,1360178981236,600352428,600365036,12608
1360178983,600366852,2,112,56,1360178970493,1360178981181,600354345,600365033,10688
1360178983,600366852,2,112,56,1360178970493,1360178981181,600354345,600365033,10688
1360178983,600366888,2,112,56,1360178968537,1360178981145,600352425,600365033,12608
1360178983,600366892,2,112,56,1360178968537,1360178981145,600352429,600365037,12608
1360178985,600369340,7,3146,449.4285714,1360178957462,1360178957654,600341802,600341994,192
1360178985,600369408,16,8743,546.4375,1360178956883,1360178961171,600341291,600345579,4288
1360178989,600373440,8,1992,249,1360178963506,1360178965362,600347946,600349802,1856
1360178993,600377332,6,936,156,1360178966430,1360178980702,600350762,600365034,14272
1360178993,600377336,4,376,94,1360178966556,1360178966812,600350892,600351148,256
1360178993,600377376,16,11028,689.25,1360178966132,1360178967540,600350508,600351916,1408
1360178993,600377376,32,40602,1268.8125,1360178967603,1360178967859,600351979,600352235,256
1360178993,600377380,6,1549,258.1666667,1360178968045,1360178972333,600352425,600356713,4288
1360178993,600377412,4,431,107.75,1360178966350,1360178975054,600350762,600359466,8704
1360178993,600377420,4,537,134.25,1360178966664,1360178966728,600351084,600351148,64
1360178993,600377464,14,5490,392.1428571,1360178968476,1360178969948,600352940,600354412,1472
1360178997,600381336,5,548,109.6,1360178970009,1360178974233,600354345,600358569,4224
1360178997,600381368,4,537,134.25,1360178970810,1360178970938,600355178,600355306,128
1360178997,600381372,4,537,134.25,1360178971000,1360178971000,600355372,600355372,0
1360178999,600382932,4,272,68,1360178997037,1360178997229,600380969,600381161,192
1360178999,600382936,2,131,65.5,1360178997099,1360178997099,600381035,600381035,0
1360179001,600385356,16,18685,1167.8125,1360178974534,1360178975110,600358890,600359466,576
1360179001,600385356,8,7324,915.5,1360178974534,1360178975046,600358890,600359402,512
1360179001,600385360,10,10926,1092.6,1360178974657,1360178975105,600359017,600359465,448
1360179001,600385360,20,24430,1221.5,1360178974657,1360178975233,600359017,600359593,576
1360179001,600385360,13,14264,1097.230769,1360178974660,1360178975236,600359020,600359596,576
1360179001,600385360,6,5684,947.3333333,1360178974660,1360178975108,600359020,600359468,448
1360179001,600385360,7,7092,1013.142857,1360178974660,1360178975044,600359020,600359404,384
1360179001,600385368,6,5561,926.8333333,1360178975036,1360178975100,600359404,600359468,64
1360179001,600385440,6,4903,817.1666667,1360178974451,1360178974963,600358891,600359403,512
1360179001,600385440,13,14446,1111.230769,1360178974451,1360178974963,600358891,600359403,512
1360179001,600385440,17,18584,1093.176471,1360178974515,1360178974963,600358955,600359403,448
1360179001,600385440,8,8494,1061.75,1360178974577,1360178975025,600359017,600359465,448
1360179001,600385440,6,5695,949.1666667,1360178974577,1360178974961,600359017,600359401,384
1360179001,600385440,20,24144,1207.2,1360178974577,1360178975025,600359017,600359465,448
1360179001,600385444,23,27798,1208.608696,1360178974573,1360178975021,600359017,600359465,448
1360179001,600385444,7,7222,1031.714286,1360178974573,1360178974957,600359017,600359401,384
1360179001,600385444,7,6948,992.5714286,1360178974573,1360178974957,600359017,600359401,384
1360179001,600385448,7,6232,890.2857143,1360178974955,1360178974955,600359403,600359403,0
1360179001,600385448,13,15726,1209.692308,1360178974955,1360178975019,600359403,600359467,64
1360179001,600385448,17,19095,1123.235294,1360178974955,1360178975083,600359403,600359531,128
1360179001,600385448,8,8554,1069.25,1360178974891,1360178975019,600359339,600359467,128
1360179001,600385448,7,6208,886.8571429,1360178974954,1360178975018,600359402,600359466,64
1360179007,600390804,4,272,68,1360178999727,1360178999919,600383531,600383723,192
1360179021,600405408,2,550,275,1360178994771,1360178994771,600379179,600379179,0
1360179031,600414880,2,141,70.5,1360179022880,1360179022880,600406760,600406760,0
1360179031,600414880,245,331780,1354.204082,1360178966884,1360179022884,600350764,600406764,56000
1360179031,600414892,5,656,131.2,1360179006296,1360179022872,600390188,600406764,16576
1360179033,600417488,1,52,52,1360179006660,1360179006660,600391148,600391148,0
1360179049,600433424,1,52,52,1360179022338,1360179022338,600406762,600406762,0
1360179049,600433424,1,52,52,1360179022338,1360179022338,600406762,600406762,0
1360179049,600433424,1,52,52,1360179022338,1360179022338,600406762,600406762,0
1360179049,600433424,1,52,52,1360179022338,1360179022338,600406762,600406762,0
1360179049,600433424,1,52,52,1360179022338,1360179022338,600406762,600406762,0
1360179049,600433424,1,52,52,1360179022338,1360179022338,600406762,600406762,0
1360179049,600433424,1,52,52,1360179022338,1360179022338,600406762,600406762,0
1360179049,600433424,1,52,52,1360179022338,1360179022338,600406762,600406762,0
1360179049,600433424,1,52,52,1360179022338,1360179022338,600406762,600406762,0
1360179049,600433424,1,52,52,1360179022338,1360179022338,600406762,600406762,0
1360179049,600433424,1,52,52,1360179022338,1360179022338,600406762,600406762,0
1360179049,600433424,1,52,52,1360179022337,1360179022337,600406761,600406761,0
1360179049,600433424,1,52,52,1360179022337,1360179022337,600406761,600406761,0
1360179049,600433440,1,46,46,1360179023024,1360179023024,600407464,600407464,0
1360179049,600433504,1,52,52,1360179022258,1360179022258,600406762,600406762,0
1360179049,600433504,1,52,52,1360179022258,1360179022258,600406762,600406762,0
1360179049,600433504,1,52,52,1360179022258,1360179022258,600406762,600406762,0
1360179049,600433504,1,52,52,1360179022258,1360179022258,600406762,600406762,0
1360179049,600433504,1,52,52,1360179022258,1360179022258,600406762,600406762,0
1360179049,600433504,1,52,52,1360179022258,1360179022258,600406762,600406762,0
1360179049,600433504,1,52,52,1360179022258,1360179022258,600406762,600406762,0
1360179049,600433504,1,52,52,1360179022258,1360179022258,600406762,600406762,0
1360179049,600433504,1,52,52,1360179022258,1360179022258,600406762,600406762,0
1360179049,600433504,1,52,52,1360179022258,1360179022258,600406762,600406762,0
1360179049,600433504,1,52,52,1360179022258,1360179022258,600406762,600406762,0
1360179049,600433504,1,52,52,1360179022258,1360179022258,600406762,600406762,0
1360179110,600493876,3,389,129.6666667,1360179085477,1360179088933,600469353,600472809,3456
1360179182,600565872,4,508,127,1360179157674,1360179158250,600541546,600542122,576
1360179199,600583052,2,104,52,1360179197941,1360179198197,600581993,600582249,256
1360179215,600598972,2,104,52,1360179207170,1360179207426,600591142,600591398,256
1360179231,600614964,1,52,52,1360179205770,1360179205770,600589734,600589734,0
1360179238,600622180,1,52,52,1360179211122,1360179211122,600595302,600595302,0
1360179238,600622260,1,52,52,1360179211173,1360179211173,600595433,600595433,0
1360179239,600623068,2,104,52,1360179235172,1360179235364,600619240,600619432,192
1360179263,600647036,5,230,46,1360179257347,1360179257603,600641383,600641639,256
1360179282,600666296,9,3899,433.2222222,1360179257597,1360179260605,600641893,600644901,3008
1360179399,600783096,4,184,46,1360179395461,1360179395525,600779557,600779621,64
1360179423,600806796,8,3226,403.25,1360179395824,1360179399024,600779620,600782820,3200
1360179527,600910968,1,52,52,1360179500995,1360179500995,600884963,600884963,0
1360179640,601023712,2,104,52,1360179638911,1360179639103,601022623,601022815,192
1360179795,601179608,7,1337,191,1360179767356,1360179789948,601151964,601174556,22592
1360179824,601207936,3,573,191,1360179800605,1360179819741,601184541,601203677,19136
1360179824,601208028,3,168,56,1360179816960,1360179817536,601200988,601201564,576
1360179832,601216120,8,1528,191,1360179830309,1360179831397,601214429,601215517,1088
1360179840,601223976,7,1423,203.2857143,1360179832374,1360179832566,601216350,601216542,192
1360179840,601223980,33,9549,289.3636364,1360179828211,1360179835891,601212191,601219871,7680
1360179840,601224028,8,1297,162.125,1360179830401,1360179835713,601214429,601219741,5312
1360179840,601224112,12,7549,629.0833333,1360179830318,1360179835630,601214430,601219742,5312
1360179844,601227744,9,3463,384.7777778,1360179819551,1360179819871,601203295,601203615,320
1360179844,601227836,23,5000,217.3913043,1360179819395,1360179824259,601203231,601208095,4864
1360179848,601232044,17,11129,654.6470588,1360179820659,1360179822323,601204703,601206367,1664
1360179855,601239668,1,116,116,1360179827327,1360179827327,601211995,601211995,0
1360179855,601239672,1,116,116,1360179827518,1360179827518,601212190,601212190,0
1360179855,601239672,9,834,92.66666667,1360179827645,1360179850941,601212317,601235613,23296
1360179856,601239748,7,3494,499.1428571,1360179827927,1360179828311,601211675,601212059,384
1360179856,601239756,1,116,116,1360179828242,1360179828242,601211998,601211998,0
1360179856,601239756,1,116,116,1360179828432,1360179828432,601212188,601212188,0
1360179856,601239756,1,46,46,1360179828432,1360179828432,601212188,601212188,0
1360179864,601247852,1,46,46,1360179835698,1360179835698,601219550,601219550,0
1360179904,601287812,1,52,52,1360179878361,1360179878361,601262173,601262173,0
1360179944,601328160,6,447,74.5,1360179939389,1360179943485,601323549,601327645,4096
1360179960,601344168,2,158,79,1360179947763,1360179956467,601331931,601340635,8704
1360180000,601383848,1,79,79,1360179974066,1360179974066,601357914,601357914,0
1360180036,601419880,1,79,79,1360180008721,1360180008721,601392601,601392601,0
1360180064,601448284,3,168,56,1360180061374,1360180062462,601445658,601446746,1088
1360180072,601456256,3,168,56,1360180069402,1360180070170,601453658,601454426,768
1360180072,601456296,3,168,56,1360180068400,1360180069104,601452696,601453400,704
1360180072,601456344,3,168,56,1360180070530,1360180071426,601454874,601455770,896
1360180088,601471964,3,672,224,1360180061821,1360180062589,601445785,601446553,768
1360180088,601472016,22,5950,270.4545455,1360180060234,1360180065034,601444250,601449050,4800
1360180088,601472052,1,52,52,1360180062309,1360180062309,601446361,601446361,0
1360180088,601472088,1,46,46,1360180062915,1360180062915,601447003,601447003,0
1360180096,601480016,1,52,52,1360180068041,1360180068041,601452057,601452057,0
1360180265,601648708,9,3611,401.2222222,1360180238588,1360180254780,601622296,601638488,16192
1360180292,601676456,3,4410,1470,1360180264015,1360180283983,601648471,601668439,19968
1360180312,601696540,3,2992,997.3333333,1360180293946,1360180303930,601678486,601688470,9984
1360180424,601808616,3,156,52,1360180416170,1360180420202,601800786,601804818,4032
1360180440,601824652,2,104,52,1360180425481,1360180435529,601810133,601820181,10048
1360180457,601840700,2,104,52,1360180446464,1360180456448,601830164,601840148,9984
1360180480,601864680,2,104,52,1360180465453,1360180475501,601850133,601860181,10048
1360180909,602293588,11,5155,468.6363636,1360180882176,1360180883968,602266764,602268556,1792
1360180914,602297740,11,4349,395.3636364,1360180887248,1360180888144,602270988,602271884,896
1360180929,602312808,26,18074,695.1538462,1360180920906,1360180922698,602304714,602306506,1792
1360180929,602312812,16,10078,629.875,1360180921033,1360180921865,602304845,602305677,832
1360180929,602312892,15,7958,530.5333333,1360180920951,1360180922807,602304843,602306699,1856
1360180929,602312928,12,7370,614.1666667,1360180923221,1360180924117,602307149,602308045,896
1360180929,602312940,4,404,101,1360180924551,1360180926023,602308491,602309963,1472
1360180929,602312940,24,24600,1025,1360180924743,1360180926343,602308683,602310283,1600
1360180929,602313616,19,11576,609.2631579,1360180920102,1360180921766,602304718,602306382,1664
1360180937,602321628,2,239,119.5,1360180909144,1360180916184,602293772,602300812,7040
1360180942,602325768,12,1520,126.6666667,1360180916020,1360180918132,602299788,602301900,2112
1360180946,602329796,14,5244,374.5714286,1360180919126,1360180922582,602302922,602306378,3456
1360180946,602329796,7,3278,468.2857143,1360180919383,1360180919895,602303179,602303691,512
1360180950,602333712,8,6025,753.125,1360180925549,1360180926765,602309261,602310477,1216
1360180961,602344872,23,13506,587.2173913,1360180956618,1360180957962,602340490,602341834,1344
1360180986,602369744,1,52,52,1360180957962,1360180957962,602341706,602341706,0
1360180993,602376844,3,179,59.66666667,1360180985829,1360180991013,602369673,602374857,5184
1360181006,602389920,2,115,57.5,1360180978074,1360180978074,602361994,602361994,0
1360181034,602418064,1,63,63,1360181007499,1360181007499,602391563,602391563,0
1360181066,602450172,1,63,63,1360181037920,1360181037920,602422092,602422092,0
1360181126,602510192,1,63,63,1360181097930,1360181097930,602482122,602482122,0
1360181134,602518136,9,3464,384.8888889,1360181106432,1360181107008,602490568,602491144,576
1360181154,602538372,2,126,63,1360181127251,1360181127443,602511623,602511815,192
1360181161,602545016,2,104,52,1360181159670,1360181159926,602543686,602543942,256
1360181182,602566484,1,63,63,1360181157732,1360181157732,602542216,602542216,0
1360181190,602574424,1,52,52,1360181161951,1360181161951,602546375,602546375,0
1360181233,602617072,2,131,65.5,1360181226944,1360181226944,602611016,602611016,0
1360181242,602626520,1,63,63,1360181217790,1360181217790,602602310,602602310,0
1360181266,602650492,4,870,217.5,1360181240602,1360181241370,602625094,602625862,768
1360181274,602658632,1,63,63,1360181246991,1360181246991,602631623,602631623,0
1360181302,602686612,3,190,63.33333333,1360181277731,1360181278179,602662343,602662791,448
1360181322,602706656,7,2541,363,1360181295160,1360181295608,602679816,602680264,448
1360181366,602750608,2,115,57.5,1360181338275,1360181338275,602722883,602722883,0
1360181394,602778680,1,63,63,1360181366941,1360181366941,602751621,602751621,0
1360181409,602793160,4,184,46,1360181408098,1360181408162,602792258,602792322,64
1360181426,602810648,1,63,63,1360181398334,1360181398334,602782982,602782982,0
1360181435,602818804,9,3464,384.8888889,1360181408518,1360181409094,602792322,602792898,576
1360181442,602826676,1,46,46,1360181416608,1360181416608,602801284,602801284,0
1360181487,602870796,4,253,63.25,1360181459216,1360181460240,602843012,602844036,1024
1360181513,602897276,2,115,57.5,1360181487344,1360181508144,602871620,602892420,20800
1360181521,602905280,5,809,161.8,1360181520299,1360181520427,602904579,602904707,128
1360181529,602913140,12,3526,293.8333333,1360181526903,1360181527351,602911043,602911491,448
1360181529,602913144,110,141178,1283.436364,1360181521906,1360181523314,602906050,602907458,1408
1360181529,602913216,15,5440,362.6666667,1360181526825,1360181527721,602911041,602911937,896
1360181529,602913264,4,256,64,1360181528507,1360181528827,602912771,602913091,320
1360181537,602921212,2,104,52,1360181536046,1360181536302,602920258,602920514,256
1360181547,602930880,41,9967,243.097561,1360181520827,1360181533819,602904707,602917699,12992
1360181579,602963020,6,451,75.16666667,1360181553389,1360181578541,602937409,602962561,25152
1360181607,602990868,1,180,180,1360181579526,1360181579526,602963394,602963394,0
1360181641,603025504,3,138,46,1360181638342,1360181638342,603022846,603022846,0
1360181663,603047292,12,4493,374.4166667,1360181636701,1360181638045,603020993,603022337,1344
1360181663,603047328,16,5636,352.25,1360181638519,1360181651575,603022847,603035903,13056
1360181667,603051368,3,178,59.33333333,1360181639439,1360181640975,603023807,603025343,1536
1360181672,603056480,22,18871,857.7727273,1360181644449,1360181650337,603028929,603034817,5888
1360181672,603056704,1,46,46,1360181644736,1360181644736,603029440,603029440,0
1360181673,603056708,1,46,46,1360181645733,1360181645733,603029441,603029441,0
1360181673,603057608,1,187,187,1360181642783,1360181642783,603027391,603027391,0
1360181681,603065532,2,131,65.5,1360181678827,1360181678827,603063359,603063359,0
1360181727,603111312,1,63,63,1360181699529,1360181699529,603083841,603083841,0
1360181735,603119372,9,3464,384.8888889,1360181709641,1360181710089,603094013,603094461,448
1360181785,603169632,2,104,52,1360181783559,1360181784007,603168191,603168639,448
1360181787,603171516,2,126,63,1360181759418,1360181760826,603143934,603145342,1408
1360181793,603177500,2,104,52,1360181784971,1360181786571,603169471,603171071,1600
1360181793,603177504,12,3526,293.8333333,1360181787141,1360181788549,603171645,603173053,1408
1360181793,603177580,108,138351,1281.027778,1360181787066,1360181788858,603171646,603173438,1792
1360181793,603177588,14,4774,341,1360181791283,1360181791731,603175871,603176319,448
1360181811,603195572,25,5718,228.72,1360181786627,1360181799619,603171199,603184191,12992
1360181815,603199456,8,2251,281.375,1360181787319,1360181789047,603171775,603173503,1728
1360181828,603211948,1,46,46,1360181800305,1360181800305,603184253,603184253,0
1360181833,603217636,3,210,70,1360181829760,1360181830016,603214396,603214652,256
1360181840,603223916,6,577,96.16666667,1360181814675,1360181819731,603198591,603203647,5056
1360181876,603260012,2,231,115.5,1360181849713,1360181850225,603233725,603234237,512
1360181904,603287996,1,52,52,1360181877567,1360181877567,603261563,603261563,0
1360181908,603292040,1,63,63,1360181881299,1360181881299,603265339,603265339,0
1360181916,603300100,1,52,52,1360181891608,1360181891608,603275708,603275708,0
1360181936,603320088,3,178,59.33333333,1360181908067,1360181910499,603292155,603294587,2432
1360181996,603380376,1,63,63,1360181970369,1360181970369,603354745,603354745,0
1360182036,603420384,9,3464,384.8888889,1360182011259,1360182011579,603395643,603395963,320
1360182052,603436412,2,126,63,1360182027742,1360182030430,603412154,603414842,2688
1360182076,603460472,2,484,242,1360182051682,1360182051810,603436154,603436282,128
1360182116,603500504,1,63,63,1360182090434,1360182090434,603474938,603474938,0
1360182138,603521904,2,131,65.5,1360182131991,1360182131991,603515895,603515895,0
1360182172,603556504,2,126,63,1360182147647,1360182150463,603532151,603534967,2816
1360182236,603620648,1,63,63,1360182210416,1360182210416,603595064,603595064,0
1360182290,603674036,3,178,59.33333333,1360182268113,1360182288465,603652149,603672501,20352
1360182298,603682136,5,808,161.6,1360182295407,1360182295471,603679543,603679607,64
1360182306,603690024,14,4774,341,1360182297502,1360182298846,603681526,603682870,1344
1360182306,603690024,12,3526,293.8333333,1360182297502,1360182298782,603681526,603682806,1280
1360182306,603690104,108,138351,1281.027778,1360182297424,1360182299536,603681528,603683640,2112
1360182314,603698172,4,184,46,1360182313099,1360182313099,603697271,603697271,0
1360182320,603704644,38,10047,264.3947368,1360182295091,1360182307955,603679735,603692599,12864
1360182340,603724648,9,3464,384.8888889,1360182312620,1360182313132,603697268,603697780,512
1360182353,603736704,2,115,57.5,1360182328669,1360182328797,603712373,603712501,128
1360182393,603776804,2,115,57.5,1360182368763,1360182368827,603752567,603752631,64
1360182434,603818112,2,131,65.5,1360182433541,1360182433541,603817653,603817653,0
1360182441,603824760,3,178,59.33333333,1360182416611,1360182429027,603800371,603812787,12416
1360183916,605299776,3,144,48,1360183888062,1360183897022,605271838,605280798,8960
1360184017,605401456,1,46,46,1360183989331,1360183989331,605373787,605373787,0
1360184052,605436528,3,168,56,1360184050380,1360184050508,605434908,605435036,128
1360184052,605436528,3,168,56,1360184050634,1360184050826,605435162,605435354,192
1360184052,605436604,4,271,67.75,1360184050110,1360184050238,605434714,605434842,128
1360184068,605452560,5,296,59.2,1360184053802,1360184063210,605438362,605447770,9408
1360184068,605452592,4,220,55,1360184063688,1360184064328,605448280,605448920,640
1360184092,605476228,8,2851,356.375,1360184064821,1360184066485,605449049,605450713,1664
1360184092,605476232,1,64,64,1360184065010,1360184065010,605449242,605449242,0
1360184092,605476312,21,4842,230.5714286,1360184064099,1360184077155,605448411,605461467,13056
1360184099,605483368,1,52,52,1360184092200,1360184092200,605476568,605476568,0
1360184185,605568884,1,46,46,1360184160845,1360184160845,605544729,605544729,0
1360184188,605572668,3,210,70,1360184185917,1360184186941,605570585,605571609,1024
1360184196,605580588,2,158,79,1360184189133,1360184193421,605573721,605578009,4288
1360184249,605633008,1,64,64,1360184223697,1360184223697,605607705,605607705,0
1360184365,605748736,22,3740,170,1360184360606,1360184361054,605744342,605744790,448
1360184373,605756712,3,168,56,1360184370422,1360184371062,605754134,605754774,640
1360184373,605756760,3,168,56,1360184369412,1360184370052,605753172,605753812,640
1360184373,605756820,3,168,56,1360184371208,1360184371848,605755028,605755668,640
1360184385,605769304,7,3438,491.1428571,1360184359203,1360184359587,605743507,605743891,384
1360184393,605777340,1,46,46,1360184368575,1360184368575,605752915,605752915,0
1360184493,605876760,15,6681,445.4,1360184484997,1360184486469,605868757,605870229,1472
1360184493,605876836,12,6440,536.6666667,1360184485814,1360184486902,605869650,605870738,1088
1360184493,605876852,13,6678,513.6923077,1360184486569,1360184487593,605870421,605871445,1024
1360184493,605876880,13,6751,519.3076923,1360184487373,1360184488269,605871253,605872149,896
1360184493,605876884,12,6314,526.1666667,1360184488071,1360184488903,605871955,605872787,832
1360184510,605893780,1,52,52,1360184484142,1360184484142,605867922,605867922,0
1360184549,605932852,2,116,58,1360184548390,1360184548710,605932242,605932562,320
1360184557,605940832,4,271,67.75,1360184551545,1360184552185,605935377,605936017,640
1360184557,605940896,4,271,67.75,1360184550395,1360184551163,605934291,605935059,768
1360184557,605940900,3,168,56,1360184549432,1360184550072,605933332,605933972,640
1360184574,605958004,1,52,52,1360184548877,1360184548877,605932881,605932881,0
1360184578,605962084,19,4066,214,1360184551296,1360184554880,605935380,605938964,3584
1360184578,605962112,1,64,64,1360184552225,1360184552225,605936337,605936337,0
1360184578,605962204,1,52,52,1360184552774,1360184552774,605936978,605936978,0
1360184626,606010196,1,52,52,1360184599692,1360184599692,605983888,605983888,0
1360184866,606250672,1,186,186,1360184841196,1360184841196,606225868,606225868,0
1360184871,606254724,12,6396,533,1360184844514,1360184847522,606228238,606231246,3008
1360184875,606258776,72,98997,1374.958333,1360184849261,1360184873005,606233037,606256781,23744
1360184877,606261232,3,168,56,1360184874468,1360184875300,606258700,606259532,832
1360184877,606261244,3,168,56,1360184871513,1360184872153,606255757,606256397,640
1360184877,606261280,3,168,56,1360184873331,1360184873971,606257611,606258251,640
1360184877,606261360,3,168,56,1360184872292,1360184872932,606256652,606257292,640
1360184877,606261384,3,168,56,1360184875471,1360184876175,606259855,606260559,704
1360184902,606286664,1,52,52,1360184875316,1360184875316,606259980,606259980,0
1360184903,606286704,21,4302,204.8571429,1360184874998,1360184878198,606258702,606261902,3200
1360184903,606286780,10,4729,472.9,1360184877095,1360184878311,606260875,606262091,1216
1360184903,606286784,1,64,64,1360184877091,1360184877091,606260875,606260875,0
1360185115,606498920,1,52,52,1360185087321,1360185087321,606471241,606471241,0
1360185143,606526980,1,52,52,1360185118107,1360185118107,606502087,606502087,0
1360185181,606565684,3,168,56,1360185179548,1360185180124,606564232,606564808,576
1360185181,606565776,2,116,58,1360185180351,1360185180543,606565127,606565319,192
1360185189,606573640,3,168,56,1360185182409,1360185183049,606567049,606567689,640
1360185189,606573680,4,220,55,1360185184543,1360185185247,606569223,606569927,704
1360185189,606573696,3,168,56,1360185181263,1360185182095,606565959,606566791,832
1360185189,606573724,3,168,56,1360185183349,1360185184181,606568073,606568905,832
1360185207,606591092,19,4066,214,1360185181804,1360185185836,606565896,606569928,4032
1360185207,606591176,1,52,52,1360185181465,1360185181465,606565641,606565641,0
1360185211,606595100,1,52,52,1360185183651,1360185183651,606567751,606567751,0
1360185254,606637800,3,168,56,1360185253774,1360185253838,606637574,606637638,64
1360185254,606637884,3,168,56,1360185253497,1360185253625,606637381,606637509,128
1360185262,606645764,4,271,67.75,1360185253940,1360185254068,606637704,606637832,128
1360185271,606655280,1,460,460,1360185243055,1360185243055,606627335,606627335,0
1360185275,606659300,8,3390,423.75,1360185247261,1360185247837,606631561,606632137,576
1360185279,606663304,1,46,46,1360185253590,1360185253590,606637894,606637894,0
1360185302,606685768,18,4468,248.2222222,1360185295469,1360185295917,606679237,606679685,448
1360185302,606685780,13,3571,274.6923077,1360185296418,1360185297314,606680198,606681094,896
1360185302,606685828,13,3583,275.6153846,1360185295539,1360185296307,606679367,606680135,768
1360185302,606685828,13,3571,274.6923077,1360185295539,1360185296307,606679367,606680135,768
1360185307,606691452,13,4330,333.0769231,1360185279748,1360185281924,606664200,606666376,2176
1360185307,606691480,1,186,186,1360185280549,1360185280549,606665029,606665029,0
1360185323,606707448,9,3463,384.7777778,1360185295493,1360185295749,606679941,606680197,256
1360185363,606747520,1,52,52,1360185335612,1360185335612,606720132,606720132,0
1360185422,606805868,3,210,70,1360185416264,1360185416520,606800132,606800388,256
1360185494,606877964,4,208,52,1360185488168,1360185489832,606872132,606873796,1664
1360185494,606878012,3,168,56,1360185490934,1360185491830,606874946,606875842,896
1360185502,606885884,3,168,56,1360185496184,1360185496824,606880068,606880708,640
1360185502,606885888,4,271,67.75,1360185500532,1360185501108,606884420,606884996,576
1360185502,606885892,3,168,56,1360185497134,1360185497966,606881026,606881858,832
1360185502,606885936,4,271,67.75,1360185499586,1360185500162,606883522,606884098,576
1360185502,606885980,3,168,56,1360185495191,1360185495703,606879171,606879683,512
1360185502,606886008,3,168,56,1360185498493,1360185499069,606882501,606883077,576
1360185524,606907840,19,4066,214,1360185496291,1360185499619,606880131,606883459,3328
1360185524,606907952,1,52,52,1360185497395,1360185497395,606881347,606881347,0
1360185526,606910040,2,104,52,1360185522331,1360185522587,606906371,606906627,256
1360185528,606912000,1,64,64,1360185501316,1360185501316,606885316,606885316,0
1360185588,606972136,1,46,46,1360185560060,1360185560060,606944196,606944196,0
1360185590,606973956,12,3367,280.5833333,1360185588398,1360185589166,606972354,606973122,768
1360185590,606973956,18,4418,245.4444444,1360185588398,1360185589358,606972354,606973314,960
1360185590,606974000,3,168,56,1360185587137,1360185587201,606971137,606971201,64
1360185590,606974076,3,168,56,1360185586677,1360185586805,606970753,606970881,128
1360185598,606981960,15,6698,446.5333333,1360185588076,1360185590380,606972036,606974340,2304
1360185598,606982056,14,5677,405.5,1360185589129,1360185590281,606973185,606974337,1152
1360185600,606984164,1,487,487,1360185574301,1360185574301,606958465,606958465,0
1360185606,606989968,32,8294,259.1875,1360185601059,1360185604707,606985027,606988675,3648
1360185606,606990088,22,6000,272.7272727,1360185603179,1360185604523,606987267,606988611,1344
1360185608,606992168,1,46,46,1360185580379,1360185580379,606964547,606964547,0
1360185612,606996364,12,3914,326.1666667,1360185587607,1360185602327,606971971,606986691,14720
1360185614,606997988,35,7757,221.6285714,1360185609037,1360185610637,606993025,606994625,1600
1360185614,3540277300,7,5564,794.8571429,1360185589144,1360185589336,3540252444,3540252636,192
1360185614,3540277300,44,57905,1316.022727,1360185589208,1360185590104,3540252508,3540253404,896
1360185614,3540277300,5,2196,439.2,1360185589208,1360185589336,3540252508,3540252636,128
1360185614,606998024,36,8655,240.4166667,1360185605675,1360185607275,606989699,606991299,1600
1360185614,3540277308,9,7486,831.7777778,1360185589136,1360185590096,3540252444,3540253404,960
1360185614,3540277308,5,2180,436,1360185589136,1360185589264,3540252444,3540252572,128
1360185614,3540277356,18,22098,1227.666667,1360185589090,1360185589282,3540252446,3540252638,192
1360185614,606998096,35,7781,222.3142857,1360185605282,1360185607394,606989378,606991490,2112
1360185614,606998104,29,7138,246.137931,1360185607642,1360185608730,606991746,606992834,1088
1360185616,607000148,12,6680,556.6666667,1360185587885,1360185588845,606972033,606972993,960
1360185616,607000148,8,3684,460.5,1360185587884,1360185589164,606972032,606973312,1280
1360185616,607000272,38,5192,136.6315789,1360185590066,1360185591282,606974338,606975554,1216
1360185616,607000276,9,2898,322,1360185590189,1360185590957,606974465,606975233,768
1360185616,607000284,7,3286,469.4285714,1360185588711,1360185589415,606972995,606973699,704
1360185616,607000320,8,7168,896,1360185589315,1360185589443,606973635,606973763,128
1360185622,607006044,29,7138,246.137931,1360185616534,1360185619286,607000578,607003330,2752
1360185622,607006052,36,8613,239.25,1360185608976,1360185616848,606993028,607000900,7872
1360185628,607012212,15,3204,213.6,1360185599981,1360185601069,606984193,606985281,1088
1360185630,3540293336,3,807,269,1360185605621,1360185605749,3540268957,3540269085,128
1360185632,607016364,7,3601,514.4285714,1360185607256,1360185616984,606991620,607001348,9728
1360185644,607028308,4,2011,502.75,1360185616780,1360185616908,607001088,607001216,128
1360185646,607030184,3,230,76.66666667,1360185642443,1360185642699,607026627,607026883,256
1360185668,607052360,22,1918,87.18181818,1360185643544,1360185644056,607027904,607028416,512
1360185678,607062204,3,156,52,1360185675443,1360185676147,607059647,607060351,704
1360185688,607072332,1,52,52,1360185663606,1360185663606,607047938,607047938,0
1360185688,607072412,2,104,52,1360185663141,1360185663397,607047553,607047809,256
1360185704,607088280,1,52,52,1360185678376,1360185678376,607062656,607062656,0
1360185710,607094236,2,131,65.5,1360185708435,1360185708435,607092671,607092671,0
1360185710,607094268,2,131,65.5,1360185708980,1360185708980,607093248,607093248,0
1360185718,607102380,2,131,65.5,1360185710788,1360185710788,607095168,607095168,0
1360185726,607110356,3,210,70,1360185722202,1360185722522,607106558,607106878,320
1360185748,607132508,4,208,52,1360185723590,1360185724166,607108098,607108674,576
1360185752,607136360,1,46,46,1360185724951,1360185724951,607109311,607109311,0
1360185766,607150268,2,131,65.5,1360185764082,1360185764082,607148350,607148350,0
1360185776,607160564,2,532,266,1360185750604,1360185750924,607135168,607135488,320
1360185806,607190392,13,1152,88.61538462,1360185802744,1360185804856,607187136,607189248,2112
1360185806,607190392,3,168,56,1360185802744,1360185803384,607187136,607187776,640
1360185814,607198320,4,512,128,1360185792125,1360185807037,607176445,607191357,14912
1360185832,607216568,10,969,96.9,1360185805125,1360185806917,607189693,607191485,1792
1360185832,607216596,19,4066,214,1360185805355,1360185808427,607189951,607193023,3072
1360185856,607240624,1,52,52,1360185829071,1360185829071,607213695,607213695,0
1360185985,607368764,1,288,288,1360185957606,1360185957606,607341370,607341370,0
1360186070,607454640,3,168,56,1360186068283,1360186068859,607452923,607453499,576
1360186078,607462664,3,168,56,1360186072100,1360186072676,607456764,607457340,576
1360186079,607462696,3,168,56,1360186073963,1360186074603,607457659,607458299,640
1360186079,607462704,3,168,56,1360186074849,1360186076577,607458553,607460281,1728
1360186079,607462744,14,2864,204.5714286,1360186068924,1360186070972,607452668,607454716,2048
1360186079,607462748,3,168,56,1360186076856,1360186077752,607460604,607461500,896
1360186092,3540755864,2,141,70.5,1360186088745,1360186088745,3540752609,3540752609,0
1360186092,3540755864,2,141,70.5,1360186089575,1360186089575,3540753439,3540753439,0
1360186092,3540755884,2,141,70.5,1360186088724,1360186088724,3540752608,3540752608,0
1360186092,3540755884,2,141,70.5,1360186088724,1360186088724,3540752608,3540752608,0
1360186092,3540755884,2,141,70.5,1360186088724,1360186088724,3540752608,3540752608,0
1360186092,3540755884,2,141,70.5,1360186089490,1360186089490,3540753374,3540753374,0
1360186093,607477040,1,46,46,1360186068243,1360186068243,607452283,607452283,0
1360186093,607477148,19,4066,214,1360186068455,1360186071463,607452603,607455611,3008
1360186097,607481028,1,52,52,1360186069920,1360186069920,607453948,607453948,0
1360186097,607481072,10,965,96.5,1360186070643,1360186072371,607454715,607456443,1728
1360186105,607489024,1,64,64,1360186078180,1360186078180,607462204,607462204,0
1360186108,3540771876,3,156,52,1360186105181,1360186105821,3540769057,3540769697,640
1360186111,607494748,13,3272,251.6923077,1360186107510,1360186109302,607491258,607493050,1792
1360186111,607494824,17,3488,205.1764706,1360186107243,1360186108971,607491067,607492795,1728
1360186119,607502684,20,3884,194.2,1360186115764,1360186117492,607499448,607501176,1728
1360186119,607502692,17,5489,322.8823529,1360186113327,1360186115503,607497019,607499195,2176
1360186119,607502692,19,4049,213.1052632,1360186109422,1360186111278,607493114,607494970,1856
1360186119,607502720,16,3672,229.5,1360186111378,1360186113298,607495098,607497018,1920
1360186119,607502756,14,6850,489.2857143,1360186115566,1360186118382,607499322,607502138,2816
1360186126,607510640,3,168,56,1360186120954,1360186121530,607505594,607506170,576
1360186126,607510648,16,3399,212.4375,1360186119025,1360186121009,607503673,607505657,1984
1360186126,607510652,15,3409,227.2666667,1360186117487,1360186118319,607502139,607502971,832
1360186126,607510672,3,168,56,1360186119256,1360186119896,607503928,607504568,640
1360186126,607510676,55,58223,1058.6,1360186122644,1360186125716,607507320,607510392,3072
1360186127,607510692,16,4057,253.5625,1360186121966,1360186123630,607505658,607507322,1664
1360186127,607510752,3,168,56,1360186121075,1360186121715,607504827,607505467,640
1360186129,607513024,14,7295,521.0714286,1360186102176,1360186106720,607486200,607490744,4544
1360186135,607518692,17,3369,198.1764706,1360186128301,1360186129837,607511993,607513529,1536
1360186135,607518696,16,3523,220.1875,1360186126699,1360186128235,607510395,607511931,1536
1360186141,607525108,1,46,46,1360186113549,1360186113549,607497657,607497657,0
1360186249,607633168,1,243,243,1360186222160,1360186222160,607606328,607606328,0
1360186303,607686836,4,235,58.75,1360186298653,1360186298653,607682489,607682489,0
1360186373,607757336,1,52,52,1360186346468,1360186346468,607730804,607730804,0
1360186383,607766960,3,168,56,1360186381340,1360186381916,607765300,607765876,576
1360186383,607766976,2,116,58,1360186382223,1360186382479,607766199,607766455,256
1360186391,607774940,3,168,56,1360186384307,1360186385011,607768247,607768951,704
1360186391,607774984,3,168,56,1360186383366,1360186383942,607767350,607767926,576
1360186407,607790932,3,168,56,1360186403640,1360186403768,607787572,607787700,128
1360186407,607790984,3,168,56,1360186403331,1360186403459,607787315,607787443,128
1360186407,607790984,3,168,56,1360186403463,1360186403527,607787447,607787511,64
1360186409,607793380,22,4826,219.3636364,1360186382586,1360186399482,607766966,607783862,16896
1360186409,607793460,1,52,52,1360186383847,1360186383847,607768307,607768307,0
1360186409,607793468,1,52,52,1360186382496,1360186382496,607766964,607766964,0
1360186413,607797540,7,2757,393.8571429,1360186388056,1360186389144,607772596,607773684,1088
1360186417,607801492,1,64,64,1360186389575,1360186389575,607774067,607774067,0
1360186501,607885616,1,52,52,1360186473739,1360186473739,607858355,607858355,0
1360186513,607897624,1,46,46,1360186486469,1360186486469,607871093,607871093,0
1360186582,607965816,1,46,46,1360186554604,1360186554604,607938420,607938420,0
1360186654,608038080,1,52,52,1360186629602,1360186629602,608013682,608013682,0
1360186655,608039148,2,131,65.5,1360186651038,1360186651038,608035186,608035186,0
1360186702,608086404,1,438,438,1360186675675,1360186675675,608060079,608060079,0
1360186703,608087140,3,168,56,1360186701734,1360186701862,608085874,608086002,128
1360186703,608087192,4,271,67.75,1360186701426,1360186701554,608085618,608085746,128
1360186703,608087268,3,168,56,1360186701158,1360186701350,608085426,608085618,192
1360186711,608095208,14,4017,286.9285714,1360186704674,1360186705634,608088882,608089842,960
1360186711,608095220,6,1235,205.8333333,1360186709716,1360186709780,608093936,608094000,64
1360186711,608095288,8,1280,160,1360186707794,1360186709266,608092082,608093554,1472
1360186711,608095292,12,3999,333.25,1360186700555,1360186704203,608084847,608088495,3648
1360186711,608095296,16,7509,469.3125,1360186700617,1360186702921,608084913,608087217,2304
1360186719,608103164,2,110,55,1360186702222,1360186712270,608086386,608096434,10048
1360186719,608103196,3,168,56,1360186712236,1360186712300,608096432,608096496,64
1360186719,608103200,3,168,56,1360186712362,1360186712490,608096562,608096690,128
1360186719,608103200,4,271,67.75,1360186712489,1360186712553,608096689,608096753,64
1360186719,608103200,3,168,56,1360186712680,1360186712808,608096880,608097008,128
1360186719,608103204,6,759,126.5,1360186709028,1360186714212,608093232,608098416,5184
1360186719,608103272,3,168,56,1360186712479,1360186712607,608096751,608096879,128
1360186719,608103276,3,168,56,1360186712862,1360186712990,608097138,608097266,128
1360186719,608103280,10,6073,607.3,1360186709081,1360186714265,608093361,608098545,5184
1360186722,608106060,1,52,52,1360186694708,1360186694708,608078768,608078768,0
1360186722,608106140,19,4499,236.7894737,1360186694115,1360186703203,608078255,608087343,9088
1360186730,608114040,8,2832,354,1360186702217,1360186704329,608086257,608088369,2112
1360186730,608114160,10,3423,342.3,1360186703184,1360186704400,608087344,608088560,1216
1360186730,608114164,9,3463,384.7777778,1360186703246,1360186704206,608087410,608088370,960
1360186734,608118080,1,116,116,1360186707874,1360186707874,608091954,608091954,0
1360186734,608118080,1,46,46,1360186707938,1360186707938,608092018,608092018,0
1360186734,608118080,25,8983,359.32,1360186707937,1360186724449,608092017,608108529,16512
1360186734,608118184,7,3494,499.1428571,1360186707640,1360186708024,608091824,608092208,384
1360186734,608118188,1,116,116,1360186707762,1360186707762,608091950,608091950,0
1360186734,608118188,1,116,116,1360186707765,1360186707765,608091953,608091953,0
1360186734,608118188,1,116,116,1360186707765,1360186707765,608091953,608091953,0
1360186762,608146108,1,52,52,1360186737731,1360186737731,608121839,608121839,0
1360186831,608215316,2,131,65.5,1360186823924,1360186823924,608208240,608208240,0
1360186831,608215316,2,131,65.5,1360186823924,1360186823924,608208240,608208240,0
1360186831,608215336,2,131,65.5,1360186824030,1360186824030,608208366,608208366,0
1360186863,608247392,2,131,65.5,1360186856998,1360186856998,608241390,608241390,0
1360186906,608290188,2,116,58,1360186879281,1360186879473,608263469,608263661,192
1360186974,608358400,1,52,52,1360186947806,1360186947806,608332206,608332206,0
1360187007,608391404,3,168,56,1360187002522,1360187003482,608386926,608387886,960
1360187007,608391472,3,168,56,1360187005972,1360187006548,608390444,608391020,576
1360187007,608391516,3,168,56,1360187004902,1360187005670,608389418,608390186,768
1360187015,608399452,17,3488,205.1764706,1360187004969,1360187007017,608389421,608391469,2048
1360187015,608399476,2,104,52,1360187006992,1360187007184,608391468,608391660,192
1360187015,608399492,3,168,56,1360187006784,1360187007296,608391276,608391788,512
1360187030,608414424,8,4908,613.5,1360187002116,1360187003716,608386540,608388140,1600
1360187030,608414460,19,4066,214,1360187003040,1360187008608,608387500,608393068,5568
1360187030,608414472,1,46,46,1360187004052,1360187004052,608388524,608388524,0
1360187071,608454740,1,52,52,1360187044529,1360187044529,608428269,608428269,0
1360187320,608703684,3,168,56,1360187318370,1360187318946,608702054,608702630,576
1360187320,608703728,3,168,56,1360187316277,1360187316853,608700005,608700581,576
1360187320,608703736,3,168,56,1360187317231,1360187317871,608700967,608701607,640
1360187320,608703768,3,168,56,1360187315343,1360187315919,608699111,608699687,576
1360187320,608703776,3,168,56,1360187319177,1360187319753,608702953,608703529,576
1360187328,608711688,3,168,56,1360187320224,1360187320800,608703912,608704488,576
1360187328,608711692,3,168,56,1360187321114,1360187322010,608704806,608705702,896
1360187339,608723456,19,4066,214,1360187314655,1360187317535,608699111,608701991,2880
1360187343,608727300,1,52,52,1360187316091,1360187316091,608700391,608700391,0
1360187347,608731380,1,64,64,1360187321644,1360187321644,608706024,608706024,0
1360187628,609012208,3,458,152.6666667,1360187602195,1360187602579,608986403,608986787,384
1360187632,609016068,3,168,56,1360187626846,1360187627550,609010914,609011618,704
1360187640,609024080,3,168,56,1360187638803,1360187639379,609022883,609023459,576
1360187640,609024116,3,168,56,1360187636846,1360187637422,609020962,609021538,576
1360187640,609024196,3,168,56,1360187637663,1360187638367,609021859,609022563,704
1360187648,609032032,3,168,56,1360187640194,1360187641090,609024226,609025122,896
1360187648,609032044,3,168,56,1360187641335,1360187641975,609025379,609026019,640
1360187648,609032092,3,168,56,1360187644103,1360187644679,609028195,609028771,576
1360187648,609032128,3,168,56,1360187642210,1360187642850,609026338,609026978,640
1360187648,609032132,3,168,56,1360187643101,1360187643741,609027233,609027873,640
1360187652,609036412,19,4066,214,1360187626502,1360187629638,609010914,609014050,3136
1360187656,609040348,1,52,52,1360187628037,1360187628037,609012385,609012385,0
1360187664,609048480,1,46,46,1360187639299,1360187639299,609023779,609023779,0
1360187912,609296276,7,1563,223.2857143,1360187907339,1360187909003,609291615,609293279,1664
1360187928,609312340,11,5880,534.5454545,1360187917898,1360187925578,609302238,609309918,7680
1360187928,609312376,10,4433,443.3,1360187919396,1360187920356,609303772,609304732,960
1360187933,609317100,2,1170,585,1360187905850,1360187915834,609289950,609299934,9984
1360187944,609328328,3,168,56,1360187943187,1360187943571,609327515,609327899,384
1360187944,609328360,9,4387,487.4444444,1360187937012,1360187939188,609321372,609323548,2176
1360187944,609328392,3,168,56,1360187938259,1360187938899,609322651,609323291,640
1360187945,609329152,24,6071,252.9583333,1360187919684,1360187941188,609303836,609325340,21504
1360187945,609329152,28,16330,583.2142857,1360187919748,1360187930500,609303900,609314652,10752
1360187945,609329172,18,13346,741.4444444,1360187919794,1360187921650,609303966,609305822,1856
1360187952,609336292,3,168,56,1360187944055,1360187944631,609328347,609328923,576
1360187952,609336308,3,168,56,1360187945961,1360187946537,609330269,609330845,576
1360187952,609336376,3,168,56,1360187944996,1360187945572,609329372,609329948,576
1360187952,609336420,3,168,56,1360187946810,1360187947386,609331230,609331806,576
1360187952,609336424,3,168,56,1360187947699,1360187948275,609332123,609332699,576
1360187953,609337272,7,2757,393.8571429,1360187927435,1360187928331,609311707,609312603,896
1360187965,609349164,23,4879,212.1304348,1360187938808,1360187956920,609322972,609341084,18112
1360187969,609353116,18,5108,283.7777778,1360187941415,1360187963239,609325531,609347355,21824
1360187969,609353156,1,52,52,1360187942658,1360187942658,609326814,609326814,0
1360187976,609360292,15,3762,250.8,1360187973114,1360187973882,609357406,609358174,768
1360187981,609365288,2,110,55,1360187956348,1360187980668,609340636,609364956,24320
1360187984,609368280,3,168,56,1360187980931,1360187980995,609365211,609365275,64
1360187984,609368340,4,220,55,1360187980682,1360187981770,609365022,609366110,1088
1360187992,609376380,5,316,63.2,1360187973089,1360187987809,609357469,609372189,14720
1360188001,609385500,9,3463,384.7777778,1360187974056,1360187974632,609358556,609359132,576
1360188005,609389432,2,188,94,1360187978283,1360187978283,609362715,609362715,0
1360188005,609389484,1,75,75,1360187980728,1360187980728,609365212,609365212,0
1360188013,609397540,1,46,46,1360187987647,1360187987647,609372187,609372187,0
1360188017,609401512,1,75,75,1360187989661,1360187989661,609374173,609374173,0
1360188056,609440476,7,1569,224.1428571,1360188050751,1360188052159,609435227,609436635,1408
1360188061,609445448,1,52,52,1360188033049,1360188033049,609417497,609417497,0
1360188069,609453576,79,96606,1222.860759,1360188042523,1360188054555,609427099,609439131,12032
1360188069,609453576,33,32539,986.030303,1360188042523,1360188051803,609427099,609436379,9280
1360188088,609472404,2,131,65.5,1360188081990,1360188081990,609466394,609466394,0
1360188088,609472528,2,131,65.5,1360188084106,1360188084106,609468634,609468634,0
1360188096,609480528,3,210,70,1360188094476,1360188094796,609479004,609479324,320
1360188144,609528628,6,2110,351.6666667,1360188132391,1360188140327,609517019,609524955,7936
1360188152,609536648,7,2989,427,1360188142931,1360188149523,609527579,609534171,6592
1360188160,609544592,11,5716,519.6363636,1360188149577,1360188158025,609534169,609542617,8448
1360188168,609552508,3,138,46,1360188165599,1360188165599,609550107,609550107,0
1360188178,609561872,1,46,46,1360188151769,1360188151769,609535641,609535641,0
1360188178,609561872,95,119149,1254.2,1360188152088,1360188171096,609535960,609554968,19008
1360188186,609569776,1,46,46,1360188161722,1360188161722,609545498,609545498,0
1360188194,609577672,15,9464,630.9333333,1360188166431,1360188168095,609550103,609551767,1664
1360188194,609577740,1,52,52,1360188168859,1360188168859,609552599,609552599,0
1360188200,609584604,2,131,65.5,1360188197179,1360188197179,609581783,609581783,0
1360188200,609584656,2,131,65.5,1360188196551,1360188196551,609581207,609581207,0
1360188230,609613836,4,610,152.5,1360188203198,1360188203902,609587034,609587738,704
1360188232,609616608,16,7509,469.3125,1360188228794,1360188229754,609613402,609614362,960
1360188234,609617756,4,1596,399,1360188206540,1360188206668,609590296,609590424,128
1360188256,609640620,3,168,56,1360188252716,1360188252780,609637336,609637400,64
1360188256,609640620,3,168,56,1360188252844,1360188252972,609637464,609637592,128
1360188256,609640620,3,168,56,1360188252395,1360188252523,609637015,609637143,128
1360188257,609640696,3,168,56,1360188253511,1360188253639,609637207,609637335,128
1360188258,609641832,11,4026,366,1360188229951,1360188230335,609613783,609614167,384
1360188258,609641832,10,3368,336.8,1360188229951,1360188231295,609613783,609615127,1344
1360188258,609641836,8,2832,354,1360188229950,1360188230526,609613786,609614362,576
1360188262,609645804,1,52,52,1360188236637,1360188236637,609620441,609620441,0
1360188278,609661792,19,4499,236.7894737,1360188252774,1360188259238,609636566,609643030,6464
1360188278,609661800,1,52,52,1360188253214,1360188253214,609637014,609637014,0
1360188278,609661816,1,46,46,1360188253329,1360188253329,609637145,609637145,0
1360188280,609664608,3,168,56,1360188274358,1360188274486,609658966,609659094,128
1360188281,609664684,4,271,67.75,1360188274964,1360188275092,609658648,609658776,128
1360188281,609664684,3,168,56,1360188275092,1360188275156,609658776,609658840,64
1360188320,609704492,1,48,48,1360188289644,1360188289644,609674136,609674136,0
1360188346,609729852,1,46,46,1360188320811,1360188320811,609704663,609704663,0
1360188346,609729904,1,46,46,1360188319735,1360188319735,609703639,609703639,0
1360188353,609736708,2,131,65.5,1360188350395,1360188350395,609734103,609734103,0
1360188353,609736712,2,131,65.5,1360188350518,1360188350518,609734230,609734230,0
1360188378,609761908,2,131,65.5,1360188351154,1360188351154,609735062,609735062,0
1360188398,609781968,1,431,431,1360188371511,1360188371511,609755479,609755479,0
1360188482,609866184,1,433,433,1360188456606,1360188456606,609840790,609840790,0
1360188526,609910332,1,60,60,1360188499785,1360188499785,609884117,609884117,0
1360188529,609912780,7,1563,223.2857143,1360188522737,1360188524337,609906517,609908117,1600
1360188546,609930364,1,52,52,1360188521320,1360188521320,609905684,609905684,0
1360188569,609952784,3,168,56,1360188566445,1360188566701,609950229,609950485,256
1360188569,609952788,3,168,56,1360188566822,1360188566950,609950610,609950738,128
1360188569,609952792,4,271,67.75,1360188566947,1360188567011,609950739,609950803,64
1360188569,609952796,3,168,56,1360188567073,1360188567201,609950869,609950997,128
1360188569,609952868,3,168,56,1360188566616,1360188566680,609950484,609950548,64
1360188569,609952880,3,168,56,1360188567181,1360188567373,609951061,609951253,192
1360188586,609970408,20,5536,276.8,1360188561019,1360188566907,609945427,609951315,5888
1360188590,609974360,1,52,52,1360188565228,1360188565228,609949588,609949588,0
1360188590,609974360,1,46,46,1360188565164,1360188565164,609949524,609949524,0
1360188626,610010344,9,3463,384.7777778,1360188600825,1360188601401,609985169,609985745,576
1360188626,610010408,1,485,485,1360188599865,1360188599865,609984273,609984273,0
1360188633,610016812,3,168,56,1360188626701,1360188626829,610010513,610010641,128
1360188633,610016888,3,168,56,1360188626434,1360188626562,610010322,610010450,128
1360188633,610016892,4,271,67.75,1360188626752,1360188626880,610010644,610010772,128
1360188715,610098880,3,240,80,1360188687623,1360188712775,610071503,610096655,25152
1360188729,610112940,2,131,65.5,1360188721611,1360188721611,610105551,610105551,0
1360188799,610183400,1,52,52,1360188773119,1360188773119,610157519,610157519,0
1360188809,610192896,22,3872,176,1360188801974,1360188802358,610185870,610186254,384
1360188827,610211272,7,3438,491.1428571,1360188801023,1360188801343,610185295,610185615,320
1360188831,610215428,5,793,158.6,1360188805218,1360188809186,610189646,610193614,3968
1360188883,610267356,53,60821,1147.566038,1360188855145,1360188872297,610239501,610256653,17152
1360188883,610267472,2,1375,687.5,1360188855414,1360188855478,610239886,610239950,64
1360188915,610299492,2,337,168.5,1360188888929,1360188914657,610273421,610299149,25728
1360188921,610304972,3,168,56,1360188914152,1360188914216,610298124,610298188,64
1360188921,610305052,3,168,56,1360188914202,1360188914394,610298254,610298446,192
1360188939,610323572,20,4782,239.1,1360188913937,1360188926097,610298509,610310669,12160
1360188953,610336960,4,271,67.75,1360188945718,1360188945846,610329678,610329806,128
1360188953,610336964,3,168,56,1360188946098,1360188946226,610330062,610330190,128
1360188953,610336992,3,168,56,1360188946390,1360188946518,610330382,610330510,128
1360188953,610337028,2,110,55,1360188935473,1360188945521,610319501,610329549,10048
1360188953,610337036,3,168,56,1360188945514,1360188945578,610329550,610329614,64
1360188953,610337044,3,168,56,1360188945891,1360188946019,610329935,610330063,128
1360188953,610337044,3,168,56,1360188946209,1360188946401,610330253,610330445,192
1360188971,610355664,1,46,46,1360188945204,1360188945204,610329868,610329868,0
1360189017,610401032,5,1282,256.4,1360189008366,1360189009006,610392398,610393038,640
1360189036,610419808,1,52,52,1360189008268,1360189008268,610392076,610392076,0
1360189097,610481176,2,104,52,1360189095770,1360189096026,610479946,610480202,256
1360189105,610489168,7,1563,223.2857143,1360189096995,1360189098211,610481163,610482379,1216
1360189113,610497112,2,104,52,1360189112538,1360189112794,610496650,610496906,256
1360189121,610505176,18,4480,248.8888889,1360189114012,1360189115484,610498188,610499660,1472
1360189121,610505252,13,3583,275.6153846,1360189113933,1360189115533,610498185,610499785,1600
1360189121,610505252,13,3583,275.6153846,1360189113933,1360189115533,610498185,610499785,1600
1360189144,610527888,9,3463,384.7777778,1360189116091,1360189117115,610499979,610501003,1024
1360189212,610596040,7,2757,393.8571429,1360189187682,1360189187938,610571722,610571978,256
1360189220,610603920,2,339,169.5,1360189195610,1360189195610,610579530,610579530,0
1360189233,610617228,3,168,56,1360189225827,1360189226019,610610055,610610247,192
1360189233,610617232,3,168,56,1360189229280,1360189229472,610613512,610613704,192
1360189233,610617308,3,168,56,1360189225621,1360189225749,610609929,610610057,128
1360189233,610617316,3,168,56,1360189229389,1360189229453,610613705,610613769,64
1360189241,610625316,2,131,65.5,1360189236620,1360189236620,610620936,610620936,0
1360189249,610633304,2,110,55,1360189229593,1360189242457,610613897,610626761,12864
1360189252,610635860,19,4499,236.7894737,1360189225811,1360189233235,610609671,610617095,7424
1360189252,610635892,1,52,52,1360189226421,1360189226421,610610313,610610313,0
1360189256,610639876,1,46,46,1360189229446,1360189229446,610613322,610613322,0
1360189257,610641232,2,110,55,1360189239711,1360189249759,610623943,610633991,10048
1360189257,610641244,3,168,56,1360189249875,1360189250003,610634119,610634247,128
1360189257,610641276,10,6451,645.1,1360189253878,1360189254070,610638154,610638346,192
1360189257,610641280,11,8136,739.6363636,1360189254831,1360189255023,610639111,610639303,192
1360189257,610641284,9,6170,685.5555556,1360189255278,1360189255534,610639562,610639818,256
1360189257,610641316,3,168,56,1360189249676,1360189249740,610633992,610634056,64
1360189257,610641320,3,168,56,1360189249928,1360189250056,610634248,610634376,128
1360189257,610641356,13,6737,518.2307692,1360189254181,1360189254629,610638537,610638985,448
1360189265,610649232,3,168,56,1360189257186,1360189257314,610641418,610641546,128
1360189265,610649308,3,168,56,1360189257237,1360189257301,610641545,610641609,64
1360189280,610664056,10,4040,404,1360189254607,1360189255759,610638663,610639815,1152
1360189284,610667900,1,64,64,1360189257774,1360189257774,610641674,610641674,0
1360189284,610667972,1,46,46,1360189257316,1360189257316,610641288,610641288,0
1360189332,610715956,2,116,58,1360189303985,1360189304177,610687941,610688133,192
1360189344,610728020,1,46,46,1360189316722,1360189316722,610700742,610700742,0
1360189380,610764232,2,188,94,1360189355039,1360189355039,610739271,610739271,0
1360189400,610784120,7,3357,479.5714286,1360189373326,1360189376462,610757446,610760582,3136
1360189433,610817436,5,260,52,1360189427536,1360189431248,610811972,610815684,3712
1360189472,610856072,1,52,52,1360189444606,1360189444606,610828678,610828678,0
1360189520,610904184,1,52,52,1360189495628,1360189495628,610879812,610879812,0
1360189561,610945640,3,168,56,1360189552194,1360189556034,610936834,610940674,3840
1360189569,610953568,3,168,56,1360189568075,1360189568651,610952643,610953219,576
1360189569,610953608,3,168,56,1360189566117,1360189566693,610950725,610951301,576
1360189569,610953612,3,168,56,1360189567134,1360189567710,610951746,610952322,576
1360189577,610961592,4,271,67.75,1360189570801,1360189571377,610955393,610955969,576
1360189577,610961604,3,168,56,1360189568936,1360189569512,610953540,610954116,576
1360189577,610961604,4,271,67.75,1360189571686,1360189572390,610956290,610956994,704
1360189577,610961636,3,168,56,1360189572741,1360189573317,610957377,610957953,576
1360189577,610961640,3,168,56,1360189569859,1360189570435,610954499,610955075,576
1360189588,610972200,1,52,52,1360189562169,1360189562169,610946369,610946369,0
1360189592,610976204,1,52,52,1360189565813,1360189565813,610950017,610950017,0
1360189592,610976248,19,4066,214,1360189564491,1360189567435,610948739,610951683,2944
1360189600,610984240,1,46,46,1360189574035,1360189574035,610958275,610958275,0
1360189609,610993652,2,110,55,1360189592184,1360189602296,610976836,610986948,10112
1360189624,611008264,3,758,252.6666667,1360189596857,1360189597113,610981121,610981377,256
1360189644,611028348,1,52,52,1360189616293,1360189616293,611000641,611000641,0
1360189714,611097704,18,3532,196.2222222,1360189704810,1360189706986,611088514,611090690,2176
1360189728,611112436,7,3438,491.1428571,1360189701388,1360189703436,611085824,611087872,2048
1360189772,611156524,3,240,80,1360189747250,1360189767346,611131774,611151870,20096
1360189818,611201860,6,1123,187.1666667,1360189813516,1360189813580,611197376,611197440,64
1360189818,611201896,8,1292,161.5,1360189811624,1360189813096,611195520,611196992,1472
1360189826,611209752,6,759,126.5,1360189813049,1360189818297,611196801,611202049,5248
1360189826,611209824,10,6085,608.5,1360189813102,1360189818350,611196926,611202174,5248
1360189837,611220808,1,116,116,1360189811582,1360189811582,611195390,611195390,0
1360189837,611220808,1,116,116,1360189811582,1360189811582,611195390,611195390,0
1360189837,611220808,35,11563,330.3714286,1360189811646,1360189828158,611195454,611211966,16512
1360189837,611220892,7,3494,499.1428571,1360189811306,1360189811690,611195198,611195582,384
1360189837,611220896,1,116,116,1360189811496,1360189811496,611195392,611195392,0
1360189837,611220896,1,46,46,1360189811559,1360189811559,611195455,611195455,0
1360189837,611220916,1,116,116,1360189811475,1360189811475,611195391,611195391,0
1360189853,611236840,1,283,283,1360189828638,1360189828638,611212478,611212478,0
1360189869,611252868,7,1036,148,1360189843074,1360189868674,611226942,611252542,25600
1360189882,611265892,3,168,56,1360189878762,1360189879274,611262654,611263166,512
1360189905,611288916,1,64,64,1360189879634,1360189879634,611263550,611263550,0
1360189905,611288992,19,4495,236.5789474,1360189879173,1360189889797,611263165,611273789,10624
1360189909,611292988,1,52,52,1360189881672,1360189881672,611265660,611265660,0
1360189937,611321040,1,52,52,1360189911125,1360189911125,611295165,611295165,0
1360189954,611337824,3,168,56,1360189946542,1360189946734,611330366,611330558,192
1360189954,611337904,3,168,56,1360189946270,1360189946334,611330174,611330238,64
1360189954,611337904,3,168,56,1360189946396,1360189946460,611330300,611330364,64
1360189969,611353308,1,52,52,1360189943560,1360189943560,611327868,611327868,0
1360189973,611357368,2,339,169.5,1360189944781,1360189944781,611329149,611329149,0
1360189978,611362004,2,110,55,1360189967673,1360189977721,611351677,611361725,10048
1360189986,611369832,3,168,56,1360189978146,1360189978274,611361978,611362106,128
1360189986,611369832,3,168,56,1360189978276,1360189978404,611362108,611362236,128
1360189986,611369904,3,168,56,1360189977948,1360189978076,611361852,611361980,128
1360189986,611369912,3,168,56,1360189977812,1360189977940,611361724,611361852,128
1360190057,611441464,3,389,129.6666667,1360190029421,1360190035693,611413885,611420157,6272
1360190069,611453380,9,3463,384.7777778,1360190041726,1360190042238,611426106,611426618,512
1360190073,611457384,1,46,46,1360190045691,1360190045691,611430075,611430075,0
1360190077,611461564,1,52,52,1360190051015,1360190051015,611435579,611435579,0
1360190150,611533724,1,52,52,1360190123664,1360190123664,611507388,611507388,0
1360190170,611554080,2,131,65.5,1360190162410,1360190162410,611546490,611546490,0
1360190186,611569856,2,337,168.5,1360190161161,1360190161161,611545017,611545017,0
1360190202,611586048,2,110,55,1360190186120,1360190198920,611570168,611582968,12800
1360190202,611586060,3,168,56,1360190199295,1360190199359,611583355,611583419,64
1360190202,611586084,3,168,56,1360190199845,1360190199973,611583929,611584057,128
1360190202,611586132,3,168,56,1360190199285,1360190199413,611583417,611583545,128
1360190202,611586136,3,168,56,1360190199410,1360190199538,611583546,611583674,128
1360190202,611586136,4,271,67.75,1360190199664,1360190199728,611583800,611583864,64
1360190202,611586140,3,168,56,1360190199917,1360190200045,611584057,611584185,128
1360190214,611597816,19,4495,236.5789474,1360190186483,1360190192819,611570299,611576635,6336
1360190214,611597900,1,52,52,1360190186974,1360190186974,611570874,611570874,0
1360190226,611609856,1,64,64,1360190200392,1360190200392,611584248,611584248,0
1360190226,611610080,3,168,56,1360190219239,1360190219303,611603319,611603383,64
1360190226,611610152,3,168,56,1360190219424,1360190219488,611603576,611603640,64
1360190234,611618164,7,1569,224.1428571,1360190223636,1360190226580,611607800,611610744,2944
1360190294,611678320,2,116,58,1360190269302,1360190269494,611653622,611653814,192
1360190303,611686712,1,46,46,1360190278489,1360190278489,611662201,611662201,0
1360190315,611699148,7,2757,393.8571429,1360190288484,1360190288676,611672632,611672824,192
1360190323,611707060,6,1082,180.3333333,1360190295421,1360190318013,611679481,611702073,22592
1360190326,611710324,1,46,46,1360190298481,1360190298481,611682805,611682805,0
1360190447,611830704,1,52,52,1360190419359,1360190419359,611803063,611803063,0
1360190483,611867016,2,487,243.5,1360190457445,1360190457445,611841461,611841461,0
1360190491,611874804,12,3369,280.75,1360190485816,1360190486136,611869620,611869940,320
1360190511,611894956,9,3463,384.7777778,1360190484770,1360190485346,611868726,611869302,576
1360190527,611910932,1,52,52,1360190500664,1360190500664,611884596,611884596,0
1360190527,611910976,20,4526,226.3,1360190498893,1360190522317,611882869,611906293,23424
1360190531,611914784,4,208,52,1360190529101,1360190530765,611912885,611914549,1664
1360190531,611914940,1,56,56,1360190504944,1360190504944,611888884,611888884,0
1360190539,611922668,2,104,52,1360190532801,1360190536641,611916469,611920309,3840
1360190555,611938696,2,104,52,1360190544357,1360190554341,611928053,611938037,9984
1360190575,611958948,2,188,94,1360190547238,1360190547238,611931186,611931186,0
1360190603,611986804,3,168,56,1360190598263,1360190598391,611982067,611982195,128
1360190611,611994720,30,4621,154.0333333,1360190603788,1360190604812,611987508,611988532,1024
1360190611,611994724,20,3574,178.7,1360190607880,1360190608328,611991604,611992052,448
1360190611,611994764,20,3669,183.45,1360190606813,1360190607197,611990577,611990961,384
1360190611,611994768,25,3896,155.84,1360190602781,1360190603613,611986549,611987381,832
1360190611,611994808,20,4265,213.25,1360190608241,1360190608945,611992049,611992753,704
1360190611,611994812,25,4119,164.76,1360190604913,1360190605553,611988725,611989365,640
1360190611,611994812,2,131,65.5,1360190605358,1360190605358,611989170,611989170,0
1360190611,611994816,20,5648,282.4,1360190605545,1360190606057,611989361,611989873,512
1360190611,611994840,68,63151,928.6911765,1360190609107,1360190610771,611992947,611994611,1664
1360190611,611994840,14,6838,488.4285714,1360190606163,1360190606675,611990003,611990515,512
1360190611,611994840,64,6184,96.625,1360190606355,1360190607187,611990195,611991027,832
1360190611,611994848,26,3948,151.8461538,1360190602377,1360190603081,611986225,611986929,704
1360190619,612002744,11,5880,534.5454545,1360190607731,1360190613683,611991475,611997427,5952
1360190619,612002792,27,3889,144.037037,1360190611394,1360190611970,611995186,611995762,576
1360190619,612002832,2,110,55,1360190608476,1360190618524,611992308,612002356,10048
1360190619,612002868,26,4031,155.0384615,1360190610743,1360190611127,611994611,611994995,384
1360190623,612007244,2,110,55,1360190597950,1360190621502,611982194,612005746,23552
1360190627,612011160,9,4004,444.8888889,1360190601491,1360190602131,611985651,611986291,640
1360190643,612026744,3,168,56,1360190640500,1360190640628,612024244,612024372,128
1360190643,612026808,3,168,56,1360190639794,1360190639922,612023602,612023730,128
1360190643,612026808,3,168,56,1360190639922,1360190639986,612023730,612023794,64
1360190643,612026812,3,168,56,1360190640238,1360190640366,612024050,612024178,128
1360190643,612026812,3,168,56,1360190640109,1360190640237,612023921,612024049,128
1360190643,612026816,3,168,56,1360190640553,1360190640617,612024369,612024433,64
1360190667,612050844,2,110,55,1360190640653,1360190658957,612024497,612042801,18304
1360190675,612059260,1,285,285,1360190650670,1360190650670,612034930,612034930,0
1360190776,612159692,3,240,80,1360190750884,1360190760676,612134576,612144368,9792
1360190832,612215668,1,52,52,1360190805563,1360190805563,612189231,612189231,0
1360190832,612215668,6,3492,582,1360190805563,1360190827003,612189231,612210671,21440
1360190835,612218912,3,168,56,1360190827592,1360190828232,612211504,612212144,640
1360190835,612219620,3,168,56,1360190825988,1360190826628,612210608,612211248,640
1360190843,612226936,4,247,61.75,1360190828591,1360190842735,612212527,612226671,14144
1360190860,612243840,22,4826,219.3636364,1360190832718,1360190854222,612216558,612238062,21504
1360190860,612243852,1,52,52,1360190834305,1360190834305,612218157,612218157,0
1360190868,612251784,1,52,52,1360190842503,1360190842503,612226287,612226287,0
1360190904,612288012,9,3463,384.7777778,1360190878497,1360190879585,612262509,612263597,1088
1360190916,612300124,1,52,52,1360190889969,1360190889969,612274093,612274093,0
1360190995,612379012,8,368,46,1360190993119,1360190994271,612377131,612378283,1152
1360190996,612380204,1,46,46,1360190971359,1360190971359,612355563,612355563,0
1360191003,612386972,73381,102301524,1394.114607,1360189077130,1360191002826,610461102,612386798,1925696
1360191004,612388160,3,611,203.6666667,1360190979597,1360190979917,612363757,612364077,320
1360191005,3545668872,5,230,46,1360190996542,1360190999294,3545660414,3545663166,2752
1360191048,612432276,9,1833,203.6666667,1360191021591,1360191039767,612405867,612424043,18176
1360191124,612508556,7,1741,248.7142857,1360191099198,1360191102206,612483754,612486762,3008
1360191163,612547020,3,796,265.3333333,1360191149589,1360191157973,612533609,612541993,8384
1360191185,612568688,4,1130,282.5,1360191160161,1360191161121,612543849,612544809,960
1360191205,612588772,2,304,152,1360191177740,1360191177740,612561512,612561512,0
1360191206,3545869512,4,591,147.75,1360191178857,1360191179241,3545842369,3545842753,384
1360191206,3545869516,3,539,179.6666667,1360191179110,1360191179174,3545842626,3545842690,64
1360191245,612629012,3,611,203.6666667,1360191219739,1360191220059,612603751,612604071,320
1360191261,3545924868,11,2098,190.7272727,1360191257861,1360191259333,3545921729,3545923201,1472
1360191267,612651080,3,611,203.6666667,1360191257687,1360191259927,612641767,612644007,2240
1360191267,612651088,2,92,46,1360191259855,1360191259855,612643943,612643943,0
1360191267,612651088,4,602,150.5,1360191258319,1360191259855,612642407,612643943,1536
1360191267,612651092,2,98,49,1360191258382,1360191259854,612642474,612643946,1472
1360191286,3545949572,1,46,46,1360191259628,1360191259628,3545923200,3545923200,0
1360191286,3545949624,1,46,46,1360191259577,1360191259577,3545923201,3545923201,0
1360191495,612878992,1,48,48,1360191466540,1360191466540,612850532,612850532,0
1360191562,612945844,9483,13191039,1391.019614,1360191003008,1360191259584,612386852,612643428,256576
1360191898,613282516,1,60,60,1360191873497,1360191873497,613258013,613258013,0
1360191958,613342492,1,60,60,1360191931059,1360191931059,613315551,613315551,0
1360192035,613418748,1,60,60,1360192010778,1360192010778,613394526,613394526,0
1360192047,613430800,1,60,60,1360192020836,1360192020836,613404636,613404636,0
1360192119,613502788,1,60,60,1360192092208,1360192092208,613475996,613475996,0
1360193493,614877488,1,56,56,1360193468383,1360193468383,614852871,614852871,0
1360194600,615984144,18,4022,223.4444444,1360194573219,1360194576355,615957363,615960499,3136
1360194600,615984224,8,2851,356.375,1360194573653,1360194574997,615957877,615959221,1344
1360194600,615984224,8,3443,430.375,1360194573842,1360194575186,615958066,615959410,1344
1360194615,615999280,3,168,56,1360194613594,1360194614554,615997874,615998834,960
1360194623,616007296,3,168,56,1360194615050,1360194615626,615999346,615999922,576
1360194640,616024180,1,52,52,1360194615805,1360194615805,615999985,615999985,0
1360194640,616024296,17,3962,233.0588235,1360194614156,1360194617420,615998452,616001716,3264
1360194644,616028160,1,64,64,1360194616083,1360194616083,616000243,616000243,0
1360194696,616080156,2,131,65.5,1360194694996,1360194694996,616079152,616079152,0
1360194711,616095352,4,220,55,1360194704273,1360194708753,616088625,616093105,4480
1360194727,616111400,9,2934,326,1360194711521,1360194725217,616095921,616109617,13696
1360194728,616112408,1,198,198,1360194703705,1360194703705,616088113,616088113,0
1360194732,616116356,9,3562,395.7777778,1360194705550,1360194709454,616089906,616093810,3904
1360194732,616116380,8,2872,359,1360194705973,1360194708981,616090353,616093361,3008
1360194732,616116440,7,2419,345.5714286,1360194705915,1360194709307,616090355,616093747,3392
1360194735,616119436,4,271,67.75,1360194731388,1360194733116,616115824,616117552,1728
1360194735,616119444,3,168,56,1360194727094,1360194727926,616111538,616112370,832
1360194735,616119444,3,168,56,1360194728309,1360194729333,616112753,616113777,1024
1360194735,616119452,2,110,55,1360194711535,1360194728303,616095987,616112755,16768
1360194735,616119476,3,168,56,1360194729621,1360194730389,616114097,616114865,768
1360194735,616119476,24,12052,502.1666667,1360194725205,1360194730645,616109681,616115121,5440
1360194740,616124484,2,104,52,1360194713675,1360194735947,616098159,616120431,22272
1360194756,616140480,1,46,46,1360194730641,1360194730641,616115121,616115121,0
1360194764,616148488,2,1056,528,1360194737415,1360194737671,616121903,616122159,256
1360194776,616159752,13,3434,264.1538462,1360194768423,1360194774055,616152175,616157807,5632
1360194823,616207612,4,208,52,1360194814795,1360194820235,616199407,616204847,5440
1360194831,616215564,3,210,70,1360194828733,1360194830013,616213297,616214577,1280
1360194839,616223568,2,158,79,1360194832439,1360194837367,616217007,616221935,4928
1360194863,616247572,2,131,65.5,1360194857457,1360194857457,616242029,616242029,0
1360194873,616256704,1,64,64,1360194845911,1360194845911,616229615,616229615,0
1360194873,616256768,1,79,79,1360194848022,1360194848022,616231790,616231790,0
1360194877,616260696,16,3910,244.375,1360194848992,1360194851936,616232688,616235632,2944
1360194877,616260788,1,52,52,1360194850308,1360194850308,616234096,616234096,0
1360194881,616264812,1,64,64,1360194856491,1360194856491,616240303,616240303,0
1360194941,616325096,1,46,46,1360194913422,1360194913422,616297518,616297518,0
1360194977,616361220,1,52,52,1360194949651,1360194949651,616333871,616333871,0
1360195104,616487788,14,3324,237.4285714,1360195101374,1360195103230,616485162,616487018,1856
1360195104,616487792,15,3376,225.0666667,1360195101564,1360195103484,616485356,616487276,1920
1360195112,616495752,17,3716,218.5882353,1360195105765,1360195108581,616489517,616492333,2816
1360195112,616495832,21,10487,499.3809524,1360195103442,1360195105490,616487274,616489322,2048
1360195112,616495836,3,219,73,1360195111566,1360195111822,616495402,616495658,256
1360195112,616495836,25,6066,242.64,1360195108494,1360195110862,616492330,616494698,2368
1360195120,616503748,17,4121,242.4117647,1360195117736,1360195119528,616501484,616503276,1792
1360195120,616503752,3,168,56,1360195118053,1360195118693,616501805,616502445,640
1360195120,616503756,12,3253,271.0833333,1360195112478,1360195114142,616496234,616497898,1664
1360195120,616503756,15,6898,459.8666667,1360195110495,1360195112479,616494251,616496235,1984
1360195120,616503760,3,168,56,1360195112733,1360195113501,616496493,616497261,768
1360195120,616503760,3,168,56,1360195115034,1360195115610,616498794,616499370,576
1360195120,616503792,3,168,56,1360195113531,1360195114043,616497323,616497835,512
1360195120,616503796,3,168,56,1360195116919,1360195117559,616500715,616501355,640
1360195120,616503836,17,3454,203.1764706,1360195114960,1360195117648,616498796,616501484,2688
1360195120,616503836,31,4588,148,1360195110671,1360195113039,616494507,616496875,2368
1360195120,616503844,3,168,56,1360195115911,1360195116551,616499755,616500395,640
1360195128,616511796,55,58458,1062.872727,1360195119734,1360195123510,616503530,616507306,3776
1360195128,616511840,19,5077,267.2105263,1360195123469,1360195125773,616507309,616509613,2304
1360195136,616520024,29,4205,145,1360195126037,1360195128981,616510061,616513005,2944
1360195137,616521652,1,52,52,1360195111454,1360195111454,616496106,616496106,0
1360195141,616525648,1,46,46,1360195113507,1360195113507,616498155,616498155,0
1360195169,616553644,3,458,152.6666667,1360195142950,1360195143462,616527594,616528106,512
1360195214,616597696,1,46,46,1360195186392,1360195186392,616570088,616570088,0
1360195408,616792236,7,1563,223.2857143,1360195406329,1360195407545,616790565,616791781,1216
1360195408,616792236,7,1569,224.1428571,1360195406333,1360195407549,616790569,616791785,1216
1360195542,616925872,4,755,188.75,1360195514214,1360195514854,616898086,616898726,640
1360195553,616936768,13,3161,243.1538462,1360195544206,1360195544974,616927974,616928742,768
1360195570,616953896,20,21861,1093.05,1360195544715,1360195545227,616928611,616929123,512
1360195610,616993992,5,726,145.2,1360195584171,1360195605739,616968163,616989731,21568
1360195689,617072892,11,5880,534.5454545,1360195681103,1360195687247,617064995,617071139,6144
1360195706,617090120,1,52,52,1360195678569,1360195678569,617062689,617062689,0
1360195745,617128956,15,3759,250.6,1360195736974,1360195737550,617120930,617121506,576
1360195754,617138064,2,337,168.5,1360195728993,1360195728993,617113057,617113057,0
1360195762,617146196,9,3463,384.7777778,1360195737756,1360195738140,617121952,617122336,384
1360195810,617194120,1,52,52,1360195785003,1360195785003,617169123,617169123,0
1360195865,617249268,2,131,65.5,1360195858003,1360195858003,617242271,617242271,0
1360195870,617254176,1,52,52,1360195842482,1360195842482,617226658,617226658,0
1360196018,617402320,2,339,169.5,1360195992989,1360195992989,617377309,617377309,0
1360196094,617478372,1,52,52,1360196069350,1360196069350,617453722,617453722,0
1360196126,617510516,2,188,94,1360196100888,1360196100888,617485404,617485404,0
1360196250,617633872,4,184,46,1360196247064,1360196247064,617630936,617630936,0
1360196275,617658700,1,285,285,1360196246791,1360196246791,617630491,617630491,0
1360196279,617662996,9,3463,384.7777778,1360196251999,1360196252639,617635995,617636635,640
1360196363,617747104,1,52,52,1360196336623,1360196336623,617720727,617720727,0
1360196378,617761892,2,131,65.5,1360196372611,1360196372611,617756503,617756503,0
1360196435,617819332,2,188,94,1360196410122,1360196410122,617794454,617794454,0
1360196531,617915524,2,337,168.5,1360196503239,1360196521607,617887763,617906131,18368
1360196559,617943576,2,188,94,1360196532949,1360196532949,617917525,617917525,0
1360196656,618039868,3,389,129.6666667,1360196628696,1360196637336,618012564,618021204,8640
1360196676,618059924,7,3101,443,1360196648478,1360196648798,618032402,618032722,320
1360196694,618078616,1,46,46,1360196665065,1360196665065,618049681,618049681,0
1360196722,618106140,4,184,46,1360196716552,1360196716552,618100692,618100692,0
1360196744,618128116,9,3463,384.7777778,1360196716573,1360196717149,618100689,618101265,576
1360196756,618140248,1,285,285,1360196731673,1360196731673,618115921,618115921,0
1360196842,618226244,3,210,70,1360196836894,1360196837150,618221138,618221394,256
1360196884,618268404,3,240,80,1360196855996,1360196861564,618240400,618245968,5568
1360196890,618274284,2,104,52,1360196888434,1360196888626,618272718,618272910,192
1360196957,618340900,1,52,52,1360196929779,1360196929779,618313679,618313679,0
1360197033,618416940,2,339,169.5,1360197006089,1360197006089,618390029,618390029,0
1360197073,618457344,1,52,52,1360197047093,1360197047093,618431437,618431437,0
1360197101,618485320,2,188,94,1360197076302,1360197076302,618460622,618460622,0
1360197154,618538428,2,92,46,1360197146209,1360197146465,618530637,618530893,256
1360197173,618557372,7,3134,447.7142857,1360197147095,1360197148183,618531467,618532555,1088
1360197201,618585428,2,238,119,1360197174239,1360197175967,618558667,618560395,1728
1360197201,618585464,14,7092,506.5714286,1360197175354,1360197179322,618559818,618563786,3968
1360197226,618610484,13,3571,274.6923077,1360197219560,1360197221224,618604044,618605708,1664
1360197226,618610484,13,3571,274.6923077,1360197219560,1360197221032,618604044,618605516,1472
1360197226,618610540,8,368,46,1360197219181,1360197219181,618603721,618603721,0
1360197226,618610572,18,4516,250.8888889,1360197219472,1360197222032,618604044,618606604,2560
1360197250,618633720,9,3463,384.7777778,1360197223140,1360197224356,618606860,618608076,1216
1360197290,618673908,4,605,151.25,1360197261989,1360197262693,618645897,618646601,704
1360197346,618730576,2,131,65.5,1360197343370,1360197343370,618727946,618727946,0
1360197370,618753832,5,1223,244.6,1360197343920,1360197355440,618727752,618739272,11520
1360197382,618766076,2,469,234.5,1360197354556,1360197363324,618738632,618747400,8768
1360197414,618798228,1,52,52,1360197388389,1360197388389,618772617,618772617,0
1360197450,618834180,3,389,129.6666667,1360197423377,1360197423889,618807557,618808069,512
1360197546,618930524,3,374,124.6666667,1360197519160,1360197534136,618903684,618918660,14976
1360197562,618946536,6,2359,393.1666667,1360197534444,1360197535980,618918980,618920516,1536
1360197623,619006708,3,732,244,1360197595753,1360197596265,618979461,618979973,512
1360197643,619026968,7,1569,224.1428571,1360197636130,1360197636962,619020098,619020930,832
1360197643,619026972,4,184,46,1360197636641,1360197636641,619020613,619020613,0
1360197663,619046852,10,4467,446.7,1360197636760,1360197637656,619020612,619021508,896
1360197739,619123376,1,186,186,1360197714249,1360197714249,619098625,619098625,0
1360197743,619127076,3,567,189,1360197715382,1360197715766,619099458,619099842,384
1360197763,619147132,2,131,65.5,1360197756927,1360197756927,619141059,619141059,0
1360197791,619175256,1,283,283,1360197766017,1360197766017,619150273,619150273,0
1360197819,619203320,1,52,52,1360197791743,1360197791743,619176063,619176063,0
1360197892,619275696,2,339,169.5,1360197865327,1360197865327,619249023,619249023,0
1360197984,619367768,1,52,52,1360197956070,1360197956070,619339838,619339838,0
1360197984,619367856,1,52,52,1360197956175,1360197956175,619340031,619340031,0
1360198067,619451212,4,184,46,1360198061032,1360198061032,619445244,619445244,0
1360198088,619471988,7,2757,393.8571429,1360198061319,1360198061511,619445307,619445499,192
1360198091,619475200,3,138,46,1360198082998,1360198082998,619467198,619467198,0
1360198104,619488024,4,560,140,1360198078501,1360198083045,619462525,619467069,4544
1360198108,619492068,15,8801,586.7333333,1360198083130,1360198086202,619467198,619470270,3072
1360198163,619547220,4,184,46,1360198158240,1360198158240,619542460,619542460,0
1360198184,619568092,9,3463,384.7777778,1360198158621,1360198159645,619542713,619543737,1024
1360198211,619595252,7,1563,223.2857143,1360198205247,1360198205823,619589499,619590075,576
1360198212,619596152,4,808,202,1360198186082,1360198186914,619570234,619571066,832
1360198280,619664248,2,471,235.5,1360198254402,1360198272386,619638650,619656634,17984
1360198280,619664360,2,490,245,1360198254864,1360198255248,619639224,619639608,384
1360198283,619667372,2,131,65.5,1360198279301,1360198279301,619663673,619663673,0
1360198328,619712256,1,52,52,1360198301241,1360198301241,619685497,619685497,0
1360198456,619840372,1,52,52,1360198429443,1360198429443,619813815,619813815,0
1360198499,619883580,5,260,52,1360198495026,1360198498802,619879606,619883382,3776
1360198515,619899556,20,8577,428.85,1360198512457,1360198514825,619897013,619899381,2368
1360198515,619899596,12,3999,333.25,1360198511458,1360198514338,619896054,619898934,2880
1360198516,619899636,5,296,59.2,1360198510689,1360198513761,619894325,619897397,3072
1360198523,619907560,18,7263,403.5,1360198515972,1360198519876,619900532,619904436,3904
1360198537,619920756,1,52,52,1360198512617,1360198512617,619896373,619896373,0
1360198537,619920796,30,9344,311.4666667,1360198510528,1360198522496,619894324,619906292,11968
1360198541,619924692,8,2851,356.375,1360198512876,1360198514988,619896568,619898680,2112
1360198541,619924696,12,4972,414.3333333,1360198513319,1360198515687,619897015,619899383,2368
1360198541,619924704,1,64,64,1360198513759,1360198513759,619897463,619897463,0
1360198541,619924740,14,5370,383.5714286,1360198515321,1360198517753,619899061,619901493,2432
1360198549,619932816,26,18686,718.6923077,1360198522480,1360198544944,619906296,619928760,22464
1360198581,619964880,1,594,594,1360198554860,1360198554860,619938740,619938740,0
1360198585,619968768,25,7395,295.8,1360198557855,1360198579679,619941623,619963447,21824
1360198585,619968804,1,64,64,1360198559546,1360198559546,619943350,619943350,0
1360198585,619968808,53,22375,422.1698113,1360198559799,1360198580023,619943607,619963831,20224
1360198585,619968852,1,52,52,1360198558155,1360198558155,619942007,619942007,0
1360198585,619968868,10,5475,547.5,1360198558328,1360198559608,619942196,619943476,1280
1360198593,619976852,1,46,46,1360198564937,1360198564937,619948789,619948789,0
1360198605,619988868,1,64,64,1360198580024,1360198580024,619963892,619963892,0
1360198625,620008904,3,180,60,1360198598486,1360198599894,619982390,619983798,1408
1360198636,620019648,4,289,72.25,1360198635027,1360198635859,620018675,620019507,832
1360198636,620019680,3,210,70,1360198635382,1360198635638,620019062,620019318,256
1360198643,620027568,4,316,79,1360198635261,1360198642493,620019829,620027061,7232
1360198643,620027576,5,368,73.6,1360198635955,1360198639475,620020531,620024051,3520
1360198644,620027652,3,237,79,1360198636944,1360198643536,620020596,620027188,6592
1360198649,620032904,1,64,64,1360198624021,1360198624021,620007925,620007925,0
1360198649,620032936,1,64,64,1360198624306,1360198624306,620008242,620008242,0
1360198653,620036868,1,64,64,1360198625399,1360198625399,620009267,620009267,0
1360198653,620036868,1,64,64,1360198625399,1360198625399,620009267,620009267,0
1360198660,620043652,2,158,79,1360198644369,1360198652369,620028021,620036021,8000
1360198675,620059588,2,158,79,1360198651433,1360198669097,620036021,620053685,17664
1360198675,620059628,2,158,79,1360198650689,1360198667265,620035317,620051893,16576
1360198684,620067688,3,168,56,1360198681900,1360198683244,620065588,620066932,1344
1360198689,620073164,1,46,46,1360198661454,1360198661454,620045618,620045618,0
1360198689,620073256,2,110,55,1360198662195,1360198683763,620046451,620068019,21568
1360198689,620073320,21,4559,217.0952381,1360198664116,1360198668468,620048436,620052788,4352
1360198692,620075720,3,168,56,1360198683531,1360198684235,620067251,620067955,704
1360198693,620077160,1,79,79,1360198667858,1360198667858,620052018,620052018,0
1360198693,620077196,1,52,52,1360198666480,1360198666480,620050676,620050676,0
1360198701,620085216,1,46,46,1360198675098,1360198675098,620059314,620059314,0
1360198701,620085288,1,46,46,1360198676626,1360198676626,620060914,620060914,0
1360198788,620171652,3,168,56,1360198786894,1360198787278,620170546,620170930,384
1360198788,620171692,4,271,67.75,1360198785895,1360198786471,620169587,620170163,576
1360198788,620171708,3,168,56,1360198782487,1360198783703,620166195,620167411,1216
1360198788,620171724,3,168,56,1360198784324,1360198785732,620168048,620169456,1408
1360198796,620179676,3,168,56,1360198787640,1360198788472,620171316,620172148,832
1360198804,620187684,3,156,52,1360198799789,1360198800557,620183473,620184241,768
1360198809,620193384,21,5867,279.3809524,1360198782705,1360198787697,620167089,620172081,4992
1360198813,620197608,1,46,46,1360198787858,1360198787858,620172466,620172466,0
1360198813,620197612,1,52,52,1360198785678,1360198785678,620170290,620170290,0
1360198818,620201660,1,64,64,1360198789956,1360198789956,620173616,620173616,0
1360198820,620203752,5,296,59.2,1360198809835,1360198819243,620193587,620202995,9408
1360198828,620211704,3,168,56,1360198819608,1360198820248,620203312,620203952,640
1360198830,620213736,1,52,52,1360198802361,1360198802361,620186097,620186097,0
1360198846,620229744,1,64,64,1360198820464,1360198820464,620204208,620204208,0
1360198868,620251728,3,168,56,1360198861888,1360198862784,620245616,620246512,896
1360198890,620273672,18,4114,228.5555556,1360198862518,1360198865846,620246190,620249518,3328
1360198890,620273676,1,64,64,1360198863220,1360198863220,620246896,620246896,0
1360198890,620273788,1,52,52,1360198863814,1360198863814,620247602,620247602,0
1360198958,620342032,1,46,46,1360198933265,1360198933265,620317297,620317297,0
1360198966,620350116,1,487,487,1360198941564,1360198941564,620325680,620325680,0
1360198970,620354032,7,2985,426.4285714,1360198942097,1360198942417,620326129,620326449,320
1360198993,620376724,1,48,48,1360198964419,1360198964419,620348143,620348143,0
1360198998,620382168,19,3441,181.1052632,1360198973318,1360198996934,620357486,620381102,23616
1360199058,620442248,1,52,52,1360199032500,1360199032500,620416748,620416748,0
1360199070,620454240,9,3463,384.7777778,1360199045310,1360199045886,620429550,620430126,576
1360199110,620494348,2,339,169.5,1360199082191,1360199082191,620466539,620466539,0
1360199124,620507844,3,168,56,1360199117257,1360199117385,620501101,620501229,128
1360199124,620507904,3,168,56,1360199117389,1360199117517,620501293,620501421,128
1360199132,620515832,4,271,67.75,1360199127827,1360199127955,620511659,620511787,128
1360199132,620515868,2,110,55,1360199117618,1360199128498,620501486,620512366,10880
1360199132,620515904,3,168,56,1360199127628,1360199127692,620511532,620511596,64
1360199142,620526564,1,46,46,1360199116792,1360199116792,620501356,620501356,0
1360199154,620538592,3,240,80,1360199127004,1360199147420,620511596,620532012,20416
1360199164,620547964,2,110,55,1360199148879,1360199159183,620532843,620543147,10304
1360199172,620555984,2,131,65.5,1360199166075,1360199166075,620550059,620550059,0
1360199186,620570532,1,191,191,1360199158999,1360199158999,620543531,620543531,0
1360199187,620570680,16,10294,643.375,1360199161261,1360199163821,620544941,620547501,2560
1360199188,620571900,5,260,52,1360199182543,1360199186255,620566443,620570155,3712
1360199194,620578552,1,446,446,1360199167428,1360199167428,620551980,620551980,0
1360199204,620587996,3,168,56,1360199199984,1360199200176,620583980,620584172,192
1360199212,620595916,3,168,56,1360199210625,1360199210689,620594541,620594605,64
1360199212,620595948,2,110,55,1360199200352,1360199210592,620584300,620594540,10240
1360199212,620595948,7,1569,224.1428571,1360199205854,1360199206494,620589802,620590442,640
1360199212,620595964,4,271,67.75,1360199210701,1360199210829,620594665,620594793,128
1360199212,620596008,7,1563,223.2857143,1360199205732,1360199206372,620589740,620590380,640
1360199218,620602604,6,4002,667,1360199191759,1360199201615,620576363,620586219,9856
1360199220,620604272,3,168,56,1360199213594,1360199213658,620597866,620597930,64
1360199228,620611968,2,110,55,1360199214027,1360199224075,620597995,620608043,10048
1360199228,620612012,3,168,56,1360199224032,1360199224096,620608044,620608108,64
1360199230,620614616,21,4904,233.5238095,1360199202693,1360199206213,620587309,620590829,3520
1360199235,620618672,8,3515,439.375,1360199207987,1360199208691,620591659,620592363,704
1360199236,620620040,3,156,52,1360199224193,1360199234241,620608233,620618281,10048
1360199238,620622472,3,168,56,1360199233811,1360199233939,620618283,620618411,128
1360199259,620642832,1,64,64,1360199234580,1360199234580,620618412,620618412,0
1360199372,620756072,3,168,56,1360199370847,1360199370975,620754919,620755047,128
1360199372,620756076,3,168,56,1360199370973,1360199371101,620755049,620755177,128
1360199372,620756080,3,168,56,1360199371288,1360199371416,620755368,620755496,128
1360199372,620756152,3,168,56,1360199371088,1360199371216,620755240,620755368,128
1360199372,620756200,4,271,67.75,1360199370401,1360199370529,620754601,620754729,128
1360199372,620756200,3,168,56,1360199370529,1360199370657,620754729,620754857,128
1360199387,620771076,1,64,64,1360199360475,1360199360475,620744551,620744551,0
1360199391,620775056,1,52,52,1360199364337,1360199364337,620748393,620748393,0
1360199391,620775180,19,4066,214,1360199363574,1360199364790,620747754,620748970,1216
1360199396,620780152,2,110,55,1360199371408,1360199394192,620755560,620778344,22784
1360199403,620787180,9,3463,384.7777778,1360199376883,1360199377203,620761063,620761383,320
1360199420,620804112,4,271,67.75,1360199412537,1360199412665,620796649,620796777,128
1360199420,620804236,2,110,55,1360199402363,1360199412411,620786599,620796647,10048
1360199431,620815116,1,52,52,1360199403315,1360199403315,620787431,620787431,0
1360199431,620815236,1,46,46,1360199404858,1360199404858,620789094,620789094,0
1360199436,620820136,7,1569,224.1428571,1360199432606,1360199433118,620816742,620817254,512
1360199436,620820216,10,4433,443.3,1360199432911,1360199433615,620817127,620817831,704
1360199447,620831608,8,3312,414,1360199421449,1360199422409,620806057,620807017,960
1360199451,620835492,1,462,462,1360199425147,1360199425147,620809639,620809639,0
1360199452,620836152,9,4387,487.4444444,1360199447568,1360199447888,620831720,620832040,320
1360199459,620843420,21,5672,270.0952381,1360199432708,1360199453188,620817128,620837608,20480
1360199459,620843420,25,17690,707.6,1360199432898,1360199447554,620817318,620831974,14656
1360199459,620843424,19,13416,706.1052632,1360199433153,1360199447105,620817577,620831529,13952
1360199475,620859432,1,52,52,1360199447991,1360199447991,620832423,620832423,0
1360199491,620875544,6,396,66,1360199462981,1360199483077,620847525,620867621,20096
1360199499,620883504,2,245,122.5,1360199472751,1360199474863,620857255,620859367,2112
1360199499,620883512,12,4334,361.1666667,1360199474021,1360199476261,620858533,620860773,2240
1360199500,620884140,2,131,65.5,1360199497179,1360199497179,620881319,620881319,0
1360199516,620900228,2,127,63.5,1360199506563,1360199511555,620890791,620895783,4992
1360199516,620900312,2,127,63.5,1360199507054,1360199512046,620891366,620896358,4992
1360199519,620903556,6,396,66,1360199492988,1360199513020,620877544,620897576,20032
1360199540,620924268,6,340,56.66666667,1360199523417,1360199532121,620907685,620916389,8704
1360199543,620927508,4,510,127.5,1360199515178,1360199536618,620899686,620921126,21440
1360199543,620927516,12,5267,438.9166667,1360199515555,1360199516899,620900071,620901415,1344
1360199559,620943552,1,46,46,1360199531710,1360199531710,620916262,620916262,0
1360199564,620948548,7,1563,223.2857143,1360199562368,1360199563136,620946916,620947684,768
1360199580,620964568,31,10993,354.6129032,1360199578607,1360199579503,620963175,620964071,896
1360199600,620983880,2,252,126,1360199574043,1360199578395,620957923,620962275,4352
1360199604,620987932,7,3438,491.1428571,1360199578728,1360199578984,620962660,620962916,256
1360199604,620987976,3,735,245,1360199576317,1360199576893,620960293,620960869,576
1360199604,620988560,15,3376,225.0666667,1360199601654,1360199602102,620986214,620986662,448
1360199604,620988564,17,5490,322.9411765,1360199603058,1360199603570,620987622,620988134,512
1360199604,620988632,16,3428,214.25,1360199601453,1360199601773,620986085,620986405,320
1360199604,620988632,23,10589,460.3913043,1360199602028,1360199602476,620986660,620987108,448
1360199604,620988636,15,3599,239.9333333,1360199602600,1360199602920,620987236,620987556,320
1360199612,620996508,17,3575,210.2941176,1360199607271,1360199607591,620991779,620992099,320
1360199612,620996512,15,3409,227.2666667,1360199604068,1360199604388,620988580,620988900,320
1360199612,620996516,21,3577,170.3333333,1360199607714,1360199608162,620992230,620992678,448
1360199612,620996520,14,6838,488.4285714,1360199603742,1360199604062,620988262,620988582,320
1360199612,620996520,15,3314,220.9333333,1360199604827,1360199605211,620989347,620989731,384
1360199612,620996524,16,4057,253.5625,1360199605208,1360199605592,620989732,620990116,384
1360199612,620996528,55,58745,1068.090909,1360199605590,1360199607254,620990118,620991782,1664
1360199612,620996568,31,4468,144.1290323,1360199603886,1360199604334,620988454,620988902,448
1360199684,621068568,4,184,46,1360199677675,1360199677675,621062243,621062243,0
1360199685,621068648,2,98,49,1360199663364,1360199678916,621047012,621062564,15552
1360199704,621088052,9,3463,384.7777778,1360199678254,1360199678574,621062306,621062626,320
1360199720,621104144,1,186,186,1360199695571,1360199695571,621079715,621079715,0
1360199724,621108104,7,1908,272.5714286,1360199695932,1360199697084,621080036,621081188,1152
1360199724,621108600,5,260,52,1360199716171,1360199719691,621100771,621104291,3520
1360199804,621188604,6,447,74.5,1360199797960,1360199801800,621182564,621186404,3840
1360199820,621204608,2,158,79,1360199805891,1360199814083,621190499,621198691,8192
1360199821,621204680,3,156,52,1360199819297,1360199819937,621202977,621203617,640
1360199828,621212596,2,104,52,1360199819916,1360199821772,621204512,621206368,1856
1360199844,621228604,3,168,56,1360199836293,1360199836421,621220897,621221025,128
1360199845,621228672,3,168,56,1360199837415,1360199837479,621221087,621221151,64
1360199853,621236692,2,110,55,1360199837589,1360199847637,621221281,621231329,10048
1360199856,621240412,1,79,79,1360199830598,1360199830598,621215010,621215010,0
1360199864,621248444,19,4066,214,1360199839527,1360199840935,621223971,621225379,1408
1360199868,621252380,1,52,52,1360199840038,1360199840038,621224418,621224418,0
1360199888,621272528,1,79,79,1360199863185,1360199863185,621247713,621247713,0
1360199917,621300864,2,110,55,1360199902567,1360199912615,621286431,621296479,10048
1360199917,621300904,3,168,56,1360199912641,1360199912769,621296545,621296673,128
1360199920,621304484,1,64,64,1360199891900,1360199891900,621276384,621276384,0
1360199949,621332896,2,110,55,1360199933832,1360199943880,621317728,621327776,10048
1360199949,621332924,3,168,56,1360199943851,1360199943979,621327775,621327903,128
1360199949,621332928,3,168,56,1360199944168,1360199944616,621328096,621328544,448
1360199949,621332928,3,168,56,1360199944038,1360199944166,621327966,621328094,128
1360199964,621348548,1,52,52,1360199936635,1360199936635,621321183,621321183,0
1360199964,621348556,1,46,46,1360199937525,1360199937525,621322081,621322081,0
1360199996,621380596,8,1776,222,1360199968393,1360199993289,621352989,621377885,24896
1360199997,621380944,3,168,56,1360199994967,1360199995095,621378911,621379039,128
1360199997,621380944,3,168,56,1360199995094,1360199995158,621379038,621379102,64
1360200013,621396904,3,168,56,1360200005311,1360200005375,621389215,621389279,64
1360200013,621396996,2,110,55,1360199995172,1360200005220,621379168,621389216,10048
1360200021,621404992,3,156,52,1360200005349,1360200017253,621389341,621401245,11904
1360200025,621408648,17,3962,233.0588235,1360199998272,1360199999232,621381920,621382880,960
1360200037,621420644,9,3463,384.7777778,1360200009729,1360200010177,621393373,621393821,448
1360200037,621420920,3,168,56,1360200031152,1360200031216,621415072,621415136,64
1360200053,621436940,2,110,55,1360200031257,1360200045401,621415197,621429341,14144
1360200061,621444672,20,4691,234.55,1360200034661,1360200035941,621418333,621419613,1280
1360200061,621444780,1,52,52,1360200034809,1360200034809,621418589,621418589,0
1360200061,621444784,8,3139,392.375,1360200035445,1360200036149,621419229,621419933,704
1360200061,621444936,10,6516,651.6,1360200056670,1360200056734,621440606,621440670,64
1360200061,621444940,9,6216,690.6666667,1360200056856,1360200056920,621440796,621440860,64
1360200061,621444984,9,6340,704.4444444,1360200055728,1360200055920,621439712,621439904,192
1360200061,621444988,9,6256,695.1111111,1360200056108,1360200056300,621440096,621440288,192
1360200061,621445060,10,6496,649.6,1360200056355,1360200056419,621440415,621440479,64
1360200109,621493036,7,1569,224.1428571,1360200102457,1360200103097,621486493,621487133,640
1360200133,621516984,2,131,65.5,1360200129775,1360200129775,621513759,621513759,0
1360200141,621525000,3,168,56,1360200134494,1360200134558,621518494,621518558,64
1360200149,621532984,4,271,67.75,1360200144685,1360200144813,621528669,621528797,128
1360200157,621541120,2,131,65.5,1360200155364,1360200155364,621539484,621539484,0
1360200161,621544856,1,64,64,1360200134701,1360200134701,621518557,621518557,0
1360200173,621557028,3,168,56,1360200165823,1360200165951,621549851,621549979,128
1360200173,621557032,3,168,56,1360200166014,1360200166142,621550046,621550174,128
1360200173,621557064,3,168,56,1360200167709,1360200167837,621551773,621551901,128
1360200173,621557108,3,168,56,1360200166065,1360200166321,621550173,621550429,256
1360200193,621576924,1,46,46,1360200167722,1360200167722,621551646,621551646,0
1360200337,621721188,9,3463,384.7777778,1360200310045,1360200310429,621694233,621694617,384
1360200365,621749444,3,168,56,1360200361436,1360200361564,621745880,621746008,128
1360200365,621749448,4,271,67.75,1360200362136,1360200362264,621746584,621746712,128
1360200365,621749492,3,168,56,1360200361579,1360200361707,621746071,621746199,128
1360200365,621749516,3,168,56,1360200361750,1360200361878,621746266,621746394,128
1360200365,621749516,3,168,56,1360200361877,1360200362005,621746393,621746521,128
1360200365,621749520,3,168,56,1360200362257,1360200362449,621746777,621746969,192
1360200381,621765548,2,110,55,1360200362485,1360200376757,621747033,621761305,14272
1360200389,621773208,21,5588,266.0952381,1360200361929,1360200363529,621746137,621747737,1600
1360200389,621773212,1,52,52,1360200362948,1360200362948,621747160,621747160,0
1360200393,621777216,2,110,55,1360200372864,1360200382912,621757080,621767128,10048
1360200405,621789472,2,110,55,1360200392768,1360200402816,621777240,621787288,10048
1360200410,621793664,1,64,64,1360200383466,1360200383466,621767130,621767130,0
1360200437,621821496,6,447,74.5,1360200429994,1360200433834,621814490,621818330,3840
1360200437,621821496,5,260,52,1360200430439,1360200434087,621814935,621818583,3648
1360200453,621837512,2,158,79,1360200437977,1360200446233,621822489,621830745,8256
1360200453,621837512,2,104,52,1360200437977,1360200445785,621822489,621830297,7808
1360200469,621853596,2,104,52,1360200455684,1360200465668,621840280,621850264,9984
1360200490,621873872,1,79,79,1360200463320,1360200463320,621847192,621847192,0
1360200493,621877572,2,104,52,1360200475739,1360200485723,621860311,621870295,9984
1360200522,621906064,1,79,79,1360200496089,1360200496089,621880153,621880153,0
1360200742,622125712,3,168,56,1360200735221,1360200735349,622118933,622119061,128
1360200742,622125732,3,168,56,1360200735390,1360200735454,622119122,622119186,64
1360200742,622125736,3,168,56,1360200735452,1360200735964,622119188,622119700,512
1360200750,622133656,6,348,58,1360200735723,1360200749035,622119379,622132691,13312
1360200758,622141664,3,168,56,1360200754788,1360200754980,622138452,622138644,192
1360200774,622157760,2,104,52,1360200755329,1360200767937,622139089,622151697,12608
1360200779,622162636,20,5534,276.7,1360200753664,1360200762368,622137300,622146004,8704
1360200782,622165692,4,271,67.75,1360200776007,1360200776071,622159699,622159763,64
1360200782,622165692,3,168,56,1360200776133,1360200776261,622159825,622159953,128
1360200782,622165796,3,168,56,1360200776222,1360200776350,622160018,622160146,128
1360200790,622173708,2,110,55,1360200776439,1360200787831,622160147,622171539,11392
1360200806,622189692,3,168,56,1360200799624,1360200799688,622183316,622183380,64
1360200918,622302224,13,3571,274.6923077,1360200913647,1360200914479,622297871,622298703,832
1360200918,622302312,13,3571,274.6923077,1360200913559,1360200914455,622297871,622298767,896
1360200918,622302312,18,4468,248.2222222,1360200913558,1360200914006,622297870,622298318,448
1360200918,622302320,13,3583,275.6153846,1360200914383,1360200915023,622298703,622299343,640
1360200939,622323156,9,3463,384.7777778,1360200914419,1360200914995,622298575,622299151,576
1360200971,622355180,7,2757,393.8571429,1360200946458,1360200946778,622330638,622330958,320
1360201038,622422436,2,131,65.5,1360201034587,1360201034587,622419023,622419023,0
1360201111,622495464,1,186,186,1360201085948,1360201085948,622470412,622470412,0
1360201115,622499396,12,5317,443.0833333,1360201087872,1360201089280,622472268,622473676,1408
1360201150,622534324,2,110,55,1360201132809,1360201142857,622517133,622527181,10048
1360201150,622534372,3,168,56,1360201142810,1360201142938,622527182,622527310,128
1360201159,622543476,20,4240,212,1360201134065,1360201136305,622518541,622520781,2240
1360201159,622543484,1,52,52,1360201134247,1360201134247,622518731,622518731,0
1360201159,622543516,1,46,46,1360201132487,1360201132487,622517003,622517003,0
1360201163,622547472,10,4991,499.1,1360201135156,1360201135540,622519628,622520012,384
1360201166,622550344,2,110,55,1360201143029,1360201161973,622527373,622546317,18944
1360201166,622550408,2,110,55,1360201153012,1360201163252,622537420,622547660,10240
1360201182,622566308,5,483,96.6,1360201175831,1360201180887,622560139,622565195,5056
1360201182,622566308,3,172,57.33333333,1360201175831,1360201180887,622560139,622565195,5056
1360201182,622566352,2,112,56,1360201178222,1360201180846,622562574,622565198,2624
1360201182,622566352,2,112,56,1360201178220,1360201180844,622562572,622565196,2624
1360201182,622566388,58,76063,1311.431034,1360201175750,1360201180806,622560138,622565194,5056
1360201182,622566388,2,112,56,1360201175750,1360201180806,622560138,622565194,5056
1360201182,622566428,4,356,89,1360201178144,1360201180768,622562572,622565196,2624
1360201182,622566428,3,164,54.66666667,1360201178144,1360201180768,622562572,622565196,2624
1360201192,622575836,2,970,485,1360201166447,1360201166703,622550283,622550539,256
1360201192,622575872,1,64,64,1360201163854,1360201163854,622547726,622547726,0
1360201196,622579796,10,5265,526.5,1360201170008,1360201173976,622553804,622557772,3968
1360201200,622583884,6,953,158.8333333,1360201175423,1360201176447,622559307,622560331,1024
1360201204,622587776,4,537,134.25,1360201176684,1360201177004,622560460,622560780,320
1360201204,622587784,3,485,161.6666667,1360201177318,1360201177382,622561102,622561166,64
1360201204,622587808,5,594,118.8,1360201177421,1360201177549,622561229,622561357,128
1360201204,622587808,4,537,134.25,1360201177611,1360201177675,622561419,622561483,64
1360201204,622587864,4,537,134.25,1360201177107,1360201177107,622560971,622560971,0
1360201204,622587868,4,537,134.25,1360201177362,1360201177426,622561230,622561294,64
1360201204,622587896,4,537,134.25,1360201177525,1360201177589,622561421,622561485,64
1360201212,622595908,1,52,52,1360201187046,1360201187046,622570954,622570954,0
1360201232,622615868,1,499,499,1360201207057,1360201207057,622590925,622590925,0
1360201236,622619932,1,52,52,1360201211409,1360201211409,622595341,622595341,0
1360201244,622627840,9,3463,384.7777778,1360201216045,1360201216621,622599885,622600461,576
1360201246,622630336,8,1656,207,1360201241787,1360201242811,622626123,622627147,1024
1360201268,622651944,1,52,52,1360201242113,1360201242113,622626057,622626057,0
1360201342,622726408,2,131,65.5,1360201335921,1360201335921,622720329,622720329,0
1360201356,622739976,1,52,52,1360201329697,1360201329697,622713673,622713673,0
1360201406,622790436,16,4846,302.875,1360201402835,1360201403347,622787271,622787783,512
1360201412,622795964,1,52,52,1360201386283,1360201386283,622770247,622770247,0
1360201412,622795964,1,52,52,1360201386283,1360201386283,622770247,622770247,0
1360201412,622795964,1,52,52,1360201386286,1360201386286,622770250,622770250,0
1360201412,622795972,8,3146,393.25,1360201387174,1360201387430,622771146,622771402,256
1360201412,622796040,1,52,52,1360201386209,1360201386209,622770249,622770249,0
1360201412,622796040,1,52,52,1360201386209,1360201386209,622770249,622770249,0
1360201412,622796040,1,52,52,1360201386208,1360201386208,622770248,622770248,0
1360201422,622806436,3,168,56,1360201418260,1360201418900,622802696,622803336,640
1360201428,622812056,8,4629,578.625,1360201402318,1360201402894,622786374,622786950,576
1360201448,622832004,1,52,52,1360201423557,1360201423557,622807561,622807561,0
1360201448,622832124,17,3962,233.0588235,1360201421835,1360201424971,622805959,622809095,3136
1360201653,623036932,1,52,52,1360201627466,1360201627466,623011398,623011398,0
1360201668,623052352,1,52,52,1360201642597,1360201642597,623026949,623026949,0
1360201735,623118772,2,116,58,1360201734248,1360201734504,623118020,623118276,256
1360201735,623118772,3,168,56,1360201730343,1360201730983,623114115,623114755,640
1360201743,623126672,3,168,56,1360201737164,1360201737676,623120836,623121348,512
1360201743,623126708,3,168,56,1360201736232,1360201737064,623119940,623120772,832
1360201743,623126748,3,168,56,1360201735166,1360201735742,623118914,623119490,576
1360201760,623144580,18,4022,223.4444444,1360201732864,1360201736256,623117444,623120836,3392
1360201761,623144624,1,52,52,1360201734970,1360201734970,623118594,623118594,0
1360201761,623144664,1,52,52,1360201735636,1360201735636,623119300,623119300,0
1360201764,623148568,1,64,64,1360201737100,1360201737100,623121668,623121668,0
1360201804,623188612,3,458,152.6666667,1360201776798,1360201777182,623161410,623161794,384
1360201903,623286864,7,1569,224.1428571,1360201894537,1360201896009,623278401,623279873,1472
1360202049,623433588,1,46,46,1360202021746,1360202021746,623406334,623406334,0
1360202079,623462920,3,168,56,1360202070477,1360202072205,623454397,623456125,1728
1360202097,623481492,9,3463,384.7777778,1360202069008,1360202070224,623453500,623454716,1216
1360202097,623481584,1,46,46,1360202069176,1360202069176,623453760,623453760,0
1360202098,623481636,1,64,64,1360202072684,1360202072684,623456320,623456320,0
1360202098,623481636,20,4232,211.6,1360202072619,1360202077227,623456255,623460863,4608
1360202101,623485580,1,52,52,1360202073723,1360202073723,623458303,623458303,0
1360202159,623542920,4,271,67.75,1360202154123,1360202155019,623538043,623538939,896
1360202177,623561600,1,46,46,1360202151846,1360202151846,623536446,623536446,0
1360202178,623561716,28,7157,255.6071429,1360202152858,1360202160090,623536574,623543806,7232
1360202181,623565580,1,64,64,1360202154683,1360202154683,623539263,623539263,0
1360202182,623565672,1,52,52,1360202155587,1360202155587,623539259,623539259,0
1360202191,623575068,2,131,65.5,1360202190521,1360202190521,623574589,623574589,0
1360202199,623582996,3,168,56,1360202197824,1360202198720,623581820,623582716,896
1360202199,623583080,3,168,56,1360202190766,1360202191278,623574846,623575358,512
1360202199,623583112,3,168,56,1360202192075,1360202193227,623576187,623577339,1152
1360202199,623583124,3,168,56,1360202196546,1360202197058,623580670,623581182,512
1360202202,623585704,1,48,48,1360202175011,1360202175011,623558715,623558715,0
1360202207,623590996,3,168,56,1360202202112,1360202202624,623586108,623586620,512
1360202207,623591028,3,168,56,1360202200223,1360202200863,623584251,623584891,640
1360202207,623591036,3,168,56,1360202201176,1360202201816,623585212,623585852,640
1360202207,623591064,3,168,56,1360202199038,1360202199614,623583102,623583678,576
1360202218,623601632,17,3970,233.5294118,1360202192555,1360202198187,623576187,623581819,5632
1360202222,623605796,1,52,52,1360202195144,1360202195144,623578940,623578940,0
1360202230,623613784,1,64,64,1360202203221,1360202203221,623587005,623587005,0
1360202295,623679272,4,220,55,1360202288106,1360202289258,623672378,623673530,1152
1360202314,623697944,1,46,46,1360202289329,1360202289329,623673273,623673273,0
1360202455,623839360,9,1642,182.4444444,1360202432720,1360202449488,623817080,623833848,16768
1360202535,623919292,3,168,56,1360202533011,1360202533587,623917303,623917879,576
1360202558,623942328,17,3962,233.0588235,1360202532976,1360202536880,623917304,623921208,3904
1360202562,623946352,1,52,52,1360202534421,1360202534421,623918773,623918773,0
1360202562,623946424,1,64,64,1360202536975,1360202536975,623921399,623921399,0
1360202707,624090752,82,99119,1208.768293,1360202682798,1360202692718,624066550,624076470,9920
1360202707,624090796,3,458,152.6666667,1360202681473,1360202682241,624065269,624066037,768
1360202707,624090840,32,31839,994.96875,1360202682706,1360202693970,624066546,624077810,11264
1360202727,624111452,2,131,65.5,1360202721775,1360202721775,624106227,624106227,0
1360202727,624111488,2,131,65.5,1360202723341,1360202723341,624107829,624107829,0
1360202847,624231556,3,168,56,1360202843654,1360202844294,624228210,624228850,640
1360202855,624239584,5,1761,352.2,1360202848809,1360202853353,624233393,624237937,4544
1360202871,624255216,1,64,64,1360202844955,1360202844955,624229171,624229171,0
1360202875,624259196,19,4066,214,1360202847660,1360202852716,624231856,624236912,5056
1360202875,624259196,1,46,46,1360202847980,1360202847980,624232176,624232176,0
1360202875,624259312,1,52,52,1360202849211,1360202849211,624233523,624233523,0
1360202952,624335648,6,2064,344,1360202940303,1360202950287,624323951,624333935,9984
1360202971,624355368,83,99212,1195.325301,1360202946110,1360202956862,624330478,624341230,10752
1360202975,624359584,1,46,46,1360202950761,1360202950761,624335345,624335345,0
1360202992,624375956,2,131,65.5,1360202986781,1360202986781,624370737,624370737,0
1360203160,624544344,3,168,56,1360203156821,1360203157461,624541165,624541805,640
1360203160,624544380,3,168,56,1360203158323,1360203159091,624542703,624543471,768
1360203168,624552384,3,168,56,1360203161455,1360203161839,624545839,624546223,384
1360203168,624552424,4,271,67.75,1360203166981,1360203167621,624551405,624552045,640
1360203168,624552452,3,168,56,1360203159978,1360203161002,624544430,624545454,1024
1360203168,624552464,4,271,67.75,1360203165150,1360203165726,624549614,624550190,576
1360203168,624552496,3,168,56,1360203166014,1360203166590,624550510,624551086,576
1360203176,624560292,3,1544,514.6666667,1360203149834,1360203150218,624534126,624534510,384
1360203184,624568256,1,46,46,1360203157806,1360203157806,624542062,624542062,0
1360203184,624568380,20,4124,206.2,1360203159025,1360203163057,624543405,624547437,4032
1360203188,624572192,1,52,52,1360203161771,1360203161771,624545963,624545963,0
1360203208,624592176,1,52,52,1360203180349,1360203180349,624564525,624564525,0
1360203317,624700748,1,64,64,1360203290406,1360203290406,624674154,624674154,0
1360203381,624764872,1,78,78,1360203353705,1360203353705,624737577,624737577,0
1360203473,624857316,3,168,56,1360203467755,1360203468459,624852071,624852775,704
1360203497,624881028,1,64,64,1360203469068,1360203469068,624853096,624853096,0
1360203497,624881076,19,4066,214,1360203471261,1360203474205,624855337,624858281,2944
1360203497,624881176,1,52,52,1360203472504,1360203472504,624856680,624856680,0
1360203801,625185536,3,168,56,1360203798347,1360203799883,625182883,625184419,1536
1360203801,625185580,3,168,56,1360203797345,1360203797985,625181925,625182565,640
1360203801,625185612,3,168,56,1360203795136,1360203795712,625179748,625180324,576
1360203801,625185620,3,168,56,1360203796087,1360203797047,625180707,625181667,960
1360203809,625193552,3,168,56,1360203800892,1360203802108,625185444,625186660,1216
1360203809,625193560,3,168,56,1360203802418,1360203803058,625186978,625187618,640
1360203810,625193624,15,3760,250.6666667,1360203803034,1360203804442,625186658,625188066,1408
1360203810,625193636,3,168,56,1360203804304,1360203804688,625187940,625188324,384
1360203826,625210024,18,4057,225.3888889,1360203798537,1360203802633,625182561,625186657,4096
1360203826,625210056,1,52,52,1360203800683,1360203800683,625184739,625184739,0
1360203826,625210148,1,46,46,1360203800589,1360203800589,625184737,625184737,0
1360203830,625214136,9,3463,384.7777778,1360203804378,1360203805786,625188514,625189922,1408
1360203930,625313808,2,131,65.5,1360203925986,1360203925986,625309794,625309794,0
1360203990,625374472,7,2757,393.8571429,1360203962250,1360203963466,625346722,625347938,1216
1360204162,625545792,4,271,67.75,1360204155564,1360204156204,625539356,625539996,640
1360204162,625545792,4,271,67.75,1360204154477,1360204155245,625538269,625539037,768
1360204162,625545796,3,168,56,1360204156457,1360204157033,625540253,625540829,576
1360204162,625545824,4,271,67.75,1360204157519,1360204158223,625541343,625542047,704
1360204183,625566900,19,4066,214,1360204157827,1360204160835,625541727,625544735,3008
1360204187,625570736,1,52,52,1360204159524,1360204159524,625543260,625543260,0
1360204202,625585788,3,219,73,1360204199664,1360204200816,625583452,625584604,1152
1360204202,625585828,3,168,56,1360204198282,1360204199050,625582110,625582878,768
1360204210,625593852,3,156,52,1360204204082,1360204206450,625587934,625590302,2368
1360204216,625600356,6,1332,222,1360204187640,1360204196664,625571996,625581020,9024
1360204218,625601828,2,104,52,1360204204808,1360204212040,625588636,625595868,7232
1360204227,625610952,3,192,64,1360204201548,1360204210508,625585500,625594460,8960
1360204235,625618892,8,3810,476.25,1360204210120,1360204212168,625594012,625596060,2048
1360204239,625622936,4,256,64,1360204212955,1360204234011,625596891,625617947,21056
1360204251,625634900,1,52,52,1360204226240,1360204226240,625610140,625610140,0
1360204258,625641780,3,168,56,1360204251129,1360204252153,625634909,625635933,1024
1360204258,625641780,3,168,56,1360204250166,1360204250806,625633946,625634586,640
1360204258,625641824,4,271,67.75,1360204253582,1360204254158,625637406,625637982,576
1360204258,625641828,4,271,67.75,1360204254216,1360204255176,625638044,625639004,960
1360204258,625641880,4,271,67.75,1360204255444,1360204256084,625639324,625639964,640
1360204266,625649796,8,1280,160,1360204258214,1360204262118,625642010,625645914,3904
1360204266,625649828,7,1980,282.8571429,1360204264264,1360204265416,625648092,625649244,1152
1360204274,625657796,2,104,52,1360204271463,1360204273127,625655259,625656923,1664
1360204274,625657840,13,7689,591.4615385,1360204261820,1360204269756,625645660,625653596,7936
1360204274,625657916,7,816,116.5714286,1360204261361,1360204267057,625645277,625650973,5696
1360204274,625657924,34,11324,333.0588235,1360204257638,1360204270502,625641562,625654426,12864
1360204279,625662948,1,46,46,1360204252494,1360204252494,625636442,625636442,0
1360204279,625662956,21,5676,270.2857143,1360204253000,1360204257736,625636956,625641692,4736
1360204279,625663004,1,52,52,1360204251670,1360204251670,625635674,625635674,0
1360204283,625666932,8,4064,508,1360204258014,1360204259806,625641946,625643738,1792
1360204283,625667008,1,46,46,1360204257557,1360204257557,625641565,625641565,0
1360204283,625667008,2,232,116,1360204257428,1360204257940,625641436,625641948,512
1360204283,625667092,2,232,116,1360204257344,1360204257792,625641436,625641884,448
1360204290,625674140,2,104,52,1360204276239,1360204283023,625660379,625667163,6784
1360204306,625690104,2,104,52,1360204293109,1360204303093,625677213,625687197,9984
1360204306,625690196,3,156,52,1360204297432,1360204302744,625681628,625686940,5312
1360204322,625706132,2,104,52,1360204309848,1360204319832,625693980,625703964,9984
1360204330,625714184,2,104,52,1360204312994,1360204322978,625697178,625707162,9984
1360204346,625730068,2,104,52,1360204329879,1360204339927,625713947,625723995,10048
1360204375,625759124,1,52,52,1360204349855,1360204349855,625733979,625733979,0
1360204439,625823248,1,60,60,1360204412512,1360204412512,625796760,625796760,0
1360204506,625890200,3,156,52,1360204498898,1360204503762,625883098,625887962,4864
1360204634,626018284,3,168,56,1360204631610,1360204632378,626015894,626016662,768
1360204658,626042312,3,168,56,1360204650012,1360204651036,626034324,626035348,1024
1360204660,626043892,23,6014,261.4782609,1360204635521,1360204641409,626019413,626025301,5888
1360204660,626043936,1,52,52,1360204634454,1360204634454,626018390,626018390,0
1360204680,626063896,1,64,64,1360204651838,1360204651838,626035734,626035734,0
1360204680,626063964,11,2504,227.6363636,1360204653240,1360204660152,626037204,626044116,6912
1360204688,626071872,1,46,46,1360204661525,1360204661525,626045397,626045397,0
1360204688,626071888,1,64,64,1360204663172,1360204663172,626047060,626047060,0
1360204690,626074300,3,168,56,1360204684135,1360204684711,626068435,626069011,576
1360204690,626074388,3,168,56,1360204684883,1360204685459,626069271,626069847,576
1360204690,626074396,3,168,56,1360204685767,1360204686151,626070163,626070547,384
1360204692,626075856,1,52,52,1360204666789,1360204666789,626050645,626050645,0
1360204692,626076004,23,5162,224.4347826,1360204665297,1360204673617,626049301,626057621,8320
1360204712,626096016,18,4014,223,1360204685510,1360204688454,626069526,626072470,2944
1360204712,626096048,1,64,64,1360204686819,1360204686819,626070867,626070867,0
1360204768,626152280,1,46,46,1360204740990,1360204740990,626125270,626125270,0
1360204794,626178372,13,3583,275.6153846,1360204791711,1360204793567,626176083,626177939,1856
1360204794,626178452,13,3583,275.6153846,1360204791632,1360204793488,626176084,626177940,1856
1360204796,626180196,18,4468,248.2222222,1360204791887,1360204793423,626176083,626177619,1536
1360204802,626186476,13,3571,274.6923077,1360204793465,1360204795193,626177941,626179669,1728
1360204820,626204424,9,3463,384.7777778,1360204793517,1360204794861,626177941,626179285,1344
1360204886,626270120,1,48,48,1360204858649,1360204858649,626242769,626242769,0
1360204922,626306388,2,131,65.5,1360204914700,1360204914700,626299088,626299088,0
1360205034,626418600,4,208,52,1360205026039,1360205031287,626410639,626415887,5248
1360205051,626434844,2,104,52,1360205037994,1360205048042,626421838,626431886,10048
1360205075,626458736,2,104,52,1360205058135,1360205068119,626441871,626451855,9984
1360205105,626489176,1,52,52,1360205077665,1360205077665,626461841,626461841,0
1360205202,626585644,1,60,60,1360205176818,1360205176818,626560462,626560462,0
1360205330,626713908,1,60,60,1360205302502,1360205302502,626686410,626686410,0
1360205330,626713932,1,60,60,1360205302861,1360205302861,626686793,626686793,0
1360205450,626834168,1,60,60,1360205423136,1360205423136,626807304,626807304,0
1360205538,626922132,1,46,46,1360205510468,1360205510468,626894600,626894600,0
1360205538,626922216,12,5977,498.0833333,1360205513454,1360205515822,626897670,626900038,2368
1360205538,626922332,23,4372,190.0869565,1360205513341,1360205518589,626897673,626902921,5248
1360205539,626923460,3,168,56,1360205537278,1360205537854,626921738,626922314,576
1360205555,626939432,3,168,56,1360205551256,1360205551896,626935688,626936328,640
1360205555,626939436,3,168,56,1360205552274,1360205552850,626936710,626937286,576
1360205566,626950140,1,64,64,1360205538492,1360205538492,626922632,626922632,0
1360205566,626950164,7,420,60,1360205539749,1360205549221,626923913,626933385,9472
1360205566,626950164,10,6754,675.4,1360205538788,1360205558180,626922952,626942344,19392
1360205578,626962372,18,4022,223.4444444,1360205552274,1360205555602,626936646,626939974,3328
1360205578,626962376,10,5475,547.5,1360205552913,1360205554897,626937289,626939273,1984
1360205582,626966168,1,52,52,1360205553888,1360205553888,626938056,626938056,0
1360205630,627014360,2,96,48,1360205602718,1360205605726,626987078,626990086,3008
1360205783,627166780,1,52,52,1360205756257,1360205756257,627140037,627140037,0
1360205787,627171472,28,10856,387.7142857,1360205780268,1360205782636,627164740,627167108,2368
1360205807,627190656,1,198,198,1360205780445,1360205780445,627164101,627164101,0
1360205819,627203484,527,38706,73.4459203,1360205554974,1360205814366,626939458,627198850,259392
1360205823,627206796,1,52,52,1360205795473,1360205795473,627179269,627179269,0
1360205835,627218644,190,14775,77.76315789,1360205516777,1360205531881,626900421,626915525,15104
1360205899,627283468,3,168,56,1360205895855,1360205898095,627280323,627282563,2240
1360205899,627283468,3,168,56,1360205892399,1360205895023,627276867,627279491,2624
1360205907,627291548,4,220,55,1360205899166,1360205902558,627283714,627287106,3392
1360205907,627291548,3,168,56,1360205903005,1360205903709,627287553,627288257,704
1360205907,627291600,2,104,52,1360205897963,1360205898795,627282563,627283395,832
1360205919,627303104,1,52,52,1360205891417,1360205891417,627275521,627275521,0
1360205923,627307112,24,4723,196.7916667,1360205895443,1360205903635,627279555,627287747,8192
1360205923,627307228,1,46,46,1360205895326,1360205895326,627279554,627279554,0
1360205931,627315484,3,168,56,1360205924636,1360205928028,627309120,627312512,3392
1360205951,627335288,16,3305,206.5625,1360205924834,1360205944290,627309122,627328578,19456
1360205955,627339204,1,46,46,1360205929269,1360205929269,627313473,627313473,0
1360205955,627339396,1,52,52,1360205929077,1360205929077,627313473,627313473,0
1360205959,627343188,4,256,64,1360205934084,1360205955268,627318272,627339456,21184
1360205975,627359356,1,60,60,1360205950365,1360205950365,627334721,627334721,0
1360205979,627363272,3,411,137,1360205954287,1360205974319,627338559,627358591,20032
1360206011,627395436,2,274,137,1360205984141,1360205994125,627368577,627378561,9984
1360206028,627411708,2,110,55,1360206014246,1360206024550,627397954,627408258,10304
1360206036,627419720,7,1980,282.8571429,1360206029081,1360206029721,627412801,627413441,640
1360206036,627419756,10,6073,607.3,1360206026355,1360206032307,627410111,627416063,5952
1360206036,627419828,7,811,115.8571429,1360206025898,1360206032938,627409726,627416766,7040
1360206043,627427556,9,3614,401.5555556,1360206016470,1360206019286,627401026,627403842,2816
1360206043,627427556,18,4030,223.8888889,1360206016469,1360206026133,627401025,627410689,9664
1360206047,627431476,1,46,46,1360206020324,1360206020324,627404800,627404800,0
1360206047,627431560,35,11584,330.9714286,1360206020239,1360206031887,627404799,627416447,11648
1360206047,627431564,7,694,99.14285714,1360206020556,1360206045772,627405120,627430336,25216
1360206052,627435824,5,814,162.8,1360206047919,1360206050351,627431743,627434175,2432
1360206076,627459640,1,46,46,1360206048102,1360206048102,627431742,627431742,0
1360206076,627459640,1,52,52,1360206048102,1360206048102,627431742,627431742,0
1360206076,627459640,1,52,52,1360206048102,1360206048102,627431742,627431742,0
1360206076,627459680,2,658,329,1360206049152,1360206050368,627432832,627434048,1216
1360206095,627479588,1,60,60,1360206067892,1360206067892,627452480,627452480,0
1360206119,627503600,1,60,60,1360206091429,1360206091429,627476029,627476029,0
1360206196,627580196,4,208,52,1360206188603,1360206195387,627572799,627579583,6784
1360206224,627607764,2,104,52,1360206203560,1360206219048,627587324,627602812,15488
1360206268,627652184,2,104,52,1360206259653,1360206263365,627643837,627647549,3712
1360206276,627659964,1,52,52,1360206249824,1360206249824,627633788,627633788,0
1360206300,627684316,2,104,52,1360206294719,1360206297599,627679035,627681915,2880
1360206316,627700396,2,104,52,1360206303280,1360206313264,627687676,627697660,9984
1360206340,627724524,2,104,52,1360206323121,1360206333169,627707645,627717693,10048
1360206356,627740436,2,104,52,1360206343239,1360206353223,627727675,627737659,9984
1360206701,628085476,1,48,48,1360206675801,1360206675801,628060277,628060277,0
1360248558,669941484,1,46,46,1360248530799,1360248530799,669914283,669914283,0
1360250732,672115856,3,168,56,1360250724953,1360250726169,672108809,672110025,1216
1360250732,672115884,3,168,56,1360250729659,1360250730683,672113543,672114567,1024
1360250748,672131912,2,110,55,1360250727711,1360250741407,672111623,672125319,13696
1360250748,672131928,7,2315,330.7142857,1360250736847,1360250747471,672120775,672131399,10624
1360250757,672140560,11,2562,232.9090909,1360250728064,1360250742144,672111624,672125704,14080
1360250758,672141604,5,296,59.2,1360250739349,1360250750101,672122953,672133705,10752
1360250758,672141608,14,3332,238,1360250747854,1360250750926,672131462,672134534,3072
1360250759,672142480,8,4629,578.625,1360250733901,1360250736461,672117381,672119941,2560
1360250759,672142484,1,64,64,1360250731467,1360250731467,672114951,672114951,0
1360250763,672146492,15,5753,383.5333333,1360250736962,1360250757378,672120454,672140870,20416
1360250779,672162644,7,2380,340,1360250752748,1360250755436,672136392,672139080,2688
1360250779,672162644,2,120,60,1360250752746,1360250753002,672136390,672136646,256
1360250783,672166520,3,564,188,1360250757478,1360250759910,672140998,672143430,2432
1360250980,672364176,3,156,52,1360250975764,1360250978708,672359940,672362884,2944
1360250996,672380176,3,168,56,1360250989202,1360250989906,672373378,672374082,704
1360251004,672388088,4,220,55,1360250999083,1360251000427,672383171,672384515,1344
1360251004,672388100,19,4528,238.3157895,1360250999901,1360251002333,672384001,672386433,2432
1360251004,672388164,2,104,52,1360250996703,1360250998623,672380867,672382787,1920
1360251004,672388172,25,10841,433.64,1360250997081,1360251002521,672381253,672386693,5440
1360251004,672388208,21,5455,259.7619048,1360250993973,1360251002997,672378181,672387205,9024
1360251011,672394792,1,52,52,1360250983060,1360250983060,672366852,672366852,0
1360251012,672396080,20,5808,290.4,1360251002869,1360251005045,672386949,672389125,2176
1360251012,672396080,26,4196,161.3846154,1360251007156,1360251007924,672391236,672392004,768
1360251012,672396084,15,3410,227.3333333,1360251007726,1360251008110,672391810,672392194,384
1360251012,672396088,18,4680,260,1360250996908,1360251008684,672380996,672392772,11776
1360251012,672396088,21,8855,421.6666667,1360251003308,1360251008108,672387396,672392196,4800
1360251012,672396092,18,7485,415.8333333,1360251005033,1360251006377,672389125,672390469,1344
1360251012,672396132,15,7457,497.1333333,1360251006718,1360251007678,672390850,672391810,960
1360251012,672396168,16,5493,343.3125,1360251004955,1360251006107,672389123,672390275,1152
1360251012,672396168,14,4245,303.2142857,1360250999834,1360251004826,672384002,672388994,4992
1360251012,672396216,19,3570,187.8947368,1360251009644,1360251011820,672393860,672396036,2176
1360251015,672398848,1,46,46,1360250990681,1360250990681,672374529,672374529,0
1360251019,672402872,1,64,64,1360250994244,1360250994244,672378116,672378116,0
1360251020,672404080,3,156,52,1360251012209,1360251013809,672396289,672397889,1600
1360251020,672404160,2,104,52,1360251007396,1360251017188,672391556,672401348,9792
1360251027,672410772,1,64,64,1360251001320,1360251001320,672385092,672385092,0
1360251027,672410808,27,24642,912.6666667,1360250999364,1360251005892,672383172,672389700,6528
1360251027,672410852,29,5566,191.9310345,1360251002518,1360251017302,672386370,672401154,14784
1360251028,672412136,10,4434,443.4,1360251011897,1360251025913,672396033,672410049,14016
1360251031,672414840,8,2872,359,1360251006433,1360251006753,672390273,672390593,320
1360251031,672414860,1,52,52,1360251006607,1360251006607,672390467,672390467,0
1360251035,672418780,11,4091,371.9090909,1360251009758,1360251018078,672393538,672401858,8320
1360251036,672420148,3,1518,506,1360251033774,1360251034030,672417922,672418178,256
1360251036,672420220,17,4121,242.4117647,1360251033959,1360251035751,672418179,672419971,1792
1360251044,672428116,16,3511,219.4375,1360251038992,1360251040848,672423108,672424964,1856
1360251044,672428144,55,59209,1076.527273,1360251035824,1360251038960,672419968,672423104,3136
1360251044,672428200,20,3601,180.05,1360251040955,1360251042939,672425155,672427139,1984
1360251047,672430828,2,128,64,1360251022318,1360251025326,672406146,672409154,3008
1360251067,672450792,2,1056,528,1360251040913,1360251040977,672424705,672424769,64
1360251092,672476212,28,17148,612.4285714,1360251071727,1360251085935,672455939,672470147,14208
1360251099,672482832,3,753,251,1360251071976,1360251072424,672455808,672456256,448
1360251103,672486880,49,44989,918.1428571,1360251078331,1360251102779,672462211,672486659,24448
1360251107,672490908,1,46,46,1360251080414,1360251080414,672464322,672464322,0
1360251131,672514828,1,993,993,1360251102958,1360251102958,672486786,672486786,0
1360251132,672516252,2,131,65.5,1360251126341,1360251126341,672510593,672510593,0
1360251159,672542868,2,372,186,1360251133061,1360251134661,672516929,672518529,1600
1360251159,672542908,7,1375,196.4285714,1360251132379,1360251135451,672516287,672519359,3072
1360251164,672548284,2,131,65.5,1360251160419,1360251160419,672544703,672544703,0
1360251187,672570880,1,52,52,1360251161337,1360251161337,672545217,672545217,0
1360251219,672603180,1,64,64,1360251192524,1360251192524,672576704,672576704,0
1360251228,672612304,3,210,70,1360251222351,1360251222607,672606655,672606911,256
1360251300,672684272,2,110,55,1360251285231,1360251295983,672669503,672680255,10752
1360251300,672684332,4,220,55,1360251295283,1360251295923,672679615,672680255,640
1360251303,672687304,2,489,244.5,1360251278541,1360251278541,672662845,672662845,0
1360251303,672687304,1,46,46,1360251278605,1360251278605,672662909,672662909,0
1360251308,672692380,2,110,55,1360251295940,1360251305988,672680320,672690368,10048
1360251308,672692420,3,168,56,1360251305946,1360251306202,672690366,672690622,256
1360251311,672695224,1,46,46,1360251285276,1360251285276,672669500,672669500,0
1360251375,672759324,1,283,283,1360251348986,1360251348986,672733310,672733310,0
1360251403,672787268,1,52,52,1360251375794,1360251375794,672760062,672760062,0
1360251403,672787312,1,52,52,1360251375046,1360251375046,672759358,672759358,0
1360251969,673352476,7,2757,393.8571429,1360251940992,1360251942080,673324468,673325556,1088
1360252149,673533064,3,460,153.3333333,1360252124847,1360252125423,673508911,673509487,576
1360252209,673593356,1,52,52,1360252181194,1360252181194,673565550,673565550,0
1360252502,673886212,2,489,244.5,1360252474712,1360252474712,673858924,673858924,0
1360252546,673930176,16,7344,459,1360252517884,1360252528316,673902060,673912492,10432
1360252546,673930196,1,186,186,1360252519975,1360252519975,673904171,673904171,0
1360252565,673949444,3,138,46,1360252562224,1360252562224,673946668,673946668,0
1360252590,673974304,9,3463,384.7777778,1360252562681,1360252564089,673946985,673948393,1408
1360252685,674069440,2,131,65.5,1360252683633,1360252683633,674068073,674068073,0
1360252795,674179084,1,52,52,1360252768402,1360252768402,674152486,674152486,0
1360252990,674373672,3,138,46,1360252987628,1360252987628,674371300,674371300,0
1360253011,674395084,2,372,186,1360252986448,1360252986960,674370532,674371044,512
1360253015,674399052,15,5666,377.7333333,1360252987566,1360252990766,674371618,674374818,3200
1360253184,674567724,1,435,435,1360253156916,1360253156916,674540640,674540640,0
1360253216,674599864,7,1387,198.1428571,1360253191655,1360253193831,674575519,674577695,2176
1360253220,674603728,1,186,186,1360253192366,1360253192366,674576094,674576094,0
1360253312,674695916,3,389,129.6666667,1360253286769,1360253287281,674670685,674671197,512
1360253460,674844336,1,52,52,1360253433354,1360253433354,674817690,674817690,0
1360253513,674897080,1,46,46,1360253484170,1360253484170,674868250,674868250,0
1360253573,674956520,1,193,193,1360253545721,1360253545721,674929241,674929241,0
1360253573,674956524,16,10027,626.6875,1360253546549,1360253549813,674930073,674933337,3264
1360253753,675136984,3,567,189,1360253726056,1360253726184,675110040,675110168,128
1360253753,675137012,1,191,191,1360253725195,1360253725195,675109207,675109207,0
1360253993,675377260,1,52,52,1360253965902,1360253965902,675350162,675350162,0
1360254675,676058984,2,129,64.5,1360254649559,1360254649559,676033543,676033543,0
1360254679,676062956,1,46,46,1360254651445,1360254651445,676035401,676035401,0
1360254740,676123460,8,3390,423.75,1360254712099,1360254714339,676095559,676097799,2240
1360254980,676364072,1,52,52,1360254953787,1360254953787,676337859,676337859,0
1360255040,676424348,1,435,435,1360255013670,1360255013670,676398018,676398018,0
1360255048,676431492,10,6631,663.1,1360255042557,1360255042621,676426049,676426113,64
1360255048,676431536,10,6390,639,1360255044690,1360255044818,676428226,676428354,128
1360255048,676431564,17,13066,768.5882353,1360255042805,1360255042997,676426369,676426561,192
1360255048,676431568,5,323,64.6,1360255042868,1360255043956,676426436,676427524,1088
1360255048,676431600,11,6699,609,1360255043860,1360255044436,676427460,676428036,576
1360255056,676439480,3,138,46,1360255049547,1360255049547,676433027,676433027,0
1360255056,676439508,10,6597,659.7,1360255051565,1360255051693,676435073,676435201,128
1360255076,676460348,15,6074,404.9333333,1360255048039,1360255055143,676432387,676439491,7104
1360255076,676460352,11,4180,380,1360255048738,1360255051618,676433090,676435970,2880
1360255076,676460444,1,191,191,1360255049287,1360255049287,676433731,676433731,0
1360255181,676564460,2,116,58,1360255154332,1360255160028,676537792,676543488,5696
1360255232,676615788,17,3882,228.3529412,1360255227796,1360255230996,676611584,676614784,3200
1360255240,676623768,20,5274,263.7,1360255231653,1360255237221,676615421,676620989,5568
1360255241,676624496,15,5076,338.4,1360255232054,1360255237622,676615550,676621118,5568
1360255241,676624496,14,4237,302.6428571,1360255232054,1360255236022,676615550,676619518,3968
1360255249,676632600,2,128,64,1360255224718,1360255227342,676608318,676610942,2624
1360255253,676636664,19,4187,220.3684211,1360255227213,1360255234317,676610877,676617981,7104
1360255257,676640568,1,52,52,1360255231085,1360255231085,676614653,676614653,0
1360255261,676644536,1,79,79,1360255234381,1360255234381,676617917,676617917,0
1360255265,676648568,1,64,64,1360255238318,1360255238318,676621886,676621886,0
1360255265,676648728,9,3463,384.7777778,1360255237457,1360255238481,676621185,676622209,1024
1360255296,676679832,5,260,52,1360255292134,1360255295526,676675966,676679358,3392
1360255304,676687912,4,208,52,1360255295318,1360255299094,676679230,676683006,3776
1360255360,676743884,2,131,65.5,1360255358255,1360255358255,676742139,676742139,0
1360255381,676764608,1,64,64,1360255352259,1360255352259,676735867,676735867,0
1360255381,676764792,1,52,52,1360255356749,1360255356749,676740541,676740541,0
1360255381,676764840,17,3962,233.0588235,1360255355484,1360255358300,676739324,676742140,2816
1360255409,676792800,1,46,46,1360255382916,1360255382916,676766716,676766716,0
1360255416,676799828,14,6838,488.4285714,1360255413351,1360255413799,676797179,676797627,448
1360255416,676799836,17,3480,204.7058824,1360255410465,1360255410977,676794301,676794813,512
1360255416,676799860,23,10066,437.6521739,1360255411145,1360255412105,676795005,676795965,960
1360255416,676799864,16,4057,253.5625,1360255415171,1360255415811,676799035,676799675,640
1360255416,676799868,17,3715,218.5294118,1360255412225,1360255412609,676796093,676796477,384
1360255416,676799868,18,5569,309.3888889,1360255412673,1360255413185,676796541,676797053,512
1360255416,676799908,38,4832,127.1578947,1360255413590,1360255414166,676797498,676798074,576
1360255416,676799912,17,3513,206.6470588,1360255413717,1360255414101,676797629,676798013,384
1360255416,676799916,16,3428,214.25,1360255410641,1360255410961,676794557,676794877,320
1360255416,676799944,20,3574,178.7,1360255414643,1360255415091,676798587,676799035,448
1360255424,676807872,43,4915,114.3023256,1360255417597,1360255418301,676801469,676802173,704
1360255424,676807880,3,168,56,1360255418486,1360255418678,676802366,676802558,192
1360255424,676807900,3,168,56,1360255418976,1360255419104,676802876,676803004,128
1360255424,676807904,24,3745,156.0416667,1360255419358,1360255419806,676803262,676803710,448
1360255424,676807916,72,60146,835.3611111,1360255415761,1360255417553,676799677,676801469,1792
1360255424,676807948,3,168,56,1360255418735,1360255418863,676802683,676802811,128
1360255437,676820780,9,4004,444.8888889,1360255409430,1360255410518,676793210,676794298,1088
1360255445,676828788,1,487,487,1360255418576,1360255418576,676802364,676802364,0
1360255473,676856880,4,508,127,1360255446898,1360255465586,676830778,676849466,18688
1360255677,677061220,1,52,52,1360255650075,1360255650075,677034295,677034295,0
1360255688,677072092,3,168,56,1360255685212,1360255685852,677069304,677069944,640
1360255688,677072128,3,168,56,1360255682361,1360255683001,677066489,677067129,640
1360255688,677072132,3,168,56,1360255683315,1360255683891,677067447,677068023,576
1360255688,677072156,3,168,56,1360255684186,1360255684762,677068342,677068918,576
1360255714,677097712,19,4066,214,1360255685848,1360255689240,677069560,677072952,3392
1360255714,677097788,1,52,52,1360255687305,1360255687305,677071093,677071093,0
1360255808,677192136,3,168,56,1360255805806,1360255806382,677189942,677190518,576
1360255808,677192144,4,271,67.75,1360255802980,1360255803620,677187124,677187764,640
1360255808,677192172,3,168,56,1360255804808,1360255805384,677188980,677189556,576
1360255808,677192208,4,271,67.75,1360255801959,1360255802599,677186167,677186807,640
1360255808,677192212,3,168,56,1360255800864,1360255801696,677185076,677185908,832
1360255808,677192224,3,168,56,1360255803799,1360255804439,677188023,677188663,640
1360256709,678093120,1,48,48,1360256683505,1360256683505,678067625,678067625,0
1360256985,678368572,5,1110,222,1360256958161,1360256974801,678341733,678358373,16640
1360257009,678392628,3,666,222,1360256984728,1360257004760,678368356,678388388,20032
1360257041,678424736,1,222,222,1360257014633,1360257014633,678398369,678398369,0
1360257218,678601496,1,52,52,1360257189975,1360257189975,678573471,678573471,0
1360257282,678665472,1,52,52,1360257253486,1360257253486,678636958,678636958,0
1360258155,679539132,3,168,56,1360258151373,1360258151949,679535505,679536081,576
1360258155,679539172,3,168,56,1360258153124,1360258153892,679537296,679538064,768
1360258155,679539228,3,168,56,1360258152174,1360258152622,679536402,679536850,448
1360258155,679539256,3,168,56,1360258149775,1360258150415,679534031,679534671,640
1360258171,679555032,1,46,46,1360258146607,1360258146607,679530639,679530639,0
1360258179,679562964,1,46,46,1360258150964,1360258150964,679534928,679534928,0
1360258179,679563008,21,4170,198.5714286,1360258152586,1360258158218,679536594,679542226,5632
1360258183,679566964,61,66485,1089.918033,1360258155958,1360258171510,679539922,679555474,15552
1360258183,679567008,7,4247,606.7142857,1360258158152,1360258159240,679542160,679543248,1088
1360258195,679578900,9,3475,386.1111111,1360258170290,1360258171314,679554190,679555214,1024
1360258199,679582952,45,10681,237.3555556,1360258171519,1360258175295,679555471,679559247,3776
1360258203,679586880,1,64,64,1360258175496,1360258175496,679559376,679559376,0
1360258291,679675320,2,131,65.5,1360258290829,1360258290829,679675149,679675149,0
1360258427,679811352,1,52,52,1360258398892,1360258398892,679783244,679783244,0
1360258439,679823376,1,52,52,1360258411092,1360258411092,679795468,679795468,0
1360258443,679827368,1,52,52,1360258414876,1360258414876,679799244,679799244,0
1360258492,679875908,3,168,56,1360258485030,1360258485670,679868938,679869578,640
1360258516,679899644,1,52,52,1360258490289,1360258490289,679873933,679873933,0
1360258516,679899784,17,3962,233.0588235,1360258488162,1360258491874,679871946,679875658,3712
1360258788,680171924,3,760,253.3333333,1360258760915,1360258761235,680144839,680145159,320
1360258812,680196296,3,168,56,1360258807520,1360258808160,680191816,680192456,640
1360258836,680219940,1,46,46,1360258808771,1360258808771,680192711,680192711,0
1360258836,680219948,1,64,64,1360258809531,1360258809531,680193479,680193479,0
1360258836,680219980,18,5432,301.7777778,1360258810587,1360258813723,680194567,680197703,3136
1360258840,680224040,1,52,52,1360258812125,1360258812125,680196165,680196165,0
1360259097,680480660,3,458,152.6666667,1360259072532,1360259072852,680456192,680456512,320
1360259125,680508848,3,168,56,1360259120282,1360259120858,680504130,680504706,576
1360259125,680508876,3,168,56,1360259122110,1360259122686,680505986,680506562,576
1360259125,680508876,3,168,56,1360259123004,1360259123580,680506880,680507456,576
1360259125,680508880,3,168,56,1360259123962,1360259124346,680507842,680508226,384
1360259125,680508920,3,168,56,1360259121170,1360259121746,680505090,680505666,576
1360259133,680516892,3,168,56,1360259124716,1360259125420,680508608,680509312,704
1360259133,680516940,3,168,56,1360259125758,1360259126462,680509698,680510402,704
1360259133,680516968,3,168,56,1360259126688,1360259127328,680510656,680511296,640
1360259133,680516972,3,168,56,1360259127644,1360259128092,680511616,680512064,448
1360259149,680533272,17,3962,233.0588235,1360259122929,1360259126065,680507201,680510337,3136
1360259149,680533308,1,52,52,1360259124364,1360259124364,680508672,680508672,0
1360259330,680714108,1,48,48,1360259305364,1360259305364,680689472,680689472,0
1360259402,680785604,2,96,48,1360259374154,1360259377162,680757758,680760766,3008
1360259429,680813160,3,168,56,1360259428059,1360259428699,680812219,680812859,640
1360259429,680813240,3,168,56,1360259427085,1360259427725,680811325,680811965,640
1360259437,680821096,4,271,67.75,1360259429084,1360259429724,680813180,680813820,640
1360259458,680842024,17,3962,233.0588235,1360259430501,1360259433829,680814525,680817853,3328
1360259458,680842056,1,52,52,1360259432003,1360259432003,680816059,680816059,0
1360259741,681125404,2,116,58,1360259740324,1360259740580,681124728,681124984,256
1360259742,681125452,3,168,56,1360259740318,1360259740894,681123770,681124346,576
1360259749,681133352,3,168,56,1360259747222,1360259747926,681131574,681132278,704
1360259749,681133392,3,168,56,1360259744305,1360259744945,681128697,681129337,640
1360259749,681133424,3,168,56,1360259746065,1360259746705,681130489,681131129,640
1360259749,681133424,3,168,56,1360259742094,1360259742798,681126518,681127222,704
1360259750,681133440,3,168,56,1360259744167,1360259744935,681127607,681128375,768
1360259750,681133472,3,168,56,1360259746118,1360259746694,681129590,681130166,576
1360259751,681135344,1,46,46,1360259722145,1360259722145,681106489,681106489,0
1360259766,681150212,18,4022,223.4444444,1360259741859,1360259744931,681126071,681129143,3072
1360259766,681150220,1,46,46,1360259741338,1360259741338,681125558,681125558,0
1360259766,681150296,1,52,52,1360259741006,1360259741006,681125302,681125302,0
1360259770,681154340,1,52,52,1360259743525,1360259743525,681127865,681127865,0
1360259910,681293548,16,3428,214.25,1360259906617,1360259908217,681290165,681291765,1600
1360259918,681301512,16,4879,304.9375,1360259915869,1360259917533,681299381,681301045,1664
1360259918,681301516,19,7039,370.4736842,1360259912218,1360259914266,681295734,681297782,2048
1360259918,681301540,21,9975,475,1360259908288,1360259910464,681291828,681294004,2176
1360259918,681301552,14,6838,488.4285714,1360259914357,1360259915829,681297909,681299381,1472
1360259918,681301588,18,3793,210.7222222,1360259910481,1360259912145,681294069,681295733,1664
1360259918,681301628,20,3884,194.2,1360259914666,1360259916330,681298294,681299958,1664
1360259926,681309520,59,59773,1013.101695,1360259921619,1360259925331,681305139,681308851,3712
1360259926,681309552,15,3314,220.9333333,1360259918260,1360259919988,681301812,681303540,1728
1360259926,681309556,15,4005,267,1360259919986,1360259921522,681303542,681305078,1536
1360259931,681314976,7,3438,491.1428571,1360259904333,1360259905549,681288309,681289525,1216
1360259934,681317560,15,3273,218.2,1360259926443,1360259928107,681310003,681311667,1664
1360259934,681317572,19,3715,195.5263158,1360259924578,1360259926306,681308150,681309878,1728
1360260038,681421604,11,6649,604.4545455,1360260036670,1360260037374,681420274,681420978,704
1360260046,681429576,23,17493,760.5652174,1360260038683,1360260040923,681422259,681424499,2240
1360260046,681429612,13,7390,568.4615385,1360260037495,1360260038391,681421107,681422003,896
1360260046,681429656,11,3894,354,1360260044045,1360260045773,681427701,681429429,1728
1360260046,681429656,11,6489,589.9090909,1360260040522,1360260041610,681424178,681425266,1088
1360260062,681445556,4,216,54,1360260046640,1360260060976,681430196,681444532,14336
1360260063,681446872,13,6344,488,1360260036595,1360260045939,681420467,681429811,9344
1360260063,681446876,53,64666,1220.113208,1360260037103,1360260057071,681420979,681440947,19968
1360260063,681446876,8,5150,643.75,1360260037039,1360260038831,681420915,681422707,1792
1360260063,681446948,16,8827,551.6875,1360260036454,1360260054246,681420402,681438194,17792
1360260067,681451008,14,5630,402.1428571,1360260040682,1360260042218,681424690,681426226,1536
1360260067,681451012,9,4706,522.8888889,1360260041000,1360260043304,681425012,681427316,2304
1360260070,681453568,3,168,56,1360260067681,1360260068257,681451249,681451825,576
1360260070,681453680,2,131,65.5,1360260069041,1360260069041,681452721,681452721,0
1360260078,681461568,11,3894,354,1360260070819,1360260072931,681454387,681456499,2112
1360260086,681469604,9,1332,148,1360260081085,1360260085565,681464689,681469169,4480
1360260091,681475188,2,1166,583,1360260063031,1360260073015,681447219,681457203,9984
1360260094,681477652,10,6085,608.5,1360260085200,1360260090896,681468852,681474548,5696
1360260094,681477696,6,1236,206,1360260086691,1360260087715,681470387,681471411,1024
1360260094,681477724,6,759,126.5,1360260084743,1360260090503,681468467,681474227,5760
1360260095,681479112,11,5671,515.5454545,1360260070659,1360260075459,681454771,681459571,4800
1360260095,681479164,1,1270,1270,1360260068176,1360260068176,681452340,681452340,0
1360260095,681479204,17,3962,233.0588235,1360260069925,1360260075941,681454129,681460145,6016
1360260095,681479244,1,64,64,1360260067966,1360260067966,681452210,681452210,0
1360260099,681483112,1,52,52,1360260072131,1360260072131,681456243,681456243,0
1360260099,681483180,10,3872,387.2,1360260074686,1360260076734,681458866,681460914,2048
1360260102,681485616,19,3584,188.6315789,1360260097330,1360260101042,681480946,681484658,3712
1360260103,681487192,7,3443,491.8571429,1360260076275,1360260077555,681460467,681461747,1280
1360260103,681487224,12,5624,468.6666667,1360260078672,1360260080720,681462896,681464944,2048
1360260107,681491132,7,3494,499.1428571,1360260079599,1360260081135,681463731,681465267,1536
1360260107,681491132,1,116,116,1360260079789,1360260079789,681463921,681463921,0
1360260107,681491136,36,12314,342.0555556,1360260079848,1360260099432,681463984,681483568,19584
1360260107,681491240,1,116,116,1360260079681,1360260079681,681463921,681463921,0
1360260107,681491244,1,46,46,1360260079740,1360260079740,681463984,681463984,0
1360260107,681491244,8,4414,551.75,1360260079871,1360260082559,681464115,681466803,2688
1360260110,681493708,32,10534,329.1875,1360260101527,1360260107671,681485235,681491379,6144
1360260111,681495164,8,3684,460.5,1360260083725,1360260088653,681467889,681472817,4928
1360260111,681495172,8,4368,546,1360260083848,1360260088136,681468020,681472308,4288
1360260118,681501596,15,3760,250.6666667,1360260110469,1360260112005,681494065,681495601,1536
1360260118,681501632,19,4528,238.3157895,1360260113376,1360260117856,681497008,681501488,4480
1360260118,681501636,25,4180,167.2,1360260109404,1360260116316,681493040,681499952,6912
1360260118,681501644,11,5880,534.5454545,1360260109716,1360260116756,681493360,681500400,7040
1360260126,681509648,11,3894,354,1360260112466,1360260120658,681496114,681504306,8192
1360260126,681509776,15,6890,459.3333333,1360260117264,1360260125392,681501040,681509168,8128
1360260134,681517616,15,3409,227.2666667,1360260125939,1360260131059,681509555,681514675,5120
1360260134,681517736,11,4112,373.8181818,1360260117048,1360260127288,681500784,681511024,10240
1360260134,681517736,11,4112,373.8181818,1360260117115,1360260127163,681500851,681510899,10048
1360260139,681523280,11,4896,445.0909091,1360260113113,1360260138201,681497393,681522481,25088
1360260139,681523356,13,5019,386.0769231,1360260112268,1360260135244,681496624,681519600,22976
1360260139,681523376,2,658,329,1360260114233,1360260129209,681498609,681513585,14976
1360260147,681531336,1,186,186,1360260120033,1360260120033,681504369,681504369,0
1360260150,681533696,5,314,62.8,1360260143971,1360260147427,681527667,681531123,3456
1360260150,681533700,29,4122,142.137931,1360260136159,1360260146335,681519859,681530035,10176
1360260155,681539240,11,3614,328.5454545,1360260127171,1360260128835,681511411,681513075,1664
1360260158,681541680,5,1084,216.8,1360260147762,1360260152114,681531442,681535794,4352
1360260158,681541768,5,684,136.8,1360260143320,1360260152024,681527088,681535792,8704
1360260159,681543252,8,4852,606.5,1360260133302,1360260148982,681517554,681533234,15680
1360260163,681547284,24,22279,928.2916667,1360260137558,1360260150166,681521842,681534450,12608
1360260163,681547356,7,2415,345,1360260137228,1360260156108,681521584,681540464,18880
1360260166,681549748,31,4837,156.0322581,1360260147054,1360260161710,681530802,681545458,14656
1360260166,681549792,2,381,190.5,1360260144834,1360260158274,681528626,681542066,13440
1360260171,681555280,1,52,52,1360260145241,1360260145241,681529521,681529521,0
1360260174,681557724,11,4112,373.8181818,1360260166663,1360260172615,681550387,681556339,5952
1360260174,681557732,3,168,56,1360260172734,1360260173182,681556466,681556914,448
1360260174,681557796,15,6571,438.0666667,1360260150076,1360260173308,681533872,681557104,23232
1360260174,681557840,2,116,58,1360260173456,1360260173584,681557296,681557424,128
1360260174,681557844,7,1216,173.7142857,1360260165774,1360260172174,681549618,681556018,6400
1360260179,681563256,3,572,190.6666667,1360260152433,1360260152689,681536689,681536945,256
1360260182,681565688,3,168,56,1360260175977,1360260176425,681559665,681560113,448
1360260182,681565728,3,168,56,1360260177729,1360260178433,681561457,681562161,704
1360260182,681565732,67,62194,928.2686567,1360260162046,1360260174462,681545778,681558194,12416
1360260182,681565760,3,168,56,1360260179618,1360260180258,681563378,681564018,640
1360260182,681565768,3,168,56,1360260174682,1360260175514,681558450,681559282,832
1360260182,681565768,18,3663,203.5,1360260174682,1360260176730,681558450,681560498,2048
1360260182,681565772,3,168,56,1360260176726,1360260177302,681560498,681561074,576
1360260182,681565776,22,3653,166.0454545,1360260177042,1360260178770,681560818,681562546,1728
1360260183,681567372,13,6689,514.5384615,1360260158525,1360260178045,681542897,681562417,19520
1360260199,681583252,60,81276,1354.6,1360260173620,1360260175732,681557872,681559984,2112
1360260199,681583328,2,104,52,1360260173609,1360260173801,681557937,681558129,192
1360260199,681583372,17,7712,453.6470588,1360260172475,1360260178555,681556847,681562927,6080
1360260203,681587304,1,46,46,1360260178241,1360260178241,681562545,681562545,0
1360260246,681629752,23,9582,416.6086957,1360260238632,1360260240744,681622384,681624496,2112
1360260254,681637756,2,131,65.5,1360260249250,1360260249250,681633006,681633006,0
1360260264,681647680,1,198,198,1360260237998,1360260237998,681621678,681621678,0
1360260308,681691732,1,52,52,1360260283579,1360260283579,681667311,681667311,0
1360260308,681691800,1,52,52,1360260282425,1360260282425,681666225,681666225,0
1360260312,681695768,1,52,52,1360260286038,1360260286038,681669806,681669806,0
1360266959,688342648,16,6515,407.1875,1360266950889,1360266951465,688334537,688335113,576
1360266959,688343308,17,6562,386,1360266950228,1360266950740,688334536,688335048,512
1360266976,688359712,8,711,88.875,1360266951336,1360266951464,688335048,688335176,128
1360266976,688359752,12,6135,511.25,1360266949760,1360266950016,688333512,688333768,256
1360266976,688359780,14,6235,445.3571429,1360266950754,1360266951138,688334534,688334918,384
1360266976,688359792,8,712,89,1360266951193,1360266951385,688334985,688335177,192
1360266976,688359796,7,756,108,1360266951249,1360266951377,688335045,688335173,128
1360266976,688359860,8,794,99.25,1360266950033,1360266950225,688333893,688334085,192
1360267012,688395804,14,8556,611.1428571,1360266984393,1360266984841,688368197,688368645,448
1360267015,688398712,3,138,46,1360267009831,1360267009831,688393543,688393543,0
1360267015,688398712,3,138,46,1360267009831,1360267009895,688393543,688393607,64
1360267015,688398712,3,138,46,1360267009830,1360267009894,688393542,688393606,64
1360267015,688398788,3,138,46,1360267009753,1360267009753,688393541,688393541,0
1360267015,688398792,3,138,46,1360267009751,1360267009751,688393543,688393543,0
1360267015,688398792,3,138,46,1360267009751,1360267009815,688393543,688393607,64
1360267028,688411828,26,7562,290.8461538,1360267001393,1360267016945,688385221,688400773,15552
1360267031,688414744,3,156,52,1360267023173,1360267027589,688406917,688411333,4416
1360267047,688430708,3,138,46,1360267044458,1360267044522,688428166,688428230,64
1360267047,688430720,2,104,52,1360267033436,1360267045084,688417156,688428804,11648
1360267068,688451844,1,46,46,1360267041312,1360267041312,688425156,688425156,0
1360267080,688463860,25,7402,296.08,1360267053521,1360267078417,688437381,688462277,24896
1360267096,688479832,1,52,52,1360267068269,1360267068269,688452101,688452101,0
1360267119,688502788,3,240,80,1360267092506,1360267113562,688476294,688497350,21056
1360267140,688523868,1,52,52,1360267114823,1360267114823,688498691,688498691,0
1360267140,688523956,30,7741,258.0333333,1360267113774,1360267135598,688497730,688519554,21824
1360267200,688584120,1,46,46,1360267173514,1360267173514,688557634,688557634,0
1360267986,689370028,5,250,50,1360267957980,1360267980124,689342008,689364152,22144
1360268030,689414196,1,48,48,1360268004211,1360268004211,689388407,689388407,0
1360268058,689442288,1,48,48,1360268033110,1360268033110,689417398,689417398,0
1360269077,690461364,2,128,64,1360269050490,1360269053370,690434854,690437734,2880
1360269153,690536700,4,271,67.75,1360269149585,1360269149841,690533285,690533541,256
1360269153,690536708,3,168,56,1360269150026,1360269150154,690533734,690533862,128
1360269153,690536752,4,271,67.75,1360269148636,1360269148700,690532388,690532452,64
1360269153,690536756,3,168,56,1360269149144,1360269149336,690532900,690533092,192
1360269153,690536784,3,168,56,1360269150079,1360269150271,690533863,690534055,192
1360269153,690536832,3,168,56,1360269148813,1360269150221,690532645,690534053,1408
1360269177,690560740,3,168,56,1360269169385,1360269169513,690553125,690553253,128
1360269177,690560776,2,110,55,1360269159300,1360269169348,690543076,690553124,10048
1360269177,690561380,21,4772,227.2380952,1360269151337,1360269157801,690535717,690542181,6464
1360269185,690568752,2,110,55,1360269169627,1360269179675,690553379,690563427,10048
1360269193,690576872,3,168,56,1360269188582,1360269188710,690572454,690572582,128
1360269209,690592784,15,3761,250.7333333,1360269204347,1360269204795,690588131,690588579,448
1360269209,690592792,18,4468,248.2222222,1360269205172,1360269205556,690588964,690589348,384
1360269209,690592792,13,3583,275.6153846,1360269205172,1360269205492,690588964,690589284,320
1360269209,690592892,13,3583,275.6153846,1360269205074,1360269205394,690588966,690589286,320
1360269234,690617580,9,3463,384.7777778,1360269206087,1360269206407,690589667,690589987,320
1360269329,690712976,2,131,65.5,1360269325945,1360269325945,690709921,690709921,0
1360269337,690721016,3,168,56,1360269336080,1360269336400,690720096,690720416,320
1360269337,690721104,10,6586,658.6,1360269335547,1360269335739,690719651,690719843,192
1360269337,690721108,11,6644,604,1360269335800,1360269336056,690719908,690720164,256
1360269337,690721112,3,168,56,1360269336563,1360269336755,690720675,690720867,192
1360269337,690721112,13,9950,765.3846154,1360269336243,1360269336435,690720355,690720547,192
1360269337,690721112,3,168,56,1360269336243,1360269336435,690720355,690720547,192
1360269337,690721112,10,6429,642.9,1360269336498,1360269336690,690720610,690720802,192
1360269454,690838284,2,116,58,1360269428358,1360269428614,690812642,690812898,256
1360269489,690873188,3,168,56,1360269485990,1360269487014,690870178,690871202,1024
1360269489,690873264,3,168,56,1360269481943,1360269482647,690866207,690866911,704
1360269489,690873276,3,168,56,1360269482956,1360269483468,690867232,690867744,512
1360269489,690873304,3,168,56,1360269483696,1360269484528,690868000,690868832,832
1360269489,690873316,3,168,56,1360269484900,1360269485540,690869216,690869856,640
1360269497,690881244,2,110,55,1360269484908,1360269495020,690869152,690879264,10112
1360269497,690881320,3,168,56,1360269495455,1360269496095,690879775,690880415,640
1360269497,690881356,2,116,58,1360269496379,1360269496699,690880735,690881055,320
1360269505,690889252,3,174,58,1360269487587,1360269502371,690871839,690886623,14784
1360269511,690894492,19,4082,214.8421053,1360269485722,1360269491674,690869214,690875166,5952
1360269515,690898476,1,52,52,1360269487468,1360269487468,690870944,690870944,0
1360269523,690906464,1,64,64,1360269497846,1360269497846,690881310,690881310,0
1360269523,690906468,1,52,52,1360269497844,1360269497844,690881312,690881312,0
1360269730,691113416,3,168,56,1360269727525,1360269728101,691110941,691111517,576
1360269730,691113428,3,168,56,1360269728409,1360269728985,691111837,691112413,576
1360269730,691113456,3,168,56,1360269728957,1360269729597,691112413,691113053,640
1360269730,691113464,3,168,56,1360269726196,1360269726772,691109660,691110236,576
1360269730,691113468,3,168,56,1360269726832,1360269727408,691110300,691110876,576
1360269755,691139120,1,46,46,1360269727398,1360269727398,691111518,691111518,0
1360269755,691139196,1,64,64,1360269728919,1360269728919,691113115,691113115,0
1360269826,691209436,3,168,56,1360269824013,1360269824781,691207449,691208217,768
1360269826,691209476,3,168,56,1360269825127,1360269825639,691208603,691209115,512
1360269826,691209488,3,168,56,1360269823067,1360269823579,691206555,691207067,512
1360269826,691209528,3,168,56,1360269821619,1360269822643,691205147,691206171,1024
1360269834,691217460,18,4507,250.3888889,1360269826744,1360269828472,691210204,691211932,1728
1360269834,691217536,3,168,56,1360269826220,1360269827308,691209756,691210844,1088
1360269834,691217536,15,8831,588.7333333,1360269832171,1360269833643,691215707,691217179,1472
1360269834,691217540,14,3548,253.4285714,1360269828520,1360269830120,691212060,691213660,1600
1360269834,691217540,17,3488,205.1764706,1360269824359,1360269826599,691207899,691210139,2240
1360269834,691217572,18,5568,309.3333333,1360269830088,1360269832008,691213660,691215580,1920
1360269834,691217576,4,271,67.75,1360269825731,1360269825923,691209307,691209499,192
1360269842,691225452,2,110,55,1360269828349,1360269838461,691211801,691221913,10112
1360269842,691225500,3,168,56,1360269838608,1360269839248,691222108,691222748,640
1360269842,691225524,16,3374,210.875,1360269835895,1360269837559,691219419,691221083,1664
1360269842,691225532,21,4784,227.8095238,1360269832302,1360269834734,691215834,691218266,2432
1360269842,691225572,16,4057,253.5625,1360269837511,1360269839303,691221083,691222875,1792
1360269842,691225580,18,5514,306.3333333,1360269833600,1360269835456,691217180,691219036,1856
1360269842,691225608,3,168,56,1360269839586,1360269840290,691223194,691223898,704
1360269848,691231412,8,3498,437.25,1360269822118,1360269823782,691205530,691207194,1664
1360269848,691231508,20,4130,206.5,1360269822023,1360269826311,691205531,691209819,4288
1360269850,691233456,18,5033,279.6111111,1360269842234,1360269843962,691225690,691227418,1728
1360269850,691233544,30,4534,151.1333333,1360269844259,1360269846563,691227803,691230107,2304
1360269850,691233616,56,59637,1064.946429,1360269839260,1360269842076,691222876,691225692,2816
1360269852,691235432,1,52,52,1360269824337,1360269824337,691207769,691207769,0
1360269852,691235600,1,46,46,1360269827563,1360269827563,691211163,691211163,0
1360269916,691299496,9,3463,384.7777778,1360269890064,1360269891920,691273560,691275416,1856
1360269968,691351560,3,459,153,1360269942735,1360269943183,691326295,691326743,448
1360270018,691401692,2,131,65.5,1360270011469,1360270011469,691395161,691395161,0
1360270088,691472092,1,52,52,1360270063100,1360270063100,691447192,691447192,0
1360270130,691513672,2,116,58,1360270129245,1360270129693,691512917,691513365,448
1360270130,691513732,3,168,56,1360270128418,1360270128930,691512150,691512662,512
1360270130,691513780,3,168,56,1360270126387,1360270127027,691510167,691510807,640
1360270130,691513784,3,168,56,1360270127278,1360270127790,691511062,691511574,512
1360270138,691521756,3,168,56,1360270130120,1360270130696,691513876,691514452,576
1360270138,691521772,3,168,56,1360270131003,1360270132027,691514775,691515799,1024
1360270156,691540276,1,52,52,1360270129472,1360270129472,691513748,691513748,0
1360270156,691540376,20,5540,277,1360270127904,1360270132128,691512280,691516504,4224
1360270156,691540404,1,52,52,1360270130112,1360270130112,691514516,691514516,0
1360270194,691577676,3,168,56,1360270188955,1360270189723,691572631,691573399,768
1360270194,691577688,3,168,56,1360270190093,1360270190669,691573781,691574357,576
1360270194,691577720,3,168,56,1360270191148,1360270191276,691574868,691574996,128
1360270194,691577800,3,168,56,1360270187933,1360270188509,691571733,691572309,576
1360270233,691616424,3,761,253.6666667,1360270206164,1360270206484,691589588,691589908,320
1360270269,691652584,1,52,52,1360270243253,1360270243253,691626837,691626837,0
1360270514,691898100,3,168,56,1360270510381,1360270511341,691894481,691895441,960
1360270514,691898180,3,168,56,1360270511643,1360270512411,691895823,691896591,768
1360270530,691914076,2,116,58,1360270528773,1360270529221,691912849,691913297,448
1360270530,691914120,3,168,56,1360270526936,1360270527512,691911056,691911632,576
1360270530,691914128,3,168,56,1360270524561,1360270525265,691908689,691909393,704
1360270530,691914164,3,168,56,1360270522348,1360270522924,691906512,691907088,576
1360270530,691914192,3,168,56,1360270523216,1360270523856,691907408,691908048,640
1360270530,691914204,3,168,56,1360270527684,1360270528324,691911888,691912528,640
1360270541,691924968,18,4026,223.6666667,1360270513456,1360270518128,691897424,691902096,4672
1360270541,691925000,1,52,52,1360270515215,1360270515215,691899215,691899215,0
1360270553,691937104,1,46,46,1360270525862,1360270525862,691909966,691909966,0
1360270557,691941120,2,104,52,1360270530518,1360270530966,691914638,691915086,448
1360270586,691970112,3,168,56,1360270581216,1360270581792,691965328,691965904,576
1360270770,692153472,9,3558,395.3333333,1360270743261,1360270763485,692126733,692146957,20224
1360270770,692154256,16,3428,214.25,1360270763468,1360270765516,692147724,692149772,2048
1360270802,692185684,1,48,48,1360270775369,1360270775369,692159053,692159053,0
1360270874,692257780,7,1140,162.8571429,1360270848676,1360270873124,692232456,692256904,24448
1360270874,692258304,3,168,56,1360270871706,1360270872282,692256010,692256586,576
1360270874,692258336,2,116,58,1360270873340,1360270873724,692257676,692258060,384
1360270874,692258352,3,168,56,1360270870570,1360270871402,692254922,692255754,832
1360270882,692265764,9,3463,384.7777778,1360270855990,1360270857206,692239754,692240970,1216
1360270882,692266268,3,168,56,1360270874238,1360270874878,692258506,692259146,640
1360270882,692266280,3,168,56,1360270875250,1360270875826,692259530,692260106,576
1360270882,692266316,3,168,56,1360270877008,1360270877712,692261324,692262028,704
1360270882,692266356,3,168,56,1360270877989,1360270878629,692262345,692262985,640
1360270882,692266392,3,168,56,1360270875971,1360270876611,692260363,692261003,640
1360270898,692281772,17,3966,233.2941176,1360270871983,1360270874735,692255755,692258507,2752
1360270898,692281784,1,46,46,1360270873123,1360270873123,692256907,692256907,0
1360270902,692285744,1,52,52,1360270874507,1360270874507,692258251,692258251,0
1360270978,692362420,2,131,65.5,1360270976420,1360270976420,692360840,692360840,0
1360271019,692402408,3,168,56,1360271011416,1360271012056,692394824,692395464,640
1360271030,692413928,1,52,52,1360271003026,1360271003026,692386954,692386954,0
1360271203,692586568,3,168,56,1360271200822,1360271201462,692584390,692585030,640
1360271203,692586604,2,116,58,1360271202447,1360271202767,692586051,692586371,320
1360271211,692594608,3,168,56,1360271203533,1360271204173,692587141,692587781,640
1360271211,692594644,3,168,56,1360271204779,1360271205419,692588423,692589063,640
1360271219,692602604,3,168,56,1360271214865,1360271215441,692598469,692599045,576
1360271219,692602616,2,116,58,1360271215751,1360271216775,692599367,692600391,1024
1360271226,692610268,1,46,46,1360271201143,1360271201143,692585411,692585411,0
1360271227,692610536,3,168,56,1360271220182,1360271221014,692603718,692604550,832
1360271227,692610564,3,168,56,1360271224379,1360271225019,692607943,692608583,640
1360271227,692610568,3,168,56,1360271221302,1360271221686,692604870,692605254,384
1360271227,692610572,3,168,56,1360271222065,1360271222705,692605637,692606277,640
1360271227,692610592,2,116,58,1360271226140,1360271226780,692609732,692610372,640
1360271227,692610604,3,168,56,1360271223058,1360271224018,692606662,692607622,960
1360271227,692610608,19,4078,214.6315789,1360271203852,1360271222028,692587460,692605636,18176
1360271227,692610648,3,168,56,1360271225189,1360271225829,692608837,692609477,640
1360271230,692614100,1,52,52,1360271202594,1360271202594,692586694,692586694,0
1360271230,692614176,1,52,52,1360271205141,1360271205141,692589317,692589317,0
1360271235,692618608,3,168,56,1360271227788,1360271228428,692611396,692612036,640
1360271235,692618748,3,168,56,1360271228608,1360271229184,692612356,692612932,576
1360271235,692618816,3,168,56,1360271229437,1360271230077,692613253,692613893,640
1360271246,692630208,19,4070,214.2105263,1360271220339,1360271223987,692604547,692608195,3648
1360271246,692630296,1,52,52,1360271219355,1360271219355,692603651,692603651,0
1360271254,692638180,1,52,52,1360271226641,1360271226641,692610821,692610821,0
1360271539,692923228,3,168,56,1360271531358,1360271531934,692915586,692916162,576
1360271559,692943208,17,3966,233.2941176,1360271534384,1360271537648,692918592,692921856,3264
1360271563,692947164,1,52,52,1360271536220,1360271536220,692920384,692920384,0
1360271655,693039188,2,96,48,1360271629124,1360271631940,693013312,693016128,2816
1360271820,693203660,3,168,56,1360271816144,1360271816784,693199804,693200444,640
1360271820,693203696,3,168,56,1360271814186,1360271814890,693197882,693198586,704
1360271820,693203704,3,168,56,1360271815203,1360271815779,693198907,693199483,576
1360271852,693235592,3,168,56,1360271844307,1360271845203,693227899,693228795,896
1360271852,693235600,3,168,56,1360271848844,1360271849420,693232444,693233020,576
1360271852,693235600,4,271,67.75,1360271845513,1360271846153,693229113,693229753,640
1360271852,693235644,3,168,56,1360271847902,1360271848414,693231546,693232058,512
1360271852,693235708,3,168,56,1360271846879,1360271847583,693230587,693231291,704
1360271871,693255396,18,4285,238.0555556,1360271843438,1360271847278,693227834,693231674,3840
1360271872,693255436,1,52,52,1360271846126,1360271846126,693229562,693229562,0
1360271872,693255556,1,46,46,1360271846455,1360271846455,693230011,693230011,0
1360272157,693540680,3,168,56,1360272155830,1360272156406,693539510,693540086,576
1360272165,693548484,3,168,56,1360272157562,1360272158138,693541046,693541622,576
1360272165,693548492,3,168,56,1360272158644,1360272159156,693542136,693542648,512
1360272165,693548580,3,168,56,1360272159386,1360272160026,693542966,693543606,640
1360272181,693564424,17,3966,233.2941176,1360272156087,1360272159543,693539511,693542967,3456
1360272184,693568292,1,46,46,1360272156115,1360272156115,693540407,693540407,0
1360272184,693568324,1,52,52,1360272156722,1360272156722,693541046,693541046,0
1360272189,693572484,3,168,56,1360272184761,1360272185401,693568245,693568885,640
1360272189,693572496,3,168,56,1360272185648,1360272186288,693569144,693569784,640
1360272189,693572496,3,168,56,1360272182383,1360272183279,693565879,693566775,896
1360272189,693572548,3,168,56,1360272181371,1360272181947,693564919,693565495,576
1360272189,693572580,4,271,67.75,1360272183579,1360272184347,693567159,693567927,768
1360272249,693632552,9,3463,384.7777778,1360272222324,1360272223540,693605876,693607092,1216
1360272349,693733140,2,131,65.5,1360272342825,1360272342825,693726965,693726965,0
1360272381,693765168,3,459,153,1360272356171,1360272356747,693740339,693740915,576
1360272470,693853476,4,271,67.75,1360272467581,1360272468221,693851057,693851697,640
1360272470,693853484,4,271,67.75,1360272468662,1360272469302,693852146,693852786,640
1360272477,693861296,4,271,67.75,1360272468808,1360272469768,693853104,693854064,960
1360272477,693861380,3,168,56,1360272470198,1360272470902,693854578,693855282,704
1360272494,693877456,19,4070,214.2105263,1360272467600,1360272471120,693851056,693854576,3520
1360272494,693877500,1,52,52,1360272469223,1360272469223,693852723,693852723,0
1360272498,693881408,1,64,64,1360272472194,1360272472194,693855602,693855602,0
1360272806,694190144,19,4070,214.2105263,1360272778716,1360272782940,694162860,694167084,4224
1360272806,694190268,1,52,52,1360272780065,1360272780065,694164333,694164333,0
1360272850,694234208,1,186,186,1360272823836,1360272823836,694208044,694208044,0
1360272858,694242208,14,9876,705.4285714,1360272831515,1360272835035,694215723,694219243,3520
1360273031,694414656,3,567,189,1360273004931,1360273005123,694388587,694388779,192
1360273031,694414740,1,186,186,1360273004267,1360273004267,694388007,694388007,0
1360273095,694479292,3,168,56,1360273090245,1360273091013,694474537,694475305,768
1360273095,694479332,3,168,56,1360273091229,1360273091869,694475561,694476201,640
1360273119,694502960,17,3966,233.2941176,1360273091022,1360273094606,694474982,694478566,3584
1360273119,694503156,1,52,52,1360273092173,1360273092173,694476329,694476329,0
1360273272,694655504,1,52,52,1360273245270,1360273245270,694628774,694628774,0
1360273288,694671436,3,459,153,1360273260248,1360273260632,694643684,694644068,384
1360273368,694751784,7,2689,384.1428571,1360273342523,1360273345275,694726307,694729059,2752
1360273408,694792240,3,168,56,1360273402291,1360273403315,694786531,694787555,1024
1360273408,694792280,3,168,56,1360273403596,1360273404172,694787876,694788452,576
1360273428,694812032,19,4078,214.6315789,1360273402881,1360273406145,694786913,694790177,3264
1360273432,694815828,1,52,52,1360273404879,1360273404879,694788707,694788707,0
1360273432,694815952,1,64,64,1360273404883,1360273404883,694788835,694788835,0
1360273613,694996504,1,46,46,1360273585554,1360273585554,694969058,694969058,0
1360273721,695105044,3,168,56,1360273718579,1360273719475,695102623,695103519,896
1360273721,695105052,3,168,56,1360273716393,1360273717545,695100445,695101597,1152
1360273721,695105056,3,168,56,1360273719908,1360273720612,695103964,695104668,704
1360273721,695105096,3,168,56,1360273717823,1360273718463,695101919,695102559,640
1360273721,695105128,3,168,56,1360273715424,1360273716064,695099552,695100192,640
1360273729,695113088,3,168,56,1360273720967,1360273721607,695105055,695105695,640
1360273741,695124784,1,46,46,1360273715127,1360273715127,695098911,695098911,0
1360273745,695128700,18,4026,223.6666667,1360273717833,1360273721353,695101533,695105053,3520
1360273745,695128740,1,52,52,1360273719459,1360273719459,695103199,695103199,0
1360273753,695136800,1,64,64,1360273725606,1360273725606,695109406,695109406,0
1360273834,695217396,3,168,56,1360273830648,1360273831288,695214044,695214684,640
1360273834,695217440,4,271,67.75,1360273829707,1360273830283,695213147,695213723,576
1360273853,695237332,1,46,46,1360273828496,1360273828496,695212828,695212828,0
1360273905,695289300,2,96,48,1360273877359,1360273880303,695261659,695264603,2944
1360274154,695538348,4,232,58,1360274144251,1360274149947,695528599,695534295,5696
1360274162,695545980,3,168,56,1360274153964,1360274154796,695537944,695538776,832
1360274162,695546168,4,271,67.75,1360274156015,1360274156591,695540183,695540759,576
1360274174,695558160,23,4695,204.1304348,1360274149815,1360274169079,695533975,695553239,19264
1360274178,695562300,7,3855,550.7142857,1360274149802,1360274154282,695534102,695538582,4480
1360274179,695562464,1,52,52,1360274153711,1360274153711,695537175,695537175,0
1360274202,695586084,8,1366,170.75,1360274193539,1360274194499,695577623,695578583,960
1360274222,695606300,14,5083,363.0714286,1360274194858,1360274220650,695579158,695604950,25792
1360274223,695606408,14,5083,363.0714286,1360274195752,1360274219752,695579160,695603160,24000
1360274223,695606408,16,4364,272.75,1360274195815,1360274222183,695579223,695605591,26368
1360274226,695610156,12,3363,280.25,1360274221819,1360274223035,695605975,695607191,1216
1360274251,695634436,9,3463,384.7777778,1360274224138,1360274225418,695607574,695608854,1280
1360274314,695698104,16,3428,214.25,1360274306862,1360274308718,695690966,695692822,1856
1360274314,695698132,15,3599,239.9333333,1360274311824,1360274313616,695695956,695697748,1792
1360274314,695698140,17,3940,231.7647059,1360274308683,1360274311755,695692823,695695895,3072
1360274314,695698180,14,3324,237.4285714,1360274306656,1360274308320,695690836,695692500,1664
1360274322,695706228,19,5628,296.2105263,1360274313522,1360274320434,695697750,695704662,6912
1360274330,695714120,20,3884,194.2,1360274320797,1360274322781,695704917,695706901,1984
1360274330,695714148,18,4649,258.2777778,1360274322047,1360274326143,695706195,695710291,4096
1360274330,695714152,15,3314,220.9333333,1360274326589,1360274328125,695710741,695712277,1536
1360274330,695714196,14,3953,282.3571429,1360274328082,1360274329682,695712278,695713878,1600
1360274330,695714204,15,7220,481.3333333,1360274320586,1360274321994,695704790,695706198,1408
1360274331,695714628,9,4004,444.8888889,1360274305416,1360274307080,695689044,695690708,1664
1360274338,695722088,17,3369,198.1764706,1360274334907,1360274336955,695718995,695721043,2048
1360274338,695722140,56,59586,1064.035714,1360274329737,1360274332809,695713877,695716949,3072
1360274338,695722208,18,3623,201.2777778,1360274332739,1360274334659,695716947,695718867,1920
1360274346,695730140,2,131,65.5,1360274344714,1360274344714,695728854,695728854,0
1360274431,695814760,1,186,186,1360274406468,1360274406468,695790228,695790228,0
1360274435,695818864,1,64,64,1360274409307,1360274409307,695793171,695793171,0
1360274435,695818924,11,5223,474.8181818,1360274408096,1360274410208,695792020,695794132,2112
1360274463,695847076,76,95686,1259.026316,1360274437317,1360274448837,695821393,695832913,11520
1360274463,695847188,33,36983,1120.69697,1360274437333,1360274439893,695821521,695824081,2560
1360274474,695858216,2,131,65.5,1360274469627,1360274469627,695853843,695853843,0
1360274474,695858224,194,16641,85.77835052,1360274209396,1360274467892,695593620,695852116,258496
1360274474,695858304,235,19934,84.82553191,1360274209314,1360274468322,695593618,695852626,259008
1360274491,695874388,12,7322,610.1666667,1360274470775,1360274483383,695854163,695866771,12608
1360274522,695906376,3,168,56,1360274520793,1360274521369,695905169,695905745,576
1360274539,695922432,2,110,55,1360274522635,1360274534347,695906067,695917779,11712
1360274547,695930388,21,16089,766.1428571,1360274528949,1360274543477,695912337,695926865,14528
1360274551,695935200,21,4306,205.047619,1360274523593,1360274528073,695907793,695912273,4480
1360274551,695935352,1,52,52,1360274525426,1360274525426,695909778,695909778,0
1360274555,695939192,9,3499,388.7777778,1360274527185,1360274529041,695911377,695913233,1856
1360274571,695955204,1,52,52,1360274546500,1360274546500,695930704,695930704,0
1360274571,695955272,84,98904,1177.428571,1360274545347,1360274558595,695929619,695942867,13248
1360274594,695978284,2,131,65.5,1360274587252,1360274587252,695971536,695971536,0
1360274599,695983272,3,1192,397.3333333,1360274571522,1360274572162,695955794,695956434,640
1360274628,696011564,1,52,52,1360274602883,1360274602883,695986447,695986447,0
1360274642,696026320,4,271,67.75,1360274640914,1360274641362,696025234,696025682,448
1360274642,696026328,2,110,55,1360274625481,1360274635785,696009809,696020113,10304
1360274642,696026364,3,168,56,1360274636132,1360274636708,696020496,696021072,576
1360274643,696026396,3,168,56,1360274637997,1360274638637,696021393,696022033,640
1360274668,696051724,1,64,64,1360274642278,1360274642278,696026002,696026002,0
1360274676,696059776,1,52,52,1360274650350,1360274650350,696034126,696034126,0
1360274736,696119780,1,46,46,1360274708523,1360274708523,696092303,696092303,0
1360274752,696135776,1,46,46,1360274724846,1360274724846,696108622,696108622,0
1360274794,696178332,3,168,56,1360274792386,1360274792450,696176718,696176782,64
1360274796,696180140,1,52,52,1360274769089,1360274769089,696153229,696153229,0
1360274810,696194380,3,168,56,1360274805651,1360274805715,696190031,696190095,64
1360274816,696200212,5,1001,200.2,1360274791224,1360274791928,696175436,696176140,704
1360274818,696202340,2,110,55,1360274792507,1360274811131,696176847,696195471,18624
1360274820,696204100,1,46,46,1360274792619,1360274792619,696176719,696176719,0
1360274835,696218656,3,168,56,1360274832038,1360274832678,696215694,696216334,640
1360274860,696244160,1,52,52,1360274835307,1360274835307,696219467,696219467,0
1360274860,696244236,21,4316,205.5238095,1360274832032,1360274842336,696216268,696226572,10304
1360274864,696248156,10,4127,412.7,1360274837295,1360274840943,696221451,696225099,3648
1360274989,696372732,9,3463,384.7777778,1360274961877,1360274963157,696345609,696346889,1280
1360275043,696426720,3,168,56,1360275041121,1360275041505,696424841,696425225,384
1360275043,696426764,2,116,58,1360275042229,1360275042485,696425993,696426249,256
1360275043,696426768,3,168,56,1360275039088,1360275039728,696422856,696423496,640
1360275043,696426776,3,168,56,1360275040043,1360275040619,696423819,696424395,576
1360275051,696434712,3,168,56,1360275044137,1360275044713,696427849,696428425,576
1360275051,696434748,3,168,56,1360275043141,1360275043717,696426889,696427465,576
1360275069,696452640,1,52,52,1360275042931,1360275042931,696426571,696426571,0
1360275069,696452688,1,46,46,1360275041859,1360275041859,696425547,696425547,0
1360275091,696474676,2,131,65.5,1360275083149,1360275083149,696466825,696466825,0
1360275107,696490800,3,168,56,1360275105167,1360275105743,696488967,696489543,576
1360275107,696490848,3,168,56,1360275106017,1360275106401,696489865,696490249,384
1360275109,696492952,1,52,52,1360275081143,1360275081143,696465095,696465095,0
1360275219,696602940,15,3384,225.6,1360275215362,1360275217154,696599302,696601094,1792
1360275242,696625468,7,3438,491.1428571,1360275213978,1360275215066,696597446,696598534,1088
1360275314,696697388,1,46,46,1360275286504,1360275286504,696669892,696669892,0
1360275314,696697512,1,64,64,1360275286958,1360275286958,696670470,696670470,0
1360275314,696697552,20,4223,211.15,1360275288964,1360275293700,696672516,696677252,4736
1360275318,696701444,1,52,52,1360275290739,1360275290739,696674183,696674183,0
1360275483,696866792,1,46,46,1360275454228,1360275454228,696838020,696838020,0
1360275484,696868264,1,52,52,1360275454266,1360275454266,696838530,696838530,0
1360275579,696963012,3,168,56,1360275578228,1360275578868,696962240,696962880,640
1360275587,696971036,3,168,56,1360275579164,1360275579740,696963200,696963776,576
1360275603,696986524,1,46,46,1360275578524,1360275578524,696962048,696962048,0
1360275607,696990404,1,64,64,1360275580694,1360275580694,696964098,696964098,0
1360275699,697082604,3,459,153,1360275673421,1360275673613,697057025,697057217,192
1360275780,697163428,1,46,46,1360275754425,1360275754425,697137853,697137853,0
1360275791,697174976,7,2689,384.1428571,1360275762901,1360275764309,697146877,697148285,1408
1360275884,697267772,3,168,56,1360275882399,1360275883103,697266171,697266875,704
1360275892,697275656,3,168,56,1360275883541,1360275884053,697267197,697267709,512
1360275892,697275688,3,168,56,1360275884790,1360275885686,697268478,697269374,896
1360275892,697275696,3,168,56,1360275886061,1360275886765,697269757,697270461,704
1360275908,697291580,19,4070,214.2105263,1360275882593,1360275885857,697266173,697269437,3264
1360275912,697295452,1,64,64,1360275887327,1360275887327,697270779,697270779,0
1360275912,697295460,1,52,52,1360275883993,1360275883993,697267453,697267453,0
1360275912,697295484,1,46,46,1360275884545,1360275884545,697268029,697268029,0
1360276032,697415800,1,46,46,1360276004484,1360276004484,697388284,697388284,0
1360276196,697580280,3,168,56,1360276194721,1360276195361,697579001,697579641,640
1360276196,697580356,4,271,67.75,1360276193749,1360276194389,697578105,697578745,640
1360276204,697588236,3,168,56,1360276200460,1360276201036,697584696,697585272,576
1360276204,697588236,3,168,56,1360276196811,1360276197643,697581047,697581879,832
1360276204,697588356,3,168,56,1360276198482,1360276198866,697582838,697583222,384
1360276205,697588388,3,168,56,1360276196507,1360276197339,697579895,697580727,832
1360276205,697588400,3,168,56,1360276200335,1360276200911,697583735,697584311,576
1360276224,697608012,19,4070,214.2105263,1360276197546,1360276201130,697581558,697585142,3584
1360276224,697608016,1,46,46,1360276198184,1360276198184,697582200,697582200,0
1360276224,697608044,1,52,52,1360276198794,1360276198794,697582838,697582838,0
1360276413,697796672,3,168,56,1360276412157,1360276412733,697795829,697796405,576
1360276421,697804536,3,168,56,1360276413254,1360276413894,697796790,697797430,640
1360276477,697860656,7,1569,224.1428571,1360276473420,1360276475084,697857076,697858740,1664
1360276497,697880508,1,796,796,1360276472224,1360276472224,697855732,697855732,0
1360276509,697892732,3,168,56,1360276506685,1360276507453,697890417,697891185,768
1360276509,697892764,3,168,56,1360276507677,1360276508253,697891441,697892017,576
1360276517,697900928,3,168,56,1360276508409,1360276509433,697892337,697893361,1024
1360276537,697920664,1,64,64,1360276510018,1360276510018,697893682,697893682,0
1360276537,697920676,1,52,52,1360276510902,1360276510902,697894578,697894578,0
1360276537,697920744,19,4070,214.2105263,1360276509364,1360276512372,697893108,697896116,3008
1360276580,697963756,1,48,48,1360276550564,1360276550564,697934320,697934320,0
1360276621,698005024,14,4515,322.5,1360276615576,1360276617688,697999600,698001712,2112
1360276621,698005072,16,7671,479.4375,1360276617575,1360276619623,698001647,698003695,2048
1360276641,698024772,1,579,579,1360276614549,1360276614549,697998321,697998321,0
1360276641,698024780,8,3154,394.25,1360276615819,1360276617227,697999599,698001007,1408
1360276641,698024864,10,3385,338.5,1360276615735,1360276617335,697999599,698001199,1600
1360276645,698028964,9,3463,384.7777778,1360276620055,1360276621207,698004019,698005171,1152
1360276741,698125200,2,131,65.5,1360276736999,1360276736999,698121199,698121199,0
1360276741,698125324,2,131,65.5,1360276736555,1360276736555,698120879,698120879,0
1360276749,698133200,2,131,65.5,1360276740903,1360276740903,698125103,698125103,0
1360276809,698193324,7,2689,384.1428571,1360276783340,1360276784428,698167664,698168752,1088
1360276821,698205188,3,168,56,1360276818739,1360276819379,698202927,698203567,640
1360276822,698205388,3,168,56,1360276820497,1360276821393,698203885,698204781,896
1360276846,698229648,1,46,46,1360276821454,1360276821454,698205102,698205102,0
1360276850,698233664,1,64,64,1360276822269,1360276822269,698205933,698205933,0
1360276850,698233740,20,4557,227.85,1360276821810,1360276849010,698205550,698232750,27200
1360276850,698233816,1,52,52,1360276823268,1360276823268,698207084,698207084,0
1360276853,698237228,3,168,56,1360276852552,1360276852616,698236780,698236844,64
1360276853,698237308,3,168,56,1360276852601,1360276852729,698236909,698237037,128
1360276853,698237308,2,116,58,1360276852728,1360276852792,698237036,698237100,64
1360276861,698245252,7,1569,224.1428571,1360276856433,1360276857009,698240685,698241261,576
1360276861,698245256,10,4433,443.3,1360276856878,1360276857390,698241134,698241646,512
1360276861,698245272,3,168,56,1360276852892,1360276852956,698237164,698237228,64
1360276877,698261208,2,110,55,1360276853084,1360276872988,698237292,698257196,19904
1360276877,698261220,9,4387,487.4444444,1360276874195,1360276875347,698258415,698259567,1152
1360276878,698261684,1,52,52,1360276853418,1360276853418,698237102,698237102,0
1360276878,698261740,1,46,46,1360276853041,1360276853041,698236781,698236781,0
1360276882,698265772,30,17522,584.0666667,1360276857489,1360276875153,698241261,698258925,17664
1360276882,698265772,17,13391,787.7058824,1360276857489,1360276859409,698241261,698243181,1920
1360276882,698265776,24,6071,252.9583333,1360276857421,1360276878733,698241197,698262509,21312
1360276914,698297812,7,476,68,1360276888103,1360276908775,698271915,698292587,20672
1360276925,698309248,3,202,67.33333333,1360276917877,1360276922869,698302125,698307117,4992
1360276934,698317948,1,52,52,1360276908641,1360276908641,698292589,698292589,0
1360276941,698325348,3,179,59.66666667,1360276934158,1360276939726,698318506,698324074,5568
1360276946,698329812,6,396,66,1360276918633,1360276939625,698302445,698323437,20992
1360276974,698357924,6,398,66.33333333,1360276949112,1360276969464,698333036,698353388,20352
1360276997,698381308,7,478,68.28571429,1360276979128,1360276989688,698363436,698373996,10560
1360277050,698434136,1,46,46,1360277024609,1360277024609,698408745,698408745,0
1360277116,698499652,1,46,46,1360277088519,1360277088519,698472171,698472171,0
1360277134,698517480,3,168,56,1360277129776,1360277130480,698513256,698513960,704
1360277134,698518220,2,96,48,1360277107533,1360277110477,698491753,698494697,2944
1360277142,698525452,2,104,52,1360277134158,1360277134734,698517610,698518186,576
1360277149,698533380,2,110,55,1360277130605,1360277141101,698514985,698525481,10496
1360277150,698533448,3,168,56,1360277142227,1360277142675,698525675,698526123,448
1360277155,698538584,1,46,46,1360277130761,1360277130761,698514345,698514345,0
1360277159,698542508,20,4178,208.9,1360277131156,1360277136276,698514664,698519784,5120
1360277171,698554520,1,64,64,1360277142921,1360277142921,698526441,698526441,0
1360277171,698554604,1,446,446,1360277146357,1360277146357,698529961,698529961,0
1360277270,698653468,14,9657,689.7857143,1360277262780,1360277264636,698646248,698648104,1856
1360277270,698653476,45,54113,1202.511111,1360277265459,1360277267635,698648935,698651111,2176
1360277270,698653524,23,20636,897.2173913,1360277260165,1360277262149,698643689,698645673,1984
1360277278,698661516,26,25788,991.8461538,1360277268235,1360277270923,698651751,698654439,2688
1360277279,698662676,1,186,186,1360277253420,1360277253420,698637096,698637096,0
1360277283,698666708,13,5649,434.5384615,1360277255756,1360277257868,698639464,698641576,2112
1360277291,698674608,1,46,46,1360277263856,1360277263856,698647464,698647464,0
1360277335,698718816,2,96,48,1360277308384,1360277311392,698692200,698695208,3008
1360277379,698762712,1,64,64,1360277352390,1360277352390,698736102,698736102,0
1360277444,698828204,1,48,48,1360277416344,1360277416344,698800548,698800548,0
1360277447,698830552,3,168,56,1360277444835,1360277445475,698828387,698829027,640
1360277447,698830556,4,271,67.75,1360277441633,1360277442529,698825189,698826085,896
1360277447,698830584,3,168,56,1360277443718,1360277444678,698827302,698828262,960
1360277447,698830628,2,238,119,1360277433495,1360277445655,698817123,698829283,12160
1360277447,698830636,3,168,56,1360277442703,1360277443343,698826339,698826979,640
1360277454,698837520,16,9769,610.5625,1360277446979,1360277448963,698830499,698832483,1984
1360277454,698837552,55,70338,1278.872727,1360277449508,1360277451748,698833060,698835300,2240
1360277454,698837592,27,23091,855.2222222,1360277444667,1360277446331,698828259,698829923,1664
1360277459,698842928,8,2327,290.875,1360277433709,1360277434541,698817637,698818469,832
1360277462,698845604,25,25686,1027.44,1360277452464,1360277454192,698836068,698837796,1728
1360277463,698846848,4,240,60,1360277436669,1360277438909,698820517,698822757,2240
1360277471,698854820,1,64,64,1360277445657,1360277445657,698829477,698829477,0
1360277471,698854916,17,3966,233.2941176,1360277443960,1360277447160,698827876,698831076,3200
1360277507,698891080,3,459,153,1360277482515,1360277482899,698866595,698866979,384
1360337111,758494844,1,60,60,1360337086520,1360337086520,758470364,758470364,0
1360338214,759597836,1,46,46,1360338187633,1360338187633,759571469,759571469,0
1360338303,759687052,1,46,46,1360338275289,1360338275289,759659341,759659341,0
1360338518,759901884,1,48,48,1360338493501,1360338493501,759877385,759877385,0
1360338583,759967088,3,168,56,1360338580912,1360338581808,759965000,759965896,896
1360338610,759994048,1,64,64,1360338582296,1360338582296,759966344,759966344,0
1360338622,760006008,22,4357,198.0454545,1360338594688,1360338614656,759978696,759998664,19968
1360338738,760122072,5,1110,222,1360338710524,1360338729788,760094596,760113860,19264
1360338766,760150164,3,666,222,1360338739745,1360338759713,760123909,760143877,19968
1360338778,760162136,1,46,46,1360338750844,1360338750844,760134980,760134980,0
1360338795,760178452,1,222,222,1360338770409,1360338770409,760153861,760153861,0
1360338864,760247224,4,232,58,1360338859401,1360338863433,760242625,760246657,4032
1360338880,760263236,3,168,56,1360338872704,1360338874432,760255940,760257668,1728
1360338888,760271236,19,4574,240.7368421,1360338879231,1360338883327,760262467,760266563,4096
1360338888,760271240,13,3583,275.6153846,1360338879292,1360338883964,760262532,760267204,4672
1360338888,760271292,13,3571,274.6923077,1360338879111,1360338883911,760262403,760267203,4800
1360338891,760274568,21,7285,346.9047619,1360338862964,1360338882932,760246532,760266500,19968
1360338899,760282580,1,46,46,1360338874726,1360338874726,760258306,760258306,0
1360338903,760286564,1,64,64,1360338875576,1360338875576,760259140,760259140,0
1360338911,760294540,8,3954,494.25,1360338883597,1360338886861,760267137,760270401,3264
1360338915,760298476,4,256,64,1360338887312,1360338908368,760270788,760291844,21056
1360338960,760343304,4,271,67.75,1360338955579,1360338956219,760338883,760339523,640
1360338960,760343304,3,168,56,1360338952122,1360338953146,760335426,760336450,1024
1360338960,760343312,3,168,56,1360338956465,1360338957105,760339777,760340417,640
1360338960,760343340,3,168,56,1360338954324,1360338955284,760337664,760338624,960
1360338960,760343356,2,110,55,1360338941959,1360338952007,760325315,760335363,10048
1360338960,760343392,3,168,56,1360338953378,1360338954018,760336770,760337410,640
1360338960,760343400,3,168,56,1360338957336,1360338958296,760340736,760341696,960
1360338963,760346908,20,4722,236.1,1360338938398,1360338945374,760322306,760329282,6976
1360338967,760350836,1,64,64,1360338940136,1360338940136,760323972,760323972,0
1360338967,760350904,1,52,52,1360338939683,1360338939683,760323587,760323587,0
1360338975,760358896,1,46,46,1360338950697,1360338950697,760334593,760334593,0
1360338975,760358956,1,46,46,1360338949166,1360338949166,760333122,760333122,0
1360338979,760362876,9,3463,384.7777778,1360338951549,1360338953213,760335425,760337089,1664
1360338983,760366892,13,4809,369.9230769,1360338958572,1360338961900,760342464,760345792,3328
1360338987,760371020,1,64,64,1360338959660,1360338959660,760343680,760343680,0
1360338998,760381724,1,48,48,1360338968085,1360338968085,760351809,760351809,0
1360339008,760391316,5,296,59.2,1360338993454,1360339002606,760376770,760385922,9152
1360339008,760391348,4,271,67.75,1360339002830,1360339002958,760386178,760386306,128
1360339008,760391348,2,131,65.5,1360339005326,1360339005326,760388674,760388674,0
1360339008,760391348,3,168,56,1360339003019,1360339003147,760386367,760386495,128
1360339008,760391396,3,168,56,1360339002524,1360339002652,760385920,760386048,128
1360339011,760394960,8,560,70,1360338982952,1360339008744,760366912,760392704,25792
1360339016,760399360,2,110,55,1360339003136,1360339014720,760386496,760398080,11584
1360339027,760410984,1,46,46,1360339002064,1360339002064,760386048,760386048,0
1360339031,760415032,1,46,46,1360339004130,1360339004130,760388162,760388162,0
1360339059,760443128,1,46,46,1360339034432,1360339034432,760418560,760418560,0
1360339080,760463492,2,131,65.5,1360339073466,1360339073466,760456958,760456958,0
1360339112,760495640,17,3352,197.1764706,1360339107366,1360339108070,760491006,760491710,704
1360339132,760515380,7,3438,491.1428571,1360339106922,1360339107242,760490302,760490622,320
1360339204,760587448,2,335,167.5,1360339177189,1360339178277,760560637,760561725,1088
1360339228,760611488,1,64,64,1360339203200,1360339203200,760586688,760586688,0
1360339228,760611528,1,46,46,1360339201366,1360339201366,760584894,760584894,0
1360339329,760712204,2,110,55,1360339311574,1360339323670,760694778,760706874,12096
1360339344,760727868,2,339,169.5,1360339317185,1360339317185,760701053,760701053,0
1360339344,760728120,4,271,67.75,1360339337093,1360339337157,760721213,760721277,64
1360339368,760751908,1,46,46,1360339342490,1360339342490,760726398,760726398,0
1360339372,760755932,1,52,52,1360339346689,1360339346689,760730621,760730621,0
1360339417,760800380,1,52,52,1360339390886,1360339390886,760774266,760774266,0
1360339533,760916464,2,188,94,1360339506194,1360339506194,760889658,760889658,0
1360339577,760960580,1,52,52,1360339552091,1360339552091,760935671,760935671,0
1360339593,760976296,4,184,46,1360339591097,1360339591097,760974393,760974393,0
1360339617,761000660,11,4941,449.1818182,1360339591054,1360339592014,760974714,760975674,960
1360339617,761000740,1,46,46,1360339590397,1360339590397,760974137,760974137,0
1360339625,761008620,10,4992,499.2,1360339598197,1360339598901,760981817,760982521,704
1360339625,761008644,12,6246,520.5,1360339598875,1360339599451,760982519,760983095,576
1360339633,761016704,1,46,46,1360339604831,1360339604831,760988535,760988535,0
1360339637,761020632,2,188,94,1360339608872,1360339608872,760992504,760992504,0
1360339649,761032776,1,46,46,1360339622549,1360339622549,761006325,761006325,0
1360339689,761072816,1,52,52,1360339663216,1360339663216,761047032,761047032,0
1360339713,761096432,2,131,65.5,1360339712112,1360339712112,761095544,761095544,0
1360339797,761180836,2,188,94,1360339770267,1360339770267,761154103,761154103,0
1360339877,761260948,2,238,119,1360339850280,1360339850728,761234228,761234676,448
1360339877,761260992,13,5674,436.4615385,1360339852474,1360339855226,761236466,761239218,2752
1360339929,761312564,155,11998,77.40645161,1360339673704,1360339924264,761057268,761307828,250560
1360339929,761312568,118,8823,74.77118644,1360339673953,1360339923873,761057521,761307441,249920
1360339946,761329328,3,461,153.6666667,1360339920148,1360339920788,761303476,761304116,640
1360340058,761441288,1,186,186,1360340030904,1360340030904,761414192,761414192,0
1360340058,761441292,3,567,189,1360340031412,1360340031604,761414704,761414896,192
1360340298,761681732,1,52,52,1360340271225,1360340271225,761654957,761654957,0
1360340310,761693844,2,188,94,1360340285577,1360340285577,761669421,761669421,0
1360340337,761720704,3,138,46,1360340334294,1360340334294,761717998,761717998,0
1360340362,761745916,11,5529,502.6363636,1360340334465,1360340337985,761718381,761721901,3520
1360340362,761745956,1,186,186,1360340336474,1360340336474,761720430,761720430,0
1360340390,761773832,1,52,52,1360340363670,1360340363670,761747502,761747502,0
1360340486,761870028,2,188,94,1360340458064,1360340458064,761842092,761842092,0
1360340513,761896872,4,184,46,1360340508075,1360340508075,761891947,761891947,0
1360340535,761918228,7,2689,384.1428571,1360340509039,1360340509999,761892267,761893227,960
1360340599,761982500,1,52,52,1360340571871,1360340571871,761955371,761955371,0
1360340599,761982576,1,46,46,1360340571536,1360340571536,761955112,761955112,0
1360340603,761986592,1,52,52,1360340578305,1360340578305,761961897,761961897,0
1360340775,762158900,1,46,46,1360340749321,1360340749321,762133221,762133221,0
1360340779,762162916,16,9926,620.375,1360340752314,1360340755258,762136230,762139174,2944
1360340779,762162960,1,193,193,1360340751312,1360340751312,762135272,762135272,0
1360340888,762271376,1,46,46,1360340862867,1360340862867,762246243,762246243,0
1360340960,762343440,3,144,48,1360340935125,1360340936533,762318565,762319973,1408
1360340960,762343468,1,191,191,1360340931831,1360340931831,762315299,762315299,0
1360340960,762343476,2,490,245,1360340932273,1360340932593,762315749,762316069,320
1360340964,762347484,3,144,48,1360340937257,1360340938601,762320741,762322085,1344
1360340964,762347496,3,144,48,1360340936157,1360340937373,762319653,762320869,1216
1360340964,762347560,3,144,48,1360340937178,1360340946202,762320738,762329762,9024
1360340968,762351440,3,144,48,1360340942227,1360340943507,762325667,762326947,1280
1360340968,762351448,3,144,48,1360340943371,1360340944715,762326819,762328163,1344
1360340972,762355496,3,144,48,1360340944412,1360340945884,762327908,762329380,1472
1360340972,762355496,2,96,48,1360340944410,1360340947418,762327906,762330914,3008
1360341073,762457052,15,3771,251.4,1360341065647,1360341068015,762449699,762452067,2368
1360341073,762457128,6,276,46,1360341065252,1360341065252,762449380,762449380,0
1360341096,762479912,9,3463,384.7777778,1360341068475,1360341069627,762452387,762453539,1152
1360341192,762575996,1,46,46,1360341164518,1360341164518,762548514,762548514,0
1360341193,762577128,2,131,65.5,1360341189280,1360341189280,762573408,762573408,0
1360341200,762584144,1,52,52,1360341171918,1360341171918,762556062,762556062,0
1360341461,762844472,2,339,169.5,1360341435244,1360341435244,762818716,762818716,0
1360341474,762857384,3,138,46,1360341472261,1360341472261,762855645,762855645,0
1360341497,762880508,13,4387,337.4615385,1360341472456,1360341476040,762855964,762859548,3584
1360341501,762884480,1,191,191,1360341474276,1360341474276,762857756,762857756,0
1360341529,762912596,1,52,52,1360341502064,1360341502064,762885660,762885660,0
1360341741,763125044,1,52,52,1360341715500,1360341715500,763099544,763099544,0
1360342275,763658584,2,110,55,1360342261937,1360342272369,763645521,763655953,10432
1360342287,763670668,28,6752,241.1428571,1360342259035,1360342280027,763642703,763663695,20992
1360342287,763670676,14,5716,408.2857143,1360342260050,1360342274514,763643726,763658190,14464
1360342295,763678656,16,10421,651.3125,1360342269222,1360342275622,763652878,763659278,6400
1360342299,763682616,1,52,52,1360342271246,1360342271246,763654862,763654862,0
1360342307,763690744,8,2776,347,1360342281422,1360342282702,763665166,763666446,1280
1360342323,763706320,3,168,56,1360342315190,1360342316086,763698510,763699406,896
1360342343,763726744,19,3493,183.8421053,1360342315726,1360342320462,763699470,763704206,4736
1360342343,763726780,1,64,64,1360342317036,1360342317036,763700816,763700816,0
1360342347,763730752,1,52,52,1360342319174,1360342319174,763702926,763702926,0
1360342371,763754732,2,697,348.5,1360342346396,1360342346396,763730128,763730128,0
1360342391,763774772,8,4360,545,1360342364785,1360342366321,763748557,763750093,1536
1360342395,763778400,3,168,56,1360342390948,1360342391780,763774348,763775180,832
1360342395,763778412,3,168,56,1360342391964,1360342392476,763775376,763775888,512
1360342419,763802732,23,4420,192.173913,1360342391322,1360342399130,763775054,763782862,7808
1360342419,763802768,1,52,52,1360342393012,1360342393012,763776780,763776780,0
1360342427,763810760,1,64,64,1360342402621,1360342402621,763786381,763786381,0
1360342427,763810892,1,46,46,1360342401464,1360342401464,763785356,763785356,0
1360342467,763850548,3,168,56,1360342458767,1360342459343,763842315,763842891,576
1360342475,763858456,4,271,67.75,1360342470509,1360342471149,763853965,763854605,640
1360342487,763870836,1,64,64,1360342459504,1360342459504,763843340,763843340,0
1360342487,763870952,1,46,46,1360342460989,1360342460989,763844941,763844941,0
1360342495,763878984,9,3463,384.7777778,1360342467165,1360342468381,763851149,763852365,1216
1360342499,763882908,1,64,64,1360342470951,1360342470951,763854859,763854859,0
1360342507,763890436,3,168,56,1360342504703,1360342505279,763888139,763888715,576
1360342531,763914864,1,46,46,1360342504084,1360342504084,763887948,763887948,0
1360342539,763922932,1,46,46,1360342514768,1360342514768,763898700,763898700,0
1360342547,763930936,1,46,46,1360342522507,1360342522507,763906443,763906443,0
1360342595,763978544,2,131,65.5,1360342588690,1360342588690,763972234,763972234,0
1360342631,764015152,1,46,46,1360342605938,1360342605938,763990090,763990090,0
1360342715,764098588,21,3988,189.9047619,1360342712100,1360342713956,764095688,764097544,1856
1360342715,764098668,13,3673,282.5384615,1360342709654,1360342711702,764093322,764095370,2048
1360342715,764098668,16,3306,206.625,1360342709845,1360342712021,764093513,764095689,2176
1360342723,764106604,15,3198,213.2,1360342721110,1360342722774,764104714,764106378,1664
1360342723,764106604,15,6762,450.8,1360342717589,1360342718805,764101193,764102409,1216
1360342723,764106632,17,3582,210.7058824,1360342714039,1360342715511,764097671,764099143,1472
1360342723,764106640,16,5312,332,1360342715506,1360342717362,764099146,764101002,1856
1360342723,764106676,20,3738,186.9,1360342717645,1360342719437,764101321,764103113,1792
1360342723,764106684,14,3248,232,1360342718723,1360342720579,764102407,764104263,1856
1360342731,764114640,19,3527,185.6315789,1360342727666,1360342729202,764111306,764112842,1536
1360342731,764114660,58,59079,1018.603448,1360342724382,1360342727646,764108042,764111306,3264
1360342731,764114704,22,4277,194.4090909,1360342722674,1360342724338,764106378,764108042,1664
1360342735,764119116,1,46,46,1360342708435,1360342708435,764092551,764092551,0
1360342736,764119188,9,4004,444.8888889,1360342708019,1360342709939,764091207,764093127,1920
1360342739,764122628,19,3339,175.7368421,1360342729340,1360342730876,764112968,764114504,1536
1360342751,764135132,8,3390,423.75,1360342724359,1360342725639,764108491,764109771,1280
1360342864,764247464,1,46,46,1360342838112,1360342838112,764221576,764221576,0
1360342864,764247552,1,64,64,1360342838662,1360342838662,764222214,764222214,0
1360342868,764251504,1,52,52,1360342842549,1360342842549,764226053,764226053,0
1360342868,764251548,17,3966,233.2941176,1360342840649,1360342844169,764224197,764227717,3520
1360342931,764314740,9,1701,189,1360342925516,1360342927052,764309256,764310792,1536
1360342948,764331584,1,759,759,1360342923687,1360342923687,764307271,764307271,0
1360342952,764335704,1,46,46,1360342926316,1360342926316,764310020,764310020,0
1360342976,764359760,1,52,52,1360342949367,1360342949367,764333127,764333127,0
1360342992,764375924,1,52,52,1360342965841,1360342965841,764349765,764349765,0
1360343253,764636692,1,46,46,1360343225461,1360343225461,764609153,764609153,0
1360343281,764664704,6,3762,627,1360343253416,1360343272936,764637120,764656640,19520
1360343307,764691032,4,1933,483.25,1360343282591,1360343302559,764666623,764686591,19968
1360343337,764720948,1,627,627,1360343312692,1360343312692,764696640,764696640,0
1360343996,765379620,3,168,56,1360343993457,1360343994161,765377077,765377781,704
1360343996,765379704,3,168,56,1360343994396,1360343995292,765378100,765378996,896
1360344023,765406868,1,64,64,1360343995451,1360343995451,765379319,765379319,0
1360344023,765406868,22,5854,266.0909091,1360343996218,1360344000570,765380086,765384438,4352
1360344027,765410932,14,7021,501.5,1360343999672,1360344002296,765383604,765386228,2624
1360344175,765559080,3,459,153,1360344150373,1360344150821,765534453,765534901,448
1360344268,765651208,1,52,52,1360344243017,1360344243017,765626225,765626225,0
1360344271,765655140,7,2689,384.1428571,1360344243813,1360344244901,765627953,765629041,1088
1360344332,765716100,4,271,67.75,1360344328717,1360344329549,765712817,765713649,832
1360344332,765716108,3,168,56,1360344329859,1360344330499,765713967,765714607,640
1360344332,765716144,4,271,67.75,1360344327583,1360344328415,765711727,765712559,832
1360344340,765724092,3,168,56,1360344336021,1360344336661,765720113,765720753,640
1360344340,765724120,3,168,56,1360344333880,1360344334584,765718000,765718704,704
1360344340,765724124,3,168,56,1360344334836,1360344335476,765718960,765719600,640
1360344356,765739376,19,4070,214.2105263,1360344330911,1360344334495,765714287,765717871,3584
1360344360,765743340,1,52,52,1360344332676,1360344332676,765716016,765716016,0
1360344412,765796128,3,168,56,1360344407089,1360344407665,765791217,765791793,576
1360344412,765796168,3,168,56,1360344405958,1360344406726,765790126,765790894,768
1360344413,765796216,3,168,56,1360344406015,1360344406655,765789231,765789871,640
1360344432,765815608,1,46,46,1360344405110,1360344405110,765788718,765788718,0
1360344512,765895684,1,46,46,1360344485355,1360344485355,765869039,765869039,0
1360344631,766014392,1,125,125,1360344601741,1360344601741,765985133,765985133,0
1360344638,766021168,3,168,56,1360344636459,1360344637291,766019627,766020459,832
1360344645,766029108,3,168,56,1360344637310,1360344637886,766021418,766021994,576
1360344645,766029112,2,116,58,1360344644541,1360344644861,766028653,766028973,320
1360344646,766029192,3,168,56,1360344639123,1360344640339,766022315,766023531,1216
1360344646,766029228,3,168,56,1360344640622,1360344641262,766023850,766024490,640
1360344646,766029232,3,168,56,1360344644523,1360344645099,766027755,766028331,576
1360344661,766044276,20,4389,219.45,1360344636289,1360344640129,766019565,766023405,3840
1360344665,766048232,1,52,52,1360344638060,1360344638060,766021292,766021292,0
1360344665,766048236,1,46,46,1360344637543,1360344637543,766020779,766020779,0
1360344673,766056212,1,64,64,1360344646401,1360344646401,766029613,766029613,0
1360344673,766056284,1,52,52,1360344645944,1360344645944,766029228,766029228,0
1360344877,766260848,1,46,46,1360344850882,1360344850882,766234730,766234730,0
1360345025,766408984,1,64,64,1360345000566,1360345000566,766384550,766384550,0
1360345029,766413024,20,4130,206.5,1360345003535,1360345007119,766387559,766391143,3584
1360345033,766417000,1,52,52,1360345005413,1360345005413,766389413,766389413,0
1360345166,766549656,18,4514,250.7777778,1360345160189,1360345162557,766543845,766546213,2368
1360345166,766549660,3,168,56,1360345161078,1360345161526,766544738,766545186,448
1360345166,766549688,15,3762,250.8,1360345158362,1360345159770,766542050,766543458,1408
1360345166,766549736,13,3583,275.6153846,1360345160110,1360345163182,766543846,766546918,3072
1360345166,766549736,13,3571,274.6923077,1360345160428,1360345162284,766544164,766546020,1856
1360345190,766573176,9,3475,386.1111111,1360345163291,1360345166043,766546467,766549219,2752
1360345286,766669752,2,131,65.5,1360345285336,1360345285336,766669088,766669088,0
1360346111,3700774392,9,5162,573.5555556,1360346102424,1360346107672,3700765816,3700771064,5248
1360346111,3700774396,9,4474,497.1111111,1360346105043,1360346106771,3700768439,3700770167,1728
1360346111,3700774404,11,7026,638.7272727,1360346103308,1360346109516,3700766712,3700772920,6208
1360346128,767511244,10,776,77.6,1360346101193,1360346103113,767484437,767486357,1920
1360346143,767526976,31,6871,221.6451613,1360346138734,1360346142702,767522710,767526678,3968
1360346159,767542984,14,6730,480.7142857,1360346149733,1360346154021,767533717,767538005,4288
1360346168,767551232,21,1308,62.28571429,1360346143702,1360346144662,767526934,767527894,960
1360346888,768272068,3,156,52,1360346879366,1360346883526,768263434,768267594,4160
1360346905,768288176,2,104,52,1360346889919,1360346899903,768273095,768283079,9984
1360346921,768304176,2,104,52,1360346909890,1360346919938,768293066,768303114,10048
1360346944,768328144,2,104,52,1360346928954,1360346938938,768313098,768323082,9984
1360347134,768517368,230,11040,48,1360346829053,1360346831677,768212421,768215045,2624
1360347703,769086352,1,46,46,1360347677702,1360347677702,769061054,769061054,0
1360348464,769848008,3,144,48,1360348438569,1360348447529,769822577,769831537,8960
1360349506,770889808,1,60,60,1360349479456,1360349479456,770863264,770863264,0
1360349506,770889852,1,60,60,1360349481527,1360349481527,770865379,770865379,0
1360349510,770893792,1,60,60,1360349482737,1360349482737,770866529,770866529,0
1360349510,770893872,1,60,60,1360349482658,1360349482658,770866530,770866530,0
1360349534,770917888,1,60,60,1360349509584,1360349509584,770893472,770893472,0
1360349534,770917936,1,60,60,1360349508450,1360349508450,770892386,770892386,0
1360349538,770921912,1,60,60,1360349511674,1360349511674,770895586,770895586,0
1360349570,770953996,15,9072,604.8,1360349544803,1360349554211,770928799,770938207,9408
1360349571,770954164,16,10620,663.75,1360349560486,1360349567334,770943650,770950498,6848
1360349579,770962196,17,13958,821.0588235,1360349569539,1360349574531,770952735,770957727,4992
1360349582,770965968,10,2488,248.8,1360349554369,1360349559297,770938337,770943265,4928
1360349586,770970152,14,7167,511.9285714,1360349574344,1360349584648,770958496,770968800,10304
1360349595,770978164,3,168,56,1360349587236,1360349587812,770970400,770970976,576
1360349595,770978172,3,168,56,1360349588125,1360349588765,770971297,770971937,640
1360349603,770986252,27,27664,1024.592593,1360349583690,1360349599306,770966942,770982558,15616
1360349603,770986404,5,335,67,1360349593845,1360349598069,770977249,770981473,4224
1360349611,770994180,30,32872,1095.733333,1360349603027,1360349604883,770986207,770988063,1856
1360349618,771002004,1,52,52,1360349589979,1360349589979,770973983,770973983,0
1360349619,771002240,7,5765,823.5714286,1360349605398,1360349615894,770988638,770999134,10496
1360349803,771186676,3,156,52,1360349794530,1360349800226,771178206,771183902,5696
1360349915,771299044,3,168,56,1360349911726,1360349912366,771295770,771296410,640
1360349915,771299076,3,168,56,1360349912591,1360349913231,771296667,771297307,640
1360349915,771299084,3,168,56,1360349913544,1360349914120,771297628,771298204,576
1360349923,771306964,3,168,56,1360349914625,1360349915521,771298589,771299485,896
1360349923,771307048,7,1609,229.8571429,1360349918828,1360349920300,771302876,771304348,1472
1360349923,771307052,20,14188,709.4,1360349915367,1360349917479,771299419,771301531,2112
1360349943,771326704,20,4130,206.5,1360349915266,1360349919170,771298970,771302874,3904
1360349943,771326800,1,46,46,1360349915937,1360349915937,771299737,771299737,0
1360349943,771326832,1,64,64,1360349916677,1360349916677,771300509,771300509,0
1360349943,771326832,1,52,52,1360349916802,1360349916802,771300634,771300634,0
1360350028,771411256,3,168,56,1360350025536,1360350025664,771408792,771408920,128
1360350039,771422992,4,1381,345.25,1360350011745,1360350028705,771395737,771412697,16960
1360350044,771427300,10,4433,443.3,1360350039445,1360350040085,771422745,771423385,640
1360350051,771434948,1,46,46,1360350024845,1360350024845,771408793,771408793,0
1360350051,771434948,1,64,64,1360350024973,1360350024973,771408921,771408921,0
1360350060,771443308,9,4387,487.4444444,1360350059535,1360350059855,771442843,771443163,320
1360350067,771450844,16,4979,311.1875,1360350038963,1360350065651,771422807,771449495,26688
1360350067,771450924,9,4456,495.1111111,1360350038822,1360350042086,771422746,771426010,3264
1360350067,771450932,26,15694,603.6153846,1360350039582,1360350063646,771423514,771447578,24064
1360350071,771454972,19,13948,734.1052632,1360350043443,1360350063155,771427415,771447127,19712
1360350076,771459256,6,530,88.33333333,1360350068544,1360350073600,771451800,771456856,5056
1360350099,771482976,1,46,46,1360350072881,1360350072881,771456857,771456857,0
1360350099,771482976,20,6598,329.9,1360350072880,1360350097136,771456856,771481112,24256
1360350103,771486900,6,4792,798.6666667,1360350076347,1360350076539,771460247,771460439,192
1360350103,771486980,23,20217,879,1360350075565,1360350078893,771459545,771462873,3328
1360350108,771491308,2,127,63.5,1360350102603,1360350107595,771485911,771490903,4992
1360350119,771502976,1,186,186,1360350094001,1360350094001,771477977,771477977,0
1360350119,771503048,11,4204,382.1818182,1360350093352,1360350095656,771477400,771479704,2304
1360350131,771515012,7,460,65.71428571,1360350106701,1360350126861,771490713,771510873,20160
1360350148,771531312,2,127,63.5,1360350136649,1360350141641,771519961,771524953,4992
1360350148,771531348,2,127,63.5,1360350138531,1360350143523,771521879,771526871,4992
1360350155,771538988,1,64,64,1360350128226,1360350128226,771512214,771512214,0
1360350163,771547088,7,476,68,1360350136705,1360350157057,771520793,771541145,20352
1360350175,771558972,1,52,52,1360350147058,1360350147058,771531030,771531030,0
1360350180,771563432,8,529,66.125,1360350167310,1360350177806,771550742,771561238,10496
1360350284,771667460,3,168,56,1360350277682,1360350278258,771661142,771661718,576
1360350304,771687256,1,46,46,1360350277502,1360350277502,771660758,771660758,0
1360350340,771723548,2,104,52,1360350336154,1360350336410,771719702,771719958,256
1360350692,772075720,28,18213,650.4642857,1360350671913,1360350685097,772055633,772068817,13184
1360350697,772080508,8,2741,342.625,1360350672061,1360350673213,772055569,772056721,1152
1360350705,772088584,54,48631,900.5740741,1360350679599,1360350702127,772063183,772085711,22528
1360350828,772211816,2,131,65.5,1360350821764,1360350821764,772205580,772205580,0
1360350938,772321348,1,46,46,1360350913369,1360350913369,772296717,772296717,0
1360350980,772364000,2,98,49,1360350966475,1360350976843,772350475,772360843,10368
1360350982,772365540,2,485,242.5,1360350956184,1360350956184,772339724,772339724,0
1360350986,772369372,19,9609,505.7368421,1360350959229,1360350963517,772342601,772346889,4288
1360350986,772369396,8,3958,494.75,1360350959846,1360350960358,772343242,772343754,512
1360350988,772371940,2,112,56,1360350969991,1360350982151,772353931,772366091,12160
1360350988,772371940,2,112,56,1360350969991,1360350982151,772353931,772366091,12160
1360350988,772372024,2,112,56,1360350969905,1360350982065,772353929,772366089,12160
1360350988,772372024,12,3363,280.25,1360350982644,1360350983348,772366668,772367372,704
1360350990,772373376,6,893,148.8333333,1360350964796,1360350966460,772348172,772349836,1664
1360350994,772377376,4,500,125,1360350966521,1360350966521,772349897,772349897,0
1360350994,772377404,4,500,125,1360350967582,1360350967646,772350986,772351050,64
1360350994,772377452,1,46,46,1360350969520,1360350969520,772352972,772352972,0
1360350994,772377464,29,32744,1129.103448,1360350967010,1360350975970,772350474,772359434,8960
1360350998,772381512,5,548,109.6,1360350970419,1360350979059,772353931,772362571,8640
1360351002,772385404,4,500,125,1360350975646,1360350975710,772359050,772359114,64
1360351002,772385408,4,500,125,1360350975835,1360350975899,772359243,772359307,64
1360351002,772385408,4,500,125,1360350976025,1360350976089,772359433,772359497,64
1360351002,772385412,4,500,125,1360350976088,1360350976152,772359500,772359564,64
1360351002,772385412,4,500,125,1360350976216,1360350976280,772359628,772359692,64
1360351002,772385412,4,500,125,1360350976342,1360350976406,772359754,772359818,64
1360351002,772385416,4,500,125,1360350976658,1360350976658,772360074,772360074,0
1360351002,772385496,4,500,125,1360350975938,1360350975938,772359434,772359434,0
1360351002,772385500,4,500,125,1360350976446,1360350976446,772359946,772359946,0
1360351004,772387992,2,112,56,1360350979411,1360350996499,772363403,772380491,17088
1360351004,772387992,2,112,56,1360350979283,1360350996499,772363275,772380491,17216
1360351004,772387992,2,112,56,1360350979410,1360350996498,772363402,772380490,17088
1360351004,772388072,2,112,56,1360350979202,1360350996418,772363274,772380490,17216
1360351004,772388072,2,112,56,1360350979330,1360350996418,772363402,772380490,17088
1360351006,772389408,7,6219,888.4285714,1360350979868,1360350980060,772363276,772363468,192
1360351006,772389408,7,6018,859.7142857,1360350979995,1360350980059,772363403,772363467,64
1360351006,772389480,8,8640,1080,1360350979794,1360350979986,772363274,772363466,192
1360351010,772393436,9,3463,384.7777778,1360350982014,1360350982846,772365450,772366282,832
1360363713,785096480,1,48,48,1360363688210,1360363688210,785071690,785071690,0
1360363961,785344804,1,46,46,1360363936137,1360363936137,785319941,785319941,0
1360363969,785352916,3,168,56,1360363967836,1360363968476,785351752,785352392,640
1360363977,785360972,4,271,67.75,1360363968803,1360363969507,785352775,785353479,704
1360363993,785376684,1,64,64,1360363964928,1360363964928,785348612,785348612,0
1360363993,785376732,19,4062,213.7894737,1360363967633,1360363971217,785351365,785354949,3584
1360363993,785376736,10,4625,462.5,1360363968014,1360363969550,785351750,785353286,1536
1360364001,785384972,16,3306,206.625,1360363993568,1360363995232,785377540,785379204,1664
1360364017,785400756,9,3463,384.7777778,1360363992123,1360363993467,785375879,785377223,1344
1360364017,785400836,8,3498,437.25,1360363991530,1360363992938,785375366,785376774,1408
1360364057,785440816,1,52,52,1360364030459,1360364030459,785414275,785414275,0
1360364110,785493132,3,457,152.3333333,1360364085544,1360364086056,785468676,785469188,512
1360364114,785497344,2,131,65.5,1360364113749,1360364113749,785497093,785497093,0
1360364258,785641620,1,52,52,1360364233152,1360364233152,785616772,785616772,0
1360364274,785657732,3,168,56,1360364271183,1360364271759,785654915,785655491,576
1360364298,785681784,19,4062,213.7894737,1360364271065,1360364274073,785654849,785657857,3008
1360364298,785681912,1,52,52,1360364272219,1360364272219,785656131,785656131,0
1360364522,785905756,7,1594,227.7142857,1360364519347,1360364520563,785903103,785904319,1216
1360364586,785969788,3,168,56,1360364582739,1360364583315,785966527,785967103,576
1360364594,785977816,3,168,56,1360364586612,1360364587188,785970428,785971004,576
1360364611,785994600,1,52,52,1360364584139,1360364584139,785967739,785967739,0
1360364611,785994640,19,4062,213.7894737,1360364582820,1360364586276,785966460,785969916,3456
1360364615,785998564,1,64,64,1360364587696,1360364587696,785971260,785971260,0
1360364906,786289948,2,110,55,1360364894253,1360364905453,786278201,786289401,11200
1360364920,786303536,19,4062,213.7894737,1360364894663,1360364898247,786278199,786281783,3584
1360364924,786307488,1,52,52,1360364896248,1360364896248,786279736,786279736,0
1360364932,786315652,1,64,64,1360364905106,1360364905106,786288758,786288758,0
1360364957,786340912,1,46,46,1360364928144,1360364928144,786312056,786312056,0
1360365016,786399904,3,457,152.3333333,1360364990935,1360364991383,786374839,786375287,448
1360365092,786476080,1,46,46,1360365064611,1360365064611,786448691,786448691,0
1360365093,786476144,2,539,269.5,1360365068685,1360365068685,786451829,786451829,0
1360365155,786538168,12,6349,529.0833333,1360365149235,1360365150387,786532403,786533555,1152
1360365155,786538176,12,6258,521.5,1360365150058,1360365151082,786533234,786534258,1024
1360365155,786538208,13,6844,526.4615385,1360365146572,1360365147468,786529780,786530676,896
1360365155,786538248,15,6698,446.5333333,1360365147427,1360365148643,786530675,786531891,1216
1360365155,786538260,11,6552,595.6363636,1360365148312,1360365149016,786531572,786532276,704
1360365173,786556460,1,52,52,1360365145936,1360365145936,786529396,786529396,0
1360365211,786594316,3,168,56,1360365206303,1360365206943,786589619,786590259,640
1360365211,786594328,3,168,56,1360365207445,1360365208341,786590773,786591669,896
1360365233,786616600,19,4062,213.7894737,1360365206276,1360365212100,786589876,786595700,5824
1360365237,786620544,1,52,52,1360365210556,1360365210556,786594100,786594100,0
1360365501,786885312,1,186,186,1360365475959,1360365475959,786860271,786860271,0
1360365506,786889372,12,5874,489.5,1360365479140,1360365482276,786862512,786865648,3136
1360365523,786906720,3,168,56,1360365519942,1360365520582,786903662,786904302,640
1360365531,786914688,3,168,56,1360365525989,1360365526629,786909677,786910317,640
1360365531,786914728,3,168,56,1360365527873,1360365528449,786911601,786912177,576
1360365531,786914772,3,168,56,1360365526868,1360365527444,786910640,786911216,576
1360365531,786914784,4,271,67.75,1360365524936,1360365525640,786908720,786909424,704
1360365531,786914784,4,232,58,1360365521030,1360365524358,786904814,786908142,3328
1360365546,786929412,1,46,46,1360365519546,1360365519546,786902958,786902958,0
1360365546,786929440,20,4238,211.9,1360365520223,1360365523807,786903663,786907247,3584
1360365550,786933324,9,3499,388.7777778,1360365523412,1360365524692,786906736,786908016,1280
1360365550,786933324,1,52,52,1360365522129,1360365522129,786905453,786905453,0
1360365675,787058864,4,271,67.75,1360365670965,1360365671541,787054829,787055405,576
1360365675,787058872,3,168,56,1360365671854,1360365672494,787055726,787056366,640
1360365675,787058880,3,168,56,1360365672803,1360365673379,787056683,787057259,576
1360365750,787133560,1,52,52,1360365722082,1360365722082,787105642,787105642,0
1360365790,787173676,1,52,52,1360365764337,1360365764337,787148013,787148013,0
1360365835,787218856,3,168,56,1360365833594,1360365834362,787217450,787218218,768
1360365835,787218864,3,168,56,1360365830641,1360365831217,787214505,787215081,576
1360365835,787218904,3,168,56,1360365832524,1360365833164,787216428,787217068,640
1360365835,787218908,3,168,56,1360365829636,1360365830212,787213544,787214120,576
1360365843,787226868,23,9376,407.6521739,1360365836398,1360365838446,787220266,787222314,2048
1360365843,787226904,15,3266,217.7333333,1360365834379,1360365836299,787218283,787220203,1920
1360365843,787226904,16,3535,220.9375,1360365838538,1360365840138,787222442,787224042,1600
1360365843,787226932,3,168,56,1360365834736,1360365835568,787218668,787219500,832
1360365843,787226940,18,5419,301.0555556,1360365840103,1360365841703,787224043,787225643,1600
1360365851,787234856,15,6762,450.8,1360365841913,1360365843385,787225769,787227241,1472
1360365851,787234860,20,3738,186.9,1360365842039,1360365844023,787225899,787227883,1984
1360365851,787234868,16,3935,245.9375,1360365847216,1360365848816,787231084,787232684,1600
1360365851,787234900,17,3290,193.5294118,1360365845648,1360365847184,787229548,787231084,1536
1360365851,787234904,13,3606,277.3846154,1360365843339,1360365845195,787227243,787229099,1856
1360365858,787241620,1,46,46,1360365831784,1360365831784,787215404,787215404,0
1360365858,787241628,7,3438,491.1428571,1360365832732,1360365833948,787216360,787217576,1216
1360365858,787241720,19,4062,213.7894737,1360365832643,1360365835715,787216363,787219435,3072
1360365860,787243148,22,3477,158.0454545,1360365854462,1360365855998,787237610,787239146,1536
1360365860,787243164,16,3389,211.8125,1360365852527,1360365854319,787235691,787237483,1792
1360365860,787243244,56,59317,1059.232143,1360365849437,1360365853213,787232681,787236457,3776
1360365862,787245612,1,52,52,1360365834414,1360365834414,787218026,787218026,0
1360365930,787313712,12,5220,435,1360365904327,1360365906055,787288039,787289767,1728
1360365930,787313792,1,186,186,1360365903736,1360365903736,787287528,787287528,0
1360365946,787329768,1,96,96,1360365918480,1360365918480,787302248,787302248,0
1360366099,787482288,1,52,52,1360366074284,1360366074284,787457572,787457572,0
1360366111,787494112,1,186,186,1360366084383,1360366084383,787467495,787467495,0
1360366111,787494240,3,567,189,1360366084895,1360366085023,787468135,787468263,128
1360366167,787550468,1,64,64,1360366141433,1360366141433,787524901,787524901,0
1360366171,787554528,19,4062,213.7894737,1360366144381,1360366147261,787527909,787530789,2880
1360366171,787554576,1,52,52,1360366145806,1360366145806,787529382,787529382,0
1360366295,787678692,1,186,186,1360366269848,1360366269848,787653540,787653540,0
1360366299,787682952,13,6940,533.8461538,1360366272340,1360366274388,787656292,787658340,2048
1360366351,787734764,1,52,52,1360366324496,1360366324496,787708260,787708260,0
1360366468,787851836,3,168,56,1360366463171,1360366463811,787847007,787847647,640
1360366475,787858912,3,558,186,1360366449658,1360366451322,787833570,787835234,1664
1360366479,787862784,1,64,64,1360366452535,1360366452535,787836319,787836319,0
1360366479,787862908,21,4298,204.6666667,1360366453244,1360366457148,787837152,787841056,3904
1360366483,787866796,8,3439,429.875,1360366456301,1360366457453,787840097,787841249,1152
1360366539,787922976,1,52,52,1360366514361,1360366514361,787898337,787898337,0
1360366724,788107396,1,52,52,1360366697848,1360366697848,788081244,788081244,0
1360366773,788156332,3,168,56,1360366765241,1360366765817,788148573,788149149,576
1360366773,788156364,3,168,56,1360366766166,1360366766742,788149530,788150106,576
1360366788,788171544,1,46,46,1360366762789,1360366762789,788146333,788146333,0
1360366792,788175500,20,4122,206.1,1360366767633,1360366771089,788151133,788154589,3456
1360366792,788175500,1,64,64,1360366767632,1360366767632,788151132,788151132,0
1360366792,788175560,1,46,46,1360366766869,1360366766869,788150429,788150429,0
1360366796,788179544,1,52,52,1360366769379,1360366769379,788152923,788152923,0
1360366828,788211816,3,457,152.3333333,1360366803219,1360366803667,788187035,788187483,448
1360366845,788228292,36,40169,1115.805556,1360366841374,1360366843742,788224666,788227034,2368
1360366853,788236300,29,30680,1057.931034,1360366844248,1360366846104,788227548,788229404,1856
1360366853,788236340,3,168,56,1360366850993,1360366851697,788234333,788235037,704
1360366853,788236340,3,168,56,1360366848239,1360366848815,788231579,788232155,576
1360366853,788236348,3,168,56,1360366849064,1360366849704,788232412,788233052,640
1360366853,788236352,3,168,56,1360366850018,1360366850594,788233370,788233946,576
1360366853,788236384,3,168,56,1360366847235,1360366847811,788230619,788231195,576
1360366864,788247688,1,186,186,1360366836241,1360366836241,788219929,788219929,0
1360366864,788247804,10,4866,486.6,1360366837343,1360366839199,788221147,788223003,1856
1360366872,788255836,1,46,46,1360366846525,1360366846525,788230361,788230361,0
1360367041,788424268,1,186,186,1360367016693,1360367016693,788399961,788399961,0
1360367045,788428272,9,3899,433.2222222,1360367017135,1360367017775,788400407,788401047,640
1360367085,788468576,13,3583,275.6153846,1360367081854,1360367083518,788465430,788467094,1664
1360367085,788468584,18,4466,248.1111111,1360367079415,1360367081015,788462999,788464599,1600
1360367085,788468620,15,3760,250.6666667,1360367077012,1360367078548,788460632,788462168,1536
1360367085,788468656,13,3571,274.6923077,1360367079665,1360367081777,788463321,788465433,2112
1360367085,788468656,13,3583,275.6153846,1360367079664,1360367081776,788463320,788465432,2112
1360367093,788476668,3,168,56,1360367087459,1360367088099,788471127,788471767,640
1360367105,788488336,1,64,64,1360367077231,1360367077231,788460567,788460567,0
1360367105,788488464,20,4122,206.1,1360367079279,1360367082927,788462743,788466391,3648
1360367109,788492436,1,52,52,1360367081356,1360367081356,788464792,788464792,0
1360367109,788492436,9,3463,384.7777778,1360367081545,1360367082825,788464981,788466261,1280
1360367205,788588924,2,131,65.5,1360367202146,1360367202146,788586070,788586070,0
1360367205,788588936,3,168,56,1360367204055,1360367204759,788587991,788588695,704
1360367213,788596860,3,168,56,1360367206113,1360367206689,788589973,788590549,576
1360367213,788596896,3,168,56,1360367205116,1360367205692,788589012,788589588,576
1360367213,788596932,3,168,56,1360367207513,1360367208153,788591445,788592085,640
1360367213,788596940,3,168,56,1360367208467,1360367209043,788592407,788592983,576
1360367229,788612728,1,46,46,1360367204004,1360367204004,788587732,788587732,0
1360367233,788616732,1,46,46,1360367207135,1360367207135,788590867,788590867,0
1360367237,788620780,1,64,64,1360367209584,1360367209584,788593364,788593364,0
1360367237,788620788,1,46,46,1360367210026,1360367210026,788593814,788593814,0
1360367285,788668940,1,52,52,1360367257105,1360367257105,788641045,788641045,0
1360367406,788789488,2,110,55,1360367388628,1360367398932,788772116,788782420,10304
1360367406,788789496,3,168,56,1360367399113,1360367399753,788782609,788783249,640
1360367414,788797188,1,46,46,1360367388286,1360367388286,788771474,788771474,0
1360367418,788801116,1,52,52,1360367393029,1360367393029,788776145,788776145,0
1360367418,788801160,19,4062,213.7894737,1360367391451,1360367394523,788774611,788777683,3072
1360367426,788809504,1,64,64,1360367400068,1360367400068,788783572,788783572,0
1360367702,789085888,3,168,56,1360367699260,1360367700028,789083148,789083916,768
1360367702,789085964,3,168,56,1360367700274,1360367700914,789084238,789084878,640
1360367702,789085968,2,104,52,1360367700845,1360367701421,789084813,789085389,576
1360367726,789109408,22,4519,205.4090909,1360367699870,1360367709406,789083278,789092814,9536
1360368015,789398464,3,168,56,1360368011682,1360368012258,789395146,789395722,576
1360368023,789406664,2,110,55,1360368012379,1360368022683,789396043,789406347,10304
1360368031,789414624,3,168,56,1360368022977,1360368023553,789406601,789407177,576
1360368031,789414628,3,168,56,1360368023869,1360368024509,789407497,789408137,640
1360368031,789414632,3,168,56,1360368027578,1360368028218,789411210,789411850,640
1360368031,789414636,3,168,56,1360368025716,1360368026356,789409352,789409992,640
1360368031,789414680,3,168,56,1360368024777,1360368025353,789408457,789409033,576
1360368031,789414712,3,168,56,1360368026539,1360368027179,789410251,789410891,640
1360368039,789422576,19,4064,213.8947368,1360368011503,1360368015919,789395079,789399495,4416
1360368039,789422628,1,52,52,1360368014331,1360368014331,789397959,789397959,0
1360368336,789719508,3,168,56,1360368333874,1360368334514,789717382,789718022,640
1360368336,789719508,2,110,55,1360368323314,1360368333618,789706822,789717126,10304
1360368336,789719560,3,168,56,1360368334782,1360368335358,789718342,789718918,576
1360368344,789727432,3,168,56,1360368335804,1360368336444,789719236,789719876,640
1360368348,789731376,19,4066,214,1360368323442,1360368327090,789706818,789710466,3648
1360368352,789735260,1,52,52,1360368325161,1360368325161,789708421,789708421,0
1360368364,789747268,1,64,64,1360368336862,1360368336862,789720130,789720130,0
1360368640,790023788,4,510,127.5,1360368615125,1360368636117,789998913,790019905,20992
1360368648,790032032,2,110,55,1360368634400,1360368644704,790018432,790028736,10304
1360368660,790043796,19,4066,214,1360368634636,1360368637708,790018432,790021504,3072
1360368672,790055808,1,64,64,1360368645185,1360368645185,790028993,790028993,0
1360368761,790144104,28,20343,726.5357143,1360368747773,1360368760445,790130877,790143549,12672
1360368768,790152084,2,110,55,1360368756520,1360368766952,790140604,790151036,10432
1360368780,790163884,50,46723,934.46,1360368753778,1360368776434,790137662,790160318,22656
1360368784,790167908,1,46,46,1360368757720,1360368757720,790141628,790141628,0
1360368905,790288532,1,46,46,1360368880335,1360368880335,790263867,790263867,0
1360368905,790288612,2,131,65.5,1360368896703,1360368896703,790280315,790280315,0
1360368953,790336528,3,168,56,1360368946641,1360368947281,790330169,790330809,640
1360368973,790356280,19,4066,214,1360368946827,1360368950539,790330107,790333819,3712
1360368973,790356384,1,52,52,1360368948260,1360368948260,790331644,790331644,0
1360369265,790648744,3,168,56,1360369257654,1360369258230,790641398,790641974,576
1360369265,790648756,3,168,56,1360369259498,1360369260074,790643254,790643830,576
1360369265,790648796,3,168,56,1360369258499,1360369259075,790642295,790642871,576
1360369286,790669588,19,4066,214,1360369261138,1360369264402,790644726,790647990,3264
1360369290,790673388,1,52,52,1360369262812,1360369262812,790646200,790646200,0
1360369442,790825656,1,191,191,1360369414283,1360369414283,790797939,790797939,0
1360369442,790825816,15,8338,555.8666667,1360369416236,1360369419756,790800052,790803572,3520
1360369547,790930116,3,458,152.6666667,1360369521063,1360369521383,790904179,790904499,320
1360369577,790960872,5,335,67,1360369573106,1360369576562,790956978,790960434,3456
1360369577,790960876,3,168,56,1360369570604,1360369571244,790954480,790955120,640
1360369577,790960880,3,168,56,1360369569512,1360369570344,790953392,790954224,832
1360369577,790960884,4,271,67.75,1360369571559,1360369572647,790955443,790956531,1088
1360369585,790968840,3,168,56,1360369576912,1360369577872,790960752,790961712,960
1360369598,790982060,20,4247,212.35,1360369570101,1360369576053,790954161,790960113,5952
1360369599,790982104,1,52,52,1360369572851,1360369572851,790955955,790955955,0
1360369599,790982140,9,3499,388.7777778,1360369573773,1360369576077,790956913,790959217,2304
1360369687,791070204,1,52,52,1360369660362,1360369660362,791043566,791043566,0
1360369769,791153028,3,168,56,1360369760851,1360369760915,791144879,791144943,64
1360369769,791153032,3,168,56,1360369760976,1360369761040,791145008,791145072,64
1360369785,791169012,2,110,55,1360369771171,1360369781219,791155183,791165231,10048
1360369786,791169088,3,168,56,1360369782143,1360369782271,791165231,791165359,128
1360369787,791170296,1,64,64,1360369761840,1360369761840,791145136,791145136,0
1360369791,791174232,1,435,435,1360369763440,1360369763440,791146672,791146672,0
1360369791,791174312,38,42138,1108.894737,1360369763743,1360369779231,791147055,791162543,15488
1360369799,791182316,7,2975,425,1360369774169,1360369774425,791157485,791157741,256
1360369809,791192988,23,23906,1039.391304,1360369793146,1360369808186,791177134,791192174,15040
1360369823,791206460,3,567,189,1360369797576,1360369797896,791181036,791181356,320
1360369827,791210396,4,1576,394,1360369802443,1360369802699,791185839,791186095,256
1360369851,791234372,11,4750,431.8181818,1360369823714,1360369829090,791207086,791212462,5376
1360369851,791234444,7,1381,197.2857143,1360369823256,1360369825304,791206700,791208748,2048
1360369851,791234480,3,429,143,1360369823861,1360369829557,791207341,791213037,5696
1360369890,791273092,3,168,56,1360369881977,1360369882809,791265069,791265901,832
1360369907,791290464,19,4066,214,1360369881668,1360369885188,791265132,791268652,3520
1360369911,791294452,1,64,64,1360369882897,1360369882897,791266349,791266349,0
1360369911,791294480,1,52,52,1360369883443,1360369883443,791266923,791266923,0
1360369955,791338568,1,46,46,1360369930651,1360369930651,791314219,791314219,0
1360370067,791450796,1,46,46,1360370042103,1360370042103,791425899,791425899,0
1360370091,791474820,1,52,52,1360370064990,1360370064990,791448810,791448810,0
1360370095,791478864,1,52,52,1360370068593,1360370068593,791452457,791452457,0
1360370194,791577524,3,168,56,1360370192772,1360370193412,791576296,791576936,640
1360370202,791585508,3,168,56,1360370194644,1360370195284,791578152,791578792,640
1360370202,791585540,3,168,56,1360370193654,1360370194294,791577194,791577834,640
1360370202,791585540,3,168,56,1360370195571,1360370196403,791579111,791579943,832
1360370224,791607252,1,64,64,1360370197013,1360370197013,791580265,791580265,0
1360370224,791607256,1,52,52,1360370197840,1360370197840,791581096,791581096,0
1360370224,791607292,20,4126,206.3,1360370196138,1360370199594,791579430,791582886,3456
1360370336,791719640,1,186,186,1360370308623,1360370308623,791692263,791692263,0
1360370336,791719668,12,4651,387.5833333,1360370309426,1360370311346,791693094,791695014,1920
1360370506,791890040,3,168,56,1360370504188,1360370504892,791888228,791888932,704
1360370514,791898052,2,238,119,1360370488238,1360370508654,791872290,791892706,20416
1360370517,791900328,3,1103,367.6666667,1360370489602,1360370489858,791872930,791873186,256
1360370523,791906136,4,271,67.75,1360370516611,1360370517251,791899747,791900387,640
1360370533,791916292,9,3463,384.7777778,1360370505639,1360370506599,791888931,791889891,960
1360370533,791916296,20,4242,212.1,1360370507747,1360370511331,791891043,791894627,3584
1360370533,791916296,1,64,64,1360370505954,1360370505954,791889250,791889250,0
1360370537,791920204,11,4750,431.8181818,1360370511422,1360370512254,791894626,791895458,832
1360370545,791928272,1,64,64,1360370517626,1360370517626,791900898,791900898,0
1360370627,792010152,2,131,65.5,1360370626738,1360370626738,792009890,792009890,0
1360370653,792036616,1,46,46,1360370627105,1360370627105,792010721,792010721,0
1360370757,792140700,1,52,52,1360370729486,1360370729486,792113186,792113186,0
1360370777,792160832,1,52,52,1360370751623,1360370751623,792135455,792135455,0
1360370835,792218344,3,168,56,1360370827181,1360370827821,792210525,792211165,640
1360370835,792218380,2,110,55,1360370816649,1360370826953,792200029,792210333,10304
1360370842,792225180,19,4066,214,1360370816851,1360370819987,792200031,792203167,3136
1360370846,792229152,1,52,52,1360370818285,1360370818285,792201437,792201437,0
1360370854,792237180,1,64,64,1360370828305,1360370828305,792211485,792211485,0
1360371147,792530648,2,110,55,1360371127802,1360371139770,792511450,792523418,11968
1360371154,792537968,19,4066,214,1360371127418,1360371131322,792511386,792515290,3904
1360371154,792538008,1,52,52,1360371129297,1360371129297,792513305,792513305,0
1360371359,792742124,3,458,152.6666667,1360371332228,1360371332484,792715352,792715608,256
1360371459,792842824,4,232,58,1360371450436,1360371454148,792834260,792837972,3712
1360371459,792842840,2,110,55,1360371439925,1360371453877,792823765,792837717,13952
1360371459,792842872,3,168,56,1360371454421,1360371455061,792838293,792838933,640
1360371467,792850252,19,4066,214,1360371439875,1360371442947,792823127,792826199,3072
1360371467,792850252,1,46,46,1360371439875,1360371439875,792823127,792823127,0
1360371467,792850336,1,52,52,1360371441198,1360371441198,792824534,792824534,0
1360371756,793139168,3,168,56,1360371752911,1360371753551,793136079,793136719,640
1360371756,793139208,3,168,56,1360371751721,1360371752553,793134929,793135761,832
1360371776,793159204,20,4126,206.3,1360371751723,1360371755115,793134927,793138319,3392
1360371780,793163400,1,46,46,1360371753642,1360371753642,793137042,793137042,0
1360371780,793163404,1,64,64,1360371754339,1360371754339,793137743,793137743,0
1360371780,793163456,1,52,52,1360371753202,1360371753202,793136658,793136658,0
1360371960,793343828,3,458,152.6666667,1360371935035,1360371935739,793318863,793319567,704
1360372644,794027584,3,156,52,1360372637666,1360372640546,794021250,794024130,2880
1360372660,794043628,2,104,52,1360372644341,1360372652021,794027969,794035649,7680
1360372676,794059692,2,104,52,1360372661944,1360372671928,794045636,794055620,9984
1360372700,794083648,2,104,52,1360372682017,1360372692001,794065665,794075649,9984
1360372838,794221568,1,438,438,1360372813490,1360372813490,794197058,794197058,0
1360373748,795131252,3,138,46,1360373723678,1360373727006,795106930,795110258,3328
1360373849,795232700,1,46,46,1360373822301,1360373822301,795206001,795206001,0
1360374008,795391532,1,131,131,1360373980673,1360373980673,795364205,795364205,0
1360374272,795655112,1,46,46,1360374241827,1360374241827,795624939,795624939,0
1360374309,795692444,1,56,56,1360374280982,1360374280982,795664426,795664426,0
1360374750,796133904,1,46,46,1360374723202,1360374723202,796107106,796107106,0
1360375031,796414732,1,437,437,1360375004333,1360375004333,796388065,796388065,0
1360376570,797953736,1,46,46,1360376544018,1360376544018,797927754,797927754,0
1360376959,798342968,1,46,46,1360376931874,1360376931874,798315842,798315842,0
1360377866,799249548,1,48,48,1360377839927,1360377839927,799223475,799223475,0
1360378187,799570292,1,92,92,1360378159603,1360378159603,799542895,799542895,0
1360378193,799576672,1,46,46,1360378163896,1360378163896,799547568,799547568,0
1360378645,800029004,1,46,46,1360378618660,1360378618660,800002664,800002664,0
1360381466,802849944,1,46,46,1360381441140,1360381441140,802825084,802825084,0
1360382604,803987820,1,46,46,1360382579169,1360382579169,803962989,803962989,0
1360382604,803987868,1,46,46,1360382578609,1360382578609,803962477,803962477,0
1360384144,805527412,1,46,46,1360384117858,1360384117858,805501270,805501270,0
1360384949,806332348,1,46,46,1360384920982,1360384920982,806304330,806304330,0
1360385235,806618660,1,46,46,1360385208472,1360385208472,806592132,806592132,0
1360386890,808273164,1,46,46,1360386862446,1360386862446,808245610,808245610,0
1360387904,809287592,1,46,46,1360387878325,1360387878325,809261917,809261917,0
1360388766,810149348,2,230,115,1360388739355,1360388739355,810122703,810122703,0
1360389399,810783004,5,250,50,1360389372992,1360389394752,810756996,810778756,21760
1360390181,811564604,1,148,148,1360390153668,1360390153668,811537272,811537272,0
1360391954,813337736,1,46,46,1360391924325,1360391924325,813308061,813308061,0
1360392028,813411728,1,46,46,1360392003244,1360392003244,813386972,813386972,0
1360393827,815210916,1,60,60,1360393802773,1360393802773,815186689,815186689,0
1360394805,816188848,1,56,56,1360394779596,1360394779596,816163444,816163444,0
1360395248,816631608,1,46,46,1360395219957,1360395219957,816603565,816603565,0
1360395563,816946556,1,444,444,1360395536738,1360395536738,816920294,816920294,0
1360396413,817796076,1,417,417,1360396387127,1360396387127,817770203,817770203,0
1360396837,818220860,1,46,46,1360396812768,1360396812768,818196628,818196628,0
1360398187,819570888,1,60,60,1360398159089,1360398159089,819542977,819542977,0
1360399386,820769432,1,60,60,1360399358436,1360399358436,820741868,820741868,0
1360399534,820917844,5,250,50,1360399507402,1360399528714,820891246,820912558,21312
1360399578,820961900,1,48,48,1360399552783,1360399552783,820936683,820936683,0
1360399610,820993840,1,48,48,1360399582283,1360399582283,820966123,820966123,0
1360400306,821689416,1,48,48,1360400276521,1360400276521,821659937,821659937,0
1360404249,825632436,1,60,60,1360404223833,1360404223833,825607269,825607269,0
1360404345,825728876,1,441,441,1360404318814,1360404318814,825702690,825702690,0
1360404618,826001936,1,48,48,1360404593180,1360404593180,825977116,825977116,0
1360404724,826107208,1,48,48,1360404695026,1360404695026,826078234,826078234,0
1360405435,826818732,1,46,46,1360405409821,1360405409821,826793553,826793553,0
1360406886,828269968,1,46,46,1360406858972,1360406858972,828242940,828242940,0
1360407536,828919424,1,48,48,1360407511091,1360407511091,828894515,828894515,0
1360408955,830338092,1,46,46,1360408927655,1360408927655,830310747,830310747,0
1360409714,831097260,1,48,48,1360409686708,1360409686708,831069968,831069968,0
1360411614,832997380,1,48,48,1360411587806,1360411587806,832971186,832971186,0
1360411697,833080096,1,46,46,1360411669819,1360411669819,833052915,833052915,0
1360412502,833885752,1,46,46,1360412473952,1360412473952,833857704,833857704,0
1360413231,834614144,1,131,131,1360413203190,1360413203190,834586334,834586334,0
1360413675,3768337656,1,131,131,1360413650553,1360413650553,3768313209,3768313209,0
1360413712,835095536,1,129,129,1360413685604,1360413685604,835069140,835069140,0
1360413744,835127556,1,131,131,1360413718418,1360413718418,835101974,835101974,0
1360414578,835961864,1,46,46,1360414551247,1360414551247,835935111,835935111,0
1360415925,837308640,1,141,141,1360415899930,1360415899930,837283570,837283570,0
1360416122,837504984,1,46,46,1360416097895,1360416097895,837480879,837480879,0
1360416220,837603680,1,46,46,1360416190385,1360416190385,837574065,837574065,0
1360416535,837918104,1,46,46,1360416509865,1360416509865,837892969,837892969,0
1360416539,837922156,1,141,141,1360416512694,1360416512694,837895850,837895850,0
1360416843,838226816,1,93,93,1360416816735,1360416816735,838200551,838200551,0
1360417048,838431388,3,144,48,1360417019975,1360417028999,838403363,838412387,9024
1360417268,838651836,1,131,131,1360417240963,1360417240963,838624799,838624799,0
1360417744,839127404,1,48,48,1360417715499,1360417715499,839098903,839098903,0
1360418044,839427784,1,48,48,1360418015084,1360418015084,839398868,839398868,0
1360418095,839478648,1,46,46,1360418068148,1360418068148,839451796,839451796,0
1360418156,839539456,1,46,46,1360418126452,1360418126452,839509908,839509908,0
1360418202,839585368,1,46,46,1360418176009,1360418176009,839559377,839559377,0
1360418225,839608020,1,46,46,1360418195172,1360418195172,839578192,839578192,0
1360418350,839733652,1,46,46,1360418322028,1360418322028,839705680,839705680,0
1360418635,840017988,1,46,46,1360418607169,1360418607169,839990157,839990157,0
1360418792,840175748,1,46,46,1360418764996,1360418764996,840148744,840148744,0
1360418799,840182536,1,48,48,1360418773466,1360418773466,840157002,840157002,0
1360419015,840398404,1,46,46,1360418987096,1360418987096,840370500,840370500,0
1360419800,841183600,2,122,61,1360419774603,1360419776907,841158203,841160507,2304
1360420305,841688692,1,46,46,1360420277093,1360420277093,841660785,841660785,0
1360420674,842057456,1,46,46,1360420646668,1360420646668,842030124,842030124,0
1360421347,842730828,1,46,46,1360421322511,1360421322511,842706339,842706339,0
1360421444,842827580,1,46,46,1360421417347,1360421417347,842800927,842800927,0
1360421504,842887424,1,435,435,1360421477281,1360421477281,842860705,842860705,0
1360421588,842971512,1,46,46,1360421561608,1360421561608,842945120,842945120,0
1360421801,843183928,1,46,46,1360421773516,1360421773516,843156444,843156444,0
1360421893,843276456,1,127,127,1360421867642,1360421867642,843251098,843251098,0
1360591438,1012820596,1,46,46,1360591411862,1360591411862,1012794458,1012794458,0
1360591737,1013120108,1,60,60,1360591709842,1360591709842,1013092950,1013092950,0
1360592912,1014295036,5,250,50,1360592885385,1360592907017,1014268421,1014290053,21632
1360592956,1014339208,1,48,48,1360592931163,1360592931163,1014314371,1014314371,0
1360592988,1014371072,1,48,48,1360592960420,1360592960420,1014343492,1014343492,0
1360593093,1014475452,1,60,60,1360593065231,1360593065231,1014447683,1014447683,0
1360593930,1015313072,1,60,60,1360593904727,1360593904727,1015287799,1015287799,0
1360594030,1015413012,1,46,46,1360594002193,1360594002193,1015385205,1015385205,0
1360594074,1015457104,1,46,46,1360594048434,1360594048434,1015431538,1015431538,0
1360594122,1015505152,1,46,46,1360594096004,1360594096004,1015479156,1015479156,0
1360594286,1015669280,1,64,64,1360594282431,1360594282431,1015665711,1015665711,0
1360594297,1015679792,3,168,56,1360594290919,1360594291111,1015673711,1015673903,192
1360594311,1015693532,2,104,52,1360594283243,1360594283307,1015665775,1015665839,64
1360594315,1015697432,1,60,60,1360594286993,1360594286993,1015669425,1015669425,0
1360594319,1015701540,19,4673,245.9473684,1360594294370,1360594300962,1015676910,1015683502,6592
1360594323,1015705580,7,2689,384.1428571,1360594296316,1360594296572,1015678896,1015679152,256
1360594375,1015757664,1,52,52,1360594347047,1360594347047,1015729711,1015729711,0
1360594375,1015757672,19,4070,214.2105263,1360594347488,1360594351648,1015730160,1015734320,4160
1360594375,1015757708,7,2799,399.8571429,1360594348605,1360594351101,1015731313,1015733809,2496
1360594375,1015757736,1,52,52,1360594349726,1360594349726,1015732462,1015732462,0
1360594383,1015765776,1,64,64,1360594355641,1360594355641,1015738417,1015738417,0
1360594401,1015783812,16,3306,206.625,1360594398869,1360594399253,1015781681,1015782065,384
1360594409,1015791832,3,168,56,1360594406782,1360594406910,1015789614,1015789742,128
1360594417,1015799880,3,168,56,1360594409933,1360594410061,1015792813,1015792941,128
1360594417,1015799880,3,168,56,1360594413326,1360594413454,1015796206,1015796334,128
1360594417,1015799880,3,168,56,1360594410061,1360594410125,1015792941,1015793005,64
1360594417,1015799884,3,168,56,1360594413580,1360594413772,1015796464,1015796656,192
1360594417,1015799884,3,168,56,1360594410188,1360594410316,1015793072,1015793200,128
1360594417,1015799936,4,271,67.75,1360594413399,1360594413463,1015796335,1015796399,64
1360594423,1015805872,7,3438,491.1428571,1360594398039,1360594398295,1015780911,1015781167,256
1360594427,1015809852,1,46,46,1360594401512,1360594401512,1015784364,1015784364,0
1360594435,1015817776,1,52,52,1360594407989,1360594407989,1015790765,1015790765,0
1360594435,1015817828,1,46,46,1360594406915,1360594406915,1015789743,1015789743,0
1360594435,1015817860,18,4451,247.2777778,1360594407204,1360594413732,1015790064,1015796592,6528
1360594473,1015855928,3,210,70,1360594470813,1360594471837,1015853741,1015854765,1024
1360594481,1015863888,12,3358,279.8333333,1360594473669,1360594475141,1015856557,1015858029,1472
1360594489,1015871940,35,37885,1082.428571,1360594485904,1360594487312,1015868844,1015870252,1408
1360594489,1015871952,21,18819,896.1428571,1360594484038,1360594484998,1015866990,1015867950,960
1360594497,1015879988,11,5880,534.5454545,1360594484834,1360594490338,1015867822,1015873326,5504
1360594499,1015881828,1,79,79,1360594473986,1360594473986,1015856814,1015856814,0
1360594499,1015881852,6,798,133,1360594472744,1360594487720,1015855596,1015870572,14976
1360594499,1015881936,8,2872,359,1360594473686,1360594475414,1015856622,1015858350,1728
1360594503,1015885824,10,4467,446.7,1360594476101,1360594478085,1015858925,1015860909,1984
1360594503,1015885908,15,9193,612.8666667,1360594475568,1360594481072,1015858476,1015863980,5504
1360594507,1015889832,10,4183,418.3,1360594480127,1360594482431,1015862959,1015865263,2304
1360594563,1015946172,1,46,46,1360594536040,1360594536040,1015919212,1015919212,0
1360594601,1015984028,2,131,65.5,1360594595255,1360594595255,1015978283,1015978283,0
1360594601,1015984044,2,131,65.5,1360594597031,1360594597031,1015980075,1015980075,0
1360594607,1015990152,3,732,244,1360594579389,1360594579773,1015962541,1015962925,384
1360594607,1015990184,27,18850,698.1481481,1360594580379,1360594586843,1015963563,1015970027,6464
1360594607,1015990276,7,4143,591.8571429,1360594580031,1360594580415,1015963307,1015963691,384
1360594609,1015992064,2,131,65.5,1360594602068,1360594602068,1015985132,1015985132,0
1360594611,1015994312,98,126017,1285.887755,1360594585373,1360594605725,1015968685,1015989037,20352
1360594617,1016000072,2,131,65.5,1360594610636,1360594610636,1015993708,1015993708,0
1360594633,1016016144,23,20400,886.9565217,1360594610306,1360594626370,1015993450,1016009514,16064
1360594636,1016018428,12,7382,615.1666667,1360594611089,1360594633617,1015993517,1016016045,22528
1360594641,1016024156,3,168,56,1360594635959,1360594636087,1016019115,1016019243,128
1360594651,1016034272,21,16099,766.6190476,1360594626242,1360594643714,1016009514,1016026986,17472
1360594657,1016040176,13,9245,711.1538462,1360594635300,1360594655524,1016018476,1016038700,20224
1360594664,1016046380,1,52,52,1360594638783,1360594638783,1016021163,1016021163,0
1360594665,1016048112,15,5992,399.4666667,1360594639009,1360594661985,1016022121,1016045097,22976
1360594665,1016048120,2,112,56,1360594657306,1360594662042,1016040426,1016045162,4736
1360594665,1016048200,169,238095,1408.846154,1360594613324,1360594661836,1015996524,1016045036,48512
1360594680,1016062612,1,186,186,1360594653013,1360594653013,1016035625,1016035625,0
1360594680,1016062616,3,567,189,1360594653393,1360594653521,1016036009,1016036137,128
1360594683,1016066216,3,1160,386.6666667,1360594657084,1360594657148,1016040300,1016040364,64
1360594683,1016066336,1,46,46,1360594657026,1360594657026,1016040362,1016040362,0
1360594688,1016070388,1,52,52,1360594662711,1360594662711,1016045099,1016045099,0
1360594695,1016078236,57,70632,1239.157895,1360594667941,1360594669413,1016051177,1016052649,1472
1360594695,1016078240,7,4143,591.8571429,1360594667940,1360594668388,1016051180,1016051628,448
1360594695,1016078240,17,13940,820,1360594667940,1360594669540,1016051180,1016052780,1600
1360594695,1016078360,23,18084,786.2608696,1360594668075,1360594670123,1016051435,1016053483,2048
1360594696,1016078396,34,43679,1284.676471,1360594670125,1360594670765,1016052521,1016053161,640
1360594705,1016088184,2,131,65.5,1360594699547,1360594699547,1016082731,1016082731,0
1360594705,1016088192,2,131,65.5,1360594700180,1360594700180,1016083372,1016083372,0
1360594705,1016088220,2,131,65.5,1360594698424,1360594698424,1016081644,1016081644,0
1360594729,1016112172,117,136395,1165.769231,1360594675048,1360594724200,1016058220,1016107372,49152
1360594793,1016176192,6,427,71.16666667,1360594787152,1360594790608,1016170344,1016173800,3456
1360594808,1016190388,1,52,52,1360594780916,1360594780916,1016163304,1016163304,0
1360594809,1016192272,2,150,75,1360594794176,1360594801536,1016177448,1016184808,7360
1360594844,1016226556,1,75,75,1360594816908,1360594816908,1016199464,1016199464,0
1360594849,1016232284,3,168,56,1360594847923,1360594848563,1016231207,1016231847,640
1360594857,1016240268,3,180,60,1360594850051,1360594850307,1016233319,1016233575,256
1360594872,1016254656,1,75,75,1360594846247,1360594846247,1016228903,1016228903,0
1360594876,1016258596,1,64,64,1360594849574,1360594849574,1016232170,1016232170,0
1360594880,1016262588,1,52,52,1360594855276,1360594855276,1016237864,1016237864,0
1360594880,1016262596,23,5975,259.7826087,1360594851940,1360594857508,1016234536,1016240104,5568
1360594884,1016266644,9,3463,384.7777778,1360594856693,1360594858037,1016239337,1016240681,1344
1360594897,1016280336,3,156,52,1360594892798,1360594894910,1016276134,1016278246,2112
1360594913,1016296364,3,168,56,1360594904545,1360594905633,1016287909,1016288997,1088
1360594924,1016306724,1,52,52,1360594898465,1360594898465,1016281189,1016281189,0
1360594936,1016318616,1,52,52,1360594909904,1360594909904,1016292520,1016292520,0
1360594936,1016318692,20,4130,206.5,1360594908161,1360594911361,1016290853,1016294053,3200
1360594986,1016368444,2,131,65.5,1360594978041,1360594978041,1016360485,1016360485,0
1360595216,1016599004,3,756,252,1360595189896,1360595190152,1016572900,1016573156,256
1360595248,1016631108,2,122,61,1360595221725,1360595224093,1016604833,1016607201,2368
1360595276,1016659176,1,52,52,1360595248791,1360595248791,1016631967,1016631967,0
1360595322,1016704904,2,110,55,1360595305834,1360595318954,1016688738,1016701858,13120
1360595330,1016712880,2,110,55,1360595316419,1360595328003,1016699299,1016710883,11584
1360595330,1016712916,3,168,56,1360595326940,1360595327516,1016709856,1016710432,576
1360595336,1016719132,28,19372,691.8571429,1360595308227,1360595330627,1016691359,1016713759,22400
1360595336,1016719168,1,52,52,1360595309408,1360595309408,1016692576,1016692576,0
1360595336,1016719228,17,3966,233.2941176,1360595307813,1360595310693,1016691041,1016693921,2880
1360595344,1016727204,50,46194,923.88,1360595316412,1360595341180,1016699616,1016724384,24768
1360595354,1016736928,3,168,56,1360595348881,1360595349393,1016731809,1016732321,512
1360595370,1016752864,2,110,55,1360595349776,1360595362768,1016732640,1016745632,12992
1360595373,1016755436,3,459,153,1360595347965,1360595348157,1016730401,1016730593,192
1360595388,1016771268,1,64,64,1360595360251,1360595360251,1016743519,1016743519,0
1360595405,1016787396,1,443,443,1360595376931,1360595376931,1016759327,1016759327,0
1360595432,1016815348,8,2741,342.625,1360595405869,1360595407277,1016789217,1016790625,1408
1360595466,1016848980,2,131,65.5,1360595461402,1360595461402,1016844382,1016844382,0
1360595641,1017023896,1,46,46,1360595615084,1360595615084,1016997980,1016997980,0
1360595673,1017055952,1,46,46,1360595647666,1360595647666,1017030618,1017030618,0
1360595713,1017096252,18,4018,223.2222222,1360595686278,1360595689734,1017069530,1017072986,3456
1360595714,1017096400,1,52,52,1360595688796,1360595688796,1017071196,1017071196,0
1360595914,1017297012,2,122,61,1360595889523,1360595892019,1017272535,1017275031,2496
1360596019,1017401592,3,168,56,1360596011798,1360596014230,1017394390,1017396822,2432
1360596019,1017401608,5,323,64.6,1360596014405,1360596017797,1017397013,1017400405,3392
1360596038,1017421232,13,6071,467,1360596011158,1360596017174,1017394390,1017400406,6016
1360596038,1017421304,27,5005,185.3703704,1360596013581,1360596032269,1017396885,1017415573,18688
1360596043,1017425512,3,174,58,1360596023143,1360596036455,1017405655,1017418967,13312
1360596043,1017425524,3,168,56,1360596040665,1360596041049,1017423189,1017423573,384
1360596043,1017425560,2,116,58,1360596042487,1360596042551,1017425047,1017425111,64
1360596043,1017425560,4,271,67.75,1360596038583,1360596039223,1017421143,1017421783,640
1360596043,1017425592,4,271,67.75,1360596039512,1360596040280,1017422104,1017422872,768
1360596043,1017425596,3,168,56,1360596036562,1360596037330,1017419158,1017419926,768
1360596043,1017425600,3,168,56,1360596037709,1360596038221,1017420309,1017420821,512
1360596043,1017425604,3,168,56,1360596041418,1360596042122,1017424022,1017424726,704
1360596046,1017429316,1,52,52,1360596018176,1360596018176,1017401492,1017401492,0
1360596059,1017441400,1,52,52,1360596031318,1360596031318,1017413718,1017413718,0
1360596070,1017453328,1,52,52,1360596042103,1360596042103,1017425431,1017425431,0
1360596139,1017521664,2,131,65.5,1360596134798,1360596134798,1017517462,1017517462,0
1360596203,1017586040,16,3306,206.625,1360596200211,1360596202067,1017583251,1017585107,1856
1360596203,1017586112,14,3214,229.5714286,1360596200524,1360596201996,1017583636,1017585108,1472
1360596211,1017593980,17,5358,315.1764706,1360596206863,1360596208847,1017589843,1017591827,1984
1360596211,1017594056,18,4132,229.5555556,1360596204933,1360596206789,1017587989,1017589845,1856
1360596211,1017594064,22,8815,400.6818182,1360596202172,1360596204860,1017585236,1017587924,2688
1360596219,1017601976,16,3935,245.9375,1360596215637,1360596217749,1017598613,1017600725,2112
1360596219,1017602020,15,3198,213.2,1360596213928,1360596215592,1017596948,1017598612,1664
1360596219,1017602056,15,3293,219.5333333,1360596212034,1360596213506,1017595090,1017596562,1472
1360596219,1017602072,15,8180,545.3333333,1360596208885,1360596211957,1017591957,1017595029,3072
1360596219,1017602072,25,5315,212.6,1360596209012,1360596211636,1017592084,1017594708,2624
1360596223,1017605800,9,4004,444.8888889,1360596198467,1360596200067,1017581267,1017582867,1600
1360596227,1017609984,21,3443,163.952381,1360596222669,1360596225357,1017605653,1017608341,2688
1360596227,1017609996,18,3481,193.3888889,1360596221119,1360596223167,1017604115,1017606163,2048
1360596227,1017610076,56,60012,1071.642857,1360596217647,1360596221039,1017600723,1017604115,3392
1360596279,1017661860,3,459,153,1360596252680,1360596253192,1017635540,1017636052,512
1360596311,1017694116,1,46,46,1360596283847,1360596283847,1017666963,1017666963,0
1360596351,1017734128,8,2741,342.625,1360596325432,1360596326648,1017708560,1017709776,1216
1360596355,1017738348,4,271,67.75,1360596351964,1360596353308,1017735312,1017736656,1344
1360596371,1017754032,1,46,46,1360596342874,1360596342874,1017725906,1017725906,0
1360596383,1017766040,1,52,52,1360596358864,1360596358864,1017741904,1017741904,0
1360596383,1017766044,1,64,64,1360596354891,1360596354891,1017737935,1017737935,0
1360596383,1017766132,23,5975,259.7826087,1360596355189,1360596361717,1017738321,1017744849,6528
1360596403,1017786336,1,46,46,1360596378346,1360596378346,1017761682,1017761682,0
1360596411,1017794200,1,46,46,1360596386225,1360596386225,1017769425,1017769425,0
1360596411,1017794352,1,46,46,1360596386393,1360596386393,1017769745,1017769745,0
1360596427,1017810172,1,191,191,1360596400139,1360596400139,1017783311,1017783311,0
1360596427,1017810244,13,7081,544.6923077,1360596402502,1360596405126,1017785746,1017788370,2624
1360596455,1017838236,1,46,46,1360596428940,1360596428940,1017812176,1017812176,0
1360596459,1017842260,1,64,64,1360596430963,1360596430963,1017814223,1017814223,0
1360596468,1017850408,1,52,52,1360596440455,1360596440455,1017822863,1017822863,0
1360596592,1017974644,1,46,46,1360596567130,1360596567130,1017949774,1017949774,0
1360596608,1017990500,3,567,189,1360596581480,1360596582056,1017963980,1017964556,576
1360596608,1017990576,1,191,191,1360596580766,1360596580766,1017963342,1017963342,0
1360596636,1018018652,1,71,71,1360596608338,1360596608338,1017990990,1017990990,0
1360596772,1018155100,2,104,52,1360596768784,1360596770512,1018151884,1018153612,1728
1360596788,1018171188,2,104,52,1360596773813,1360596780661,1018157001,1018163849,6848
1360596804,1018187168,2,104,52,1360596790666,1360596800714,1018173834,1018183882,10048
1360596828,1018211152,4,208,52,1360596821402,1360596825626,1018204554,1018208778,4224
1360596828,1018211180,2,104,52,1360596810684,1360596820668,1018193864,1018203848,9984
1360597293,1018676164,3,168,56,1360597289991,1360597290695,1018673155,1018673859,704
1360597321,1018703556,18,4157,230.9444444,1360597293288,1360597301992,1018675844,1018684548,8704
1360597325,1018707596,11,4252,386.5454545,1360597299071,1360597303231,1018681667,1018685827,4160
1360597349,1018731680,11,5471,497.3636364,1360597324777,1360597328425,1018707457,1018711105,3648
1360597357,1018740232,3,168,56,1360597354817,1360597355393,1018738049,1018738625,576
1360597357,1018740236,3,168,56,1360597355711,1360597356351,1018738947,1018739587,640
1360597357,1018740280,4,271,67.75,1360597353874,1360597354450,1018737154,1018737730,576
1360597405,1018788304,4,271,67.75,1360597403067,1360597403195,1018786371,1018786499,128
1360597405,1018788316,3,168,56,1360597403311,1360597403439,1018786627,1018786755,128
1360597405,1018788316,3,168,56,1360597403438,1360597403630,1018786754,1018786946,192
1360597421,1018804220,3,168,56,1360597413837,1360597413901,1018797057,1018797121,64
1360597429,1018811752,1,46,46,1360597404194,1360597404194,1018786946,1018786946,0
1360597429,1018811848,1,64,64,1360597404163,1360597404163,1018787011,1018787011,0
1360597433,1018815680,1,458,458,1360597406122,1360597406122,1018788802,1018788802,0
1360597453,1018836224,2,131,65.5,1360597445386,1360597445386,1018828610,1018828610,0
1360597497,1018879956,1,52,52,1360597470165,1360597470165,1018853121,1018853121,0
1360597557,1018940060,1,46,46,1360597532525,1360597532525,1018915585,1018915585,0
1360597569,1018952176,1,52,52,1360597542646,1360597542646,1018925822,1018925822,0
1360597761,1019144300,1,64,64,1360597734903,1360597734903,1019118203,1019118203,0
1360597765,1019148264,20,4852,242.6,1360597738014,1360597761182,1019121278,1019144446,23168
1360597765,1019148288,1,52,52,1360597738501,1360597738501,1019121789,1019121789,0
1360597766,1019148624,9,6263,695.8888889,1360597758940,1360597759068,1019141564,1019141692,128
1360597766,1019148700,10,6557,655.7,1360597758478,1360597758542,1019141178,1019141242,64
1360597766,1019148704,10,6423,642.3,1360597759244,1360597759308,1019141948,1019142012,64
1360597766,1019148708,10,7679,767.9,1360597759498,1360597759690,1019142206,1019142398,192
1360597778,1019160400,7,2689,384.1428571,1360597751739,1360597751995,1019134139,1019134395,256
1360597786,1019168428,7,3186,455.1428571,1360597759458,1360597759842,1019141886,1019142270,384
1360597790,1019172460,1,46,46,1360597765438,1360597765438,1019147898,1019147898,0
1360597814,1019196460,19,4499,236.7894737,1360597789503,1360597800191,1019171963,1019182651,10688
1360597818,1019200500,1,52,52,1360597793369,1360597793369,1019175869,1019175869,0
1360597822,1019204652,1,64,64,1360597794113,1360597794113,1019176765,1019176765,0
1360597838,1019220580,1,46,46,1360597810441,1360597810441,1019193021,1019193021,0
1360597870,1019252872,3,168,56,1360597866722,1360597866850,1019249594,1019249722,128
1360597870,1019252872,3,168,56,1360597866849,1360597866913,1019249721,1019249785,64
1360597870,1019252944,3,168,56,1360597866522,1360597866586,1019249466,1019249530,64
1360597878,1019260960,3,168,56,1360597877001,1360597877065,1019259961,1019260025,64
1360597886,1019268800,18,4469,248.2777778,1360597877865,1360597878505,1019260665,1019261305,640
1360597886,1019268800,13,3571,274.6923077,1360597877801,1360597878121,1019260601,1019260921,320
1360597886,1019268848,5,296,59.2,1360597877244,1360597880828,1019260092,1019263676,3584
1360597886,1019268856,13,3583,275.6153846,1360597877744,1360597878192,1019260600,1019261048,448
1360597894,1019276668,1,64,64,1360597867182,1360597867182,1019249850,1019249850,0
1360597898,1019280588,19,4184,220.2105263,1360597870015,1360597871615,1019252603,1019254203,1600
1360597898,1019280592,1,52,52,1360597870521,1360597870521,1019253113,1019253113,0
1360597906,1019288472,9,3463,384.7777778,1360597879027,1360597879603,1019261499,1019262075,576
1360597926,1019308928,2,92,46,1360597907755,1360597923755,1019290683,1019306683,16000
1360597946,1019328488,1,483,483,1360597918112,1360597918112,1019300600,1019300600,0
1360598006,1019388784,4,907,226.75,1360597979063,1360597991991,1019361847,1019374775,12928
1360598006,1019389068,2,131,65.5,1360597998942,1360597998942,1019382010,1019382010,0
1360598006,1019389068,2,92,46,1360597999197,1360597999453,1019382265,1019382521,256
1360598006,1019389116,29,3922,135.2413793,1360598001774,1360598003182,1019384890,1019386298,1408
1360598018,1019400992,1,46,46,1360597991465,1360597991465,1019374457,1019374457,0
1360598026,1019408928,7,3438,491.1428571,1360597999722,1360598000874,1019382650,1019383802,1152
1360598058,1019440888,2,188,94,1360598032210,1360598032210,1019415098,1019415098,0
1360598110,1019492992,2,116,58,1360598082472,1360598082664,1019465464,1019465656,192
1360598190,1019573040,2,339,169.5,1360598162292,1360598162292,1019545332,1019545332,0
1360606491,1027873688,1,46,46,1360606464792,1360606464792,1027847480,1027847480,0
1360606703,1028086244,1,46,46,1360606675112,1360606675112,1028058356,1028058356,0
1360606932,1028315304,1,46,46,1360606904810,1360606904810,1028288114,1028288114,0
1360607177,1028559896,1,46,46,1360607149631,1360607149631,1028532527,1028532527,0
1360607750,1029132948,1,46,46,1360607722816,1360607722816,1029105764,1029105764,0
1360608187,1029569548,1,46,46,1360608162124,1360608162124,1029544672,1029544672,0
1360608523,1029906112,1,46,46,1360608497424,1360608497424,1029880536,1029880536,0
1360608599,1029982152,1,52,52,1360608572841,1360608572841,1029955993,1029955993,0
1360608908,1030290520,1,46,46,1360608881437,1360608881437,1030263957,1030263957,0
1360608952,1030334664,29,5260,181.3793103,1360608926732,1360608946956,1030309396,1030329620,20224
1360608960,1030342784,6,360,60,1360608934674,1360608937682,1030317458,1030320466,3008
1360608984,1030366740,1,165,165,1360608956863,1360608956863,1030339603,1030339603,0
1360608988,1030370976,3,168,56,1360608984656,1360608985168,1030367632,1030368144,512
1360608988,1030371048,3,168,56,1360608983818,1360608984266,1030366866,1030367314,448
1360608988,1030371096,3,168,56,1360608982808,1360608983576,1030365904,1030366672,768
1360608996,1030379188,3,168,56,1360608987774,1360608988606,1030370962,1030371794,832
1360608996,1030379252,3,168,56,1360608990012,1360608990524,1030373264,1030373776,512
1360608996,1030379252,3,168,56,1360608993277,1360608994109,1030376529,1030377361,832
1360608997,1030379324,3,168,56,1360608995294,1360608996062,1030377618,1030378386,768
1360608997,1030379384,3,168,56,1360608989858,1360608990434,1030372242,1030372818,576
1360608997,1030379460,4,271,67.75,1360608991575,1360608993431,1030374035,1030375891,1856
1360608997,1030379464,2,116,58,1360608995281,1360608995921,1030377745,1030378385,640
1360609004,1030387052,3,168,56,1360608999558,1360609000134,1030382610,1030383186,576
1360609004,1030387128,4,214,53.5,1360608995258,1360609001914,1030378386,1030385042,6656
1360609004,1030387136,3,168,56,1360608999985,1360609000753,1030383121,1030383889,768
1360609004,1030387172,3,168,56,1360609000909,1360609001869,1030384081,1030385041,960
1360609004,1030387176,3,168,56,1360608997706,1360608998922,1030380882,1030382098,1216
1360609004,1030387184,3,168,56,1360608998468,1360608999428,1030381652,1030382612,960
1360609012,1030394612,20,4715,235.75,1360608984254,1360608988926,1030366866,1030371538,4672
1360609012,1030395092,3,168,56,1360609009310,1360609010078,1030392402,1030393170,768
1360609012,1030395144,3,168,56,1360609008555,1360609009131,1030391699,1030392275,576
1360609024,1030406808,2,104,52,1360608997561,1360608997881,1030380369,1030380689,320
1360609024,1030406852,1,46,46,1360608999055,1360608999055,1030381907,1030381907,0
1360609024,1030406852,1,46,46,1360608999245,1360608999245,1030382097,1030382097,0
1360609028,1030411168,2,110,55,1360609010196,1360609021524,1030393364,1030404692,11328
1360609048,1030430836,2,372,186,1360609022749,1360609023453,1030405585,1030406289,704
1360609052,1030434832,11,5071,461,1360609026338,1360609029090,1030409170,1030411922,2752
1360609104,1030486908,9,3463,384.7777778,1360609075924,1360609077908,1030458832,1030460816,1984
1360609112,1030495200,1,487,487,1360609086256,1360609086256,1030469456,1030469456,0
1360609148,1030531284,3,733,244.3333333,1360609122460,1360609122844,1030505744,1030506128,384
1360609180,1030563148,1,52,52,1360609152290,1360609152290,1030535438,1030535438,0
1360609205,1030587500,2,131,65.5,1360609198252,1360609198252,1030580752,1030580752,0
1360609208,1030591272,3,673,224.3333333,1360609182693,1360609202341,1030565965,1030585613,19648
1360609228,1030611140,3,567,189,1360609202923,1360609203051,1030586063,1030586191,128
1360609233,1030615604,1,48,48,1360609207172,1360609207172,1030589776,1030589776,0
1360609321,1030703660,1,52,52,1360609294155,1360609294155,1030676815,1030676815,0
1360610568,1031951360,11,1565,142.2727273,1360610564668,1360610565756,1031948028,1031949116,1088
1360610569,1031951488,16,2464,154,1360610564324,1360610564900,1031946812,1031947388,576
1360610569,1031951488,13,3571,274.6923077,1360610564259,1360610565731,1031946747,1031948219,1472
1360610569,1031951564,13,3571,274.6923077,1360610564184,1360610565400,1031946748,1031947964,1216
1360610588,1031971096,1,52,52,1360610562372,1360610562372,1031945468,1031945468,0
1360610588,1031971216,1,52,52,1360610562250,1360610562250,1031945466,1031945466,0
1360610592,1031975176,7,1457,208.1428571,1360610564851,1360610565491,1031948027,1031948667,640
1360610616,1031999172,8,2274,284.25,1360610588790,1360610589110,1031971962,1031972282,320
1360610616,1031999176,1,52,52,1360610589104,1360610589104,1031972280,1031972280,0
1360610616,1031999224,3,304,101.3333333,1360610591104,1360610591104,1031974328,1031974328,0
1360610660,1032043152,5,774,154.8,1360610633800,1360610633928,1032016952,1032017080,128
1360610664,1032047132,3,571,190.3333333,1360610636573,1360610636637,1032019705,1032019769,64
1360610664,1032047248,7,3638,519.7142857,1360610635945,1360610636265,1032019193,1032019513,320
1360610664,1032047256,3,571,190.3333333,1360610636576,1360610636576,1032019832,1032019832,0
1360610689,1032071640,3,210,70,1360610685896,1360610686344,1032068536,1032068984,448
1360610745,1032127656,11,2295,208.6363636,1360610741114,1360610741818,1032123770,1032124474,704
1360610765,1032147528,6,1117,186.1666667,1360610740408,1360610740792,1032122936,1032123320,384
1360610841,1032223608,8,5427,678.375,1360610815527,1360610816039,1032198135,1032198647,512
1360610857,1032239760,1,52,52,1360610831567,1360610831567,1032214327,1032214327,0
1360610865,1032248176,3,210,70,1360610860079,1360610860399,1032243255,1032243575,320
1360610886,1032268768,1,46,46,1360610858244,1360610858244,1032241012,1032241012,0
1360610901,1032283576,1,46,46,1360610874500,1360610874500,1032257076,1032257076,0
1360610905,1032287564,1,52,52,1360610876946,1360610876946,1032259510,1032259510,0
1360610905,1032287568,1,52,52,1360610877197,1360610877197,1032259765,1032259765,0
1360610905,1032287700,1,52,52,1360610877129,1360610877129,1032259829,1032259829,0
1360610913,1032295700,1,52,52,1360610886154,1360610886154,1032268854,1032268854,0
1360610957,1032339824,8,2274,284.25,1360610930891,1360610931339,1032313715,1032314163,448
1360610957,1032339856,1,52,52,1360610931309,1360610931309,1032314165,1032314165,0
1360610965,1032347716,3,304,101.3333333,1360610938426,1360610938490,1032321142,1032321206,64
1360611001,1032384120,6,1327,221.1666667,1360610998245,1360610998821,1032381365,1032381941,576
1360611001,1032384196,6,2433,405.5,1360610995096,1360610995352,1032378292,1032378548,256
1360611001,1032384232,5,616,123.2,1360610996148,1360610996276,1032379380,1032379508,128
1360611009,1032392240,5,793,158.6,1360611002990,1360611003182,1032386230,1032386422,192
1360611057,1032439928,6,820,136.6666667,1360611028964,1360611029476,1032411892,1032412404,512
1360611081,1032464044,1,52,52,1360611055599,1360611055599,1032438643,1032438643,0
1360611202,1032584508,6,1680,280,1360611175684,1360611176004,1032558192,1032558512,320
1360611206,1032588404,1,52,52,1360611178796,1360611178796,1032561200,1032561200,0
1360611226,1032608692,7,2930,418.5714286,1360611221836,1360611223244,1032604528,1032605936,1408
1360611226,1032608692,18,16918,939.8888889,1360611221899,1360611224523,1032604591,1032607215,2624
1360611229,1032612292,7,1457,208.1428571,1360611201907,1360611202419,1032585199,1032585711,512
1360611254,1032636336,9,3744,416,1360611226030,1360611226478,1032608366,1032608814,448
1360611254,1032636348,1,52,52,1360611226469,1360611226469,1032608817,1032608817,0
1360611274,1032656708,3,138,46,1360611269758,1360611270526,1032652466,1032653234,768
1360611330,1032712860,2,131,65.5,1360611322721,1360611322721,1032705581,1032705581,0
1360611394,1032777008,7,2679,382.7142857,1360611387661,1360611389709,1032770669,1032772717,2048
1360611394,1032777012,30,34108,1136.933333,1360611387784,1360611390984,1032770796,1032773996,3200
1360611442,1032824488,1,52,52,1360611416022,1360611416022,1032798510,1032798510,0
1360611450,1032832476,1,64,64,1360611424098,1360611424098,1032806574,1032806574,0
1360611450,1032832480,1,64,64,1360611424413,1360611424413,1032806893,1032806893,0
1360611530,1032912736,9,3463,384.7777778,1360611503578,1360611503962,1032886314,1032886698,384
1360611538,1032921192,20,22428,1121.4,1360611534997,1360611536213,1032918189,1032919405,1216
1360611538,1032921200,53,67368,1271.09434,1360611533003,1360611536971,1032916203,1032920171,3968
1360611538,1032921200,7,3052,436,1360611533002,1360611534474,1032916202,1032917674,1472
1360611570,1032953136,5,260,52,1360611562507,1360611566155,1032945643,1032949291,3648
1360611586,1032969052,2,104,52,1360611570142,1360611577886,1032953194,1032960938,7744
1360611602,1032985100,2,104,52,1360611587886,1360611597870,1032970986,1032980970,9984
1360611618,1033001116,2,104,52,1360611607838,1360611617822,1032990954,1033000938,9984
1360611626,1033009120,5,368,73.6,1360611623513,1360611625369,1033006633,1033008489,1856
1360611634,1033017192,2,158,79,1360611627412,1360611631636,1033010604,1033014828,4224
1360611651,1033033336,5,436,87.2,1360611650216,1360611650600,1033032552,1033032936,384
1360611651,1033033336,5,436,87.2,1360611650216,1360611650600,1033032552,1033032936,384
1360611651,1033033336,5,436,87.2,1360611650216,1360611650664,1033032552,1033033000,448
1360611651,1033033340,5,436,87.2,1360611650213,1360611650597,1033032553,1033032937,384
1360611651,1033033412,6,777,129.5,1360611649374,1360611649950,1033031786,1033032362,576
1360611651,1033033412,5,436,87.2,1360611650012,1360611650396,1033032424,1033032808,384
1360611651,1033033416,5,436,87.2,1360611650139,1360611650523,1033032555,1033032939,384
1360611659,1033041420,4,393,98.25,1360611653396,1360611653780,1033035816,1033036200,384
1360611659,1033041436,4,347,86.75,1360611650888,1360611651464,1033033324,1033033900,576
1360611659,1033041460,4,347,86.75,1360611651245,1360611651885,1033033705,1033034345,640
1360611659,1033041504,5,1663,332.6,1360611649473,1360611653889,1033031977,1033036393,4416
1360611674,1033057232,2,152,76,1360611645994,1360611646122,1033029226,1033029354,128
1360611678,1033061152,4,620,155,1360611651576,1360611651896,1033034728,1033035048,320
1360611699,1033081408,6,914,152.3333333,1360611692640,1360611693216,1033075048,1033075624,576
1360611707,1033089400,6,678,113,1360611703593,1360611704297,1033085993,1033086697,704
1360611707,1033089408,5,705,141,1360611701026,1360611702050,1033083434,1033084458,1024
1360611707,1033089424,7,5980,854.2857143,1360611701073,1360611701393,1033083497,1033083817,320
1360611707,1033089472,6,712,118.6666667,1360611699618,1360611700194,1033082090,1033082666,576
1360611722,1033105244,1,575,575,1360611696541,1360611696541,1033079785,1033079785,0
1360611726,1033109248,7,1026,146.5714286,1360611701336,1360611703320,1033084584,1033086568,1984
1360613495,1034877868,1,46,46,1360613467579,1360613467579,1034850447,1034850447,0
1360613495,1034878052,3,168,56,1360613492418,1360613492482,1034875470,1034875534,64
1360613495,1034878140,3,168,56,1360613492457,1360613492585,1034875597,1034875725,128
1360613503,1034886020,3,168,56,1360613496032,1360613496096,1034879052,1034879116,64
1360613503,1034886028,32,41637,1301.15625,1360613496796,1360613497948,1034879824,1034880976,1152
1360613503,1034886104,3,180,60,1360613495631,1360613495695,1034878735,1034878799,64
1360613503,1034886104,3,168,56,1360613495758,1360613495950,1034878862,1034879054,192
1360613503,1034886108,4,271,67.75,1360613496138,1360613496266,1034879246,1034879374,128
1360613511,1034894032,3,168,56,1360613505749,1360613505877,1034888781,1034888909,128
1360617546,1038929240,1,46,46,1360617520966,1360617520966,1038904206,1038904206,0
1360617727,1039109484,1,60,60,1360617700411,1360617700411,1039082895,1039082895,0
1360617815,1039197596,1,60,60,1360617789769,1360617789769,1039172365,1039172365,0
1360618007,1039389852,1,48,48,1360617982150,1360617982150,1039365002,1039365002,0
1360618335,1039718096,20,5540,277,1360618307723,1360618311499,1039690819,1039694595,3776
1360618352,1039734576,3,168,56,1360618347668,1360618348436,1039730244,1039731012,768
1360618352,1039734608,3,168,56,1360618348722,1360618349362,1039731330,1039731970,640
1360618352,1039734628,3,168,56,1360618349601,1360618350177,1039732229,1039732805,576
1360618352,1039734628,3,168,56,1360618346783,1360618347359,1039729411,1039729987,576
1360618352,1039734872,3,168,56,1360618350317,1360618351341,1039733189,1039734213,1024
1360618360,1039742600,3,168,56,1360618357691,1360618358267,1039740291,1039740867,576
1360618360,1039742676,3,168,56,1360618356656,1360618357232,1039739332,1039739908,576
1360618376,1039758676,3,168,56,1360618372721,1360618373361,1039755397,1039756037,640
1360618376,1039758808,3,168,56,1360618373484,1360618374124,1039756292,1039756932,640
1360618376,1039758840,3,168,56,1360618374410,1360618375050,1039757250,1039757890,640
1360618380,1039762336,1,46,46,1360618354436,1360618354436,1039736772,1039736772,0
1360618552,1039935104,5,250,50,1360618525058,1360618546498,1039908162,1039929602,21440
1360618596,1039979168,1,48,48,1360618570560,1360618570560,1039953728,1039953728,0
1360618628,1040011100,1,48,48,1360618599811,1360618599811,1039982911,1039982911,0
1360618665,1040047568,7,1609,229.8571429,1360618659032,1360618660952,1040041600,1040043520,1920
1360618665,1040047568,7,1457,208.1428571,1360618659031,1360618660887,1040041599,1040043455,1856
1360618685,1040067328,1,721,721,1360618657925,1360618657925,1040040253,1040040253,0
1360618901,1040283824,3,459,153,1360618876626,1360618877010,1040259450,1040259834,384
1360619050,1040432488,3,168,56,1360619046370,1360619046882,1040428858,1040429370,512
1360619050,1040432524,3,168,56,1360619048189,1360619048829,1040430713,1040431353,640
1360619050,1040432556,2,116,58,1360619049245,1360619049693,1040431801,1040432249,448
1360619050,1040432600,3,168,56,1360619047089,1360619047857,1040429689,1040430457,768
1360619058,1040440580,3,168,56,1360619050373,1360619050821,1040432953,1040433401,448
1360619058,1040440584,3,168,56,1360619051199,1360619051839,1040433783,1040434423,640
1360619058,1040440628,3,168,56,1360619052372,1360619053012,1040435000,1040435640,640
1360619074,1040456456,17,3966,233.2941176,1360619049473,1360619053057,1040431929,1040435513,3584
1360619077,1040460144,1,52,52,1360619049999,1360619049999,1040433143,1040433143,0
1360619077,1040460264,1,52,52,1360619049434,1360619049434,1040432698,1040432698,0
1360619467,1040849816,2,116,58,1360619466132,1360619466452,1040848948,1040849268,320
1360619475,1040857832,4,271,67.75,1360619467138,1360619467778,1040849970,1040850610,640
1360619475,1040857876,3,168,56,1360619469975,1360619470615,1040852851,1040853491,640
1360619475,1040857904,2,116,58,1360619473913,1360619474553,1040856817,1040857457,640
1360619475,1040857916,3,168,56,1360619470832,1360619471600,1040853748,1040854516,768
1360619475,1040857924,3,168,56,1360619468198,1360619468838,1040851122,1040851762,640
1360619475,1040857948,4,271,67.75,1360619472077,1360619472717,1040855025,1040855665,640
1360619475,1040857960,3,168,56,1360619472964,1360619473604,1040855924,1040856564,640
1360619483,1040865820,3,168,56,1360619475278,1360619475918,1040858098,1040858738,640
1360619495,1040877548,1,52,52,1360619467103,1360619467103,1040849651,1040849651,0
1360619495,1040877632,1,46,46,1360619469643,1360619469643,1040852275,1040852275,0
1360619495,1040877636,19,4070,214.2105263,1360619469636,1360619472324,1040852272,1040854960,2688
1360619499,1040881420,1,52,52,1360619471199,1360619471199,1040853619,1040853619,0
1360619503,1040885392,1,52,52,1360619475386,1360619475386,1040857778,1040857778,0
1360619940,1041322956,23,4396,191.1304348,1360619915263,1360619922815,1041298219,1041305771,7552
1360619940,1041323188,3,168,56,1360619933527,1360619934167,1041316715,1041317355,640
1360619940,1041323196,3,168,56,1360619934478,1360619935118,1041317674,1041318314,640
1360619940,1041323244,3,168,56,1360619932575,1360619933215,1041315819,1041316459,640
1360619948,1041330776,1,52,52,1360619921395,1360619921395,1041304171,1041304171,0
1360620137,1041519832,5,3323,664.6,1360620136440,1360620136696,1041519272,1041519528,256
1360620141,1041523332,5,3323,664.6,1360620136939,1360620137195,1041519271,1041519527,256
1360620165,1041547440,28,34370,1227.5,1360620137601,1360620139585,1041520041,1041522025,1984
1360620165,1041547588,77,95702,1242.883117,1360620137453,1360620148013,1041520041,1041530601,10560
1360620173,1041555964,2,131,65.5,1360620168882,1360620168882,1041551846,1041551846,0
1360620181,1041563964,2,131,65.5,1360620177010,1360620177010,1041559974,1041559974,0
1360620253,1041636232,3,168,56,1360620248295,1360620248999,1041631527,1041632231,704
1360620277,1041659772,1,64,64,1360620249906,1360620249906,1041632678,1041632678,0
1360620277,1041659944,18,4026,223.6666667,1360620251396,1360620255428,1041634340,1041638372,4032
1360620281,1041663896,1,52,52,1360620253238,1360620253238,1041636134,1041636134,0
1360620301,1041684156,3,168,56,1360620297522,1360620298162,1041680678,1041681318,640
1360620301,1041684180,3,168,56,1360620298395,1360620299035,1041681575,1041682215,640
1360620301,1041684192,3,168,56,1360620295948,1360620296588,1041679140,1041679780,640
1360620301,1041684236,4,271,67.75,1360620293858,1360620294434,1041677094,1041677670,576
1360620301,1041684240,3,168,56,1360620294557,1360620295389,1041677797,1041678629,832
1360620301,1041684276,5,1802,360.4,1360620290938,1360620295034,1041674214,1041678310,4096
1360620301,1041684276,3,168,56,1360620299256,1360620299960,1041682532,1041683236,704
1360620317,1041699896,1,46,46,1360620289268,1360620289268,1041672164,1041672164,0
1360620317,1041699936,1,46,46,1360620290252,1360620290252,1041673188,1041673188,0
1360620317,1041699976,86,101302,1177.930233,1360620291301,1360620300709,1041674277,1041683685,9408
1360620325,1041707804,1,46,46,1360620297233,1360620297233,1041680037,1041680037,0
1360620325,1041708036,1,46,46,1360620300010,1360620300010,1041683046,1041683046,0
1360620325,1041708288,4,232,58,1360620318894,1360620322670,1041702182,1041705958,3776
1360620333,1041716200,2,131,65.5,1360620329797,1360620329797,1041712997,1041712997,0
1360620357,1041739944,10,5685,568.5,1360620329220,1360620334980,1041712164,1041717924,5760
1360620357,1041740016,1,188,188,1360620331131,1360620331131,1041714147,1041714147,0
1360620365,1041748236,13,3571,274.6923077,1360620363039,1360620364639,1041746275,1041747875,1600
1360620365,1041748268,15,3760,250.6666667,1360620360575,1360620362431,1041743843,1041745699,1856
1360620366,1041748324,18,5915,328.6111111,1360620363887,1360620365487,1041746211,1041747811,1600
1360620374,1041756620,13,3571,274.6923077,1360620363657,1360620365769,1041746277,1041748389,2112
1360620382,1041764412,4,1244,311,1360620356057,1360620356377,1041738469,1041738789,320
1360620393,1041776124,1,79,79,1360620365262,1360620365262,1041748386,1041748386,0
1360620393,1041776276,9,3463,384.7777778,1360620365302,1360620366454,1041748578,1041749730,1152
1360620413,1041796288,1,52,52,1360620385516,1360620385516,1041768804,1041768804,0
1360620494,1041876588,2,131,65.5,1360620487013,1360620487013,1041869601,1041869601,0
1360620534,1041916748,1,46,46,1360620508487,1360620508487,1041891235,1041891235,0
1360620602,1041984668,1,52,52,1360620575252,1360620575252,1041957920,1041957920,0
1360620674,1042056808,2,238,119,1360620646470,1360620672966,1042029278,1042055774,26496
1360620674,1042056848,13,7069,543.7692308,1360620647265,1360620649441,1042030113,1042032289,2176
1360620698,1042081040,23,4713,204.9130435,1360620670816,1360620686880,1042053856,1042069920,16064
1360620698,1042081280,10,4986,498.6,1360620673391,1360620675119,1042056671,1042058399,1728
1360620704,1042086372,1,46,46,1360620676602,1360620676602,1042058974,1042058974,0
1360620895,1042278236,2,116,58,1360620894361,1360620894617,1042277597,1042277853,256
1360620904,1042286308,3,168,56,1360620896183,1360620896823,1042278491,1042279131,640
1360620915,1042297440,1,52,52,1360620889845,1360620889845,1042272285,1042272285,0
1360620922,1042305256,1,52,52,1360620894916,1360620894916,1042278172,1042278172,0
1360620923,1042305340,1,64,64,1360620897111,1360620897111,1042279451,1042279451,0
1360620943,1042325380,1,52,52,1360620916016,1360620916016,1042298396,1042298396,0
1360680362,1101744196,1,46,46,1360680336868,1360680336868,1101719064,1101719064,0
1360681908,1103290580,1,46,46,1360681878287,1360681878287,1103260867,1103260867,0
1360682114,1103496676,1,46,46,1360682087212,1360682087212,1103469888,1103469888,0
1360682636,1104018216,1,64,64,1360682608494,1360682608494,1103990710,1103990710,0
1360682636,1104018296,18,4147,230.3888889,1360682611551,1360682615711,1103993847,1103998007,4160
1360682643,1104026072,18,16267,903.7222222,1360682615318,1360682618454,1103998390,1104001526,3136
1360682720,1104102400,1,46,46,1360682694196,1360682694196,1104076596,1104076596,0
1360682720,1104102512,1,64,64,1360682694727,1360682694727,1104077239,1104077239,0
1360682740,1104122552,9,2335,259.4444444,1360682714524,1360682721500,1104097076,1104104052,6976
1360682748,1104130396,1,52,52,1360682720889,1360682720889,1104103285,1104103285,0
1360682752,1104134432,1,46,46,1360682724182,1360682724182,1104106614,1104106614,0
1360682764,1104146756,3,168,56,1360682759377,1360682760721,1104142133,1104143477,1344
1360682772,1104154812,4,232,58,1360682761497,1360682765721,1104144309,1104148533,4224
1360682828,1104210752,3,168,56,1360682819988,1360682820116,1104202740,1104202868,128
1360682836,1104218440,21,6302,300.0952381,1360682808522,1360682817418,1104190962,1104199858,8896
1360682836,1104218452,1,52,52,1360682809344,1360682809344,1104191796,1104191796,0
1360682840,1104222576,1,46,46,1360682813764,1360682813764,1104196340,1104196340,0
1360682844,1104226592,9,3475,386.1111111,1360682819251,1360682820147,1104201843,1104202739,896
1360682848,1104230572,1,64,64,1360682820489,1360682820489,1104203061,1104203061,0
1360682880,1104262432,12,5715,476.25,1360682851922,1360682854994,1104234354,1104237426,3072
1360682880,1104262560,3,307,102.3333333,1360682853649,1360682863953,1104236209,1104246513,10304
1360682884,1104266512,1,52,52,1360682858947,1360682858947,1104241459,1104241459,0
1360682900,1104282932,3,168,56,1360682895198,1360682896286,1104278130,1104279218,1088
1360682924,1104306516,24,7708,321.1666667,1360682896254,1360682908542,1104278770,1104291058,12288
1360682932,1104314560,1,52,52,1360682906002,1360682906002,1104288562,1104288562,0
1360682932,1104314652,1,64,64,1360682906039,1360682906039,1104288691,1104288691,0
1360682940,1104322920,2,131,65.5,1360682939688,1360682939688,1104322608,1104322608,0
1360682948,1104330964,4,316,79,1360682940030,1360682944766,1104322994,1104327730,4736
1360682964,1104347000,2,158,79,1360682950231,1360682961175,1104333231,1104344175,10944
1360682988,1104371004,7,502,71.71428571,1360682979029,1360682985941,1104362033,1104368945,6912
1360683008,1104390788,1,79,79,1360682983278,1360682983278,1104366066,1104366066,0
1360683012,1104394644,1,46,46,1360682986301,1360682986301,1104368945,1104368945,0
1360683012,1104394644,3,174,58,1360682986364,1360683010556,1104369008,1104393200,24192
1360683012,1104394736,21,4813,229.1904762,1360682987039,1360682994527,1104369775,1104377263,7488
1360683012,1104394920,1,52,52,1360682987560,1360682987560,1104370480,1104370480,0
1360683032,1104414820,5,250,50,1360683006541,1360683028621,1104389361,1104411441,22080
1360683036,1104418724,1,64,64,1360683010474,1360683010474,1104393198,1104393198,0
1360683040,1104422692,1,46,46,1360683013003,1360683013003,1104395695,1104395695,0
1360683056,1104438812,1,52,52,1360683028950,1360683028950,1104411762,1104411762,0
1360683068,1104450720,1,64,64,1360683040754,1360683040754,1104423474,1104423474,0
1360683068,1104450884,1,46,46,1360683043338,1360683043338,1104426222,1104426222,0
1360683100,1104483056,3,168,56,1360683096993,1360683097633,1104480049,1104480689,640
1360683100,1104483084,3,168,56,1360683097923,1360683098499,1104481007,1104481583,576
1360683101,1104483092,3,168,56,1360683099809,1360683100449,1104481901,1104482541,640
1360683101,1104483096,3,168,56,1360683096926,1360683097566,1104479022,1104479662,640
1360683101,1104483136,3,168,56,1360683095864,1360683096568,1104478000,1104478704,704
1360683120,1104502924,1,52,52,1360683094562,1360683094562,1104477486,1104477486,0
1360683152,1104534932,2,188,94,1360683124187,1360683124187,1104507119,1104507119,0
1360683229,1104611292,1,52,52,1360683203033,1360683203033,1104585325,1104585325,0
1360683365,1104747396,2,188,94,1360683336945,1360683336945,1104719341,1104719341,0
1360683365,1104747580,7,1609,229.8571429,1360683357237,1360683358709,1104739817,1104741289,1472
1360683385,1104767632,9,3463,384.7777778,1360683356867,1360683358019,1104739499,1104740651,1152
1360683397,1104779560,2,464,232,1360683369355,1360683369611,1104751915,1104752171,256
1360683429,1104811736,4,304,76,1360683403419,1360683413467,1104786155,1104796203,10048
1360683485,1104867676,3,240,80,1360683459734,1360683478038,1104842410,1104860714,18304
1360683485,1104867936,2,131,65.5,1360683477587,1360683477587,1104860523,1104860523,0
1360683501,1104883952,21,3548,168.952381,1360683497728,1360683499456,1104880680,1104882408,1728
1360683521,1104903820,7,3438,491.1428571,1360683495943,1360683497031,1104878763,1104879851,1088
1360683545,1104927760,1,52,52,1360683519617,1360683519617,1104902377,1104902377,0
1360683697,1105080020,4,642,160.5,1360683672440,1360683682104,1105055460,1105065124,9664
1360683741,1105124060,1,52,52,1360683716755,1360683716755,1105099815,1105099815,0
1360683765,1105147988,1,52,52,1360683736920,1360683736920,1105119908,1105119908,0
1360683810,1105192836,1,48,48,1360683784432,1360683784432,1105167268,1105167268,0
1360684122,1105504940,1,78,78,1360684095682,1360684095682,1105478622,1105478622,0
1360684267,1105649116,8,3390,423.75,1360684240313,1360684241657,1105622429,1105623773,1344
1360684507,1105889408,1,52,52,1360684481361,1360684481361,1105863769,1105863769,0
1360684647,1106029992,5,333,66.6,1360684641352,1360684641800,1106024344,1106024792,448
1360684684,1106066096,18,4018,223.2222222,1360684657609,1360684660361,1106039705,1106042457,2752
1360684953,1106335812,1,46,46,1360684925558,1360684925558,1106308370,1106308370,0
1360685216,1106599012,1,222,222,1360685191338,1360685191338,1106574350,1106574350,0
1360685730,1107112228,1,48,48,1360685703027,1360685703027,1107085255,1107085255,0
1360685789,1107171872,1,46,46,1360685764079,1360685764079,1107146951,1107146951,0
1360685986,1107368864,2,539,269.5,1360685959604,1360685959668,1107342468,1107342532,64
1360685990,1107372776,8,3741,467.625,1360685964043,1360685965451,1107346819,1107348227,1408
1360686050,1107432828,1,52,52,1360686022680,1360686022680,1107405508,1107405508,0
1360686118,1107501036,1,46,46,1360686092166,1360686092166,1107475202,1107475202,0
1360686122,1107504624,17,5237,308.0588235,1360686118178,1360686119586,1107500802,1107502210,1408
1360686122,1107504664,18,4468,248.2222222,1360686119865,1360686121529,1107502529,1107504193,1664
1360686122,1107504676,6,276,46,1360686117867,1360686117867,1107500543,1107500543,0
1360686130,1107512608,13,3571,274.6923077,1360686120242,1360686122802,1107502850,1107505410,2560
1360686130,1107512640,13,3571,274.6923077,1360686121872,1360686123216,1107504512,1107505856,1344
1360686130,1107512676,13,3571,274.6923077,1360686120174,1360686121838,1107502850,1107504514,1664
1360686135,1107517084,2,188,94,1360686110460,1360686110460,1107492544,1107492544,0
1360686147,1107529228,9,3463,384.7777778,1360686122221,1360686123309,1107504449,1107505537,1088
1360686223,1107605104,1,52,52,1360686195305,1360686195305,1107577409,1107577409,0
1360686231,1107613300,1,52,52,1360686205925,1360686205925,1107588225,1107588225,0
1360686250,1107633000,2,131,65.5,1360686242409,1360686242409,1107625409,1107625409,0
1360686571,1107954072,1,193,193,1360686543131,1360686543131,1107926203,1107926203,0
1360686572,1107954280,15,9529,635.2666667,1360686546674,1360686549042,1107928954,1107931322,2368
1360686748,1108130604,1,191,191,1360686723563,1360686723563,1108106167,1108106167,0
1360686752,1108134628,3,567,189,1360686724243,1360686724371,1108106871,1108106999,128
1360686891,1108273500,4,184,46,1360686885328,1360686885328,1108267828,1108267828,0
1360686912,1108295012,7,2757,393.8571429,1360686884947,1360686885203,1108267959,1108268215,256
1360686916,1108299056,4,608,152,1360686887911,1360686888423,1108270967,1108271479,512
1360686923,1108305484,13,7325,563.4615385,1360686920802,1360686922146,1108303286,1108304630,1344
1360686923,1108305484,39,42333,1085.461538,1360686916770,1360686919138,1108299254,1108301622,2368
1360686923,1108305528,5,1407,281.4,1360686918965,1360686919093,1108301493,1108301621,128
1360686923,1108305528,7,5038,719.7142857,1360686919157,1360686919285,1108301685,1108301813,128
1360686923,1108305600,4,1505,376.25,1360686918635,1360686918699,1108301235,1108301299,64
1360686931,1108313540,50,65470,1309.4,1360686915495,1360686925543,1108298035,1108308083,10048
1360686931,1108313544,2,112,56,1360686917603,1360686927651,1108300147,1108310195,10048
1360686931,1108313572,5,546,109.2,1360686926727,1360686926855,1108309299,1108309427,128
1360686931,1108313576,9,2756,306.2222222,1360686922118,1360686923078,1108304694,1108305654,960
1360686931,1108313604,9,2924,324.8888889,1360686923050,1360686927530,1108305654,1108310134,4480
1360686931,1108313612,1497,2128209,1421.649299,1360686915426,1360686927650,1108298038,1108310262,12224
1360686931,1108313612,3,164,54.66666667,1360686917535,1360686927583,1108300147,1108310195,10048
1360686931,1108313616,2,112,56,1360686917531,1360686927579,1108300147,1108310195,10048
1360686941,1108323416,7,3509,501.2857143,1360686915108,1360686915556,1108297524,1108297972,448
1360686945,1108327312,13,14782,1137.076923,1360686917839,1360686917903,1108300151,1108300215,64
1360686945,1108327376,1,60,60,1360686919310,1360686919310,1108301686,1108301686,0
1360686945,1108327468,1,60,60,1360686919216,1360686919216,1108301684,1108301684,0
1360686945,1108327468,1,60,60,1360686919216,1360686919216,1108301684,1108301684,0
1360686945,1108327468,3,514,171.3333333,1360686919407,1360686919471,1108301875,1108301939,64
1360686969,1108351380,1,191,191,1360686942857,1360686942857,1108325237,1108325237,0
1360686969,1108351464,7,1381,197.2857143,1360686942260,1360686943860,1108324724,1108326324,1600
1360686979,1108361568,5,546,109.2,1360686971084,1360686971148,1108353652,1108353716,64
1360686997,1108379420,1,52,52,1360686971934,1360686971934,1108354354,1108354354,0
1360686997,1108379464,3,240,80,1360686968883,1360686973171,1108351347,1108355635,4288
1360686997,1108379536,1,52,52,1360686971820,1360686971820,1108354356,1108354356,0
1360686997,1108379536,1,52,52,1360686971819,1360686971819,1108354355,1108354355,0
1360687085,1108467472,1,52,52,1360687057324,1360687057324,1108439796,1108439796,0
1360687107,1108489656,14,6710,479.2857143,1360687101683,1360687102195,1108484339,1108484851,512
1360687107,1108489660,15,3292,219.4666667,1360687102190,1360687102574,1108484850,1108485234,384
1360687107,1108489660,15,3260,217.3333333,1360687097773,1360687099053,1108480433,1108481713,1280
1360687107,1108489696,17,3582,210.7058824,1360687100427,1360687100747,1108483123,1108483443,320
1360687107,1108489700,24,6948,289.5,1360687100744,1360687101512,1108483444,1108484212,768
1360687107,1108489704,27,4441,164.4814815,1360687104643,1360687105411,1108487347,1108488115,768
1360687107,1108489720,34,9830,289.1176471,1360687099059,1360687100275,1108481779,1108482995,1216
1360687107,1108489728,33,4348,131.7575758,1360687101868,1360687102572,1108484596,1108485300,704
1360687107,1108489780,15,3198,213.2,1360687103735,1360687104503,1108486515,1108487283,768
1360687115,1108497644,20,3426,171.3,1360687109120,1360687109696,1108491764,1108492340,576
1360687115,1108497724,60,61473,1024.55,1360687105391,1360687108207,1108488115,1108490931,2816
1360687115,1108497764,17,3435,202.0588235,1360687108165,1360687108805,1108490929,1108491569,640
1360687125,1108507792,7,3438,491.1428571,1360687097064,1360687097320,1108479856,1108480112,256
1360687125,1108507956,2,188,94,1360687098054,1360687098054,1108481010,1108481010,0
1360687131,1108513708,3,168,56,1360687126783,1360687127039,1108509491,1108509747,256
1360687131,1108513708,12,6343,528.5833333,1360687126719,1360687127167,1108509427,1108509875,448
1360687131,1108513728,3,168,56,1360687127016,1360687127272,1108509744,1108510000,256
1360687131,1108513784,3,156,52,1360687125424,1360687126192,1108508208,1108508976,768
1360687131,1108513792,17,13663,803.7058824,1360687126312,1360687126632,1108509104,1108509424,320
1360687131,1108513800,10,6603,660.3,1360687127201,1360687127393,1108510001,1108510193,192
1360687131,1108513804,9,6176,686.2222222,1360687127518,1360687127582,1108510322,1108510386,64
1360687139,1108521740,11,2905,264.0909091,1360687138140,1360687138780,1108520880,1108521520,640
1360687147,1108529676,2,110,55,1360687127389,1360687145885,1108510065,1108528561,18496
1360687153,1108535952,1,46,46,1360687126344,1360687126344,1108509296,1108509296,0
1360687153,1108535984,11,4416,401.4545455,1360687127209,1360687128809,1108510193,1108511793,1600
1360687163,1108545640,2,104,52,1360687155392,1360687155584,1108538032,1108538224,192
1360687163,1108545716,2,104,52,1360687157495,1360687157687,1108540211,1108540403,192
1360687163,1108545732,2,92,46,1360687159205,1360687159461,1108541937,1108542193,256
1360687171,1108553640,2,92,46,1360687169794,1360687169986,1108552434,1108552626,192
1360687189,1108571972,15,7270,484.6666667,1360687164405,1360687167349,1108547377,1108550321,2944
1360687189,1108572044,2,238,119,1360687163502,1360687183726,1108546546,1108566770,20224
1360687209,1108591912,1,52,52,1360687183407,1360687183407,1108566319,1108566319,0
1360687243,1108625716,3,168,56,1360687239283,1360687240435,1108621999,1108623151,1152
1360687243,1108625764,2,116,58,1360687242309,1360687242629,1108625073,1108625393,320
1360687251,1108633728,2,104,52,1360687245674,1360687246122,1108628402,1108628850,448
1360687251,1108633756,3,168,56,1360687246603,1360687247371,1108629359,1108630127,768
1360687259,1108641688,3,150,50,1360687243024,1360687254224,1108625712,1108636912,11200
1360687269,1108651932,31,6577,212.1612903,1360687241498,1360687262170,1108624430,1108645102,20672
1360687269,1108652040,1,46,46,1360687241008,1360687241008,1108624048,1108624048,0
1360687273,1108655976,14,5140,367.1428571,1360687247151,1360687263343,1108630127,1108646319,16192
1360687273,1108655976,1,64,64,1360687247214,1360687247214,1108630190,1108630190,0
1360687301,1108683944,7,2443,349,1360687273359,1360687297103,1108656303,1108680047,23744
1360687307,1108689800,2,110,55,1360687294111,1360687299871,1108676911,1108682671,5760
1360687325,1108707996,2,188,94,1360687299420,1360687299420,1108682416,1108682416,0
1360687337,1108720076,8,3930,491.25,1360687310348,1360687310924,1108693424,1108694000,576
1360687339,1108721724,3,156,52,1360687337385,1360687338089,1108720109,1108720813,704
1360687346,1108728232,17,9591,564.1764706,1360687319319,1360687337623,1108701551,1108719855,18304
1360687347,1108729724,3,168,56,1360687346154,1360687346346,1108728878,1108729070,192
1360687347,1108729760,2,104,52,1360687338949,1360687340805,1108721709,1108723565,1856
1360687363,1108745716,3,168,56,1360687355377,1360687355761,1108738093,1108738477,384
1360687363,1108745752,3,168,56,1360687356236,1360687357132,1108738988,1108739884,896
1360687378,1108760236,27,8638,319.9259259,1360687350610,1360687369042,1108732846,1108751278,18432
1360687382,1108764156,1,1004,1004,1360687355874,1360687355874,1108738030,1108738030,0
1360687382,1108764280,1,52,52,1360687355815,1360687355815,1108738095,1108738095,0
1360687386,1108768164,1,64,64,1360687358044,1360687358044,1108740208,1108740208,0
1360687394,1108776408,1,52,52,1360687369383,1360687369383,1108751791,1108751791,0
1360687398,1108780328,11,4527,411.5454545,1360687370549,1360687375221,1108752877,1108757549,4672
1360687410,1108792196,1,52,52,1360687385848,1360687385848,1108768044,1108768044,0
1360687411,1108793768,2,116,58,1360687409533,1360687410045,1108792301,1108792813,512
1360687411,1108793888,2,104,52,1360687407428,1360687408452,1108790316,1108791340,1024
1360687438,1108820228,1,52,52,1360687411545,1360687411545,1108793773,1108793773,0
1360687491,1108873760,4,271,67.75,1360687490308,1360687490372,1108873068,1108873132,64
1360687491,1108873764,3,168,56,1360687490751,1360687490879,1108873515,1108873643,128
1360687491,1108873832,3,168,56,1360687490428,1360687490556,1108873260,1108873388,128
1360687498,1108880284,1,52,52,1360687473826,1360687473826,1108856110,1108856110,0
1360687498,1108880336,16,4347,271.6875,1360687473518,1360687492334,1108855854,1108874670,18816
1360687499,1108881764,2,131,65.5,1360687491968,1360687491968,1108874732,1108874732,0
1360687499,1108881836,3,168,56,1360687490807,1360687490999,1108873643,1108873835,192
1360687518,1108900268,1,64,64,1360687491697,1360687491697,1108873965,1108873965,0
1360687518,1108900360,18,4884,271.3333333,1360687491541,1360687498261,1108873901,1108880621,6720
1360687518,1108900396,1,46,46,1360687490993,1360687490993,1108873389,1108873389,0
1360687547,1108929972,2,104,52,1360687534641,1360687540785,1108917613,1108923757,6144
1360687555,1108937912,3,168,56,1360687549036,1360687549100,1108931948,1108932012,64
1360687555,1108937956,3,168,56,1360687548863,1360687548991,1108931819,1108931947,128
1360687563,1108945888,13,3003,231,1360687557957,1360687560069,1108940845,1108942957,2112
1360687563,1108945928,5,1407,281.4,1360687560092,1360687560220,1108943020,1108943148,128
1360687563,1108945964,4,1507,376.75,1360687559416,1360687559480,1108942380,1108942444,64
1360687563,1108945972,7,5103,729,1360687560751,1360687560879,1108943723,1108943851,128
1360687563,1108945972,9,2684,298.2222222,1360687560751,1360687562415,1108943723,1108945387,1664
1360687571,1108953904,2,112,56,1360687558707,1360687568755,1108941611,1108951659,10048
1360687571,1108953904,2,112,56,1360687558706,1360687568754,1108941610,1108951658,10048
1360687571,1108953908,10,3158,315.8,1360687567214,1360687570670,1108950122,1108953578,3456
1360687571,1108953928,1444,2159349,1495.394044,1360687556890,1360687569306,1108939818,1108952234,12416
1360687571,1108953976,9,2924,324.8888889,1360687563373,1360687565485,1108946349,1108948461,2112
1360687571,1108953976,9,2684,298.2222222,1360687562475,1360687565483,1108945451,1108948459,3008
1360687571,1108953976,2,112,56,1360687558634,1360687568682,1108941610,1108951658,10048
1360687571,1108953988,52,71366,1372.423077,1360687556829,1360687566877,1108939817,1108949865,10048
1360687574,1108956480,1,46,46,1360687549277,1360687549277,1108931757,1108931757,0
1360687574,1108956572,1,64,64,1360687549502,1360687549502,1108932074,1108932074,0
1360687578,1108960464,15,4295,286.3333333,1360687552425,1360687558313,1108934889,1108940777,5888
1360687578,1108960544,1,52,52,1360687551451,1360687551451,1108933995,1108933995,0
1360687578,1108960580,1,52,52,1360687552631,1360687552631,1108935211,1108935211,0
1360687579,1108961932,2,112,56,1360687560792,1360687578776,1108943724,1108961708,17984
1360687579,1108961932,2,112,56,1360687560791,1360687578775,1108943723,1108961707,17984
1360687579,1108961972,2,110,55,1360687562161,1360687572273,1108945133,1108955245,10112
1360687579,1108962004,2,112,56,1360687560720,1360687578704,1108943724,1108961708,17984
1360687582,1108964528,7,3509,501.2857143,1360687557226,1360687557546,1108939754,1108940074,320
1360687586,1108968508,3,514,171.3333333,1360687561406,1360687561406,1108943914,1108943914,0
1360687586,1108968552,18,23468,1303.777778,1360687559059,1360687559251,1108941611,1108941803,192
1360687587,1108969936,5,546,109.2,1360687580244,1360687580372,1108963180,1108963308,128
1360687587,1108969940,2,110,55,1360687572305,1360687584849,1108955245,1108967789,12544
1360687603,1108985924,3,168,56,1360687601504,1360687601632,1108984428,1108984556,128
1360687603,1108985924,3,168,56,1360687601630,1360687601694,1108984554,1108984618,64
1360687603,1108985928,3,168,56,1360687601756,1360687601884,1108984684,1108984812,128
1360687610,1108992748,1,64,64,1360687582608,1360687582608,1108965356,1108965356,0
1360687634,1109016584,1,46,46,1360687607025,1360687607025,1108989609,1108989609,0
1360687707,1109090008,11,5562,505.6363636,1360687700873,1360687705033,1109083881,1109088041,4160
1360687707,1109090012,4,1625,406.25,1360687701188,1360687701252,1109084200,1109084264,64
1360687708,1109090092,16,9542,596.375,1360687706143,1360687707295,1109088235,1109089387,1152
1360687715,1109097960,10,3158,315.8,1360687710650,1360687711482,1109093610,1109094442,832
1360687715,1109098000,6,1021,170.1666667,1360687707345,1360687707409,1109090345,1109090409,64
1360687715,1109098000,10,3158,315.8,1360687707344,1360687708112,1109090344,1109091112,768
1360687715,1109098004,5,546,109.2,1360687707339,1360687707531,1109090343,1109090535,192
1360687715,1109098020,10,3158,315.8,1360687710652,1360687711420,1109093672,1109094440,768
1360687723,1109106036,133,192755,1449.285714,1360687707628,1360687717676,1109090664,1109100712,10048
1360687723,1109106036,489,726602,1485.893661,1360687707627,1360687718123,1109090663,1109101159,10496
1360687723,1109106048,5,1020,204,1360687720161,1360687720353,1109103209,1109103401,192
1360687726,1109108816,10,14618,1461.8,1360687700874,1360687700874,1109083690,1109083690,0
1360687730,1109112744,9,3475,386.1111111,1360687702863,1360687703503,1109085607,1109086247,640
1360687731,1109113976,5,546,109.2,1360687724327,1360687724391,1109107303,1109107367,64
1360687734,1109116672,1,416,416,1360687706842,1360687706842,1109089514,1109089514,0
1360687734,1109116684,1,46,46,1360687708430,1360687708430,1109091114,1109091114,0
1360687734,1109116796,1,46,46,1360687708315,1360687708315,1109091111,1109091111,0
1360687738,1109120800,1,186,186,1360687712087,1360687712087,1109094887,1109094887,0
1360687742,1109124744,12,6862,571.8333333,1360687715153,1360687716881,1109097897,1109099625,1728
1360687755,1109138044,10,3156,315.6,1360687751142,1360687753574,1109134186,1109136618,2432
1360687771,1109153988,5,546,109.2,1360687763291,1360687763419,1109146279,1109146407,128
1360687774,1109156840,1,60,60,1360687748209,1360687748209,1109131049,1109131049,0
1360687806,1109188696,4,814,203.5,1360687778177,1360687778561,1109160873,1109161257,384
1360687822,1109204944,1,52,52,1360687797128,1360687797128,1109180072,1109180072,0
1360687827,1109210008,2,131,65.5,1360687822984,1360687822984,1109205992,1109205992,0
1360687892,1109274276,16,9542,596.375,1360687887716,1360687888932,1109269992,1109271208,1216
1360687892,1109274280,3,168,56,1360687888416,1360687888544,1109270696,1109270824,128
1360687892,1109274304,3,168,56,1360687888903,1360687889031,1109271207,1109271335,128
1360687892,1109274304,10,5036,503.6,1360687889093,1360687889989,1109271397,1109272293,896
1360687892,1109274308,3,168,56,1360687889152,1360687889280,1109271460,1109271588,128
1360687892,1109274348,4,271,67.75,1360687888666,1360687888794,1109271014,1109271142,128
1360687892,1109274348,3,168,56,1360687888538,1360687888730,1109270886,1109271078,192
1360687892,1109274352,3,168,56,1360687888981,1360687889045,1109271333,1109271397,64
1360687908,1109290292,5,1020,204,1360687904145,1360687904337,1109286437,1109286629,192
1360687908,1109290328,11,5082,462,1360687890158,1360687901166,1109272486,1109283494,11008
1360687918,1109300944,1,52,52,1360687891397,1360687891397,1109274341,1109274341,0
1360687919,1109301080,18,4575,254.1666667,1360687891686,1360687898982,1109273766,1109281062,7296
1360687919,1109301136,8,3439,429.875,1360687893422,1360687893742,1109275558,1109275878,320
1360687924,1109306284,4,1506,376.5,1360687920345,1360687920409,1109302629,1109302693,64
1360687924,1109306348,5,546,109.2,1360687916571,1360687916699,1109298919,1109299047,128
1360687932,1109314296,16,18610,1163.125,1360687925836,1360687925964,1109308132,1109308260,128
1360687932,1109314300,8,5627,703.375,1360687925771,1360687931723,1109308071,1109314023,5952
1360687932,1109314316,5,546,109.2,1360687927739,1360687927803,1109310055,1109310119,64
1360687932,1109314344,5,1407,281.4,1360687925535,1360687925663,1109307879,1109308007,128
1360687940,1109322380,6,1838,306.3333333,1360687925496,1360687932408,1109307876,1109314788,6912
1360687940,1109322408,4,449,112.25,1360687926110,1360687932382,1109308518,1109314790,6272
1360687948,1109330280,2,92,46,1360687947293,1360687947485,1109329573,1109329765,192
1360687948,1109330316,5,274,54.8,1360687925818,1360687942650,1109308134,1109324966,16832
1360687948,1109330364,2,104,52,1360687941321,1360687941513,1109323685,1109323877,192
1360687948,1109330368,5,274,54.8,1360687925766,1360687942598,1109308134,1109324966,16832
1360687948,1109330368,5,274,54.8,1360687925766,1360687942598,1109308134,1109324966,16832
1360687951,1109333160,3,514,171.3333333,1360687926230,1360687926230,1109308390,1109308390,0
1360687959,1109341096,1,46,46,1360687932693,1360687932693,1109314789,1109314789,0
1360687972,1109354336,5,546,109.2,1360687968997,1360687969573,1109351333,1109351909,576
1360687994,1109377020,2,116,58,1360687966776,1360687966968,1109349796,1109349988,192
1360688004,1109386364,16,3306,206.625,1360687997706,1360687999370,1109380070,1109381734,1664
1360688022,1109405032,7,3438,491.1428571,1360687995308,1360687996396,1109378340,1109379428,1088
1360688047,1109429244,1,52,52,1360688018945,1360688018945,1109401189,1109401189,0
1360688099,1109481352,3,144,48,1360688074836,1360688083732,1109457188,1109466084,8896
1360688108,1109490380,15,5164,344.2666667,1360688106232,1360688107704,1109488612,1109490084,1472
1360688123,1109505512,7,2757,393.8571429,1360688096435,1360688096691,1109478947,1109479203,256
1360688123,1109505572,9,3463,384.7777778,1360688098167,1360688098551,1109480739,1109481123,384
1360688124,1109506448,10,3156,315.6,1360688113969,1360688117681,1109496417,1109500129,3712
1360688127,1109509584,3,408,136,1360688102186,1360688112874,1109484770,1109495458,10688
1360688132,1109514432,5,546,109.2,1360688126593,1360688126721,1109509025,1109509153,128
1360688159,1109541592,1,52,52,1360688133281,1360688133281,1109515873,1109515873,0
1360688191,1109573644,1,46,46,1360688165871,1360688165871,1109548515,1109548515,0
1360688220,1109602540,2,131,65.5,1360688218453,1360688218453,1109600993,1109600993,0
1360688252,1109634564,12,5360,446.6666667,1360688247037,1360688249021,1109629601,1109631585,1984
1360688252,1109634568,4,1617,404.25,1360688247291,1360688247419,1109629859,1109629987,128
1360688252,1109634592,6,1839,306.5,1360688247585,1360688248993,1109630177,1109631585,1408
1360688252,1109634596,9,7100,788.8888889,1360688247838,1360688248990,1109630434,1109631586,1152
1360688252,1109634608,14,4565,326.0714286,1360688249103,1360688249935,1109631711,1109632543,832
1360688260,1109642508,2,112,56,1360688246966,1360688257014,1109629474,1109639522,10048
1360688260,1109642524,10,3156,315.6,1360688253541,1360688256677,1109636065,1109639201,3136
1360688260,1109642560,4,449,112.25,1360688250496,1360688253312,1109633056,1109635872,2816
1360688260,1109642560,2,112,56,1360688246911,1360688256959,1109629471,1109639519,10048
1360688260,1109642560,2,112,56,1360688246911,1360688256959,1109629471,1109639519,10048
1360688263,1109645980,1,52,52,1360688236508,1360688236508,1109619488,1109619488,0
1360688271,1109653932,15,19140,1276,1360688246539,1360688246603,1109629471,1109629535,64
1360688275,1109657920,3,514,171.3333333,1360688249689,1360688249753,1109632609,1109632673,64
1360688279,1109661896,1,46,46,1360688252976,1360688252976,1109635872,1109635872,0
1360688300,1109682684,4,271,67.75,1360688297795,1360688298819,1109680479,1109681503,1024
1360688308,1109690532,4,271,67.75,1360688303260,1360688303900,1109685792,1109686432,640
1360688308,1109690552,6,1080,180,1360688302086,1360688302918,1109684638,1109685470,832
1360688308,1109690620,4,271,67.75,1360688302146,1360688302658,1109684766,1109685278,512
1360688332,1109714108,19,4070,214.2105263,1360688306307,1360688309763,1109688415,1109691871,3456
1360688335,1109718064,1,52,52,1360688307142,1360688307142,1109690206,1109690206,0
1360688348,1109730700,4,271,67.75,1360688345971,1360688346803,1109728671,1109729503,832
1360688351,1109733832,4,271,67.75,1360688346927,1360688347567,1109729759,1109730399,640
1360688356,1109738568,3,168,56,1360688348152,1360688348792,1109730720,1109731360,640
1360688363,1109745980,1,52,52,1360688336220,1360688336220,1109719200,1109719200,0
1360688375,1109758104,17,5384,316.7058824,1360688348575,1360688351967,1109731679,1109735071,3392
1360688375,1109758120,1,52,52,1360688350157,1360688350157,1109733277,1109733277,0
1360688492,1109874780,2,92,46,1360688489888,1360688490080,1109872668,1109872860,192
1360688512,1109894596,1,52,52,1360688486874,1360688486874,1109869470,1109869470,0
1360688685,1110067340,3,168,56,1360688683285,1360688683925,1110065625,1110066265,640
1360688693,1110075220,4,271,67.75,1360688684558,1360688685198,1110066778,1110067418,640
1360688697,1110079172,1,64,64,1360688671742,1360688671742,1110053914,1110053914,0
1360688701,1110083140,17,3966,233.2941176,1360688674653,1360688678045,1110056793,1110060185,3392
1360688701,1110083184,1,52,52,1360688676529,1360688676529,1110058713,1110058713,0
1360688709,1110091336,3,168,56,1360688706394,1360688706970,1110088730,1110089306,576
1360688725,1110107568,2,110,55,1360688706992,1360688717360,1110089560,1110099928,10368
1360688725,1110107608,3,168,56,1360688717577,1360688718281,1110100185,1110100889,704
1360688749,1110131364,9,3475,386.1111111,1360688723454,1360688726590,1110105818,1110108954,3136
1360688765,1110147600,3,168,56,1360688763664,1360688764240,1110146264,1110146840,576
1360688773,1110155548,3,168,56,1360688764612,1360688765188,1110147160,1110147736,576
1360688773,1110155560,3,168,56,1360688765691,1360688766395,1110148251,1110148955,704
1360688793,1110175468,1,46,46,1360688766739,1360688766739,1110149207,1110149207,0
1360688853,1110235764,3,183,61,1360688845483,1360688846379,1110228247,1110229143,896
1360688981,1110363924,3,168,56,1360688979402,1360688980042,1110362326,1110362966,640
1360689009,1110391596,19,4070,214.2105263,1360688982224,1360688989072,1110364820,1110371668,6848
1360689009,1110391644,1,52,52,1360688984097,1360688984097,1110366741,1110366741,0
1360689169,1110551936,1,186,186,1360689142715,1360689142715,1110525651,1110525651,0
1360689173,1110555944,13,7073,544.0769231,1360689145139,1360689146995,1110528083,1110529939,1856
1360689310,1110692400,3,168,56,1360689305810,1360689306450,1110688210,1110688850,640
1360689318,1110700400,18,4142,230.1111111,1360689292047,1360689297743,1110674447,1110680143,5696
1360689322,1110704152,1,46,46,1360689294473,1360689294473,1110676625,1110676625,0
1360689322,1110704192,1,52,52,1360689296033,1360689296033,1110678225,1110678225,0
1360689322,1110704272,1,64,64,1360689295250,1360689295250,1110677522,1110677522,0
1360689322,1110704340,9,3499,388.7777778,1360689297100,1360689298508,1110679440,1110680848,1408
1360689334,1110716176,1,64,64,1360689306993,1360689306993,1110689169,1110689169,0
1360689342,1110724548,3,168,56,1360689340029,1360689340605,1110722577,1110723153,576
1360689342,1110724564,3,168,56,1360689338221,1360689338733,1110720785,1110721297,512
1360689342,1110724592,3,168,56,1360689339023,1360689339663,1110721615,1110722255,640
1360689342,1110724628,3,168,56,1360689340844,1360689341484,1110723472,1110724112,640
1360689350,1110732228,1,46,46,1360689321978,1360689321978,1110704206,1110704206,0
1360689350,1110732532,3,168,56,1360689342924,1360689343500,1110725456,1110726032,576
1360689350,1110732576,3,168,56,1360689341791,1360689342559,1110724367,1110725135,768
1360689362,1110744236,1,46,46,1360689334388,1360689334388,1110716624,1110716624,0
1360689390,1110772868,2,104,52,1360689387067,1360689387707,1110769935,1110770575,640
1360689486,1110868736,26,17598,676.8461538,1360689459390,1360689462910,1110842126,1110845646,3520
1360689566,1110948656,1,52,52,1360689538189,1360689538189,1110920845,1110920845,0
1360689623,1111005096,3,168,56,1360689615611,1360689616187,1110997707,1110998283,576
1360689623,1111005140,2,110,55,1360689605009,1360689615313,1110987149,1110997453,10304
1360689623,1111005168,7,1609,229.8571429,1360689611509,1360689615605,1110993677,1110997773,4096
1360689630,1111012780,1,46,46,1360689603729,1360689603729,1110986509,1110986509,0
1360689630,1111012820,18,4188,232.6666667,1360689605479,1360689621415,1110988299,1111004235,15936
1360689634,1111016888,1,52,52,1360689607397,1360689607397,1110990285,1110990285,0
1360689642,1111024776,1,64,64,1360689615891,1360689615891,1110998667,1110998667,0
1360689730,1111112996,1,52,52,1360689702645,1360689702645,1111085641,1111085641,0
1360689778,1111160932,7,2757,393.8571429,1360689752053,1360689753397,1111134985,1111136329,1344
1360689943,1111325172,19,4070,214.2105263,1360689917740,1360689920748,1111299912,1111302920,3008
1360689943,1111325484,3,168,56,1360689940211,1360689941363,1111322695,1111323847,1152
1360689943,1111325484,3,168,56,1360689936306,1360689936882,1111318790,1111319366,576
1360689943,1111325564,3,168,56,1360689940961,1360689941601,1111323525,1111324165,640
1360689947,1111329176,1,52,52,1360689919205,1360689919205,1111301381,1111301381,0
1360689959,1111341504,3,168,56,1360689954975,1360689955679,1111337479,1111338183,704
1360689959,1111341540,13,3571,274.6923077,1360689956602,1360689958138,1111339142,1111340678,1536
1360689959,1111341588,4,271,67.75,1360689955657,1360689956617,1111338245,1111339205,960
1360689959,1111341588,18,4468,248.2222222,1360689956043,1360689957899,1111338631,1111340487,1856
1360689959,1111341588,3,168,56,1360689952905,1360689953545,1111335493,1111336133,640
1360689959,1111341592,13,3571,274.6923077,1360689956550,1360689958278,1111339142,1111340870,1728
1360689959,1111341596,15,3760,250.6666667,1360689953987,1360689955395,1111336583,1111337991,1408
1360689959,1111341596,3,168,56,1360689953986,1360689954690,1111336582,1111337286,704
1360689959,1111341616,3,168,56,1360689956976,1360689957872,1111339592,1111340488,896
1360689967,1111349200,1,64,64,1360689942798,1360689942798,1111324998,1111324998,0
1360689967,1111349308,1,46,46,1360689942180,1360689942180,1111324488,1111324488,0
1360689967,1111349556,20,16301,815.05,1360689956650,1360689959658,1111339206,1111342214,3008
1360689971,1111353176,1,52,52,1360689945126,1360689945126,1111327302,1111327302,0
1360689983,1111365156,2,734,367,1360689955706,1360689965050,1111337862,1111347206,9344
1360689983,1111365240,9,3463,384.7777778,1360689958631,1360689959463,1111340871,1111341703,832
1360690019,1111401380,1,52,52,1360689993946,1360689993946,1111376326,1111376326,0
1360690035,1111417284,2,240,120,1360690009657,1360690013305,1111391941,1111395589,3648
1360690035,1111417424,10,4560,456,1360690010542,1360690014126,1111392966,1111396550,3584
1360690087,1111469744,2,131,65.5,1360690078895,1360690078895,1111461639,1111461639,0
1360690232,1111614132,3,168,56,1360690230413,1360690231245,1111612545,1111613377,832
1360690240,1111622124,5,284,56.8,1360690234647,1360690235095,1111616771,1111617219,448
1360690240,1111622160,3,168,56,1360690236275,1360690236723,1111618435,1111618883,448
1360690240,1111622196,3,168,56,1360690237008,1360690237712,1111619204,1111619908,704
1360690240,1111622212,3,168,56,1360690235325,1360690235965,1111617537,1111618177,640
1360690255,1111637784,19,5755,302.8947368,1360690229508,1360690232772,1111612292,1111615556,3264
1360690259,1111641824,1,52,52,1360690231129,1360690231129,1111613953,1111613953,0
1360690279,1111661932,1,52,52,1360690253612,1360690253612,1111636544,1111636544,0
1360690280,1111662096,4,232,58,1360690274289,1360690278001,1111656385,1111660097,3712
1360690280,1111662108,3,168,56,1360690278248,1360690278824,1111660356,1111660932,576
1360690280,1111662136,3,168,56,1360690272203,1360690273035,1111654339,1111655171,832
1360690280,1111662180,3,168,56,1360690279133,1360690279709,1111661313,1111661889,576
1360690299,1111681808,1,46,46,1360690272747,1360690272747,1111655555,1111655555,0
1360690299,1111681848,20,5540,277,1360690274368,1360690277184,1111657216,1111660032,2816
1360690303,1111685792,1,52,52,1360690275640,1360690275640,1111658432,1111658432,0
1360690328,1111710176,4,208,52,1360690320033,1360690325025,1111702209,1111707201,4992
1360690344,1111726312,2,104,52,1360690330649,1360690340633,1111712961,1111722945,9984
1360690368,1111750340,2,104,52,1360690350652,1360690360636,1111732992,1111742976,9984
1360690396,1111778248,1,52,52,1360690370713,1360690370713,1111752961,1111752961,0
1360690657,1112039132,3,168,56,1360690652232,1360690653448,1112034364,1112035580,1216
1360690657,1112039144,3,168,56,1360690649277,1360690650045,1112031421,1112032189,768
1360690657,1112039176,3,168,56,1360690650334,1360690651230,1112032510,1112033406,896
1360690657,1112039176,3,168,56,1360690653725,1360690654493,1112035901,1112036669,768
1360690657,1112039204,4,220,55,1360690654975,1360690655743,1112037179,1112037947,768
1360690657,1112039212,2,116,58,1360690656246,1360690656566,1112038458,1112038778,320
1360690665,1112047108,3,168,56,1360690657374,1360690657950,1112039482,1112040058,576
1360690665,1112047116,3,168,56,1360690658327,1360690658903,1112040443,1112041019,576
1360690665,1112047144,4,271,67.75,1360690659132,1360690660284,1112041276,1112042428,1152
1360690665,1112047156,3,168,56,1360690660591,1360690661167,1112042747,1112043323,576
1360690676,1112058984,19,4086,215.0526316,1360690651381,1360690655413,1112034365,1112038397,4032
1360690684,1112066776,1,52,52,1360690656261,1360690656261,1112039037,1112039037,0
1360690753,1112135688,17,3358,197.5294118,1360690749402,1360690751386,1112132090,1112134074,1984
1360690753,1112135692,14,3214,229.5714286,1360690749656,1360690751384,1112132348,1112134076,1728
1360690761,1112143540,17,3581,210.6470588,1360690753773,1360690755373,1112136313,1112137913,1600
1360690761,1112143572,19,7378,388.3157895,1360690755406,1360690758926,1112137978,1112141498,3520
1360690761,1112143652,14,6710,479.2857143,1360690758974,1360690760830,1112141626,1112143482,1856
1360690761,1112143656,22,8815,400.6818182,1360690751482,1360690753530,1112134138,1112136186,2048
1360690769,1112151544,16,3250,203.125,1360690764904,1360690766760,1112147448,1112149304,1856
1360690769,1112151560,16,4027,251.6875,1360690762714,1360690764634,1112145274,1112147194,1920
1360690769,1112151584,16,3935,245.9375,1360690766722,1360690768514,1112149306,1112151098,1792
1360690769,1112151588,20,3738,186.9,1360690759166,1360690761214,1112141754,1112143802,2048
1360690769,1112151596,15,3293,219.5333333,1360690760887,1360690762551,1112143483,1112145147,1664
1360690773,1112155340,9,4004,444.8888889,1360690747828,1360690749556,1112130168,1112131896,1728
1360690777,1112159608,24,3769,157.0416667,1360690771500,1360690772908,1112154108,1112155516,1408
1360690777,1112159608,27,19449,720.3333333,1360690774507,1360690776747,1112157115,1112159355,2240
1360690777,1112159620,56,60005,1071.517857,1360690768479,1360690771487,1112151099,1112154107,3008
1360690777,1112159640,17,3241,190.6470588,1360690773066,1360690774410,1112155706,1112157050,1344
1360690785,1112167184,26,17221,662.3461538,1360690758482,1360690762450,1112140666,1112144634,3968
1360690993,1112375856,3,156,52,1360690989039,1360690991215,1112371895,1112374071,2176
1360691009,1112391784,4,208,52,1360691001845,1360691005941,1112384629,1112388725,4096
1360691021,1112403584,1,52,52,1360690994431,1360690994431,1112377015,1112377015,0
1360691033,1112415800,2,104,52,1360691029608,1360691032168,1112412408,1112414968,2560
1360691049,1112431972,2,104,52,1360691037179,1360691047227,1112420151,1112430199,10048
1360691073,1112455968,2,104,52,1360691057215,1360691067199,1112440183,1112450167,9984
1360691089,1112471912,2,104,52,1360691077237,1360691087285,1112460149,1112470197,10048
1360691266,1112648108,1,46,46,1360691240536,1360691240536,1112622644,1112622644,0
1360691438,1112820596,2,96,48,1360691413163,1360691416043,1112795759,1112798639,2880
1360691651,1113033272,3,168,56,1360691646700,1360691647340,1113028972,1113029612,640
1360691675,1113057392,1,64,64,1360691647542,1360691647542,1113029934,1113029934,0
1360691675,1113057440,18,4026,223.6666667,1360691649605,1360691653765,1113032045,1113036205,4160
1360691683,1113065628,3,168,56,1360691680330,1360691680906,1113062958,1113063534,576
1360691683,1113065656,3,168,56,1360691681258,1360691681834,1113063914,1113064490,576
1360691683,1113065656,2,116,58,1360691682156,1360691682540,1113064812,1113065196,384
1360691691,1113073556,3,168,56,1360691684495,1360691685135,1113067051,1113067691,640
1360691691,1113073628,3,168,56,1360691686856,1360691687496,1113069484,1113070124,640
1360691691,1113073628,3,168,56,1360691683528,1360691684104,1113066156,1113066732,576
1360691691,1113073668,3,168,56,1360691685919,1360691686559,1113068587,1113069227,640
1360691707,1113089352,1,46,46,1360691680350,1360691680350,1113062702,1113062702,0
1360691711,1113093320,1,52,52,1360691683197,1360691683197,1113065517,1113065517,0
1360691711,1113093492,1,46,46,1360691685456,1360691685456,1113067948,1113067948,0
1360692140,1113522864,13,8440,649.2307692,1360692136596,1360692138324,1113519460,1113521188,1728
1360692140,1113522896,11,6788,617.0909091,1360692134967,1360692136375,1113517863,1113519271,1408
1360692140,1113522900,10,6390,639,1360692138483,1360692139059,1113521383,1113521959,576
1360692148,1113530836,12,5364,447,1360692143794,1360692145394,1113526630,1113528230,1600
1360692148,1113530844,10,6201,620.1,1360692140779,1360692141419,1113523623,1113524263,640
1360692148,1113530896,13,10737,825.9230769,1360692139446,1360692140278,1113522342,1113523174,832
1360692156,1113538672,20,4280,214,1360692130582,1360692137878,1113513254,1113520550,7296
1360692156,1113538868,12,3993,332.75,1360692149456,1360692151248,1113532324,1113534116,1792
1360692160,1113542600,1,64,64,1360692133660,1360692133660,1113516260,1113516260,0
1360692160,1113542636,1,52,52,1360692134777,1360692134777,1113517413,1113517413,0
1360692164,1113546568,16,8979,561.1875,1360692136635,1360692156731,1113519203,1113539299,20096
1360692164,1113546568,15,7730,515.3333333,1360692136635,1360692155067,1113519203,1113537635,18432
1360692164,1113546572,34,41425,1218.382353,1360692136570,1360692143354,1113519142,1113525926,6784
1360692164,1113546572,91,112915,1240.824176,1360692136697,1360692150201,1113519269,1113532773,13504
1360692164,1113546708,10,3888,388.8,1360692139762,1360692141938,1113522470,1113524646,2176
1360692164,1113547020,9,1344,149.3333333,1360692154169,1360692158969,1113537189,1113541989,4800
1360692164,1113547020,28,9597,342.75,1360692158777,1360692163385,1113541797,1113546405,4608
1360692164,1113547060,16,3306,206.625,1360692156496,1360692158672,1113539556,1113541732,2176
1360692165,1113547068,6,1237,206.1666667,1360692162162,1360692163058,1113544230,1113545126,896
1360692165,1113547100,12,3993,332.75,1360692159633,1360692161681,1113541733,1113543781,2048
1360692168,1113550704,19,8644,454.9473684,1360692141044,1360692148404,1113523748,1113531108,7360
1360692172,1113554840,10,4792,479.2,1360692146286,1360692148270,1113529126,1113531110,1984
1360692172,1113554924,23,3851,167.4347826,1360692163800,1360692167512,1113546724,1113550436,3712
1360692172,1113554976,16,6808,425.5,1360692167715,1360692171043,1113550691,1113554019,3328
1360692172,1113555036,6,759,126.5,1360692157929,1360692163881,1113540965,1113546917,5952
1360692173,1113555064,13,8003,615.6153846,1360692159606,1360692165174,1113541670,1113547238,5568
1360692176,1113558656,8,4913,614.125,1360692151076,1360692151972,1113533732,1113534628,896
1360692180,1113562604,8,4241,530.125,1360692152666,1360692154266,1113535270,1113536870,1600
1360692180,1113562640,1,116,116,1360692154100,1360692154100,1113536740,1113536740,0
1360692180,1113562640,31,11364,366.5806452,1360692154163,1360692173683,1113536803,1113556323,19520
1360692180,1113562648,1,46,46,1360692154155,1360692154155,1113536803,1113536803,0
1360692180,1113562816,8,4094,511.75,1360692153795,1360692155523,1113536611,1113538339,1728
1360692180,1113562816,1,116,116,1360692153924,1360692153924,1113536740,1113536740,0
1360692180,1113562860,8,3685,460.625,1360692155224,1360692157080,1113538084,1113539940,1856
1360692180,1113562904,2,131,65.5,1360692179692,1360692179692,1113562596,1113562596,0
1360692180,1113562984,2,131,65.5,1360692172060,1360692172060,1113555044,1113555044,0
1360692180,1113563040,30,3989,132.9666667,1360692171366,1360692176422,1113554406,1113559462,5056
1360692188,1113570916,5,1084,216.8,1360692180514,1360692182946,1113563430,1113565862,2432
1360692188,1113570980,23,3572,155.3043478,1360692179937,1360692185569,1113562917,1113568549,5632
1360692192,1113574684,9,4912,545.7777778,1360692166281,1360692184329,1113548965,1113567013,18048
1360692196,1113578848,98,127998,1306.102041,1360692168996,1360692187556,1113551844,1113570404,18560
1360692197,1113579088,23,4263,185.3478261,1360692186590,1360692191966,1113568678,1113574054,5376
1360692197,1113579088,4,624,156,1360692184091,1360692188763,1113566179,1113570851,4672
1360692213,1113595076,64,60376,943.375,1360692192295,1360692210663,1113574371,1113592739,18368
1360692216,1113598696,16,6923,432.6875,1360692190715,1360692210619,1113573411,1113593315,19904
1360692216,1113598764,2,658,329,1360692188599,1360692203639,1113571363,1113586403,15040
1360692216,1113598768,4,632,158,1360692188915,1360692189491,1113571683,1113572259,576
1360692220,1113602876,37,3714,100.3783784,1360692195273,1360692219593,1113578149,1113602469,24320
1360692220,1113602960,31,4103,132.3548387,1360692209846,1360692214006,1113592806,1113596966,4160
1360692220,1113602992,11,4112,373.8181818,1360692211283,1360692217555,1113594275,1113600547,6272
1360692220,1113602992,10,4035,403.5,1360692211347,1360692217427,1113594339,1113600419,6080
1360692237,1113619092,39,4758,122,1360692215383,1360692230359,1113597475,1113612451,14976
1360692244,1113626764,1,329,329,1360692218615,1360692218615,1113601379,1113601379,0
1360692248,1113630856,28,1288,46,1360692221533,1360692229021,1113604389,1113611877,7488
1360692269,1113651076,3,486,162,1360692266215,1360692266343,1113648291,1113648419,128
1360692269,1113651160,5,1072,214.4,1360692266002,1360692266770,1113648162,1113648930,768
1360692293,1113675120,7,3878,554,1360692266170,1360692267450,1113648290,1113649570,1280
1360692321,1113703208,1,46,46,1360692295457,1360692295457,1113677665,1113677665,0
1360692397,1113779540,2,104,52,1360692395222,1360692396374,1113777762,1113778914,1152
1360692397,1113779612,2,104,52,1360692395020,1360692396428,1113777632,1113779040,1408
1360692405,1113787568,3,156,52,1360692397370,1360692400762,1113779938,1113783330,3392
1360692409,1113791204,1,52,52,1360692382437,1360692382437,1113764641,1113764641,0
1360692409,1113791344,1,64,64,1360692383962,1360692383962,1113766306,1113766306,0
1360692414,1113796384,1,46,46,1360692388145,1360692388145,1113770529,1113770529,0
1360692414,1113796572,1,52,52,1360692388531,1360692388531,1113771103,1113771103,0
1360692415,1113797364,1,52,52,1360692388742,1360692388742,1113771106,1113771106,0
1360692419,1113801176,1,52,52,1360692392448,1360692392448,1113774624,1113774624,0
1360692421,1113803304,56,78487,1401.553571,1360692393279,1360692394175,1113775583,1113776479,896
1360692421,1113803348,1,52,52,1360692394518,1360692394518,1113776866,1113776866,0
1360692421,1113803828,3,168,56,1360692414581,1360692415349,1113797409,1113798177,768
1360692421,1113803840,3,168,56,1360692415722,1360692416554,1113798562,1113799394,832
1360692425,1113807236,1,52,52,1360692399557,1360692399557,1113781793,1113781793,0
1360692425,1113807452,1,52,52,1360692398766,1360692398766,1113781218,1113781218,0
1360692441,1113823372,16,11036,689.75,1360692414779,1360692417531,1113797151,1113799903,2752
1360692445,1113827456,1,46,46,1360692417000,1360692417000,1113799456,1113799456,0
1360692445,1113827580,1,64,64,1360692417644,1360692417644,1113800224,1113800224,0
1360692445,1113827588,17,3966,233.2941176,1360692418150,1360692421158,1113800738,1113803746,3008
1360692445,1113827656,1,52,52,1360692419617,1360692419617,1113802273,1113802273,0
1360692449,1113831684,1,52,52,1360692424325,1360692424325,1113807009,1113807009,0
1360692453,1113835644,1,52,52,1360692427179,1360692427179,1113809823,1113809823,0
1360692453,1113835908,2,131,65.5,1360692446949,1360692446949,1113829857,1113829857,0
1360692457,1113839504,1,52,52,1360692429754,1360692429754,1113812258,1113812258,0
1360692477,1113859548,1,52,52,1360692450764,1360692450764,1113833312,1113833312,0
1360692533,1113916052,3,168,56,1360692530709,1360692531349,1113913761,1113914401,640
1360692534,1113916056,3,168,56,1360692532726,1360692533110,1113914782,1113915166,384
1360692534,1113916076,2,116,58,1360692533411,1360692533667,1113915487,1113915743,256
1360692541,1113923960,3,168,56,1360692533424,1360692534128,1113916384,1113917088,704
1360692541,1113923968,3,168,56,1360692534567,1360692535207,1113917535,1113918175,640
1360692549,1113931644,1,46,46,1360692522092,1360692522092,1113904736,1113904736,0
1360692553,1113935788,85,100141,1178.129412,1360692526617,1360692537561,1113909405,1113920349,10944
1360692557,1113939664,1,46,46,1360692530839,1360692530839,1113913503,1113913503,0
1360692561,1113943748,1,52,52,1360692533317,1360692533317,1113916065,1113916065,0
1360692565,1113947628,9,3463,384.7777778,1360692536890,1360692538042,1113919518,1113920670,1152
1360692565,1113947804,1,64,64,1360692538635,1360692538635,1113921439,1113921439,0
1360692574,1113956108,2,131,65.5,1360692567937,1360692567937,1113950045,1113950045,0
1360692661,1114044020,1,52,52,1360692633075,1360692633075,1114016095,1114016095,0
1360692662,1114044320,2,131,65.5,1360692658221,1360692658221,1114040541,1114040541,0
1360692666,1114048092,1,222,222,1360692639314,1360692639314,1114021406,1114021406,0
1360692794,1114176172,3,1544,514.6666667,1360692766461,1360692766973,1114148633,1114149145,512
1360692822,1114204300,1,52,52,1360692796798,1360692796798,1114179098,1114179098,0
1360692878,1114260584,1,64,64,1360692853345,1360692853345,1114235929,1114235929,0
1360692882,1114264364,17,3966,233.2941176,1360692856316,1360692859388,1114238680,1114241752,3072
1360692882,1114264524,1,52,52,1360692857500,1360692857500,1114240024,1114240024,0
1360692946,1114328468,1,46,46,1360692920084,1360692920084,1114302552,1114302552,0
1360693183,1114565248,4,271,67.75,1360693178605,1360693179437,1114560853,1114561685,832
1360693183,1114565368,3,168,56,1360693180084,1360693180468,1114562452,1114562836,384
1360693203,1114585160,1,46,46,1360693177221,1360693177221,1114559381,1114559381,0
1360693206,1114589024,1,64,64,1360693180067,1360693180067,1114563091,1114563091,0
1360693207,1114589172,22,4422,201,1360693180347,1360693184443,1114562519,1114566615,4096
1360693207,1114589212,1,52,52,1360693181778,1360693181778,1114563990,1114563990,0
1360693223,1114605340,3,168,56,1360693216018,1360693216658,1114598358,1114598998,640
1360693223,1114605384,3,168,56,1360693218149,1360693218789,1114600533,1114601173,640
1360693223,1114605432,3,168,56,1360693216883,1360693217459,1114599315,1114599891,576
1360693243,1114625232,1,46,46,1360693217980,1360693217980,1114600212,1114600212,0
1360693520,1114902444,3,219,73,1360693519333,1360693519653,1114901777,1114902097,320
1360693528,1114910528,3,168,56,1360693522831,1360693523471,1114905359,1114905999,640
1360693528,1114910560,3,168,56,1360693520238,1360693520878,1114902798,1114903438,640
1360693528,1114910568,3,168,56,1360693521769,1360693522537,1114904337,1114905105,768
1360693547,1114930008,17,3966,233.2941176,1360693522031,1360693524911,1114905039,1114907919,2880
1360693547,1114930016,1,52,52,1360693519399,1360693519399,1114902415,1114902415,0
1360693547,1114930064,1,46,46,1360693520695,1360693520695,1114903759,1114903759,0
1360693551,1114933916,1,64,64,1360693523532,1360693523532,1114906448,1114906448,0
1360693551,1114933916,1,52,52,1360693523595,1360693523595,1114906511,1114906511,0
1360709665,1131047172,3,152,50.66666667,1360709640061,1360709649021,1131022233,1131031193,8960
1360709665,1131047260,3,152,50.66666667,1360709638823,1360709647847,1131021083,1131030107,9024
1360709668,1131050996,3,152,50.66666667,1360709640325,1360709649349,1131023321,1131032345,9024
1360709668,1131050996,3,152,50.66666667,1360709640325,1360709649349,1131023321,1131032345,9024
1360709673,1131055040,5,230,46,1360709646658,1360709666882,1131028698,1131048922,20224
1360709713,1131095512,3,138,46,1360709688299,1360709698859,1131070811,1131081371,10560
1360709753,1131135324,1,46,46,1360709726374,1360709726374,1131108698,1131108698,0
1360709753,1131135324,1,46,46,1360709726374,1360709726374,1131108698,1131108698,0
1360709753,1131135448,1,46,46,1360709726248,1360709726248,1131108696,1131108696,0
1360709753,1131135448,1,46,46,1360709726248,1360709726248,1131108696,1131108696,0
1360709753,1131135504,1,46,46,1360709728497,1360709728497,1131111001,1131111001,0
1360709781,1131163464,3,192,64,1360709755288,1360709757784,1131137752,1131140248,2496
1360709785,1131167404,1,64,64,1360709757271,1360709757271,1131139675,1131139675,0
1360709986,1131368172,4,184,46,1360709961404,1360709984700,1131343576,1131366872,23296
1360710018,1131400300,1,46,46,1360709991033,1360709991033,1131373333,1131373333,0
1360710026,1131408192,2,96,48,1360709999015,1360710001959,1131381207,1131384151,2944
1360710026,1131408220,3,144,48,1360710000072,1360710009032,1131382292,1131391252,8960
1360710026,1131408224,3,144,48,1360710000071,1360710009031,1131382295,1131391255,8960
1360710026,1131408296,2,96,48,1360709997823,1360710000767,1131380119,1131383063,2944
1360710030,1131412360,1,60,60,1360710003006,1360710003006,1131385366,1131385366,0
1360710030,1131412392,1,60,60,1360710004252,1360710004252,1131386644,1131386644,0
1360710046,1131428428,3,152,50.66666667,1360710020600,1360710029624,1131403028,1131412052,9024
1360710070,1131452200,1,52,52,1360710042654,1360710042654,1131424854,1131424854,0
1360710078,1131460472,3,152,50.66666667,1360710052492,1360710061516,1131434964,1131443988,9024
1360710082,1131464192,3,152,50.66666667,1360710053860,1360710062884,1131436052,1131445076,9024
1360710082,1131464212,3,152,50.66666667,1360710054994,1360710063954,1131437206,1131446166,8960
1360710082,1131464328,3,152,50.66666667,1360710054876,1360710063900,1131437204,1131446228,9024
1360710234,1131616556,1,46,46,1360710205877,1360710205877,1131588433,1131588433,0
1360710362,1131744640,6,384,64,1360710335650,1360710341218,1131718290,1131723858,5568
1360710362,1131744776,5,320,64,1360710336602,1360710341082,1131719378,1131723858,4480
1360710366,1131748644,5,320,64,1360710337883,1360710342299,1131720527,1131724943,4416
1360710366,1131748752,4,256,64,1360710337775,1360710341103,1131720527,1131723855,3328
1360710406,1131788792,1,46,46,1360710380552,1360710380552,1131763344,1131763344,0
1360710410,1131792696,3,152,50.66666667,1360710383911,1360710392935,1131766607,1131775631,9024
1360710410,1131792728,3,152,50.66666667,1360710384967,1360710393991,1131767695,1131776719,9024
1360710414,1131796628,3,152,50.66666667,1360710386218,1360710395178,1131768846,1131777806,8960
1360710414,1131796724,3,152,50.66666667,1360710386125,1360710395149,1131768849,1131777873,9024
1360710547,1131929076,2,96,48,1360710521232,1360710524304,1131903308,1131906380,3072
1360710547,1131929244,2,96,48,1360710522155,1360710525099,1131904399,1131907343,2944
1360710551,1131933004,2,96,48,1360710523546,1360710526426,1131905550,1131908430,2880
1360710551,1131933124,2,96,48,1360710523425,1360710526305,1131905549,1131908429,2880
1360710571,1131953036,2,104,52,1360710543416,1360710546424,1131925452,1131928460,3008
1360710571,1131953112,2,104,52,1360710545519,1360710548527,1131927631,1131930639,3008
1360710571,1131953196,2,104,52,1360710544347,1360710547355,1131926543,1131929551,3008
1360710571,1131953228,2,104,52,1360710545400,1360710548408,1131927628,1131930636,3008
1360710639,1132021196,1,46,46,1360710611672,1360710611672,1131993868,1131993868,0
1360710879,1132261948,6,384,64,1360710852772,1360710857956,1132235720,1132240904,5184
1360710879,1132261984,5,320,64,1360710853953,1360710858113,1132236937,1132241097,4160
1360710880,1132262088,6,384,64,1360710852480,1360710857664,1132234568,1132239752,5184
1360710880,1132262164,5,320,64,1360710854707,1360710858867,1132236871,1132241031,4160
1360710955,1132338048,6,384,64,1360710928446,1360710932158,1132311494,1132315206,3712
1360710956,1132338128,5,320,64,1360710931607,1360710934487,1132313735,1132316615,2880
1360710956,1132338212,6,384,64,1360710930755,1360710934083,1132312967,1132316295,3328
1360710959,1132342080,2,120,60,1360710932065,1360710935073,1132315145,1132318153,3008
1360710967,1132350048,1,60,60,1360710941120,1360710941120,1132324168,1132324168,0
1360710980,1132362136,1,60,60,1360710954000,1360710954000,1132336136,1132336136,0
1360711004,1132386048,1,60,60,1360710978086,1360710978086,1132360134,1132360134,0
1360711052,1132434264,1,60,60,1360711025872,1360711025872,1132408136,1132408136,0
1360711145,1132527120,1,46,46,1360711118749,1360711118749,1132500869,1132500869,0
1360711296,1132678384,6,384,64,1360711268562,1360711274002,1132650946,1132656386,5440
1360711296,1132678424,6,384,64,1360711269612,1360711275116,1132652036,1132657540,5504
1360711296,1132678456,5,320,64,1360711270730,1360711275082,1132653186,1132657538,4352
1360711296,1132678456,1,64,64,1360711270729,1360711270729,1132653185,1132653185,0
1360711304,1132686576,1,46,46,1360711279186,1360711279186,1132661762,1132661762,0
1360711324,1132706656,3,144,48,1360711296131,1360711305091,1132678787,1132687747,8960
1360711324,1132706676,3,144,48,1360711297196,1360711306156,1132679872,1132688832,8960
1360711324,1132706692,3,144,48,1360711298268,1360711307228,1132680960,1132689920,8960
1360711324,1132706816,3,144,48,1360711298211,1360711307107,1132681027,1132689923,8896
1360711609,1132991380,3,168,56,1360711583955,1360711592787,1132966335,1132975167,8832
1360711613,1132995180,3,168,56,1360711585179,1360711594139,1132967359,1132976319,8960
1360711613,1132995180,3,168,56,1360711585178,1360711594202,1132967358,1132976382,9024
1360711613,1132995292,3,168,56,1360711585068,1360711594092,1132967360,1132976384,9024
1360711958,1133340560,1,46,46,1360711933783,1360711933783,1133316343,1133316343,0
1360712030,1133412612,2,120,60,1360712002850,1360712007842,1133385462,1133390454,4992
1360712030,1133412812,2,120,60,1360712005659,1360712009115,1133388471,1133391927,3456
1360712275,1133657676,3,152,50.66666667,1360712249054,1360712258142,1133631730,1133640818,9088
1360712279,1133661628,3,152,50.66666667,1360712250767,1360712259727,1133633395,1133642355,8960
1360712467,1133849944,3,152,50.66666667,1360712442001,1360712451025,1133824945,1133833969,9024
1360712471,1133853908,2,100,50,1360712443893,1360712449909,1133826801,1133832817,6016
1360712471,1133854000,3,152,50.66666667,1360712443035,1360712452059,1133826035,1133835059,9024
1360712471,1133854000,3,152,50.66666667,1360712443034,1360712452058,1133826034,1133835058,9024
1360712620,1134002196,3,138,46,1360712594299,1360712603963,1133976495,1133986159,9664
1360712652,1134034128,1,46,46,1360712624127,1360712624127,1134006255,1134006255,0
1360712941,1134323052,4,220,55,1360712935623,1360712939463,1134317675,1134321515,3840
1360712949,1134331004,8,870,108.75,1360712937012,1360712948404,1134319016,1134330408,11392
1360712968,1134350980,1,46,46,1360712943334,1360712943334,1134326314,1134326314,0
1360712972,1134354828,20,5815,290.75,1360712947647,1360712959167,1134330475,1134341995,11520
1360712984,1134366824,1,64,64,1360712956673,1360712956673,1134339497,1134339497,0
1360713013,1134395196,4,630,157.5,1360713008373,1360713009461,1134390569,1134391657,1088
1360713021,1134403036,3,168,56,1360713013141,1360713013653,1134395177,1134395689,512
1360713029,1134411108,3,168,56,1360713025740,1360713026700,1134407848,1134408808,960
1360713040,1134422884,1,64,64,1360713013061,1360713013061,1134395945,1134395945,0
1360713045,1134427132,4,283,70.75,1360713039605,1360713043893,1134421737,1134426025,4288
1360713045,1134427204,3,156,52,1360713026925,1360713038381,1134409129,1134420585,11456
1360713053,1134435144,4,228,57,1360713034281,1360713048681,1134416425,1134430825,14400
1360713060,1134442804,4,228,57,1360713033619,1360713057875,1134416423,1134440679,24256
1360713060,1134442924,4,228,57,1360713033502,1360713058142,1134416426,1134441066,24640
1360713061,1134443264,3,180,60,1360713054322,1360713059506,1134436586,1134441770,5184
1360713077,1134459356,7,4732,676,1360713051732,1360713056532,1134434088,1134438888,4800
1360713081,1134463096,1,46,46,1360713054486,1360713054486,1134436582,1134436582,0
1360713085,1134467200,6,4597,766.1666667,1360713059310,1360713080302,1134441510,1134462502,20992
1360713085,1134467408,3,150,50,1360713061345,1360713079329,1134443753,1134461737,17984
1360713085,1134467416,1260,1885175,1496.170635,1360713034007,1360713080023,1134416423,1134462439,46016
1360713085,1134467524,3,168,56,1360713079978,1360713080426,1134462502,1134462950,448
1360713097,1134479072,1,46,46,1360713069041,1360713069041,1134451113,1134451113,0
1360713097,1134479092,1,46,46,1360713070109,1360713070109,1134452201,1134452201,0
1360713101,1134483128,1,52,52,1360713075192,1360713075192,1134457320,1134457320,0
1360713105,1134487280,1,46,46,1360713080161,1360713080161,1134462441,1134462441,0
1360713129,1134511288,9,7659,851,1360713101144,1360713119704,1134483432,1134501992,18560
1360713133,1134515416,1,46,46,1360713106904,1360713106904,1134489320,1134489320,0
1360713141,1134523528,3,222,74,1360713134696,1360713134696,1134517224,1134517224,0
1360713141,1134523564,30,33973,1132.433333,1360713131010,1360713138178,1134513574,1134520742,7168
1360713141,1134523568,4,630,157.5,1360713139713,1360713140609,1134522281,1134523177,896
1360713149,1134531340,1,46,46,1360713124258,1360713124258,1134506598,1134506598,0
1360713149,1134531428,1,46,46,1360713123211,1360713123211,1134505639,1134505639,0
1360713149,1134531508,45,61883,1375.177778,1360713141305,1360713146553,1134523813,1134529061,5248
1360713149,1134531556,5,1713,342.6,1360713140236,1360713141260,1134522792,1134523816,1024
1360713149,1134531596,42,57383,1366.261905,1360713138532,1360713141092,1134521128,1134523688,2560
1360713157,1134539228,11,3622,329.2727273,1360713130131,1360713139603,1134512359,1134521831,9472
1360713157,1134539284,4,1699,424.75,1360713132377,1360713133337,1134514661,1134515621,960
1360713157,1134539540,3,168,56,1360713139226,1360713151322,1134521766,1134533862,12096
1360713161,1134543308,1,46,46,1360713136131,1360713136131,1134518439,1134518439,0
1360713165,1134547268,15,17652,1176.8,1360713139497,1360713140649,1134521765,1134522917,1152
1360713165,1134547268,2,1535,767.5,1360713139497,1360713140649,1134521765,1134522917,1152
1360713165,1134547452,3,2290,763.3333333,1360713139313,1360713140465,1134521765,1134522917,1152
1360713181,1134563556,7,5327,761,1360713177932,1360713178636,1134560488,1134561192,704
1360713181,1134563588,5,533,106.6,1360713179819,1360713180523,1134562407,1134563111,704
1360713189,1134571600,18,20200,1122.222222,1360713180832,1360713181536,1134563432,1134564136,704
1360713197,1134579560,5,274,54.8,1360713180933,1360713193669,1134563493,1134576229,12736
1360713197,1134579560,6,338,56.33333333,1360713180932,1360713193668,1134563492,1134576228,12736
1360713197,1134579572,3,351,117,1360713177913,1360713189753,1134560485,1134572325,11840
1360713197,1134579572,4,590,147.5,1360713177912,1360713190264,1134560484,1134572836,12352
1360713197,1134579572,6,3326,554.3333333,1360713190648,1360713192376,1134573220,1134574948,1728
1360713197,1134579612,8,436,54.5,1360713180881,1360713193681,1134563493,1134576293,12800
1360713197,1134579644,3,351,117,1360713177842,1360713189810,1134560486,1134572454,11968
1360713197,1134579648,4,232,58,1360713178668,1360713189804,1134561316,1134572452,11136
1360713205,1134587288,13,12538,964.4615385,1360713177684,1360713190420,1134559972,1134572708,12736
1360713205,1134587332,1,556,556,1360713178984,1360713178984,1134561316,1134561316,0
1360713205,1134587416,1,435,435,1360713177941,1360713177941,1134560357,1134560357,0
1360713205,1134587448,6,6014,1002.333333,1360713178869,1360713185269,1134561317,1134567717,6400
1360713205,1134587448,1,549,549,1360713178869,1360713178869,1134561317,1134561317,0
1360713205,1134587480,1,52,52,1360713179542,1360713179542,1134562022,1134562022,0
1360713209,1134591364,1,60,60,1360713184009,1360713184009,1134566373,1134566373,0
1360713209,1134591480,7,6599,942.7142857,1360713183893,1360713184597,1134566373,1134567077,704
1360713209,1134591484,1,60,60,1360713183890,1360713183890,1134566374,1134566374,0
1360713209,1134591484,1,60,60,1360713183890,1360713183890,1134566374,1134566374,0
1360713213,1134595276,7,6099,871.2857143,1360713184930,1360713185378,1134567206,1134567654,448
1360713213,1134595276,1,60,60,1360713184930,1360713184930,1134567206,1134567206,0
1360713213,1134595276,3,862,287.3333333,1360713184930,1360713186530,1134567206,1134568806,1600
1360713213,1134595372,3,1384,461.3333333,1360713184832,1360713185280,1134567204,1134567652,448
1360713213,1134595436,9,9176,1019.555556,1360713186432,1360713193664,1134568868,1134576100,7232
1360713217,1134599464,1,60,60,1360713190821,1360713190821,1134573285,1134573285,0
1360713221,1134603284,1,60,60,1360713193755,1360713193755,1134576039,1134576039,0
1360713221,1134603284,1,60,60,1360713193755,1360713193755,1134576039,1134576039,0
1360713221,1134603364,1,46,46,1360713196555,1360713196555,1134578919,1134578919,0
1360713221,1134603400,1,60,60,1360713193636,1360713193636,1134576036,1134576036,0
1360713225,1134607572,1,46,46,1360713199928,1360713199928,1134582500,1134582500,0
1360713253,1134635812,2,104,52,1360713245706,1360713245898,1134628518,1134628710,192
1360713253,1134635816,2,104,52,1360713246150,1360713246150,1134628966,1134628966,0
1360713253,1134635816,3,156,52,1360713246341,1360713248133,1134629157,1134630949,1792
1360713253,1134635896,2,104,52,1360713247027,1360713247667,1134629923,1134630563,640
1360713253,1134635900,3,530,176.6666667,1360713249842,1360713252082,1134632742,1134634982,2240
1360713253,1134635936,2,291,145.5,1360713252238,1360713252238,1134635174,1134635174,0
1360713261,1134643960,4,220,55,1360713256243,1360713260019,1134639203,1134642979,3776
1360713269,1134651636,1,46,46,1360713243897,1360713243897,1134626533,1134626533,0
1360713269,1134651812,1,46,46,1360713243784,1360713243784,1134626596,1134626596,0
1360713269,1134651968,2,291,145.5,1360713263083,1360713263211,1134646051,1134646179,128
1360713270,1134652004,2,478,239,1360713257394,1360713266290,1134639398,1134648294,8896
1360713273,1134655680,1,52,52,1360713245837,1360713245837,1134628517,1134628517,0
1360713273,1134655760,1,46,46,1360713248318,1360713248318,1134631078,1134631078,0
1360713281,1134663656,1,239,239,1360713253412,1360713253412,1134636068,1134636068,0
1360713285,1134667620,1,285,285,1360713258375,1360713258375,1134640995,1134640995,0
1360713285,1134667804,2,131,65.5,1360713258832,1360713258832,1134641636,1134641636,0
1360713285,1134667844,22,4282,194.6363636,1360713260135,1360713267879,1134642979,1134650723,7744
1360713285,1134667848,1,64,64,1360713260388,1360713260388,1134643236,1134643236,0
1360713293,1134675816,1,52,52,1360713264964,1360713264964,1134647780,1134647780,0
1360713293,1134675980,3,150,50,1360713291103,1360713291743,1134674083,1134674723,640
1360713317,1134699736,1,52,52,1360713291346,1360713291346,1134674082,1134674082,0
1360713317,1134699856,1,52,52,1360713291230,1360713291230,1134674086,1134674086,0
1360713317,1134699988,4,220,55,1360713313240,1360713313944,1134696228,1134696932,704
1360713318,1134700028,3,168,56,1360713313048,1360713313880,1134695076,1134695908,832
1360713325,1134707984,2,116,58,1360713324762,1360713324826,1134707746,1134707810,64
1360713326,1134708064,2,104,52,1360713319284,1360713320372,1134701348,1134702436,1088
1360713326,1134708072,2,110,55,1360713315628,1360713325740,1134697700,1134707812,10112
1360713334,1134716028,4,208,52,1360713326102,1360713327574,1134708130,1134709602,1472
1360713341,1134723832,1,46,46,1360713314227,1360713314227,1134697059,1134697059,0
1360713341,1134723844,18,4220,234.4444444,1360713314922,1360713322858,1134697766,1134705702,7936
1360713350,1134732648,3,168,56,1360713342955,1360713343531,1134725603,1134726179,576
1360713350,1134732656,3,168,56,1360713343842,1360713344418,1134726498,1134727074,576
1360713350,1134732680,4,220,55,1360713344716,1360713345420,1134727396,1134728100,704
1360713366,1134748064,2,110,55,1360713346291,1360713362803,1134728355,1134744867,16512
1360713373,1134755804,1,239,239,1360713345680,1360713345680,1134728484,1134728484,0
1360713438,1134820404,7,1490,212.8571429,1360713429471,1360713430751,1134811875,1134813155,1280
1360713438,1134820416,5,3824,764.8,1360713430800,1360713431248,1134813216,1134813664,448
1360713438,1134820456,8,2341,292.625,1360713429420,1360713430700,1134811876,1134813156,1280
1360713438,1134820492,44,61357,1394.477273,1360713430727,1360713431175,1134813219,1134813667,448
1360713442,1134824032,1,485,485,1360713414097,1360713414097,1134796129,1134796129,0
1360713446,1134828456,5,346,69.2,1360713436906,1360713439082,1134819362,1134821538,2176
1360713450,1134832232,1,52,52,1360713425419,1360713425419,1134807651,1134807651,0
1360713450,1134832232,1,52,52,1360713425418,1360713425418,1134807650,1134807650,0
1360713454,1134836264,6,838,139.6666667,1360713426218,1360713441770,1134808482,1134824034,15552
1360713478,1134860300,2,505,252.5,1360713452039,1360713476487,1134834339,1134858787,24448
1360713494,1134876072,644,963112,1495.515528,1360713181418,1360713193258,1134563490,1134575330,11840
1360713502,1134884456,2,110,55,1360713487274,1360713497322,1134869730,1134879778,10048
1360713514,1134896256,1,46,46,1360713486130,1360713486130,1134868386,1134868386,0
1360713526,1134908440,737,80503,109.2306649,1360713441720,1360713521464,1134824160,1134903904,79744
1360713538,1134920532,9,3463,384.7777778,1360713509723,1360713510235,1134892255,1134892767,512
1360713554,1134936484,1,52,52,1360713527755,1360713527755,1134910239,1134910239,0
1360713554,1134936612,1,82,82,1360713528205,1360713528205,1134910817,1134910817,0
1360713630,1135012872,2,131,65.5,1360713629703,1360713629703,1135012575,1135012575,0
1360713639,1135021032,1023,114873,112.2903226,1360713528975,1360713634319,1134911007,1135016351,105344
1360713666,1135048660,1,80,80,1360713639900,1360713639900,1135022560,1135022560,0
1360713666,1135048780,1,52,52,1360713639203,1360713639203,1135021983,1135021983,0
1360713694,1135076868,2,337,168.5,1360713665996,1360713692108,1135048864,1135074976,26112
1360713695,1135077340,6,388,64.66666667,1360713694235,1360713694491,1135076575,1135076831,256
1360713715,1135097056,1,64,64,1360713689143,1360713689143,1135071199,1135071199,0
1360713718,1135100880,19,4503,237,1360713690559,1360713698047,1135073439,1135080927,7488
1360713759,1135141104,3,240,80,1360713730948,1360713735492,1135113052,1135117596,4544
1360713766,1135148976,1,46,46,1360713740063,1360713740063,1135123039,1135123039,0
1360713831,1135213212,4,674,168.5,1360713806488,1360713829144,1135188700,1135211356,22656
1360713839,1135221264,7,2757,393.8571429,1360713813605,1360713813861,1135195869,1135196125,256
1360713859,1135241416,43,29641,689.3255814,1360713834508,1360713856716,1135216924,1135239132,22208
1360713859,1135241440,1,46,46,1360713830838,1360713830838,1135213278,1135213278,0
1360713863,1135245480,7,3306,472.2857143,1360713834893,1360713835405,1135217373,1135217885,512
1360713863,1135245648,12,7695,641.25,1360713861859,1360713862243,1135244507,1135244891,384
1360713863,1135245648,8,3722,465.25,1360713861987,1360713862563,1135244635,1135245211,576
1360713875,1135257456,10,2427,242.7,1360713847973,1360713860197,1135230429,1135242653,12224
1360713879,1135261736,2,112,56,1360713860684,1360713870796,1135243420,1135253532,10112
1360713879,1135261736,2,112,56,1360713860748,1360713871308,1135243484,1135254044,10560
1360713879,1135261740,2,98,49,1360713861897,1360713872265,1135244637,1135255005,10368
1360713879,1135261740,2,98,49,1360713861897,1360713872265,1135244637,1135255005,10368
1360713879,1135261740,2,98,49,1360713862150,1360713872326,1135244890,1135255066,10176
1360713879,1135261812,2,112,56,1360713860608,1360713870720,1135243420,1135253532,10112
1360713879,1135261820,2,98,49,1360713861818,1360713872186,1135244638,1135255006,10368
1360713883,1135265580,9,3463,384.7777778,1360713858408,1360713858920,1135240988,1135241500,512
1360713887,1135269432,4,675,168.75,1360713862203,1360713862523,1135244635,1135244955,320
1360713887,1135269436,4,537,134.25,1360713862457,1360713862521,1135244893,1135244957,64
1360713887,1135269604,20,16946,847.3,1360713862033,1360713863569,1135244637,1135246173,1536
1360713887,1135269656,2,112,56,1360713863772,1360713880540,1135246428,1135263196,16768
1360713887,1135269656,2,112,56,1360713863772,1360713880540,1135246428,1135263196,16768
1360713887,1135269728,2,112,56,1360713863700,1360713880468,1135246428,1135263196,16768
1360713887,1135269732,6,502,83.66666667,1360713864399,1360713884431,1135247131,1135267163,20032
1360713891,1135273424,16,5622,351.375,1360713865027,1360713868163,1135247451,1135250587,3136
1360713891,1135273512,4,496,124,1360713863915,1360713871531,1135246427,1135254043,7616
1360713895,1135277588,4,537,134.25,1360713868446,1360713868510,1135251034,1135251098,64
1360713895,1135277592,3,485,161.6666667,1360713868572,1360713868636,1135251164,1135251228,64
1360713895,1135277708,2,112,56,1360713872231,1360713890791,1135254939,1135273499,18560
1360713895,1135277740,4,272,68,1360713892550,1360713892678,1135275290,1135275418,128
1360713895,1135277784,2,112,56,1360713871578,1360713890714,1135254362,1135273498,19136
1360713895,1135277788,2,112,56,1360713872152,1360713890712,1135254940,1135273500,18560
1360713895,1135277788,2,112,56,1360713872152,1360713890712,1135254940,1135273500,18560
1360713899,1135281372,4,1669,417.25,1360713871992,1360713872440,1135254364,1135254812,448
1360713899,1135281372,19,23367,1229.842105,1360713871992,1360713872440,1135254364,1135254812,448
1360713899,1135281372,12,14015,1167.916667,1360713871992,1360713872504,1135254364,1135254876,512
1360713899,1135281388,10,10916,1091.6,1360713871975,1360713872551,1135254363,1135254939,576
1360713899,1135281388,9,9991,1110.111111,1360713871975,1360713872423,1135254363,1135254811,448
1360713899,1135281388,13,15958,1227.538462,1360713871975,1360713872487,1135254363,1135254875,512
1360713899,1135281388,28,35681,1274.321429,1360713871976,1360713872744,1135254364,1135255132,768
1360713899,1135281396,9,10043,1115.888889,1360713872481,1360713872545,1135254877,1135254941,64
1360713899,1135281396,15,17031,1135.4,1360713872481,1360713872737,1135254877,1135255133,256
1360713899,1135281396,5,3976,795.2,1360713872480,1360713872608,1135254876,1135255004,128
1360713899,1135281396,10,11534,1153.4,1360713872479,1360713872735,1135254875,1135255131,256
1360713899,1135281448,1,283,283,1360713874348,1360713874348,1135256796,1135256796,0
1360713899,1135281492,11,12630,1148.181818,1360713871871,1360713872447,1135254363,1135254939,576
1360713899,1135281492,9,9572,1063.555556,1360713871871,1360713872447,1135254363,1135254939,576
1360713899,1135281512,16,18993,1187.0625,1360713871850,1360713872426,1135254362,1135254938,576
1360713899,1135281512,17,20982,1234.235294,1360713871850,1360713872298,1135254362,1135254810,448
1360713899,1135281512,21,26076,1241.714286,1360713871850,1360713872618,1135254362,1135255130,768
1360713899,1135281512,23,27671,1203.086957,1360713871850,1360713872682,1135254362,1135255194,832
1360713899,1135281512,9,9124,1013.777778,1360713871851,1360713872363,1135254363,1135254875,512
1360713899,1135281512,20,26098,1304.9,1360713871851,1360713872619,1135254363,1135255131,768
1360713899,1135281512,1,46,46,1360713871915,1360713871915,1135254427,1135254427,0
1360713899,1135281520,14,14823,1058.785714,1360713872356,1360713872676,1135254876,1135255196,320
1360713903,1135285824,4,272,68,1360713896755,1360713896883,1135279579,1135279707,128
1360713915,1135297416,2,551,275.5,1360713889355,1360713889355,1135271771,1135271771,0
1360713919,1135301652,1,52,52,1360713894558,1360713894558,1135277210,1135277210,0
1360713927,1135309720,2,112,56,1360713909917,1360713921117,1135292637,1135303837,11200
1360713927,1135309720,2,112,56,1360713909917,1360713921117,1135292637,1135303837,11200
1360713927,1135309796,2,112,56,1360713909840,1360713921040,1135292636,1135303836,11200
1360713931,1135313500,15,3790,252.6666667,1360713903225,1360713909241,1135285725,1135291741,6016
1360713935,1135317392,4,537,134.25,1360713907747,1360713907811,1135290139,1135290203,64
1360713935,1135317416,4,537,134.25,1360713907917,1360713907981,1135290333,1135290397,64
1360713935,1135317464,17,20704,1217.882353,1360713909597,1360713910493,1135292061,1135292957,896
1360713935,1135317464,15,18435,1229,1360713909597,1360713910237,1135292061,1135292701,640
1360713935,1135317464,12,14601,1216.75,1360713909660,1360713910108,1135292124,1135292572,448
1360713935,1135317468,11,13250,1204.545455,1360713910038,1360713910166,1135292506,1135292634,128
1360713935,1135317472,10,13287,1328.7,1360713910037,1360713910101,1135292509,1135292573,64
1360713935,1135317472,3,3276,1092,1360713910101,1360713910101,1135292573,1135292573,0
1360713935,1135317472,8,10557,1319.625,1360713910100,1360713910292,1135292572,1135292764,192
1360713935,1135317472,5,4528,905.6,1360713910100,1360713910164,1135292572,1135292636,64
1360713935,1135317472,8,10596,1324.5,1360713910164,1360713910164,1135292636,1135292636,0
1360713935,1135317472,8,11099,1387.375,1360713910099,1360713910163,1135292571,1135292635,64
1360713935,1135317472,9,12252,1361.333333,1360713910099,1360713910291,1135292571,1135292763,192
1360713935,1135317472,5,4748,949.6,1360713910099,1360713910163,1135292571,1135292635,64
1360713935,1135317472,7,7536,1076.571429,1360713910163,1360713910163,1135292635,1135292635,0
1360713935,1135317580,2,824,412,1360713908967,1360713908967,1135291547,1135291547,0
1360713935,1135317596,19,26854,1413.368421,1360713909593,1360713909977,1135292189,1135292573,384
1360713935,1135317596,10,11422,1142.2,1360713909911,1360713910039,1135292507,1135292635,128
1360713935,1135317596,9,10498,1166.444444,1360713909911,1360713910103,1135292507,1135292699,192
1360713935,1135317596,5,3713,742.6,1360713909974,1360713910102,1135292570,1135292698,128
1360713935,1135317596,10,14369,1436.9,1360713909974,1360713909974,1135292570,1135292570,0
1360713935,1135317616,4,3804,951,1360713910018,1360713910018,1135292634,1135292634,0
1360713935,1135317620,18,23388,1299.333333,1360713909888,1360713910080,1135292508,1135292700,192
1360713935,1135317620,2,1468,734,1360713909951,1360713910015,1135292571,1135292635,64
1360713935,1135317620,15,19897,1326.466667,1360713909951,1360713910143,1135292571,1135292763,192
1360713935,1135317620,8,11112,1389,1360713909951,1360713910015,1135292571,1135292635,64
1360713951,1135333796,416,554093,1331.954327,1360713860624,1360713948112,1135243420,1135330908,87488
1360713954,4068616676,5,983,196.6,1360713948457,1360713948713,4068611133,4068611389,256
1360713954,4068616684,6,3041,506.8333333,1360713948449,1360713948641,4068611133,4068611325,192
1360713962,4068624680,2,112,56,1360713948451,1360713961251,4068611131,4068623931,12800
1360713962,4068624680,2,112,56,1360713948515,1360713961251,4068611195,4068623931,12736
1360713962,4068624688,2,112,56,1360713948443,1360713961243,4068611131,4068623931,12800
1360713967,1135349480,3,408,136,1360713940042,1360713946122,1135322522,1135328602,6080
1360713967,1135349796,4,414,103.5,1360713948111,1360713965519,1135330907,1135348315,17408
1360713967,1135349820,3,296,98.66666667,1360713952824,1360713965496,1135335644,1135348316,12672
1360713967,1135349868,9,1082,120.2222222,1360713948038,1360713965446,1135330906,1135348314,17408
1360713967,1135349868,3,164,54.66666667,1360713948038,1360713961030,1135330906,1135343898,12992
1360713967,1135349904,128,178643,1395.648438,1360713860708,1360713965412,1135243612,1135348316,104704
1360713975,1135357480,6,1601,266.8333333,1360713948489,1360713951625,1135330969,1135334105,3136
1360713975,1135357516,2,469,234.5,1360713950181,1360713958501,1135332697,1135341017,8320
1360713975,1135357828,2,112,56,1360713967662,1360713972846,1135350490,1135355674,5184
1360713975,1135357908,3,164,54.66666667,1360713967584,1360713972768,1135350492,1135355676,5184
1360713975,1135357908,11,1384,125.8181818,1360713967584,1360713972768,1135350492,1135355676,5184
1360713975,1135357908,2,112,56,1360713967584,1360713972768,1135350492,1135355676,5184
1360713979,1135361468,4,537,134.25,1360713951701,1360713951765,1135334169,1135334233,64
1360713979,1135361648,13,6944,534.1538462,1360713953314,1360713954978,1135335962,1135337626,1664
1360713983,1135365812,2,131,65.5,1360713978495,1360713978495,1135361307,1135361307,0
1360713991,1135373524,1,52,52,1360713965790,1360713965790,1135348314,1135348314,0
1360713991,1135373524,1,52,52,1360713965790,1360713965790,1135348314,1135348314,0
1360713991,1135373524,1,52,52,1360713965790,1360713965790,1135348314,1135348314,0
1360713991,1135373524,1,52,52,1360713965790,1360713965790,1135348314,1135348314,0
1360713991,1135373524,1,52,52,1360713965790,1360713965790,1135348314,1135348314,0
1360713991,1135373528,1,46,46,1360713965976,1360713965976,1135348504,1135348504,0
1360713991,1135373528,1,52,52,1360713965787,1360713965787,1135348315,1135348315,0
1360713991,1135373528,1,52,52,1360713965787,1360713965787,1135348315,1135348315,0
1360713991,1135373528,1,52,52,1360713965787,1360713965787,1135348315,1135348315,0
1360713991,1135373528,1,52,52,1360713965787,1360713965787,1135348315,1135348315,0
1360713991,1135373528,1,52,52,1360713965787,1360713965787,1135348315,1135348315,0
1360713991,1135373528,1,52,52,1360713965787,1360713965787,1135348315,1135348315,0
1360713991,1135373652,1,52,52,1360713965660,1360713965660,1135348312,1135348312,0
1360713991,1135373652,1,52,52,1360713965660,1360713965660,1135348312,1135348312,0
1360713991,1135373652,1,52,52,1360713965660,1360713965660,1135348312,1135348312,0
1360713991,1135373652,1,52,52,1360713965660,1360713965660,1135348312,1135348312,0
1360713991,1135373652,1,52,52,1360713965663,1360713965663,1135348315,1135348315,0
1360713991,1135373652,1,52,52,1360713965663,1360713965663,1135348315,1135348315,0
1360713991,1135373652,1,52,52,1360713965663,1360713965663,1135348315,1135348315,0
1360713991,1135373652,1,52,52,1360713965663,1360713965663,1135348315,1135348315,0
1360713991,1135373652,1,52,52,1360713965663,1360713965663,1135348315,1135348315,0
1360713991,1135373652,1,52,52,1360713965663,1360713965663,1135348315,1135348315,0
1360713991,1135373652,1,52,52,1360713965663,1360713965663,1135348315,1135348315,0
1360713991,1135373652,1,52,52,1360713965663,1360713965663,1135348315,1135348315,0
1360713991,1135373652,1,52,52,1360713965663,1360713965663,1135348315,1135348315,0
1360713999,1135381468,4,537,134.25,1360713971094,1360713971158,1135353562,1135353626,64
1360713999,1135381584,4,537,134.25,1360713970849,1360713970913,1135353433,1135353497,64
1360714003,1135385476,157,18464,117.6050955,1360713641103,1360713699215,1135023579,1135081691,58112
1360714008,1135390104,3,168,56,1360714001088,1360714001216,1135383192,1135383320,128
1360714008,1135390108,3,168,56,1360714001279,1360714001407,1135383387,1135383515,128
1360714008,1135390108,3,168,56,1360714001533,1360714001661,1135383641,1135383769,128
1360714008,1135390184,3,168,56,1360714000882,1360714000946,1135383066,1135383130,64
1360714008,1135390188,3,168,56,1360714001327,1360714001391,1135383515,1135383579,64
1360714015,1135397864,3,168,56,1360714010954,1360714011018,1135393818,1135393882,64
1360714015,1135397864,4,271,67.75,1360714011081,1360714011209,1135393945,1135394073,128
1360714015,1135397896,2,110,55,1360714000873,1360714010921,1135383769,1135393817,10048
1360714015,1135397912,4,271,67.75,1360714014171,1360714014235,1135397083,1135397147,64
1360714027,1135409572,19,4741,249.5263158,1360714002351,1360714009583,1135384923,1135392155,7232
1360714027,1135409648,1,46,46,1360714000675,1360714000675,1135383323,1135383323,0
1360714031,1135413700,1,52,52,1360714002797,1360714002797,1135385497,1135385497,0
1360714031,1135413748,7,3527,503.8571429,1360714004158,1360714005118,1135386906,1135387866,960
1360714039,1135421496,63,67920,1078.095238,1360714012026,1360714035450,1135394522,1135417946,23424
1360714039,1135421520,7,4247,606.7142857,1360714012448,1360714012832,1135394968,1135395352,384
1360714063,1135445500,57,11306,198.3508772,1360714035508,1360714037236,1135418008,1135419736,1728
1360714079,1135461592,1,52,52,1360714053591,1360714053591,1135436183,1135436183,0
1360714103,1135485676,1,52,52,1360714075203,1360714075203,1135457879,1135457879,0
1360714104,1135486044,16,3306,206.625,1360714096957,1360714097213,1135479001,1135479257,256
1360714123,1135505704,2,566,283,1360714095594,1360714095914,1135478298,1135478618,320
1360714127,1135509832,1,52,52,1360714099751,1360714099751,1135482583,1135482583,0
1360714127,1135509912,1,52,52,1360714102039,1360714102039,1135484951,1135484951,0
1360714135,1135517740,1,52,52,1360714108483,1360714108483,1135491223,1135491223,0
1360714135,1135517856,1,52,52,1360714108239,1360714108239,1135491095,1135491095,0
1360714155,1135537876,1,52,52,1360714128893,1360714128893,1135511769,1135511769,0
1360714175,1135557728,1,52,52,1360714147471,1360714147471,1135530199,1135530199,0
1360714175,1135557848,1,52,52,1360714147543,1360714147543,1135530391,1135530391,0
1360714187,1135569892,9,3463,384.7777778,1360714159466,1360714159914,1135542358,1135542806,448
1360714219,1135601800,1,52,52,1360714191432,1360714191432,1135574232,1135574232,0
1360714219,1135601924,1,52,52,1360714191179,1360714191179,1135574103,1135574103,0
1360714220,1135602016,1,52,52,1360714195606,1360714195606,1135577622,1135577622,0
1360714235,1135617904,1,52,52,1360714210719,1360714210719,1135593623,1135593623,0
1360714235,1135617904,1,52,52,1360714209502,1360714209502,1135592406,1135592406,0
1360714235,1135617924,1,52,52,1360714210571,1360714210571,1135593495,1135593495,0
1360714236,1135618036,1,52,52,1360714210307,1360714210307,1135592343,1135592343,0
1360714236,1135618036,1,52,52,1360714210371,1360714210371,1135592407,1135592407,0
1360714236,1135618036,1,52,52,1360714210371,1360714210371,1135592407,1135592407,0
1360714256,1135638320,51,11092,217.4901961,1360714247078,1360714248678,1135629398,1135630998,1600
1360714271,1135653860,1,198,198,1360714242826,1360714242826,1135625686,1135625686,0
1360714271,1135653948,7,3438,491.1428571,1360714245683,1360714246067,1135628631,1135629015,384
1360714288,1135670428,2,131,65.5,1360714280249,1360714280249,1135662677,1135662677,0
1360714305,1135687084,1,48,48,1360714278673,1360714278673,1135660757,1135660757,0
1360714336,1135718060,1,64,64,1360714310507,1360714310507,1135692567,1135692567,0
1360714336,1135718060,18,4575,254.1666667,1360714310569,1360714317609,1135692629,1135699669,7040
1360714336,1135718068,1,52,52,1360714311007,1360714311007,1135693075,1135693075,0
1360714336,1135718896,2,110,55,1360714319779,1360714332387,1135702675,1135715283,12608
1360714340,1135722184,8,3520,440,1360714314155,1360714315307,1135696339,1135697491,1152
1360714344,1135726800,3,168,56,1360714340036,1360714340164,1135722836,1135722964,128
1360714352,1135734936,3,168,56,1360714349179,1360714349307,1135732115,1135732243,128
1360714352,1135734936,3,168,56,1360714349309,1360714349437,1135732245,1135732373,128
1360714352,1135734936,3,168,56,1360714349501,1360714349629,1135732437,1135732565,128
1360714353,1135735028,3,168,56,1360714350599,1360714350727,1135732627,1135732755,128
1360714353,1135735032,3,168,56,1360714350788,1360714350916,1135732820,1135732948,128
1360714356,1135738176,1,64,64,1360714330548,1360714330548,1135712724,1135712724,0
1360714368,1135750424,1,46,46,1360714341884,1360714341884,1135724308,1135724308,0
1360714376,1135758412,1,46,46,1360714350151,1360714350151,1135732563,1135732563,0
1360714408,1135790308,1,46,46,1360714383345,1360714383345,1135765653,1135765653,0
1360714484,1135866436,5,230,46,1360714456621,1360714477421,1135839057,1135859857,20800
1360714488,1135870356,9,3463,384.7777778,1360714460992,1360714461440,1135843348,1135843796,448
1360714512,1135894636,1,52,52,1360714486373,1360714486373,1135869009,1135869009,0
1360714516,1135898628,20,13712,685.6,1360714490606,1360714495278,1135873234,1135877906,4672
1360714524,1135906572,42,57216,1362.285714,1360714496422,1360714498662,1135878994,1135881234,2240
1360714524,1135906612,10,11650,1165,1360714497279,1360714497407,1135879891,1135880019,128
1360714524,1135906688,43,57495,1337.093023,1360714496304,1360714498160,1135878992,1135880848,1856
1360714532,1135914624,7,3285,469.2857143,1360714505842,1360714506226,1135888466,1135888850,384
1360714545,1135927132,26,26218,1008.384615,1360714537951,1360714539295,1135920083,1135921427,1344
1360714560,1135942680,1,186,186,1360714532985,1360714532985,1135915665,1135915665,0
1360714560,1135942688,5,2648,529.6,1360714533488,1360714534576,1135916176,1135917264,1088
1360714576,1135958832,3,408,136,1360714550562,1360714556642,1135933394,1135939474,6080
1360714585,1135967232,2,131,65.5,1360714581434,1360714581434,1135963666,1135963666,0
1360714596,1135978736,1,52,52,1360714571201,1360714571201,1135953937,1135953937,0
1360714604,1135986808,1,52,52,1360714577145,1360714577145,1135959953,1135959953,0
1360714609,1135991288,7,1609,229.8571429,1360714599874,1360714601346,1135982162,1135983634,1472
1360714617,1135999292,4,289,72.25,1360714615486,1360714616254,1135997778,1135998546,768
1360714625,1136007176,3,237,79,1360714617393,1360714623537,1135999569,1136005713,6144
1360714625,1136007180,5,260,52,1360714617773,1360714621613,1135999953,1136003793,3840
1360714641,1136023196,2,104,52,1360714625630,1360714633758,1136007826,1136015954,8128
1360714649,1136031208,2,158,79,1360714631696,1360714648144,1136013904,1136030352,16448
1360714649,1136031288,3,156,52,1360714648000,1360714648768,1136030288,1136031056,768
1360714657,1136039176,3,156,52,1360714649904,1360714656112,1136032080,1136038288,6208
1360714677,1136059212,1,52,52,1360714649931,1360714649931,1136032143,1136032143,0
1360714681,1136063512,2,104,52,1360714664030,1360714674014,1136046542,1136056526,9984
1360714697,1136079532,2,104,52,1360714683981,1360714693965,1136066513,1136076497,9984
1360714709,1136091296,1,79,79,1360714680889,1360714680889,1136063185,1136063185,0
1360714709,1136091344,1,52,52,1360714682249,1360714682249,1136064593,1136064593,0
1360714729,1136111468,1,52,52,1360714704075,1360714704075,1136086543,1136086543,0
1360714753,1136135584,5,260,52,1360714746263,1360714749911,1136128847,1136132495,3648
1360714777,1136159664,4,208,52,1360714774598,1360714776198,1136157262,1136158862,1600
1360714805,1136187460,1,52,52,1360714778196,1360714778196,1136160656,1136160656,0
1360714817,1136199676,326,84969,260.6411043,1360714543227,1360714815739,1135925903,1136198415,272512
1360714829,1136211632,1,46,46,1360714802405,1360714802405,1136185037,1136185037,0
1360715158,1136540376,8,832,104,1360715130146,1360715145058,1136512522,1136527434,14912
1360715186,1136568404,1,104,104,1360715160131,1360715160131,1136542535,1136542535,0
1360715218,1136600368,1,104,104,1360715190441,1360715190441,1136572809,1136572809,0
1360715278,1136660544,1,104,104,1360715250807,1360715250807,1136633351,1136633351,0
1360715398,1136780576,1,104,104,1360715371027,1360715371027,1136753603,1136753603,0
1360715518,1136900872,1,104,104,1360715491052,1360715491052,1136873924,1136873924,0
1360715595,1136977000,1,46,46,1360715570001,1360715570001,1136952001,1136952001,0
1360715639,1137021432,1,104,104,1360715611809,1360715611809,1136994241,1136994241,0
1360715759,1137141736,1,104,104,1360715731824,1360715731824,1137114560,1137114560,0
1360715823,1137205696,8,496,62,1360715797143,1360715811671,1137179839,1137194367,14528
1360715847,1137229700,2,96,48,1360715819860,1360715833364,1137202560,1137216064,13504
1360715879,1137261856,1,104,104,1360715852020,1360715852020,1137234876,1137234876,0
1360715895,1137277860,1,48,48,1360715868274,1360715868274,1137251134,1137251134,0
1360716000,1137382212,1,104,104,1360715972985,1360715972985,1137355197,1137355197,0
1360716136,1137518636,1,46,46,1360716110669,1360716110669,1137493305,1137493305,0
1360716188,1137570692,1,46,46,1360716162134,1360716162134,1137544826,1137544826,0
1360716301,1137683212,2,104,52,1360716276084,1360716279092,1137658296,1137661304,3008
1360716301,1137683284,2,104,52,1360716274861,1360716277869,1137657145,1137660153,3008
1360716305,1137687048,2,104,52,1360716277336,1360716280344,1137659384,1137662392,3008
1360716305,1137687048,2,104,52,1360716277335,1360716280343,1137659383,1137662391,3008
1360716609,1137991712,2,104,52,1360716583420,1360716586364,1137966132,1137969076,2944
1360716609,1137991760,2,104,52,1360716581129,1360716584073,1137963889,1137966833,2944
1360716609,1137991800,2,104,52,1360716582177,1360716585185,1137964977,1137967985,3008
1360716609,1137991840,2,104,52,1360716583225,1360716586233,1137966065,1137969073,3008
1360716836,1138218468,17,3358,197.5294118,1360716831340,1360716833516,1138213808,1138215984,2176
1360716844,1138226368,18,3634,201.8888889,1360716836433,1360716839889,1138218801,1138222257,3456
1360716844,1138226432,20,5373,268.65,1360716833680,1360716836240,1138216112,1138218672,2560
1360716844,1138226480,18,5410,300.5555556,1360716839777,1360716842401,1138222257,1138224881,2624
1360716852,1138234340,21,5557,264.6190476,1360716845547,1360716848363,1138227887,1138230703,2816
1360716852,1138234352,16,6814,425.875,1360716842654,1360716845534,1138225006,1138227886,2880
1360716852,1138234432,27,4072,150.8148148,1360716842767,1360716846863,1138225199,1138229295,4096
1360716858,1138240032,18,4026,223.6666667,1360716831776,1360716836384,1138213808,1138218416,4608
1360716858,1138240064,12,6726,560.5,1360716832254,1360716835774,1138214318,1138217838,3520
1360716868,1138250384,22,3594,163.3636364,1360716865473,1360716867265,1138247857,1138249649,1792
1360716874,1138256152,11,2488,226.1818182,1360716849383,1360716851623,1138231535,1138233775,2240
1360716876,1138258388,17,7400,435.2941176,1360716871675,1360716872827,1138254063,1138255215,1152
1360716876,1138258388,19,3903,205.4210526,1360716867258,1360716869370,1138249646,1138251758,2112
1360716876,1138258420,15,3484,232.2666667,1360716869467,1360716871579,1138251887,1138253999,2112
1360716876,1138258472,15,3293,219.5333333,1360716872806,1360716874726,1138255278,1138257198,1920
1360716878,1138260008,1,64,64,1360716849975,1360716849975,1138231983,1138231983,0
1360716884,1138266356,3,168,56,1360716878809,1360716879577,1138261165,1138261933,768
1360716884,1138266360,61,65026,1066,1360716879126,1360716883606,1138261486,1138265966,4480
1360716884,1138266376,17,3987,234.5294118,1360716877062,1360716879110,1138259438,1138261486,2048
1360716884,1138266376,16,3749,234.3125,1360716874949,1360716877061,1138257325,1138259437,2112
1360716884,1138266376,3,168,56,1360716879621,1360716880325,1138261997,1138262701,704
1360716884,1138266388,3,168,56,1360716880636,1360716881276,1138263024,1138263664,640
1360716884,1138266436,3,168,56,1360716876809,1360716877833,1138259245,1138260269,1024
1360716884,1138266472,3,168,56,1360716875750,1360716876262,1138258222,1138258734,512
1360716884,1138266476,2,110,55,1360716864931,1360716877091,1138247407,1138259567,12160
1360716892,1138274484,20,3385,169.25,1360716885147,1360716887195,1138267631,1138269679,2048
1360716892,1138274488,18,3493,194.0555556,1360716883479,1360716885015,1138265967,1138267503,1536
1360716893,1138275896,17,3966,233.2941176,1360716864957,1360716868093,1138247853,1138250989,3136
1360716893,1138275980,1,52,52,1360716866345,1360716866345,1138249325,1138249325,0
1360716894,1138276024,10,5475,547.5,1360716866149,1360716868133,1138248173,1138250157,1984
1360716906,1138288028,1,46,46,1360716878624,1360716878624,1138260652,1138260652,0
1360717092,1138474492,2,110,55,1360717076431,1360717086735,1138458923,1138469227,10304
1360717092,1138474580,3,168,56,1360717086648,1360717086712,1138469228,1138469292,64
1360717100,1138482532,22,9426,428.4545455,1360717097445,1360717098405,1138479977,1138480937,960
1360717102,1138484324,1,52,52,1360717075509,1360717075509,1138457833,1138457833,0
1360717114,1138496420,1,64,64,1360717086871,1360717086871,1138469291,1138469291,0
1360717122,1138504388,4,929,232.25,1360717096181,1360717096565,1138478569,1138478953,384
1360717124,1138506620,410,30845,75.23170732,1360716867599,1360717121231,1138250219,1138503851,253632
1360717134,1138516564,1,52,52,1360717107591,1360717107591,1138490155,1138490155,0
1360717139,1138521240,1,46,46,1360717113867,1360717113867,1138496107,1138496107,0
1360717139,1138521392,9,3463,384.7777778,1360717111857,1360717112433,1138494249,1138494825,576
1360717154,1138536340,270,19443,72.01111111,1360716835559,1360716853799,1138217899,1138236139,18240
1360717204,1138586556,3,168,56,1360717196943,1360717197071,1138579499,1138579627,128
1360717204,1138586628,3,168,56,1360717196679,1360717196807,1138579307,1138579435,128
1360717204,1138586632,3,168,56,1360717196995,1360717197059,1138579627,1138579691,64
1360717212,1138594564,7,811,115.8571429,1360717204102,1360717209542,1138586666,1138592106,5440
1360717212,1138594564,11,6451,586.4545455,1360717204165,1360717209669,1138586729,1138592233,5504
1360717212,1138594568,32,9084,283.875,1360717202497,1360717209857,1138585065,1138592425,7360
1360717212,1138594568,8,1292,161.5,1360717202560,1360717204288,1138585128,1138586856,1728
1360717212,1138594592,6,1237,206.1666667,1360717204968,1360717205160,1138587560,1138587752,192
1360717222,1138604508,1,46,46,1360717196924,1360717196924,1138579432,1138579432,0
1360717222,1138604664,1,64,64,1360717197088,1360717197088,1138579752,1138579752,0
1360717226,1138608504,17,4399,258.7647059,1360717199810,1360717206594,1138582314,1138589098,6784
1360717226,1138608620,1,52,52,1360717200204,1360717200204,1138582824,1138582824,0
1360717226,1138608672,3,152,50.66666667,1360717201369,1360717202649,1138584041,1138585321,1280
1360717230,1138612480,7,3509,501.2857143,1360717202137,1360717202393,1138584617,1138584873,256
1360717230,1138612484,1,116,116,1360717202325,1360717202325,1138584809,1138584809,0
1360717230,1138612512,1,116,116,1360717202553,1360717202553,1138585065,1138585065,0
1360717230,1138612564,3,152,50.66666667,1360717203719,1360717204999,1138586283,1138587563,1280
1360717230,1138612564,2,104,52,1360717203719,1360717206727,1138586283,1138589291,3008
1360717230,1138612604,1,116,116,1360717202205,1360717202205,1138584809,1138584809,0
1360717230,1138612632,1,46,46,1360717202432,1360717202432,1138585064,1138585064,0
1360717230,1138612632,1,116,116,1360717202432,1360717202432,1138585064,1138585064,0
1360717230,1138612636,3,152,50.66666667,1360717202556,1360717203836,1138585192,1138586472,1280
1360717236,1138618676,2,131,65.5,1360717231957,1360717231957,1138614633,1138614633,0
1360717238,1138620668,1,64,64,1360717212831,1360717212831,1138595499,1138595499,0
1360717266,1138648592,2,116,58,1360717238632,1360717238824,1138621224,1138621416,192
1360717398,1138780852,8,1792,224,1360717372003,1360717397475,1138754855,1138780327,25472
1360717435,1138817096,3,672,224,1360717408213,1360717428245,1138790309,1138810341,20032
1360717444,1138826780,4,208,52,1360717442090,1360717443690,1138824870,1138826470,1600
1360717471,1138853176,1,52,52,1360717446086,1360717446086,1138828262,1138828262,0
1360717635,1139017828,3,152,50.66666667,1360717610295,1360717619255,1138993123,1139002083,8960
1360717639,1139021680,3,152,50.66666667,1360717612621,1360717621645,1138995301,1139004325,9024
1360717639,1139021680,3,152,50.66666667,1360717612620,1360717621644,1138995300,1139004324,9024
1360717639,1139021788,3,152,50.66666667,1360717611423,1360717620447,1138994211,1139003235,9024
1360717756,1139138916,3,156,52,1360717750495,1360717754719,1139133411,1139137635,4224
1360717772,1139154816,2,104,52,1360717760451,1360717770435,1139143267,1139153251,9984
1360717796,1139178884,2,104,52,1360717780413,1360717790397,1139163297,1139173281,9984
1360718020,1139402716,1,46,46,1360717994530,1360717994530,1139377246,1139377246,0
1360719507,1140889552,1,52,52,1360719480174,1360719480174,1140862726,1140862726,0
1360719988,1141370568,3,152,50.66666667,1360719963865,1360719972889,1141346433,1141355457,9024
1360719988,1141370732,3,152,50.66666667,1360719961460,1360719970484,1141344192,1141353216,9024
1360719988,1141370748,3,152,50.66666667,1360719962532,1360719971620,1141345280,1141354368,9088
1360719988,1141370776,3,152,50.66666667,1360719963654,1360719972614,1141346430,1141355390,8960
1360720096,1141478756,1,46,46,1360720069915,1360720069915,1141452671,1141452671,0
1360720337,1141719552,2,104,52,1360720311266,1360720314274,1141693818,1141696826,3008
1360720337,1141719696,2,104,52,1360720312276,1360720315284,1141694972,1141697980,3008
1360720341,1141723436,2,104,52,1360720313624,1360720316632,1141696060,1141699068,3008
1360720341,1141723552,2,104,52,1360720313507,1360720316515,1141696059,1141699067,3008
1360720634,1142016028,1,440,440,1360720609002,1360720609002,1141991030,1141991030,0
1360720738,1142120568,10,1998,199.8,1360720735375,1360720735951,1142117943,1142118519,576
1360720738,1142120568,11,5588,508,1360720735629,1360720736269,1142118197,1142118837,640
1360720738,1142120608,19,6982,367.4736842,1360720733350,1360720736742,1142115958,1142119350,3392
1360720738,1142120624,21,3788,180.3809524,1360720734419,1360720735635,1142117043,1142118259,1216
1360720758,1142140140,31,7340,236.7741935,1360720733498,1360720745530,1142115638,1142127670,12032
1360720758,1142140300,3,304,101.3333333,1360720733082,1360720733082,1142115382,1142115382,0
1360720762,1142144024,16,6713,419.5625,1360720733867,1360720739307,1142115891,1142121331,5440
1360720762,1142144104,17,11215,659.7058824,1360720735899,1360720740827,1142118003,1142122931,4928
1360720762,1142144104,8,3162,395.25,1360720736028,1360720736604,1142118132,1142118708,576
1360720762,1142144112,32,20194,631.0625,1360720736532,1360720746196,1142118644,1142128308,9664
1360720766,1142148332,10,3659,365.9,1360720740346,1360720742330,1142122678,1142124662,1984
1360720774,1142156020,7,959,137,1360720745970,1360720746482,1142127990,1142128502,512
1360720786,1142168564,8,895,111.875,1360720785170,1360720785490,1142167734,1142168054,320
1360720794,1142176584,6,3682,613.6666667,1360720787578,1360720787770,1142170162,1142170354,192
1360720810,1142192264,3,291,97,1360720783934,1360720785598,1142166198,1142167862,1664
1360720810,1142192416,5,557,111.4,1360720783780,1360720788132,1142166196,1142170548,4352
1360720814,1142196148,6,396,66,1360720788144,1360720788208,1142170292,1142170356,64
1360720850,1142232760,8,895,111.875,1360720848586,1360720848906,1142231346,1142231666,320
1360720858,1142240660,3,210,70,1360720855920,1360720856240,1142238580,1142238900,320
1360720898,1142280404,1,52,52,1360720870829,1360720870829,1142253233,1142253233,0
1360720978,1142360824,2,104,52,1360720972555,1360720972811,1142355379,1142355635,256
1360720987,1142369100,8,895,111.875,1360720978332,1360720978652,1142360432,1142360752,320
1360721006,1142388688,2,245,122.5,1360720978001,1360720978641,1142360689,1142361329,640
1360721006,1142388696,8,641,80.125,1360720978121,1360720982985,1142360817,1142365681,4864
1360721010,1142392688,5,350,70,1360720981969,1360720982097,1142364657,1142364785,128
1360721010,1142392788,1,52,52,1360720985518,1360720985518,1142368306,1142368306,0
1360721010,1142392960,1,52,52,1360720985471,1360720985471,1142368431,1142368431,0
1360721067,1142449108,6,1201,200.1666667,1360721063443,1360721063635,1142445551,1142445743,192
1360721067,1142449136,6,3682,613.6666667,1360721064054,1360721064246,1142446190,1142446382,192
1360721091,1142473116,2,265,132.5,1360721066378,1360721066378,1142448494,1142448494,0
1360721091,1142473152,6,3682,613.6666667,1360721087465,1360721087657,1142469617,1142469809,192
1360721091,1142473356,9,5616,624,1360721086042,1360721086618,1142468398,1142468974,576
1360721119,1142501040,2,245,122.5,1360721093208,1360721100376,1142475248,1142482416,7168
1360721119,1142501044,11,5973,543,1360721093397,1360721098773,1142475441,1142480817,5376
1360721199,1142581432,1,52,52,1360721173901,1360721173901,1142556333,1142556333,0
1360721235,1142617660,8,895,111.875,1360721233898,1360721234218,1142616558,1142616878,320
1360721303,1142685780,1,52,52,1360721277617,1360721277617,1142660397,1142660397,0
1360721340,1142722040,7,807,115.2857143,1360721332370,1360721332626,1142714410,1142714666,256
1360721340,1142722044,7,1323,189,1360721332814,1360721333198,1142714858,1142715242,384
1360721359,1142741684,2,241,120.5,1360721332497,1360721334993,1142715181,1142717677,2496
1360721359,1142741812,9,5715,635,1360721332623,1360721333007,1142715435,1142715819,384
1360721460,1142842340,6,3682,613.6666667,1360721451943,1360721453735,1142834283,1142836075,1792
1360721480,1142862180,2,465,232.5,1360721453894,1360721453894,1142836074,1142836074,0
1360721492,1142874456,26,11274,433.6153846,1360721482033,1360721487793,1142864489,1142870249,5760
1360721500,1142882452,51,13152,257.8823529,1360721479413,1360721492917,1142861865,1142875369,13504
1360721500,1142882464,41,12224,298.1463415,1360721496681,1360721499049,1142879145,1142881513,2368
1360721500,1142882464,26,11456,440.6153846,1360721493097,1360721496169,1142875561,1142878633,3072
1360721500,1142882468,2,92,46,1360721493415,1360721493415,1142875883,1142875883,0
1360721500,1142882500,38,12070,317.6315789,1360721494150,1360721496582,1142876650,1142879082,2432
1360721500,1142882552,13,4342,334,1360721493392,1360721494416,1142875944,1142876968,1024
1360721500,1142882556,37,7813,211.1621622,1360721497422,1360721499278,1142879978,1142881834,1856
1360721500,1142882576,15,6703,446.8666667,1360721494394,1360721495098,1142876970,1142877674,704
1360721508,1142890416,41,12214,297.902439,1360721503642,1360721505434,1142886058,1142887850,1792
1360721508,1142890424,34,11857,348.7352941,1360721500499,1360721502739,1142882923,1142885163,2240
1360721508,1142890464,41,12225,298.1707317,1360721502759,1360721505127,1142885223,1142887591,2368
1360721508,1142890472,41,12224,298.1463415,1360721499553,1360721502369,1142882025,1142884841,2816
1360721516,1142898456,29,11590,399.6551724,1360721512947,1360721514803,1142895403,1142897259,1856
1360721516,1142898456,38,7869,207.0789474,1360721509298,1360721511730,1142891754,1142894186,2432
1360721516,1142898492,38,7869,207.0789474,1360721505421,1360721507853,1142887913,1142890345,2432
1360721516,1142898500,40,12168,304.2,1360721506310,1360721509190,1142888810,1142891690,2880
1360721516,1142898532,41,12225,298.1707317,1360721512036,1360721514468,1142894568,1142897000,2432
1360721516,1142898572,40,12168,304.2,1360721510077,1360721511933,1142892649,1142894505,1856
1360721520,1142902180,13,7778,598.3076923,1360721494022,1360721494598,1142876202,1142876778,576
1360721520,1142902308,10,5874,587.4,1360721495238,1360721495686,1142877546,1142877994,448
1360721520,1142902384,8,2851,356.375,1360721493496,1360721494520,1142875880,1142876904,1024
1360721520,1142902388,6,859,143.1666667,1360721493686,1360721494134,1142876074,1142876522,448
1360721520,1142902424,47,6040,128.5106383,1360721494353,1360721496209,1142876777,1142878633,1856
1360721522,4076184892,19,22160,1166.315789,1360721494212,1360721495044,4076157104,4076157936,832
1360721522,4076184892,7,4635,662.1428571,1360721494212,1360721495044,4076157104,4076157936,832
1360721522,4076184952,9,7838,870.8888889,1360721494150,1360721494406,4076157102,4076157358,256
1360721522,4076184952,9,7619,846.5555556,1360721494150,1360721494982,4076157102,4076157934,832
1360721522,4076184952,9,5699,633.2222222,1360721494149,1360721494981,4076157101,4076157933,832
1360721522,4076184952,68,94264,1386.235294,1360721494149,1360721495045,4076157101,4076157997,896
1360721524,1142906452,41,12223,298.1219512,1360721515701,1360721517557,1142898153,1142900009,1856
1360721524,1142906460,29,11612,400.4137931,1360721520557,1360721522989,1142903017,1142905449,2432
1360721524,1142906488,27,11520,426.6666667,1360721517523,1360721520211,1142900011,1142902699,2688
1360721524,1142906492,31,11703,377.516129,1360721518349,1360721520461,1142900841,1142902953,2112
1360721524,1142906504,41,12230,298.2926829,1360721514816,1360721517184,1142897320,1142899688,2368
1360721524,1142906568,31,11703,377.516129,1360721521281,1360721523137,1142903849,1142905705,1856
1360721532,1142914432,35,7723,220.6571429,1360721524168,1360721526088,1142906600,1142908520,1920
1360721532,1142914472,29,11612,400.4137931,1360721526050,1360721528482,1142908522,1142910954,2432
1360721532,1142914472,34,7517,221.0882353,1360721529632,1360721531616,1142912104,1142914088,1984
1360721532,1142914532,12,3171,264.25,1360721525990,1360721526694,1142908522,1142909226,704
1360721532,1142914556,38,7867,207.0263158,1360721526796,1360721528652,1142909352,1142911208,1856
1360721532,1142914564,39,12144,311.3846154,1360721523205,1360721525637,1142905769,1142908201,2432
1360721548,1142930244,15,3494,232.9333333,1360721523205,1360721524293,1142905449,1142906537,1088
1360721548,4076210636,5,1757,351.4,1360721547072,1360721547072,4076209708,4076209708,0
1360721552,1142934200,11,3021,274.6363636,1360721526385,1360721526897,1142908585,1142909097,512
1360721552,1142934344,13,11966,920.4615385,1360721526815,1360721527071,1142909159,1142909415,256
1360721556,1142938192,26,10969,421.8846154,1360721529080,1360721529848,1142911272,1142912040,768
1360721556,1142938436,1,487,487,1360721530693,1360721530693,1142913129,1142913129,0
1360721556,1142938516,27,21566,798.7407407,1360721545652,1360721549940,1142928168,1142932456,4288
1360721556,1142938596,14,3258,232.7142857,1360721550564,1360721551460,1142933160,1142934056,896
1360721568,1142950228,10,907,90.7,1360721541395,1360721541587,1142923623,1142923815,192
1360721571,4076233132,79,103054,1304.481013,1360721546424,1360721570552,4076208556,4076232684,24128
1360721571,4076233132,33,46260,1401.818182,1360721546488,1360721570488,4076208620,4076232620,24000
1360721571,4076233184,50,69048,1380.96,1360721546436,1360721570820,4076208620,4076233004,24384
1360721571,4076233188,52,63314,1217.576923,1360721546563,1360721570307,4076208751,4076232495,23744
1360721571,4076233188,35,38518,1100.514286,1360721546435,1360721570691,4076208623,4076232879,24256
1360721571,4076233188,94,129619,1378.925532,1360721546435,1360721570627,4076208623,4076232815,24192
1360721572,1142954236,3,854,284.6666667,1360721545931,1360721546187,1142928167,1142928423,256
1360721572,1142954272,7,897,128.1428571,1360721546602,1360721547050,1142928874,1142929322,448
1360721572,1142954284,7,3400,485.7142857,1360721547419,1360721547739,1142929703,1142930023,320
1360721572,1142954396,20,19118,955.9,1360721546731,1360721571691,1142929127,1142954087,24960
1360721572,1142954580,6,507,84.5,1360721550451,1360721570547,1142933031,1142953127,20096
1360721572,1142954604,27,20119,745.1481481,1360721567261,1360721569629,1142949865,1142952233,2368
1360721575,4076237116,3,1253,417.6666667,1360721547721,1360721547849,4076209837,4076209965,128
1360721575,4076237168,4,1960,490,1360721547671,1360721547799,4076209839,4076209967,128
1360721576,1142958360,71,95572,1346.084507,1360721550160,1360721571664,1142932520,1142954024,21504
1360721576,1142958360,11,6807,618.8181818,1360721550160,1360721550352,1142932520,1142932712,192
1360721576,1142958380,15,8734,582.2666667,1360721550651,1360721571835,1142933031,1142954215,21184
1360721576,1142958392,1,46,46,1360721551217,1360721551217,1142933609,1142933609,0
1360721576,1142958508,23,17170,746.5217391,1360721550523,1360721571707,1142933031,1142954215,21184
1360721576,1142958508,9,4188,465.3333333,1360721550523,1360721571579,1142933031,1142954087,21056
1360721576,1142958524,1,46,46,1360721551086,1360721551086,1142933610,1142933610,0
1360721592,1142974320,8,3825,478.125,1360721566841,1360721567353,1142949161,1142949673,512
1360721592,1142974448,2,538,269,1360721566777,1360721566841,1142949225,1142949289,64
1360721596,1142978508,12,8511,709.25,1360721570746,1360721571258,1142953254,1142953766,512
1360721596,1142978520,8,1924,240.5,1360721571378,1360721571890,1142953898,1142954410,512
1360721596,1142978544,7,1467,209.5714286,1360721571673,1360721592665,1142954217,1142975209,20992
1360721596,1142978680,7,1467,209.5714286,1360721571536,1360721592464,1142954216,1142975144,20928
1360721599,4076261108,2,1357,678.5,1360721571412,1360721571412,4076233520,4076233520,0
1360721599,4076261108,2,701,350.5,1360721571411,1360721571411,4076233519,4076233519,0
1360721599,4076261140,3,1565,521.6666667,1360721570931,1360721571379,4076233071,4076233519,448
1360721599,4076261140,8,9049,1131.125,1360721570931,1360721571635,4076233071,4076233775,704
1360721599,4076261140,41,58345,1423.04878,1360721570931,1360721571443,4076233071,4076233583,512
1360721599,4076261156,3,4161,1387,1360721571362,1360721571362,4076233518,4076233518,0
1360721604,1142986552,4,235,58.75,1360721596304,1360721596304,1142978856,1142978856,0
1360721620,1143002788,12,1497,124.75,1360721611684,1360721612132,1142994472,1142994920,448
1360721620,1143002868,20,8471,423.55,1360721604307,1360721611859,1142987175,1142994727,7552
1360721624,1143006472,14,3371,240.7857143,1360721596385,1360721597153,1142978857,1142979625,768
1360721624,1143006540,7,3443,491.8571429,1360721598109,1360721598941,1142980649,1142981481,832
1360721624,1143006552,11,4137,376.0909091,1360721598864,1360721604624,1142981416,1142987176,5760
1360721624,1143006584,9,4795,532.7777778,1360721599727,1360721600367,1142982311,1142982951,640
1360721624,1143006664,9,4994,554.8888889,1360721598111,1360721599327,1142980775,1142981991,1216
1360721624,1143006680,12,5766,480.5,1360721598993,1360721606097,1142981673,1142988777,7104
1360721624,1143006696,7,3087,441,1360721599359,1360721599615,1142982055,1142982311,256
1360721628,1143010660,12,5518,459.8333333,1360721600098,1360721600738,1142982758,1142983398,640
1360721628,1143010700,11,4565,415,1360721601148,1360721601852,1142983848,1142984552,704
1360721628,1143010732,82,109356,1333.609756,1360721601756,1360721602844,1142984488,1142985576,1088
1360721628,1143010792,2,127,63.5,1360721625120,1360721625120,1143007912,1143007912,0
1360721632,1143014520,3,3270,1090,1360721605359,1360721605359,1142987879,1142987879,0
1360721632,1143014524,2,2253,1126.5,1360721605420,1360721605420,1142987944,1142987944,0
1360721632,1143014636,12,7065,588.75,1360721604797,1360721605309,1142987433,1142987945,512
1360721632,1143014640,3,2401,800.3333333,1360721605238,1360721605238,1142987878,1142987878,0
1360721632,1143014644,2,2157,1078.5,1360721605299,1360721605299,1142987943,1142987943,0
1360721632,1143014692,9,5711,634.5555556,1360721607108,1360721607300,1142989800,1142989992,192
1360721632,1143014712,3,291,97,1360721606959,1360721610415,1142989671,1142993127,3456
1360721644,1143026836,13,2564,197.2307692,1360721638196,1360721638708,1143021032,1143021544,512
1360721653,1143035024,2,131,65.5,1360721647008,1360721647008,1143029032,1143029032,0
1360721664,1143046644,13,8531,656.2307692,1360721639540,1360721640052,1143022184,1143022696,512
1360721667,4076329296,48,67270,1401.458333,1360721640726,1360721642646,4076303022,4076304942,1920
1360721667,4076329296,21,27681,1318.142857,1360721640726,1360721642966,4076303022,4076305262,2240
1360721667,4076329348,14,19991,1427.928571,1360721640546,1360721640866,4076302894,4076303214,320
1360721667,4076329348,5,6558,1311.6,1360721640610,1360721640802,4076302958,4076303150,192
1360721667,4076329348,5,4868,973.6,1360721640610,1360721642658,4076302958,4076305006,2048
1360721667,4076329348,8,8800,1100,1360721640609,1360721642529,4076302957,4076304877,1920
1360721668,1143050544,10,7626,762.6,1360721640857,1360721642073,1143023401,1143024617,1216
1360721668,1143050664,3,2060,686.6666667,1360721640672,1360721640672,1143023336,1143023336,0
1360721668,1143050692,7,5337,762.4285714,1360721641091,1360721642115,1143023783,1143024807,1024
1360721668,1143050928,6,447,74.5,1360721660822,1360721665174,1143043750,1143048102,4352
1360721668,1143050940,5,368,73.6,1360721665355,1360721667211,1143048295,1143050151,1856
1360721668,1143050972,4,289,72.25,1360721666281,1360721667433,1143049253,1143050405,1152
1360721676,1143058884,6,447,74.5,1360721669826,1360721673538,1143052710,1143056422,3712
1360721676,1143058928,3,230,76.66666667,1360721675031,1360721675287,1143057959,1143058215,256
1360721676,1143058960,2,158,79,1360721668982,1360721672118,1143051942,1143055078,3136
1360721676,1143058964,2,158,79,1360721669363,1360721673587,1143052327,1143056551,4224
1360721684,1143066884,2,158,79,1360721669825,1360721678977,1143052709,1143061861,9152
1360721692,1143074920,2,158,79,1360721677407,1360721685215,1143060327,1143068135,7808
1360721692,1143074952,6,447,74.5,1360721686271,1360721690495,1143069223,1143073447,4224
1360721693,1143075024,2,158,79,1360721679326,1360721691870,1143061350,1143073894,12544
1360721693,1143075028,5,368,73.6,1360721687515,1360721690011,1143069543,1143072039,2496
1360721700,1143082928,2,158,79,1360721691992,1360721697688,1143074920,1143080616,5696
1360721701,1143083024,3,230,76.66666667,1360721698910,1360721700382,1143080934,1143082406,1472
1360721701,1143083040,2,158,79,1360721683021,1360721700045,1143065061,1143082085,17024
1360721704,1143086696,5,445,89,1360721676032,1360721692096,1143058728,1143074792,16064
1360721709,1143090976,3,230,76.66666667,1360721706959,1360721708623,1143088935,1143090599,1664
1360721709,1143090980,2,158,79,1360721696010,1360721705034,1143077990,1143087014,9024
1360721724,1143106664,1,79,79,1360721697630,1360721697630,1143080294,1143080294,0
1360721725,1143106984,3,201,67,1360721718853,1360721721861,1143100837,1143103845,3008
1360721725,1143107036,6,497,82.83333333,1360721717906,1360721722194,1143099942,1143104230,4288
1360721725,1143107040,3,201,67,1360721718478,1360721721486,1143100518,1143103526,3008
1360721728,1143110744,1,79,79,1360721701007,1360721701007,1143083751,1143083751,0
1360721728,1143110784,3,267,89,1360721702501,1360721719973,1143085285,1143102757,17472
1360721733,1143114968,2,158,79,1360721709975,1360721732759,1143091943,1143114727,22784
1360721736,1143118708,3,267,89,1360721711156,1360721730868,1143093864,1143113576,19712
1360721736,1143118784,1,89,89,1360721709158,1360721709158,1143091942,1143091942,0
1360721740,1143122960,2,134,67,1360721724599,1360721732599,1143107559,1143115559,8000
1360721741,1143123040,2,134,67,1360721725837,1360721733837,1143107877,1143115877,8000
1360721744,1143126668,1,79,79,1360721716314,1360721716314,1143098982,1143098982,0
1360721744,1143126820,3,408,136,1360721716928,1360721722944,1143099748,1143105764,6016
1360721748,1143130728,1,79,79,1360721722332,1360721722332,1143105060,1143105060,0
1360721752,1143134828,2,178,89,1360721726009,1360721735161,1143108837,1143117989,9152
1360721760,1143142668,1,79,79,1360721732378,1360721732378,1143115046,1143115046,0
1360721760,1143142736,1,79,79,1360721734423,1360721734423,1143117159,1143117159,0
1360721760,1143142824,1,79,79,1360721733308,1360721733308,1143116132,1143116132,0
1360721765,1143147088,5,368,73.6,1360721760415,1360721763231,1143142503,1143145319,2816
1360721765,1143147172,5,368,73.6,1360721761163,1360721763339,1143143335,1143145511,2176
1360721768,1143150920,1,46,46,1360721743774,1360721743774,1143126694,1143126694,0
1360721769,1143151004,1,46,46,1360721743667,1360721743667,1143125671,1143125671,0
1360721769,1143151008,1,89,89,1360721744045,1360721744045,1143126053,1143126053,0
1360721769,1143151008,1,89,89,1360721744172,1360721744172,1143126180,1143126180,0
1360721773,1143155052,7,2261,323,1360721747331,1360721763843,1143129383,1143145895,16512
1360721773,1143155304,2,158,79,1360721765637,1360721770565,1143147941,1143152869,4928
1360721773,1143155312,2,158,79,1360721766207,1360721772543,1143148519,1143154855,6336
1360721781,1143163048,1,89,89,1360721754310,1360721754310,1143136358,1143136358,0
1360721785,1143167000,1,79,79,1360721759091,1360721759091,1143141091,1143141091,0
1360721785,1143167084,1,89,89,1360721757792,1360721757792,1143139876,1143139876,0
1360721793,1143175104,1,79,79,1360721767051,1360721767051,1143149155,1143149155,0
1360721805,1143186996,1,79,79,1360721778298,1360721778298,1143160294,1143160294,0
1360721805,1143187128,2,158,79,1360721780534,1360721800182,1143162662,1143182310,19648
1360721805,1143187128,1,323,323,1360721780532,1360721780532,1143162660,1143162660,0
1360721813,1143195172,2,158,79,1360721785481,1360721811017,1143167653,1143193189,25536
1360721817,1143199024,1,89,89,1360721790622,1360721790622,1143172646,1143172646,0
1360721817,1143199144,1,89,89,1360721790884,1360721790884,1143173028,1143173028,0
1360721821,1143203404,5,352,70.4,1360721817505,1360721819233,1143199909,1143201637,1728
1360721837,1143219228,1,89,89,1360721810257,1360721810257,1143192485,1143192485,0
1360721841,1143223128,1,323,323,1360721814066,1360721814066,1143196194,1143196194,0
1360721845,1143227316,4,184,46,1360721842232,1360721843832,1143224548,1143226148,1600
1360721845,1143227348,5,260,52,1360721839641,1360721842969,1143221989,1143225317,3328
1360721845,1143227348,2,104,52,1360721842969,1360721843801,1143225317,1143226149,832
1360721845,1143227356,5,260,52,1360721840590,1360721843982,1143222946,1143226338,3392
1360721845,1143227388,5,260,52,1360721840942,1360721844398,1143223330,1143226786,3456
1360721845,1143227404,5,260,52,1360721839074,1360721842402,1143221478,1143224806,3328
1360721845,1143227428,5,230,46,1360721839946,1360721843466,1143222374,1143225894,3520
1360721848,1143231012,4,300,75,1360721820545,1360721847745,1143203557,1143230757,27200
1360721853,1143235364,2,104,52,1360721845511,1360721848903,1143227875,1143231267,3392
1360721853,1143235408,5,260,52,1360721844763,1360721848155,1143227171,1143230563,3392
1360721853,1143235412,5,260,52,1360721845528,1360721848920,1143227940,1143231332,3392
1360721853,1143235440,2,92,46,1360721845563,1360721849275,1143228003,1143231715,3712
1360721853,1143235444,5,230,46,1360721846392,1360721849912,1143228836,1143232356,3520
1360721861,1143243408,2,92,46,1360721847260,1360721854876,1143229668,1143237284,7616
1360721865,1143247224,1,79,79,1360721839316,1360721839316,1143221540,1143221540,0
1360721869,1143251352,2,92,46,1360721853780,1360721861268,1143236132,1143243620,7488
1360721869,1143251392,2,92,46,1360721856748,1360721866796,1143239140,1143249188,10048
1360721877,1143259384,1,46,46,1360721852146,1360721852146,1143234530,1143234530,0
1360721877,1143259416,2,92,46,1360721864853,1360721874837,1143247269,1143257253,9984
1360721885,1143267496,2,92,46,1360721871107,1360721881155,1143253603,1143263651,10048
1360721889,1143271304,1,79,79,1360721861891,1360721861891,1143244195,1143244195,0
1360721905,1143287132,1,46,46,1360721877040,1360721877040,1143259172,1143259172,0
1360721905,1143287212,1,75,75,1360721879584,1360721879584,1143261796,1143261796,0
1360721909,1143291152,1,323,323,1360721881115,1360721881115,1143263267,1143263267,0
1360721965,1143347576,4,268,67,1360721956849,1360721963889,1143339425,1143346465,7040
1360721965,1143347596,3,201,67,1360721959264,1360721962272,1143341860,1143344868,3008
1360721969,1143351608,1,46,46,1360721941140,1360721941140,1143323748,1143323748,0
1360721981,1143363420,2,134,67,1360721966478,1360721974478,1143348898,1143356898,8000
1360721989,1143371524,2,113,56.5,1360721971943,1360721983143,1143354467,1143365667,11200
1360722009,1143391944,1,46,46,1360721984194,1360721984194,1143367138,1143367138,0
1360722025,1143407792,1,323,323,1360722000795,1360722000795,1143383587,1143383587,0
1360722052,4076714876,3,156,52,1360722047060,1360722047956,4076709936,4076710832,896
1360722052,4076714876,3,156,52,1360722047127,1360722048087,4076710003,4076710963,960
1360722061,1143443424,3,201,67,1360722054793,1360722057801,1143437217,1143440225,3008
1360722073,1143455908,1,604,604,1360722047140,1360722047140,1143430048,1143430048,0
1360722077,1143459532,2,134,67,1360722061724,1360722069724,1143444256,1143452256,8000
1360722077,1143459548,6,497,82.83333333,1360722071372,1360722075980,1143453920,1143458528,4608
1360722106,1143488032,5,975,195,1360722080974,1360722096014,1143463006,1143478046,15040
1360722106,1143488056,2,178,89,1360722081335,1360722091063,1143463391,1143473119,9728
1360722106,1143488116,1,46,46,1360722079740,1360722079740,1143461856,1143461856,0
1360722138,1143520016,1,195,195,1360722112095,1360722112095,1143494111,1143494111,0
1360722138,1143520092,1,89,89,1360722110547,1360722110547,1143492639,1143492639,0
1360722148,4076810900,5,408,81.6,1360722139967,1360722144255,4076802867,4076807155,4288
1360722148,4076810904,4,319,79.75,1360722140859,1360722147579,4076803763,4076810483,6720
1360722148,4076810908,5,408,81.6,1360722140276,1360722144884,4076803184,4076807792,4608
1360722148,4076810912,4,319,79.75,1360722140786,1360722145906,4076803698,4076808818,5120
1360722148,4076810912,4,319,79.75,1360722140786,1360722146802,4076803698,4076809714,6016
1360722148,4076810912,3,230,76.66666667,1360722140786,1360722143474,4076803698,4076806386,2688
1360722164,4076826900,2,178,89,1360722148861,1360722159549,4076811761,4076822449,10688
1360722164,4076826904,2,178,89,1360722149179,1360722158971,4076812083,4076821875,9792
1360722164,4076826912,2,178,89,1360722150194,1360722160882,4076813106,4076823794,10688
1360722170,1143552228,1,195,195,1360722143947,1360722143947,1143526175,1143526175,0
1360722172,4076834916,2,178,89,1360722152813,1360722166509,4076815729,4076829425,13696
1360722172,4076834932,2,178,89,1360722154782,1360722170782,4076817714,4076833714,16000
1360722174,1143556056,1,89,89,1360722149558,1360722149558,1143531614,1143531614,0
1360722180,4076842904,2,178,89,1360722156536,1360722174456,4076819440,4076837360,17920
1360722204,4076865972,1,89,89,1360722179550,1360722179550,4076841522,4076841522,0
1360722207,4076869880,1,89,89,1360722180946,1360722180946,4076843826,4076843826,0
1360722207,4076869900,1,89,89,1360722182206,1360722182206,4076845106,4076845106,0
1360722219,4076881916,1,89,89,1360722193964,1360722193964,4076856880,4076856880,0
1360722228,4076889980,1,89,89,1360722203736,1360722203736,4076865716,4076865716,0
1360722234,1143616256,1,195,195,1360722208045,1360722208045,1143590301,1143590301,0
1360722235,4076897932,1,89,89,1360722210335,1360722210335,4076873267,4076873267,0
1360722244,4076905996,1,89,89,1360722218695,1360722218695,4076880691,4076880691,0
1360722251,4076913936,1,89,89,1360722223642,1360722223642,4076886578,4076886578,0
1360722251,4076913944,1,89,89,1360722224786,1360722224786,4076887730,4076887730,0
1360722270,1143652616,3,408,136,1360722244485,1360722250565,1143627101,1143633181,6080
1360722277,1143659756,3,189,63,1360722272059,1360722276027,1143654815,1143658783,3968
1360722290,1143672556,8,1608,201,1360722263426,1360722288258,1143645982,1143670814,24832
1360722293,1143675620,2,126,63,1360722281346,1360722291778,1143663966,1143674398,10432
1360722322,1143704596,1,46,46,1360722296537,1360722296537,1143679133,1143679133,0
1360722326,1143708400,3,603,201,1360722298398,1360722318366,1143680798,1143700766,19968
1360722454,1143836956,1,52,52,1360722429102,1360722429102,1143812058,1143812058,0
1360722573,1143955888,4,268,67,1360722564275,1360722571315,1143947163,1143954203,7040
1360722603,1143985476,1,46,46,1360722576462,1360722576462,1143958938,1143958938,0
1360723086,1144468240,3,181,60.33333333,1360723078064,1360723078768,1144460304,1144461008,704
1360723192,1144574256,2,104,52,1360723164001,1360723166945,1144546257,1144549201,2944
1360723192,1144574264,2,104,52,1360723166170,1360723169242,1144548434,1144551506,3072
1360723192,1144574384,2,104,52,1360723166110,1360723169118,1144548494,1144551502,3008
1360723192,1144574424,2,104,52,1360723164921,1360723167993,1144547345,1144550417,3072
1360723929,1145311752,2,104,52,1360723900900,1360723903844,1145283652,1145286596,2944
1360723929,1145311812,2,104,52,1360723903081,1360723906025,1145285893,1145288837,2944
1360723930,1145312012,2,104,52,1360723902729,1360723905737,1145284741,1145287749,3008
1360723930,1145312016,2,104,52,1360723903877,1360723906821,1145285893,1145288837,2944
1360724114,1145496300,1,46,46,1360724086629,1360724086629,1145468929,1145468929,0
1360764533,1185915684,1,48,48,1360764506119,1360764506119,1185888803,1185888803,0
1360764533,1185915684,1,48,48,1360764506183,1360764506183,1185888867,1185888867,0
1360764533,1185915684,1,48,48,1360764506311,1360764506311,1185888995,1185888995,0
1360764580,1185962608,1,46,46,1360764550035,1360764550035,1185932643,1185932643,0
1360764722,1186104120,2,122,61,1360764695481,1360764697977,1186077601,1186080097,2496
1360765375,1186757344,1,46,46,1360765349006,1360765349006,1186731350,1186731350,0
1360767256,1188638224,4,283,70.75,1360767249899,1360767253675,1188632123,1188635899,3776
1360767271,1188652904,13,4337,333.6153846,1360767244459,1360767257515,1188626363,1188639419,13056
1360767280,1188662128,3,168,56,1360767273420,1360767274188,1188655548,1188656316,768
1360767280,1188662164,3,168,56,1360767275367,1360767276519,1188657531,1188658683,1152
1360767280,1188662168,3,168,56,1360767273377,1360767274145,1188655545,1188656313,768
1360767280,1188662172,5,272,54.4,1360767276256,1360767279136,1188658428,1188661308,2880
1360767282,1188664812,2,155,77.5,1360767255582,1360767256990,1188638394,1188639802,1408
1360767288,1188670212,4,283,70.75,1360767281142,1360767286646,1188663354,1188668858,5504
1360767292,1188674248,1,64,64,1360767289170,1360767289170,1188671418,1188671418,0
1360767292,1188674416,14,5714,408.1428571,1360767277993,1360767287977,1188660409,1188670393,9984
1360767292,1188674456,1,46,46,1360767278276,1360767278276,1188660732,1188660732,0
1360767292,1188674460,4,220,55,1360767287743,1360767288831,1188670203,1188671291,1088
1360767292,1188674464,1,52,52,1360767287740,1360767287740,1188670204,1188670204,0
1360767292,1188674500,1,52,52,1360767287893,1360767287893,1188670393,1188670393,0
1360767293,1188674892,3,168,56,1360767290488,1360767291640,1188672380,1188673532,1152
1360767293,1188674972,1,64,64,1360767278502,1360767278502,1188660474,1188660474,0
1360767319,1188700896,1,64,64,1360767292147,1360767292147,1188674043,1188674043,0
1360767323,1188704868,15,2687,179.1333333,1360767296461,1360767313549,1188678329,1188695417,17088
1360767327,1188709024,3,192,64,1360767302704,1360767306096,1188684728,1188688120,3392
1360767328,1188710168,5,284,56.8,1360767321313,1360767326817,1188703481,1188708985,5504
1360767336,1188718180,3,219,73,1360767335061,1360767335701,1188717241,1188717881,640
1360767336,1188718192,3,156,52,1360767329481,1360767334985,1188711673,1188717177,5504
1360767343,1188724972,9,3463,384.7777778,1360767316198,1360767316646,1188698170,1188698618,448
1360767363,1188744892,1,52,52,1360767336374,1360767336374,1188718266,1188718266,0
1360767363,1188744968,1,64,64,1360767336426,1360767336426,1188718394,1188718394,0
1360767387,1188768988,3,240,80,1360767362711,1360767366231,1188744699,1188748219,3520
1360767408,1188790192,4,271,67.75,1360767405576,1360767405768,1188787768,1188787960,192
1360767408,1188790256,3,168,56,1360767405384,1360767405448,1188787640,1188787704,64
1360767415,1188796992,1,46,46,1360767390544,1360767390544,1188772536,1188772536,0
1360767415,1188796992,1,64,64,1360767390607,1360767390607,1188772599,1188772599,0
1360767416,1188798236,4,271,67.75,1360767414814,1360767414878,1188797050,1188797114,64
1360767419,1188801032,17,4370,257.0588235,1360767391399,1360767397671,1188773431,1188779703,6272
1360767419,1188801048,1,52,52,1360767391703,1360767391703,1188773751,1188773751,0
1360767440,1188822256,2,131,65.5,1360767436230,1360767436230,1188818486,1188818486,0
1360767443,1188825280,1,64,64,1360767414894,1360767414894,1188797174,1188797174,0
1360767451,1188833296,1,220,220,1360767425566,1360767425566,1188807862,1188807862,0
1360767483,1188865176,1,64,64,1360767455638,1360767455638,1188837814,1188837814,0
1360767483,1188865252,19,4501,236.8947368,1360767456203,1360767461643,1188838455,1188843895,5440
1360767483,1188865284,1,52,52,1360767457196,1360767457196,1188839480,1188839480,0
1360767496,1188878276,3,168,56,1360767491956,1360767492532,1188874232,1188874808,576
1360767519,1188901256,1,52,52,1360767494277,1360767494277,1188876533,1188876533,0
1360767519,1188901320,1,64,64,1360767492809,1360767492809,1188875129,1188875129,0
1360767519,1188901320,21,4605,219.2857143,1360767492808,1360767504328,1188875128,1188886648,11520
1360767539,1188921236,1,46,46,1360767512921,1360767512921,1188895157,1188895157,0
1360767579,1188961344,3,240,80,1360767554223,1360767570479,1188936567,1188952823,16256
1360767643,1189025364,3,391,130.3333333,1360767617051,1360767621147,1188999415,1189003511,4096
1360767715,1189097384,1,52,52,1360767689155,1360767689155,1189071539,1189071539,0
1360767864,1189246492,3,168,56,1360767861909,1360767862549,1189244401,1189245041,640
1360767864,1189246524,3,168,56,1360767860470,1360767861558,1189242994,1189244082,1088
1360767887,1189269660,18,4026,223.6666667,1360767860205,1360767865581,1189242865,1189248241,5376
1360767887,1189269704,1,52,52,1360767862209,1360767862209,1189244913,1189244913,0
1360767888,1189270484,13,3571,274.6923077,1360767884060,1360767886364,1189266544,1189268848,2304
1360767888,1189270516,19,6864,361.2631579,1360767877244,1360767883324,1189259760,1189265840,6080
1360767888,1189270532,18,4466,248.1111111,1360767883695,1360767885231,1189266227,1189267763,1536
1360767888,1189270532,13,3571,274.6923077,1360767884012,1360767886700,1189266544,1189269232,2688
1360767888,1189270568,13,3583,275.6153846,1360767886280,1360767887688,1189268848,1189270256,1408
1360767891,1189273588,1,64,64,1360767864181,1360767864181,1189246769,1189246769,0
1360767911,1189293640,11,5027,457,1360767885378,1360767886722,1189268018,1189269362,1344
1360767944,1189325920,1,487,487,1360767916369,1360767916369,1189298289,1189298289,0
1360768008,1189390728,2,131,65.5,1360768006504,1360768006504,1189389232,1189389232,0
1360768096,1189478676,25,16620,664.8,1360768075545,1360768090521,1189458221,1189473197,14976
1360768100,1189482464,1,52,52,1360768075119,1360768075119,1189457583,1189457583,0
1360768104,1189486792,17,3358,197.5294118,1360768095079,1360768097191,1189477871,1189479983,2112
1360768108,1189490460,51,47239,926.254902,1360768082865,1360768106737,1189465325,1189489197,23872
1360768120,1189502368,7,3438,491.1428571,1360768093836,1360768095052,1189476204,1189477420,1216
1360768233,1189614980,2,131,65.5,1360768227089,1360768227089,1189609069,1189609069,0
1360768233,1189615016,3,168,56,1360768225387,1360768225451,1189607403,1189607467,64
1360768249,1189630984,3,168,56,1360768243661,1360768243789,1189625645,1189625773,128
1360768249,1189631056,3,168,56,1360768243523,1360768243651,1189625579,1189625707,128
1360768253,1189634852,1,64,64,1360768225681,1360768225681,1189607533,1189607533,0
1360768253,1189634904,9,2327,258.5555556,1360768228634,1360768251226,1189610538,1189633130,22592
1360768256,1189638780,1,52,52,1360768228593,1360768228593,1189611373,1189611373,0
1360768261,1189642868,1,64,64,1360768233664,1360768233664,1189615532,1189615532,0
1360768265,1189646844,7,2757,393.8571429,1360768236890,1360768237274,1189618734,1189619118,384
1360768265,1189647076,2,110,55,1360768243761,1360768257905,1189625837,1189639981,14144
1360768277,1189658864,17,4399,258.7647059,1360768250948,1360768270148,1189632812,1189652012,19200
1360768289,1189671164,3,168,56,1360768284886,1360768285014,1189667050,1189667178,128
1360768289,1189671164,3,168,56,1360768285079,1360768285207,1189667243,1189667371,128
1360768297,1189679160,3,168,56,1360768295322,1360768295386,1189677482,1189677546,64
1360768297,1189679204,2,110,55,1360768274801,1360768296561,1189657005,1189678765,21760
1360768313,1189694924,1,64,64,1360768285512,1360768285512,1189667436,1189667436,0
1360768313,1189695056,1,46,46,1360768285314,1360768285314,1189667370,1189667370,0
1360768329,1189710980,9,3463,384.7777778,1360768304079,1360768305551,1189686059,1189687531,1472
1360768357,1189739024,1,220,220,1360768331937,1360768331937,1189713961,1189713961,0
1360768361,1189743036,1,52,52,1360768335384,1360768335384,1189717420,1189717420,0
1360768401,1189783416,2,116,58,1360768374426,1360768374618,1189756842,1189757034,192
1360768433,1189815512,2,131,65.5,1360768424951,1360768424951,1189807463,1189807463,0
1360768501,1189883432,1,52,52,1360768476679,1360768476679,1189859111,1189859111,0
1360768521,1189903368,2,188,94,1360768494664,1360768494664,1189877032,1189877032,0
1360768578,1189959840,3,168,56,1360768575575,1360768576599,1189957415,1189958439,1024
1360768602,1189983964,1,64,64,1360768576793,1360768576793,1189958757,1189958757,0
1360768606,1189987816,1,52,52,1360768580911,1360768580911,1189962727,1189962727,0
1360768606,1189987852,18,5436,302,1360768578762,1360768582218,1189960614,1189964070,3456
1360768642,1190024124,1,46,46,1360768616378,1360768616378,1189998502,1189998502,0
1360768870,1190252724,8,3390,423.75,1360768844767,1360768846239,1190227491,1190228963,1472
1360768902,1190284728,1,462,462,1360768877402,1360768877402,1190260130,1190260130,0
1360768982,1190364724,1,64,64,1360768953884,1360768953884,1190336608,1190336608,0
1360768982,1190364792,17,3966,233.2941176,1360768956889,1360768960025,1190339681,1190342817,3136
1360768986,1190368760,1,52,52,1360768958394,1360768958394,1190341154,1190341154,0
1360769018,1190399964,3,168,56,1360769016340,1360769016596,1190398304,1190398560,256
1360769018,1190400044,3,168,56,1360769016902,1360769017798,1190398946,1190399842,896
1360769026,1190408016,14,3214,229.5714286,1360769017824,1360769019744,1190399840,1190401760,1920
1360769039,1190420812,3,573,191,1360769012845,1360769013485,1190394657,1190395297,640
1360769042,1190424028,2,110,55,1360769021076,1360769035220,1190403104,1190417248,14144
1360769042,1190424720,7,3438,491.1428571,1360769015520,1360769016416,1190398240,1190399136,896
1360769042,1190424744,9,3463,384.7777778,1360769015817,1360769017417,1190398561,1190400161,1600
1360769042,1190424752,13,7046,542,1360769016769,1360769019841,1190399521,1190402593,3072
1360769066,1190447960,7,1609,229.8571429,1360769058458,1360769059738,1190440418,1190441698,1280
1360769114,1190496792,1,52,52,1360769086169,1360769086169,1190468961,1190468961,0
1360769122,1190504808,1,487,487,1360769094981,1360769094981,1190477789,1190477789,0
1360769146,1190528072,2,131,65.5,1360769137893,1360769137893,1190519965,1190519965,0
1360769187,1190569052,1,283,283,1360769159930,1360769159930,1190541982,1190541982,0
1360769219,1190601012,1,191,191,1360769192610,1360769192610,1190574622,1190574622,0
1360769219,1190601016,4,644,161,1360769193502,1360769193694,1190575518,1190575710,192
1360769267,1190649180,1,52,52,1360769240378,1360769240378,1190622558,1190622558,0
1360769283,1190665140,1,52,52,1360769256993,1360769256993,1190639133,1190639133,0
1360769354,1190736248,3,168,56,1360769347445,1360769347637,1190729693,1190729885,192
1360769375,1190757400,17,4395,258.5294118,1360769350554,1360769356698,1190732954,1190739098,6144
1360769379,1190761436,1,52,52,1360769350966,1360769350966,1190733402,1190733402,0
1360769386,1190768248,2,110,55,1360769368754,1360769378866,1190751002,1190761114,10112
1360769386,1190768300,3,168,56,1360769378817,1360769378945,1190761117,1190761245,128
1360769407,1190789468,1,64,64,1360769378837,1360769378837,1190761305,1190761305,0
1360769443,1190825472,4,498,124.5,1360769416721,1360769433809,1190799193,1190816281,17088
1360769443,1190825488,11,4252,386.5454545,1360769415044,1360769417796,1190797532,1190800284,2752
1360769459,1190841488,1,52,52,1360769433281,1360769433281,1190815769,1190815769,0
1360769471,1190853472,9,3463,384.7777778,1360769443860,1360769444500,1190826332,1190826972,640
1360769471,1190853512,2,339,169.5,1360769446440,1360769446504,1190828952,1190829016,64
1360769556,1190937904,1,52,52,1360769530570,1360769530570,1190912474,1190912474,0
1360769570,1190952564,4,289,72.25,1360769564277,1360769565109,1190946841,1190947673,832
1360769664,1191046016,2,487,243.5,1360769636248,1360769636248,1191018264,1191018264,0
1360769684,1191066372,1,52,52,1360769657908,1360769657908,1191040280,1191040280,0
1360769796,1191178392,7,1981,283,1360769771548,1360769788380,1191153940,1191170772,16832
1360769824,1191206528,3,849,283,1360769798229,1360769818261,1191180757,1191200789,20032
1360769856,1191238800,1,283,283,1360769827971,1360769827971,1191210771,1191210771,0
1360769874,1191256692,3,168,56,1360769867312,1360769868464,1191250004,1191251156,1152
1360769890,1191272652,2,110,55,1360769869527,1360769886743,1191252179,1191269395,17216
1360769890,1191272736,3,168,56,1360769886596,1360769886724,1191269332,1191269460,128
1360769897,1191278848,22,6105,277.5,1360769870843,1360769883579,1191252691,1191265427,12736
1360769898,1191280644,22,9408,427.6363636,1360769896222,1360769897310,1191278866,1191279954,1088
1360769898,1191280768,20,3490,174.5,1360769895139,1360769895779,1191277907,1191278547,640
1360769898,1191280772,21,3536,168.3809524,1360769895521,1360769896033,1191278293,1191278805,512
1360769906,1191288648,3,168,56,1360769904411,1360769904539,1191287059,1191287187,128
1360769906,1191288656,20,3933,196.65,1360769901522,1360769902674,1191284178,1191285330,1152
1360769906,1191288660,23,3924,170.6086957,1360769899086,1360769900174,1191281746,1191282834,1088
1360769906,1191288692,11,5526,502.3636364,1360769894512,1360769901232,1191277204,1191283924,6720
1360769906,1191288700,18,5422,301.2222222,1360769897897,1360769898537,1191280597,1191281237,640
1360769906,1191288724,14,6710,479.2857143,1360769898896,1360769899728,1191281620,1191282452,832
1360769906,1191288732,15,3483,232.2,1360769897480,1360769897864,1191280212,1191280596,384
1360769906,1191288764,17,3391,199.4705882,1360769899688,1360769900328,1191282452,1191283092,640
1360769909,1191290896,10,4479,447.9,1360769882059,1360769884043,1191263955,1191265939,1984
1360769913,1191294892,1,64,64,1360769887629,1360769887629,1191269521,1191269521,0
1360769914,1191296784,8,4232,529,1360769902611,1360769913363,1191285395,1191296147,10752
1360769922,1191304664,2,92,46,1360769914761,1360769917321,1191297425,1191299985,2560
1360769925,1191306912,1,52,52,1360769898300,1360769898300,1191280212,1191280212,0
1360769925,1191306960,21,5461,260.047619,1360769897930,1360769904586,1191279890,1191286546,6656
1360769938,1191320680,2,92,46,1360769922427,1360769932411,1191305107,1191315091,9984
1360769954,1191336712,2,92,46,1360769942361,1360769952409,1191325073,1191335121,10048
1360770010,1191392704,6,447,74.5,1360770002851,1360770006755,1191385555,1191389459,3904
1360770026,1191408704,2,158,79,1360770010848,1360770019168,1191393552,1191401872,8320
1360770026,1191408804,3,168,56,1360770019903,1360770020031,1191402707,1191402835,128
1360770045,1191427372,1,64,64,1360770020462,1360770020462,1191402834,1191402834,0
1360770049,1191431300,6,312,52,1360770024565,1360770033909,1191406865,1191416209,9344
1360770049,1191431364,16,4566,285.375,1360770023670,1360770046838,1191406034,1191429202,23168
1360770073,1191455272,6,1710,285,1360770045970,1360770066194,1191428242,1191448466,20224
1360770085,1191467264,4,337,84.25,1360770056919,1360770083799,1191439183,1191466063,26880
1360770101,1191483392,3,855,285,1360770076057,1360770096089,1191458449,1191478481,20032
1360770130,1191512788,17,3581,210.6470588,1360770127117,1360770128909,1191509905,1191511697,1792
1360770131,1191512828,16,3306,206.625,1360770123661,1360770125197,1191505489,1191507025,1536
1360770131,1191512840,23,8785,381.9565217,1360770125182,1360770127998,1191507022,1191509838,2816
1360770133,1191515352,1,285,285,1360770106111,1360770106111,1191488463,1191488463,0
1360770138,1191520752,14,6710,479.2857143,1360770129006,1360770130350,1191511758,1191513102,1344
1360770138,1191520756,16,3935,245.9375,1360770134059,1360770135659,1191516815,1191518415,1600
1360770138,1191520788,15,3198,213.2,1360770132300,1360770134028,1191515088,1191516816,1728
1360770138,1191520800,15,3293,219.5333333,1360770130430,1360770131902,1191513230,1191514702,1472
1360770145,1191527424,1,64,64,1360770118647,1360770118647,1191501071,1191501071,0
1360770147,1191528852,24,3763,156.7916667,1360770140213,1360770141813,1191522065,1191523665,1600
1360770147,1191528852,3,168,56,1360770140213,1360770140789,1191522065,1191522641,576
1360770147,1191528860,3,168,56,1360770141228,1360770141868,1191523088,1191523728,640
1360770147,1191528860,60,65261,1087.683333,1360770136554,1360770140138,1191518414,1191521998,3584
1360770153,1191535644,21,4352,207.2380952,1360770126813,1360770143965,1191509457,1191526609,17152
1360770154,1191536732,21,3443,163.952381,1360770141125,1360770147269,1191523857,1191530001,6144
1360770157,1191539612,1,64,64,1360770129147,1360770129147,1191511759,1191511759,0
1360770161,1191543696,93,114255,1228.548387,1360770134502,1360770144806,1191517198,1191527502,10304
1360770161,1191543696,23,22844,993.2173913,1360770134502,1360770137638,1191517198,1191520334,3136
1360770169,1191551700,1,46,46,1360770141156,1360770141156,1191523856,1191523856,0
1360770169,1191551704,1,64,64,1360770141791,1360770141791,1191524495,1191524495,0
1360770171,1191552856,2,131,65.5,1360770168048,1360770168048,1191549904,1191549904,0
1360770178,1191560780,2,131,65.5,1360770173970,1360770173970,1191556750,1191556750,0
1360770259,1191640912,7,5023,717.5714286,1360770247286,1360770255030,1191629198,1191636942,7744
1360770265,1191647784,17,11034,649.0588235,1360770240463,1360770243279,1191623247,1191626063,2816
1360770267,1191648968,2,116,58,1360770266174,1360770266494,1191648142,1191648462,320
1360770267,1191648980,3,168,56,1360770263985,1360770264625,1191645965,1191646605,640
1360770267,1191649008,3,168,56,1360770264854,1360770265494,1191646862,1191647502,640
1360770275,1191656828,2,131,65.5,1360770274187,1360770274187,1191656015,1191656015,0
1360770275,1191656832,4,271,67.75,1360770267719,1360770268743,1191649551,1191650575,1024
1360770275,1191656868,3,168,56,1360770269090,1360770269538,1191650958,1191651406,448
1360770289,1191671792,1,1500,1500,1360770263236,1360770263236,1191646028,1191646028,0
1360770290,1191671844,1,46,46,1360770263416,1360770263416,1191645260,1191645260,0
1360770293,1191675804,1,52,52,1360770268280,1360770268280,1191651084,1191651084,0
1360770294,1191675832,1,52,52,1360770267140,1360770267140,1191648972,1191648972,0
1360770294,1191675840,21,4734,225.4285714,1360770266239,1360770292799,1191648079,1191674639,26560
1360770294,1191675884,10,3574,357.4,1360770269521,1360770271377,1191651405,1191653261,1856
1360770297,1191679764,1,64,64,1360770268963,1360770268963,1191651727,1191651727,0
1360770297,1191679772,1,46,46,1360770269722,1360770269722,1191652494,1191652494,0
1360770302,1191683856,81,97430,1202.839506,1360770274285,1360770283501,1191656141,1191665357,9216
1360770315,1191696936,2,131,65.5,1360770312798,1360770312798,1191694734,1191694734,0
1360770362,1191744112,3,1548,516,1360770334827,1360770335147,1191716939,1191717259,320
1360770370,1191752256,1,46,46,1360770344923,1360770344923,1191727179,1191727179,0
1360770390,1191772276,1,52,52,1360770364998,1360770364998,1191747274,1191747274,0
1360770395,1191776896,2,131,65.5,1360770391171,1360770391171,1191773067,1191773067,0
1360770395,1191776980,2,116,58,1360770393518,1360770394222,1191775498,1191776202,704
1360770403,1191784928,3,168,56,1360770395365,1360770395877,1191777293,1191777805,512
1360770410,1191792192,1,64,64,1360770382554,1360770382554,1191764746,1191764746,0
1360770419,1191800904,3,168,56,1360770416123,1360770416955,1191798027,1191798859,832
1360770419,1191800932,2,116,58,1360770418335,1360770418655,1191800267,1191800587,320
1360770419,1191800980,3,168,56,1360770417328,1360770417904,1191799308,1191799884,576
1360770422,1191804188,1,52,52,1360770394785,1360770394785,1191776973,1191776973,0
1360770427,1191808956,3,168,56,1360770419526,1360770420358,1191801482,1191802314,832
1360770442,1191824316,17,3966,233.2941176,1360770416286,1360770419934,1191798602,1191802250,3648
1360770446,1191828284,1,52,52,1360770418112,1360770418112,1191800396,1191800396,0
1360770446,1191828284,1,52,52,1360770418814,1360770418814,1191801098,1191801098,0
1360770466,1191848612,1,46,46,1360770440118,1360770440118,1191822730,1191822730,0
1360770474,1191856628,1,487,487,1360770448549,1360770448549,1191831177,1191831177,0
1360770498,1191880592,7,4143,591.8571429,1360770472716,1360770473292,1191855308,1191855884,576
1360770498,1191880592,26,16003,615.5,1360770472906,1360770494090,1191855498,1191876682,21184
1360770498,1191880664,57,57313,1005.491228,1360770472834,1360770493378,1191855498,1191876042,20544
1360770507,1191888976,2,131,65.5,1360770503924,1360770503924,1191885900,1191885900,0
1360770523,1191904972,24,20761,865.0416667,1360770503157,1360770518581,1191885129,1191900553,15424
1360770523,1191905048,11,7519,683.5454545,1360770500841,1360770518441,1191882889,1191900489,17600
1360770531,1191913028,2,92,46,1360770529406,1360770529406,1191911434,1191911434,0
1360770542,1191924808,1,431,431,1360770517488,1360770517488,1191900296,1191900296,0
1360770554,1191936804,16,13875,867.1875,1360770528693,1360770532661,1191911497,1191915465,3968
1360770566,1191948724,11,5906,536.9090909,1360770539142,1360770539654,1191921866,1191922378,512
1360770571,1191953004,2,131,65.5,1360770563477,1360770563477,1191945481,1191945481,0
1360770571,1191953096,2,131,65.5,1360770570298,1360770570298,1191952394,1191952394,0
1360770610,1191992816,2,517,258.5,1360770585386,1360770600170,1191968202,1191982986,14784
1360770627,1192009060,9,6034,670.4444444,1360770600990,1360770601566,1191983050,1191983626,576
1360770627,1192009184,1,46,46,1360770600799,1360770600799,1191982983,1191982983,0
1360770631,1192013028,16,16643,1040.1875,1360770604349,1360770605181,1191986377,1191987209,832
1360770635,1192017244,2,131,65.5,1360770631396,1360770631396,1192013640,1192013640,0
1360770651,1192033096,1,46,46,1360770623737,1360770623737,1192005833,1192005833,0
1360770659,1192041184,9,3463,384.7777778,1360770633120,1360770633632,1192015304,1192015816,512
1360770675,1192057352,9,2977,330.7777778,1360770673399,1360770674807,1192055751,1192057159,1408
1360770675,1192057360,10,3036,303.6,1360770670638,1360770672494,1192052998,1192054854,1856
1360770675,1192057360,4,1415,353.75,1360770670706,1360770670770,1192053066,1192053130,64
1360770675,1192057360,4,1416,354,1360770670769,1360770670833,1192053129,1192053193,64
1360770675,1192057396,10,3036,303.6,1360770672462,1360770673486,1192054858,1192055882,1024
1360770683,1192065320,35,38195,1091.285714,1360770676121,1360770678297,1192058441,1192060617,2176
1360770683,1192065320,5,1510,302,1360770676375,1360770676567,1192058695,1192058887,192
1360770683,1192065324,5,1408,281.6,1360770676437,1360770676565,1192058761,1192058889,128
1360770683,1192065324,172,239555,1392.761628,1360770672021,1360770682069,1192054345,1192064393,10048
1360770683,1192065324,11,2854,259.4545455,1360770680658,1360770682002,1192062982,1192064326,1344
1360770683,1192065352,2,112,56,1360770670134,1360770680182,1192052486,1192062534,10048
1360770683,1192065360,11,4565,415,1360770679089,1360770680625,1192061449,1192062985,1536
1360770683,1192065364,4,1506,376.5,1360770676076,1360770676204,1192058440,1192058568,128
1360770683,1192065368,16,17632,1102,1360770676586,1360770676778,1192058954,1192059146,192
1360770683,1192065400,2,112,56,1360770670087,1360770680135,1192052487,1192062535,10048
1360770683,1192065400,2,112,56,1360770670087,1360770680135,1192052487,1192062535,10048
1360770683,1192065404,104,131252,1262.038462,1360770493701,1360770675397,1191876105,1192057801,181696
1360770687,1192069024,9,2924,324.8888889,1360770674878,1360770676414,1192056902,1192058438,1536
1360770687,1192069216,12,5553,462.75,1360770660799,1360770662591,1192043015,1192044807,1792
1360770691,1192073224,1,285,285,1360770665910,1360770665910,1192048134,1192048134,0
1360770691,1192073316,11,4463,405.7272727,1360770686685,1360770688541,1192069001,1192070857,1856
1360770691,1192073316,5,1020,204,1360770686939,1360770687771,1192069255,1192070087,832
1360770691,1192073324,10,2976,297.6,1360770684053,1360770688533,1192066377,1192070857,4480
1360770691,1192073356,25,21446,857.84,1360770682035,1360770684211,1192064391,1192066567,2176
1360770691,1192073392,1183,1680291,1420.364328,1360770671952,1360770683152,1192054344,1192065544,11200
1360770691,1192073392,4,228,57,1360770676559,1360770690511,1192058951,1192072903,13952
1360770691,1192073392,4,228,57,1360770676558,1360770690510,1192058950,1192072902,13952
1360770691,1192073392,5,280,56,1360770676558,1360770690510,1192058950,1192072902,13952
1360770691,1192073408,104,110589,1063.355769,1360770481280,1360770684736,1191863688,1192067144,203456
1360770695,1192077168,9,3994,443.7777778,1360770666864,1360770675632,1192049032,1192057800,8768
1360770695,1192077292,3,298,99.33333333,1360770670196,1360770670196,1192052488,1192052488,0
1360770695,1192077292,8,3789,473.625,1360770670578,1360770671154,1192052870,1192053446,576
1360770699,1192081416,3,162,54,1360770690998,1360770691574,1192073414,1192073990,576
1360770699,1192081420,4,208,52,1360770690994,1360770691570,1192073414,1192073990,576
1360770699,1192081420,4,208,52,1360770690997,1360770691573,1192073417,1192073993,576
1360770699,1192081444,6,420,70,1360770692380,1360770696668,1192074824,1192079112,4288
1360770699,1192081456,2,127,63.5,1360770697297,1360770697297,1192079753,1192079753,0
1360770703,1192085168,7,3509,501.2857143,1360770675502,1360770675886,1192057670,1192058054,384
1360770703,1192085200,3,514,171.3333333,1360770677006,1360770677070,1192059206,1192059270,64
1360770739,1192121196,3,240,80,1360770712979,1360770714707,1192095175,1192096903,1728
1360770751,1192133264,1,46,46,1360770726670,1360770726670,1192108934,1192108934,0
1360770751,1192133344,21,12658,602.7619048,1360770726589,1360770732413,1192108933,1192114757,5824
1360770755,1192137460,2,131,65.5,1360770753228,1360770753228,1192135688,1192135688,0
1360770759,1192141296,1,46,46,1360770731629,1360770731629,1192113925,1192113925,0
1360770759,1192141296,18,18341,1018.944444,1360770731695,1360770731823,1192113991,1192114119,128
1360770763,1192145476,2,131,65.5,1360770762233,1360770762233,1192144709,1192144709,0
1360770795,1192177492,2,131,65.5,1360770790889,1360770790889,1192173381,1192173381,0
1360770807,1192189736,1,46,46,1360770781687,1360770781687,1192164423,1192164423,0
1360770807,1192189736,9,5338,593.1111111,1360770781685,1360770782133,1192164421,1192164869,448
1360770819,1192201540,3,210,70,1360770812346,1360770812666,1192194886,1192195206,320
1360770832,1192213832,1,285,285,1360770806141,1360770806141,1192187973,1192187973,0
1360770884,1192266200,2,116,58,1360770857420,1360770857932,1192239620,1192240132,512
1360770915,1192297548,3,159,53,1360770907569,1360770907569,1192290117,1192290117,0
1360770919,1192301812,3,379,126.3333333,1360770893158,1360770916582,1192275970,1192299394,23424
1360770932,1192314088,13,9988,768.3076923,1360770903866,1360770905146,1192285954,1192287234,1280
1360770932,1192314092,21,17414,829.2380952,1360770903862,1360770922038,1192285954,1192304130,18176
1360770936,1192318004,2,104,52,1360770910542,1360770912270,1192292546,1192294274,1728
1360770936,1192318032,31,31415,1013.387097,1360770908084,1360770929588,1192290116,1192311620,21504
1360770936,1192318036,9,6125,680.5555556,1360770908082,1360770908338,1192290118,1192290374,256
1360770939,1192321648,2,131,65.5,1360770934602,1360770934602,1192317250,1192317250,0
1360770940,1192321960,1,52,52,1360770915836,1360770915836,1192297796,1192297796,0
1360770944,1192325968,1,46,46,1360770917299,1360770917299,1192299267,1192299267,0
1360770944,1192326008,1,52,52,1360770916045,1360770916045,1192298053,1192298053,0
1360770948,1192330004,13,7040,541.5384615,1360770923281,1360770924625,1192305285,1192306629,1344
1360770955,1192337632,2,131,65.5,1360770948379,1360770948379,1192331011,1192331011,0
1360770960,1192342028,1,46,46,1360770935607,1360770935607,1192317635,1192317635,0
1360770963,1192345576,2,92,46,1360770956565,1360770956693,1192339141,1192339269,128
1360770963,1192345576,2,92,46,1360770956692,1360770956692,1192339268,1192339268,0
1360770984,1192365984,30,23689,789.6333333,1360770957282,1360770978146,1192339266,1192360130,20864
1360770984,1192366064,16,12647,790.4375,1360770957203,1360770964627,1192339267,1192346691,7424
1360770984,1192366068,13,5774,444.1538462,1360770957456,1360770962384,1192339524,1192344452,4928
1360770995,1192377572,2,131,65.5,1360770991830,1360770991830,1192374402,1192374402,0
1360770996,1192378148,24,26441,1101.708333,1360770968256,1360770968768,1192350404,1192350916,512
1360771003,1192385564,5,2078,415.6,1360770983454,1360771001822,1192366018,1192384386,18368
1360771003,1192385564,8,4882,610.25,1360770983453,1360771001821,1192366017,1192384385,18368
1360771003,1192385620,4,184,46,1360770995496,1360770995496,1192378116,1192378116,0
1360771004,1192385988,1,46,46,1360770979488,1360770979488,1192361476,1192361476,0
1360771004,1192385988,9,5907,656.3333333,1360770979551,1360770979999,1192361539,1192361987,448
1360771019,1192401672,2,141,70.5,1360771016116,1360771016116,1192398788,1192398788,0
1360771024,1192406084,9,3463,384.7777778,1360770996094,1360770996670,1192378178,1192378754,576
1360771027,1192409592,2,92,46,1360771025028,1360771025028,1192407620,1192407620,0
1360771048,1192430108,1,46,46,1360771022760,1360771022760,1192404868,1192404868,0
1360771048,1192430108,11,5703,518.4545455,1360771022823,1360771023335,1192404931,1192405443,512
1360771052,1192434044,17,12406,729.7647059,1360771025573,1360771033189,1192407617,1192415233,7616
1360771056,1192438168,14,16866,1204.714286,1360771031659,1360771032235,1192413827,1192414403,576
1360771059,1192441664,2,131,65.5,1360771052795,1360771052795,1192435459,1192435459,0
1360771067,1192449748,5,368,73.6,1360771062504,1360771064616,1192445252,1192447364,2112
1360771091,1192473652,5,314,62.8,1360771088132,1360771089860,1192470784,1192472512,1728
1360771092,1192474044,3,237,79,1360771067751,1360771082407,1192449795,1192464451,14656
1360771099,1192481604,3,180,60,1360771091894,1360771098870,1192474498,1192481474,6976
1360771123,1192505628,3,210,70,1360771115998,1360771116254,1192498626,1192498882,256
1360771124,1192506124,1,52,52,1360771099413,1360771099413,1192481537,1192481537,0
1360771124,1192506144,5,816,163.2,1360771097282,1360771099010,1192479426,1192481154,1728
1360771128,1192510148,3,567,189,1360771100031,1360771100223,1192482179,1192482371,192
1360771144,1192526288,10,5448,544.8,1360771117809,1360771118641,1192500097,1192500929,832
1360771155,1192537708,2,131,65.5,1360771148236,1360771148236,1192530944,1192530944,0
1360771156,1192538180,1,46,46,1360771128413,1360771128413,1192510593,1192510593,0
1360771156,1192538180,1,46,46,1360771128731,1360771128731,1192510911,1192510911,0
1360771156,1192538256,1,46,46,1360771128655,1360771128655,1192510911,1192510911,0
1360771156,1192538292,2,188,94,1360771130797,1360771130797,1192513089,1192513089,0
1360771208,1192590424,4,812,203,1360771181353,1360771181801,1192563777,1192564225,448
1360771219,1192601716,188,245987,1308.441489,1360770962309,1360771215429,1192345025,1192598145,253120
1360771236,1192618376,1,52,52,1360771211416,1360771211416,1192593792,1192593792,0
1360771304,1192686520,4,1909,477.25,1360771277830,1360771278598,1192660350,1192661118,768
1360771304,1192686596,3,532,177.3333333,1360771276859,1360771283515,1192659455,1192666111,6656
1360771316,1192697840,4,231,57.75,1360771311533,1360771311533,1192693373,1192693373,0
1360771328,1192710540,27,20023,741.5925926,1360771302641,1360771324849,1192685181,1192707389,22208
1360771336,1192718556,9,5907,656.3333333,1360771310883,1360771311459,1192693439,1192694015,576
1360771336,1192718668,33,33897,1027.181818,1360771311602,1360771319026,1192694270,1192701694,7424
1360771340,1192722504,13,8725,671.1538462,1360771312405,1360771324821,1192694909,1192707325,12416
1360771348,1192730568,7,2757,393.8571429,1360771323351,1360771323735,1192705919,1192706303,384
1360771355,1192737732,7,433,61.85714286,1360771347506,1360771352882,1192730238,1192735614,5376
1360771355,1192737776,2,131,65.5,1360771354565,1360771354565,1192737341,1192737341,0
1360771364,1192746576,3,729,243,1360771337868,1360771338252,1192720444,1192720828,384
1360771380,1192762732,16,11044,690.25,1360771352880,1360771362224,1192735612,1192744956,9344
1360771388,1192770612,12,15346,1278.833333,1360771361768,1360771361768,1192744380,1192744380,0
1360771388,1192770700,11,5732,521.0909091,1360771361939,1360771362643,1192744639,1192745343,704
1360771392,1192774576,12,15206,1267.166667,1360771364365,1360771364365,1192746941,1192746941,0
1360771395,1192777812,2,131,65.5,1360771392159,1360771392159,1192774971,1192774971,0
1360771396,1192777820,2,131,65.5,1360771393535,1360771393535,1192775355,1192775355,0
1360771404,1192785848,2,127,63.5,1360771399974,1360771399974,1192781822,1192781822,0
1360771427,1192809792,3,159,53,1360771426293,1360771426293,1192809085,1192809085,0
1360771443,1192825792,4,184,46,1360771436406,1360771436406,1192819198,1192819198,0
1360771448,1192830752,1,46,46,1360771423644,1360771423644,1192806396,1192806396,0
1360771449,1192830840,9,5280,586.6666667,1360771424555,1360771425003,1192806395,1192806843,448
1360771452,1192834704,1,46,46,1360771424909,1360771424909,1192807613,1192807613,0
1360771452,1192834720,12,10392,866,1360771426428,1360771426556,1192809148,1192809276,128
1360771452,1192834784,13,6975,536.5384615,1360771424955,1360771431035,1192807739,1192813819,6080
1360771456,1192838748,14,8942,638.7142857,1360771431008,1360771453216,1192813756,1192835964,22208
1360771459,1192841800,2,131,65.5,1360771454060,1360771454060,1192836860,1192836860,0
1360771464,1192846716,9,3463,384.7777778,1360771436479,1360771436991,1192819195,1192819707,512
1360771468,1192849848,2,131,65.5,1360771461924,1360771461924,1192843772,1192843772,0
1360771484,1192865824,8,4940,617.5,1360771460541,1360771477053,1192842365,1192858877,16512
1360771485,1192866812,11,7203,654.8181818,1360771458057,1360771459017,1192839869,1192840829,960
1360771485,1192866912,1,191,191,1360771457506,1360771457506,1192839418,1192839418,0
1360771492,1192874792,13,15271,1174.692308,1360771467698,1360771467762,1192850490,1192850554,64
1360771493,1192874908,15,16562,1104.133333,1360771466088,1360771466216,1192847996,1192848124,128
1360771496,1192878788,1,52,52,1360771469880,1360771469880,1192852668,1192852668,0
1360771513,1192894828,1,46,46,1360771488184,1360771488184,1192870012,1192870012,0
1360771513,1192894948,11,5698,518,1360771488574,1360771490686,1192870522,1192872634,2112
1360771516,1192897844,8,1655,206.875,1360771514089,1360771515305,1192895933,1192897149,1216
1360771524,1192905880,2,131,65.5,1360771520769,1360771520769,1192902649,1192902649,0
1360771532,1192913932,4,277,69.25,1360771527825,1360771528017,1192909757,1192909949,192
1360771545,1192927012,5,927,185.4,1360771519165,1360771519549,1192901177,1192901561,384
1360771561,1192942932,1,127,127,1360771532941,1360771532941,1192914873,1192914873,0
1360771564,1192945896,2,131,65.5,1360771557684,1360771557684,1192939580,1192939580,0
1360771573,1192954844,1,52,52,1360771548134,1360771548134,1192929978,1192929978,0
1360771625,1193007188,1,46,46,1360771597708,1360771597708,1192979896,1192979896,0
1360771644,1193025940,3,159,53,1360771641223,1360771641223,1193023163,1193023163,0
1360771653,1193035236,3,379,126.3333333,1360771626331,1360771637211,1193008567,1193019447,10880
1360771657,1193039336,28,23247,830.25,1360771631546,1360771645818,1193013882,1193028154,14272
1360771657,1193039336,1,46,46,1360771631545,1360771631545,1193013881,1193013881,0
1360771665,1193047188,3,928,309.3333333,1360771637582,1360771638158,1193019770,1193020346,576
1360771669,1193051192,1,46,46,1360771641607,1360771641607,1193023799,1193023799,0
1360771681,1193063296,1,220,220,1360771653410,1360771653410,1193035706,1193035706,0
1360771684,1193066108,9,4765,529.4444444,1360771674782,1360771676894,1193056890,1193059002,2112
1360771692,1193073980,139,142042,1021.884892,1360771641310,1360771686430,1193023290,1193068410,45120
1360771717,1193099248,13,5894,453.3846154,1360771690833,1360771691665,1193073081,1193073913,832
1360771724,1193106044,2,131,65.5,1360771721885,1360771721885,1193103929,1193103929,0
1360771748,1193130048,13,3571,274.6923077,1360771742679,1360771744663,1193124727,1193126711,1984
1360771748,1193130084,3,138,46,1360771739890,1360771740402,1193121974,1193122486,512
1360771748,1193130108,15,3759,250.6,1360771740380,1360771741980,1193122488,1193124088,1600
1360771748,1193130112,18,4466,248.1111111,1360771742359,1360771743831,1193124471,1193125943,1472
1360771748,1193130116,13,3571,274.6923077,1360771742612,1360771744596,1193124728,1193126712,1984
1360771748,1193130152,13,3571,274.6923077,1360771744559,1360771746287,1193126711,1193128439,1728
1360771770,1193151844,9,3463,384.7777778,1360771744357,1360771745573,1193126201,1193127417,1216
1360771778,1193159920,1,52,52,1360771751191,1360771751191,1193133111,1193133111,0
1360771820,1193202108,141,14593,103.4964539,1360771560027,1360771812059,1192942135,1193194167,252032
1360771822,1193203868,144,14199,98.60416667,1360771560268,1360771812364,1192942136,1193194232,252096
1360771842,1193223996,1,193,193,1360771817417,1360771817417,1193199413,1193199413,0
1360771846,1193227912,8,4072,509,1360771818015,1360771818783,1193199927,1193200695,768
1360771860,1193242124,152,196313,1291.532895,1360771641098,1360771857674,1193023222,1193239798,216576
1360771868,1193250184,2,131,65.5,1360771865167,1360771865167,1193247351,1193247351,0
1360771870,1193251944,1,46,46,1360771844159,1360771844159,1193226103,1193226103,0
1360772022,1193404240,2,339,169.5,1360771997330,1360771997330,1193379570,1193379570,0
1360772052,1193434336,4,184,46,1360772045876,1360772045876,1193428212,1193428212,0
1360772058,1193440508,1,191,191,1360772032585,1360772032585,1193415093,1193415093,0
1360772058,1193440608,8,1456,182,1360772032034,1360772033698,1193414642,1193416306,1664
1360772066,1193448584,15,14283,952.2,1360772039227,1360772065531,1193421811,1193448115,26304
1360772070,1193452560,9,3463,384.7777778,1360772045650,1360772046226,1193428210,1193428786,576
1360772092,1193474300,12,6017,501.4166667,1360772067798,1360772084566,1193450098,1193466866,16768
1360772094,1193476640,1,46,46,1360772068996,1360772068996,1193451636,1193451636,0
1360772094,1193476640,13,10316,793.5384615,1360772069060,1360772070788,1193451700,1193453428,1728
1360772098,1193480556,11,7410,673.6363636,1360772072726,1360772077270,1193455282,1193459826,4544
1360772100,1193482276,2,127,63.5,1360772094511,1360772094511,1193476787,1193476787,0
1360772108,1193490316,2,131,65.5,1360772107526,1360772107526,1193489842,1193489842,0
1360772108,1193490332,11,3916,356,1360772099895,1360772100535,1193482227,1193482867,640
1360772108,1193490400,21,16642,792.4761905,1360772101492,1360772102900,1193483892,1193485300,1408
1360772108,1193490408,11,3952,359.2727273,1360772106027,1360772106539,1193488435,1193488947,512
1360772116,1193498308,11,3938,358,1360772110861,1360772111821,1193493169,1193494129,960
1360772116,1193498316,13,5264,404.9230769,1360772109000,1360772109768,1193491316,1193492084,768
1360772116,1193498348,23,21328,927.3043478,1360772113125,1360772113893,1193495473,1193496241,768
1360772116,1193498388,23,20021,870.4782609,1360772114496,1360772115648,1193496884,1193498036,1152
1360772116,1193498400,23,19423,844.4782609,1360772107506,1360772108210,1193489906,1193490610,704
1360772122,1193504584,1,186,186,1360772095480,1360772095480,1193478064,1193478064,0
1360772122,1193504676,15,9744,649.6,1360772095967,1360772097695,1193478643,1193480371,1728
1360772124,1193506312,14,8129,580.6428571,1360772118730,1360772119306,1193501042,1193501618,576
1360772124,1193506348,23,19825,861.9565217,1360772117221,1360772117989,1193499569,1193500337,768
1360772124,1193506360,13,5488,422.1538462,1360772120986,1360772121562,1193503346,1193503922,576
1360772124,1193506400,13,5524,424.9230769,1360772122547,1360772123187,1193504947,1193505587,640
1360772124,1193506432,14,6923,494.5,1360772119761,1360772120337,1193502193,1193502769,576
1360772126,1193508552,11,5615,510.4545455,1360772098265,1360772098969,1193480817,1193481521,704
1360772132,1193514340,10,3753,375.3,1360772127213,1360772127789,1193509553,1193510129,576
1360772132,1193514344,10,3745,374.5,1360772131177,1360772131689,1193513521,1193514033,512
1360772132,1193514420,112,148543,1326.276786,1360772125023,1360772126431,1193507443,1193508851,1408
1360772132,1193514452,11,3800,345.4545455,1360772123645,1360772124221,1193506097,1193506673,576
1360772132,1193514460,83,99982,1204.60241,1360772128438,1360772129078,1193510898,1193511538,640
1360772132,1193514464,2,131,65.5,1360772129010,1360772129010,1193511474,1193511474,0
1360772132,1193514468,13,6139,472.2307692,1360772129647,1360772130287,1193512115,1193512755,640
1360772140,1193522344,67,84383,1259.447761,1360772132841,1360772133673,1193515185,1193516017,832
1360772140,1193522408,55,63764,1159.345455,1360772134696,1360772135912,1193517104,1193518320,1216
1360772140,1193522420,14,6901,492.9285714,1360772139166,1360772139806,1193521586,1193522226,640
1360772140,1193522452,67,80641,1203.597015,1360772136446,1360772137278,1193518898,1193519730,832
1360772142,1193524548,26,28057,1079.115385,1360772137887,1360772138463,1193520435,1193521011,576
1360772148,1193530332,12,5870,489.1666667,1360772140726,1360772141302,1193523058,1193523634,576
1360772148,1193530376,13,5600,430.7692308,1360772141833,1360772142793,1193524209,1193525169,960
1360772172,1193554324,2,131,65.5,1360772166269,1360772166269,1193548593,1193548593,0
1360772182,1193564616,3,733,244.3333333,1360772156185,1360772156441,1193538801,1193539057,256
1360772255,1193636956,1,46,46,1360772228843,1360772228843,1193610799,1193610799,0
1360772275,1193656992,1,52,52,1360772250055,1360772250055,1193632047,1193632047,0
1360772299,1193681136,1,52,52,1360772273721,1360772273721,1193655857,1193655857,0
1360772303,1193684984,4,644,161,1360772276877,1360772277069,1193658861,1193659053,192
1360772303,1193685020,1,188,188,1360772276077,1360772276077,1193658097,1193658097,0
1360772461,1193842980,4,184,46,1360772459024,1360772459024,1193841004,1193841004,0
1360772483,1193865776,7,2757,393.8571429,1360772458294,1360772458550,1193841070,1193841326,256
1360772525,1193906920,2,104,52,1360772517132,1360772517388,1193899052,1193899308,256
1360772620,1194001980,3,573,191,1360772593420,1360772595404,1193975400,1193977384,1984
1360772620,1194002100,1,46,46,1360772594838,1360772594838,1193976938,1193976938,0
1360772620,1194002128,17,8156,479.7647059,1360772595578,1360772599482,1193977706,1193981610,3904
1360772701,1194083112,2,104,52,1360772699208,1360772699464,1194081320,1194081576,256
1360772744,1194126392,1,191,191,1360772717040,1360772717040,1194099432,1194099432,0
1360772744,1194126504,3,567,189,1360772717633,1360772717953,1194100137,1194100457,320
1360772788,1194170564,4,756,189,1360772760066,1360772760578,1194142630,1194143142,512
1360772824,1194206664,3,756,252,1360772799392,1360772799712,1194182056,1194182376,320
1360772857,1194238964,1,52,52,1360772830809,1360772830809,1194212773,1194212773,0
1360772925,1194306964,1,193,193,1360772897435,1360772897435,1194279399,1194279399,0
1360772925,1194306968,3,567,189,1360772898069,1360772898197,1194280037,1194280165,128
1360773165,1194547212,1,52,52,1360773137951,1360773137951,1194520163,1194520163,0
1360773206,1194588468,1,46,46,1360773180574,1360773180574,1194563042,1194563042,0
1360773489,1194871684,1,46,46,1360773461951,1360773461951,1194844635,1194844635,0
1360773494,1194875824,6,360,60,1360773467231,1360773470175,1194849055,1194851999,2944
1360773542,1194923992,12,636,53,1360773534579,1360773540467,1194916571,1194922459,5888
1360773542,1194924200,5,296,59.2,1360773529507,1360773538211,1194911707,1194920411,8704
1360773566,1194948280,4,256,64,1360773540244,1360773561236,1194922524,1194943516,20992
1360773566,1194948360,9,5236,581.7777778,1360773540098,1360773560706,1194922458,1194943066,20608
1360773574,1194956028,3,168,56,1360773572175,1360773572751,1194954203,1194954779,576
1360773574,1194956068,3,168,56,1360773570919,1360773571815,1194952987,1194953883,896
1360773598,1194980368,1,1426,1426,1360773570682,1360773570682,1194953050,1194953050,0
1360773598,1194980492,1,64,64,1360773572737,1360773572737,1194955229,1194955229,0
1360773602,1194984388,20,4130,206.5,1360773576169,1360773580521,1194958557,1194962909,4352
1360773606,1194988380,1,52,52,1360773578285,1360773578285,1194960665,1194960665,0
1360773688,1195069892,1,46,46,1360773660758,1360773660758,1195042650,1195042650,0
1360773998,1195380196,2,104,52,1360773995363,1360773996707,1195377559,1195378903,1344
1360774006,1195388260,2,104,52,1360773999266,1360774004514,1195381526,1195386774,5248
1360774030,1195412192,2,104,52,1360774014628,1360774024612,1195396820,1195406804,9984
1360774046,1195428272,2,104,52,1360774034516,1360774044564,1195416788,1195426836,10048
1360774079,1195461332,1,52,52,1360774054489,1360774054489,1195436821,1195436821,0
1360774438,1195820480,3,168,56,1360774434301,1360774434877,1195816781,1195817357,576
1360774446,1195828436,14,3214,229.5714286,1360774439339,1360774441515,1195821775,1195823951,2176
1360774446,1195828472,21,8167,388.9047619,1360774441541,1360774443781,1195824013,1195826253,2240
1360774454,1195836444,17,5358,315.1764706,1360774449185,1360774450081,1195831629,1195832525,896
1360774454,1195836480,15,3293,219.5333333,1360774450943,1360774451327,1195833423,1195833807,384
1360774454,1195836524,18,3633,201.8333333,1360774446865,1360774449105,1195829389,1195831629,2240
1360774454,1195836524,15,3198,213.2,1360774452753,1360774453457,1195835277,1195835981,704
1360774454,1195836552,3,168,56,1360774445685,1360774446261,1195828237,1195828813,576
1360774454,1195836552,14,6710,479.2857143,1360774450487,1360774450871,1195833039,1195833423,384
1360774454,1195836552,47,4980,105.9574468,1360774450806,1360774451958,1195833358,1195834510,1152
1360774460,1195842028,1,64,64,1360774435716,1360774435716,1195817744,1195817744,0
1360774462,1195844444,66,65487,992.2272727,1360774453985,1360774456481,1195836429,1195838925,2496
1360774462,1195844452,30,4033,134.4333333,1360774456473,1360774456985,1195838925,1195839437,512
1360774462,1195844456,3,168,56,1360774460566,1360774460694,1195843022,1195843150,128
1360774462,1195844460,3,168,56,1360774460688,1360774461008,1195843148,1195843468,320
1360774462,1195844480,3,168,56,1360774460989,1360774461117,1195843469,1195843597,128
1360774462,1195844484,16,3935,245.9375,1360774453498,1360774453946,1195835982,1195836430,448
1360774462,1195844528,3,168,56,1360774460752,1360774460880,1195843280,1195843408,128
1360774462,1195844528,28,3753,134.0357143,1360774457166,1360774457550,1195839694,1195840078,384
1360774462,1195844532,3,168,56,1360774457356,1360774457484,1195839888,1195840016,128
1360774464,1195846008,12,2946,245.5,1360774437525,1360774440405,1195819533,1195822413,2880
1360774464,1195846092,19,4511,237.4210526,1360774437444,1360774452228,1195819536,1195834320,14784
1360774464,1195846116,7,3438,491.1428571,1360774437803,1360774439019,1195819919,1195821135,1216
1360774472,1195854260,1,64,64,1360774446876,1360774446876,1195829136,1195829136,0
1360774472,1195854348,2,104,52,1360774446977,1360774447297,1195829325,1195829645,320
1360774478,1195860492,1932,2884164,1492.838509,1360774474737,1360774477809,1195857229,1195860301,3072
1360774478,1195860496,5,777,155.4,1360774469997,1360774470317,1195852493,1195852813,320
1360774484,1195866172,12,9371,780.9166667,1360774459572,1360774468340,1195841744,1195850512,8768
1360774484,1195866176,27,23059,854.037037,1360774455856,1360774460464,1195838032,1195842640,4608
1360774484,1195866176,9,5734,637.1111111,1360774455856,1360774456624,1195838032,1195838800,768
1360774486,1195868452,2,112,56,1360774470042,1360774480218,1195852494,1195862670,10176
1360774486,1195868496,2,112,56,1360774474735,1360774484783,1195857231,1195867279,10048
1360774486,1195868504,2,112,56,1360774469990,1360774480166,1195852494,1195862670,10176
1360774486,1195868504,3,164,54.66666667,1360774469990,1360774480166,1195852494,1195862670,10176
1360774486,1195868568,2,112,56,1360774474661,1360774484709,1195857229,1195867277,10048
1360774486,1195868572,2,112,56,1360774474657,1360774484705,1195857229,1195867277,10048
1360774488,1195870136,1,46,46,1360774461271,1360774461271,1195843407,1195843407,0
1360774494,1195876472,2,112,56,1360774477895,1360774490119,1195860367,1195872591,12224
1360774494,1195876472,2,112,56,1360774477895,1360774490119,1195860367,1195872591,12224
1360774494,1195876476,2,112,56,1360774471876,1360774487940,1195854352,1195870416,16064
1360774494,1195876476,3,164,54.66666667,1360774471876,1360774487940,1195854352,1195870416,16064
1360774494,1195876476,2,131,65.5,1360774486337,1360774486337,1195868813,1195868813,0
1360774494,1195876476,3,164,54.66666667,1360774472065,1360774487937,1195854541,1195870413,15872
1360774494,1195876476,3,164,54.66666667,1360774470400,1360774487936,1195852876,1195870412,17536
1360774494,1195876480,2,112,56,1360774470526,1360774487934,1195853006,1195870414,17408
1360774494,1195876480,2,112,56,1360774470526,1360774487934,1195853006,1195870414,17408
1360774494,1195876480,2,112,56,1360774470654,1360774487934,1195853134,1195870414,17280
1360774494,1195876480,3,164,54.66666667,1360774470654,1360774487934,1195853134,1195870414,17280
1360774494,1195876516,2,131,65.5,1360774490137,1360774490137,1195872653,1195872653,0
1360774494,1195876524,2,112,56,1360774477842,1360774490066,1195860366,1195872590,12224
1360774494,1195876524,2,112,56,1360774471824,1360774487888,1195854348,1195870412,16064
1360774494,1195876528,2,112,56,1360774472014,1360774487886,1195854542,1195870414,15872
1360774494,1195876528,2,112,56,1360774472014,1360774487886,1195854542,1195870414,15872
1360774494,1195876548,2,112,56,1360774470330,1360774487866,1195852878,1195870414,17536
1360774494,1195876548,2,112,56,1360774470329,1360774487865,1195852877,1195870413,17536
1360774494,1195876552,2,112,56,1360774470455,1360774487863,1195853007,1195870415,17408
1360774494,1195876552,2,112,56,1360774470581,1360774487861,1195853133,1195870413,17280
1360774496,1195878116,10,3620,362,1360774470312,1360774471272,1195852428,1195853388,960
1360774496,1195878164,4,537,134.25,1360774471608,1360774471672,1195853772,1195853836,64
1360774496,1195878168,4,537,134.25,1360774469941,1360774470133,1195852109,1195852301,192
1360774496,1195878208,3,681,227,1360774470607,1360774470735,1195852815,1195852943,128
1360774496,1195878208,4,1164,291,1360774470797,1360774478157,1195853005,1195860365,7360
1360774496,1195878212,88,117297,1332.920455,1360774470922,1360774478218,1195853134,1195860430,7296
1360774496,1195878232,4,537,134.25,1360774471220,1360774471284,1195853452,1195853516,64
1360774496,1195878236,4,537,134.25,1360774471347,1360774471411,1195853583,1195853647,64
1360774500,1195882148,48,67134,1398.625,1360774472393,1360774472521,1195854541,1195854669,128
1360774500,1195882152,1,46,46,1360774472647,1360774472647,1195854799,1195854799,0
1360774500,1195882224,74,104537,1412.662162,1360774472125,1360774472637,1195854349,1195854861,512
1360774504,1195886192,5,1504,300.8,1360774478173,1360774498205,1195860365,1195880397,20032
1360774510,1195892472,2,516,258,1360774507972,1360774508612,1195890444,1195891084,640
1360774518,1195900588,2,92,46,1360774515344,1360774515344,1195897932,1195897932,0
1360774526,1195908524,12,12534,1044.5,1360774522577,1360774522705,1195905101,1195905229,128
1360774534,1195916492,77,107120,1391.168831,1360774518704,1360774530416,1195901196,1195912908,11712
1360774534,1195916492,3,164,54.66666667,1360774518704,1360774530160,1195901196,1195912652,11456
1360774534,1195916492,2,112,56,1360774518703,1360774528687,1195901195,1195911179,9984
1360774534,1195916496,2,112,56,1360774518699,1360774530155,1195901195,1195912651,11456
1360774534,1195916512,17,13634,802,1360774529244,1360774529628,1195911756,1195912140,384
1360774536,1195918180,1,52,52,1360774508904,1360774508904,1195891084,1195891084,0
1360774536,1195918260,1,52,52,1360774508826,1360774508826,1195891086,1195891086,0
1360774536,1195918260,1,52,52,1360774508825,1360774508825,1195891085,1195891085,0
1360774536,1195918260,1,52,52,1360774508825,1360774508825,1195891085,1195891085,0
1360774536,1195918260,1,52,52,1360774508825,1360774508825,1195891085,1195891085,0
1360774540,1195922228,25,21489,859.56,1360774515705,1360774538681,1195897933,1195920909,22976
1360774542,1195924556,3,159,53,1360774534193,1360774534193,1195916749,1195916749,0
1360774544,1195926160,4,537,134.25,1360774518781,1360774518909,1195900941,1195901069,128
1360774544,1195926184,4,537,134.25,1360774518949,1360774519013,1195901133,1195901197,64
1360774544,1195926236,9,5338,593.1111111,1360774516079,1360774516591,1195898315,1195898827,512
1360774544,1195926268,3,485,161.6666667,1360774518994,1360774519058,1195901262,1195901326,64
1360774544,1195926272,3,485,161.6666667,1360774519118,1360774519246,1195901390,1195901518,128
1360774550,1195932604,2,131,65.5,1360774546240,1360774546240,1195928844,1195928844,0
1360774552,1195934224,4,537,134.25,1360774525693,1360774525693,1195907917,1195907917,0
1360774552,1195934228,3,485,161.6666667,1360774525819,1360774525819,1195908047,1195908047,0
1360774556,1195938232,4,2121,530.25,1360774528692,1360774528948,1195910924,1195911180,256
1360774556,1195938276,36,46351,1287.527778,1360774530441,1360774530697,1195912717,1195912973,256
1360774560,1195942168,12,9498,791.5,1360774534581,1360774537781,1195916749,1195919949,3200
1360774564,1195946208,1,46,46,1360774538636,1360774538636,1195920844,1195920844,0
1360774564,1195946296,13,7991,614.6923077,1360774538550,1360774544566,1195920846,1195926862,6016
1360774566,1195948496,129,157850,1223.643411,1360774528556,1360774561964,1195911052,1195944460,33408
1360774566,1195948572,6,1259,209.8333333,1360774544288,1360774563488,1195926860,1195946060,19200
1360774576,1195958188,8,5683,710.375,1360774548703,1360774549599,1195930891,1195931787,896
1360774582,1195964568,2,131,65.5,1360774574308,1360774574308,1195956876,1195956876,0
1360774588,1195970360,13,9380,721.5384615,1360774563701,1360774572149,1195946061,1195954509,8448
1360774600,1195982332,45,57769,1283.755556,1360774572942,1360774596494,1195955274,1195978826,23552
1360774604,1195986312,2,476,238,1360774576356,1360774597860,1195958668,1195980172,21504
1360774606,1195988604,4,223,55.75,1360774601921,1360774603073,1195984525,1195985677,1152
1360774616,1195998224,1,197,197,1360774590334,1360774590334,1195972558,1195972558,0
1360774616,1195998348,10,5622,562.2,1360774589313,1360774589761,1195971661,1195972109,448
1360774616,1195998348,1,46,46,1360774589312,1360774589312,1195971660,1195971660,0
1360774622,1196004632,2,131,65.5,1360774619492,1360774619492,1196002124,1196002124,0
1360774624,1196006612,15,7172,478.1333333,1360774599226,1360774601018,1195981838,1195983630,1792
1360774628,1196010696,8,5319,664.875,1360774602980,1360774603364,1195985676,1195986060,384
1360774628,1196010696,16,11523,720.1875,1360774603043,1360774616675,1195985739,1195999371,13632
1360774628,1196010696,1,46,46,1360774602979,1360774602979,1195985675,1195985675,0
1360774632,1196014540,5,6294,1258.8,1360774603966,1360774604030,1195986506,1195986570,64
1360774638,1196020520,2,131,65.5,1360774633556,1360774633556,1196016076,1196016076,0
1360774654,1196036600,3,210,70,1360774646788,1360774647044,1196029388,1196029644,256
1360774676,1196058652,9,3463,384.7777778,1360774648529,1360774649873,1196031181,1196032525,1344
1360774684,1196066652,1,52,52,1360774657487,1360774657487,1196040139,1196040139,0
1360774684,1196066772,6,952,158.6666667,1360774658517,1360774658901,1196041289,1196041673,384
1360774705,1196086804,1,52,52,1360774679327,1360774679327,1196061131,1196061131,0
1360774718,1196100516,4,235,58.75,1360774710487,1360774710487,1196093003,1196093003,0
1360774718,1196100520,2,104,52,1360774710868,1360774711188,1196093388,1196093708,320
1360774718,1196100520,2,104,52,1360774710994,1360774711250,1196093514,1196093770,256
1360774718,1196100544,2,104,52,1360774711292,1360774711484,1196093836,1196094028,192
1360774718,1196100628,4,226,56.5,1360774711144,1360774711400,1196093772,1196094028,256
1360774734,1196116588,3,159,53,1360774730702,1360774730702,1196113290,1196113290,0
1360774734,1196116624,4,231,57.75,1360774726697,1360774726697,1196109321,1196109321,0
1360774737,1196118832,1,52,52,1360774711810,1360774711810,1196093642,1196093642,0
1360774737,1196118860,1,52,52,1360774710439,1360774710439,1196092299,1196092299,0
1360774744,1196126748,2,337,168.5,1360774717037,1360774717037,1196099785,1196099785,0
1360774745,1196126836,1,46,46,1360774720126,1360774720126,1196101962,1196101962,0
1360774748,1196130800,15,10091,672.7333333,1360774723194,1360774729658,1196105994,1196112458,6464
1360774749,1196130892,1,46,46,1360774724100,1360774724100,1196105992,1196105992,0
1360774753,1196134880,8,5253,656.625,1360774727441,1360774727953,1196109321,1196109833,512
1360774756,1196138776,16,18261,1141.3125,1360774730515,1360774730707,1196113291,1196113483,192
1360774756,1196138804,10,5506,550.6,1360774731575,1360774732023,1196114379,1196114827,448
1360774757,1196138844,11,7212,655.6363636,1360774730420,1360774731124,1196112264,1196112968,704
1360774766,1196148596,5,260,52,1360774758724,1360774762372,1196141320,1196144968,3648
1360774766,1196148600,5,260,52,1360774758913,1360774762561,1196141513,1196145161,3648
1360774766,1196148640,6,447,74.5,1360774759834,1360774764314,1196142474,1196146954,4480
1360774766,1196148672,6,447,74.5,1360774760316,1360774764732,1196142988,1196147404,4416
1360774766,1196148676,5,260,52,1360774758390,1360774762166,1196141066,1196144842,3776
1360774766,1196148680,5,260,52,1360774758516,1360774762100,1196141196,1196144780,3584
1360774766,1196148712,2,104,52,1360774765267,1360774765459,1196147979,1196148171,192
1360774766,1196148712,2,104,52,1360774765392,1360774765584,1196148104,1196148296,192
1360774766,1196148720,5,368,73.6,1360774762120,1360774764168,1196144840,1196146888,2048
1360774774,1196156564,3,156,52,1360774766244,1360774769124,1196148808,1196151688,2880
1360774774,1196156564,5,260,52,1360774768612,1360774772260,1196151176,1196154824,3648
1360774774,1196156648,3,156,52,1360774766035,1360774768915,1196148683,1196151563,2880
1360774774,1196156688,4,289,72.25,1360774769579,1360774772011,1196152267,1196154699,2432
1360774776,1196158724,176,254259,1444.653409,1360774474885,1360774475013,1195857609,1195857737,128
1360774782,1196164704,2,158,79,1360774775194,1360774781594,1196157898,1196164298,6400
1360774793,1196174824,3,237,79,1360774767435,1360774781451,1196149259,1196163275,14016
1360774797,1196178820,2,158,79,1360774769934,1360774779534,1196151754,1196161354,9600
1360774797,1196178848,2,158,79,1360774770291,1360774779827,1196152139,1196161675,9536
1360774804,1196186764,7,1337,191,1360774777435,1360774797531,1196160199,1196180295,20096
1360774820,1196202780,1,79,79,1360774794315,1360774794315,1196177095,1196177095,0
1360774824,1196206744,1,79,79,1360774797810,1360774797810,1196180554,1196180554,0
1360774825,1196206828,1,79,79,1360774798789,1360774798789,1196180617,1196180617,0
1360774825,1196206936,1,79,79,1360774800088,1360774800088,1196182024,1196182024,0
1360774833,1196214916,3,573,191,1360774808363,1360774828331,1196190279,1196210247,19968
1360774848,1196230772,1,79,79,1360774819924,1360774819924,1196202696,1196202696,0
1360774864,1196246768,1,79,79,1360774835865,1360774835865,1196218633,1196218633,0
1360774864,1196246776,1,79,79,1360774836178,1360774836178,1196218954,1196218954,0
1360774865,1196246896,1,79,79,1360774837632,1360774837632,1196219528,1196219528,0
1360774865,1196246936,1,191,191,1360774838362,1360774838362,1196220298,1196220298,0
1360774894,1196276588,3,168,56,1360774892300,1360774892428,1196274888,1196275016,128
1360774894,1196276644,3,168,56,1360774891861,1360774891925,1196274505,1196274569,64
1360774894,1196276644,3,168,56,1360774891988,1360774892116,1196274632,1196274760,128
1360774894,1196276668,3,168,56,1360774892347,1360774892539,1196275015,1196275207,192
1360774897,1196278868,1,79,79,1360774872156,1360774872156,1196254024,1196254024,0
1360774902,1196284652,3,156,52,1360774898892,1360774900556,1196281544,1196283208,1664
1360774918,1196300652,6,381,63.5,1360774911115,1360774914571,1196293767,1196297223,3456
1360774921,1196302804,1,46,46,1360774893019,1360774893019,1196274823,1196274823,0
1360774921,1196302848,9,2456,272.8888889,1360774895791,1360774896303,1196277639,1196278151,512
1360774921,1196302924,1,64,64,1360774893282,1360774893282,1196275206,1196275206,0
1360774929,1196310944,1,52,52,1360774903439,1360774903439,1196285383,1196285383,0
1360774934,1196316668,5,260,52,1360774927421,1360774930941,1196310089,1196313609,3520
1360774945,1196326900,3,201,67,1360774918973,1360774940925,1196300873,1196322825,21952
1360774950,1196332644,2,104,52,1360774934739,1360774942291,1196317383,1196324935,7552
1360774966,1196348636,2,104,52,1360774952345,1360774962329,1196334981,1196344965,9984
1360774990,1196372648,2,104,52,1360774972301,1360774982285,1196354949,1196364933,9984
1360774997,1196378904,1,67,67,1360774970166,1360774970166,1196352070,1196352070,0
1360775077,1196459116,1,64,64,1360775051618,1360775051618,1196433734,1196433734,0
1360775231,1196612860,2,127,63.5,1360775227936,1360775227936,1196609796,1196609796,0
1360775239,1196620872,5,2271,454.2,1360775232148,1360775236948,1196614020,1196618820,4800
1360775239,1196620908,32,41571,1299.09375,1360775233839,1360775234735,1196615747,1196616643,896
1360775247,1196628904,11,5505,500.4545455,1360775239153,1360775243185,1196621057,1196625089,4032
1360775247,1196628908,16,9927,620.4375,1360775239215,1360775241583,1196621123,1196623491,2368
1360775247,1196628916,3,164,54.66666667,1360775246181,1360775246309,1196628097,1196628225,128
1360775253,1196635348,1,76,76,1360775227252,1360775227252,1196609600,1196609600,0
1360775255,1196636868,7,1609,229.8571429,1360775247572,1360775248276,1196629440,1196630144,704
1360775255,1196636892,5,704,140.8,1360775248125,1360775250301,1196630017,1196632193,2176
1360775255,1196636908,11,5437,494.2727273,1360775252078,1360775252654,1196633986,1196634562,576
1360775255,1196636940,7,1609,229.8571429,1360775247501,1360775248205,1196629441,1196630145,704
1360775255,1196636944,3,518,172.6666667,1360775247690,1360775252746,1196629634,1196634690,5056
1360775255,1196636976,13,4046,311.2307692,1360775234985,1360775252201,1196616961,1196634177,17216
1360775255,1196636980,26,20250,778.8461538,1360775235047,1360775252199,1196617027,1196634179,17152
1360775255,1196636980,11,5505,500.4545455,1360775243239,1360775248295,1196625219,1196630275,5056
1360775255,1196636984,9,5157,573,1360775251300,1360775251684,1196633284,1196633668,384
1360775257,1196639380,1,76,76,1360775232150,1360775232150,1196614530,1196614530,0
1360775263,1196644820,9,2463,273.6666667,1360775237191,1360775261063,1196619011,1196642883,23872
1360775263,1196644824,4,271,67.75,1360775257348,1360775258308,1196639172,1196640132,960
1360775263,1196644868,3,168,56,1360775256344,1360775257048,1196638212,1196638916,704
1360775263,1196644912,13,4732,364,1360775250475,1360775257899,1196632387,1196639811,7424
1360775263,1196644940,3,168,56,1360775258829,1360775259661,1196640769,1196641601,832
1360775271,1196652860,2,116,58,1360775269916,1360775270556,1196651776,1196652416,640
1360775271,1196652888,6,630,105,1360775246594,1360775267394,1196628482,1196649282,20800
1360775271,1196652980,3,168,56,1360775268710,1360775269350,1196650690,1196651330,640
1360775273,1196655344,1,116,116,1360775245690,1360775245690,1196628034,1196628034,0
1360775273,1196655344,1,116,116,1360775245689,1360775245689,1196628033,1196628033,0
1360775273,1196655348,1,46,46,1360775245815,1360775245815,1196628163,1196628163,0
1360775277,1196659372,16,6024,376.5,1360775250717,1360775264797,1196633089,1196647169,14080
1360775277,1196659404,9,3672,408,1360775251837,1360775252861,1196634241,1196635265,1024
1360775279,1196660852,11,5880,534.5454545,1360775269991,1360775278631,1196651843,1196660483,8640
1360775279,1196660888,14,5322,380.1428571,1360775270659,1360775273603,1196652547,1196655491,2944
1360775281,1196663288,2,104,52,1360775256052,1360775256244,1196638340,1196638532,192
1360775281,1196663316,8,3781,472.625,1360775253333,1360775255573,1196635649,1196637889,2240
1360775281,1196663356,1,46,46,1360775255151,1360775255151,1196637507,1196637507,0
1360775285,1196667236,15,5645,376.3333333,1360775257896,1360775264808,1196640132,1196647044,6912
1360775285,1196667236,12,4206,350.5,1360775257895,1360775261223,1196640131,1196643459,3328
1360775285,1196667260,10,4625,462.5,1360775258445,1360775261389,1196640705,1196643649,2944
1360775285,1196667340,8,3062,382.75,1360775257916,1360775259964,1196640256,1196642304,2048
1360775287,1196668852,11,4111,373.7272727,1360775274086,1360775284582,1196655938,1196666434,10496
1360775287,1196668880,3,168,56,1360775280009,1360775281033,1196661889,1196662913,1024
1360775287,1196668880,3,168,56,1360775285192,1360775286152,1196667072,1196668032,960
1360775287,1196668920,3,168,56,1360775278947,1360775279523,1196660867,1196661443,576
1360775287,1196668920,3,168,56,1360775281379,1360775282083,1196663299,1196664003,704
1360775289,1196671228,12,5442,453.5,1360775261420,1360775273516,1196643648,1196655744,12096
1360775295,1196676868,10,1252,125.2,1360775287446,1360775293206,1196669314,1196675074,5760
1360775295,1196676904,4,271,67.75,1360775286704,1360775287408,1196668608,1196669312,704
1360775295,1196676976,23,5800,252.173913,1360775270185,1360775290537,1196652161,1196672513,20352
1360775297,1196679240,1,64,64,1360775271072,1360775271072,1196653312,1196653312,0
1360775297,1196679240,10,2971,297.1,1360775271457,1360775296609,1196653697,1196678849,25152
1360775297,1196679312,1,52,52,1360775270488,1360775270488,1196652800,1196652800,0
1360775297,1196679360,13,5578,429.0769231,1360775271722,1360775278762,1196654082,1196661122,7040
1360775301,1196683332,9,4360,484.4444444,1360775273287,1360775297543,1196655619,1196679875,24256
1360775301,1196683364,11,3409,309.9090909,1360775274086,1360775296870,1196656450,1196679234,22784
1360775303,1196684856,4,235,58.75,1360775298081,1360775298081,1196679937,1196679937,0
1360775303,1196684864,15,6759,450.6,1360775295898,1360775297370,1196677762,1196679234,1472
1360775303,1196684888,13,6698,515.2307692,1360775298755,1360775299779,1196680643,1196681667,1024
1360775303,1196684928,11,6605,600.4545455,1360775297305,1360775298265,1196679233,1196680193,960
1360775303,1196684940,4,271,67.75,1360775295439,1360775296143,1196677379,1196678083,704
1360775303,1196684968,3,168,56,1360775296178,1360775297010,1196678146,1196678978,832
1360775303,1196684980,10,6393,639.3,1360775299751,1360775300455,1196681731,1196682435,704
1360775303,1196684984,2,110,55,1360775284705,1360775295393,1196666689,1196677377,10688
1360775305,1196687328,1,46,46,1360775280202,1360775280202,1196662530,1196662530,0
1360775305,1196687416,14,3459,247.0714286,1360775280115,1360775302643,1196662531,1196685059,22528
1360775305,1196687416,2,104,52,1360775280114,1360775280370,1196662530,1196662786,256
1360775309,1196691372,14,2409,172.0714286,1360775282399,1360775307935,1196664771,1196690307,25536
1360775311,1196692856,22,24007,1091.227273,1360775287074,1360775303202,1196668930,1196685058,16128
1360775311,1196692892,10,6407,640.7,1360775302398,1360775308798,1196684290,1196690690,6400
1360775313,1196695252,8,6216,777,1360775287062,1360775296214,1196669314,1196678466,9152
1360775313,1196695400,5,1082,216.4,1360775288195,1360775288835,1196670595,1196671235,640
1360775325,1196707336,63,82371,1307.47619,1360775297411,1360775306179,1196679747,1196688515,8768
1360775329,1196711340,35,42355,1210.142857,1360775304510,1360775309182,1196686850,1196691522,4672
1360775349,1196731372,1,52,52,1360775322270,1360775322270,1196704642,1196704642,0
1360775351,1196732944,20,19942,997.1,1360775328329,1360775344265,1196710273,1196726209,15936
1360775353,1196735456,2,517,258.5,1360775327815,1360775328007,1196710271,1196710463,192
1360775353,1196735468,8,3149,393.625,1360775328127,1360775329919,1196710595,1196712387,1792
1360775369,1196751396,1,188,188,1360775342019,1360775342019,1196724415,1196724415,0
1360775369,1196751404,32,34008,1062.75,1360775344059,1360775354939,1196726463,1196737343,10880
1360775377,1196759292,11,6782,616.5454545,1360775350637,1360775354733,1196732929,1196737025,4096
1360775381,1196763420,2,1045,522.5,1360775354411,1360775354603,1196736831,1196737023,192
1360775407,1196789000,3,183,61,1360775398928,1360775400272,1196780928,1196782272,1344
1360775423,1196805156,2,131,65.5,1360775416947,1360775416947,1196799103,1196799103,0
1360775455,1196837100,2,131,65.5,1360775448300,1360775448300,1196830400,1196830400,0
1360775455,1196837140,2,131,65.5,1360775449989,1360775449989,1196832129,1196832129,0
1360778146,1199527876,5,1020,204,1360778145635,1360778145827,1199527511,1199527703,192
1360778244,1199626052,22,4869,221.3181818,1360778216242,1360778218226,1199598294,1199600278,1984
1360778252,1199634128,7,2541,363,1360778225638,1360778225894,1199607766,1199608022,256
1360778264,1199646032,1,52,52,1360778239111,1360778239111,1199621143,1199621143,0
1360778284,1199666136,3,152,50.66666667,1360778258971,1360778260443,1199641107,1199642579,1472
1360778288,1199670080,3,152,50.66666667,1360778260118,1360778261654,1199642198,1199643734,1536
1360778288,1199670088,3,152,50.66666667,1360778261260,1360778262540,1199643348,1199644628,1280
1360778288,1199670196,2,104,52,1360778261151,1360778264095,1199643347,1199646291,2944
1360778304,1199686068,3,152,50.66666667,1360778276064,1360778277792,1199658132,1199659860,1728
1360778304,1199686120,3,152,50.66666667,1360778278253,1360778279725,1199660373,1199661845,1472
1360778304,1199686192,3,152,50.66666667,1360778277092,1360778278372,1199659284,1199660564,1280
1360778304,1199686204,3,152,50.66666667,1360778278168,1360778287128,1199660372,1199669332,8960
1360778340,1199722192,16,3274,204.625,1360778315492,1360778316068,1199697684,1199698260,576
1360778340,1199722216,1,52,52,1360778315787,1360778315787,1199698003,1199698003,0
1360778474,1199856032,2,104,52,1360778465984,1360778466240,1199848016,1199848272,256
1360778576,1199958740,1,64,64,1360778548989,1360778548989,1199931729,1199931729,0
1360778576,1199958740,1,64,64,1360778549244,1360778549244,1199931984,1199931984,0
1360778632,1200014748,1,46,46,1360778606836,1360778606836,1199989584,1199989584,0
1360778690,1200072164,5,260,52,1360778686011,1360778689595,1200068175,1200071759,3584
1360778706,1200088304,2,104,52,1360778693295,1360778700975,1200075599,1200083279,7680
1360778729,1200111140,18,4882,271.2222222,1360778702418,1360778703186,1200084558,1200085326,768
1360779033,1200415356,16,3274,204.625,1360779006070,1360779006710,1200388426,1200389066,640
1360779033,1200415360,1,52,52,1360779006386,1360779006386,1200388746,1200388746,0
1360779122,1200504476,3,156,52,1360779115517,1360779116285,1200497993,1200498761,768
1360779173,1200555548,22,4880,221.8181818,1360779145971,1360779147635,1200528519,1200530183,1664
1360779173,1200555552,3,152,50.66666667,1360779145135,1360779146991,1200527687,1200529543,1856
1360779173,1200555552,3,152,50.66666667,1360779146286,1360779147566,1200528838,1200530118,1280
1360779173,1200555592,3,152,50.66666667,1360779147334,1360779148742,1200529926,1200531334,1408
1360779173,1200555592,2,104,52,1360779147334,1360779150342,1200529926,1200532934,3008
1360779282,1200664000,3,152,50.66666667,1360779257685,1360779259605,1200639685,1200641605,1920
1360779286,1200667968,3,152,50.66666667,1360779259958,1360779261494,1200641926,1200643462,1536
1360779286,1200668016,3,152,50.66666667,1360779258822,1360779260294,1200640838,1200642310,1472
1360779286,1200668056,2,104,52,1360779259869,1360779262877,1200641925,1200644933,3008
1360779402,1200784728,4,208,52,1360779399482,1360779401146,1200782210,1200783874,1664
1360779410,1200792696,2,104,52,1360779403164,1360779407132,1200785860,1200789828,3968
1360779426,1200808664,2,104,52,1360779415036,1360779425020,1200797700,1200807684,9984
1360779450,1200832756,2,104,52,1360779434910,1360779444894,1200817666,1200827650,9984
1360779482,1200864544,1,52,52,1360779455154,1360779455154,1200837698,1200837698,0
1360779523,1200905116,19,3418,179.8947368,1360779514015,1360779515103,1200896131,1200897219,1088
1360779542,1200924744,17,3593,211.3529412,1360779513897,1360779514601,1200896641,1200897345,704
1360779803,1201185204,16,3274,204.625,1360779776513,1360779777217,1201158717,1201159421,704
1360779803,1201185316,1,52,52,1360779776914,1360779776914,1201159230,1201159230,0
1360779929,4134591548,2,96,48,1360779902493,1360779905565,4134565041,4134568113,3072
1360780020,1201402072,2,104,52,1360780017923,1360780018179,1201399995,1201400251,256
1360780079,1201461748,3,152,50.66666667,1360780053341,1360780055325,1201436089,1201438073,1984
1360780079,1201461776,3,152,50.66666667,1360780054403,1360780058563,1201437179,1201441339,4160
1360780080,1201461960,23,5022,218.3478261,1360780054641,1360780056433,1201436601,1201438393,1792
1360780083,1201465684,3,152,50.66666667,1360780055583,1360780056991,1201438267,1201439675,1408
1360780083,1201465684,2,104,52,1360780055581,1360780058589,1201438265,1201441273,3008
1360780132,1201514528,3,156,52,1360780130040,1360780130744,1201512568,1201513272,704
1360780140,1201522152,3,156,52,1360780132082,1360780137842,1201514234,1201519994,5760
1360780164,1201546212,17,4744,279.0588235,1360780138677,1360780139381,1201520889,1201521593,704
1360780200,1201582188,2,175,87.5,1360780174669,1360780174669,1201556857,1201556857,0
1360780272,1201654116,8,4560,570,1360780246288,1360780246864,1201628404,1201628980,576
1360780272,1201654140,1,52,52,1360780247161,1360780247161,1201629301,1201629301,0
1360780272,1201654236,16,3274,204.625,1360780246748,1360780247324,1201628984,1201629560,576
1360780316,1201698392,4,208,52,1360780312636,1360780314364,1201695028,1201696756,1728
1360780324,1201706452,2,104,52,1360780316226,1360780320194,1201698678,1201702646,3968
1360780340,1201722496,2,104,52,1360780327959,1360780337943,1201710455,1201720439,9984
1360780364,1201746436,2,104,52,1360780348050,1360780358034,1201730486,1201740470,9984
1360780396,1201778476,1,52,52,1360780367978,1360780367978,1201750454,1201750454,0
1360780493,1201875060,5,260,52,1360780486918,1360780490438,1201868978,1201872498,3520
1360780594,1201975952,1,48,48,1360780564849,1360780564849,1201946801,1201946801,0
1360780648,1202030580,3,152,50.66666667,1360780622460,1360780631484,1202005040,1202014064,9024
1360780648,1202030616,3,152,50.66666667,1360780623706,1360780632730,1202006322,1202015346,9024
1360780648,1202030616,3,152,50.66666667,1360780623705,1360780632665,1202006321,1202015281,8960
1360780648,1202030660,3,152,50.66666667,1360780621356,1360780630316,1202004016,1202012976,8960
1360780949,1202331744,3,156,52,1360780947282,1360780948050,1202330026,1202330794,768
1360780957,1202339336,3,152,50.66666667,1360780929003,1360780937963,1202311339,1202320299,8960
1360780957,1202339352,3,152,50.66666667,1360780930076,1360780939100,1202312428,1202321452,9024
1360780957,1202339376,3,152,50.66666667,1360780931202,1360780940162,1202313578,1202322538,8960
1360780957,1202339380,3,152,50.66666667,1360780931200,1360780940160,1202313580,1202322540,8960
1360780957,1202339624,3,156,52,1360780949196,1360780955148,1202331820,1202337772,5952
1360780982,1202364108,2,104,52,1360780963662,1360780973646,1202345770,1202355754,9984
1360781009,1202391700,1,52,52,1360780983040,1360780983040,1202365740,1202365740,0
1360781270,1202652552,1,48,48,1360781244303,1360781244303,1202626855,1202626855,0
1360781274,1202656640,1,48,48,1360781245814,1360781245814,1202628454,1202628454,0
1360781534,1202916464,3,168,56,1360781527972,1360781528612,1202910436,1202911076,640
1360781534,1202916472,3,168,56,1360781528858,1360781529562,1202911330,1202912034,704
1360781555,1202937224,1,46,46,1360781527572,1360781527572,1202909796,1202909796,0
1360781555,1202937268,1,64,64,1360781530088,1360781530088,1202912356,1202912356,0
1360781555,1202937424,21,4264,203.047619,1360781530058,1360781534218,1202912482,1202916642,4160
1360781555,1202937428,9,4351,483.4444444,1360781530501,1360781532677,1202912929,1202915105,2176
1360781654,1203036500,2,131,65.5,1360781652478,1360781652478,1203034978,1203034978,0
1360781662,1203044540,2,158,79,1360781654037,1360781657109,1203036577,1203039649,3072
1360781678,1203060660,2,158,79,1360781663198,1360781675614,1203045858,1203058274,12416
1360781694,1203076600,3,168,56,1360781687832,1360781688920,1203070432,1203071520,1088
1360781694,1203076628,3,168,56,1360781689340,1360781690172,1203071968,1203072800,832
1360781694,1203076640,3,168,56,1360781690546,1360781691058,1203073186,1203073698,512
1360781702,1203084672,4,232,58,1360781691344,1360781695184,1203074016,1203077856,3840
1360781715,1203097684,19,4062,213.7894737,1360781690690,1360781693890,1203073374,1203076574,3200
1360781719,1203101612,1,52,52,1360781692172,1360781692172,1203074784,1203074784,0
1360781723,1203105628,1,64,64,1360781695613,1360781695613,1203078241,1203078241,0
1360781727,1203109716,1,79,79,1360781700386,1360781700386,1203083102,1203083102,0
1360781767,1203148840,2,104,52,1360781765455,1360781766223,1203147295,1203148063,768
1360781775,1203156872,2,110,55,1360781760241,1360781772401,1203142113,1203154273,12160
1360781775,1203156944,3,168,56,1360781771175,1360781772647,1203153119,1203154591,1472
1360781776,1203157948,1,46,46,1360781749348,1360781749348,1203131296,1203131296,0
1360781776,1203157988,1,79,79,1360781750844,1360781750844,1203132832,1203132832,0
1360781782,1203164780,4,232,58,1360781772193,1360781778081,1203154973,1203160861,5888
1360781783,1203164868,3,168,56,1360781777460,1360781778228,1203159328,1203160096,768
1360781783,1203164896,3,168,56,1360781778775,1360781780375,1203160671,1203162271,1600
1360781788,1203169888,12,4119,343.25,1360781760158,1360781766878,1203142046,1203148766,6720
1360781791,1203173212,3,168,56,1360781785499,1360781786075,1203167711,1203168287,576
1360781792,1203173944,1,52,52,1360781767717,1360781767717,1203149661,1203149661,0
1360781799,1203180824,7,633,90.42857143,1360781797725,1360781798237,1203179549,1203180061,512
1360781807,1203188884,2,92,46,1360781800609,1360781800609,1203182493,1203182493,0
1360781815,1203196912,7,406,58,1360781809669,1360781813637,1203191581,1203195549,3968
1360781820,1203201960,3,152,50.66666667,1360781794582,1360781798166,1203176542,1203180126,3584
1360781820,1203202080,3,152,50.66666667,1360781795613,1360781798109,1203177693,1203180189,2496
1360781824,1203206032,2,104,52,1360781796750,1360781798094,1203178782,1203180126,1344
1360781824,1203206032,2,104,52,1360781796813,1360781799757,1203178845,1203181789,2944
1360781836,1203217980,6,360,60,1360781810755,1360781820099,1203192735,1203202079,9344
1360781863,1203244884,5,260,52,1360781856480,1360781860320,1203238364,1203242204,3840
1360781868,1203250036,19,5747,302.4736842,1360781843530,1360781848842,1203225566,1203230878,5312
1360781868,1203250096,1,64,64,1360781842956,1360781842956,1203225052,1203225052,0
1360781872,1203254072,1,52,52,1360781847334,1360781847334,1203229406,1203229406,0
1360781879,1203260896,8,515,64.375,1360781854871,1360781877143,1203236767,1203259039,22272
1360781879,1203260900,2,104,52,1360781864403,1360781872595,1203246303,1203254495,8192
1360781879,1203260940,3,168,56,1360781877608,1360781878376,1203259548,1203260316,768
1360781887,1203268840,3,168,56,1360781880782,1360781881550,1203262622,1203263390,768
1360781887,1203268904,3,168,56,1360781878733,1360781880333,1203260637,1203262237,1600
1360781887,1203268952,3,168,56,1360781881887,1360781882527,1203263839,1203264479,640
1360781904,1203286064,21,4544,216.3809524,1360781879532,1360781884780,1203261596,1203266844,5248
1360781908,1203290048,1,52,52,1360781881342,1360781881342,1203263390,1203263390,0
1360781908,1203290056,1,52,52,1360781882420,1360781882420,1203264476,1203264476,0
1360781908,1203290084,1,64,64,1360781883227,1360781883227,1203265311,1203265311,0
1360781911,1203293004,2,116,58,1360781910055,1360781910311,1203292059,1203292315,256
1360781919,1203300884,3,168,56,1360781912543,1360781913119,1203294427,1203295003,576
1360781919,1203300888,3,168,56,1360781911325,1360781912157,1203293213,1203294045,832
1360781936,1203318120,1,52,52,1360781910837,1360781910837,1203292957,1203292957,0
1360781959,1203340956,3,168,56,1360781957911,1360781958487,1203339867,1203340443,576
1360781959,1203340996,4,220,55,1360781956655,1360781957551,1203338651,1203339547,896
1360782184,1203566396,1,52,52,1360782156892,1360782156892,1203539288,1203539288,0
1360782184,1203566444,2,104,52,1360782159084,1360782160300,1203541528,1203542744,1216
1360782184,1203566448,3,152,50.66666667,1360782159210,1360782167978,1203541658,1203550426,8768
1360782184,1203566480,2,100,50,1360782159239,1360782160199,1203541719,1203542679,960
1360782184,1203566520,2,100,50,1360782157855,1360782158623,1203540375,1203541143,768
1360782184,1203566524,1,52,52,1360782157982,1360782157982,1203540506,1203540506,0
1360782188,1203570496,1,48,48,1360782161208,1360782161208,1203543704,1203543704,0
1360782388,1203770620,7,2757,393.8571429,1360782361399,1360782362551,1203744019,1203745171,1152
1360782388,1203770668,1,64,64,1360782360392,1360782360392,1203743060,1203743060,0
1360782388,1203770676,1,64,64,1360782360962,1360782360962,1203743638,1203743638,0
1360782553,1203934968,3,457,152.3333333,1360782528005,1360782528389,1203909973,1203910357,384
1360782629,1204011172,1,52,52,1360782602996,1360782602996,1203985168,1203985168,0
1360782857,1204239764,8,3390,423.75,1360782830436,1360782832036,1204213200,1204214800,1600
1360783010,1204391976,3,152,50.66666667,1360782984630,1360782988854,1204366606,1204370830,4224
1360783010,1204391976,3,152,50.66666667,1360782984628,1360782993652,1204366604,1204375628,9024
1360783010,1204391992,3,152,50.66666667,1360782983460,1360782987620,1204365452,1204369612,4160
1360783010,1204392056,3,152,50.66666667,1360782982309,1360782986021,1204364365,1204368077,3712
1360783030,1204412140,3,152,50.66666667,1360783005456,1360783014480,1204387596,1204396620,9024
1360783054,1204436000,3,152,50.66666667,1360783026589,1360783035613,1204408589,1204417613,9024
1360783098,1204480072,1,52,52,1360783072723,1360783072723,1204454795,1204454795,0
1360783424,1204806204,5,2088,417.6,1360783413768,1360783419528,1204795972,1204801732,5760
1360783455,1204836924,1,46,46,1360783427619,1360783427619,1204809543,1204809543,0
1360783496,1204878256,4,256,64,1360783488786,1360783489298,1204871042,1204871554,512
1360783523,1204904924,19,4062,213.7894737,1360783497439,1360783500191,1204879363,1204882115,2752
1360783705,1205087140,1,46,46,1360783675655,1360783675655,1205057795,1205057795,0
1360783739,1205121420,2,1241,620.5,1360783713195,1360783732395,1205095615,1205114815,19200
1360783743,1205125392,1,46,46,1360783715335,1360783715335,1205097727,1205097727,0
1360783744,1205126376,10,4433,443.3,1360783735639,1360783736407,1205118015,1205118783,768
1360783751,1205133336,3,152,50.66666667,1360783725377,1360783727041,1205107713,1205109377,1664
1360783751,1205133456,3,152,50.66666667,1360783726344,1360783728200,1205108800,1205110656,1856
1360783755,1205137404,3,152,50.66666667,1360783727550,1360783729214,1205109954,1205111618,1664
1360783755,1205137404,3,152,50.66666667,1360783727550,1360783736510,1205109954,1205118914,8960
1360783763,1205145396,21,13609,648.047619,1360783736131,1360783749315,1205118527,1205131711,13184
1360783763,1205145436,25,7548,301.92,1360783735516,1360783761436,1205117952,1205143872,25920
1360783763,1205145436,27,13465,498.7037037,1360783735516,1360783762780,1205117952,1205145216,27264
1360783767,1205149440,1,667,667,1360783741592,1360783741592,1205124032,1205124032,0
1360783771,1205153332,11,4761,432.8181818,1360783743363,1360783765187,1205125695,1205147519,21824
1360783776,1205158544,9,4387,487.4444444,1360783773617,1360783773937,1205156161,1205156481,320
1360783791,1205173344,15,14543,969.5333333,1360783763001,1360783765305,1205145345,1205147649,2304
1360783791,1205173400,17,2346,138,1360783766017,1360783788161,1205148417,1205170561,22144
1360783792,1205174452,10,4433,443.3,1360783781643,1360783788875,1205164095,1205171327,7232
1360783795,1205177428,1,609,609,1360783770790,1360783770790,1205153218,1205153218,0
1360783800,1205182536,9,4387,487.4444444,1360783798393,1360783798777,1205180929,1205181313,384
1360783807,1205189604,1,52,52,1360783782131,1360783782131,1205164735,1205164735,0
1360783808,1205190448,6,1868,311.3333333,1360783796623,1360783802895,1205179071,1205185343,6272
1360783815,1205197468,1,46,46,1360783788861,1360783788861,1205171329,1205171329,0
1360783816,1205198468,15,3760,250.6666667,1360783814716,1360783815484,1205197184,1205197952,768
1360783823,1205205452,6,384,64,1360783795980,1360783816076,1205178432,1205198528,20096
1360783824,1205206424,16,4460,278.75,1360783817318,1360783819302,1205199742,1205201726,1984
1360783824,1205206492,13,3571,274.6923077,1360783816163,1360783816739,1205198655,1205199231,576
1360783824,1205206496,13,3571,274.6923077,1360783816289,1360783816929,1205198785,1205199425,640
1360783824,1205206496,18,4468,248.2222222,1360783816416,1360783817184,1205198912,1205199680,768
1360783839,1205221552,32,24160,755,1360783811432,1360783836008,1205193984,1205218560,24576
1360783843,1205225520,8,2872,359,1360783817417,1360783817737,1205199937,1205200257,320
1360783843,1205225612,9,3463,384.7777778,1360783817453,1360783817901,1205200065,1205200513,448
1360783847,1205229540,43,42899,997.6511628,1360783820789,1360783830645,1205203329,1205213185,9856
1360783847,1205229540,9,5718,635.3333333,1360783820852,1360783821492,1205203392,1205204032,640
1360783847,1205229588,49,41811,853.2857143,1360783819332,1360783836292,1205201920,1205218880,16960
1360783847,1205229620,7,4142,591.7142857,1360783820258,1360783820770,1205202878,1205203390,512
1360783851,1205233540,6,386,64.33333333,1360783825908,1360783846196,1205208448,1205228736,20288
1360783855,1205237496,25,25619,1024.76,1360783828382,1360783831198,1205210878,1205213694,2816
1360783856,1205238528,2,131,65.5,1360783850879,1360783850879,1205233407,1205233407,0
1360783856,1205238536,2,131,65.5,1360783851511,1360783851511,1205234047,1205234047,0
1360783863,1205245504,1,285,285,1360783836311,1360783836311,1205218815,1205218815,0
1360783863,1205245532,1,46,46,1360783836604,1360783836604,1205219136,1205219136,0
1360783872,1205254472,6,2199,366.5,1360783854710,1360783869878,1205237182,1205252350,15168
1360783872,1205254544,2,92,46,1360783869870,1360783869870,1205252414,1205252414,0
1360783883,1205265516,6,387,64.5,1360783856138,1360783876170,1205238654,1205258686,20032
1360783895,1205277544,13,8655,665.7692308,1360783869807,1360783871279,1205252351,1205253823,1472
1360783895,1205277544,12,13914,1159.5,1360783869997,1360783873965,1205252541,1205256509,3968
1360783895,1205277628,23,18468,802.9565217,1360783869787,1360783880603,1205252415,1205263231,10816
1360783899,1205281680,50,55305,1106.1,1360783873893,1360783875173,1205256573,1205257853,1280
1360783904,1205286492,2,127,63.5,1360783896034,1360783901026,1205278526,1205283518,4992
1360783904,1205286496,3,179,59.66666667,1360783895326,1360783900510,1205277822,1205283006,5184
1360783904,1205286620,2,131,65.5,1360783901217,1360783901217,1205283837,1205283837,0
1360783911,1205293584,17,6055,356.1764706,1360783885252,1360783885828,1205267836,1205268412,576
1360783911,1205293680,6,387,64.5,1360783885991,1360783906215,1205268671,1205288895,20224
1360783920,1205302592,2,131,65.5,1360783915837,1360783915837,1205298429,1205298429,0
1360783920,1205302596,7,2603,371.8571429,1360783900409,1360783919545,1205283005,1205302141,19136
1360783920,1205302596,4,256,64,1360783912952,1360783912952,1205295548,1205295548,0
1360783928,1205310600,2,141,70.5,1360783927157,1360783927157,1205309757,1205309757,0
1360783937,1205319380,2,92,46,1360783932946,1360783932946,1205315326,1205315326,0
1360783944,1205326544,2,131,65.5,1360783937709,1360783937709,1205320253,1205320253,0
1360783944,1205326564,2,131,65.5,1360783937816,1360783937816,1205320380,1205320380,0
1360783947,1205329680,1,46,46,1360783919525,1360783919525,1205302205,1205302205,0
1360783947,1205329680,14,11053,789.5,1360783919525,1360783920549,1205302205,1205303229,1024
1360783948,1205329788,22,18228,828.5454545,1360783920416,1360783939872,1205302204,1205321660,19456
1360783951,1205333652,7,7731,1104.428571,1360783923779,1360783923779,1205306431,1205306431,0
1360783952,1205334556,2,131,65.5,1360783950625,1360783950625,1205333181,1205333181,0
1360783968,1205350616,2,131,65.5,1360783964711,1360783964711,1205347327,1205347327,0
1360783984,1205366620,153,190241,1243.405229,1360783932768,1360783980128,1205315388,1205362748,47360
1360783984,1205366620,2,92,46,1360783977312,1360783977312,1205359932,1205359932,0
1360783987,1205369672,1,46,46,1360783959150,1360783959150,1205341822,1205341822,0
1360783987,1205369672,9,5482,609.1111111,1360783959150,1360783959598,1205341822,1205342270,448
1360783988,1205369792,1,283,283,1360783962588,1360783962588,1205344380,1205344380,0
1360783992,1205374588,2,131,65.5,1360783989698,1360783989698,1205372286,1205372286,0
1360783992,1205374620,2,92,46,1360783987041,1360783987105,1205369661,1205369725,64
1360784000,1205381820,1,46,46,1360783975682,1360783975682,1205357502,1205357502,0
1360784003,1205385724,11,9185,835,1360783977274,1360783986874,1205359998,1205369598,9600
1360784015,1205397668,1,46,46,1360783986865,1360783986865,1205369533,1205369533,0
1360784015,1205397668,24,26190,1091.25,1360783987119,1360783987439,1205369787,1205370107,320
1360784015,1205397748,7,4284,612,1360783986849,1360783987233,1205369597,1205369981,384
1360784024,1205406624,3,210,70,1360784016926,1360784017246,1205399550,1205399870,320
1360784024,1205406628,2,131,65.5,1360784017369,1360784017369,1205399997,1205399997,0
1360784032,1205413820,1,52,52,1360784005442,1360784005442,1205387262,1205387262,0
1360784063,1205445728,5,693,138.6,1360784036533,1360784040885,1205419261,1205423613,4352
1360784068,1205449848,3,144,48,1360784042210,1360784043618,1205424058,1205425466,1408
1360784068,1205449884,3,144,48,1360784043201,1360784044673,1205425085,1205426557,1472
1360784071,1205453712,14,6631,473.6428571,1360784043205,1360784046405,1205425917,1205429117,3200
1360784071,1205453712,3,144,48,1360784043522,1360784045570,1205426234,1205428282,2048
1360784071,1205453716,2,96,48,1360784043518,1360784046462,1205426234,1205429178,2944
1360784104,1205486636,3,230,76.66666667,1360784097104,1360784097360,1205479740,1205479996,256
1360784112,1205494616,2,113,56.5,1360784104098,1360784104098,1205486714,1205486714,0
1360784112,1205494656,30,8648,288.2666667,1360784108797,1360784111229,1205491453,1205493885,2432
1360784112,1205494672,21,3437,163.6666667,1360784106986,1360784108778,1205489658,1205491450,1792
1360784112,1205494748,19,3456,181.8947368,1360784106717,1360784108701,1205489465,1205491449,1984
1360784120,1205502632,27,4078,151.037037,1360784115218,1360784117202,1205497850,1205499834,1984
1360784120,1205502636,22,3868,175.8181818,1360784111374,1360784113102,1205494010,1205495738,1728
1360784120,1205502648,19,5456,287.1578947,1360784113091,1360784114691,1205495739,1205497339,1600
1360784120,1205502684,14,6710,479.2857143,1360784114847,1360784116319,1205497531,1205499003,1472
1360784120,1205502748,18,3443,191.2777778,1360784116318,1360784119518,1205499066,1205502266,3200
1360784128,1205510640,58,60782,1047.965517,1360784123853,1360784126861,1205506493,1205509501,3008
1360784128,1205510676,20,4125,206.25,1360784121896,1360784123752,1205504572,1205506428,1856
1360784128,1205510712,18,3336,185.3333333,1360784119939,1360784121859,1205502651,1205504571,1920
1360784132,1205513868,9,4004,444.8888889,1360784105743,1360784107535,1205487611,1205489403,1792
1360784136,1205518648,18,3287,182.6111111,1360784128579,1360784128835,1205511227,1205511483,256
1360784136,1205518688,26,3855,148.2692308,1360784126809,1360784128473,1205509497,1205511161,1664
1360784152,1205533804,1,46,46,1360784123981,1360784123981,1205505785,1205505785,0
1360784152,1205533888,10,5505,550.5,1360784124217,1360784125497,1205506105,1205507385,1280
1360784153,1205534780,190,228811,1204.268421,1360783874856,1360784149992,1205256636,1205531772,275136
1360784160,1205541944,2,337,168.5,1360784132996,1360784132996,1205514940,1205514940,0
1360784161,1205542788,2,131,65.5,1360784155615,1360784155615,1205537403,1205537403,0
1360784196,1205577888,3,733,244.3333333,1360784168571,1360784169019,1205550459,1205550907,448
1360784208,1205590680,5,230,46,1360784204449,1360784204705,1205587129,1205587385,256
1360784232,1205613984,9,3463,384.7777778,1360784205339,1360784206747,1205587323,1205588731,1408
1360784248,1205629988,4,575,143.75,1360784221653,1360784246421,1205603641,1205628409,24768
1360784248,1205629996,3,567,189,1360784222476,1360784222668,1205604472,1205604664,192
1360784304,1205685988,1,46,46,1360784278422,1360784278422,1205660410,1205660410,0
1360784329,1205710840,2,131,65.5,1360784326697,1360784326697,1205708537,1205708537,0
1360784372,1205754300,1,52,52,1360784347099,1360784347099,1205729399,1205729399,0
1360784432,1205814580,1,46,46,1360784406915,1360784406915,1205789495,1205789495,0
1360784488,1205870512,1,52,52,1360784462150,1360784462150,1205844662,1205844662,0
1360784529,1205910868,3,138,46,1360784528778,1360784528778,1205910646,1205910646,0
1360784552,1205934664,1,188,188,1360784527277,1360784527277,1205909941,1205909941,0
1360784556,1205938508,12,4708,392.3333333,1360784528519,1360784530439,1205911027,1205912947,1920
1360784609,1205990840,1,186,186,1360784581795,1360784581795,1205963635,1205963635,0
1360784609,1205990948,8,977,122.125,1360784582199,1360784602935,1205964147,1205984883,20736
1360784665,1206047284,4,184,46,1360784660903,1360784660903,1206043187,1206043187,0
1360784689,1206070968,7,2757,393.8571429,1360784661475,1360784663907,1206043443,1206045875,2432
1360784789,1206171536,8,1488,186,1360784761063,1360784787367,1206143599,1206169903,26304
1360784802,1206184656,1,46,46,1360784774642,1360784774642,1206157298,1206157298,0
1360784825,1206207348,3,156,52,1360784822053,1360784824101,1206204401,1206206449,2048
1360784825,1206207564,3,558,186,1360784797322,1360784817354,1206179886,1206199918,20032
1360784853,1206235608,1,52,52,1360784826593,1360784826593,1206209201,1206209201,0
1360784905,1206287432,2,104,52,1360784903440,1360784904592,1206285872,1206287024,1152
1360784934,1206315940,1,52,52,1360784907257,1360784907257,1206289197,1206289197,0
1360785034,1206416032,3,152,50.66666667,1360785008991,1360785018015,1206391023,1206400047,9024
1360785266,1206648712,2,104,52,1360785240947,1360785243955,1206623659,1206626667,3008
1360785267,1206648764,2,104,52,1360785240807,1360785243815,1206622571,1206625579,3008
1360785267,1206648796,2,104,52,1360785241862,1360785244870,1206623658,1206626666,3008
1360785267,1206648828,2,104,52,1360785239588,1360785242596,1206621416,1206624424,3008
1360785599,1206981636,10,825,82.5,1360785572087,1360785573687,1206954723,1206956323,1600
1360785599,1206981672,15,3263,217.5333333,1360785573715,1360785575891,1206956387,1206958563,2176
1360785603,1206985628,9,4027,447.4444444,1360785577217,1360785583617,1206959845,1206966245,6400
1360785722,1207103868,16,4941,308.8125,1360785712567,1360785714103,1207094435,1207095971,1536
1360785722,1207103952,21,6527,310.8095238,1360785714720,1360785716000,1207096672,1207097952,1280
1360785731,1207113732,6,2732,455.3333333,1360785703893,1360785718805,1207086625,1207101537,14912
1360785738,1207120036,15,4731,315.4,1360785734735,1360785735695,1207116771,1207117731,960
1360785746,1207127932,23,8760,380.8695652,1360785737205,1360785743733,1207119137,1207125665,6528
1360785760,1207141864,3,1988,662.6666667,1360785733754,1360785754682,1207115618,1207136546,20928
1360785762,1207144068,18,8233,457.3888889,1360785755244,1360785757100,1207137312,1207139168,1856
1360785762,1207144096,19,5339,281,1360785758097,1360785759313,1207140193,1207141409,1216
1360785826,1207207960,2,104,52,1360785824281,1360785824601,1207206241,1207206561,320
1360786074,1207456156,15,3106,207.0666667,1360786066255,1360786073231,1207448411,1207455387,6976
1360786082,1207464196,27,7625,282.4074074,1360786073513,1360786081833,1207455709,1207464029,8320
1360786082,1207464200,18,5189,288.2777778,1360786075555,1360786077027,1207457755,1207459227,1472
1360786090,1207472200,110,13859,125.9909091,1360786073508,1360786088740,1207455708,1207470940,15232
1360786092,1207474284,2,128,64,1360786064783,1360786065871,1207447067,1207448155,1088
1360786092,1207474384,2,183,91.5,1360786066858,1360786066858,1207449242,1207449242,0
1360786092,1207474384,1,64,64,1360786066862,1360786066862,1207449246,1207449246,0
1360786098,1207480084,18,4275,237.5,1360786072025,1360786073817,1207454109,1207455901,1792
1360786108,1207490348,1,52,52,1360786081678,1360786081678,1207464026,1207464026,0
1360786111,4140772872,9,2350,261.1111111,1360786098666,1360786105066,4140760538,4140766938,6400
1360786114,1207496148,10,4427,442.7,1360786105366,1360786112662,1207487514,1207494810,7296
1360786114,1207496188,9,1973,219.2222222,1360786106288,1360786112624,1207488476,1207494812,6336
1360786114,1207496196,11,5462,496.5454545,1360786106730,1360786107306,1207488926,1207489502,576
1360786119,4140780864,11,2609,237.1818182,1360786106737,1360786113073,4140768601,4140774937,6336
1360786119,4140780872,13,5158,396.7692308,1360786105705,1360786115049,4140767577,4140776921,9344
1360786122,1207504096,54,28016,518.8148148,1360786096138,1360786114762,1207478234,1207496858,18624
1360786122,1207504112,18,12845,713.6111111,1360786106746,1360786114746,1207488858,1207496858,8000
1360786122,1207504140,44,42252,960.2727273,1360786105440,1360786114720,1207487580,1207496860,9280
1360786122,1207504188,19,15739,828.3684211,1360786106674,1360786114674,1207488862,1207496862,8000
1360786128,1207510360,24,4065,169.375,1360786100229,1360786100869,1207482589,1207483229,640
1360786136,1207518472,8,4884,610.5,1360786109843,1360786110291,1207492315,1207492763,448
1360786138,1207520244,14,1513,108.0714286,1360786126073,1360786132537,1207508317,1207514781,6464
1360786146,1207528212,4,235,58.75,1360786140697,1360786142105,1207522909,1207524317,1408
1360786151,4140812888,10,1904,190.4,1360786140761,1360786148953,4140802649,4140810841,8192
1360786154,1207536136,20,13693,684.65,1360786140389,1360786148645,1207522525,1207530781,8256
1360786154,1207536136,159,217422,1367.433962,1360786140324,1360786148644,1207522460,1207530780,8320
1360786154,1207536224,23,19558,850.3478261,1360786140236,1360786148556,1207522460,1207530780,8320
1360786154,1207536228,22,10123,460.1363636,1360786138185,1360786146569,1207520413,1207528797,8384
1360786156,1207538432,3,358,119.3333333,1360786130810,1360786153082,1207513242,1207535514,22272
1360786168,1207550388,10,5507,550.7,1360786140520,1360786156264,1207522908,1207538652,15744
1360786170,1207552236,15,2112,140.8,1360786156350,1360786164542,1207538586,1207546778,8192
1360786178,1207560160,8,3774,471.75,1360786173451,1360786175051,1207555611,1207557211,1600
1360786178,1207560204,11,9038,821.6363636,1360786174815,1360786174943,1207557019,1207557147,128
1360786178,1207560268,41,49676,1211.609756,1360786176990,1360786177566,1207559258,1207559834,576
1360786178,1207560276,18,9920,551.1111111,1360786177241,1360786177689,1207559517,1207559965,448
1360786178,1207560280,18,14680,815.5555556,1360786174354,1360786174994,1207556634,1207557274,640
1360786186,1207568172,4,893,223.25,1360786180413,1360786180541,1207562585,1207562713,128
1360786186,1207568176,5,2664,532.8,1360786180477,1360786180541,1207562653,1207562717,64
1360786186,1207568184,14,15199,1085.642857,1360786173107,1360786180595,1207555291,1207562779,7488
1360786186,1207568212,4,1380,345,1360786173527,1360786180567,1207555739,1207562779,7040
1360786186,1207568212,4,544,136,1360786179222,1360786179350,1207561434,1207561562,128
1360786186,1207568212,4,849,212.25,1360786179222,1360786179414,1207561434,1207561626,192
1360786186,1207568216,20,23478,1173.9,1360786173717,1360786180565,1207555933,1207562781,6848
1360786186,1207568224,4,597,149.25,1360786174793,1360786182665,1207557017,1207564889,7872
1360786186,1207568228,4,597,149.25,1360786174793,1360786182601,1207557021,1207564829,7808
1360786186,1207568228,4,797,199.25,1360786174857,1360786182665,1207557085,1207564893,7808
1360786186,1207568308,6,4019,669.8333333,1360786179318,1360786179382,1207561626,1207561690,64
1360786186,1207568316,49,65689,1340.591837,1360786174319,1360786182511,1207556635,1207564827,8192
1360786186,1207568316,4,977,244.25,1360786174319,1360786180463,1207556635,1207562779,6144
1360786194,1207576180,35,37669,1076.257143,1360786180406,1360786188726,1207562586,1207570906,8320
1360786194,1207576180,23,22440,975.6521739,1360786180406,1360786188726,1207562586,1207570906,8320
1360786194,1207576188,15,16153,1076.866667,1360786184557,1360786186349,1207566745,1207568537,1792
1360786194,1207576188,4,431,107.75,1360786186351,1360786186415,1207568539,1207568603,64
1360786194,1207576224,6,2593,432.1666667,1360786179402,1360786192074,1207561626,1207574298,12672
1360786194,1207576268,9,6593,732.5555556,1360786184479,1360786186271,1207566747,1207568539,1792
1360786194,1207576272,4,235,58.75,1360786186459,1360786187483,1207568731,1207569755,1024
1360786202,1207584192,17,16121,948.2941176,1360786188778,1360786196714,1207570970,1207578906,7936
1360786202,1207584196,23,26568,1155.130435,1360786188773,1360786196773,1207570969,1207578969,8000
1360786202,1207584196,101,138111,1367.435644,1360786188841,1360786196777,1207571037,1207578973,7936
1360786202,1207584308,14,1513,108.0714286,1360786186871,1360786194615,1207569179,1207576923,7744
1360786202,1207584316,4,356,89,1360786193647,1360786200623,1207575963,1207582939,6976
1360786204,1207586428,1,179,179,1360786178494,1360786178494,1207560922,1207560922,0
1360786204,1207586476,7,2827,403.8571429,1360786179536,1360786179984,1207562012,1207562460,448
1360786210,1207592276,8,2914,364.25,1360786188694,1360786202710,1207570970,1207584986,14016
1360786210,1207592276,3,229,76.33333333,1360786202453,1360786203221,1207584729,1207585497,768
1360786210,1207592296,68,75507,1110.397059,1360786186563,1360786208707,1207568859,1207591003,22144
1360786212,1207594420,8,4884,610.5,1360786186311,1360786187079,1207568731,1207569499,768
1360786218,1207600180,74,92146,1245.216216,1360786210040,1360786212088,1207592220,1207594268,2048
1360786218,1207600180,40,51040,1276,1360786212280,1360786213752,1207594460,1207595932,1472
1360786218,1207600180,14,14137,1009.785714,1360786210103,1360786211383,1207592283,1207593563,1280
1360786218,1207600180,21,17734,844.4761905,1360786210102,1360786215862,1207592282,1207598042,5760
1360786218,1207600180,32,29168,911.5,1360786210102,1360786212918,1207592282,1207595098,2816
1360786218,1207600184,20,19660,983,1360786204658,1360786210354,1207586842,1207592538,5696
1360786218,1207600188,4,801,200.25,1360786212847,1360786213423,1207595035,1207595611,576
1360786218,1207600188,44,53007,1204.704545,1360786210606,1360786211950,1207592794,1207594138,1344
1360786218,1207600188,4,1217,304.25,1360786216686,1360786217006,1207598874,1207599194,320
1360786218,1207600192,32,29617,925.53125,1360786211113,1360786212073,1207593305,1207594265,960
1360786218,1207600216,23,19805,861.0869565,1360786211092,1360786211860,1207593308,1207594076,768
1360786218,1207600216,31,28128,907.3548387,1360786211281,1360786212305,1207593497,1207594521,1024
1360786218,1207600228,40,38544,963.6,1360786211974,1360786213190,1207594202,1207595418,1216
1360786218,1207600256,30,26405,880.1666667,1360786212138,1360786213418,1207594394,1207595674,1280
1360786218,1207600256,4,542,135.5,1360786209962,1360786216746,1207592218,1207599002,6784
1360786218,1207600256,6,3266,544.3333333,1360786212138,1360786212778,1207594394,1207595034,640
1360786218,1207600260,3,284,94.66666667,1360786210024,1360786210664,1207592284,1207592924,640
1360786218,1207600260,7,4128,589.7142857,1360786212327,1360786212967,1207594587,1207595227,640
1360786218,1207600260,16,14511,906.9375,1360786210213,1360786214949,1207592473,1207597209,4736
1360786218,1207600264,7,3708,529.7142857,1360786210275,1360786214947,1207592539,1207597211,4672
1360786218,1207600268,4,1169,292.25,1360786216608,1360786216992,1207598876,1207599260,384
1360786218,1207600268,29,35220,1214.482759,1360786205150,1360786212830,1207587418,1207595098,7680
1360786218,1207600272,6,904,150.6666667,1360786213081,1360786215449,1207595353,1207597721,2368
1360786218,1207600272,24,21376,890.6666667,1360786210780,1360786211740,1207593052,1207594012,960
1360786218,1207600272,41,48426,1181.121951,1360786205275,1360786214939,1207587547,1207597211,9664
1360786218,1207600272,28,32149,1148.178571,1360786210906,1360786212058,1207593178,1207594330,1152
1360786218,1207600272,27,30422,1126.740741,1360786210906,1360786212698,1207593178,1207594970,1792
1360786218,1207600292,41,37440,913.1707317,1360786210949,1360786211845,1207593241,1207594137,896
1360786218,1207600300,3,270,90,1360786213949,1360786214653,1207596249,1207596953,704
1360786218,1207600308,23,21306,926.3478261,1360786211959,1360786213111,1207594267,1207595419,1152
1360786218,1207600308,23,20656,898.0869565,1360786211959,1360786213175,1207594267,1207595483,1216
1360786218,1207600308,62,83471,1346.306452,1360786214838,1360786215030,1207597146,1207597338,192
1360786218,1207600308,4,1190,297.5,1360786215030,1360786215350,1207597338,1207597658,320
1360786218,1207600308,4,1216,304,1360786215030,1360786215414,1207597338,1207597722,384
1360786218,1207600312,4,1167,291.75,1360786215092,1360786215540,1207597404,1207597852,448
1360786226,1207608188,2,131,65.5,1360786220911,1360786220911,1207603099,1207603099,0
1360786226,1207608188,4,556,139,1360786218415,1360786218863,1207600603,1207601051,448
1360786226,1207608188,4,556,139,1360786218415,1360786218863,1207600603,1207601051,448
1360786226,1207608196,13,9655,742.6923077,1360786205350,1360786224038,1207587546,1207606234,18688
1360786226,1207608220,4,627,156.75,1360786217293,1360786217869,1207599513,1207600089,576
1360786226,1207608232,23,19518,848.6086957,1360786211908,1360786221060,1207594140,1207603292,9152
1360786226,1207608232,18,20673,1148.5,1360786219908,1360786220612,1207602140,1207602844,704
1360786226,1207608232,15,12731,848.7333333,1360786219971,1360786225283,1207602203,1207607515,5312
1360786226,1207608232,12,12613,1051.083333,1360786220035,1360786225283,1207602267,1207607515,5248
1360786226,1207608232,17,19661,1156.529412,1360786219906,1360786220610,1207602138,1207602842,704
1360786226,1207608232,18,20673,1148.5,1360786219906,1360786225154,1207602138,1207607386,5248
1360786226,1207608236,12,12613,1051.083333,1360786219964,1360786220604,1207602200,1207602840,640
1360786226,1207608264,4,556,139,1360786218145,1360786218465,1207600409,1207600729,320
1360786226,1207608264,4,556,139,1360786218081,1360786218465,1207600345,1207600729,384
1360786226,1207608268,4,556,139,1360786218271,1360786218655,1207600539,1207600923,384
1360786226,1207608268,4,556,139,1360786218271,1360786218655,1207600539,1207600923,384
1360786226,1207608272,5,1238,247.6,1360786216540,1360786224860,1207598812,1207607132,8320
1360786226,1207608312,16,16581,1036.3125,1360786214130,1360786224690,1207596442,1207607002,10560
1360786226,1207608316,4,874,218.5,1360786214316,1360786220716,1207596632,1207603032,6400
1360786226,1207608316,17,19661,1156.529412,1360786219822,1360786225070,1207602138,1207607386,5248
1360786228,1207610456,23,28660,1246.086957,1360786203043,1360786219939,1207585499,1207602395,16896
1360786231,4140892888,6,1992,332,1360786214939,1360786225179,4140876827,4140887067,10240
1360786232,1207614536,37,37383,1010.351351,1360786205009,1360786228753,1207587545,1207611289,23744
1360786234,1207616264,15,2182,145.4666667,1360786218273,1360786226721,1207600537,1207608985,8448
1360786234,1207616300,5,671,134.2,1360786217216,1360786226880,1207599516,1207609180,9664
1360786244,1207626472,1,46,46,1360786218833,1360786218833,1207601305,1207601305,0
1360786248,1207630652,1,259,259,1360786223324,1360786223324,1207605976,1207605976,0
1360786252,1207634460,1,46,46,1360786226655,1360786226655,1207609115,1207609115,0
1360786252,1207634464,1,52,52,1360786226778,1360786226778,1207609242,1207609242,0
1360786252,1207634548,1,46,46,1360786226567,1360786226567,1207609115,1207609115,0
1360786252,1207634548,1,46,46,1360786226566,1360786226566,1207609114,1207609114,0
1360786256,1207638560,1,46,46,1360786228539,1360786228539,1207611099,1207611099,0
1360786264,1207646464,1,1426,1426,1360786237273,1360786237273,1207619737,1207619737,0
1360786266,1207648252,4,450,112.5,1360786260205,1360786265389,1207642457,1207647641,5184
1360786266,1207648256,7,5292,756,1360786260200,1360786265384,1207642456,1207647640,5184
1360786266,1207648256,29,27065,933.2758621,1360786260268,1360786262124,1207642524,1207644380,1856
1360786266,1207648256,4,855,213.75,1360786260203,1360786261419,1207642459,1207643675,1216
1360786266,1207648256,6,2946,491,1360786260394,1360786265770,1207642650,1207648026,5376
1360786266,1207648256,19,2123,111.7368421,1360786248361,1360786262761,1207630617,1207645017,14400
1360786266,1207648296,4,442,110.5,1360786261634,1360786261698,1207643930,1207643994,64
1360786266,1207648308,5,608,121.6,1360786262836,1360786264052,1207645144,1207646360,1216
1360786266,1207648336,4,825,206.25,1360786260185,1360786261337,1207642521,1207643673,1152
1360786266,1207648336,6,1718,286.3333333,1360786260249,1360786261337,1207642585,1207643673,1088
1360786266,1207648336,6,2964,494,1360786260313,1360786265689,1207642649,1207648025,5376
1360786266,1207648336,6,3197,532.8333333,1360786260313,1360786261337,1207642649,1207643673,1024
1360786266,1207648336,11,4584,416.7272727,1360786260312,1360786261720,1207642648,1207644056,1408
1360786266,1207648340,7,3576,510.8571429,1360786260308,1360786261332,1207642648,1207643672,1024
1360786266,1207648344,12,12726,1060.5,1360786264531,1360786265043,1207646875,1207647387,512
1360786266,1207648372,8,3000,375,1360786261304,1360786261944,1207643676,1207644316,640
1360786266,1207648372,27,21293,788.6296296,1360786249078,1360786261686,1207631450,1207644058,12608
1360786266,1207648372,13,12588,968.3076923,1360786261366,1360786262326,1207643738,1207644698,960
1360786266,1207648376,4,1136,284,1360786261744,1360786262128,1207644120,1207644504,384
1360786271,4140932904,4,464,116,1360786263051,1360786263051,4140924955,4140924955,0
1360786274,1207656244,4,542,135.5,1360786260022,1360786266742,1207642266,1207648986,6720
1360786274,1207656248,13,12772,982.4615385,1360786264369,1360786271153,1207646617,1207653401,6784
1360786274,1207656252,7,3162,451.7142857,1360786260590,1360786269038,1207642842,1207651290,8448
1360786274,1207656332,7,3200,457.1428571,1360786260575,1360786268959,1207642907,1207651291,8384
1360786274,1207656376,5,656,131.2,1360786262578,1360786270898,1207644954,1207653274,8320
1360786292,1207674624,1,46,46,1360786266488,1360786266488,1207649112,1207649112,0
1360786292,1207674628,1,46,46,1360786266487,1360786266487,1207649115,1207649115,0
1360786292,1207674628,1,46,46,1360786266614,1360786266614,1207649242,1207649242,0
1360786296,1207678572,1,64,64,1360786271405,1360786271405,1207653977,1207653977,0
1360786296,1207678588,1,46,46,1360786268701,1360786268701,1207651289,1207651289,0
1360786296,1207678628,2,128,64,1360786270067,1360786270771,1207652695,1207653399,704
1360786298,1207680296,23,2428,105.5652174,1360786278211,1360786296963,1207660507,1207679259,18752
1360786314,1207696368,2,201,100.5,1360786301050,1360786310650,1207683418,1207693018,9600
1360786322,1207704284,14,1513,108.0714286,1360786308301,1360786314765,1207690585,1207697049,6464
1360786346,1207728288,13,1436,110.4615385,1360786338247,1360786344711,1207720535,1207726999,6464
1360786361,1207742784,1,46,46,1360786332736,1360786332736,1207714520,1207714520,0
1360786378,1207760292,14,1513,108.0714286,1360786368387,1360786374915,1207750679,1207757207,6528
1360786401,1207782920,3,521,173.6666667,1360786373496,1360786373944,1207755416,1207755864,448
1360786410,1207792340,4,542,135.5,1360786404946,1360786407570,1207787286,1207789910,2624
1360786410,1207792380,7,2933,419,1360786406442,1360786407722,1207788822,1207790102,1280
1360786410,1207792380,7,2937,419.5714286,1360786406446,1360786407726,1207788826,1207790106,1280
1360786410,1207792380,7,2941,420.1428571,1360786406446,1360786407726,1207788826,1207790106,1280
1360786410,1207792388,5,926,185.2,1360786407014,1360786407526,1207789402,1207789914,512
1360786410,1207792452,14,1513,108.0714286,1360786398114,1360786404578,1207780566,1207787030,6464
1360786426,1207808480,2,104,52,1360786419975,1360786420231,1207802455,1207802711,256
1360786457,1207838944,13,5608,431.3846154,1360786429727,1360786431263,1207811671,1207813207,1536
1360786457,1207838980,17,17832,1048.941176,1360786430845,1360786431101,1207812825,1207813081,256
1360786457,1207839012,4,2715,678.75,1360786432346,1360786432410,1207814358,1207814422,64
1360786457,1207839016,6,4584,764,1360786432409,1360786432601,1207814425,1207814617,192
1360786457,1207839016,6,5382,897,1360786432599,1360786432663,1207814615,1207814679,64
1360786457,1207839016,6,5258,876.3333333,1360786432598,1360786432662,1207814614,1207814678,64
1360786457,1207839064,16,18286,1142.875,1360786430760,1360786431016,1207812824,1207813080,256
1360786457,1207839096,5,4228,845.6,1360786432265,1360786432329,1207814361,1207814425,64
1360786457,1207839096,5,4182,836.4,1360786432517,1360786432581,1207814613,1207814677,64
1360786461,1207843056,3,554,184.6666667,1360786432942,1360786433006,1207814998,1207815062,64
1360786482,1207864468,12,929,77.41666667,1360786472211,1360786474515,1207854679,1207856983,2304
1360786501,1207882976,2,176,88,1360786474365,1360786474365,1207856341,1207856341,0
1360786501,1207883100,15,3151,210.0666667,1360786474500,1360786476932,1207856600,1207859032,2432
1360786501,1207883116,11,2078,188.9090909,1360786473716,1360786474676,1207855832,1207856792,960
1360786501,1207883152,1,52,52,1360786476237,1360786476237,1207858389,1207858389,0
1360786521,1207903356,8,721,90.125,1360786495428,1360786495684,1207877784,1207878040,256
1360786561,1207943432,7,3869,552.7142857,1360786534774,1360786534902,1207917206,1207917334,128
1360786561,1207943436,4,1980,495,1360786535027,1360786535155,1207917463,1207917591,128
1360786561,1207943436,21,20521,977.1904762,1360786535217,1360786535857,1207917653,1207918293,640
1360786561,1207943524,3,1091,363.6666667,1360786534682,1360786534810,1207917206,1207917334,128
1360786561,1207943552,11,3624,329.4545455,1360786535231,1360786537663,1207917783,1207920215,2432
1360786561,1207943564,7,3223,460.4285714,1360786536627,1360786537331,1207919191,1207919895,704
1360786565,1207947408,5,4302,860.4,1360786537422,1360786537550,1207919830,1207919958,128
1360786565,1207947412,5,4054,810.8,1360786537415,1360786537479,1207919827,1207919891,64
1360786565,1207947412,5,4282,856.4,1360786537419,1360786537483,1207919831,1207919895,64
1360786565,1207947412,6,4568,761.3333333,1360786537419,1360786537483,1207919831,1207919895,64
1360786565,1207947440,5,2014,402.8,1360786538861,1360786538989,1207921301,1207921429,128
1360786565,1207947492,1,202,202,1360786538171,1360786538171,1207920663,1207920663,0
1360786565,1207947520,6,4633,772.1666667,1360786537311,1360786537375,1207919831,1207919895,64
1360786565,1207947520,6,4694,782.3333333,1360786537310,1360786537374,1207919830,1207919894,64
1360786565,1207947520,6,4444,740.6666667,1360786537310,1360786537374,1207919830,1207919894,64
1360786565,1207947520,5,4229,845.8,1360786537374,1360786537630,1207919894,1207920150,256
1360786569,1207951388,3,152,50.66666667,1360786544865,1360786546273,1207927253,1207928661,1408
1360786569,1207951480,4,1070,267.5,1360786541125,1360786552069,1207923605,1207934549,10944
1360786569,1207951516,4,1050,262.5,1360786542370,1360786561442,1207924886,1207943958,19072
1360786573,1207955416,3,152,50.66666667,1360786545925,1360786547589,1207928341,1207930005,1664
1360786573,1207955456,3,152,50.66666667,1360786546972,1360786548444,1207929428,1207930900,1472
1360786573,1207955540,2,104,52,1360786546888,1360786549896,1207929428,1207932436,3008
1360786597,1207979528,1,469,469,1360786571412,1360786571412,1207953940,1207953940,0
1360786597,1207979564,1,403,403,1360786572081,1360786572081,1207954645,1207954645,0
1360786637,1208019704,1,403,403,1360786612003,1360786612003,1207994707,1207994707,0
1360786649,1208031720,1,389,389,1360786624082,1360786624082,1208006802,1208006802,0
1360786678,1208059844,1,403,403,1360786652928,1360786652928,1208034772,1208034772,0
1360786690,1208072600,4854,6846935,1410.575814,1360786538955,1360786686155,1207921555,1208068755,147200
1360786698,1208079780,1,52,52,1360786671294,1360786671294,1208053074,1208053074,0
1360786698,1208079784,1,52,52,1360786671420,1360786671420,1208053204,1208053204,0
1360786698,1208079820,1,52,52,1360786672598,1360786672598,1208054418,1208054418,0
1360786698,1208079824,1,52,52,1360786672850,1360786672850,1208054674,1208054674,0
1360786698,1208079848,1,52,52,1360786672762,1360786672762,1208054610,1208054610,0
1360786698,1208079848,1,52,52,1360786673213,1360786673213,1208055061,1208055061,0
1360786698,1208079848,1,52,52,1360786672829,1360786672829,1208054677,1208054677,0
1360786698,1208079896,1,52,52,1360786671180,1360786671180,1208053076,1208053076,0
1360786698,1208080020,1,52,52,1360786672400,1360786672400,1208054420,1208054420,0
1360786698,1208080020,1,52,52,1360786672655,1360786672655,1208054675,1208054675,0
1360786698,1208080604,4,235,58.75,1360786694278,1360786694278,1208076882,1208076882,0
1360786718,1208099960,2,806,403,1360786692873,1360786693129,1208074833,1208075089,256
1360786758,1208140004,3,870,290,1360786733024,1360786733280,1208115028,1208115284,256
1360786798,1208180036,2,455,227.5,1360786773501,1360786773501,1208155537,1208155537,0
1360786802,1208184000,1,52,52,1360786775587,1360786775587,1208157587,1208157587,0
1360786802,1208184008,1,52,52,1360786776283,1360786776283,1208158291,1208158291,0
1360786802,1208184092,1,52,52,1360786775239,1360786775239,1208157331,1208157331,0
1360786802,1208184092,1,52,52,1360786775238,1360786775238,1208157330,1208157330,0
1360786806,1208187960,1,52,52,1360786777929,1360786777929,1208159889,1208159889,0
1360786806,1208187960,1,52,52,1360786777929,1360786777929,1208159889,1208159889,0
1360786806,1208187960,1,52,52,1360786777929,1360786777929,1208159889,1208159889,0
1360786806,1208187960,1,52,52,1360786777929,1360786777929,1208159889,1208159889,0
1360786806,1208187960,1,52,52,1360786777929,1360786777929,1208159889,1208159889,0
1360786806,1208187964,1,52,52,1360786777991,1360786777991,1208159955,1208159955,0
1360786806,1208187964,1,52,52,1360786778180,1360786778180,1208160144,1208160144,0
1360786806,1208188036,1,52,52,1360786777853,1360786777853,1208159889,1208159889,0
1360786806,1208188036,1,52,52,1360786777917,1360786777917,1208159953,1208159953,0
1360786806,1208188044,1,46,46,1360786778231,1360786778231,1208160275,1208160275,0
1360786838,1208220228,11,3665,333.1818182,1360786813692,1360786825340,1208195920,1208207568,11648
1360786838,1208220236,1,46,46,1360786809844,1360786809844,1208192080,1208192080,0
1360786838,1208220360,1,52,52,1360786811641,1360786811641,1208194001,1208194001,0
1360786842,1208224244,1,46,46,1360786814510,1360786814510,1208196754,1208196754,0
1360786866,1208248584,4,542,135.5,1360786858008,1360786864344,1208240592,1208246928,6336
1360786866,1208248596,10,5670,567,1360786859404,1360786864716,1208242000,1208247312,5312
1360786866,1208248600,5,608,121.6,1360786862794,1360786863882,1208245394,1208246482,1088
1360786866,1208248600,5,608,121.6,1360786862857,1360786863881,1208245457,1208246481,1024
1360786866,1208248620,5,608,121.6,1360786862900,1360786863860,1208245520,1208246480,960
1360786866,1208248704,8,4172,521.5,1360786859296,1360786864608,1208242000,1208247312,5312
1360786866,1208248708,5,608,121.6,1360786862748,1360786863836,1208245456,1208246544,1088
1360786871,4141533208,4,464,116,1360786862431,1360786868831,4141524639,4141531039,6400
1360786874,1208256644,7,2952,421.7142857,1360786859358,1360786870558,1208242002,1208253202,11200
1360786874,1208256672,23,19905,865.4347826,1360786863872,1360786872704,1208246544,1208255376,8832
1360786874,1208256672,13,12659,973.7692308,1360786864383,1360786872703,1208247055,1208255375,8320
1360786874,1208256712,5,926,185.2,1360786861464,1360786868184,1208244176,1208250896,6720
1360786874,1208256716,4,592,148,1360786861717,1360786868181,1208244433,1208250897,6464
1360786874,1208256716,6,996,166,1360786862035,1360786870355,1208244751,1208253071,8320
1360786874,1208256748,24,20917,871.5416667,1360786863540,1360786870580,1208246288,1208253328,7040
1360786874,1208256752,24,20917,871.5416667,1360786864050,1360786872626,1208246802,1208255378,8576
1360786874,1208256752,16,12777,798.5625,1360786864050,1360786872626,1208246802,1208255378,8576
1360786874,1208256752,23,19905,865.4347826,1360786864305,1360786872625,1208247057,1208255377,8320
1360786882,1208264728,11,2232,202.9090909,1360786879113,1360786879625,1208261841,1208262353,512
1360786883,1208264812,8,2766,345.75,1360786879835,1360786880475,1208261647,1208262287,640
1360786883,1208264812,33,26856,813.8181818,1360786880091,1360786882011,1208261903,1208263823,1920
1360786883,1208264824,48,33440,696.6666667,1360786866961,1360786879185,1208248785,1208261009,12224
1360786883,1208264852,13,1617,124.3846154,1360786881270,1360786882102,1208263122,1208263954,832
1360786883,1208264852,9,3607,400.7777778,1360786868277,1360786875061,1208250129,1208256913,6784
1360786887,4141549176,11,4593,417.5454545,1360786879164,1360786886844,4141541340,4141549020,7680
1360786887,4141549204,10,2961,296.1,1360786879138,1360786886818,4141541342,4141549022,7680
1360786890,1208272520,19,13478,709.3684211,1360786865175,1360786866199,1208247695,1208248719,1024
1360786890,1208272672,15,8472,564.8,1360786878592,1360786886400,1208261264,1208269072,7808
1360786890,1208272672,28,25182,899.3571429,1360786878655,1360786886527,1208261327,1208269199,7872
1360786890,1208272672,13,4804,369.5384615,1360786878591,1360786886271,1208261263,1208268943,7680
1360786890,1208272676,9,3075,341.6666667,1360786878781,1360786886653,1208261457,1208269329,7872
1360786890,1208272676,12,3268,272.3333333,1360786878844,1360786886908,1208261520,1208269584,8064
1360786890,1208272748,14,5474,391,1360786878515,1360786886579,1208261263,1208269327,8064
1360786897,1208278880,1,52,52,1360786869337,1360786869337,1208251217,1208251217,0
1360786897,1208278884,1,52,52,1360786869334,1360786869334,1208251218,1208251218,0
1360786897,1208279272,1,48,48,1360786866514,1360786866514,1208248786,1208248786,0
1360786898,1208280684,11,6060,550.9090909,1360786889971,1360786896819,1208272655,1208279503,6848
1360786898,1208280700,22,8126,369.3636364,1360786887014,1360786896870,1208269714,1208279570,9856
1360786902,1208284388,3,152,50.66666667,1360786876443,1360786877979,1208258831,1208260367,1536
1360786902,1208284424,3,152,50.66666667,1360786877497,1360786878905,1208259921,1208261329,1408
1360786906,1208288348,3,152,50.66666667,1360786878723,1360786880195,1208261071,1208262543,1472
1360786906,1208288348,3,152,50.66666667,1360786878723,1360786887683,1208261071,1208270031,8960
1360786906,1208288640,15,4573,304.8666667,1360786890463,1360786898847,1208273103,1208281487,8384
1360786906,1208288712,15,4150,276.6666667,1360786890328,1360786898776,1208273040,1208281488,8448
1360786910,1208292380,1,46,46,1360786883365,1360786883365,1208265745,1208265745,0
1360786910,1208292380,1,46,46,1360786883363,1360786883363,1208265743,1208265743,0
1360786910,1208292380,1,46,46,1360786883363,1360786883363,1208265743,1208265743,0
1360786910,1208292384,1,46,46,1360786883361,1360786883361,1208265745,1208265745,0
1360786910,1208292384,1,46,46,1360786883361,1360786883361,1208265745,1208265745,0
1360786910,1208292384,1,46,46,1360786883361,1360786883361,1208265745,1208265745,0
1360786910,1208292444,1,79,79,1360786882341,1360786882341,1208264785,1208264785,0
1360786910,1208292480,1,46,46,1360786883265,1360786883265,1208265745,1208265745,0
1360786910,1208292480,1,46,46,1360786883265,1360786883265,1208265745,1208265745,0
1360786910,1208292480,1,46,46,1360786883265,1360786883265,1208265745,1208265745,0
1360786910,1208292480,1,46,46,1360786883265,1360786883265,1208265745,1208265745,0
1360786910,1208292480,1,46,46,1360786883265,1360786883265,1208265745,1208265745,0
1360786910,1208292480,1,46,46,1360786883264,1360786883264,1208265744,1208265744,0
1360786910,1208292480,1,46,46,1360786883264,1360786883264,1208265744,1208265744,0
1360786910,1208292480,1,46,46,1360786883264,1360786883264,1208265744,1208265744,0
1360786910,1208292480,1,52,52,1360786883264,1360786883264,1208265744,1208265744,0
1360786914,1208296456,10,5486,548.6,1360786887385,1360786912473,1208269841,1208294929,25088
1360786914,1208296680,96,121304,1263.583333,1360786911289,1360786912249,1208293969,1208294929,960
1360786914,1208296684,10,2240,224,1360786911924,1360786912244,1208294608,1208294928,320
1360786914,1208296684,13,2428,186.7692308,1360786911923,1360786912499,1208294607,1208295183,576
1360786914,1208296688,10,2145,214.5,1360786911986,1360786913138,1208294674,1208295826,1152
1360786914,1208296716,9,2118,235.3333333,1360786912403,1360786912531,1208295119,1208295247,128
1360786915,1208296768,19,13567,714.0526316,1360786912201,1360786913097,1208293969,1208294865,896
1360786915,1208296776,11,2285,207.7272727,1360786912895,1360786913279,1208294671,1208295055,384
1360786915,1208296800,10,2171,217.1,1360786912871,1360786913767,1208294671,1208295567,896
1360786919,4141581184,10,2159,215.9,1360786911926,1360786913590,4141574110,4141575774,1664
1360786919,4141581184,12,2429,202.4166667,1360786911926,1360786913078,4141574110,4141575262,1152
1360786919,4141581184,9,1947,216.3333333,1360786912053,1360786912565,4141574237,4141574749,512
1360786919,4141581184,10,1897,189.7,1360786912053,1360786912949,4141574237,4141575133,896
1360786919,4141581184,12,2194,182.8333333,1360786912117,1360786912821,4141574301,4141575005,704
1360786919,4141581196,11,2269,206.2727273,1360786911979,1360786912555,4141574175,4141574751,576
1360786919,4141581208,11,2189,199,1360786912095,1360786913247,4141574303,4141575455,1152
1360786922,1208304660,120,157978,1316.483333,1360786905803,1360786916875,1208288463,1208299535,11072
1360786922,1208304700,38,26956,709.3684211,1360786900515,1360786914851,1208283215,1208297551,14336
1360786922,1208304708,88,113924,1294.590909,1360786909212,1360786916828,1208291920,1208299536,7616
1360786927,4141589180,10,2443,244.3,1360786911930,1360786919610,4141574110,4141581790,7680
1360786927,4141589180,9,1898,210.8888889,1360786911994,1360786919610,4141574174,4141581790,7616
1360786927,4141589184,9,3048,338.6666667,1360786905717,1360786919477,4141567901,4141581661,13760
1360786927,4141589192,10,2291,229.1,1360786911918,1360786919598,4141574110,4141581790,7680
1360786927,4141589204,11,4064,369.4545455,1360786905697,1360786919905,4141567901,4141582109,14208
1360786939,1208320764,16,1671,104.4375,1360786931403,1360786938699,1208313167,1208320463,7296
1360786946,1208328684,4,235,58.75,1360786942197,1360786943157,1208324881,1208325841,960
1360786970,1208352484,8,4884,610.5,1360786942394,1360786943098,1208324878,1208325582,704
1360786979,1208360820,17,1879,110.5294118,1360786961489,1360786977297,1208343309,1208359117,15808
1360786987,1208369136,5,671,134.2,1360786973529,1360786983001,1208355665,1208365137,9472
1360787011,1208393080,20,4604,230.2,1360786991053,1360787003533,1208373133,1208385613,12480
1360787067,1208448872,14,7393,528.0714286,1360787039069,1360787039517,1208420941,1208421389,448
1360787067,1208448992,25,24228,969.12,1360787039652,1360787046436,1208421644,1208428428,6784
1360787067,1208448992,11,3665,333.1818182,1360787039844,1360787046436,1208421836,1208428428,6592
1360787071,1208452928,3,1109,369.6666667,1360787046436,1360787046500,1208428364,1208428428,64
1360787071,1208453016,22,21251,965.9545455,1360787046348,1360787047244,1208428364,1208429260,896
1360787071,1208453020,4,1981,495.25,1360787046538,1360787046666,1208428558,1208428686,128
1360787075,1208456792,5,4323,864.6,1360787048556,1360787048748,1208430348,1208430540,192
1360787075,1208456792,5,4041,808.2,1360787048556,1360787048684,1208430348,1208430476,128
1360787075,1208456792,6,4561,760.1666667,1360787048556,1360787048748,1208430348,1208430540,192
1360787075,1208456792,5,4338,867.6,1360787048623,1360787048751,1208430415,1208430543,128
1360787075,1208456792,6,5052,842,1360787048623,1360787048879,1208430415,1208430671,256
1360787075,1208456792,6,5442,907,1360787048622,1360787048750,1208430414,1208430542,128
1360787075,1208456884,6,4823,803.8333333,1360787048531,1360787048659,1208430415,1208430543,128
1360787075,1208456884,6,4774,795.6666667,1360787048531,1360787048659,1208430415,1208430543,128
1360787075,1208456884,6,4610,768.3333333,1360787048466,1360787048722,1208430350,1208430606,256
1360787075,1208456884,5,4183,836.6,1360787048530,1360787048658,1208430414,1208430542,128
1360787075,1208456884,6,4794,799,1360787048530,1360787048658,1208430414,1208430542,128
1360787075,1208456920,4,1774,443.5,1360787049967,1360787050031,1208431887,1208431951,64
1360787079,1208460804,4,1070,267.5,1360787051936,1360787062944,1208433740,1208444748,11008
1360787079,1208460924,4,1050,262.5,1360787052907,1360787072939,1208434831,1208454863,20032
1360787099,1208481092,4,218,54.5,1360787096131,1360787096195,1208478223,1208478287,64
1360787107,1208488860,1,469,469,1360787082025,1360787082025,1208463885,1208463885,0
1360787111,1208492864,7,2541,363,1360787084902,1360787085414,1208466766,1208467278,512
1360787111,1208492908,1,403,403,1360787082938,1360787082938,1208464846,1208464846,0
1360787115,1208497228,3241,4592181,1416.902499,1360787049720,1360787113016,1208431948,1208495244,63296
1360787147,1208529116,1,403,403,1360787122793,1360787122793,1208504909,1208504909,0
1360787191,1208573200,1,403,403,1360787162836,1360787162836,1208545036,1208545036,0
1360787227,1208609660,5,1045,209,1360787221895,1360787221959,1208604555,1208604619,64
1360787231,1208613332,2,806,403,1360787202896,1360787224208,1208585228,1208606540,21312
1360787243,1208625484,1,46,46,1360787218486,1360787218486,1208600970,1208600970,0
1360787247,1208629304,3,3643,1214.333333,1360787220329,1360787220329,1208602633,1208602633,0
1360787247,1208629304,8,8964,1120.5,1360787220329,1360787220393,1208602633,1208602697,64
1360787247,1208629304,4,4589,1147.25,1360787220329,1360787220329,1208602633,1208602633,0
1360787247,1208629328,3,4048,1349.333333,1360787220308,1360787220308,1208602636,1208602636,0
1360787247,1208629328,3,3816,1272,1360787220308,1360787220308,1208602636,1208602636,0
1360787247,1208629372,2,1042,521,1360787218982,1360787219046,1208601354,1208601418,64
1360787247,1208629372,18,20348,1130.444444,1360787218982,1360787219238,1208601354,1208601610,256
1360787247,1208629376,3,752,250.6666667,1360787219108,1360787219172,1208601484,1208601548,64
1360787247,1208629376,3,2051,683.6666667,1360787219108,1360787219172,1208601484,1208601548,64
1360787247,1208629416,4,5209,1302.25,1360787220217,1360787220217,1208602633,1208602633,0
1360787247,1208629416,3,3950,1316.666667,1360787220217,1360787220217,1208602633,1208602633,0
1360787247,1208629416,4,5316,1329,1360787220217,1360787220217,1208602633,1208602633,0
1360787247,1208629416,4,4498,1124.5,1360787220219,1360787220219,1208602635,1208602635,0
1360787247,1208629416,3,3311,1103.666667,1360787220219,1360787220219,1208602635,1208602635,0
1360787247,1208629416,4,5168,1292,1360787220219,1360787220219,1208602635,1208602635,0
1360787247,1208629456,4,1774,443.5,1360787221908,1360787221972,1208604364,1208604428,64
1360787251,1208633328,2,938,469,1360787225173,1360787244245,1208607501,1208626573,19072
1360787259,1208641524,1,403,403,1360787234062,1360787234062,1208616586,1208616586,0
1360787259,1208641596,4,190,47.5,1360787240073,1360787257737,1208622669,1208640333,17664
1360787275,1208657560,6,1504,250.6666667,1360787250474,1360787252138,1208633034,1208634698,1664
1360787276,1208657808,2,131,65.5,1360787274075,1360787274075,1208655883,1208655883,0
1360787303,1208685624,1,52,52,1360787278761,1360787278761,1208661385,1208661385,0
1360787303,1208685676,17,16920,995.2941176,1360787277367,1360787277559,1208660043,1208660235,192
1360787303,1208685704,3,3717,1239,1360787278169,1360787278169,1208660873,1208660873,0
1360787303,1208685704,6,5383,897.1666667,1360787278169,1360787278233,1208660873,1208660937,64
1360787303,1208685708,4,4412,1103,1360787278166,1360787278166,1208660874,1208660874,0
1360787303,1208685708,3,3763,1254.333333,1360787278166,1360787278166,1208660874,1208660874,0
1360787303,1208685708,3,4169,1389.666667,1360787278165,1360787278165,1208660873,1208660873,0
1360787303,1208685708,4,5254,1313.5,1360787278165,1360787278165,1208660873,1208660873,0
1360787304,1208685796,4,5093,1273.25,1360787279078,1360787279078,1208660874,1208660874,0
1360787304,1208685796,5,4788,957.6,1360787279078,1360787279078,1208660874,1208660874,0
1360787304,1208685820,5,4428,885.6,1360787279055,1360787279055,1208660875,1208660875,0
1360787304,1208685820,4,4698,1174.5,1360787279055,1360787279055,1208660875,1208660875,0
1360787304,1208685820,4,4785,1196.25,1360787279055,1360787279055,1208660875,1208660875,0
1360787304,1208685820,4,4828,1207,1360787279054,1360787279054,1208660874,1208660874,0
1360787311,1208693704,1,52,52,1360787285720,1360787285720,1208668424,1208668424,0
1360787320,1208702444,1,46,46,1360787292252,1360787292252,1208674696,1208674696,0
1360787332,1208714048,2,104,52,1360787325226,1360787325482,1208707274,1208707530,256
1360787340,1208721812,14,1513,108.0714286,1360787327635,1360787334291,1208709447,1208716103,6656
1360787355,1208737688,32,34973,1092.90625,1360787344106,1360787351466,1208726794,1208734154,7360
1360787355,1208737688,9,2959,328.7777778,1360787344106,1360787351466,1208726794,1208734154,7360
1360787355,1208737688,42,40063,953.8809524,1360787344105,1360787351465,1208726793,1208734153,7360
1360787355,1208737716,9,3607,400.7777778,1360787341387,1360787349387,1208724103,1208732103,8000
1360787359,4142021288,11,3683,334.8181818,1360787346002,1360787354002,4142008290,4142016290,8000
1360787363,1208745756,40,23238,580.95,1360787339173,1360787355493,1208721929,1208738249,16320
1360787368,1208749988,1,46,46,1360787343077,1360787343077,1208725065,1208725065,0
1360787372,1208753904,9,5331,592.3333333,1360787346745,1360787350969,1208728649,1208732873,4224
1360787380,1208761924,1,52,52,1360787354342,1360787354342,1208736266,1208736266,0
1360787380,1208761924,1,46,46,1360787354406,1360787354406,1208736330,1208736330,0
1360787380,1208761924,1,52,52,1360787354405,1360787354405,1208736329,1208736329,0
1360787380,1208761924,1,52,52,1360787354405,1360787354405,1208736329,1208736329,0
1360787380,1208761924,1,52,52,1360787354405,1360787354405,1208736329,1208736329,0
1360787380,1208761924,1,52,52,1360787354405,1360787354405,1208736329,1208736329,0
1360787380,1208761944,1,52,52,1360787354383,1360787354383,1208736327,1208736327,0
1360787380,1208761944,1,46,46,1360787354383,1360787354383,1208736327,1208736327,0
1360787380,1208761944,1,52,52,1360787354383,1360787354383,1208736327,1208736327,0
1360787380,1208761944,1,52,52,1360787354383,1360787354383,1208736327,1208736327,0
1360787380,1208762040,1,52,52,1360787354289,1360787354289,1208736329,1208736329,0
1360787380,1208762040,1,52,52,1360787354289,1360787354289,1208736329,1208736329,0
1360787380,1208762040,1,52,52,1360787354289,1360787354289,1208736329,1208736329,0
1360787380,1208762040,1,52,52,1360787354289,1360787354289,1208736329,1208736329,0
1360787380,1208762040,1,52,52,1360787354289,1360787354289,1208736329,1208736329,0
1360787380,1208762040,1,52,52,1360787354289,1360787354289,1208736329,1208736329,0
1360787380,1208762044,1,46,46,1360787354223,1360787354223,1208736267,1208736267,0
1360787380,1208762044,1,52,52,1360787354286,1360787354286,1208736330,1208736330,0
1360787380,1208762044,1,52,52,1360787354286,1360787354286,1208736330,1208736330,0
1360787380,1208762044,1,52,52,1360787354286,1360787354286,1208736330,1208736330,0
1360787380,1208762080,7,2924,417.7142857,1360787355274,1360787355978,1208737354,1208738058,704
1360787384,1208765904,17,3401,200.0588235,1360787358265,1360787366137,1208740169,1208748041,7872
1360787387,1208769608,17,7117,418.6470588,1360787372154,1360787379706,1208754762,1208762314,7552
1360787387,1208769632,10,2158,215.8,1360787377631,1360787385695,1208760263,1208768327,8064
1360787391,4142053300,9,1999,222.1111111,1360787378181,1360787386117,4142040481,4142048417,7936
1360787396,1208777856,14,1513,108.0714286,1360787387561,1360787394537,1208769417,1208776393,6976
1360787400,1208781836,10,825,82.5,1360787373883,1360787376891,1208755719,1208758727,3008
1360787404,1208786132,14,3088,220.5714286,1360787376788,1360787383636,1208758920,1208765768,6848
1360787408,1208789812,1,52,52,1360787381076,1360787381076,1208762888,1208762888,0
1360787411,1208793608,4,956,239,1360787403066,1360787409786,1208785674,1208792394,6720
1360787411,1208793648,9,7311,812.3333333,1360787406351,1360787406991,1208788999,1208789639,640
1360787411,1208793652,9,4442,493.5555556,1360787406350,1360787406990,1208789002,1208789642,640
1360787411,1208793652,38,48880,1286.315789,1360787406732,1360787407116,1208789384,1208789768,384
1360787412,1208793836,11,9071,824.6363636,1360787407163,1360787407803,1208788999,1208789639,640
1360787412,1208793840,9,2244,249.3333333,1360787407543,1360787407927,1208789383,1208789767,384
1360787412,1208793844,5,2448,489.6,1360787407796,1360787407860,1208789640,1208789704,64
1360787412,1208793844,5,3014,602.8,1360787407795,1360787407859,1208789639,1208789703,64
1360787416,1208797992,1,435,435,1360787390690,1360787390690,1208772682,1208772682,0
1360787419,1208801664,20,22087,1104.35,1360787405506,1360787413762,1208788170,1208796426,8256
1360787419,1208801664,46,60894,1323.782609,1360787405506,1360787411778,1208788170,1208794442,6272
1360787419,1208801668,4,963,240.75,1360787406010,1360787413754,1208788678,1208796422,7744
1360787419,1208801668,8,5199,649.875,1360787406332,1360787413756,1208789000,1208796424,7424
1360787419,1208801668,8,4657,582.125,1360787406395,1360787413755,1208789063,1208796423,7360
1360787419,1208801672,6,4084,680.6666667,1360787406394,1360787413754,1208789066,1208796426,7360
1360787419,1208801708,83,109628,1320.819277,1360787403411,1360787413715,1208786119,1208796423,10304
1360787427,1208809672,14,1513,108.0714286,1360787416761,1360787423801,1208799433,1208806473,7040
1360787428,1208810076,9,4055,450.5555556,1360787401036,1360787402828,1208783112,1208784904,1792
1360787443,1208825692,5,2644,528.8,1360787429860,1360787437732,1208812552,1208820424,7872
1360787443,1208825700,8,6379,797.375,1360787430621,1360787437725,1208813321,1208820425,7104
1360787443,1208825700,10,4284,428.4,1360787430621,1360787437725,1208813321,1208820425,7104
1360787443,1208825700,5,1686,337.2,1360787430621,1360787437725,1208813321,1208820425,7104
1360787443,1208825700,5,2952,590.4,1360787430621,1360787437725,1208813321,1208820425,7104
1360787443,1208825704,25,30681,1227.24,1360787431001,1360787437721,1208813705,1208820425,6720
1360787444,1208825776,6,3115,519.1666667,1360787431543,1360787438647,1208813319,1208820423,7104
1360787444,1208825776,15,17062,1137.466667,1360787431543,1360787438647,1208813319,1208820423,7104
1360787459,1208841696,14,1513,108.0714286,1360787446752,1360787453792,1208829448,1208836488,7040
1360787467,1208849700,10,8977,897.7,1360787457244,1360787463772,1208839944,1208846472,6528
1360787483,1208865684,32,40971,1280.34375,1360787471465,1360787477801,1208854149,1208860485,6336
1360787484,1208865764,10,4355,435.5,1360787464321,1360787476737,1208846085,1208858501,12416
1360787484,1208865812,7,3294,470.5714286,1360787470933,1360787478677,1208852745,1208860489,7744
1360787484,1208865840,11,11475,1043.181818,1360787471928,1360787478648,1208853768,1208860488,6720
1360787491,1208873700,2,131,65.5,1360787484314,1360787484314,1208867014,1208867014,0
1360787492,1208873812,14,1513,108.0714286,1360787477650,1360787484690,1208859462,1208866502,7040
1360787499,1208881700,4,665,166.25,1360787487771,1360787495771,1208870471,1208878471,8000
1360787499,1208881704,33,42064,1274.666667,1360787488151,1360787495831,1208870855,1208878535,7680
1360787499,1208881704,11,10953,995.7272727,1360787488151,1360787495831,1208870855,1208878535,7680
1360787499,1208881704,4,632,158,1360787488215,1360787495767,1208870919,1208878471,7552
1360787499,1208881744,6,4269,711.5,1360787487022,1360787493742,1208869766,1208876486,6720
1360787507,1208889720,4,508,127,1360787495685,1360787501829,1208878405,1208884549,6144
1360787508,1208889812,4,521,130.25,1360787496851,1360787504723,1208878663,1208886535,7872
1360787508,1208889812,4,628,157,1360787496787,1360787504723,1208878599,1208886535,7936
1360787516,1208897856,4,628,157,1360787506854,1360787514726,1208888710,1208896582,7872
1360787516,1208897860,14,1513,108.0714286,1360787507681,1360787514721,1208889541,1208896581,7040
1360787532,1208913832,5,692,138.4,1360787516861,1360787525053,1208898693,1208906885,8192
1360787540,1208921876,4,628,157,1360787526803,1360787534675,1208908679,1208916551,7872
1360787548,1208929776,13,1436,110.4615385,1360787537652,1360787544820,1208919428,1208926596,7168
1360787552,1208934176,1883,2657257,1411.182687,1360787222502,1360787250982,1208604678,1208633158,28480
1360787580,1208961928,14,1513,108.0714286,1360787567519,1360787574943,1208949447,1208956871,7424
1360787580,1208962008,5773,8194935,1419.527975,1360787494476,1360787571916,1208876484,1208953924,77440
1360787580,1208962008,4,628,157,1360787566671,1360787572815,1208948679,1208954823,6144
1360787612,1208993932,14,1513,108.0714286,1360787597531,1360787603995,1208979463,1208985927,6464
1360787620,1209001852,4,628,157,1360787606887,1360787614183,1208988739,1208996035,7296
1360787620,1209001968,5,254,50.8,1360787603123,1360787612787,1208985091,1208994755,9664
1360787620,1209002580,1,52,52,1360787595473,1360787595473,1208978053,1208978053,0
1360787628,1209010592,1,52,52,1360787600199,1360787600199,1208982791,1208982791,0
1360787628,1209010600,1,52,52,1360787601275,1360787601275,1208983875,1208983875,0
1360787628,1209010640,1,64,64,1360787602325,1360787602325,1208984965,1208984965,0
1360787636,1209017940,6,3662,610.3333333,1360787621263,1360787627983,1209003203,1209009923,6720
1360787636,1209017948,29,36003,1241.482759,1360787622024,1360787629960,1209003972,1209011908,7936
1360787636,1209017948,7,5388,769.7142857,1360787622024,1360787629960,1209003972,1209011908,7936
1360787636,1209018492,1,46,46,1360787611303,1360787611303,1208993795,1208993795,0
1360787644,1209025812,4,508,127,1360787628306,1360787636114,1209010118,1209017926,7808
1360787644,1209025812,4,521,130.25,1360787628369,1360787636113,1209010181,1209017925,7744
1360787644,1209025812,14,1513,108.0714286,1360787628368,1360787636176,1209010180,1209017988,7808
1360787644,1209025892,4,628,157,1360787628224,1360787636032,1209010116,1209017924,7808
1360787652,1209033932,4,628,157,1360787638233,1360787646041,1209020165,1209027973,7808
1360787660,1209041992,4,628,157,1360787648221,1360787655965,1209030213,1209037957,7744
1360787668,1209049964,4,628,157,1360787658231,1360787666039,1209040195,1209048003,7808
1360787668,1209049964,14,1513,108.0714286,1360787658167,1360787666039,1209040131,1209048003,7872
1360787668,1209050592,1,52,52,1360787642308,1360787642308,1209024900,1209024900,0
1360787692,1209073848,8,6377,797.125,1360787676074,1360787684138,1209057922,1209065986,8064
1360787692,1209073896,4,508,127,1360787680378,1360787688122,1209062274,1209070018,7744
1360787692,1209073924,4,628,157,1360787680478,1360787688094,1209062402,1209070018,7616
1360787692,1209073928,35,45465,1299,1360787675998,1360787684062,1209057926,1209065990,8064
1360787692,1209073972,8,4433,554.125,1360787675119,1360787688047,1209057091,1209070019,12928
1360787700,1209081880,4,628,157,1360787690572,1360787698124,1209072452,1209080004,7552
1360787700,1209081988,14,1525,108.9285714,1360787688161,1360787696097,1209070149,1209078085,7936
1360787716,1209097840,4,628,157,1360787700662,1360787708214,1209082502,1209090054,7552
1360787724,1209105856,4,628,157,1360787710627,1360787718179,1209092483,1209100035,7552
1360787732,1209113876,14,1513,108.0714286,1360787718223,1360787726159,1209100099,1209108035,7936
1360787756,1209137864,14,1513,108.0714286,1360787748315,1360787754779,1209130179,1209136643,6464
1360787788,1209170004,14,1513,108.0714286,1360787778192,1360787784592,1209160196,1209166596,6400
1360787796,1209177948,4,733,183.25,1360787784136,1360787790664,1209166084,1209172612,6528
1360787812,1209193920,8,2517,314.625,1360787793890,1360787806690,1209175810,1209188610,12800
1360787820,1209201932,4,962,240.5,1360787807957,1360787814677,1209189889,1209196609,6720
1360787820,1209201936,14,1488,106.2857143,1360787808401,1360787817105,1209190337,1209199041,8704
1360787828,1209209876,34,43846,1289.588235,1360787813261,1360787820749,1209195137,1209202625,7488
1360787828,1209209936,51,65605,1286.372549,1360787808338,1360787820690,1209190274,1209202626,12352
1360787828,1209210012,9,6103,678.1111111,1360787807751,1360787820615,1209189763,1209202627,12864
1360787836,1209217972,4,508,127,1360787821231,1360787828655,1209203203,1209210627,7424
1360787836,1209217972,4,521,130.25,1360787821358,1360787828654,1209203330,1209210626,7296
1360787836,1209217972,4,628,157,1360787821294,1360787828654,1209203266,1209210626,7360
1360787841,1209223224,1,52,52,1360787814641,1360787814641,1209196865,1209196865,0
1360787841,1209223324,1,52,52,1360787815117,1360787815117,1209197441,1209197441,0
1360787841,1209223348,1,52,52,1360787815669,1360787815669,1209198017,1209198017,0
1360787841,1209223352,1,48,48,1360787815986,1360787815986,1209198338,1209198338,0
1360787844,1209226012,4,628,157,1360787831492,1360787838596,1209213504,1209220608,7104
1360787845,1209227180,1,52,52,1360787816924,1360787816924,1209199104,1209199104,0
1360787845,1209227184,3,152,50.66666667,1360787816924,1360787825948,1209199108,1209208132,9024
1360787845,1209227192,1,52,52,1360787817489,1360787817489,1209199681,1209199681,0
1360787845,1209227272,1,52,52,1360787817283,1360787817283,1209199555,1209199555,0
1360787845,1209227300,1,48,48,1360787817828,1360787817828,1209200128,1209200128,0
1360787845,1209227304,1,48,48,1360787817954,1360787817954,1209200258,1209200258,0
1360787852,1209233892,4,628,157,1360787841406,1360787848766,1209223298,1209230658,7360
1360787852,1209233932,13,1436,110.4615385,1360787838422,1360787846742,1209220354,1209228674,8320
1360787860,1209241952,4,628,157,1360787851330,1360787858818,1209233282,1209240770,7488
1360787876,1209257988,13,1436,110.4615385,1360787868382,1360787874782,1209250370,1209256770,6400
1360787900,1209281988,4,628,157,1360787891422,1360787897566,1209273410,1209279554,6144
1360787908,1209290052,14,1513,108.0714286,1360787898269,1360787905501,1209280321,1209287553,7232
1360787916,1209297980,6328,8975144,1418.322377,1360787817062,1360787913062,1209199042,1209295042,96000
1360787940,1209322112,4,628,157,1360787930144,1360787936800,1209312256,1209318912,6656
1360787940,1209322144,14,1513,108.0714286,1360787928319,1360787934783,1209310463,1209316927,6464
1360787965,1209347484,3372,4785260,1419.116251,1360787624685,1360787664749,1209007169,1209047233,40064
1360787969,1209351476,16,7902,493.875,1360787941042,1360787964466,1209323518,1209346942,23424
1360787972,1209354064,44,57428,1305.181818,1360787961553,1360787968849,1209343617,1209350913,7296
1360787972,1209354092,14,1513,108.0714286,1360787958324,1360787964852,1209340416,1209346944,6528
1360787972,1209354220,7,3127,446.7142857,1360787960501,1360787968693,1209342721,1209350913,8192
1360787973,1209355376,11,9091,826.4545455,1360787960920,1360787968536,1209343296,1209350912,7616
1360787977,1209359544,1,78,78,1360787951470,1360787951470,1209334014,1209334014,0
1360787980,1209362108,4,218,54.5,1360787976739,1360787976867,1209358847,1209358975,128
1360787996,1209378052,31,39832,1284.903226,1360787988572,1360787995804,1209370624,1209377856,7232
1360787996,1209378056,14,1513,108.0714286,1360787988629,1360787995861,1209370685,1209377917,7232
1360787996,1209378100,5,2085,417,1360787987565,1360787993773,1209369665,1209375873,6208
1360788012,1209394112,5,2111,422.2,1360788003743,1360788011743,1209385855,1209393855,8000
1360788012,1209394208,27,34222,1267.481481,1360788004863,1360788011647,1209387071,1209393855,6784
1360788028,1209410204,14,1513,108.0714286,1360788018498,1360788025730,1209400702,1209407934,7232
1360788036,1209418088,7,4659,665.5714286,1360788025911,1360788033783,1209407999,1209415871,7872
1360788036,1209418096,4,665,166.25,1360788026415,1360788033775,1209408511,1209415871,7360
1360788036,1209418128,9,7940,882.2222222,1360788026704,1360788033744,1209408832,1209415872,7040
1360788036,1209418176,5,1231,246.2,1360788030429,1360788030493,1209412605,1209412669,64
1360788036,1209418212,35,45250,1292.857143,1360788026618,1360788033658,1209408830,1209415870,7040
1360788036,1209418212,4,632,158,1360788026617,1360788033657,1209408829,1209415869,7040
1360788037,1209419616,4348,6171384,1419.361546,1360787677607,1360787735847,1209060223,1209118463,58240
1360788044,1209426084,4,508,127,1360788036283,1360788043771,1209418367,1209425855,7488
1360788044,1209426084,4,628,157,1360788036346,1360788043834,1209418430,1209425918,7488
1360788044,1209426172,4,521,130.25,1360788036259,1360788043747,1209418431,1209425919,7488
1360788060,1209442160,14,1513,108.0714286,1360788048559,1360788055791,1209430719,1209437951,7232
1360788060,1209442176,4,628,157,1360788046238,1360788053726,1209428414,1209435902,7488
1360788068,1209450128,4,628,157,1360788056334,1360788063758,1209438462,1209445886,7424
1360788076,1209458216,6,1556,259.3333333,1360788066230,1360788073654,1209448446,1209455870,7424
1360788092,1209474204,14,1513,108.0714286,1360788078467,1360788085763,1209460671,1209467967,7296
1360788116,1209498228,4,628,157,1360788106281,1360788112361,1209488509,1209494589,6080
1360788124,1209506240,13,1448,111.3846154,1360788108447,1360788116447,1209490687,1209498687,8000
1360788148,1209530196,15,1590,106,1360788138504,1360788144840,1209520700,1209527036,6336
1360788156,1209538308,4,628,157,1360788146203,1360788152731,1209528511,1209535039,6528
1360788166,1209548016,1,46,46,1360788141501,1360788141501,1209523517,1209523517,0
1360788180,1209562240,14,1513,108.0714286,1360788168478,1360788174750,1209550718,1209556990,6272
1360788196,1209578276,4,628,157,1360788186297,1360788192377,1209568573,1209574653,6080
1360788212,1209594268,14,1513,108.0714286,1360788198465,1360788206401,1209580733,1209588669,7936
1360788236,1209618200,4,628,157,1360788226307,1360788232387,1209608507,1209614587,6080
1360788242,1209624264,3,152,50.66666667,1360788213954,1360788215362,1209596218,1209597626,1408
1360788242,1209624280,3,152,50.66666667,1360788215029,1360788216373,1209597309,1209598653,1344
1360788242,1209624424,3,152,50.66666667,1360788215971,1360788217251,1209598395,1209599675,1280
1360788242,1209624424,2,104,52,1360788215971,1360788218979,1209598395,1209601403,3008
1360788244,1209626204,13,1436,110.4615385,1360788228480,1360788236416,1209610684,1209618620,7936
1360788254,1209636400,3,423,141,1360788229625,1360788235705,1209612025,1209618105,6080
1360788260,1209642312,12255,17356179,1416.252876,1360788030485,1360788258453,1209412797,1209640765,227968
1360788268,1209650200,13,1436,110.4615385,1360788258497,1360788264833,1209640697,1209647033,6336
1360788286,1209668440,7,2541,363,1360788260818,1360788262482,1209643258,1209644922,1664
1360788294,1209676412,3,576,192,1360788266095,1360788266159,1209648507,1209648571,64
1360788298,1209680464,10,825,82.5,1360788273148,1360788274428,1209655612,1209656892,1280
1360788300,1209682264,13,1436,110.4615385,1360788288451,1360788294915,1209670715,1209677179,6464
1360788302,1209684456,1,52,52,1360788277633,1360788277633,1209660089,1209660089,0
1360788302,1209684544,14,3088,220.5714286,1360788274797,1360788279917,1209657341,1209662461,5120
1360788316,1209698220,4,628,157,1360788306477,1360788312621,1209688697,1209694841,6144
1360788332,1209714240,40,52560,1314,1360788324251,1360788330779,1209706491,1209713019,6528
1360788332,1209714244,14,1513,108.0714286,1360788318743,1360788326679,1209700987,1209708923,7936
1360788332,1209714276,7,3007,429.5714286,1360788323127,1360788330679,1209705403,1209712955,7552
1360788332,1209714284,5,2807,561.4,1360788323693,1360788330733,1209705977,1209713017,7040
1360788332,1209714312,11,5487,498.8181818,1360788313937,1360788328529,1209696249,1209710841,14592
1360788332,1209714472,6,3078,513,1360788323504,1360788330544,1209705976,1209713016,7040
1360788356,1209738248,14,1513,108.0714286,1360788348691,1360788355091,1209730939,1209737339,6400
1360788372,1209754280,39,50831,1303.358974,1360788360499,1360788367027,1209742779,1209749307,6528
1360788372,1209754356,9,8694,966,1360788360421,1360788366885,1209742777,1209749241,6464
1360788380,1209762268,8,4517,564.625,1360788359231,1360788373055,1209741499,1209755323,13824
1360788380,1209762300,4,628,157,1360788365533,1360788373021,1209747833,1209755321,7488
1360788380,1209762388,4,508,127,1360788365383,1360788372935,1209747771,1209755323,7552
1360788388,1209770300,4,628,157,1360788375708,1360788383004,1209758008,1209765304,7296
1360788388,1209770372,14,1513,108.0714286,1360788378583,1360788384983,1209760955,1209767355,6400
1360788396,1209778432,4,628,157,1360788385499,1360788392859,1209767931,1209775291,7360
1360788404,1209786316,5,688,137.6,1360788395599,1360788402959,1209777915,1209785275,7360
1360788420,1209802308,14,1513,108.0714286,1360788408662,1360788414998,1209790970,1209797306,6336
1360788423,1209804772,3,152,50.66666667,1360788396974,1360788398510,1209778746,1209780282,1536
1360788423,1209804816,2,104,52,1360788398080,1360788401088,1209779896,1209782904,3008
1360788423,1209804888,3,152,50.66666667,1360788395769,1360788397241,1209777657,1209779129,1472
1360788423,1209804924,3,152,50.66666667,1360788397973,1360788399445,1209779897,1209781369,1472
1360788444,1209826388,4,628,157,1360788435525,1360788441669,1209817913,1209824057,6144
1360788452,1209834280,14,1513,108.0714286,1360788438640,1360788445808,1209820920,1209828088,7168
1360788476,1209858436,14,1513,108.0714286,1360788468500,1360788474772,1209850936,1209857208,6272
1360788484,1209866448,4,628,157,1360788475527,1360788482759,1209857975,1209865207,7232
1360788508,1209890328,13,1436,110.4615385,1360788498561,1360788504897,1209880889,1209887225,6336
1360788516,1209898344,2,104,52,1360788514670,1360788514670,1209897014,1209897014,0
1360788524,1209906408,4,628,157,1360788515568,1360788521712,1209897976,1209904120,6144
1360788531,1209912964,1,52,52,1360788502957,1360788502957,1209884921,1209884921,0
1360788531,1209913136,1,52,52,1360788506432,1360788506432,1209888568,1209888568,0
1360788540,1209922392,14,1513,108.0714286,1360788529793,1360788537793,1209912185,1209920185,8000
1360788548,1209930348,4,628,157,1360788534827,1360788541867,1209917175,1209924215,7040
1360788548,1209930348,5,581,116.2,1360788534890,1360788541866,1209917238,1209924214,6976
1360788551,1209933240,11,930,84.54545455,1360788526359,1360788527831,1209908599,1209910071,1472
1360788556,1209938396,20,5453,272.65,1360788552633,1360788554617,1209935029,1209937013,1984
1360788556,1209938488,15,4722,314.8,1360788549856,1360788550944,1209932344,1209933432,1088
1360788556,1209938488,4,628,157,1360788544734,1360788551710,1209927222,1209934198,6976
1360788564,1209946408,16,4758,297.375,1360788556015,1360788556911,1209938423,1209939319,896
1360788564,1209946416,16,5245,327.8125,1360788548327,1360788555879,1209930743,1209938295,7552
1360788564,1209946536,18,5499,305.5,1360788558065,1360788559025,1209940601,1209941561,960
1360788567,1209949200,3,1951,650.3333333,1360788540735,1360788552063,1209922935,1209934263,11328
1360788572,1209954404,14,1513,108.0714286,1360788559667,1360788567859,1209942071,1209950263,8192
1360788572,1209954488,4,628,157,1360788564703,1360788571807,1209947191,1209954295,7104
1360788596,1209978516,4,628,157,1360788585025,1360788591169,1209967541,1209973685,6144
1360788596,1209978520,4,521,130.25,1360788585023,1360788593215,1209967543,1209975735,8192
1360788604,1209986412,4,628,157,1360788595180,1360788601324,1209977592,1209983736,6144
1360788604,1209986568,14,1513,108.0714286,1360788589837,1360788597197,1209972405,1209979765,7360
1360788628,1210010416,16,1644,102.75,1360788619941,1360788627685,1210002357,1210010101,7744
1360788628,1210010536,11,3064,278.5454545,1360788605036,1360788621228,1209987572,1210003764,16192
1360788668,1210050456,20,3746,187.3,1360788652924,1360788665980,1210035380,1210048436,13056
1360788676,1210058432,2,158,79,1360788668758,1360788674198,1210051190,1210056630,5440
1360788679,1210061364,2,96,48,1360788652890,1360788655898,1210035254,1210038262,3008
1360788679,1210061616,2,96,48,1360788653789,1360788654429,1210036405,1210037045,640
1360788683,1210065328,2,96,48,1360788655166,1360788655806,1210037494,1210038134,640
1360788683,1210065404,2,120,60,1360788658226,1360788658610,1210040630,1210041014,384
1360788683,1210065416,2,96,48,1360788655078,1360788658022,1210037494,1210040438,2944
1360788687,1210069376,1,48,48,1360788660683,1360788660683,1210043059,1210043059,0
1360788692,1210074592,6,744,124,1360788682293,1360788689077,1210064885,1210071669,6784
1360788700,1210082564,26,6046,232.5384615,1360788694610,1360788697490,1210077174,1210080054,2880
1360804222,1225604100,3,438,146,1360804194036,1360804200052,1225576136,1225582152,6016
1360804839,1226221224,3,438,146,1360804811569,1360804817585,1226193793,1226199809,6016
1360805718,1227100080,1,46,46,1360805692081,1360805692081,1227074161,1227074161,0
1360805836,1227218068,1,46,46,1360805808957,1360805808957,1227191025,1227191025,0
1360807087,1228469204,1,46,46,1360807061732,1360807061732,1228443936,1228443936,0
1360807627,1229009536,1,46,46,1360807601104,1360807601104,1228983640,1228983640,0
1360807627,1229009540,1,46,46,1360807601419,1360807601419,1228983959,1228983959,0
1360807668,1229050348,1,48,48,1360807642571,1360807642571,1229024919,1229024919,0
1360807804,1229186064,3,168,56,1360807796836,1360807797668,1229178900,1229179732,832
1360807804,1229186100,3,168,56,1360807799295,1360807800703,1229181395,1229182803,1408
1360807804,1229186152,3,168,56,1360807797965,1360807798669,1229180117,1229180821,704
1360807812,1229194180,7,1609,229.8571429,1360807802286,1360807804782,1229184466,1229186962,2496
1360807824,1229205840,1,46,46,1360807796420,1360807796420,1229178260,1229178260,0
1360807824,1229206004,25,5820,232.8,1360807798941,1360807822429,1229180945,1229204433,23488
1360807828,1229210140,3,168,56,1360807824086,1360807824726,1229206226,1229206866,640
1360807828,1229210148,3,168,56,1360807821389,1360807821965,1229203537,1229204113,576
1360807828,1229210200,3,168,56,1360807819996,1360807820956,1229202196,1229203156,960
1360807828,1229210228,4,220,55,1360807825087,1360807825727,1229207315,1229207955,640
1360807828,1229210264,3,168,56,1360807823003,1360807823835,1229205267,1229206099,832
1360807848,1229229868,16,3910,244.375,1360807821288,1360807824296,1229203156,1229206164,3008
1360807848,1229230008,1,46,46,1360807822427,1360807822427,1229204435,1229204435,0
1360807932,1229314332,2,104,52,1360807923860,1360807924500,1229306192,1229306832,640
1360807940,1229322376,3,168,56,1360807933608,1360807934248,1229315984,1229316624,640
1360807948,1229330036,23,6171,268.3043478,1360807922943,1360807927487,1229304979,1229309523,4544
1360807948,1229330040,1,64,64,1360807923449,1360807923449,1229305489,1229305489,0
1360807948,1229330124,1,46,46,1360807922534,1360807922534,1229304658,1229304658,0
1360807960,1229342184,1,64,64,1360807934761,1360807934761,1229316945,1229316945,0
1360808020,1229402412,3,168,56,1360808017925,1360808017989,1229400337,1229400401,64
1360808020,1229402412,3,168,56,1360808018051,1360808018179,1229400463,1229400591,128
1360808020,1229402412,3,168,56,1360808018179,1360808018307,1229400591,1229400719,128
1360808020,1229402460,3,168,56,1360808017362,1360808017490,1229399822,1229399950,128
1360808020,1229402460,3,168,56,1360808017556,1360808017684,1229400016,1229400144,128
1360808020,1229402464,3,168,56,1360808017745,1360808017873,1229400209,1229400337,128
1360808036,1229418348,3,168,56,1360808028482,1360808028674,1229410830,1229411022,192
1360808036,1229418424,3,168,56,1360808028600,1360808028664,1229411024,1229411088,64
1360808044,1229426064,1,46,46,1360808018079,1360808018079,1229400143,1229400143,0
1360808044,1229426184,2,110,55,1360808018537,1360808043753,1229400721,1229425937,25216
1360808048,1229430076,17,4372,257.1764706,1360808021010,1360808024850,1229403086,1229406926,3840
1360808048,1229430104,1,52,52,1360808021560,1360808021560,1229403664,1229403664,0
1360808060,1229442376,15,3759,250.6,1360808057255,1360808057895,1229439631,1229440271,640
1360808060,1229442404,7,1609,229.8571429,1360808055436,1360808056012,1229437840,1229438416,576
1360808060,1229442412,9,4387,487.4444444,1360808055812,1360808056196,1229438224,1229438608,384
1360808084,1229466036,37,12318,332.9189189,1360808056377,1360808079033,1229438413,1229461069,22656
1360808084,1229466124,64,21235,331.796875,1360808056228,1360808079076,1229438352,1229461200,22848
1360808084,1229466192,13,8610,662.3076923,1360808058143,1360808059423,1229440335,1229441615,1280
1360808084,1229466196,9,3463,384.7777778,1360808058459,1360808058971,1229440655,1229441167,512
1360808092,1229474188,1,46,46,1360808067427,1360808067427,1229449615,1229449615,0
1360808112,1229494208,9,782,86.88888889,1360808086414,1360808106702,1229468622,1229488910,20288
1360808124,1229506368,9,4387,487.4444444,1360808119599,1360808121647,1229501967,1229504015,2048
1360808124,1229506408,3,179,59.66666667,1360808118343,1360808123527,1229500751,1229505935,5184
1360808140,1229522128,3,401,133.6666667,1360808115422,1360808131806,1229497550,1229513934,16384
1360808144,1229526096,8,524,65.5,1360808116542,1360808136830,1229498638,1229518926,20288
1360808144,1229526220,7,3209,458.4285714,1360808117572,1360808118660,1229499792,1229500880,1088
1360808148,1229530460,3,202,67.33333333,1360808138514,1360808143506,1229520974,1229525966,4992
1360808156,1229538368,11,5880,534.5454545,1360808144174,1360808150318,1229526542,1229532686,6144
1360808172,1229554168,10,1779,177.9,1360808146487,1360808171767,1229528655,1229553935,25280
1360808172,1229554428,9,4387,487.4444444,1360808169906,1360808170162,1229552334,1229552590,256
1360808172,1229554432,3,138,46,1360808170415,1360808170415,1229552847,1229552847,0
1360808180,1229562464,3,138,46,1360808172300,1360808172300,1229554764,1229554764,0
1360808180,1229562504,2,131,65.5,1360808178534,1360808178534,1229561038,1229561038,0
1360808184,1229566240,4,1737,434.25,1360808156653,1360808164653,1229538893,1229546893,8000
1360808188,1229570476,9,4387,487.4444444,1360808185216,1360808187136,1229567692,1229569612,1920
1360808196,1229578204,53,21260,401.1320755,1360808170640,1360808190096,1229552844,1229572300,19456
1360808200,1229582160,9,1411,156.7777778,1360808171902,1360808196670,1229554062,1229578830,24768
1360808200,1229582172,1,46,46,1360808172913,1360808172913,1229555085,1229555085,0
1360808200,1229582172,1,46,46,1360808172913,1360808172913,1229555085,1229555085,0
1360808200,1229582280,12,8531,710.9166667,1360808172486,1360808172806,1229554766,1229555086,320
1360808225,1229606696,14,1205,86.07142857,1360808198285,1360808199245,1229579981,1229580941,960
1360808225,1229606700,17,3397,199.8235294,1360808198410,1360808201162,1229580110,1229582862,2752
1360808232,1229614636,7,464,66.28571429,1360808205986,1360808226338,1229588622,1229608974,20352
1360808244,1229626660,4,254,63.5,1360808231560,1360808236744,1229614220,1229619404,5184
1360808245,1229626820,1,52,52,1360808217551,1360808217551,1229599371,1229599371,0
1360808260,1229642612,2,127,63.5,1360808249591,1360808254583,1229632203,1229637195,4992
1360808264,1229646628,6,387,64.5,1360808236006,1360808256294,1229618634,1229638922,20288
1360808293,1229674828,6,387,64.5,1360808266822,1360808287110,1229648650,1229668938,20288
1360808308,1229690520,7,462,66,1360808296149,1360808306389,1229678669,1229688909,10240
1360808348,1229730532,3,168,56,1360808346120,1360808346696,1229728652,1229729228,576
1360808348,1229730632,3,168,56,1360808346850,1360808347490,1229729482,1229730122,640
1360808356,1229738544,3,168,56,1360808348219,1360808348795,1229730763,1229731339,576
1360808377,1229758956,22,4442,201.9090909,1360808349701,1360808353157,1229731657,1229735113,3456
1360808377,1229758992,1,52,52,1360808351009,1360808351009,1229733001,1229733001,0
1360808405,1229787060,1,48,48,1360808377629,1360808377629,1229759689,1229759689,0
1360808420,1229802620,16,3312,207,1360808415919,1360808418735,1229798539,1229801355,2816
1360808441,1229823096,8,4629,578.625,1360808414264,1360808415800,1229796360,1229797896,1536
1360808465,1229847056,1,52,52,1360808440802,1360808440802,1229822858,1229822858,0
1360808465,1229847108,1,52,52,1360808438830,1360808438830,1229820938,1229820938,0
1360808561,1229943120,1,46,46,1360808533089,1360808533089,1229915209,1229915209,0
1360808681,1230063472,1,52,52,1360808655423,1360808655423,1230037895,1230037895,0
1360808797,1230179552,2,406,203,1360808771374,1360808771694,1230153926,1230154246,320
1360808973,1230354724,1,46,46,1360808944804,1360808944804,1230326528,1230326528,0
1360808981,1230363184,3,168,56,1360808978395,1360808978971,1230360579,1230361155,576
1360808981,1230363268,3,168,56,1360808979204,1360808979780,1230361472,1230362048,576
1360809006,1230388032,1,46,46,1360808977906,1360808977906,1230359938,1230359938,0
1360809006,1230388104,1,64,64,1360808980328,1360808980328,1230362432,1230362432,0
1360809006,1230388116,17,3962,233.0588235,1360808981150,1360808984350,1230363266,1230366466,3200
1360809010,1230392108,1,52,52,1360808982630,1360808982630,1230364738,1230364738,0
1360809126,1230508388,9,3463,384.7777778,1360809098379,1360809100491,1230480767,1230482879,2112
1360809130,1230512460,18,4014,223,1360809102148,1360809105348,1230484608,1230487808,3200
1360809130,1230512496,1,52,52,1360809103389,1360809103389,1230485885,1230485885,0
1360809134,1230516548,1,64,64,1360809107817,1360809107817,1230490365,1230490365,0
1360809157,1230539404,3,168,56,1360809151481,1360809152185,1230533885,1230534589,704
1360809157,1230539444,3,168,56,1360809150162,1360809150738,1230532606,1230533182,576
1360809165,1230547444,2,104,52,1360809162324,1360809162964,1230544768,1230545408,640
1360809179,1230560728,1,46,46,1360809151775,1360809151775,1230533503,1230533503,0
1360809179,1230560760,9,5284,587.1111111,1360809153277,1360809162429,1230535037,1230544189,9152
1360809179,1230560764,1,64,64,1360809153276,1360809153276,1230535040,1230535040,0
1360809187,1230568792,1,64,64,1360809161567,1360809161567,1230543359,1230543359,0
1360809187,1230568880,24,4333,180.5416667,1360809161479,1360809177799,1230543359,1230559679,16320
1360809203,1230584916,4,256,64,1360809177762,1360809198626,1230559678,1230580542,20864
1360809213,1230595472,4,490,122.5,1360809187189,1360809210229,1230569661,1230592701,23040
1360809213,1230595516,3,168,56,1360809209802,1360809210442,1230592318,1230592958,640
1360809221,1230603528,2,131,65.5,1360809220223,1360809220223,1230602751,1230602751,0
1360809229,1230611404,3,168,56,1360809221498,1360809222138,1230603902,1230604542,640
1360809229,1230611448,3,168,56,1360809222351,1360809222991,1230604799,1230605439,640
1360809229,1230611484,3,168,56,1360809223272,1360809223912,1230605756,1230606396,640
1360809235,1230616960,17,3962,233.0588235,1360809209335,1360809212279,1230591295,1230594239,2944
1360809239,1230620804,1,64,64,1360809211602,1360809211602,1230593406,1230593406,0
1360809573,1230955640,4,208,52,1360809568137,1360809572361,1230950777,1230955001,4224
1360809589,1230971664,2,104,52,1360809577136,1360809586800,1230959800,1230969464,9664
1360809613,1230995620,2,104,52,1360809596829,1360809606813,1230979449,1230989433,9984
1360809629,1231011604,2,104,52,1360809616810,1360809626858,1230999414,1231009462,10048
1360810209,1231591244,2,96,48,1360810182282,1360810185226,1231564526,1231567470,2944
1360810209,1231591356,2,96,48,1360810183324,1360810186268,1231565680,1231568624,2944
1360810209,1231591392,2,96,48,1360810184373,1360810187381,1231566765,1231569773,3008
1360810209,1231591396,2,96,48,1360810184369,1360810187377,1231566765,1231569773,3008
1360810822,1232204124,2,96,48,1360810795066,1360810798010,1232177190,1232180134,2944
1360810822,1232204152,2,96,48,1360810796125,1360810799069,1232178277,1232181221,2944
1360810822,1232204192,2,96,48,1360810793908,1360810796852,1232176100,1232179044,2944
1360810822,1232204248,2,96,48,1360810796095,1360810798975,1232178343,1232181223,2880
1360811195,1232577100,2,96,48,1360811170699,1360811173707,1232552799,1232555807,3008
1360811195,1232577168,2,96,48,1360811168394,1360811171338,1232550562,1232553506,2944
1360811195,1232577180,2,96,48,1360811169533,1360811172541,1232551713,1232554721,3008
1360811195,1232577220,2,96,48,1360811170581,1360811173589,1232552801,1232555809,3008
1360811211,1232593184,1,432,432,1360811183354,1360811183354,1232565538,1232565538,0
1360811275,1232657324,2,96,48,1360811249771,1360811252779,1232632095,1232635103,3008
1360811279,1232661140,2,96,48,1360811252194,1360811255138,1232634334,1232637278,2944
1360811279,1232661220,2,96,48,1360811251025,1360811253969,1232633245,1232636189,2944
1360811279,1232661236,2,96,48,1360811252100,1360811255044,1232634336,1232637280,2944
1360812606,1233988356,2,96,48,1360812579190,1360812582198,1233961546,1233964554,3008
1360812606,1233988396,2,96,48,1360812580304,1360812583248,1233962700,1233965644,2944
1360812606,1233988420,2,96,48,1360812581368,1360812584312,1233963788,1233966732,2944
1360812606,1233988512,2,96,48,1360812581276,1360812584220,1233963788,1233966732,2944
1360812703,1234085308,1,48,48,1360812677350,1360812677350,1234059658,1234059658,0
1360813392,1234774076,3,152,50.66666667,1360813364673,1360813373633,1234746749,1234755709,8960
1360813640,1235022472,1,46,46,1360813614517,1360813614517,1234996989,1234996989,0
1360814614,1235996160,1,48,48,1360814587422,1360814587422,1235969582,1235969582,0
1360815091,1236473636,3,152,50.66666667,1360815065724,1360815074748,1236448360,1236457384,9024
1360815252,1236633964,1,78,78,1360815224918,1360815224918,1236606882,1236606882,0
1360815578,1236959876,1,46,46,1360815551660,1360815551660,1236933536,1236933536,0
1360815983,1237365184,1,46,46,1360815954545,1360815954545,1237336729,1237336729,0
1360816528,1237910492,7,1969,281.2857143,1360816523190,1360816523318,1237905682,1237905810,128
1360816547,1237929548,1,108,108,1360816522686,1360816522686,1237905234,1237905234,0
1360816547,1237929596,1,108,108,1360816522574,1360816522574,1237905170,1237905170,0
1360816551,1237933408,1,108,108,1360816522889,1360816522889,1237905297,1237905297,0
1360816688,1238070520,8,2021,252.625,1360816681367,1360816681559,1238063887,1238064079,192
1360816708,1238089708,1,108,108,1360816681537,1360816681537,1238063245,1238063245,0
1360816708,1238089712,1,108,108,1360816681600,1360816681600,1238063312,1238063312,0
1360816708,1238089712,1,108,108,1360816681726,1360816681726,1238063438,1238063438,0
1360816977,1238358740,8,2021,252.625,1360816975711,1360816975967,1238357451,1238357707,256
1360816985,1238366688,15,9934,662.2666667,1360816976913,1360816977681,1238358601,1238359369,768
1360816985,1238366704,9,2664,296,1360816978114,1360816978306,1238359818,1238360010,192
1360816985,1238366776,8,2612,326.5,1360816978680,1360816979064,1238360456,1238360840,384
1360817000,1238381844,1,108,108,1360816974327,1360816974327,1238356171,1238356171,0
1360817000,1238381932,1,108,108,1360816974172,1360816974172,1238356104,1238356104,0
1360817000,1238381936,1,108,108,1360816974299,1360816974299,1238356235,1238356235,0
1360817137,1238518804,8,2021,252.625,1360817136410,1360817136602,1238518214,1238518406,192
1360817160,1238542136,1,108,108,1360817135568,1360817135568,1238517704,1238517704,0
1360817160,1238542136,1,108,108,1360817135629,1360817135629,1238517765,1238517765,0
1360817160,1238542136,1,108,108,1360817135693,1360817135693,1238517829,1238517829,0
1360817169,1238550892,18,14434,801.8888889,1360817161731,1360817162371,1238543623,1238544263,640
1360817177,1238558808,7,2662,380.2857143,1360817171351,1360817171607,1238553159,1238553415,256
1360817433,1238815216,8,2714,339.25,1360817428729,1360817429049,1238810945,1238811265,320
1360817745,1239127340,8,2714,339.25,1360817738488,1360817738616,1239120828,1239120956,128
1360818050,1239431664,8,2714,339.25,1360818049177,1360818049305,1239430841,1239430969,128
1360855492,1276874484,1,46,46,1360855463922,1360855463922,1276846406,1276846406,0
1360855658,1277039536,2,110,55,1360855650150,1360855656486,1277031686,1277038022,6336
1360855658,1277039540,21,5573,265.3809524,1360855653983,1360855656287,1277035523,1277037827,2304
1360855658,1277039540,13,3571,274.6923077,1360855653983,1360855655583,1277035523,1277037123,1600
1360855673,1277054984,22,5687,258.5,1360855647078,1360855655846,1277029062,1277037830,8768
1360855677,1277058960,12,4947,412.25,1360855649085,1360855653501,1277031045,1277035461,4416
1360855677,1277058960,1,46,46,1360855649084,1360855649084,1277031044,1277031044,0
1360855701,1277083076,1,487,487,1360855673801,1360855673801,1277055877,1277055877,0
1360855738,1277119552,15,3266,217.7333333,1360855731732,1360855733460,1277113284,1277115012,1728
1360855753,1277135320,7,1380,197.1428571,1360855727890,1360855730642,1277110210,1277112962,2752
1360855753,1277135400,2,238,119,1360855728196,1360855730628,1277110596,1277113028,2432
1360855757,1277139280,7,3438,491.1428571,1360855729083,1360855730171,1277111363,1277112451,1088
1360855910,1277291804,10,3817,381.7,1360855884308,1360855886164,1277266112,1277267968,1856
1360855910,1277291852,1,64,64,1360855882918,1360855882918,1277264770,1277264770,0
1360855914,1277295764,1,52,52,1360855886205,1360855886205,1277267969,1277267969,0
1360855914,1277296040,3,168,56,1360855907177,1360855908137,1277289217,1277290177,960
1360855914,1277296052,3,168,56,1360855908767,1360855910111,1277290819,1277292163,1344
1360855922,1277304060,2,116,58,1360855921109,1360855921685,1277303169,1277303745,576
1360855930,1277311992,3,168,56,1360855922779,1360855925659,1277304771,1277307651,2880
1360855930,1277312076,3,156,52,1360855928390,1360855929734,1277310466,1277311810,1344
1360855946,1277327860,1,46,46,1360855920668,1360855920668,1277302528,1277302528,0
1360855950,1277331780,1,52,52,1360855922668,1360855922668,1277304448,1277304448,0
1360855950,1277331856,14,2693,192.3571429,1360855922913,1360855930401,1277304769,1277312257,7488
1360855954,1277335864,1,64,64,1360855926936,1360855926936,1277308800,1277308800,0
1360855978,1277360004,4,208,52,1360855970443,1360855976267,1277352447,1277358271,5824
1360855978,1277360056,3,156,52,1360855970902,1360855974038,1277352958,1277356094,3136
1360856006,1277387860,1,52,52,1360855978331,1360855978331,1277360191,1277360191,0
1360856014,1277395840,1,52,52,1360855989870,1360855989870,1277371710,1277371710,0
1360856014,1277395872,18,4010,222.7777778,1360855988433,1360855991889,1277370305,1277373761,3456
1360856018,1277399912,9,3463,384.7777778,1360855991910,1360855993126,1277373822,1277375038,1216
1360856114,1277496388,2,131,65.5,1360856112523,1360856112523,1277494911,1277494911,0
1360856179,1277560672,1,485,485,1360856151764,1360856151764,1277533436,1277533436,0
1360856183,1277564660,8,3390,423.75,1360856157410,1360856157922,1277539070,1277539582,512
1360856231,1277612712,2,471,235.5,1360856204523,1360856214763,1277586235,1277596475,10240
1360856231,1277612824,13,5626,432.7692308,1360856206652,1360856208764,1277588476,1277590588,2112
1360856291,1277672828,3,737,245.6666667,1360856264951,1360856265399,1277646779,1277647227,448
1360856319,1277700892,1,52,52,1360856294071,1360856294071,1277675963,1277675963,0
1360856402,1277784236,2,104,52,1360856397341,1360856397533,1277779577,1277779769,192
1360856411,1277793112,1,188,188,1360856384154,1360856384154,1277766266,1277766266,0
1360856411,1277793136,3,567,189,1360856384768,1360856384960,1277766904,1277767096,192
1360856442,1277824248,11,5880,534.5454545,1360856434897,1360856440977,1277817145,1277823225,6080
1360856483,1277865216,2,339,169.5,1360856456625,1360856456625,1277838841,1277838841,0
1360856532,1277913568,1,52,52,1360856505399,1360856505399,1277886967,1277886967,0
1360856652,1278033976,7,3438,491.1428571,1360856626141,1360856627293,1278008117,1278009269,1152
1360856652,1278034020,1,52,52,1360856625075,1360856625075,1278007095,1278007095,0
1360856859,1278240580,23,3708,161.2173913,1360856852199,1360856855399,1278233779,1278236979,3200
1360856877,1278258552,7,2898,414,1360856850691,1360856851779,1278232243,1278233331,1088
1360856893,1278274616,1,52,52,1360856867652,1360856867652,1278249268,1278249268,0
1360856949,1278330632,12,1103,91.91666667,1360856924722,1360856925874,1278306354,1278307506,1152
1360856953,1278334552,13,3179,244.5384615,1360856924994,1360856926402,1278306546,1278307954,1408
1360857029,1278410576,3,459,153,1360857002537,1360857002857,1278384113,1278384433,320
1360857035,1278416644,3,138,46,1360857031651,1360857031651,1278413295,1278413295,0
1360857057,1278438576,2,372,186,1360857030953,1360857031145,1278412529,1278412721,192
1360857057,1278438600,16,5939,371.1875,1360857032015,1360857035087,1278413615,1278416687,3072
1360857193,1278574856,1,52,52,1360857165647,1360857165647,1278547503,1278547503,0
1360857193,1278574860,1,52,52,1360857166091,1360857166091,1278547951,1278547951,0
1360857301,1278683196,1,52,52,1360857274489,1360857274489,1278656685,1278656685,0
1360857321,1278703384,2,122,61,1360857295933,1360857298237,1278678317,1278680621,2304
1360857638,1279020224,1,191,191,1360857612760,1360857612760,1278994984,1278994984,0
1360857638,1279020232,16,9831,614.4375,1360857613584,1360857616080,1278995816,1278998312,2496
1360857819,1279200748,1,191,191,1360857793200,1360857793200,1279174948,1279174948,0
1360857819,1279200828,3,567,189,1360857793634,1360857793826,1279175462,1279175654,192
1360857819,1279201148,6,276,46,1360857816224,1360857816224,1279198372,1279198372,0
1360857819,1279201216,15,3762,250.8,1360857816158,1360857816478,1279198374,1279198694,320
1360857843,1279224764,9,3463,384.7777778,1360857817248,1360857817888,1279199012,1279199652,640
1360857859,1279240860,4,913,228.25,1360857833984,1360857834496,1279215844,1279216356,512
1360857875,1279256840,3,156,52,1360857849556,1360857859412,1279231396,1279241252,9856
1360857894,1279275576,1,46,46,1360857864732,1360857864732,1279246308,1279246308,0
1360857940,1279321972,2,131,65.5,1360857937488,1360857937488,1279319460,1279319460,0
1360857959,1279341116,3,387,129,1360857934205,1360857934717,1279316321,1279316833,512
1360857967,1279349176,3,144,48,1360857940548,1360857942404,1279322724,1279324580,1856
1360940394,1361776132,1,50,50,1360940367614,1360940367614,1361749746,1361749746,0
1360941895,1363277228,1,46,46,1360941866119,1360941866119,1363248347,1363248347,0
1360942050,1363431668,1,46,46,1360942025073,1360942025073,1363406741,1363406741,0
1360942758,1364140148,1,48,48,1360942730375,1360942730375,1364112523,1364112523,0
1360943520,1364901964,3,168,56,1360943517555,1360943518451,1364899519,1364900415,896
1360943528,1364909916,3,168,56,1360943521698,1360943522786,1364903614,1364904702,1088
1360943536,1364917908,6,450,75,1360943524012,1360943535660,1364905920,1364917568,11648
1360943544,1364926144,3,168,56,1360943541247,1360943542719,1364923391,1364924863,1472
1360943544,1364926184,2,116,58,1360943543127,1360943543639,1364925311,1364925823,512
1360943544,1364926224,3,168,56,1360943538606,1360943540782,1364920830,1364923006,2176
1360943548,1364929928,9,2264,251.5555556,1360943520792,1360943525592,1364902720,1364907520,4800
1360943552,1364933988,4,331,82.75,1360943549852,1360943550364,1364931840,1364932352,512
1360943572,1364954076,1,46,46,1360943547525,1360943547525,1364929601,1364929601,0
1360943572,1364954084,1,52,52,1360943544314,1360943544314,1364926398,1364926398,0
1360943584,1364966180,7,2186,312.2857143,1360943559709,1360943561821,1364941889,1364944001,2112
1360943624,1365006004,2,104,52,1360943620234,1360943622282,1365002238,1365004286,2048
1360943640,1365022012,2,104,52,1360943626305,1360943634369,1365008317,1365016381,8064
1360943656,1365038100,2,104,52,1360943644330,1360943654314,1365026430,1365036414,9984
1360943680,1365062016,2,104,52,1360943664383,1360943674367,1365046399,1365056383,9984
1360943777,1365158488,1,64,64,1360943750605,1360943750605,1365132093,1365132093,0
1360943789,1365170568,6,360,60,1360943762301,1360943771709,1365143869,1365153277,9408
1360943797,1365178596,4,256,64,1360943770786,1360943791842,1365152382,1365173438,21056
1360943841,1365222272,3,168,56,1360943837604,1360943837860,1365218876,1365219132,256
1360943849,1365230360,3,168,56,1360943848013,1360943848141,1365229373,1365229501,128
1360943849,1365230364,3,168,56,1360943848137,1360943848329,1365229501,1365229693,192
1360943857,1365238376,4,232,58,1360943851388,1360943854652,1365232764,1365236028,3264
1360943865,1365246284,2,110,55,1360943854742,1360943864790,1365236026,1365246074,10048
1360943865,1365246688,22,4869,221.3181818,1360943839234,1360943855810,1365220922,1365237498,16576
1360943865,1365246708,1,46,46,1360943837423,1360943837423,1365219131,1365219131,0
1360943865,1365246708,1,64,64,1360943837487,1360943837487,1365219195,1365219195,0
1360943873,1365254324,4,271,67.75,1360943868013,1360943868141,1365249337,1365249465,128
1360943873,1365254324,3,168,56,1360943868271,1360943868335,1365249595,1365249659,64
1360943873,1365254332,3,168,56,1360943864809,1360943865001,1365246141,1365246333,192
1360943921,1365302368,27,16244,601.6296296,1360943913793,1360943918849,1365295161,1365300217,5056
1360943921,1365302372,27,4867,180.2592593,1360943913791,1360943917311,1365295163,1365298683,3520
1360943921,1365302384,16,3306,206.625,1360943911281,1360943913585,1365292665,1365294969,2304
1360943921,1365302456,22,3648,165.8181818,1360943911017,1360943913513,1365292473,1365294969,2496
1360943929,1365310420,22,12053,547.8636364,1360943925452,1360943927308,1365306872,1365308728,1856
1360943929,1365310420,21,6849,326.1428571,1360943921613,1360943925453,1365303033,1365306873,3840
1360943929,1365310448,17,3581,210.6470588,1360943918768,1360943924016,1365300216,1365305464,5248
1360943929,1365310456,15,3294,219.6,1360943927275,1360943927723,1365308731,1365309179,448
1360943929,1365310488,26,4020,154.6153846,1360943925386,1360943927562,1365306874,1365309050,2176
1360943933,1365315108,10,4064,406.4,1360943907998,1360943910110,1365290106,1365292218,2112
1360943937,1365318368,60,62208,1036.8,1360943931264,1360943932992,1365312632,1365314360,1728
1360943937,1365318396,17,3435,202.0588235,1360943932965,1360943933413,1365314361,1365314809,448
1360943937,1365318412,15,3889,259.2666667,1360943930646,1360943931222,1365312058,1365312634,576
1360943937,1365318448,18,3287,182.6111111,1360943933427,1360943933939,1365314875,1365315387,512
1360943937,1365318448,18,6640,368.8888889,1360943928305,1360943930609,1365309753,1365312057,2304
1360943937,1365319076,2,116,58,1360943911869,1360943912189,1365293945,1365294265,320
1360943957,1365339132,9,3463,384.7777778,1360943932294,1360943932806,1365314426,1365314938,512
1360944025,1365407236,2,339,169.5,1360943998684,1360943998684,1365380920,1365380920,0
1360944057,1365438456,2,131,65.5,1360944053353,1360944053353,1365434809,1365434809,0
1360944102,1365483404,1,52,52,1360944074524,1360944074524,1365455928,1365455928,0
1360944178,1365559484,1,52,52,1360944150730,1360944150730,1365532214,1365532214,0
1360944322,1365704032,3,324,108,1360944294501,1360944294949,1365676533,1365676981,448
1360944391,1365772392,1,52,52,1360944365346,1360944365346,1365746738,1365746738,0
1360944539,1365920972,1,188,188,1360944514333,1360944514333,1365896305,1365896305,0
1360944543,1365924936,14,5542,395.8571429,1360944515971,1360944517443,1365897907,1365899379,1472
1360944602,1365983408,4,184,46,1360944600975,1360944600975,1365982383,1365982383,0
1360944615,1365996968,3,523,174.3333333,1360944589278,1360944589278,1365971246,1365971246,0
1360944615,1365997052,3,567,189,1360944590538,1360944590730,1365972590,1365972782,192
1360944627,1366008968,9,3463,384.7777778,1360944600417,1360944600993,1365982385,1365982961,576
1360944647,1366029020,2,382,191,1360944620013,1360944620013,1366002033,1366002033,0
1360944647,1366029048,20,10356,517.8,1360944621007,1360944625167,1366003055,1366007215,4160
1360944659,1366040988,1,46,46,1360944631306,1360944631306,1366013294,1366013294,0
1360944680,1366061280,6,1613,268.8333333,1360944652367,1360944657295,1366033647,1366038575,4928
1360944708,1366089276,6,1333,222.1666667,1360944680528,1360944696400,1366061804,1366077676,15872
1360944720,1366101352,1,186,186,1360944694983,1360944694983,1366076335,1366076335,0
1360944722,1366103392,2,131,65.5,1360944721373,1360944721373,1366102765,1366102765,0
1360944724,1366105268,6,1384,230.6666667,1360944695898,1360944699354,1366077166,1366080622,3456
1360944796,1366177288,5,713,142.6,1360944770499,1360944770819,1366151787,1366152107,320
1360944796,1366177292,4,631,157.75,1360944770624,1360944770880,1366151916,1366152172,256
1360944796,1366177328,7,2757,393.8571429,1360944769757,1360944771037,1366151085,1366152365,1280
1360944799,1366181256,2,377,188.5,1360944769022,1360944769022,1366151278,1366151278,0
1360944818,1366199492,11,5880,534.5454545,1360944804855,1360944810999,1366186347,1366192491,6144
1360944824,1366205416,1,52,52,1360944799301,1360944799301,1366180717,1366180717,0
1360944948,1366329476,2,188,94,1360944920391,1360944920391,1366301867,1366301867,0
1360944996,1366377540,1,52,52,1360944969798,1360944969798,1366351338,1366351338,0
1360945036,1366417464,1,52,52,1360945010512,1360945010512,1366391976,1366391976,0
1360945036,1366417548,1,52,52,1360945010557,1360945010557,1366392105,1366392105,0
1360945036,1366417572,1,52,52,1360945010791,1360945010791,1366392363,1366392363,0
1360945116,1366497684,3,460,153.3333333,1360945090739,1360945090995,1366472423,1366472679,256
1360945297,1366679000,1,46,46,1360945268151,1360945268151,1366650151,1366650151,0
1360945306,1366687868,5,230,46,1360945305337,1360945305593,1366687205,1366687461,256
1360945332,1366714132,9,3463,384.7777778,1360945305392,1360945306416,1366687524,1366688548,1024
1360945434,1366815940,2,131,65.5,1360945426542,1360945426542,1366808482,1366808482,0
1360945436,1366818192,2,120,60,1360945411508,1360945414452,1366793700,1366796644,2944
1360945472,1366854132,4,755,188.75,1360945445295,1360945445935,1366827427,1366828067,640
1360945481,1366862332,8,3390,423.75,1360945454797,1360945456205,1366836129,1366837537,1408
1360945541,1366922360,1,52,52,1360945513328,1360945513328,1366894688,1366894688,0
1360945721,1367102832,1,52,52,1360945695703,1360945695703,1367077535,1367077535,0
1360945725,1367106856,2,188,94,1360945698942,1360945698942,1367080798,1367080798,0
1360945810,1367192236,15,3759,250.6,1360945806083,1360945807363,1367188319,1367189599,1280
1360945811,1367192272,19,4782,251.6842105,1360945808581,1360945809029,1367189853,1367190301,448
1360945811,1367192276,13,3508,269.8461538,1360945809215,1360945809791,1367190491,1367191067,576
1360945811,1367192300,6,276,46,1360945806632,1360945806632,1367187932,1367187932,0
1360945811,1367192340,13,3508,269.8461538,1360945808511,1360945809215,1367189851,1367190555,704
1360945811,1367192340,13,3508,269.8461538,1360945808511,1360945809151,1367189851,1367190491,640
1360945833,1367215048,9,3463,384.7777778,1360945808444,1360945808892,1367190492,1367190940,448
1360945931,1367312340,3,210,70,1360945929470,1360945929726,1367310810,1367311066,256
1360945958,1367339316,1,52,52,1360945930136,1360945930136,1367311452,1367311452,0
1360946026,1367407624,2,188,94,1360945999011,1360945999011,1367380635,1367380635,0
1360946075,1367456612,2,92,46,1360946072622,1360946073710,1367454234,1367455322,1088
1360946090,1367471912,1,46,46,1360946065215,1360946065215,1367447127,1367447127,0
1360946098,1367479692,7,3036,433.7142857,1360946072989,1360946073501,1367454681,1367455193,512
1360946158,1367539724,1,52,52,1360946131516,1360946131516,1367513240,1367513240,0
1360946298,1367679908,1,71,71,1360946272002,1360946272002,1367653910,1367653910,0
1360946411,1367792980,126,11119,88.24603175,1360946147129,1360946403961,1367529109,1367785941,256832
1360946411,1367792980,150,14607,97.38,1360946147128,1360946404728,1367529108,1367786708,257600
1360946471,1367852276,1,46,46,1360946445560,1360946445560,1367826836,1367826836,0
1360946471,1367852356,1,46,46,1360946445479,1360946445479,1367826835,1367826835,0
1360946475,1367856312,4,612,153,1360946447700,1360946448276,1367829012,1367829588,576
1360946539,1367920680,3,387,129,1360946514528,1360946515104,1367896208,1367896784,576
1360946591,1367972636,2,188,94,1360946562894,1360946562894,1367944530,1367944530,0
1360946603,1367985008,4,184,46,1360946600920,1360946600920,1367982928,1367982928,0
1360946627,1368008852,9,3463,384.7777778,1360946601078,1360946601654,1367982930,1367983506,576
1360946676,1368057312,1,52,52,1360946649810,1360946649810,1368031122,1368031122,0
1360946723,1368105132,3,210,70,1360946721178,1360946721434,1368103310,1368103566,256
1360946784,1368165436,4,755,188.75,1360946759507,1360946759955,1368140943,1368141391,448
1360946848,1368229520,3,539,179.6666667,1360946821949,1360946831485,1368203469,1368213005,9536
1360946920,1368301680,1,52,52,1360946895580,1360946895580,1368277260,1368277260,0
1360947124,1368505368,2,92,46,1360947120529,1360947120529,1368501897,1368501897,0
1360947140,1368521376,12,5880,490,1360947121290,1360947135434,1368502666,1368516810,14144
1360947204,1368586032,24,7937,330.7083333,1360947178296,1360947186936,1368560328,1368568968,8640
1360947204,1368586036,1,52,52,1360947178932,1360947178932,1368560968,1368560968,0
1360947204,1368586108,12,5541,461.75,1360947178476,1360947178860,1368560584,1368560968,384
1360947212,1368594080,22,19810,900.4545455,1360947184327,1360947201927,1368566407,1368584007,17600
1360947212,1368594088,1,60,60,1360947184894,1360947184894,1368566982,1368566982,0
1360947228,1368609540,3,168,56,1360947220772,1360947220836,1368602312,1368602376,64
1360947236,1368617600,2,110,55,1360947220841,1360947231209,1368602441,1368612809,10368
1360947248,1368630156,60,66996,1116.6,1360947223801,1360947246841,1368605957,1368628997,23040
1360947248,1368630232,18,5865,325.8333333,1360947223281,1360947229681,1368605513,1368611913,6400
1360947253,1368634252,1,52,52,1360947224834,1360947224834,1368606086,1368606086,0
1360947268,1368649592,4,238,59.5,1360947252013,1360947262317,1368633605,1368643909,10304
1360947268,1368650208,76,15639,205.7763158,1360947241800,1360947249928,1368624008,1368632136,8128
1360947305,1368686256,2,116,58,1360947279614,1360947279870,1368660870,1368661126,256
1360947305,1368686260,1,64,64,1360947280186,1360947280186,1368661446,1368661446,0
1360947309,1368690460,38,2180,57.36842105,1360947280755,1360947308339,1368662215,1368689799,27584
1360947329,1368710344,58,68267,1177.017241,1360947303781,1360947306213,1368685125,1368687557,2432
1360947332,1368713764,3,168,56,1360947325571,1360947326083,1368707335,1368707847,512
1360947332,1368713768,3,168,56,1360947326398,1360947327038,1368708166,1368708806,640
1360947332,1368713772,2,110,55,1360947310970,1360947324346,1368692742,1368706118,13376
1360947333,1368714332,91,11183,122.8901099,1360947306416,1360947316784,1368687748,1368698116,10368
1360947337,1368718368,21,1244,59.23809524,1360947309136,1360947314768,1368690504,1368696136,5632
1360947345,1368726384,1,46,46,1360947318844,1360947318844,1368700228,1368700228,0
1360947348,1368729696,4,220,55,1360947344452,1360947345860,1368726148,1368727556,1408
1360947356,1368737708,3,168,56,1360947349307,1360947350331,1368731015,1368732039,1024
1360947356,1368737752,4,271,67.75,1360947348301,1360947348941,1368730053,1368730693,640
1360947377,1368758436,9,3475,386.1111111,1360947352395,1360947355083,1368733831,1368736519,2688
1360947381,1368762360,4,264,66,1360947352980,1360947354644,1368734340,1368736004,1664
1360947396,1368777796,38,8482,223.2105263,1360947389089,1360947392865,1368770885,1368774661,3776
1360947396,1368777796,9,5576,619.5555556,1360947392992,1360947394208,1368774788,1368776004,1216
1360947421,1368802464,55,62557,1137.4,1360947393579,1360947395883,1368775043,1368777347,2304
1360947445,1368826420,1,52,52,1360947419478,1360947419478,1368800898,1368800898,0
1360947461,1368842488,1,52,52,1360947433428,1360947433428,1368814916,1368814916,0
1360947476,1368857968,2,131,65.5,1360947474420,1360947474420,1368856388,1368856388,0
1360947477,1368858772,2,188,94,1360947451577,1360947451577,1368833349,1368833349,0
1360947516,1368897936,37,4284,115.7837838,1360947508050,1360947508818,1368889986,1368890754,768
1360947533,1368914928,7,3438,491.1428571,1360947507547,1360947507867,1368889475,1368889795,320
1360947626,1369007240,1,52,52,1360947601801,1360947601801,1368983041,1368983041,0
1360947661,1369043224,1,52,52,1360947635184,1360947635184,1369017408,1369017408,0
1360947756,1369138128,5,260,52,1360947747664,1360947751056,1369129792,1369133184,3392
1360947782,1369163716,1,64,64,1360947757099,1360947757099,1369138815,1369138815,0
1360947786,1369167652,19,4066,214,1360947760106,1360947763306,1369141758,1369144958,3200
1360947786,1369167692,1,52,52,1360947761732,1360947761732,1369143424,1369143424,0
1360948093,1369474276,3,168,56,1360948091358,1360948091998,1369472634,1369473274,640
1360948093,1369474308,2,116,58,1360948092223,1360948092543,1369473531,1369473851,320
1360948100,1369482232,3,168,56,1360948094817,1360948095457,1369477049,1369477689,640
1360948101,1369482268,3,168,56,1360948094181,1360948094885,1369475449,1369476153,704
1360948101,1369482308,3,168,56,1360948093181,1360948093757,1369474489,1369475065,576
1360948101,1369482316,4,271,67.75,1360948096631,1360948097271,1369477947,1369478587,640
1360948107,1369488612,1,64,64,1360948080462,1360948080462,1369462074,1369462074,0
1360948111,1369492620,1,52,52,1360948085128,1360948085128,1369466748,1369466748,0
1360948111,1369492728,19,4066,214,1360948083418,1360948086874,1369465146,1369468602,3456
1360948119,1369500632,1,52,52,1360948092536,1360948092536,1369474168,1369474168,0
1360948119,1369500692,1,46,46,1360948094719,1360948094719,1369476411,1369476411,0
1360948123,1369504668,2,110,55,1360948097366,1360948121174,1369479034,1369502842,23808
1360948125,1369506420,3,168,56,1360948117133,1360948117773,1369498553,1369499193,640
1360948163,1369544724,9,3463,384.7777778,1360948138718,1360948139998,1369520442,1369521722,1280
1360948175,1369556740,1,46,46,1360948147470,1360948147470,1369529210,1369529210,0
1360948261,1369642328,2,131,65.5,1360948260201,1360948260201,1369641529,1369641529,0
1360948444,1369825628,3,458,152.6666667,1360948416314,1360948416890,1369797942,1369798518,576
1360948613,1369994540,3,168,56,1360948608141,1360948608845,1369989681,1369990385,704
1360948613,1369994580,3,168,56,1360948606245,1360948606885,1369987825,1369988465,640
1360948613,1369994588,3,168,56,1360948607135,1360948607775,1369988723,1369989363,640
1360948624,1370006072,25,9505,380.2,1360948611706,1360948613818,1369993778,1369995890,2112
1360948632,1370014204,1,198,198,1360948603766,1360948603766,1369985970,1369985970,0
1360948636,1370018096,18,4150,230.5555556,1360948608992,1360948612576,1369991088,1369994672,3584
1360948636,1370018176,1,64,64,1360948608915,1360948608915,1369991091,1369991091,0
1360948653,1370034528,3,168,56,1360948650328,1360948650904,1370031856,1370032432,576
1360948653,1370034560,3,168,56,1360948651321,1360948651897,1370032881,1370033457,576
1360948677,1370058316,1,64,64,1360948652525,1360948652525,1370033841,1370033841,0
1360948729,1370110460,1,186,186,1360948701787,1360948701787,1370083247,1370083247,0
1360948729,1370110576,12,5987,498.9166667,1360948703784,1360948706280,1370085360,1370087856,2496
1360948733,1370114440,1,46,46,1360948705392,1360948705392,1370086832,1370086832,0
1360948797,1370178608,1,46,46,1360948769672,1360948769672,1370151280,1370151280,0
1360948909,1370291004,1,186,186,1360948881208,1360948881208,1370263212,1370263212,0
1360948909,1370291140,3,567,189,1360948882033,1360948882225,1370264173,1370264365,192
1360949114,1370495596,1,64,64,1360949089551,1360949089551,1370471147,1370471147,0
1360949118,1370499488,17,3962,233.0588235,1360949092346,1360949095674,1370473834,1370477162,3328
1360949122,1370503544,1,52,52,1360949094083,1360949094083,1370475627,1370475627,0
1360949150,1370531576,1,52,52,1360949122784,1360949122784,1370504360,1370504360,0
1360949351,1370732384,3,458,152.6666667,1360949323358,1360949324062,1370704742,1370705446,704
1360949359,1370740404,8,3390,423.75,1360949334794,1360949336074,1370716198,1370717478,1280
1360949363,1370744332,9,3463,384.7777778,1360949336274,1360949337298,1370717606,1370718630,1024
1360949451,1370832512,1,64,64,1360949425244,1360949425244,1370806756,1370806756,0
1360949455,1370836468,17,3962,233.0588235,1360949427915,1360949431819,1370809383,1370813287,3904
1360949455,1370836596,1,52,52,1360949429640,1360949429640,1370811236,1370811236,0
1360949462,1370843996,2,131,65.5,1360949456504,1360949456504,1370838500,1370838500,0
1360949603,1370984776,1,52,52,1360949575699,1360949575699,1370957475,1370957475,0
1360949766,1371148048,3,168,56,1360949759617,1360949760001,1371141665,1371142049,384
1360949766,1371148092,2,110,55,1360949749014,1360949759382,1371131106,1371141474,10368
1360949766,1371148132,3,168,56,1360949760302,1360949760878,1371142434,1371143010,576
1360949779,1371160976,19,4066,214,1360949752202,1360949755146,1371134178,1371137122,2944
1360949779,1371161008,1,52,52,1360949753513,1360949753513,1371135521,1371135521,0
1360949790,1371172096,3,168,56,1360949782287,1360949782799,1371164383,1371164895,512
1360949798,1371180156,3,168,56,1360949793747,1360949794323,1371175903,1371176479,576
1360949806,1371188104,2,110,55,1360949783112,1360949798344,1371165216,1371180448,15232
1360949830,1371212096,10,5805,580.5,1360949823377,1360949827345,1371205473,1371209441,3968
1360950068,1371449784,1,186,186,1360950041733,1360950041733,1371423517,1371423517,0
1360950072,1371453668,12,6980,581.6666667,1360950044152,1360950046456,1371425820,1371428124,2304
1360950249,1371630292,7,1302,186,1360950222254,1360950240814,1371603546,1371622106,18560
1360950271,1371652400,3,168,56,1360950268031,1360950268607,1371649431,1371650007,576
1360950271,1371652444,3,168,56,1360950267029,1360950267605,1371648473,1371649049,576
1360950276,1371658232,3,558,186,1360950249921,1360950269889,1371632153,1371652121,19968
1360950296,1371678216,19,4457,234.5789474,1360950268814,1360950272782,1371651030,1371654998,3968
1360950301,1371682256,13,6945,534.2307692,1360950274576,1360950277200,1371655832,1371658456,2624
1360950313,1371694660,1,52,52,1360950286459,1360950286459,1371668119,1371668119,0
1360950541,1371923120,1,52,52,1360950516334,1360950516334,1371898454,1371898454,0
1360950557,1371939184,3,458,152.6666667,1360950531628,1360950532012,1371913812,1371914196,384
1360950639,1372020532,13,3520,270.7692308,1360950631286,1360950632886,1372012818,1372014418,1600
1360950639,1372020608,22,5890,267.7272727,1360950631530,1360950633578,1372013138,1372015186,2048
1360950750,1372131616,1,110,110,1360950722209,1360950722209,1372103825,1372103825,0
1360950783,1372164668,3,168,56,1360950776940,1360950777580,1372158608,1372159248,640
1360950783,1372164680,3,168,56,1360950777889,1360950778465,1372159569,1372160145,576
1360950783,1372164708,3,168,56,1360950778757,1360950779397,1372160465,1372161105,640
1360950791,1372172652,3,219,73,1360950790270,1360950790590,1372171922,1372172242,320
1360950791,1372172660,2,110,55,1360950779764,1360950790068,1372161424,1372171728,10304
1360950799,1372180728,4,271,67.75,1360950791281,1360950791857,1372173009,1372173585,576
1360950802,1372183744,1,46,46,1360950776865,1360950776865,1372158609,1372158609,0
1360950806,1372187616,17,3962,233.0588235,1360950779745,1360950783201,1372161361,1372164817,3456
1360950806,1372187652,1,52,52,1360950781500,1360950781500,1372163152,1372163152,0
1360950818,1372199596,1,52,52,1360950790966,1360950790966,1372172562,1372172562,0
1360951010,1372392168,1,458,458,1360950985143,1360950985143,1372367311,1372367311,0
1360951034,1372416012,10,6764,676.4,1360951006608,1360951009616,1372388620,1372391628,3008
1360951047,1372428816,3,158,52.66666667,1360951029589,1360951039765,1372411405,1372421581,10176
1360951123,1372504320,7,3045,435,1360951096131,1360951115523,1372477451,1372496843,19392
1360951151,1372532252,3,1305,435,1360951125638,1360951145606,1372506890,1372526858,19968
1360951183,1372564304,1,435,435,1360951155538,1360951155538,1372536842,1372536842,0
1360951255,1372637084,5,260,52,1360951248775,1360951252615,1372630859,1372634699,3840
1360951639,1373021032,1,46,46,1360951613365,1360951613365,1372995397,1372995397,0
1360953272,1374653776,4,184,46,1360953247641,1360953248281,1374629417,1374630057,640
1360954148,1375529320,3,168,56,1360954146839,1360954147287,1375528159,1375528607,448
1360954148,1375529364,3,168,56,1360954145514,1360954146666,1375526878,1375528030,1152
1360954156,1375537304,3,168,56,1360954150118,1360954152038,1375531422,1375533342,1920
1360954156,1375537304,3,168,56,1360954154150,1360954154854,1375535454,1375536158,704
1360954156,1375537332,4,220,55,1360954148232,1360954149448,1375529564,1375530780,1216
1360954156,1375537352,3,168,56,1360954152310,1360954153334,1375533662,1375534686,1024
1360954164,1375545352,3,168,56,1360954156596,1360954157236,1375537948,1375538588,640
1360954164,1375545364,3,168,56,1360954155691,1360954156331,1375537055,1375537695,640
1360954164,1375545364,3,168,56,1360954157736,1360954158760,1375539100,1375540124,1024
1360954170,1375551756,20,5888,294.4,1360954142880,1360954148384,1375524636,1375530140,5504
1360954174,1375555748,1,52,52,1360954147495,1360954147495,1375529243,1375529243,0
1360954182,1375563780,1,46,46,1360954154633,1360954154633,1375536413,1375536413,0
1360954186,1375567832,10,3523,352.3,1360954159123,1360954161363,1375540955,1375543195,2240
1360954234,1375615952,2,916,458,1360954208219,1360954209243,1375590171,1375591195,1024
1360954266,1375648064,1,52,52,1360954239661,1360954239661,1375621725,1375621725,0
1360954284,1375665352,2,131,65.5,1360954281650,1360954281650,1375663002,1375663002,0
1360954292,1375673392,2,158,79,1360954284812,1360954291084,1375666204,1375672476,6272
1360954331,1375712420,2,158,79,1360954303664,1360954328880,1375685084,1375710300,25216
1360954340,1375721416,5,296,59.2,1360954324787,1360954338867,1375706203,1375720283,14080
1360954355,1375736408,9,3933,437,1360954326841,1360954329593,1375708249,1375711001,2752
1360954396,1375777372,3,156,52,1360954387037,1360954394333,1375768409,1375775705,7296
1360954420,1375801388,2,104,52,1360954404043,1360954414027,1375785431,1375795415,9984
1360954436,1375817456,2,104,52,1360954423943,1360954433927,1375805399,1375815383,9984
1360954471,1375852496,1,52,52,1360954443937,1360954443937,1375825433,1375825433,0
1360954516,1375897540,5,284,56.8,1360954507060,1360954511796,1375888600,1375893336,4736
1360954527,1375908884,22,4655,211.5909091,1360954502362,1360954507802,1375884246,1375889686,5440
1360954531,1375912868,1,52,52,1360954505322,1360954505322,1375887190,1375887190,0
1360954531,1375912876,1,46,46,1360954505764,1360954505764,1375887640,1375887640,0
1360954539,1375920836,4,256,64,1360954511948,1360954532940,1375893784,1375914776,20992
1360954540,1375921540,16,5808,363,1360954535347,1360954539059,1375916887,1375920599,3712
1360954540,1375921580,3,168,56,1360954536779,1360954537419,1375918359,1375918999,640
1360954540,1375921596,20,4894,244.7,1360954530619,1360954534459,1375912215,1375916055,3840
1360954540,1375921596,13,3508,269.8461538,1360954530874,1360954534202,1375912470,1375915798,3328
1360954548,1375929588,5,296,59.2,1360954537794,1360954541378,1375919382,1375922966,3584
1360954548,1375929628,3,168,56,1360954541657,1360954542553,1375923285,1375924181,896
1360954559,1375940904,24,6696,279,1360954533383,1360954542727,1375915287,1375924631,9344
1360954563,1375944936,12,4894,407.8333333,1360954534822,1360954543206,1375916758,1375925142,8384
1360954563,1375944988,1,52,52,1360954537012,1360954537012,1375919000,1375919000,0
1360954583,1375964948,1,46,46,1360954557340,1360954557340,1375939288,1375939288,0
1360954627,1376009016,67,7014,104.6865672,1360954602453,1360954613845,1375984469,1375995861,11392
1360954668,1376049664,2,131,65.5,1360954663351,1360954663351,1376045015,1376045015,0
1360954676,1376057360,1,46,46,1360954650661,1360954650661,1376032021,1376032021,0
1360954716,1376097956,20,3502,175.1,1360954709840,1360954711504,1376091796,1376093460,1664
1360954736,1376117388,7,3438,491.1428571,1360954707974,1360954709126,1376089362,1376090514,1152
1360954860,1376242128,104,9833,94.54807692,1360954602340,1360954855396,1375984468,1376237524,253056
1360954880,1376261972,1,46,46,1360954853885,1360954853885,1376235857,1376235857,0
1360954933,1376314392,1,46,46,1360954906687,1360954906687,1376288079,1376288079,0
1360954977,1376358524,1,52,52,1360954948989,1360954948989,1376330513,1376330513,0
1360955005,1376386948,1,46,46,1360954980309,1360954980309,1376362257,1376362257,0
1360955189,1376570848,1,46,46,1360955162166,1360955162166,1376544014,1376544014,0
1360955381,1376762716,28,19725,704.4642857,1360955367926,1360955376566,1376749642,1376758282,8640
1360955393,1376775156,3,458,152.6666667,1360955366461,1360955366781,1376748617,1376748937,320
1360955402,1376783276,52,48776,938,1360955375855,1360955400239,1376757131,1376781515,24384
1360955446,1376827624,1,46,46,1360955418383,1360955418383,1376800007,1376800007,0
1360955525,1376906956,2,131,65.5,1360955519491,1360955519491,1376901447,1376901447,0
1360955702,1377084156,1,46,46,1360955673849,1360955673849,1377056005,1377056005,0
1360955955,1377337024,1,46,46,1360955929976,1360955929976,1377312000,1377312000,0
1360956208,1377589292,2,92,46,1360956179985,1360956181009,1377561277,1377562301,1024
1360956212,1377593284,1,46,46,1360956186714,1360956186714,1377567998,1377567998,0
1361151704,1573085440,1,46,46,1361151676313,1361151676313,1573057753,1573057753,0
1361151991,1573371856,1,46,46,1361151966363,1361151966363,1573347219,1573347219,0
1361152340,1573720600,1,46,46,1361152313558,1361152313558,1573694158,1573694158,0
1361153675,1575055892,1,46,46,1361153648286,1361153648286,1575029178,1575029178,0
1361155447,1576828108,1,46,46,1361155421930,1361155421930,1576803038,1576803038,0
1361155712,1577092608,1,46,46,1361155685085,1361155685085,1577065693,1577065693,0
1361156545,1577925720,1,46,46,1361156517920,1361156517920,1577898640,1577898640,0
1361157546,217240212,1,46,46,1361157521486,1361157521486,217215698,217215698,0
1361159603,1580983956,3,138,46,1361159575235,1361159583683,1580956191,1580964639,8448
1361160617,1581998204,1,48,48,1361160590010,1361160590010,1581971214,1581971214,0
1361161821,1583201872,1,46,46,1361161795317,1361161795317,1583176189,1583176189,0
1361162462,1583843080,1,46,46,1361162435164,1361162435164,1583816244,1583816244,0
1361164318,1585698940,1,61,61,1361164292045,1361164292045,1585672985,1585672985,0
1361164534,1585915472,1,46,46,1361164508658,1361164508658,1585890130,1585890130,0
1361164771,1586151656,1,78,78,1361164745695,1361164745695,1586126351,1586126351,0
1361164919,1586300128,1,46,46,1361164893318,1361164893318,1586274446,1586274446,0
1361165874,1587254912,5,250,50,1361165847312,1361165869584,1587228224,1587250496,22272
1361166695,1588076476,2,122,61,1361166669839,1361166670031,1588051315,1588051507,192
1361167213,1588594172,1,48,48,1361167185143,1361167185143,1588566315,1588566315,0
1361167418,1588798728,1,48,48,1361167391921,1361167391921,1588772649,1588772649,0
1361167919,1589300272,1,46,46,1361167891721,1361167891721,1589272993,1589272993,0
1361168009,1589389572,1,46,46,1361167980482,1361167980482,1589361054,1589361054,0
1361168614,1589995188,1,46,46,1361168586449,1361168586449,1589967637,1589967637,0
1361169062,1590442808,1,46,46,1361169037511,1361169037511,1590418319,1590418319,0
1361169544,1590924792,1,46,46,1361169516369,1361169516369,1590897161,1590897161,0
1361169704,1591084580,1,46,46,1361169676515,1361169676515,1591057095,1591057095,0
1361197123,1618504188,1,71,71,1361197095965,1361197095965,1618477153,1618477153,0
1361199615,1620995828,3,168,56,1361199613470,1361199614302,1620994298,1620995130,832
1361199623,1621003824,2,110,55,1361199603172,1361199617764,1620983996,1620998588,14592
1361199629,1621009616,1,46,46,1361199601908,1361199601908,1620982524,1620982524,0
1361199629,1621009616,9,2911,323.4444444,1361199602098,1361199610290,1620982714,1620990906,8192
1361199629,1621009648,19,4208,221.4736842,1361199603411,1361199614483,1620984059,1620995131,11072
1361199633,1621013664,10,3510,351,1361199608131,1361199611267,1620988795,1620991931,3136
1361199633,1621013712,24,10357,431.5416667,1361199607697,1361199618449,1620988409,1620999161,10752
1361199641,1621021676,1,64,64,1361199615095,1361199615095,1620995771,1620995771,0
1361199653,1621033636,1,64,64,1361199625503,1361199625503,1621006139,1621006139,0
1361199681,1621061728,17,5480,322.3529412,1361199654210,1361199660226,1621034938,1621040954,6016
1361199685,1621065648,1,52,52,1361199657362,1361199657362,1621038010,1621038010,0
1361199689,1621069748,1,46,46,1361199663792,1361199663792,1621044540,1621044540,0
1361199735,1621115836,2,131,65.5,1361199730006,1361199730006,1621110842,1621110842,0
1361199741,1621121716,8,2872,359,1361199713229,1361199714701,1621093945,1621095417,1472
1361199741,1621121732,9,3475,386.1111111,1361199714815,1361199715391,1621095547,1621096123,576
1361199741,1621121800,3,755,251.6666667,1361199713787,1361199714619,1621094587,1621095419,832
1361199823,1621203928,3,168,56,1361199815546,1361199816122,1621196474,1621197050,576
1361199823,1621203932,3,168,56,1361199818547,1361199819315,1621199479,1621200247,768
1361199823,1621203936,3,168,56,1361199814576,1361199815216,1621195512,1621196152,640
1361199823,1621203964,3,168,56,1361199817429,1361199818133,1621198393,1621199097,704
1361199823,1621204004,3,168,56,1361199816364,1361199817004,1621197368,1621198008,640
1361199839,1621219972,3,210,70,1361199834378,1361199834634,1621215350,1621215606,256
1361199839,1621219988,3,210,70,1361199834939,1361199835195,1621215927,1621216183,256
1361199845,1621225820,1,52,52,1361199819491,1361199819491,1621200311,1621200311,0
1361199845,1621225864,17,4096,240.9411765,1361199817913,1361199821753,1621198777,1621202617,3840
1361199845,1621225864,14,5747,410.5,1361199818231,1361199823671,1621199095,1621204535,5440
1361199845,1621225900,1,64,64,1361199819668,1361199819668,1621200568,1621200568,0
1361199865,1621245812,16,3306,206.625,1361199860778,1361199862570,1621241590,1621243382,1792
1361199877,1621257920,1,52,52,1361199851008,1361199851008,1621231928,1621231928,0
1361199885,1621265844,7,3438,491.1428571,1361199858892,1361199860044,1621239736,1621240888,1152
1361199885,1621265912,1,52,52,1361199858248,1361199858248,1621239160,1621239160,0
1361200089,1621470196,1,52,52,1361200063338,1361200063338,1621444534,1621444534,0
1361200111,1621492168,27,19480,721.4814815,1361200100675,1361200109955,1621481843,1621491123,9280
1361200126,1621506516,1,52,52,1361200100369,1361200100369,1621480885,1621480885,0
1361200134,1621514476,7,2407,343.8571429,1361200109686,1361200110710,1621490162,1621491186,1024
1361200138,1621518472,1,64,64,1361200111100,1361200111100,1621491572,1621491572,0
1361200158,1621538484,1,64,64,1361200132720,1361200132720,1621513204,1621513204,0
1361200158,1621538532,1,46,46,1361200132287,1361200132287,1621512819,1621512819,0
1361200162,1621542488,18,5867,325.9444444,1361200135469,1361200141037,1621515957,1621521525,5568
1361200162,1621542496,1,52,52,1361200135780,1361200135780,1621516276,1621516276,0
1361200167,1621548236,3,168,56,1361200163904,1361200164032,1621545140,1621545268,128
1361200175,1621556196,4,271,67.75,1361200174182,1361200174310,1621555378,1621555506,128
1361200175,1621556224,2,110,55,1361200164042,1361200174858,1621545266,1621556082,10816
1361200183,1621564176,3,168,56,1361200177721,1361200177849,1621558897,1621559025,128
1361200183,1621564180,3,168,56,1361200177528,1361200177656,1621558708,1621558836,128
1361200183,1621564216,3,168,56,1361200177363,1361200177491,1621558579,1621558707,128
1361200186,1621566544,3,2517,839,1361200160820,1361200160820,1621541364,1621541364,0
1361200191,1621572332,3,168,56,1361200187808,1361200187872,1621569140,1621569204,64
1361200206,1621586592,1,46,46,1361200178436,1361200178436,1621559028,1621559028,0
1361200206,1621586592,1,64,64,1361200178499,1361200178499,1621559091,1621559091,0
1361200214,1621594596,7,3247,463.8571429,1361200186304,1361200186752,1621566900,1621567348,448
1361200258,1621638952,16,8038,502.375,1361200231129,1361200234457,1621612081,1621615409,3328
1361200258,1621638956,4,492,123,1361200232791,1361200234519,1621613747,1621615475,1728
1361200263,1621644320,11,5880,534.5454545,1361200254825,1361200261481,1621636145,1621642801,6656
1361200286,1621667048,97,9359,96.48453608,1361200260727,1361200271671,1621641775,1621652719,10944
1361200439,1621819444,1,224,224,1361200413268,1361200413268,1621793712,1621793712,0
1361200480,1621860468,3,156,52,1361200474938,1361200476730,1621855406,1621857198,1792
1361200520,1621900508,168,13921,82.86309524,1361200261011,1361200516115,1621641519,1621896623,255104
1361200520,1621900520,4,184,46,1361200512199,1361200516359,1621892719,1621896879,4160
1361200535,1621916464,2,92,46,1361200519511,1361200528215,1621900975,1621909679,8704
1361200547,1621927600,1,46,46,1361200521078,1361200521078,1621901678,1621901678,0
1361200551,1621931480,1,64,64,1361200522926,1361200522926,1621903406,1621903406,0
1361200551,1621931620,16,3910,244.375,1361200526176,1361200529440,1621906796,1621910060,3264
1361200555,1621935596,1,52,52,1361200527610,1361200527610,1621908206,1621908206,0
1361200592,1621972568,3,168,56,1361200589525,1361200590165,1621970093,1621970733,640
1361200592,1621972568,3,168,56,1361200586771,1361200587411,1621967339,1621967979,640
1361200592,1621972572,12,3366,280.5,1361200582479,1361200584015,1621963051,1621964587,1536
1361200592,1621972580,4,271,67.75,1361200587656,1361200588296,1621968236,1621968876,640
1361200592,1621972604,3,168,56,1361200588593,1361200589169,1621969197,1621969773,576
1361200592,1621972624,4,271,67.75,1361200591003,1361200591579,1621971627,1621972203,576
1361200607,1621987792,9,3463,384.7777778,1361200580210,1361200581426,1621961002,1621962218,1216
1361200611,1621991908,1,46,46,1361200586111,1361200586111,1621967019,1621967019,0
1361200619,1621999852,1,64,64,1361200591736,1361200591736,1621972588,1621972588,0
1361200704,1622084632,2,131,65.5,1361200701459,1361200701459,1622082091,1622082091,0
1361200760,1622140604,12,3122,260.1666667,1361200757485,1361200758957,1622138089,1622139561,1472
1361200784,1622164568,7,3438,491.1428571,1361200755859,1361200757011,1622136427,1622137579,1152
1361200912,1622292940,3,168,56,1361200907867,1361200908763,1622288807,1622289703,896
1361200912,1622292984,3,168,56,1361200910640,1361200911280,1622291624,1622292264,640
1361200912,1622293024,3,168,56,1361200909639,1361200910343,1622290663,1622291367,704
1361200920,1622301072,2,104,52,1361200913560,1361200914328,1622294632,1622295400,768
1361200928,1622309088,3,168,56,1361200926536,1361200927112,1622307624,1622308200,576
1361200936,1622316888,1,46,46,1361200909456,1361200909456,1622290344,1622290344,0
1361200936,1622316888,12,2652,221,1361200909710,1361200932814,1622290598,1622313702,23104
1361200936,1622316932,1,64,64,1361200911651,1361200911651,1622292583,1622292583,0
1361200952,1622332880,1,64,64,1361200927701,1361200927701,1622308581,1622308581,0
1361200956,1622336856,18,4457,247.6111111,1361200930800,1361200949872,1622311656,1622330728,19072
1361200992,1622372868,1,46,46,1361200966755,1361200966755,1622347623,1622347623,0
1361200992,1622373208,19,21961,1155.842105,1361200980813,1361200989389,1622362021,1622370597,8576
1361201024,1622405008,1,52,52,1361200996566,1361200996566,1622377574,1622377574,0
1361201052,1622433288,10,11568,1156.8,1361201026878,1361201027454,1622408166,1622408742,576
1361201056,1622437168,3,1258,419.3333333,1361201027894,1361201028214,1622409062,1622409382,320
1361201056,1622437252,3,2683,894.3333333,1361201029409,1361201029665,1622410661,1622410917,256
1361201056,1622437340,1,52,52,1361201030217,1361201030217,1622411557,1622411557,0
1361201112,1622493300,1,52,52,1361201087088,1361201087088,1622468388,1622468388,0
1361201277,1622657912,1,46,46,1361201251057,1361201251057,1622631969,1622631969,0
1361201337,1622717960,18,5432,301.7777778,1361201309759,1361201313087,1622690719,1622694047,3328
1361201337,1622718108,1,52,52,1361201311278,1361201311278,1622692386,1622692386,0
1361201381,1622762156,1,46,46,1361201353723,1361201353723,1622734879,1622734879,0
1361201385,1622766168,1,46,46,1361201357617,1361201357617,1622738785,1622738785,0
1361201465,1622845744,10,6685,668.5,1361201461910,1361201462614,1622842654,1622843358,704
1361201465,1622845748,12,6571,547.5833333,1361201462546,1361201462994,1622843294,1622843742,448
1361201465,1622845784,19,13981,735.8421053,1361201461102,1361201461422,1622841886,1622842206,320
1361201465,1622845788,17,13864,815.5294118,1361201461418,1361201461738,1622842206,1622842526,320
1361201465,1622846308,2,703,351.5,1361201440417,1361201440993,1622821725,1622822301,576
1361201489,1622870348,7,3153,450.4285714,1361201461948,1361201462204,1622843296,1622843552,256
1361201542,1622922608,1,52,52,1361201514270,1361201514270,1622894878,1622894878,0
1361201646,1623026720,1,224,224,1361201617964,1361201617964,1622998684,1622998684,0
1361201665,1623045844,17,3358,197.5294118,1361201658223,1361201660079,1623039067,1623040923,1856
1361201665,1623045848,22,3588,163.0909091,1361201658410,1361201660074,1623039258,1623040922,1664
1361201665,1623045892,17,3582,210.7058824,1361201662463,1361201663999,1623043355,1623044891,1536
1361201665,1623045932,22,9868,448.5454545,1361201660119,1361201662295,1623041051,1623043227,2176
1361201673,1623053916,17,3302,194.2352941,1361201670184,1361201672296,1623051100,1623053212,2112
1361201673,1623053916,24,3928,163.6666667,1361201666344,1361201668392,1623047260,1623049308,2048
1361201673,1623053924,16,8731,545.6875,1361201665886,1361201667742,1623046810,1623048666,1856
1361201673,1623053944,24,3720,155,1361201667789,1361201669581,1623048733,1623050525,1792
1361201673,1623053948,18,5422,301.2222222,1361201664010,1361201665674,1623044958,1623046622,1664
1361201681,1623061860,13,3522,270.9230769,1361201674398,1361201676062,1623055258,1623056922,1664
1361201681,1623061908,13,3522,270.9230769,1361201672561,1361201674353,1623053469,1623055261,1792
1361201681,1623061908,22,5891,267.7727273,1361201670064,1361201673072,1623050972,1623053980,3008
1361201681,1623061912,26,3661,140.8076923,1361201678636,1361201679980,1623059548,1623060892,1344
1361201681,1623061920,61,65157,1068.147541,1361201673957,1361201676965,1623054877,1623057885,3008
1361201681,1623061948,3,168,56,1361201676806,1361201677574,1623057754,1623058522,768
1361201681,1623061948,24,3769,157.0416667,1361201676936,1361201678472,1623057884,1623059420,1536
1361201681,1623061952,18,5451,302.8333333,1361201672259,1361201673923,1623053211,1623054875,1664
1361201681,1623061952,13,3522,270.9230769,1361201672515,1361201674307,1623053467,1623055259,1792
1361201682,1623063108,9,4004,444.8888889,1361201655975,1361201657639,1623037083,1623038747,1664
1361201702,1623083124,1,64,64,1361201677719,1361201677719,1623058843,1623058843,0
1361201705,1623085892,4,184,46,1361201702719,1361201704319,1623083611,1623085211,1600
1361201729,1623109856,3,168,56,1361201723233,1361201723937,1623104089,1623104793,704
1361201729,1623109864,3,168,56,1361201724249,1361201724953,1623105113,1623105817,704
1361201729,1623109896,4,220,55,1361201725372,1361201726076,1623106268,1623106972,704
1361201734,1623115244,1,46,46,1361201705888,1361201705888,1623087132,1623087132,0
1361201737,1623117896,4,271,67.75,1361201735163,1361201735995,1623116059,1623116891,832
1361201737,1623117928,2,116,58,1361201736220,1361201736668,1623117148,1623117596,448
1361201738,1623119252,9,2334,259.3333333,1361201713048,1361201715992,1623094300,1623097244,2944
1361201742,1623123176,1,52,52,1361201714977,1361201714977,1623096153,1623096153,0
1361201746,1623127216,1,46,46,1361201721724,1361201721724,1623102940,1623102940,0
1361201762,1623143168,1,52,52,1361201736683,1361201736683,1623117851,1623117851,0
1361201762,1623143180,1,64,64,1361201737376,1361201737376,1623118556,1623118556,0
1361201762,1623143284,20,4260,213,1361201736311,1361201751031,1623117595,1623132315,14720
1361201766,1623147212,1,52,52,1361201737919,1361201737919,1623119131,1623119131,0
1361201831,1623211580,1,46,46,1361201804791,1361201804791,1623185371,1623185371,0
1361201923,1623303560,1,52,52,1361201898183,1361201898183,1623278743,1623278743,0
1361202097,1623478244,3,168,56,1361202089752,1361202090328,1623470996,1623471572,576
1361202097,1623478296,3,168,56,1361202091236,1361202091876,1623472532,1623473172,640
1361202105,1623486308,3,168,56,1361202102808,1361202103320,1623484116,1623484628,512
1361202121,1623502272,2,110,55,1361202103486,1361202115710,1623484758,1623496982,12224
1361202123,1623503728,1,52,52,1361202097627,1361202097627,1623478355,1623478355,0
1361202123,1623503756,17,3970,233.5294118,1361202095362,1361202099650,1623476118,1623480406,4288
1361202139,1623519688,1,64,64,1361202114182,1361202114182,1623494870,1623494870,0
1361202426,1623806720,1,46,46,1361202397088,1361202397088,1623777808,1623777808,0
1361202463,1623844040,1,64,64,1361202437023,1361202437023,1623818063,1623818063,0
1361202463,1623844040,14,2662,190.1428571,1361202437087,1361202444191,1623818127,1623825231,7104
1361202471,1623851996,17,4047,238.0588235,1361202445708,1361202449420,1623826704,1623830416,3712
1361202475,1623856016,1,52,52,1361202447159,1361202447159,1623828175,1623828175,0
1361202570,1623950608,3,168,56,1361202569165,1361202569357,1623949773,1623949965,192
1361202586,1623966656,4,271,67.75,1361202580575,1361202581023,1623961231,1623961679,448
1361202595,1623976132,1,64,64,1361202568896,1361202568896,1623950028,1623950028,0
1361202595,1623976200,1,46,46,1361202568699,1361202568699,1623949899,1623949899,0
1361202599,1623980100,22,5503,250.1363636,1361202571810,1361202574818,1623952910,1623955918,3008
1361202599,1623980104,1,52,52,1361202572126,1361202572126,1623953230,1623953230,0
1361202599,1623980168,19,8258,434.6315789,1361202571803,1361202579931,1623952971,1623961099,8128
1361202607,1623988128,1,64,64,1361202581125,1361202581125,1623962253,1623962253,0
1361202626,1624006672,2,110,55,1361202614158,1361202624206,1623994830,1624004878,10048
1361202626,1624006688,3,168,56,1361202624189,1361202624317,1624004877,1624005005,128
1361202626,1624006688,3,168,56,1361202624380,1361202624508,1624005068,1624005196,128
1361202631,1624012208,7,2689,384.1428571,1361202603956,1361202604212,1623985164,1623985420,256
1361202635,1624016116,1,46,46,1361202609423,1361202609423,1623990539,1623990539,0
1361202643,1624024120,1,487,487,1361202615437,1361202615437,1623996557,1623996557,0
1361202651,1624032164,11,7817,710.6363636,1361202624034,1361202639522,1624005198,1624020686,15488
1361202651,1624032212,50,43833,876.66,1361202623983,1361202639471,1624005195,1624020683,15488
1361202655,1624036204,21,20860,993.3333333,1361202629624,1361202632696,1624010828,1624013900,3072
1361202659,1624040180,10,4467,446.7,1361202633999,1361202634767,1624015179,1624015947,768
1361202659,1624040192,72,83003,1152.819444,1361202632709,1361202651269,1624013901,1624032461,18560
1361202674,1624054672,2,131,65.5,1361202669644,1361202669644,1624050316,1624050316,0
1361202674,1624054672,2,131,65.5,1361202669643,1361202669643,1624050315,1624050315,0
1361202682,1624062644,2,92,46,1361202676265,1361202676265,1624056909,1624056909,0
1361202700,1624080556,30,31912,1063.733333,1361202672063,1361202698495,1624052619,1624079051,26432
1361202704,1624084484,7,4285,612.1428571,1361202676360,1361202676616,1624056844,1624057100,256
1361202704,1624084540,1,46,46,1361202676368,1361202676368,1624056908,1624056908,0
1361202704,1624084560,24,19996,833.1666667,1361202676346,1361202685050,1624056906,1624065610,8704
1361202712,1624092564,12,5668,472.3333333,1361202684921,1361202685817,1624065485,1624066381,896
1361202714,1624094720,2,131,65.5,1361202706395,1361202706395,1624087115,1624087115,0
1361202722,1624102740,2,131,65.5,1361202714694,1361202714694,1624095434,1624095434,0
1361202722,1624102752,2,131,65.5,1361202715641,1361202715641,1624096393,1624096393,0
1361202730,1624110768,2,92,46,1361202727146,1361202727530,1624107914,1624108298,384
1361202732,1624112516,20,23029,1151.45,1361202706665,1361202710057,1624087181,1624090573,3392
1361202752,1624132596,60,77401,1290.016667,1361202727702,1361202728406,1624108298,1624109002,704
1361202752,1624132672,11,6128,557.0909091,1361202727689,1361202749641,1624108361,1624130313,21952
1361202762,1624142880,2,131,65.5,1361202754620,1361202754620,1624135500,1624135500,0
1361202764,1624144592,95,121499,1278.936842,1361202739739,1361202757275,1624120331,1624137867,17536
1361202778,1624158820,18,10646,591.4444444,1361202756023,1361202773431,1624136843,1624154251,17408
1361202784,1624164600,1,46,46,1361202756241,1361202756241,1624136841,1624136841,0
1361202784,1624164604,15,13366,891.0666667,1361202756304,1361202756880,1624136908,1624137484,576
1361202794,1624174820,2,131,65.5,1361202786678,1361202786678,1624167498,1624167498,0
1361202800,1624180700,13,7940,610.7692308,1361202773680,1361202798768,1624154380,1624179468,25088
1361202812,1624192560,2,92,46,1361202807866,1361202807866,1624188426,1624188426,0
1361202812,1624192684,1,46,46,1361202787454,1361202787454,1624168138,1624168138,0
1361202812,1624192872,12,5784,482,1361202787267,1361202788035,1624168139,1624168907,768
1361202818,1624198772,4,245,61.25,1361202812006,1361202812006,1624192778,1624192778,0
1361202818,1624198788,3,168,56,1361202813974,1361202814038,1624194762,1624194826,64
1361202818,1624198856,2,113,56.5,1361202813523,1361202813523,1624194379,1624194379,0
1361202826,1624206768,2,131,65.5,1361202818152,1361202818152,1624198920,1624198920,0
1361202826,1624206808,14,9984,713.1428571,1361202807553,1361202818625,1624188361,1624199433,11072
1361202828,1624208892,15,16562,1104.133333,1361202802287,1361202802543,1624183179,1624183435,256
1361202832,1624212928,21,19734,939.7142857,1361202807563,1361202829963,1624188491,1624210891,22400
1361202832,1624212928,46,58391,1269.369565,1361202807626,1361202811978,1624188554,1624192906,4352
1361202834,1624214780,2,92,46,1361202830046,1361202830046,1624210826,1624210826,0
1361202844,1624224876,1,46,46,1361202818556,1361202818556,1624199432,1624199432,0
1361202856,1624236896,10,6450,645,1361202829992,1361202838696,1624210888,1624219592,8704
1361202858,1624238820,4,223,55.75,1361202852725,1361202857141,1624233545,1624237961,4416
1361202872,1624252948,1,46,46,1361202844470,1361202844470,1624225418,1624225418,0
1361202882,1624262840,9,6131,681.2222222,1361202857120,1361202875168,1624237960,1624256008,18048
1361202884,1624264996,14,11760,840,1361202857093,1361202874309,1624238089,1624255305,17216
1361202884,1624265036,1,46,46,1361202858395,1361202858395,1624239431,1624239431,0
1361202884,1624265040,11,5794,526.7272727,1361202858584,1361202859416,1624239624,1624240456,832
1361202890,1624270884,3,159,53,1361202887795,1361202887859,1624268679,1624268743,64
1361202890,1624270892,2,92,46,1361202884269,1361202884269,1624265161,1624265161,0
1361202890,1624270956,2,131,65.5,1361202889516,1361202889516,1624270472,1624270472,0
1361202900,1624280984,67,85948,1282.80597,1361202874834,1361202875410,1624255818,1624256394,576
1361202906,1624286860,14,11861,847.2142857,1361202885581,1361202902349,1624266441,1624283209,16768
1361202912,1624293020,14,9885,706.0714286,1361202884205,1361202885421,1624265225,1624266441,1216
1361202912,1624293088,1,46,46,1361202887655,1361202887655,1624268743,1624268743,0
1361202912,1624293088,31,32756,1056.645161,1361202887719,1361202901223,1624268807,1624282311,13504
1361202922,1624302924,2,131,65.5,1361202915533,1361202915533,1624296457,1624296457,0
1361202946,1624326916,3,230,76.66666667,1361202945492,1361202945748,1624326408,1624326664,256
1361202962,1624342880,4,184,46,1361202956472,1361202956472,1624337352,1624337352,0
1361202972,1624353128,3,240,80,1361202943872,1361202948800,1624325000,1624329928,4928
1361202977,1624357428,15,6143,409.5333333,1361202949819,1361202950523,1624330247,1624330951,704
1361202984,1624365368,9,3463,384.7777778,1361202955983,1361202957455,1624337351,1624338823,1472
1361202986,1624366964,2,131,65.5,1361202980003,1361202980003,1624360967,1624360967,0
1361203049,1624429420,1,46,46,1361203023042,1361203023042,1624403462,1624403462,0
1361203058,1624438968,601,789920,1314.342762,1361202811806,1361203052446,1624192774,1624433414,240640
1361203064,1624445408,1,46,46,1361203037925,1361203037925,1624419333,1624419333,0
1361203065,1624445500,1,52,52,1361203039348,1361203039348,1624419848,1624419848,0
1361203082,1624462944,2,131,65.5,1361203077751,1361203077751,1624458695,1624458695,0
1361203082,1624463012,2,113,56.5,1361203081395,1361203081395,1624462407,1624462407,0
1361203225,1624605700,1,46,46,1361203200104,1361203200104,1624580804,1624580804,0
1361203237,1624617696,1,193,193,1361203211501,1361203211501,1624592197,1624592197,0
1361203241,1624621652,13,7083,544.8461538,1361203213974,1361203217814,1624594626,1624598466,3840
1361203281,1624661796,5,731,146.2,1361203256775,1361203257543,1624637571,1624638339,768
1361203281,1624661860,3,379,126.3333333,1361203255749,1361203255749,1624636609,1624636609,0
1361203282,1624663048,3,179,59.66666667,1361203277321,1361203277321,1624658369,1624658369,0
1361203297,1624677788,25,18528,741.12,1361203271566,1361203296782,1624652354,1624677570,25216
1361203301,1624681768,1,46,46,1361203273633,1361203273633,1624654401,1624654401,0
1361203301,1624681848,40,40480,1012,1361203273553,1361203284305,1624654401,1624665153,10752
1361203305,1624685768,17,18069,1062.882353,1361203277665,1361203278369,1624658433,1624659137,704
1361203322,1624703092,2,131,65.5,1361203316255,1361203316255,1624697347,1624697347,0
1361203325,1624705784,9,6274,697.1111111,1361203296978,1361203304018,1624677762,1624684802,7040
1361203330,1624711132,2,92,46,1361203325880,1361203325880,1624707012,1624707012,0
1361203345,1624725808,3,730,243.3333333,1361203316922,1361203317242,1624697730,1624698050,320
1361203346,1624727072,3,994,331.3333333,1361203326002,1361203341938,1624707074,1624723010,15936
1361203353,1624733912,18,12750,708.3333333,1361203326225,1361203348753,1624707137,1624729665,22528
1361203354,1624735156,2,92,46,1361203347804,1361203347868,1624728960,1624729024,64
1361203357,1624737876,11,5616,510.5454545,1361203328886,1361203329334,1624709762,1624710210,448
1361203362,1624743144,2,131,65.5,1361203359080,1361203359080,1624740224,1624740224,0
1361203373,1624753904,8,4366,545.75,1361203348185,1361203348505,1624729089,1624729409,320
1361203378,1624759112,2,131,65.5,1361203371145,1361203371145,1624752257,1624752257,0
1361203386,1624767104,3,210,70,1361203378322,1361203378642,1624759426,1624759746,320
1361203405,1624786260,2,122,61,1361203379190,1361203381686,1624760450,1624762946,2496
1361203417,1624797904,2,243,121.5,1361203391258,1361203391578,1624772162,1624772482,320
1361203417,1624797908,3,567,189,1361203391892,1361203392084,1624772800,1624772992,192
1361203453,1624833944,2,415,207.5,1361203427696,1361203427696,1624808640,1624808640,0
1361203453,1624834052,10,6695,669.5,1361203428101,1361203428869,1624809153,1624809921,768
1361203489,1624870236,3,180,60,1361203464139,1361203464395,1624845375,1624845631,256
1361203506,1624886456,1,46,46,1361203481494,1361203481494,1624861950,1624861950,0
1361203517,1624898284,1,46,46,1361203492379,1361203492379,1624873663,1624873663,0
1361203582,1624962444,10,5477,547.7,1361203556001,1361203556641,1624936445,1624937085,640
1361203585,1624966404,2,188,94,1361203560738,1361203560738,1624942142,1624942142,0
1361203586,1624967344,2,131,65.5,1361203585756,1361203585756,1624967100,1624967100,0
1361203613,1624994392,1,79,79,1361203585965,1361203585965,1624967357,1624967357,0
1361203634,1625014656,3,240,80,1361203608462,1361203612558,1624989118,1624993214,4096
1361203667,1625047452,15,3758,250.5333333,1361203661145,1361203661593,1625041597,1625042045,448
1361203667,1625047452,6,276,46,1361203661144,1361203661144,1625041596,1625041596,0
1361203670,1625050636,1,60,60,1361203644322,1361203644322,1625024958,1625024958,0
1361203670,1625050684,1,60,60,1361203642290,1361203642290,1625022974,1625022974,0
1361203690,1625070676,9,3463,384.7777778,1361203662008,1361203662520,1625042684,1625043196,512
1361203694,1625074668,1,52,52,1361203669248,1361203669248,1625049916,1625049916,0
1361203699,1625079552,3,138,46,1361203697589,1361203697589,1625078141,1625078141,0
1361203722,1625102756,12,4253,354.4166667,1361203697703,1361203701031,1625078459,1625081787,3328
1361203726,1625106636,2,245,122.5,1361203698783,1361203699551,1625079419,1625080187,768
1361203779,1625159540,2,127,63.5,1361203778493,1361203778493,1625159033,1625159033,0
1361203787,1625167448,2,131,65.5,1361203782618,1361203782618,1625163066,1625163066,0
1361203850,1625230928,2,188,94,1361203825784,1361203825784,1625206712,1625206712,0
1361203942,1625323016,3,240,80,1361203915679,1361203928607,1625296695,1625309623,12928
1361203966,1625347052,1,52,52,1361203940731,1361203940731,1625321783,1625321783,0
1361204026,1625407080,1,52,52,1361204000541,1361204000541,1625381621,1625381621,0
1361204094,1625475092,2,188,94,1361204066193,1361204066193,1625447285,1625447285,0
1361204138,1625519376,1,52,52,1361204112503,1361204112503,1625493879,1625493879,0
1361204174,1625555420,3,553,184.3333333,1361204148105,1361204148425,1625529525,1625529845,320
1361204195,1625575440,1,46,46,1361204169371,1361204169371,1625549811,1625549811,0
1361204251,1625631520,1,52,52,1361204226508,1361204226508,1625607028,1625607028,0
1361204315,1625696096,1,46,46,1361204287244,1361204287244,1625668340,1625668340,0
1361204476,1625856504,3,144,48,1361204450585,1361204459545,1625831089,1625840049,8960
1361204481,1625861444,1,48,48,1361204453910,1361204453910,1625834354,1625834354,0
1361204488,1625868440,2,339,169.5,1361204460311,1361204460311,1625840751,1625840751,0
1361204576,1625956520,1,52,52,1361204547848,1361204547848,1625928368,1625928368,0
1361204596,1625976780,3,144,48,1361204570306,1361204579330,1625951086,1625960110,9024
1361205164,1626544436,4,184,46,1361205162515,1361205162515,1626542951,1626542951,0
1361205177,1626557480,2,339,169.5,1361205149030,1361205149030,1626529510,1626529510,0
1361205189,1626569620,10,3523,352.3,1361205162395,1361205163995,1626543015,1626544615,1600
1361205233,1626613644,1,52,52,1361205206976,1361205206976,1626587620,1626587620,0
1361205258,1626638644,1,46,46,1361205229569,1361205229569,1626610213,1626610213,0
1361205292,1626672592,2,131,65.5,1361205283892,1361205283892,1626664484,1626664484,0
1361205428,1626808740,23,9920,431.3043478,1361205420444,1361205425692,1626801184,1626806432,5248
1361205428,1626808748,16,3306,206.625,1361205418519,1361205420375,1626799267,1626801123,1856
1361205428,1626808784,23,3851,167.4347826,1361205424113,1361205425969,1626804897,1626806753,1856
1361205436,1626816680,23,7842,340.9565217,1361205426075,1361205430811,1626806755,1626811491,4736
1361205436,1626816716,21,3623,172.5238095,1361205432821,1361205434421,1626813537,1626815137,1600
1361205436,1626816764,15,6762,450.8,1361205430852,1361205432708,1626811616,1626813472,1856
1361205436,1626816764,20,3738,186.9,1361205431108,1361205433476,1626811872,1626814240,2368
1361205442,1626822500,10,3653,365.3,1361205416267,1361205418123,1626796767,1626798623,1856
1361205444,1626824676,69,65771,953.2028986,1361205439518,1361205442526,1626820194,1626823202,3008
1361205444,1626824680,21,3608,171.8095238,1361205435162,1361205437466,1626815842,1626818146,2304
1361205444,1626824732,15,3889,259.2666667,1361205437414,1361205439462,1626818146,1626820194,2048
1361205452,1626832700,24,3665,152.7083333,1361205444421,1361205446789,1626825121,1626827489,2368
1361205452,1626832724,17,3435,202.0588235,1361205442475,1361205443947,1626823199,1626824671,1472
1361205453,1626834388,62,70448,1136.258065,1361205427476,1361205444500,1626808864,1626825888,17024
1361205470,1626850500,59,12759,216.2542373,1361205445646,1361205450574,1626826146,1626831074,4928
1361205476,1626856804,2,92,46,1361205475230,1361205475486,1626856034,1626856290,256
1361205570,1626950568,8,3532,441.5,1361205545673,1361205547017,1626926241,1626927585,1344
1361205612,1626992744,3,152,50.66666667,1361205607702,1361205607958,1626988446,1626988702,256
1361205676,1627056740,23,9935,431.9565217,1361205669785,1361205670809,1627050525,1627051549,1024
1361205686,1627066632,1,52,52,1361205657989,1361205657989,1627038621,1627038621,0
1361205694,1627074756,3,388,129.3333333,1361205669001,1361205677513,1627049757,1627058269,8512
1361205710,1627090696,1,52,52,1361205685190,1361205685190,1627065886,1627065886,0
1361205718,1627098660,1,52,52,1361205690411,1361205690411,1627071071,1627071071,0
1361205726,1627106748,1,46,46,1361205698706,1361205698706,1627079454,1627079454,0
1361205786,1627166696,3,240,80,1361205758661,1361205775237,1627139357,1627155933,16576
1361205786,1627166804,1,46,46,1361205759640,1361205759640,1627140444,1627140444,0
1361205814,1627194840,1,46,46,1361205786805,1361205786805,1627167645,1627167645,0
1361205882,1627262940,1,52,52,1361205855246,1361205855246,1627236186,1627236186,0
1361206036,1627417020,9,414,46,1361206031869,1361206034365,1627412889,1627415385,2496
1361206123,1627503576,1,46,46,1361206095414,1361206095414,1627475990,1627475990,0
1361206123,1627503656,4,256,64,1361206095336,1361206116392,1627475992,1627497048,21056
1361206148,1627529072,7,400,57.14285714,1361206132806,1361206146694,1627513878,1627527766,13888
1361206164,1627545008,7,406,58,1361206155079,1361206160455,1627536087,1627541463,5376
1361206172,1627553116,14,5010,357.8571429,1361206165337,1361206167385,1627546453,1627548501,2048
1361206172,1627553128,22,5893,267.8636364,1361206161935,1361206165519,1627543063,1627546647,3584
1361206172,1627553132,20,6013,300.65,1361206162444,1361206166092,1627543576,1627547224,3648
1361206179,1627559640,2,104,52,1361206151927,1361206153079,1627532567,1627533719,1152
1361206180,1627561112,4,220,55,1361206174366,1361206177822,1627555478,1627558934,3456
1361206180,1627561156,15,3661,244.0666667,1361206167984,1361206173040,1627549140,1627554196,5056
1361206191,1627571648,1,46,46,1361206162927,1361206162927,1627543575,1627543575,0
1361206191,1627571736,1,64,64,1361206163925,1361206163925,1627544661,1627544661,0
1361206196,1627577168,5,296,59.2,1361206184548,1361206195684,1627565716,1627576852,11136
1361206204,1627585104,4,220,55,1361206196069,1361206197541,1627577173,1627578645,1472
1361206207,1627587800,1,52,52,1361206182037,1361206182037,1627562837,1627562837,0
1361206212,1627593152,5,284,56.8,1361206202163,1361206208371,1627583315,1627589523,6208
1361206220,1627601144,2,104,52,1361206211902,1361206218878,1627593046,1627600022,6976
1361206231,1627612112,3,564,188,1361206206236,1361206206684,1627587348,1627587796,448
1361206243,1627624076,1,46,46,1361206216257,1361206216257,1627597333,1627597333,0
1361206247,1627628032,9,4211,467.8888889,1361206219756,1361206221740,1627600788,1627602772,1984
1361206251,1627631996,1,52,52,1361206226706,1361206226706,1627607702,1627607702,0
1361206251,1627632116,1,64,64,1361206224984,1361206224984,1627606100,1627606100,0
1361206252,1627633132,4,220,55,1361206245448,1361206246984,1627626580,1627628116,1536
1361206252,1627633152,3,168,56,1361206246387,1361206247027,1627627539,1627628179,640
1361206259,1627640028,1,46,46,1361206231026,1361206231026,1627612054,1627612054,0
1361206388,1627768492,1,46,46,1361206363527,1361206363527,1627744019,1627744019,0
1361206388,1627768516,17,4086,240.3529412,1361206360112,1361206364080,1627740628,1627744596,3968
1361206392,1627772440,13,7258,558.3076923,1361206365177,1361206368377,1627745617,1627748817,3200
1361206456,1627836564,1,460,460,1361206430207,1361206430207,1627810771,1627810771,0
1361206488,1627868752,1,46,46,1361206462018,1361206462018,1627842770,1627842770,0
1361206492,1627872628,6,1292,215.3333333,1361206465404,1361206467260,1627846032,1627847888,1856
1361206492,1627872652,1,186,186,1361206466019,1361206466019,1627846671,1627846671,0
1361206520,1627900688,1,52,52,1361206495361,1361206495361,1627876049,1627876049,0
1361206637,1628017520,4,184,46,1361206634789,1361206634789,1628015309,1628015309,0
1361206660,1628041152,8,2741,342.625,1361206634412,1361206636652,1628015564,1628017804,2240
1361206709,1628089724,2,104,52,1361206707160,1361206707864,1628087884,1628088588,704
1361206717,1628097708,2,104,52,1361206709226,1361206711914,1628089934,1628092622,2688
1361206861,1628242136,2,104,52,1361206859260,1361206859772,1628240396,1628240908,512
1361206869,1628250084,3,156,52,1361206860845,1361206866925,1628241929,1628248009,6080
1361206885,1628266080,3,138,46,1361206876787,1361206882035,1628257867,1628263115,5248
1361206893,1628274124,2,104,52,1361206874951,1361206884999,1628256075,1628266123,10048
1361206901,1628282080,2,92,46,1361206889010,1361206898994,1628270090,1628280074,9984
1361206909,1628290184,2,104,52,1361206894923,1361206904907,1628276107,1628286091,9984
1361206925,1628306164,2,92,46,1361206908893,1361206918877,1628290057,1628300041,9984
1361206941,1628322156,1,52,52,1361206914919,1361206914919,1628296075,1628296075,0
1361207742,1629122812,3,168,56,1361207738418,1361207740978,1629119230,1629121790,2560
1361207742,1629122836,3,168,56,1361207735451,1361207737563,1629116287,1629118399,2112
1361207742,1629122888,3,219,73,1361207741287,1361207741607,1629122175,1629122495,320
1361207750,1629130756,3,168,56,1361207742953,1361207743593,1629123709,1629124349,640
1361207750,1629130828,4,220,55,1361207743840,1361207745632,1629124668,1629126460,1792
1361207750,1629130844,2,116,58,1361207748627,1361207748947,1629129471,1629129791,320
1361207758,1629138740,3,168,56,1361207751866,1361207754106,1629132606,1629134846,2240
1361207758,1629138856,4,271,67.75,1361207755269,1361207755909,1629136125,1629136765,640
1361207760,1629140428,11,3595,326.8181818,1361207734449,1361207745713,1629114877,1629126141,11264
1361207763,1629144376,13,2635,202.6923077,1361207737020,1361207757436,1629118396,1629138812,20416
1361207767,1629148332,1,52,52,1361207741674,1361207741674,1629123006,1629123006,0
1361207771,1629152396,1,46,46,1361207745066,1361207745066,1629126462,1629126462,0
1361207775,1629156332,2,104,52,1361207749546,1361207749994,1629130878,1629131326,448
1361207792,1629172516,6,1447,241.1666667,1361207764568,1361207764760,1629145084,1629145276,192
1361207870,1629250888,2,131,65.5,1361207865124,1361207865124,1629246012,1629246012,0
1361208117,1629497584,1,64,64,1361208090382,1361208090382,1629470966,1629470966,0
1361208121,1629501488,1,52,52,1361208094959,1361208094959,1629475447,1629475447,0
1361208121,1629501488,18,5432,301.7777778,1361208093551,1361208097135,1629474039,1629477623,3584
1361208134,1629514956,3,168,56,1361208130781,1361208131357,1629511737,1629512313,576
1361208134,1629514964,3,168,56,1361208131667,1361208132307,1629512631,1629513271,640
1361208134,1629514988,3,168,56,1361208128890,1361208129530,1629509878,1629510518,640
1361208134,1629515000,3,168,56,1361208129774,1361208130414,1629510774,1629511414,640
1361208142,1629523000,3,168,56,1361208134509,1361208135085,1629515509,1629516085,576
1361208142,1629523036,3,168,56,1361208133450,1361208134154,1629514486,1629515190,704
1361208142,1629523040,3,168,56,1361208135430,1361208136006,1629516470,1629517046,576
1361208150,1629531024,3,168,56,1361208141655,1361208142295,1629522679,1629523319,640
1361208161,1629541724,1,46,46,1361208132804,1361208132804,1629513528,1629513528,0
1361208277,1629658020,1,222,222,1361208250841,1361208250841,1629631861,1629631861,0
1361212911,1634292264,1,48,48,1361212883358,1361212883358,1634264622,1634264622,0
1361213215,1634596272,1,46,46,1361213185744,1361213185744,1634567016,1634567016,0
1361213374,1634755060,3,168,56,1361213370851,1361213371491,1634751911,1634752551,640
1361213398,1634779040,3,168,56,1361213392950,1361213393590,1634773990,1634774630,640
1361213401,1634782144,20,5888,294.4,1361213373646,1361213382222,1634754790,1634763366,8576
1361213406,1634787112,3,168,56,1361213404589,1361213405165,1634785701,1634786277,576
1361213414,1634795136,3,168,56,1361213405843,1361213406163,1634786979,1634787299,320
1361213414,1634795144,3,168,56,1361213406158,1361213406478,1634787302,1634787622,320
1361213414,1634795148,3,168,56,1361213406472,1361213407496,1634787620,1634788644,1024
1361213421,1634802048,1,64,64,1361213393835,1361213393835,1634774883,1634774883,0
1361213430,1634811168,2,116,58,1361213429427,1361213429683,1634810595,1634810851,256
1361213438,1634819076,3,168,56,1361213430417,1361213430993,1634811493,1634812069,576
1361213453,1634834084,8,2741,342.625,1361213427591,1361213429511,1634808675,1634810595,1920
1361213453,1634834200,1,46,46,1361213428372,1361213428372,1634809572,1634809572,0
1361213457,1634838116,1,52,52,1361213430056,1361213430056,1634811172,1634811172,0
1361213517,1634898244,1,487,487,1361213492713,1361213492713,1634873957,1634873957,0
1361213662,1635043236,3,180,60,1361213656110,1361213660142,1635037346,1635041378,4032
1361213678,1635059192,3,138,46,1361213669465,1361213676121,1635050657,1635057313,6656
1361213689,1635070336,1,52,52,1361213662154,1361213662154,1635043490,1635043490,0
1361213714,1635094444,1,46,46,1361213685829,1361213685829,1635066273,1635066273,0
1361213742,1635123296,2,104,52,1361213733233,1361213734961,1635114529,1635116257,1728
1361213742,1635123300,4,271,67.75,1361213737771,1361213738411,1635119071,1635119711,640
1361213742,1635123328,3,168,56,1361213738704,1361213739344,1635120032,1635120672,640
1361213742,1635123340,3,168,56,1361213739589,1361213740165,1635120929,1635121505,576
1361213742,1635123340,3,168,56,1361213736707,1361213737219,1635118047,1635118559,512
1361213758,1635138788,17,3962,233.0588235,1361213732397,1361213735469,1635113185,1635116257,3072
1361213854,1635235372,3,168,56,1361213849762,1361213849890,1635231134,1635231262,128
1361213854,1635235376,5,296,59.2,1361213846493,1361213849693,1635227869,1635231069,3200
1361213855,1635235452,3,168,56,1361213847289,1361213847417,1635227741,1635227869,128
1361213855,1635235456,3,168,56,1361213850868,1361213850932,1635231324,1635231388,64
1361213855,1635235456,3,168,56,1361213850998,1361213851190,1635231454,1635231646,192
1361213871,1635251396,22,5905,268.4090909,1361213862834,1361213865074,1635243230,1635245470,2240
1361213871,1635251472,13,3510,270,1361213862757,1361213864229,1635243229,1635244701,1472
1361213878,1635258896,1,46,46,1361213850172,1361213850172,1635231068,1635231068,0
1361213882,1635263048,1,487,487,1361213856679,1361213856679,1635237727,1635237727,0
1361213987,1635367480,5,575,115,1361213960668,1361213967644,1635341148,1635348124,6976
1361214031,1635411584,4,304,76,1361214004146,1361214004850,1635384730,1635385434,704
1361214091,1635471652,5,577,115.4,1361214065712,1361214087664,1635446364,1635468316,21952
1361214184,1635565352,1,48,48,1361214158064,1361214158064,1635539416,1635539416,0
1361214203,1635583868,3,240,80,1361214176405,1361214200789,1635557273,1635581657,24384
1361214272,1635652760,21,3609,171.8571429,1361214269185,1361214270913,1635649945,1635651673,1728
1361214272,1635652760,16,5235,327.1875,1361214269248,1361214271680,1635650008,1635652440,2432
1361214280,1635660756,15,6781,452.0666667,1361214277506,1361214278978,1635658262,1635659734,1472
1361214280,1635660788,17,5356,315.0588235,1361214275620,1361214277284,1635656408,1635658072,1664
1361214280,1635660788,31,10298,332.1935484,1361214271651,1361214274019,1635652439,1635654807,2368
1361214280,1635660832,21,3777,179.8571429,1361214274102,1361214275638,1635654934,1635656470,1536
1361214284,1635664516,1,52,52,1361214255794,1361214255794,1635636310,1635636310,0
1361214288,1635668728,18,4052,225.1111111,1361214284513,1361214286433,1635665241,1635667161,1920
1361214288,1635668764,24,3976,165.6666667,1361214277757,1361214279933,1635658521,1635660697,2176
1361214288,1635668816,20,3465,173.25,1361214281350,1361214284422,1635662166,1635665238,3072
1361214288,1635668856,22,3625,164.7727273,1361214278878,1361214280798,1635659734,1635661654,1920
1361214295,1635676336,10,4518,451.8,1361214267137,1361214268097,1635648473,1635649433,960
1361214296,1635676780,19,3545,186.5789474,1361214289643,1361214292907,1635670423,1635673687,3264
1361214296,1635676868,18,3836,213.1111111,1361214292946,1361214294994,1635673814,1635675862,2048
1361214296,1635676880,62,65484,1056.193548,1361214286279,1361214289543,1635667159,1635670423,3264
1361214359,1635740344,8,2741,342.625,1361214333046,1361214334070,1635714390,1635715414,1024
1361214476,1635856832,1,48,48,1361214449779,1361214449779,1635830611,1635830611,0
1361214508,1635888732,4,607,151.75,1361214481879,1361214482391,1635862611,1635863123,512
1361214536,1635917048,20,8619,430.95,1361214509531,1361214529947,1635890579,1635910995,20416
1361214536,1635917088,1,52,52,1361214508146,1361214508146,1635889234,1635889234,0
1361214544,1635925008,54,49172,910.5925926,1361214515906,1361214542466,1635896914,1635923474,26560
1361214560,1635941056,1,52,52,1361214534673,1361214534673,1635915729,1635915729,0
1361214600,1635981032,1,46,46,1361214574377,1361214574377,1635955409,1635955409,0
1361214665,1636045444,2,131,65.5,1361214662903,1361214662903,1636043347,1636043347,0
1361214681,1636061704,18,4867,270.3888889,1361214677683,1361214679027,1636058387,1636059731,1344
1361214684,1636065208,2,188,94,1361214658168,1361214658168,1636039376,1636039376,0
1361214724,1636105232,1,46,46,1361214697057,1361214697057,1636078289,1636078289,0
1361214784,1636165344,3,240,80,1361214758383,1361214766447,1636139727,1636147791,8064
1361214804,1636185296,1,56,56,1361214779616,1361214779616,1636160912,1636160912,0
1361214836,1636217244,1,52,52,1361214809041,1361214809041,1636190285,1636190285,0
1361214913,1636293440,1,224,224,1361214886583,1361214886583,1636267023,1636267023,0
1361215085,1636465964,2,339,169.5,1361215060135,1361215060135,1636441099,1636441099,0
1361215169,1636549984,1,52,52,1361215144144,1361215144144,1636525128,1636525128,0
1361215193,1636574200,16,3306,206.625,1361215187641,1361215187961,1636568841,1636569161,320
1361216026,1637406664,4,256,64,1361216020486,1361216021126,1637401150,1637401790,640
1361216060,1637440796,16,3911,244.4375,1361216034753,1361216037697,1637415549,1637418493,2944
1361216256,1637637172,1,485,485,1361216228230,1361216228230,1637609402,1637609402,0
1361216333,1637713492,1,52,52,1361216305773,1361216305773,1637686265,1637686265,0
1361216497,1637877996,18,4046,224.7777778,1361216471217,1361216475441,1637852213,1637856437,4224
1361216501,1637881976,1,52,52,1361216473539,1361216473539,1637854515,1637854515,0
1361216602,1637982956,3,168,56,1361216598998,1361216599510,1637979954,1637980466,512
1361216602,1637982980,3,168,56,1361216598976,1361216599488,1637979956,1637980468,512
1361216602,1637982984,3,168,56,1361216596858,1361216598202,1637977842,1637979186,1344
1361216602,1637982992,3,168,56,1361216601203,1361216601587,1637982195,1637982579,384
1361216602,1637983148,3,168,56,1361216596697,1361216598041,1637977845,1637979189,1344
1361216610,1637990948,3,168,56,1361216606048,1361216607264,1637986996,1637988212,1216
1361216610,1637990952,3,168,56,1361216602652,1361216603356,1637983604,1637984308,704
1361216610,1637991072,3,168,56,1361216603682,1361216604386,1637984754,1637985458,704
1361216610,1637991076,3,168,56,1361216607457,1361216608417,1637988533,1637989493,960
1361216610,1637991084,4,271,67.75,1361216604696,1361216605592,1637985780,1637986676,896
1361216622,1638002648,17,3970,233.5294118,1361216596492,1361216601484,1637977140,1637982132,4992
1361216626,1638006504,1,52,52,1361216599451,1361216599451,1637979955,1637979955,0
1361216626,1638006632,1,46,46,1361216600794,1361216600794,1637981426,1637981426,0
1361216626,1638006632,1,46,46,1361216600730,1361216600730,1637981362,1637981362,0
1361216626,1638006664,1,64,64,1361216601532,1361216601532,1637982196,1637982196,0
1361216626,1638006940,2,116,58,1361216625447,1361216625703,1638006387,1638006643,256
1361216630,1638010500,8,3220,402.5,1361216603552,1361216605024,1637984052,1637985524,1472
1361216650,1638031192,2,92,46,1361216644012,1361216647212,1638025204,1638028404,3200
1361216654,1638034572,1,52,52,1361216626390,1361216626390,1638006962,1638006962,0
1361216658,1638039320,3,168,56,1361216651308,1361216652908,1638032628,1638034228,1600
1361216674,1638054736,66,5910,89.54545455,1361216648881,1361216657713,1638029617,1638038449,8832
1361216674,1638054820,46,5536,120.3478261,1361216648928,1361216657632,1638029748,1638038452,8704
1361216678,1638058696,1,64,64,1361216653595,1361216653595,1638034291,1638034291,0
1361216714,1638094676,3,701,233.6666667,1361216687535,1361216709167,1638068211,1638089843,21632
1361216718,1638098704,11,5015,455.9090909,1361216690067,1361216691603,1638070771,1638072307,1536
1361216718,1638098736,1,46,46,1361216691443,1361216691443,1638072179,1638072179,0
1361216730,1638110748,1,64,64,1361216705446,1361216705446,1638086194,1638086194,0
1361216734,1638114676,8,2282,285.25,1361216706158,1361216709166,1638086834,1638089842,3008
1361216770,1638151212,4,220,55,1361216761747,1361216763283,1638142959,1638144495,1536
1361216778,1638159240,2,110,55,1361216762616,1361216774520,1638143856,1638155760,11904
1361216790,1638170984,17,4395,258.5294118,1361216765050,1361216778234,1638146034,1638159218,13184
1361216794,1638175032,1,52,52,1361216766346,1361216766346,1638147378,1638147378,0
1361216818,1638199328,2,131,65.5,1361216810785,1361216810785,1638192113,1638192113,0
1361216850,1638231120,3,539,179.6666667,1361216823598,1361216844398,1638204718,1638225518,20800
1361216903,1638283404,2,337,168.5,1361216875130,1361216879162,1638255534,1638259566,4032
1361216922,1638303120,1,46,46,1361216897326,1361216897326,1638278446,1638278446,0
1361216922,1638303120,1,46,46,1361216897390,1361216897390,1638278510,1638278510,0
1361216931,1638311400,34,39193,1152.735294,1361216925758,1361216928894,1638306158,1638309294,3136
1361216938,1638319116,5,940,188,1361216911988,1361216916980,1638293104,1638298096,4992
1361216946,1638327100,12,5564,463.6666667,1361216919808,1361216922624,1638300908,1638303724,2816
1361217011,1638391672,13,3168,243.6923077,1361217001645,1361217003245,1638382317,1638383917,1600
1361217022,1638403248,2,408,204,1361216997035,1361216997035,1638378283,1638378283,0
1361217026,1638407208,4,644,161,1361216998743,1361216998935,1638379951,1638380143,192
1361217026,1638407212,7,3438,491.1428571,1361216999187,1361217000339,1638380399,1638381551,1152
1361217070,1638451216,2,188,94,1361217042126,1361217042126,1638423342,1638423342,0
1361217102,1638483304,6,1300,216.6666667,1361217077236,1361217092276,1638458540,1638473580,15040
1361217118,1638499320,1,186,186,1361217091747,1361217091747,1638473067,1638473067,0
1361217155,1638535396,3,240,80,1361217129216,1361217142336,1638509612,1638522732,13120
1361217231,1638611564,1,52,52,1361217205204,1361217205204,1638585768,1638585768,0
1361217267,1638647772,1,52,52,1361217240838,1361217240838,1638621610,1638621610,0
1361217303,1638683880,1,234,234,1361217278233,1361217278233,1638659113,1638659113,0
1361217355,1638736208,9,3463,384.7777778,1361217329232,1361217329744,1638710440,1638710952,512
1361217359,1638739916,1,52,52,1361217332661,1361217332661,1638713577,1638713577,0
1361217359,1638739956,2,188,94,1361217334284,1361217334284,1638715240,1638715240,0
1361217404,1638784468,4,1439,359.75,1361217396211,1361217396339,1638776679,1638776807,128
1361217404,1638784468,5,1491,298.2,1361217396274,1361217396594,1638776742,1638777062,320
1361217404,1638784548,10,3036,303.6,1361217396065,1361217398049,1638776613,1638778597,1984
1361217404,1638784552,9,2924,324.8888889,1361217400415,1361217401375,1638780967,1638781927,960
1361217404,1638784560,10,3036,303.6,1361217397784,1361217399384,1638778344,1638779944,1600
1361217404,1638784560,4,1509,377.25,1361217401238,1361217401302,1638781798,1638781862,64
1361217404,1638784564,5,1404,280.8,1361217401489,1361217401617,1638782053,1638782181,128
1361217404,1638784580,9,2977,330.7777778,1361217398468,1361217399428,1638779048,1638780008,960
1361217404,1638784580,17,19863,1168.411765,1361217401667,1361217401795,1638782247,1638782375,128
1361217404,1638784584,31,34244,1104.645161,1361217401535,1361217403071,1638782119,1638783655,1536
1361217411,1638792356,2,112,56,1361217394877,1361217404925,1638776233,1638786281,10048
1361217411,1638792356,11,4565,415,1361217403260,1361217406588,1638784616,1638787944,3328
1361217412,1638792404,2,112,56,1361217395826,1361217405874,1638776230,1638786278,10048
1361217412,1638792404,3,164,54.66666667,1361217395826,1361217405874,1638776230,1638786278,10048
1361217419,1638800180,9,3994,443.7777778,1361217391532,1361217399980,1638772712,1638781160,8448
1361217419,1638800348,4,190,47.5,1361217406786,1361217417538,1638788134,1638798886,10752
1361217423,1638804124,12,14772,1231,1361217395108,1361217395108,1638776232,1638776232,0
1361217423,1638804124,8,3789,473.625,1361217395234,1361217395874,1638776358,1638776998,640
1361217427,1638808080,7,3509,501.2857143,1361217400014,1361217400718,1638781094,1638781798,704
1361217427,1638808112,5,274,54.8,1361217401133,1361217423405,1638782245,1638804517,22272
1361217427,1638808116,3,514,171.3333333,1361217401323,1361217401387,1638782439,1638782503,64
1361217427,1638808196,5,274,54.8,1361217401051,1361217423323,1638782247,1638804519,22272
1361217427,1638808200,5,274,54.8,1361217401047,1361217423319,1638782247,1638804519,22272
1361217428,1638808388,10,4394,439.4,1361217422594,1361217426562,1638802982,1638806950,3968
1361217428,1638808400,23,22457,976.3913043,1361217419957,1361217422453,1638800357,1638802853,2496
1361217428,1638808428,6,1028,171.3333333,1361217420187,1361217420955,1638800615,1638801383,768
1361217428,1638808472,10,2808,280.8,1361217418222,1361217419822,1638798694,1638800294,1600
1361217451,1638832136,1,46,46,1361217424853,1361217424853,1638805989,1638805989,0
1361217451,1638832140,8,4513,564.125,1361217425108,1361217426388,1638806248,1638807528,1280
1361217452,1638832500,3,210,70,1361217450258,1361217450514,1638830758,1638831014,256
1361217476,1638856464,1,52,52,1361217450934,1361217450934,1638831398,1638831398,0
1361217524,1638904632,6,447,74.5,1361217516236,1361217520140,1638896868,1638900772,3904
1361217540,1638920864,2,158,79,1361217524135,1361217532519,1638904999,1638913383,8384
1361217576,1638956600,1,79,79,1361217549614,1361217549614,1638930214,1638930214,0
1361217608,1638988632,1,79,79,1361217583178,1361217583178,1638963810,1638963810,0
1361217636,1639017160,2,104,52,1361217635132,1361217635324,1639016292,1639016484,192
1361217644,1639025024,3,156,52,1361217635909,1361217638661,1639016933,1639019685,2752
1361217644,1639025028,5,260,52,1361217640127,1361217643519,1639021155,1639024547,3392
1361217644,1639025168,4,208,52,1361217640627,1361217642227,1639021795,1639023395,1600
1361217644,1639025236,4,184,46,1361217641263,1361217642927,1639022499,1639024163,1664
1361217652,1639033044,2,92,46,1361217645039,1361217648879,1639026083,1639029923,3840
1361217652,1639033072,3,168,56,1361217649169,1361217649617,1639030241,1639030689,448
1361217660,1639040976,3,168,56,1361217658673,1361217659377,1639039649,1639040353,704
1361217660,1639041048,3,168,56,1361217657642,1361217658218,1639038690,1639039266,576
1361217660,1639041084,3,168,56,1361217650694,1361217652358,1639031778,1639033442,1664
1361217668,1639048976,3,168,56,1361217659697,1361217660465,1639040673,1639041441,768
1361217668,1639048984,3,168,56,1361217660780,1361217661164,1639041764,1639042148,384
1361217668,1639049020,3,168,56,1361217662469,1361217663749,1639043489,1639044769,1280
1361217668,1639049060,3,168,56,1361217663966,1361217664542,1639045026,1639045602,576
1361217668,1639049096,3,168,56,1361217661498,1361217662138,1639042594,1639043234,640
1361217672,1639052660,1,52,52,1361217644528,1361217644528,1639025188,1639025188,0
1361217676,1639056724,1,46,46,1361217650223,1361217650223,1639030947,1639030947,0
1361217680,1639060700,17,3004,176.7058824,1361217652678,1361217663174,1639033378,1639043874,10496
1361217684,1639064732,1,52,52,1361217658597,1361217658597,1639039329,1639039329,0
1361217688,1639068688,8,4307,538.375,1361217660690,1361217662290,1639041378,1639042978,1600
1361217692,1639072852,1,46,46,1361217666352,1361217666352,1639047204,1639047204,0
1361217692,1639072852,1,46,46,1361217666669,1361217666669,1639047521,1639047521,0
1361217885,1639265856,14,3214,229.5714286,1361217882473,1361217882921,1639263329,1639263777,448
1361217901,1639281804,13,3522,270.9230769,1361217898329,1361217898841,1639279133,1639279645,512
1361217901,1639281804,19,4798,252.5263158,1361217898459,1361217899035,1639279263,1639279839,576
1361217901,1639281804,13,3522,270.9230769,1361217898523,1361217899227,1639279327,1639280031,704
1361217909,1639289488,2,566,283,1361217882264,1361217882392,1639262752,1639262880,128
1361217913,1639293588,8,2150,268.75,1361217884917,1361217886965,1639265505,1639267553,2048
1361217925,1639305660,9,3463,384.7777778,1361217899497,1361217899945,1639280157,1639280605,448
1361217969,1639349604,1,52,52,1361217941026,1361217941026,1639321630,1639321630,0
1361218005,1639385924,3,168,56,1361218000992,1361218001184,1639381916,1639382108,192
1361218021,1639401992,2,131,65.5,1361218019487,1361218019487,1639400479,1639400479,0
1361218029,1639410112,18,5865,325.8333333,1361218003877,1361218010661,1639384989,1639391773,6784
1361218029,1639410244,3,168,56,1361218024995,1361218025571,1639406239,1639406815,576
1361218029,1639410248,4,271,67.75,1361218021918,1361218022878,1639403166,1639404126,960
1361218029,1639410268,4,271,67.75,1361218025867,1361218026507,1639407135,1639407775,640
1361218029,1639410272,3,168,56,1361218023108,1361218023684,1639404380,1639404956,576
1361218029,1639410276,4,271,67.75,1361218026753,1361218027393,1639408029,1639408669,640
1361218029,1639410304,3,168,56,1361218024037,1361218024613,1639405341,1639405917,576
1361218033,1639413644,1,52,52,1361218004858,1361218004858,1639385502,1639385502,0
1361218053,1639433672,1,64,64,1361218028380,1361218028380,1639409052,1639409052,0
1361218101,1639482012,3,168,56,1361218094471,1361218094535,1639475483,1639475547,64
1361218101,1639482016,3,168,56,1361218094594,1361218094658,1639475610,1639475674,64
1361218109,1639490104,9,1701,189,1361218105579,1361218107307,1639486683,1639488411,1728
1361218113,1639493672,2,907,453.5,1361218084826,1361218104922,1639465498,1639485594,20096
1361218121,1639501688,1,46,46,1361218094797,1361218094797,1639475485,1639475485,0
1361218149,1639529772,1,52,52,1361218122105,1361218122105,1639502877,1639502877,0
1361218165,1639546036,10,4433,443.3,1361218157168,1361218157680,1639538204,1639538716,512
1361218181,1639561728,2,188,94,1361218153316,1361218153316,1639534044,1639534044,0
1361218185,1639565724,10,5448,544.8,1361218157479,1361218162919,1639538203,1639543643,5440
1361218185,1639565836,25,6985,279.4,1361218157369,1361218179897,1639538205,1639560733,22528
1361218185,1639565844,17,13680,804.7058824,1361218158192,1361218159984,1639539036,1639540828,1792
1361218185,1639565876,26,17570,675.7692308,1361218158863,1361218160655,1639539739,1639541531,1792
1361218189,1639569760,7,3201,457.2857143,1361218164099,1361218167363,1639544859,1639548123,3264
1361218213,1639593728,18,2908,161.5555556,1361218185506,1361218207906,1639566234,1639588634,22400
1361218229,1639610124,4,277,69.25,1361218218965,1361218223957,1639600089,1639605081,4992
1361218229,1639610244,4,277,69.25,1361218219870,1361218224862,1639601114,1639606106,4992
1361218237,1639617876,3,992,330.6666667,1361218210831,1361218213199,1639591707,1639594075,2368
1361218237,1639618156,9,4387,487.4444444,1361218228728,1361218229752,1639609884,1639610908,1024
1361218241,1639621756,11,1556,141.4545455,1361218213061,1361218237829,1639593817,1639618585,24768
1361218245,1639625816,2,890,445,1361218220746,1361218243210,1639601562,1639624026,22464
1361218261,1639642092,10,4433,443.3,1361218253685,1361218254645,1639634777,1639635737,960
1361218261,1639642096,3,138,46,1361218253939,1361218253939,1639635035,1639635035,0
1361218269,1639649920,10,1975,197.5,1361218243105,1361218267681,1639624025,1639648601,24576
1361218281,1639661792,22,18374,835.1818182,1361218254305,1361218256097,1639635097,1639636889,1792
1361218281,1639661792,1,685,685,1361218254368,1361218254368,1639635160,1639635160,0
1361218281,1639661808,28,23015,821.9642857,1361218255251,1361218261651,1639636059,1639642459,6400
1361218281,1639661908,1,46,46,1361218254828,1361218254828,1639635736,1639635736,0
1361218293,1639674120,10,3303,330.3,1361218286808,1361218287128,1639667928,1639668248,320
1361218293,1639674120,9,4387,487.4444444,1361218289880,1361218290200,1639671000,1639671320,320
1361218297,1639677796,6,563,93.83333333,1361218269982,1361218287774,1639650778,1639668570,17792
1361218301,1639682188,8,1292,161.5,1361218292181,1361218294037,1639673369,1639675225,1856
1361218301,1639682224,10,6209,620.9,1361218293682,1361218299122,1639674906,1639680346,5440
1361218301,1639682224,6,759,126.5,1361218293617,1361218298865,1639674841,1639680089,5248
1361218317,1639697952,7,3509,501.2857143,1361218291968,1361218292288,1639672920,1639673240,320
1361218317,1639697956,1,46,46,1361218292284,1361218292284,1639673240,1639673240,0
1361218317,1639697964,1,116,116,1361218292213,1361218292213,1639673177,1639673177,0
1361218317,1639697964,1,116,116,1361218292276,1361218292276,1639673240,1639673240,0
1361218317,1639698164,33,11720,355.1515152,1361218292076,1361218308844,1639673240,1639690008,16768
1361218317,1639698168,1,116,116,1361218292009,1361218292009,1639673177,1639673177,0
1361218317,1639698172,1,116,116,1361218292071,1361218292071,1639673243,1639673243,0
1361218325,1639705988,7,1051,150.1428571,1361218297502,1361218317598,1639678490,1639698586,20096
1361218325,1639706224,3,179,59.66666667,1361218315376,1361218320496,1639696600,1639701720,5120
1361218333,1639714028,1,667,667,1361218307637,1361218307637,1639688665,1639688665,0
1361218333,1639714168,2,127,63.5,1361218320681,1361218325673,1639701849,1639706841,4992
1361218349,1639730084,1,329,329,1361218323900,1361218323900,1639704984,1639704984,0
1361218353,1639733964,7,539,77,1361218327542,1361218348982,1639708506,1639729946,21440
1361218398,1639778416,8,5880,735,1361218371544,1361218394072,1639751960,1639774488,22528
1361218398,1639778500,1,77,77,1361218371267,1361218371267,1639751767,1639751767,0
1361218414,1639794780,5,230,46,1361218407341,1361218410989,1639788121,1639791769,3648
1361218429,1639810328,3,2205,735,1361218403144,1361218423176,1639784472,1639804504,20032
1361218430,1639810652,2,92,46,1361218415020,1361218422828,1639795672,1639803480,7808
1361218441,1639822324,1,77,77,1361218414089,1361218414089,1639795413,1639795413,0
1361218446,1639826692,2,92,46,1361218432772,1361218442820,1639813464,1639823512,10048
1361218454,1639834688,9,3251,361.2222222,1361218452551,1361218452807,1639833239,1639833495,256
1361218462,1639842728,8,1280,160,1361218456797,1361218458141,1639837525,1639838869,1344
1361218462,1639842736,2,237,118.5,1361218457365,1361218457365,1639838101,1639838101,0
1361218462,1639842772,4,271,67.75,1361218461555,1361218461683,1639842327,1639842455,128
1361218462,1639842848,3,168,56,1361218461287,1361218461351,1639842135,1639842199,64
1361218462,1639842848,3,168,56,1361218461351,1361218461415,1639842199,1639842263,64
1361218470,1639850816,15,5129,341.9333333,1361218455429,1361218464005,1639836245,1639844821,8576
1361218470,1639850880,6,419,69.83333333,1361218465672,1361218469320,1639846552,1639850200,3648
1361218470,1639850880,6,759,126.5,1361218457861,1361218463045,1639838741,1639843925,5184
1361218470,1639850884,10,6221,622.1,1361218457925,1361218463237,1639838809,1639844121,5312
1361218478,1639858744,2,110,55,1361218461839,1361218471887,1639842583,1639852631,10048
1361218478,1639858780,3,168,56,1361218471980,1361218472108,1639852760,1639852888,128
1361218478,1639858840,3,168,56,1361218471791,1361218471855,1639852631,1639852695,64
1361218482,1639862476,1,116,116,1361218456857,1361218456857,1639837333,1639837333,0
1361218482,1639862492,1,116,116,1361218456842,1361218456842,1639837334,1639837334,0
1361218482,1639862492,28,9288,331.7142857,1361218456905,1361218473417,1639837397,1639853909,16512
1361218482,1639862492,1,46,46,1361218456905,1361218456905,1639837397,1639837397,0
1361218482,1639862548,20,5897,294.85,1361218455760,1361218462800,1639836308,1639843348,7040
1361218482,1639862592,6,3457,576.1666667,1361218456613,1361218456805,1639837205,1639837397,192
1361218486,1639866472,9,3463,384.7777778,1361218460317,1361218461021,1639840789,1639841493,704
1361218490,1639870416,1,46,46,1361218462102,1361218462102,1639842518,1639842518,0
1361218494,1639874420,18,2967,164.8333333,1361218466065,1361218493073,1639846485,1639873493,27008
1361218494,1639874428,23,18526,805.4782609,1361218466635,1361218471883,1639847063,1639852311,5248
1361218494,1639874724,3,168,56,1361218491299,1361218491363,1639872023,1639872087,64
1361218494,1639874808,3,168,56,1361218491342,1361218491470,1639872150,1639872278,128
1361218494,1639874820,2,110,55,1361218481092,1361218491140,1639861912,1639871960,10048
1361218498,1639878420,31,25426,820.1935484,1361218470737,1361218491601,1639851157,1639872021,20864
1361218510,1639890920,5,373,74.6,1361218503004,1361218503068,1639883924,1639883988,64
1361218514,1639894604,2,658,329,1361218488347,1361218503323,1639868951,1639883927,14976
1361218518,1639898828,5,373,74.6,1361218515066,1361218515194,1639895894,1639896022,128
1361218522,1639902660,9,1435,159.4444444,1361218495968,1361218516000,1639876628,1639896660,20032
1361218530,1639910664,1,77,77,1361218501920,1361218501920,1639882584,1639882584,0
1361218534,1639914808,2,1034,517,1361218508560,1361218525968,1639889368,1639906776,17408
1361218534,1639914940,3,486,162,1361218518027,1361218529291,1639898967,1639910231,11264
1361218542,1639922864,16,14753,922.0625,1361218515350,1361218525910,1639896214,1639906774,10560
1361218542,1639922868,32,24230,757.1875,1361218515666,1361218536722,1639896534,1639917590,21056
1361218550,1639930656,17,3115,183.2352941,1361218521894,1361218546022,1639902550,1639926678,24128
1361218550,1639930848,1,46,46,1361218524325,1361218524325,1639905173,1639905173,0
1361218550,1639930864,1,46,46,1361218524309,1361218524309,1639905173,1639905173,0
1361218558,1639938904,1,52,52,1361218532331,1361218532331,1639913235,1639913235,0
1361218582,1639962900,13,1564,120.3076923,1361218555759,1361218575919,1639936659,1639956819,20160
1361218582,1639963112,3,210,70,1361218580189,1361218580445,1639961301,1639961557,256
1361218598,1639979012,3,202,67.33333333,1361218585665,1361218590657,1639966677,1639971669,4992
1361218598,1639979172,5,373,74.6,1361218596448,1361218596768,1639977620,1639977940,320
1361218606,1639987016,3,138,46,1361218601598,1361218601598,1639982614,1639982614,0
1361218606,1639987056,5,373,74.6,1361218601172,1361218601364,1639982228,1639982420,192
1361218606,1639987056,6,340,56.66666667,1361218596051,1361218605267,1639977107,1639986323,9216
1361218614,1639994828,15,2368,157.8666667,1361218585848,1361218612984,1639966676,1639993812,27136
1361218622,1640003044,4,1002,250.5,1361218596704,1361218605088,1639977748,1639986132,8384
1361218622,1640003144,9,3251,361.2222222,1361218616955,1361218617211,1639998099,1639998355,256
1361218626,1640006828,26,21368,821.8461538,1361218601783,1361218615159,1639982611,1639995987,13376
1361218626,1640006868,1,46,46,1361218599311,1361218599311,1639980179,1639980179,0
1361218630,1640010908,34,29028,853.7647059,1361218605416,1361218615464,1639986324,1639996372,10048
1361218638,1640018968,1,46,46,1361218613294,1361218613294,1639994262,1639994262,0
1361218642,1640022964,17,3122,183.6470588,1361218615729,1361218635761,1639996693,1640016725,20032
1361218658,1640039024,3,976,325.3333333,1361218633525,1361218633525,1640014549,1640014549,0
1361218670,1640050960,17,2398,141.0588235,1361218645685,1361218669621,1640026645,1640050581,23936
1361218686,1640067236,18,14865,825.8333333,1361218659808,1361218677024,1640041044,1640058260,17216
1361218695,1640075404,39,23353,598.7948718,1361218667295,1361218678943,1640047699,1640059347,11648
1361218695,1640075552,11,3367,306.0909091,1361218693901,1361218694157,1640074453,1640074709,256
1361218702,1640083116,10,1058,105.8,1361218674136,1361218695576,1640055252,1640076692,21440
1361218722,1640103164,1,52,52,1361218696230,1361218696230,1640077394,1640077394,0
1361218730,1640111220,13,2422,186.3076923,1361218705453,1361218728877,1640086673,1640110097,23424
1361218730,1640111304,2,944,472,1361218705434,1361218715354,1640086738,1640096658,9920
1361218734,1640115336,12,9939,828.25,1361218707836,1361218714876,1640089172,1640096212,7040
1361218754,1640135300,27,9841,364.4814815,1361218727646,1361218748638,1640108946,1640129938,20992
1361218759,1640139568,23,3634,158,1361218757691,1361218758075,1640138259,1640138643,384
1361218759,1640139568,20,3490,174.5,1361218757946,1361218758458,1640138514,1640139026,512
1361218762,1640143312,10,1100,110,1361218735377,1361218755409,1640116689,1640136721,20032
1361218767,1640147436,24,10994,458.0833333,1361218758655,1361218759871,1640139091,1640140307,1216
1361218767,1640147448,16,3935,245.9375,1361218763825,1361218764401,1640144273,1640144849,576
1361218767,1640147472,65,69948,1076.123077,1361218764376,1361218766168,1640144848,1640146640,1792
1361218767,1640147476,14,6710,479.2857143,1361218761493,1361218762005,1640141969,1640142481,512
1361218767,1640147484,26,3849,148.0384615,1361218766156,1361218766732,1640146640,1640147216,576
1361218767,1640147520,16,3244,202.75,1361218763051,1361218763755,1640143571,1640144275,704
1361218767,1640147528,17,3582,210.7058824,1361218760100,1361218760612,1640140628,1640141140,512
1361218767,1640147528,17,5356,315.0588235,1361218760610,1361218761250,1640141138,1640141778,640
1361218767,1640147556,15,3293,219.5333333,1361218761989,1361218762309,1640142545,1640142865,320
1361218767,1640147560,25,3974,158.96,1361218761923,1361218762371,1640142483,1640142931,448
1361218775,1640155576,21,3431,163.3809524,1361218766705,1361218767089,1640147281,1640147665,384
1361218782,1640163224,9,4004,444.8888889,1361218756393,1361218757033,1640137617,1640138257,640
1361218783,1640163464,5,283,56.6,1361218775651,1361218781795,1640156115,1640162259,6144
1361218790,1640171332,9,643,71.44444444,1361218765375,1361218788287,1640146707,1640169619,22912
1361218791,1640171432,2,104,52,1361218783106,1361218785730,1640163538,1640166162,2624
1361218807,1640187612,2,104,52,1361218790860,1361218801356,1640171472,1640181968,10496
1361218815,1640195604,3,168,56,1361218807702,1361218807766,1640188306,1640188370,64
1361218818,1640199316,2,154,77,1361218791436,1361218797708,1640172752,1640179024,6272
1361218823,1640203552,2,110,55,1361218807818,1361218819658,1640188370,1640200210,11840
1361218823,1640203584,3,168,56,1361218817898,1361218818026,1640198482,1640198610,128
1361218826,1640207232,33,8787,266.2727273,1361218801121,1361218821601,1640182353,1640202833,20480
1361218826,1640207344,15,4291,286.0666667,1361218801394,1361218807410,1640182738,1640188754,6016
1361218830,1640211212,1,52,52,1361218801845,1361218801845,1640183057,1640183057,0
1361218831,1640211376,42,25461,606.2142857,1361218805560,1361218810680,1640185936,1640191056,5120
1361218831,1640211688,6,419,69.83333333,1361218830017,1361218830337,1640210705,1640211025,320
1361218834,1640215360,1,75,75,1361218808607,1361218808607,1640189967,1640189967,0
1361218838,1640219216,9,3463,384.7777778,1361218811569,1361218812145,1640192785,1640193361,576
1361218838,1640219268,15,13098,873.2,1361218810110,1361218814462,1640191378,1640195730,4352
1361218839,1640219544,223,293155,1314.596413,1361218734800,1361218831568,1640115344,1640212112,96768
1361218847,1640227564,18,3719,206.6111111,1361218840573,1361218840957,1640221137,1640221521,384
1361218855,1640235544,7,465,66.42857143,1361218847120,1361218850704,1640227664,1640231248,3584
1361218859,1640239384,11,1686,153.2727273,1361218831666,1361218852466,1640212050,1640232850,20800
1361218859,1640239384,1,685,685,1361218831729,1361218831729,1640212113,1640212113,0
1361218874,1640255296,1,46,46,1361218846367,1361218846367,1640227663,1640227663,0
1361218874,1640255304,17,14754,867.8823529,1361218846745,1361218849497,1640228049,1640230801,2752
1361218875,1640255416,28,21484,767.2857143,1361218848017,1361218853073,1640228433,1640233489,5056
1361218887,1640267396,6,384,64,1361218862181,1361218882597,1640242577,1640262993,20416
1361218887,1640267624,5,373,74.6,1361218883392,1361218883776,1640264016,1640264400,384
1361218907,1640287420,3,1370,456.6666667,1361218882315,1361218892747,1640262735,1640273167,10432
1361218919,1640299424,7,1040,148.5714286,1361218892168,1361218912584,1640272592,1640293008,20416
1361218919,1640299812,2,127,63.5,1361218911877,1361218916933,1640292689,1640297745,5056
1361218919,1640299876,2,127,63.5,1361218909827,1361218914819,1640290703,1640295695,4992
1361218935,1640315820,2,131,65.5,1361218932346,1361218932346,1640313166,1640313166,0
1361218947,1640327464,8,1813,226.625,1361218922145,1361218942561,1640302609,1640323025,20416
1361218959,1640339524,3,2217,739,1361218932129,1361218936737,1640312653,1640317261,4608
1361218979,1640359408,6,387,64.5,1361218952215,1361218972503,1640332623,1640352911,20288
1361218999,1640380240,2,104,52,1361218997016,1361218997272,1640378256,1640378512,256
1361218999,1640380240,7,462,66,1361218981399,1361218991767,1640362639,1640373007,10368
1361219079,1640459556,1,691,691,1361219051842,1361219051842,1640432398,1640432398,0
1361219111,1640491756,1,46,46,1361219085754,1361219085754,1640466510,1640466510,0
1361219143,1640523936,7,2270,324.2857143,1361219117763,1361219138947,1640498699,1640519883,21184
1361219167,1640548132,3,168,56,1361219163584,1361219163712,1640544716,1640544844,128
1361219167,1640548160,3,168,56,1361219164066,1361219164130,1640545226,1640545290,64
1361219167,1640548216,3,168,56,1361219163629,1361219163757,1640544845,1640544973,128
1361219167,1640548240,3,168,56,1361219163730,1361219165202,1640544970,1640546442,1472
1361219167,1640548240,3,168,56,1361219163859,1361219163987,1640545099,1640545227,128
1361219167,1640548252,3,168,56,1361219164361,1361219164489,1640545613,1640545741,128
1361219171,1640551868,3,861,287,1361219145161,1361219165129,1640526029,1640545997,19968
1361219175,1640556168,2,110,55,1361219164570,1361219174618,1640545738,1640555786,10048
1361219175,1640556176,5,373,74.6,1361219173524,1361219173588,1640554700,1640554764,64
1361219175,1640556204,3,168,56,1361219174584,1361219174712,1640555788,1640555916,128
1361219183,1640564120,3,168,56,1361219174796,1361219174988,1640555916,1640556108,192
1361219191,1640572024,17,5233,307.8235294,1361219163242,1361219183658,1640544266,1640564682,20416
1361219195,1640576068,15,4291,286.0666667,1361219166975,1361219172927,1640548043,1640553995,5952
1361219207,1640588084,5,250,50,1361219182384,1361219203824,1640563468,1640584908,21440
1361219219,1640600172,9,600,66.66666667,1361219193432,1361219213848,1640574604,1640595020,20416
1361219232,1640612416,9,3251,361.2222222,1361219225610,1361219226890,1640606026,1640607306,1280
1361219251,1640632076,6,384,64,1361219223543,1361219243895,1640604619,1640624971,20352
1361219251,1640632192,2,116,58,1361219223811,1361219224003,1640605003,1640605195,192
1361219255,1640636152,1,48,48,1361219228011,1361219228011,1640609163,1640609163,0
1361219279,1640660176,9,1377,153,1361219253457,1361219275921,1640634633,1640657097,22464
1361219279,1640660344,6,419,69.83333333,1361219275817,1361219277929,1640657161,1640659273,2112
1361219283,1640664180,1,48,48,1361219257037,1361219257037,1640638217,1640638217,0
1361219291,1640672236,3,881,293.6666667,1361219262934,1361219273430,1640644170,1640654666,10496
1361219303,1640684248,1,46,46,1361219278024,1361219278024,1640659272,1640659272,0
1361219304,1640684376,23,18433,801.4347826,1361219277168,1361219278896,1640657544,1640659272,1728
1361219304,1640684384,35,28316,809.0285714,1361219277867,1361219279787,1640658251,1640660171,1920
1361219311,1640692244,8,692,86.5,1361219283404,1361219303820,1640664648,1640685064,20416
1361219320,1640700456,5,373,74.6,1361219317152,1361219317920,1640697608,1640698376,768
1361219339,1640720304,6,387,64.5,1361219313361,1361219333585,1640694665,1640714889,20224
1361219344,1640724536,1,52,52,1361219317585,1361219317585,1640698121,1640698121,0
1361219344,1640724772,3,202,67.33333333,1361219338087,1361219343143,1640718859,1640723915,5056
1361219352,1640732704,3,202,67.33333333,1361219339239,1361219344231,1640719943,1640724935,4992
1361219360,1640740780,3,138,46,1361219359579,1361219359579,1640740359,1640740359,0
1361219360,1640740864,5,373,74.6,1361219359049,1361219359113,1640739913,1640739977,64
1361219368,1640748892,3,138,46,1361219363373,1361219363373,1640744265,1640744265,0
1361219372,1640752444,5,2643,528.6,1361219346094,1361219357614,1640726538,1640738058,11520
1361219372,1640752480,10,2222,222.2,1361219344200,1361219364296,1640724680,1640744776,20096
1361219388,1640768488,23,18340,797.3913043,1361219362946,1361219365442,1640743434,1640745930,2496
1361219392,1640772388,32,26795,837.34375,1361219363875,1361219365923,1640744263,1640746311,2048
1361219392,1640772432,1,46,46,1361219365434,1361219365434,1640745866,1640745866,0
1361219392,1640772516,1,46,46,1361219365349,1361219365349,1640745865,1640745865,0
1361219400,1640780528,8,692,86.5,1361219374170,1361219394394,1640754698,1640774922,20224
1361219408,1640788824,5,373,74.6,1361219406639,1361219407023,1640787463,1640787847,384
1361219432,1640812448,6,387,64.5,1361219404263,1361219424679,1640784711,1640805127,20416
1361219432,1640812528,2,276,138,1361219407319,1361219410263,1640787847,1640790791,2944
1361219432,1640812852,3,202,67.33333333,1361219424277,1361219429269,1640805129,1640810121,4992
1361219432,1640812856,2,127,63.5,1361219425038,1361219430030,1640805894,1640810886,4992
1361219460,1640840596,6,387,64.5,1361219434133,1361219454549,1640814729,1640835145,20416
1361219492,1640872580,6,387,64.5,1361219464101,1361219484453,1640844681,1640865033,20352
1361219520,1640900624,6,462,77,1361219494072,1361219511864,1640874696,1640892488,17792
1361219552,1640933040,2,104,52,1361219551062,1361219551510,1640932102,1640932550,448
1361219556,1640936588,1,77,77,1361219530265,1361219530265,1640910853,1640910853,0
1361219560,1640940884,3,156,52,1361219552690,1361219558834,1640933574,1640939718,6144
1361219584,1640964976,2,104,52,1361219566871,1361219576855,1640947847,1640957831,9984
1361219592,1640972792,1,77,77,1361219566797,1361219566797,1640947589,1640947589,0
1361219600,1640981040,2,104,52,1361219586772,1361219596756,1640967812,1640977796,9984
1361219632,1641012672,1,52,52,1361219607171,1361219607171,1640987843,1640987843,0
1361219668,1641048596,1,77,77,1361219640337,1361219640337,1641020933,1641020933,0
1361219700,1641080848,2,122,61,1361219674133,1361219676629,1641054981,1641057477,2496
1361219788,1641168908,1,77,77,1361219760086,1361219760086,1641140994,1641140994,0
1361219881,1641261488,6,1563,260.5,1361219878776,1361219880248,1641259264,1641260736,1472
1361219889,1641269524,3,168,56,1361219880982,1361219881174,1641261506,1641261698,192
1361219889,1641269524,3,168,56,1361219881299,1361219881427,1641261823,1641261951,128
1361219889,1641269528,3,168,56,1361219881426,1361219881618,1641261954,1641262146,192
1361219889,1641269600,3,168,56,1361219881097,1361219881289,1641261697,1641261889,192
1361219889,1641269652,3,168,56,1361219879955,1361219880723,1641260607,1641261375,768
1361219897,1641277556,7,1609,229.8571429,1361219887350,1361219889590,1641267906,1641270146,2240
1361219905,1641285468,13,7479,575.3076923,1361219901259,1361219904715,1641281727,1641285183,3456
1361219908,1641289232,1,77,77,1361219880082,1361219880082,1641261314,1641261314,0
1361219908,1641289236,1,46,46,1361219880398,1361219880398,1641261634,1641261634,0
1361219908,1641289328,1,46,46,1361219880240,1361219880240,1641261568,1641261568,0
1361219909,1641289396,24,6784,282.6666667,1361219883604,1361219894484,1641264000,1641274880,10880
1361219924,1641305256,28,7974,284.7857143,1361219896823,1361219917303,1641278079,1641298559,20480
1361219924,1641305260,39,28583,732.8974359,1361219896818,1361219910706,1641278078,1641291966,13888
1361219924,1641305372,19,14990,788.9473684,1361219896706,1361219898562,1641278078,1641279934,1856
1361219936,1641317300,1,46,46,1361219909901,1361219909901,1641291201,1641291201,0
1361219952,1641333348,7,460,65.71428571,1361219927133,1361219947613,1641308481,1641328961,20480
1361219953,1641333656,9,4387,487.4444444,1361219948688,1361219949648,1641329344,1641330304,960
1361219969,1641349696,2,127,63.5,1361219959016,1361219964008,1641339712,1641344704,4992
1361219977,1641357656,2,127,63.5,1361219971088,1361219976080,1641351744,1641356736,4992
1361219985,1641365484,6,384,64,1361219958010,1361219978042,1641338494,1641358526,20032
1361219985,1641365656,3,391,130.3333333,1361219958224,1361219981584,1641338880,1641362240,23360
1361220013,1641393772,6,386,64.33333333,1361219987673,1361220008217,1641368445,1641388989,20544
1361220033,1641413936,9,3251,361.2222222,1361220028214,1361220029430,1641409150,1641410366,1216
1361220045,1641425752,6,387,64.5,1361220017711,1361220038191,1641398463,1641418943,20480
1361220049,1641430080,5,333,66.6,1361220047398,1361220047654,1641428478,1641428734,256
1361220057,1641437800,1,52,52,1361220031614,1361220031614,1641412414,1641412414,0
1361220089,1641470032,10,4433,443.3,1361220085591,1361220086167,1641466623,1641467199,576
1361220089,1641470032,3,138,46,1361220085972,1361220085972,1641467004,1641467004,0
1361220089,1641470144,3,138,46,1361220086756,1361220086756,1641467900,1641467900,0
1361220101,1641481868,3,881,293.6666667,1361220074170,1361220082298,1641455038,1641463166,8128
1361220113,1641493860,16,5357,334.8125,1361220086019,1361220106307,1641466879,1641487167,20288
1361220113,1641493872,31,25378,818.6451613,1361220087031,1361220089143,1641467903,1641470015,2112
1361220113,1641494056,1,46,46,1361220086079,1361220086079,1641467135,1641467135,0
1361220113,1641494056,25,21405,856.2,1361220086206,1361220088446,1641467262,1641469502,2240
1361220121,1641501808,9,3463,384.7777778,1361220092981,1361220094517,1641473789,1641475325,1536
1361220141,1641521948,1,60,60,1361220115431,1361220115431,1641496379,1641496379,0
1361220141,1641521980,12,1456,121.3333333,1361220116103,1361220137863,1641497083,1641518843,21760
1361220153,1641534348,2,127,63.5,1361220147289,1361220152281,1641528637,1641533629,4992
1361220154,1641534400,9,3251,361.2222222,1361220146891,1361220148491,1641527291,1641528891,1600
1361220162,1641542388,2,127,63.5,1361220149336,1361220154328,1641529724,1641534716,4992
1361220169,1641550248,19,3597,189.3157895,1361220141564,1361220165948,1641522812,1641547196,24384
1361220170,1641550388,3,138,46,1361220163478,1361220163478,1641543866,1641543866,0
1361220189,1641570288,9,4663,518.1111111,1361220162578,1361220162834,1641543866,1641544122,256
1361220202,1641582376,10,832,83.2,1361220176677,1361220197157,1641557053,1641577533,20480
1361220218,1641598624,5,368,73.6,1361220214506,1361220216362,1641595130,1641596986,1856
1361220226,1641606700,2,158,79,1361220218398,1361220222622,1641599098,1641603322,4224
1361220234,1641614484,7,514,73.42857143,1361220206584,1361220225016,1641587068,1641605500,18432
1361220234,1641614616,5,352,70.4,1361220223090,1361220228082,1641603706,1641608698,4992
1361220250,1641630716,2,158,79,1361220231055,1361220247951,1641611771,1641628667,16896
1361220261,1641642324,2,150,75,1361220233071,1361220244463,1641614395,1641625787,11392
1361220262,1641642440,2,154,77,1361220234018,1361220252002,1641614458,1641632442,17984
1361220294,1641674508,1,75,75,1361220268126,1361220268126,1641648634,1641648634,0
1361220310,1641690492,1,79,79,1361220281967,1361220281967,1641662459,1641662459,0
1361220314,1641694824,3,558,186,1361220287202,1361220289122,1641668026,1641669946,1920
1361220314,1641694832,1,77,77,1361220287580,1361220287580,1641668412,1641668412,0
1361220314,1641694996,9,3251,361.2222222,1361220305654,1361220306934,1641686650,1641687930,1280
1361220322,1641702576,18,4138,229.8888889,1361220294104,1361220297496,1641674680,1641678072,3392
1361220322,1641702760,19,5184,272.8421053,1361220293923,1361220315363,1641674683,1641696123,21440
1361220326,1641706596,13,5075,390.3846154,1361220299204,1361220301572,1641679800,1641682168,2368
1361220386,1641766924,1,77,77,1361220359419,1361220359419,1641740343,1641740343,0
1361220566,1641947308,1,52,52,1361220540856,1361220540856,1641922164,1641922164,0
1361220571,1641951460,17,3352,197.1764706,1361220562700,1361220563212,1641943160,1641943672,512
1361220582,1641963296,1,46,46,1361220557255,1361220557255,1641938551,1641938551,0
1361220586,1641967204,7,3438,491.1428571,1361220561442,1361220561762,1641942646,1641942966,320
1361220590,1641971300,1,462,462,1361220565249,1361220565249,1641946549,1641946549,0
1361220627,1642007840,3,168,56,1361220624077,1361220624653,1642004917,1642005493,576
1361220655,1642035520,11,4172,379.2727273,1361220628236,1361220632076,1642008756,1642012596,3840
1361220655,1642035536,1,52,52,1361220629563,1361220629563,1642010099,1642010099,0
1361220655,1642035580,16,4054,253.375,1361220627343,1361220631247,1642007923,1642011827,3904
1361220755,1642135984,3,168,56,1361220750906,1361220751354,1642131890,1642132338,448
1361220755,1642136068,3,168,56,1361220751399,1361220751463,1642132467,1642132531,64
1361220755,1642136068,3,168,56,1361220751526,1361220751654,1642132594,1642132722,128
1361220763,1642143960,3,168,56,1361220761876,1361220761940,1642142836,1642142900,64
1361220763,1642143996,2,110,55,1361220751792,1361220761840,1642132788,1642142836,10048
1361220763,1642144036,3,168,56,1361220761926,1361220762054,1642142962,1642143090,128
1361220779,1642159628,7,2689,384.1428571,1361220751840,1361220752608,1642132468,1642133236,768
1361220779,1642159628,1,46,46,1361220752094,1361220752094,1642132722,1642132722,0
1361220787,1642168048,1,462,462,1361220759290,1361220759290,1642140338,1642140338,0
1361220803,1642184296,2,104,52,1361220801665,1361220801857,1642182961,1642183153,192
1361220839,1642220084,4,891,222.75,1361220812950,1361220838038,1642194034,1642219122,25088
1361220843,1642224352,7,1609,229.8571429,1361220839051,1361220840267,1642220403,1642221619,1216
1361220851,1642232060,9,3463,384.7777778,1361220826542,1361220827118,1642207602,1642208178,576
1361220851,1642232292,10,4433,443.3,1361220848838,1361220849286,1642230130,1642230578,448
1361220875,1642256028,40,31001,775.025,1361220849102,1361220855950,1642230130,1642236978,6848
1361220875,1642256032,26,20093,772.8076923,1361220849672,1361220851720,1642230704,1642232752,2048
1361220875,1642256120,21,5640,268.5714286,1361220848947,1361220869555,1642230067,1642250675,20608
1361220884,1642264392,9,4387,487.4444444,1361220880906,1361220881866,1642261298,1642262258,960
1361220899,1642280052,1,52,52,1361220871543,1361220871543,1642252595,1642252595,0
1361220907,1642288124,6,384,64,1361220879277,1361220899373,1642260401,1642280497,20096
1361220923,1642304208,1,52,52,1361220895257,1361220895257,1642276465,1642276465,0
1361220924,1642304420,3,202,67.33333333,1361220916271,1361220921263,1642296691,1642301683,4992
1361220924,1642304540,3,179,59.66666667,1361220911157,1361220916469,1642291697,1642297009,5312
1361220935,1642316112,9,636,70.66666667,1361220909306,1361220932218,1642290418,1642313330,22912
1361220948,1642328732,3,210,70,1361220947251,1361220947507,1642327983,1642328239,256
1361220956,1642336712,4,316,79,1361220948103,1361220955655,1642328815,1642336367,7552
1361220964,1642344464,3,228,76,1361220936254,1361220956478,1642316718,1642336942,20224
1361220980,1642360816,3,168,56,1361220978080,1361220979424,1642358896,1642360240,1344
1361220980,1642360816,3,168,56,1361220975326,1361220976350,1642356142,1642357166,1024
1361220988,1642368660,3,168,56,1361220980923,1361220981563,1642361583,1642362223,640
1361220988,1642368672,15,1885,125.6666667,1361220977521,1361220986993,1642358193,1642367665,9472
1361220988,1642368704,2,116,58,1361220987282,1361220987794,1642367986,1642368498,512
1361220988,1642368708,3,168,56,1361220980046,1361220980430,1642360754,1642361138,384
1361220988,1642368728,2,158,79,1361220964279,1361220981623,1642345007,1642362351,17344
1361220988,1642368740,3,180,60,1361220981870,1361220985518,1642362610,1642366258,3648
1361220996,1642376772,3,138,46,1361220992525,1361220993229,1642373297,1642374001,704
1361221004,1642384444,1,46,46,1361220977493,1361220977493,1642357937,1642357937,0
1361221004,1642384448,19,5258,276.7368421,1361220977807,1361220983375,1642358255,1642363823,5568
1361221004,1642384684,3,168,56,1361220996197,1361220996837,1642376881,1642377521,640
1361221004,1642384692,3,168,56,1361220997085,1361220997725,1642377777,1642378417,640
1361221004,1642384772,3,168,56,1361220997962,1361220998666,1642378734,1642379438,704
1361221008,1642388520,1,52,52,1361220980550,1361220980550,1642361070,1642361070,0
1361221008,1642388596,1,76,76,1361220983291,1361220983291,1642363887,1642363887,0
1361221016,1642396516,1,52,52,1361220988298,1361220988298,1642368814,1642368814,0
1361221020,1642400580,1,52,52,1361220993610,1361220993610,1642374190,1642374190,0
1361221244,1642624972,1,222,222,1361221219840,1361221219840,1642600812,1642600812,0
1361221332,1642713292,3,168,56,1361221329983,1361221330751,1642711275,1642712043,768
1361221332,1642713332,3,168,56,1361221328792,1361221329560,1642710124,1642710892,768
1361221340,1642721264,3,168,56,1361221336218,1361221336794,1642717482,1642718058,576
1361221340,1642721276,3,168,56,1361221337104,1361221337808,1642718380,1642719084,704
1361221340,1642721276,3,168,56,1361221333454,1361221334030,1642714730,1642715306,576
1361221340,1642721312,3,168,56,1361221338154,1361221338730,1642719466,1642720042,576
1361221340,1642721312,3,168,56,1361221335273,1361221335849,1642716585,1642717161,576
1361221341,1642721460,3,168,56,1361221335165,1361221335741,1642715625,1642716201,576
1361221341,1642721472,3,168,56,1361221331891,1361221333939,1642712363,1642714411,2048
1361221353,1642733572,18,4014,223,1361221327950,1361221331918,1642708522,1642712490,3968
1361221357,1642737732,1,52,52,1361221329454,1361221329454,1642710186,1642710186,0
1361221468,1642849336,10,6216,621.6,1361221462354,1361221462738,1642843690,1642844074,384
1361221468,1642849360,13,6834,525.6923077,1361221462840,1361221463992,1642844200,1642845352,1152
1361221469,1642849408,11,6785,616.8181818,1361221461106,1361221462002,1642841514,1642842410,896
1361221469,1642849412,15,7022,468.1333333,1361221462190,1361221463598,1642842602,1642844010,1408
1361221469,1642849420,17,3857,226.8823529,1361221463524,1361221465380,1642843944,1642845800,1856
1361221469,1642849448,13,6667,512.8461538,1361221464583,1361221465671,1642845031,1642846119,1088
1361221485,1642865748,7,3438,491.1428571,1361221460764,1361221462300,1642841512,1642843048,1536
1361221657,1643038120,1,460,460,1361221632102,1361221632102,1643013222,1643013222,0
1361221701,1643081644,3,168,56,1361221693183,1361221693887,1643073827,1643074531,704
1361221701,1643081676,3,168,56,1361221694178,1361221695074,1643074854,1643075750,896
1361221717,1643098076,1,52,52,1361221692688,1361221692688,1643073764,1643073764,0
1361221717,1643098148,16,3910,244.375,1361221691015,1361221694087,1643072163,1643075235,3072
1361221729,1643110156,1,52,52,1361221701887,1361221701887,1643083043,1643083043,0
1361221805,1643185572,13,3522,270.9230769,1361221802184,1361221803848,1643182756,1643184420,1664
1361221805,1643185652,19,4797,252.4736842,1361221802105,1361221803705,1643182757,1643184357,1600
1361221805,1643185652,13,3510,270,1361221802105,1361221803705,1643182757,1643184357,1600
1361221829,1643210300,9,3463,384.7777778,1361221803248,1361221804400,1643184548,1643185700,1152
1361221925,1643305788,2,131,65.5,1361221924718,1361221924718,1643305506,1643305506,0
1361222315,1643696200,1,46,46,1361222286157,1361222286157,1643667357,1643667357,0
1361222366,1643747204,18,4022,223.4444444,1361222340872,1361222343752,1643722076,1643724956,2880
1361222370,1643751216,1,52,52,1361222342329,1361222342329,1643723545,1643723545,0
1361222389,1643770112,4,271,67.75,1361222383011,1361222383907,1643764123,1643765019,896
1361222389,1643770112,3,168,56,1361222381729,1361222382369,1643762841,1643763481,640
1361222389,1643770140,3,168,56,1361222384197,1361222384837,1643765337,1643765977,640
1361222389,1643770180,3,168,56,1361222386335,1361222387039,1643767515,1643768219,704
1361222389,1643770224,3,168,56,1361222387251,1361222388083,1643768475,1643769307,832
1361222397,1643778300,3,168,56,1361222388645,1361222389541,1643769945,1643770841,896
1361222405,1643786184,2,116,58,1361222404442,1361222404762,1643785626,1643785946,320
1361222405,1643786228,3,168,56,1361222403500,1361222404140,1643784728,1643785368,640
1361222411,1643791432,1,46,46,1361222386442,1361222386442,1643766874,1643766874,0
1361222413,1643794212,3,168,56,1361222405375,1361222406015,1643786587,1643787227,640
1361222430,1643811264,1,52,52,1361222405002,1361222405002,1643786266,1643786266,0
1361222450,1643831288,1,48,48,1361222422385,1361222422385,1643803673,1643803673,0
1361222455,1643835388,1,222,222,1361222426868,1361222426868,1643807256,1643807256,0
1361222523,1643903376,1,60,60,1361222496447,1361222496447,1643876823,1643876823,0
1361222750,1644130392,3,168,56,1361222747500,1361222748140,1644127892,1644128532,640
1361222750,1644130476,3,168,56,1361222743704,1361222744408,1644124180,1644124884,704
1361222750,1644130508,3,168,56,1361222744632,1361222745144,1644125140,1644125652,512
1361222750,1644130512,4,220,55,1361222748469,1361222749173,1644128981,1644129685,704
1361222750,1644130516,3,168,56,1361222745776,1361222746416,1644126292,1644126932,640
1361222750,1644130548,3,168,56,1361222746450,1361222747090,1644126998,1644127638,640
1361222767,1644147716,1,46,46,1361222742312,1361222742312,1644123028,1644123028,0
1361222771,1644151644,16,3910,244.375,1361222745969,1361222749553,1644126613,1644130197,3584
1361222774,1644154384,3,168,56,1361222767670,1361222768246,1644148054,1644148630,576
1361222774,1644154416,3,168,56,1361222768598,1361222769238,1644149014,1644149654,640
1361222774,1644154420,3,168,56,1361222769551,1361222770127,1644149971,1644150547,576
1361222775,1644155596,1,52,52,1361222747359,1361222747359,1644127955,1644127955,0
1361223182,1644562720,2,116,58,1361223181148,1361223181532,1644561868,1644562252,384
1361223206,1644586672,15,3759,250.6,1361223199819,1361223202123,1644580491,1644582795,2304
1361223206,1644586720,3,168,56,1361223205022,1361223205406,1644585742,1644586126,384
1361223206,1644586724,12,3359,279.9166667,1361223202647,1361223204631,1644583371,1644585355,1984
1361223206,1644586752,3,168,56,1361223203773,1361223204861,1644584525,1644585613,1088
1361223207,1644588260,1,52,52,1361223181376,1361223181376,1644562636,1644562636,0
1361223211,1644592280,20,4381,219.05,1361223183470,1361223190702,1644564750,1644571982,7232
1361223211,1644592320,1,52,52,1361223185220,1361223185220,1644566540,1644566540,0
1361223214,1644594720,3,168,56,1361223208796,1361223209436,1644589516,1644590156,640
1361223214,1644594732,3,168,56,1361223209746,1361223210770,1644590478,1644591502,1024
1361223214,1644594732,3,168,56,1361223207377,1361223208529,1644588109,1644589261,1152
1361223214,1644594836,3,168,56,1361223205672,1361223206248,1644586508,1644587084,576
1361223222,1644602740,3,168,56,1361223220938,1361223221578,1644601678,1644602318,640
1361223222,1644602788,3,168,56,1361223219995,1361223220635,1644600783,1644601423,640
1361223224,1644604396,7,2689,384.1428571,1361223198689,1361223199073,1644579085,1644579469,384
1361223232,1644612360,1,46,46,1361223207046,1361223207046,1644587406,1644587406,0
1361223232,1644612396,9,3463,384.7777778,1361223205345,1361223206753,1644585741,1644587149,1408
1361223334,1644714900,2,131,65.5,1361223326055,1361223326055,1644706955,1644706955,0
1361223464,1644844812,1,46,46,1361223438654,1361223438654,1644819466,1644819466,0
1361223558,1644939008,3,168,56,1361223554104,1361223555128,1644935112,1644936136,1024
1361223584,1644965164,1,64,64,1361223555930,1361223555930,1644937094,1644937094,0
1361223584,1644965280,1,52,52,1361223557865,1361223557865,1644939145,1644939145,0
1361223584,1644965288,17,5380,316.4705882,1361223556383,1361223559455,1644937671,1644940743,3072
1361223638,1645019056,3,168,56,1361223631046,1361223631686,1645012102,1645012742,640
1361223638,1645019068,4,271,67.75,1361223631996,1361223632636,1645013064,1645013704,640
1361223657,1645037408,1,46,46,1361223631503,1361223631503,1645011911,1645011911,0
1361223958,1645339220,3,168,56,1361223951070,1361223951774,1645332290,1645332994,704
1361223958,1645339232,3,168,56,1361223952274,1361223952786,1645333506,1645334018,512
1361223981,1645362168,1,52,52,1361223955858,1361223955858,1645337026,1645337026,0
1361223981,1645362220,17,5380,316.4705882,1361223954333,1361223957469,1645335553,1645338689,3136
1361224066,1645446708,1,48,48,1361224037979,1361224037979,1645418687,1645418687,0
1361224178,1645558776,1,46,46,1361224152981,1361224152981,1645533757,1645533757,0
1361224262,1645643112,1,222,222,1361224235590,1361224235590,1645616702,1645616702,0
1361224310,1645691308,1,46,46,1361224285503,1361224285503,1645666811,1645666811,0
1361224351,1645731740,4,232,58,1361224346744,1361224350136,1645727484,1645730876,3392
1361224359,1645739724,3,168,56,1361224351816,1361224353608,1645732540,1645734332,1792
1361224359,1645739884,3,168,56,1361224350312,1361224350760,1645731196,1645731644,448
1361224375,1645755684,17,4059,238.7647059,1361224349870,1361224354030,1645730554,1645734714,4160
1361224379,1645759444,1,46,46,1361224351454,1361224351454,1645731898,1645731898,0
1361224379,1645759552,1,52,52,1361224351091,1361224351091,1645731643,1645731643,0
1361224383,1645763868,3,168,56,1361224376888,1361224377464,1645757756,1645758332,576
1361224383,1645763876,3,168,56,1361224377775,1361224378351,1645758651,1645759227,576
1361224383,1645763916,4,220,55,1361224378632,1361224381192,1645759548,1645762108,2560
1361224383,1645763928,3,168,56,1361224375869,1361224376445,1645756797,1645757373,576
1361224411,1645791460,1,64,64,1361224385037,1361224385037,1645765497,1645765497,0
1361224696,1646076348,3,168,56,1361224691961,1361224692601,1646072309,1646072949,640
1361224696,1646076384,3,168,56,1361224689941,1361224690581,1646070325,1646070965,640
1361224696,1646076388,3,168,56,1361224693715,1361224694355,1646074103,1646074743,640
1361224696,1646076392,3,168,56,1361224690830,1361224691598,1646071222,1646071990,768
1361224696,1646076420,3,168,56,1361224694770,1361224695538,1646075190,1646075958,768
1361224696,1646076436,3,168,56,1361224692770,1361224693410,1646073206,1646073846,640
1361224703,1646084284,3,168,56,1361224695889,1361224696529,1646077173,1646077813,640
1361224704,1646084356,3,168,56,1361224695923,1361224696499,1646076279,1646076855,576
1361224704,1646084372,3,168,56,1361224697763,1361224698403,1646078135,1646078775,640
1361224719,1646100000,17,3962,233.0588235,1361224692204,1361224694956,1646073204,1646075956,2752
1361224719,1646100032,1,52,52,1361224693453,1361224693453,1646074485,1646074485,0
1361224723,1646104108,1,46,46,1361224697923,1361224697923,1646079031,1646079031,0
1361224932,1646312484,9,3463,384.7777778,1361224905200,1361224906544,1646285684,1646287028,1344
1361224956,1646336648,7,2689,384.1428571,1361224929929,1361224930889,1646310577,1646311537,960
1361225032,1646413200,2,131,65.5,1361225025571,1361225025571,1646406771,1646406771,0
1361225052,1646432884,24,25127,1046.958333,1361225026844,1361225036572,1646407728,1646417456,9728
1361225052,1646432888,76,95360,1254.736842,1361225026777,1361225036825,1646407665,1646417713,10048
1361225064,1646445248,14,3214,229.5714286,1361225061680,1361225063152,1646442928,1646444400,1472
1361225072,1646453192,20,3385,169.25,1361225064105,1361225065449,1646445297,1646446641,1344
1361225072,1646453208,17,3602,211.8823529,1361225065691,1361225067483,1646446899,1646448691,1792
1361225072,1646453228,2,131,65.5,1361225066180,1361225066180,1646447408,1646447408,0
1361225072,1646453232,2,131,65.5,1361225066175,1361225066175,1646447407,1646447407,0
1361225072,1646453232,16,6827,426.6875,1361225069313,1361225071105,1646450545,1646452337,1792
1361225072,1646453320,17,3358,197.5294118,1361225061481,1361225063785,1646442801,1646445105,2304
1361225072,1646453344,19,5454,287.0526316,1361225067344,1361225069840,1646448688,1646451184,2496
1361225073,1646453348,23,9912,430.9565217,1361225064115,1361225066355,1646444463,1646446703,2240
1361225080,1646461264,16,4021,251.3125,1361225072930,1361225076706,1646454194,1646457970,3776
1361225080,1646461300,25,5440,217.6,1361225069630,1361225073342,1646450930,1646454642,3712
1361225080,1646461336,15,3293,219.5333333,1361225070999,1361225072599,1646452335,1646453935,1600
1361225088,1646468948,9,4004,444.8888889,1361225060060,1361225061596,1646441008,1646442544,1536
1361225088,1646469204,15,3198,213.2,1361225078045,1361225080157,1646459249,1646461361,2112
1361225088,1646469228,16,3935,245.9375,1361225080134,1361225082310,1646461362,1646463538,2176
1361225096,1646477172,3,138,46,1361225088059,1361225088059,1646469231,1646469231,0
1361225096,1646477212,59,65386,1108.237288,1361225082324,1361225089108,1646463536,1646470320,6784
1361225096,1646477224,22,3477,158.0454545,1361225091081,1361225092681,1646472305,1646473905,1600
1361225096,1646477260,18,14758,819.8888889,1361225092771,1361225095779,1646474031,1646477039,3008
1361225096,1646477264,17,3441,202.4117647,1361225089057,1361225090913,1646470321,1646472177,1856
1361225096,1646477296,13,8669,666.8461538,1361225077951,1361225092351,1646459247,1646473647,14400
1361225116,1646496988,59,73043,1238.016949,1361225088437,1361225095861,1646469425,1646476849,7424
1361225120,1646501008,41,48492,1182.731707,1361225093087,1361225098335,1646474095,1646479343,5248
1361225120,1646501012,1,46,46,1361225093084,1361225093084,1646474096,1646474096,0
1361225128,1646509292,2,131,65.5,1361225127490,1361225127490,1646508782,1646508782,0
1361225128,1646509304,2,131,65.5,1361225124217,1361225124217,1646505521,1646505521,0
1361225196,1646577252,1,46,46,1361225170284,1361225170284,1646551536,1646551536,0
1361225273,1646653704,4,271,67.75,1361225271375,1361225272015,1646652079,1646652719,640
1361225273,1646653728,3,168,56,1361225272053,1361225272693,1646652781,1646653421,640
1361225281,1646661680,3,168,56,1361225273063,1361225273767,1646653743,1646654447,704
1361225297,1646677360,16,3910,244.375,1361225271781,1361225274661,1646652141,1646655021,2880
1361225301,1646681496,1,52,52,1361225272988,1361225272988,1646653484,1646653484,0
1361225329,1646709368,1,52,52,1361225302171,1361225302171,1646682539,1646682539,0
1361225769,1647150344,1,222,222,1361225743492,1361225743492,1647124836,1647124836,0
1361225834,1647214804,3,168,56,1361225828511,1361225829215,1647209315,1647210019,704
1361225834,1647214848,3,168,56,1361225830133,1361225830709,1647210981,1647211557,576
1361225834,1647214876,3,168,56,1361225831064,1361225831896,1647211940,1647212772,832
1361225858,1647238500,1,46,46,1361225829903,1361225829903,1647210403,1647210403,0
1361225858,1647238652,1,64,64,1361225832376,1361225832376,1647213028,1647213028,0
1361225858,1647238656,1,52,52,1361225832883,1361225832883,1647213539,1647213539,0
1361225858,1647238732,22,5382,244.6363636,1361225831464,1361225834856,1647212196,1647215588,3392
1361225963,1647343356,3,168,56,1361225956766,1361225957406,1647337122,1647337762,640
1361225963,1647343492,4,271,67.75,1361225957590,1361225958166,1647338082,1647338658,576
1361225982,1647362928,1,46,46,1361225956001,1361225956001,1647336929,1647336929,0
1361225986,1647367064,1,64,64,1361225957977,1361225957977,1647339041,1647339041,0
1361226255,1647635664,1,46,46,1361226228134,1361226228134,1647608798,1647608798,0
1361226291,1647672208,5,296,59.2,1361226279430,1361226289030,1647660638,1647670238,9600
1361226291,1647672252,3,168,56,1361226289368,1361226289880,1647670620,1647671132,512
1361226291,1647672276,2,116,58,1361226290242,1361226290370,1647671518,1647671646,128
1361226299,1647680224,3,168,56,1361226292595,1361226293171,1647673819,1647674395,576
1361226299,1647680232,3,168,56,1361226293487,1361226294063,1647674719,1647675295,576
1361226299,1647680276,3,168,56,1361226291074,1361226291586,1647672350,1647672862,512
1361226300,1647680348,3,168,56,1361226295331,1361226295907,1647675679,1647676255,576
1361226307,1647688064,22,4521,205.5,1361226279509,1361226287765,1647660573,1647668829,8256
1361226311,1647692016,1,52,52,1361226286148,1361226286148,1647667164,1647667164,0
1361226319,1647699956,1,46,46,1361226292223,1361226292223,1647673179,1647673179,0
1361226319,1647700008,1,52,52,1361226291085,1361226291085,1647672093,1647672093,0
1361226356,1647736420,13,3522,270.9230769,1361226347034,1361226348762,1647727454,1647729182,1728
1361226356,1647736420,22,5893,267.8636364,1361226347098,1361226349146,1647727518,1647729566,2048
1361226716,1648096548,3,168,56,1361226708242,1361226709010,1648088790,1648089558,768
1361226716,1648096556,3,168,56,1361226709706,1361226710730,1648090262,1648091286,1024
1361226716,1648096592,4,271,67.75,1361226714533,1361226715173,1648095125,1648095765,640
1361226716,1648096624,3,219,73,1361226715399,1361226715719,1648096023,1648096343,320
1361226724,1648104488,3,168,56,1361226717265,1361226717905,1648097753,1648098393,640
1361226740,1648121020,1,46,46,1361226713597,1361226713597,1648094617,1648094617,0
1361226740,1648121020,16,3910,244.375,1361226713660,1361226717180,1648094680,1648098200,3520
1361226740,1648121064,1,52,52,1361226715023,1361226715023,1648096087,1648096087,0
1361226744,1648125072,1,52,52,1361226715976,1361226715976,1648097048,1648097048,0
1361226748,1648128712,4,271,67.75,1361226743345,1361226743985,1648124057,1648124697,640
1361226769,1648149412,1,64,64,1361226744537,1361226744537,1648124949,1648124949,0
1361226772,1648152560,4,271,67.75,1361226768518,1361226769158,1648149078,1648149718,640
1361226890,1648270488,1,46,46,1361226863950,1361226863950,1648244438,1648244438,0
1361226908,1648288724,3,168,56,1361226904607,1361226905183,1648285331,1648285907,576
1361226921,1648301816,1,46,46,1361226895363,1361226895363,1648276179,1648276179,0
1361226977,1648357832,1,222,222,1361226950193,1361226950193,1648331025,1648331025,0
1361227100,1648480828,3,168,56,1361227095222,1361227096118,1648476050,1648476946,896
1361227125,1648506324,1,52,52,1361227100100,1361227100100,1648481424,1648481424,0
1361227126,1648506476,19,4088,215.1578947,1361227099027,1361227102483,1648479503,1648482959,3456
1361227146,1648526496,1,60,60,1361227120321,1361227120321,1648500817,1648500817,0
1361227271,1648651876,1,46,46,1361227243652,1361227243652,1648624528,1648624528,0
1361227379,1648760140,1,48,48,1361227352698,1361227352698,1648733838,1648733838,0
1361227468,1648848912,3,168,56,1361227467100,1361227467740,1648848012,1648848652,640
1361227468,1648848956,3,168,56,1361227466032,1361227466672,1648846988,1648847628,640
1361227476,1648856876,4,220,55,1361227469952,1361227470528,1648850828,1648851404,576
1361227476,1648856880,3,168,56,1361227468093,1361227468669,1648848973,1648849549,576
1361227476,1648856888,4,271,67.75,1361227471219,1361227471923,1648852107,1648852811,704
1361227476,1648856992,4,271,67.75,1361227468874,1361227469514,1648849866,1648850506,640
1361227476,1648857008,4,271,67.75,1361227472249,1361227472633,1648853257,1648853641,384
1361227476,1648857032,3,168,56,1361227472932,1361227473444,1648853964,1648854476,512
1361227494,1648874776,17,3970,233.5294118,1361227469157,1361227473189,1648849933,1648853965,4032
1361227498,1648878872,1,52,52,1361227471298,1361227471298,1648852170,1648852170,0
1361227508,1648888932,20,5000,250,1361227499464,1361227503688,1648880396,1648884620,4224
1361287251,1708631320,3,168,56,1361287244892,1361287245724,1708625212,1708626044,832
1361287274,1708654304,1,46,46,1361287246122,1361287246122,1708626426,1708626426,0
1361287274,1708654336,2,120,60,1361287247882,1361287248202,1708628218,1708628538,320
1361287275,1708655324,4,220,55,1361287266967,1361287273047,1708647291,1708653371,6080
1361287275,1708655420,4,271,67.75,1361287273206,1361287274358,1708653626,1708654778,1152
1361287299,1708679416,4,220,55,1361287295035,1361287296507,1708675451,1708676923,1472
1361287302,1708682352,1,64,64,1361287274745,1361287274745,1708655097,1708655097,0
1361287310,1708690500,9,3463,384.7777778,1361287285671,1361287287015,1708666171,1708667515,1344
1361287315,1708695356,3,168,56,1361287307703,1361287309879,1708688059,1708690235,2176
1361287315,1708695360,2,98,49,1361287308210,1361287314546,1708688570,1708694906,6336
1361287322,1708702484,2,128,64,1361287297016,1361287300024,1708677500,1708680508,3008
1361287331,1708711368,2,110,55,1361287319722,1361287329770,1708700090,1708710138,10048
1361287331,1708711400,4,271,67.75,1361287329737,1361287329865,1708710137,1708710265,128
1361287346,1708726408,22,4958,225.3636364,1361287320960,1361287328768,1708701368,1708709176,7808
1361287410,1708790856,1,64,64,1361287382207,1361287382207,1708763063,1708763063,0
1361287411,1708791516,4,289,72.25,1361287406807,1361287409431,1708787323,1708789947,2624
1361287414,1708794860,9,3919,435.4444444,1361287386172,1361287390844,1708767032,1708771704,4672
1361287427,1708807472,2,158,79,1361287412928,1361287419840,1708793400,1708800312,6912
1361287451,1708831460,2,104,52,1361287447437,1361287450701,1708827897,1708831161,3264
1361287451,1708831500,3,168,56,1361287450086,1361287450790,1708830586,1708831290,704
1361287458,1708838988,1,79,79,1361287433147,1361287433147,1708814135,1708814135,0
1361287459,1708839472,3,168,56,1361287456063,1361287456895,1708836535,1708837367,832
1361287459,1708839508,3,156,52,1361287457438,1361287458590,1708837946,1708839098,1152
1361287459,1708839516,3,168,56,1361287455317,1361287455701,1708835833,1708836217,384
1361287459,1708839556,4,220,55,1361287454189,1361287456557,1708834745,1708837113,2368
1361287467,1708847512,5,308,61.6,1361287457434,1361287466778,1708837946,1708847290,9344
1361287475,1708855496,3,168,56,1361287470120,1361287473064,1708850616,1708853560,2944
1361287478,1708858976,1,46,46,1361287452039,1361287452039,1708833015,1708833015,0
1361287482,1708862948,19,5176,272.4210526,1361287454245,1361287461093,1708835193,1708842041,6848
1361287486,1708867064,1,79,79,1361287460848,1361287460848,1708841912,1708841912,0
1361287494,1708875048,2,104,52,1361287467390,1361287469246,1708848438,1708850294,1856
1361287502,1708883092,1,52,52,1361287475218,1361287475218,1708856310,1708856310,0
1361287579,1708959624,4,220,55,1361287575463,1361287576871,1708956087,1708957495,1408
1361287587,1708967588,7,400,57.14285714,1361287577228,1361287584268,1708957816,1708964856,7040
1361287603,1708983324,23,5308,230.7826087,1361287578385,1361287588433,1708958709,1708968757,10048
1361287603,1708983604,4,220,55,1361287598907,1361287601275,1708979511,1708981879,2368
1361287607,1708987368,1,52,52,1361287579879,1361287579879,1708960247,1708960247,0
1361287607,1708987372,1,52,52,1361287580320,1361287580320,1708960692,1708960692,0
1361287643,1709023656,3,168,56,1361287639621,1361287640197,1709020277,1709020853,576
1361287667,1709047452,1,64,64,1361287640721,1361287640721,1709021173,1709021173,0
1361287675,1709055684,7,1609,229.8571429,1361287666663,1361287668391,1709047347,1709049075,1728
1361287675,1709055756,7,1609,229.8571429,1361287666720,1361287668384,1709047476,1709049140,1664
1361287715,1709095820,11,5311,482.8181818,1361287688289,1361287691297,1709069109,1709072117,3008
1361287747,1709127912,8,3390,423.75,1361287721155,1361287722691,1709102067,1709103603,1536
1361287799,1709179896,9,3463,384.7777778,1361287771026,1361287771410,1709151922,1709152306,384
1361287803,1709183864,1,485,485,1361287776370,1361287776370,1709157234,1709157234,0
1361287900,1709280284,2,131,65.5,1361287891891,1361287891891,1709272175,1709272175,0
1361287959,1709340052,1,46,46,1361287931061,1361287931061,1709312113,1709312113,0
1361287987,1709368044,1,52,52,1361287962558,1361287962558,1709343602,1709343602,0
1361288011,1709392140,1,52,52,1361287982939,1361287982939,1709364079,1709364079,0
1361288084,1709464560,15,3260,217.3333333,1361288076765,1361288078429,1709457325,1709458989,1664
1361288084,1709464564,13,3168,243.6923077,1361288076890,1361288078810,1709457454,1709459374,1920
1361288084,1709464572,26,8653,332.8076923,1361288078865,1361288081553,1709459437,1709462125,2688
1361288092,1709472392,20,3658,182.9,1361288088455,1361288090567,1709468847,1709470959,2112
1361288092,1709472424,15,6762,450.8,1361288086629,1361288088421,1709467053,1709468845,1792
1361288092,1709472440,16,5310,331.875,1361288084757,1361288086485,1709465197,1709466925,1728
1361288092,1709472472,13,3404,261.8461538,1361288081784,1361288084728,1709462256,1709465200,2944
1361288092,1709472476,29,4296,148.137931,1361288086836,1361288089524,1709467312,1709470000,2688
1361288100,1709480288,9,4004,444.8888889,1361288075246,1361288076782,1709455534,1709457070,1536
1361288100,1709480436,18,3372,187.3333333,1361288090970,1361288092890,1709471406,1709473326,1920
1361288100,1709480464,21,4246,202.1904762,1361288092861,1361288094909,1709473325,1709475373,2048
1361288100,1709480480,65,69839,1074.446154,1361288094895,1361288099631,1709475375,1709480111,4736
1361288108,1709488440,21,3425,163.0952381,1361288100309,1361288101973,1709480749,1709482413,1664
1361288108,1709488512,23,3777,164.2173913,1361288098637,1361288100109,1709479149,1709480621,1472
1361288252,1709632872,7,1609,229.8571429,1361288243042,1361288244258,1709623914,1709625130,1216
1361288344,1709724736,1,52,52,1361288316332,1361288316332,1709697068,1709697068,0
1361288368,1709748996,1,46,46,1361288340070,1361288340070,1709721066,1709721066,0
1361288413,1709793240,2,188,94,1361288387096,1361288387096,1709767336,1709767336,0
1361288417,1709797212,8,3608,451,1361288390836,1361288391220,1709771048,1709771432,384
1361288417,1709797292,18,10956,608.6666667,1361288390439,1361288393127,1709770731,1709773419,2688
1361288436,1709816996,15,3759,250.6,1361288432743,1361288433575,1709813739,1709814571,832
1361288436,1709816996,6,276,46,1361288432742,1361288432742,1709813738,1709813738,0
1361288436,1709817008,13,3510,270,1361288433947,1361288434587,1709814955,1709815595,640
1361288436,1709817020,19,4798,252.5263158,1361288433996,1361288434700,1709815016,1709815720,704
1361288436,1709817072,14,4326,309,1361288433944,1361288434712,1709815016,1709815784,768
1361288436,1709817080,12,3358,279.8333333,1361288434897,1361288435409,1709815977,1709816489,512
1361288464,1709845136,9,3463,384.7777778,1361288435738,1361288436250,1709816874,1709817386,512
1361288481,1709861344,1,220,220,1361288454064,1361288454064,1709834408,1709834408,0
1361288497,1709877268,33,2470,74.84848485,1361288469436,1361288474492,1709849704,1709854760,5056
1361288497,1709877268,72,5350,74.30555556,1361288469372,1361288474236,1709849640,1709854504,4864
1361288525,1709905736,1,52,52,1361288498473,1361288498473,1709879209,1709879209,0
1361288541,1709921476,1,46,46,1361288513003,1361288513003,1709893479,1709893479,0
1361288553,1709933516,2,188,94,1361288527364,1361288527364,1709907880,1709907880,0
1361288564,1709945152,2,131,65.5,1361288556103,1361288556103,1709937255,1709937255,0
1361288633,1710013632,3,240,80,1361288607760,1361288620112,1709988392,1710000744,12352
1361288637,1710017228,11,5880,534.5454545,1361288625760,1361288631200,1710005988,1710011428,5440
1361288713,1710093956,1,60,60,1361288688714,1361288688714,1710069670,1710069670,0
1361288741,1710121836,1,46,46,1361288713664,1361288713664,1710094500,1710094500,0
1361288741,1710121992,1,46,46,1361288713827,1361288713827,1710094819,1710094819,0
1361288777,1710157920,1,52,52,1361288751018,1361288751018,1710131938,1710131938,0
1361289093,1710473504,14,3214,229.5714286,1361289085958,1361289087622,1710466462,1710468126,1664
1361289110,1710490808,8,4864,608,1361289083287,1361289084887,1710464095,1710465695,1600
1361289333,1710713616,4,184,46,1361289326292,1361289326292,1710706908,1710706908,0
1361289351,1710731208,1,52,52,1361289325483,1361289325483,1710705691,1710705691,0
1361289354,1710735136,7,2689,384.1428571,1361289326154,1361289328586,1710707290,1710709722,2432
1361289547,1710927732,4,783,195.75,1361289519516,1361289542044,1710900248,1710922776,22528
1361289549,1710929852,4,184,46,1361289543332,1361289543332,1710924184,1710924184,0
1361289571,1710951812,9,3463,384.7777778,1361289543307,1361289543947,1710924119,1710924759,640
1361289595,1710975796,1,46,46,1361289568924,1361289568924,1710949720,1710949720,0
1361289627,1711007840,1,52,52,1361289602607,1361289602607,1710983447,1710983447,0
1361289669,1711049924,3,210,70,1361289663643,1361289663899,1711044567,1711044823,256
1361289704,1711084196,2,188,94,1361289679729,1361289679729,1711059925,1711059925,0
1361289861,1711242100,24,3674,153.0833333,1361289857576,1361289858024,1711238676,1711239124,448
1361289933,1711314064,4,184,46,1361289928396,1361289928396,1711309460,1711309460,0
1361289948,1711328976,1,46,46,1361289920225,1361289920225,1711301201,1711301201,0
1361289949,1711330144,8,1655,206.875,1361289942777,1361289943417,1711323921,1711324561,640
1361289956,1711336960,9,3463,384.7777778,1361289928691,1361289929331,1711309651,1711310291,640
1361290025,1711405248,3,240,80,1361289999160,1361290023352,1711379408,1711403600,24192
1361290053,1711434128,2,131,65.5,1361290049032,1361290049032,1711430160,1711430160,0
1361290077,1711457248,7,4144,592,1361290052281,1361290052729,1711432529,1711432977,448
1361290077,1711457324,40,47921,1198.025,1361290052268,1361290055532,1711432592,1711435856,3264
1361290077,1711457324,22,15674,712.4545455,1361290052395,1361290055915,1711432719,1711436239,3520
1361290085,1711466132,2,131,65.5,1361290084741,1361290084741,1711465873,1711465873,0
1361290086,1711466156,3,210,70,1361290082834,1361290083154,1711462990,1711463310,320
1361290093,1711473196,1,191,191,1361290064939,1361290064939,1711445135,1711445135,0
1361290093,1711473288,15,9828,655.2,1361290066384,1361290068304,1711446672,1711448592,1920
1361290094,1711474172,2,131,65.5,1361290086082,1361290086082,1711466254,1711466254,0
1361290197,1711577572,4,431,107.75,1361290169266,1361290174322,1711549838,1711554894,5056
1361290201,1711581520,3,567,189,1361290174821,1361290175013,1711555341,1711555533,192
1361290225,1711605544,1,46,46,1361290198735,1361290198735,1711579279,1711579279,0
1361290225,1711605568,14,12126,866.1428571,1361290199540,1361290200756,1711580108,1711581324,1216
1361290225,1711605572,11,5471,497.3636364,1361290199859,1361290201075,1711580431,1711581647,1216
1361290225,1711605616,1,46,46,1361290198662,1361290198662,1711579278,1711579278,0
1361290238,1711618164,2,131,65.5,1361290231178,1361290231178,1711611342,1711611342,0
1361290238,1711618168,2,131,65.5,1361290231494,1361290231494,1711611662,1711611662,0
1361290257,1711637932,2,245,122.5,1361290230858,1361290244234,1711611790,1711625166,13376
1361290261,1711641908,7,1386,198,1361290235680,1361290245280,1711616588,1711626188,9600
1361290377,1711758032,1,46,46,1361290351524,1361290351524,1711732556,1711732556,0
1361290422,1711802592,2,188,94,1361290397724,1361290397724,1711778316,1711778316,0
1361290510,1711890832,1,52,52,1361290485352,1361290485352,1711866184,1711866184,0
1361290534,1711914512,4,184,46,1361290531944,1361290531944,1711912456,1711912456,0
1361290558,1711938744,9,3463,384.7777778,1361290531713,1361290532225,1711912457,1711912969,512
1361290574,1711954792,3,559,186.3333333,1361290546383,1361290546703,1711927175,1711927495,320
1361290642,1712022992,3,180,60,1361290616390,1361290616838,1711997382,1711997830,448
1361290654,1712034492,2,131,65.5,1361290652346,1361290652346,1712032838,1712032838,0
1361290698,1712079024,2,188,94,1361290671975,1361290671975,1712052999,1712052999,0
1361290815,1712195476,1,52,52,1361290787850,1361290787850,1712168326,1712168326,0
1361291027,1712407988,2,188,94,1361291001543,1361291001543,1712382531,1712382531,0
1361291180,1712560328,1,52,52,1361291152472,1361291152472,1712532800,1712532800,0
1361291452,1712833128,3,561,187,1361291425138,1361291425394,1712806266,1712806522,256
1361291454,1712835024,4,184,46,1361291450267,1361291450267,1712831291,1712831291,0
1361291477,1712857184,9,3463,384.7777778,1361291451105,1361291451617,1712831289,1712831801,512
1361291525,1712905536,2,335,167.5,1361291499779,1361291516291,1712880315,1712896827,16512
1361291575,1712955144,3,210,70,1361291571529,1361291571785,1712951673,1712951929,256
1361291585,1712965648,2,188,94,1361291558225,1361291558225,1712938873,1712938873,0
1361291633,1713013720,1,52,52,1361291606024,1361291606024,1712986744,1712986744,0
1361291681,1713061980,2,337,168.5,1361291653507,1361291653507,1713034487,1713034487,0
1361291830,351524384,1,48,48,1361291800142,1361291800142,351494526,351494526,0
1361291850,1713230528,1,52,52,1361291822915,1361291822915,1713203443,1713203443,0
1361291926,1713306716,2,188,94,1361291899910,1361291899910,1713280626,1713280626,0
1361291978,1713358912,1,52,52,1361291951747,1361291951747,1713332659,1713332659,0
1361292033,1713413460,1,48,48,1361292003912,1361292003912,1713384372,1713384372,0
1361292183,1713564108,3,168,56,1361292176380,1361292176508,1713557488,1713557616,128
1361292184,1713564184,6,348,58,1361292177433,1361292182361,1713557617,1713562545,4928
1361292192,1713572192,2,104,52,1361292184400,1361292188240,1713564592,1713568432,3840
1361292207,1713587448,13,6912,531.6923077,1361292180367,1361292191951,1713560815,1713572399,11584
1361292223,1713603428,1,52,52,1361292195427,1361292195427,1713575855,1713575855,0
1361292231,1713612120,4,271,67.75,1361292225008,1361292225200,1713606128,1713606320,192
1361292247,1713628112,15,3761,250.7333333,1361292242807,1361292243127,1713623919,1713624239,320
1361292247,1713628120,13,3510,270,1361292244077,1361292245293,1713625197,1713626413,1216
1361292248,1713628200,19,4845,255,1361292245061,1361292245637,1713625261,1713625837,576
1361292248,1713628200,13,3510,270,1361292245061,1361292245765,1713625261,1713625965,704
1361292255,1713635452,17,4399,258.7647059,1361292228746,1361292235850,1713609198,1713616302,7104
1361292255,1713635472,1,52,52,1361292229621,1361292229621,1713610093,1713610093,0
1361292271,1713651440,9,3463,384.7777778,1361292245591,1361292246359,1713626031,1713626799,768
1361292271,1713651472,1,52,52,1361292242934,1361292242934,1713623406,1713623406,0
1361292279,1713659452,1,52,52,1361292253514,1361292253514,1713633966,1713633966,0
1361292351,1713731612,1,64,64,1361292325800,1361292325800,1713706412,1713706412,0
1361292355,1713735512,17,5384,316.7058824,1361292330060,1361292333836,1713710572,1713714348,3776
1361292359,1713739488,1,52,52,1361292331877,1361292331877,1713712365,1713712365,0
1361292360,1713740160,3,168,56,1361292352109,1361292352237,1713732269,1713732397,128
1361292368,1713748224,2,110,55,1361292352237,1361292362285,1713732461,1713742509,10048
1361292368,1713748256,3,168,56,1361292362251,1361292362315,1713742507,1713742571,64
1361292368,1713748264,2,131,65.5,1361292366341,1361292366341,1713746605,1713746605,0
1361292376,1713756172,3,168,56,1361292372512,1361292372640,1713752684,1713752812,128
1361292376,1713756176,3,168,56,1361292372766,1361292372894,1713752942,1713753070,128
1361292376,1713756244,3,168,56,1361292372567,1361292372631,1713752811,1713752875,64
1361292379,1713759532,1,46,46,1361292351867,1361292351867,1713732399,1713732399,0
1361292383,1713763504,18,4018,223.2222222,1361292355540,1361292358356,1713736044,1713738860,2816
1361292383,1713763596,1,52,52,1361292357497,1361292357497,1713738093,1713738093,0
1361292387,1713767628,1,64,64,1361292362009,1361292362009,1713742637,1713742637,0
1361292391,1713771640,1,46,46,1361292365006,1361292365006,1713745646,1713745646,0
1361292511,1713891664,1,460,460,1361292484851,1361292484851,1713865515,1713865515,0
1361292523,1713903704,1,46,46,1361292495689,1361292495689,1713876393,1713876393,0
1361292563,1713943760,1,52,52,1361292536784,1361292536784,1713917544,1713917544,0
1361292584,1713964340,23,8521,370.4782609,1361292579958,1361292582070,1713960298,1713962410,2112
1361292584,1713964348,15,3307,220.4666667,1361292577711,1361292579247,1713958059,1713959595,1536
1361292584,1713964348,13,3168,243.6923077,1361292578284,1361292579884,1713958632,1713960232,1600
1361292584,1713964428,17,3582,210.7058824,1361292582045,1361292583773,1713962473,1713964201,1728
1361292592,1713972392,17,5356,315.0588235,1361292583875,1361292585539,1713964267,1713965931,1664
1361292592,1713972416,13,6670,513.0769231,1361292585640,1361292587112,1713966056,1713967528,1472
1361292592,1713972420,18,3646,202.5555556,1361292585767,1361292587623,1713966187,1713968043,1856
1361292592,1713972428,19,3887,204.5789474,1361292589726,1361292591646,1713970154,1713972074,1920
1361292592,1713972428,17,4815,283.2352941,1361292587100,1361292589404,1713967528,1713969832,2304
1361292600,1713980348,19,3527,185.6315789,1361292596397,1361292597997,1713976745,1713978345,1600
1361292600,1713980352,60,67197,1119.95,1361292593322,1361292596394,1713973674,1713976746,3072
1361292600,1713980376,22,3471,157.7727273,1361292598032,1361292599568,1713978408,1713979944,1536
1361292600,1713980388,16,3935,245.9375,1361292591685,1361292593285,1713972073,1713973673,1600
1361292603,1713983760,9,4004,444.8888889,1361292576850,1361292577362,1713957610,1713958122,512
1361292692,1714072176,18,4210,233.8888889,1361292667800,1361292678360,1714047976,1714058536,10560
1361292696,1714076152,1,52,52,1361292669424,1361292669424,1714049576,1714049576,0
1361292704,1714084412,17,12794,752.5882353,1361292698540,1361292698860,1714078952,1714079272,320
1361292704,1714084480,4,271,67.75,1361292701609,1361292701673,1714082089,1714082153,64
1361292704,1714084480,3,168,56,1361292701863,1361292702055,1714082343,1714082535,192
1361292704,1714084484,3,168,56,1361292698661,1361292698789,1714079145,1714079273,128
1361292704,1714084484,3,168,56,1361292698916,1361292699044,1714079400,1714079528,128
1361292704,1714084484,10,6766,676.6,1361292698916,1361292699044,1714079400,1714079528,128
1361292704,1714084484,10,6605,660.5,1361292699235,1361292699363,1714079719,1714079847,128
1361292712,1714092428,3,168,56,1361292708125,1361292708701,1714088553,1714089129,576
1361292712,1714092432,3,168,56,1361292708696,1361292709272,1714089128,1714089704,576
1361292720,1714100276,1,487,487,1361292695411,1361292695411,1714075687,1714075687,0
1361292724,1714104184,7,3203,457.5714286,1361292699089,1361292699409,1714079273,1714079593,320
1361292728,1714108172,1,64,64,1361292702426,1361292702426,1714082598,1714082598,0
1361292736,1714116176,1,64,64,1361292709590,1361292709590,1714089766,1714089766,0
1361292752,1714132504,3,168,56,1361292751246,1361292751822,1714131750,1714132326,576
1361292760,1714140464,3,168,56,1361292752249,1361292752953,1714132713,1714133417,704
1361292760,1714140512,2,110,55,1361292748487,1361292758791,1714128999,1714139303,10304
1361292760,1714140516,3,168,56,1361292753477,1361292754629,1714133993,1714135145,1152
1361292760,1714140544,4,220,55,1361292755048,1361292755816,1714135592,1714136360,768
1361292760,1714140548,3,168,56,1361292758755,1361292759139,1714139303,1714139687,384
1361292776,1714156276,17,3974,233.7647059,1361292749362,1361292755314,1714129638,1714135590,5952
1361292780,1714160248,1,52,52,1361292753488,1361292753488,1714133736,1714133736,0
1361292780,1714160320,1,46,46,1361292753349,1361292753349,1714133669,1714133669,0
1361292784,1714164272,1,64,64,1361292759477,1361292759477,1714139749,1714139749,0
1361292784,1714164300,1,64,64,1361292756379,1361292756379,1714136679,1714136679,0
1361292784,1714164544,3,168,56,1361292775909,1361292776549,1714156453,1714157093,640
1361292792,1714172704,3,168,56,1361292787527,1361292788167,1714168231,1714168871,640
1361292792,1714172716,3,168,56,1361292785658,1361292786298,1714166374,1714167014,640
1361292792,1714172800,3,168,56,1361292786468,1361292787108,1714167268,1714167908,640
1361292800,1714180784,7,1609,229.8571429,1361292793336,1361292795192,1714174120,1714175976,1856
1361292800,1714180784,7,1609,229.8571429,1361292793336,1361292795256,1714174120,1714176040,1920
1361292804,1714184516,16,3914,244.625,1361292775937,1361292779393,1714156453,1714159909,3456
1361292804,1714184532,1,52,52,1361292777203,1361292777203,1714157735,1714157735,0
1361292816,1714196616,25,12081,483.24,1361292790750,1361292795102,1714171366,1714175718,4352
1361292824,1714204792,3,168,56,1361292818990,1361292819886,1714199782,1714200678,896
1361292824,1714204868,2,116,58,1361292823459,1361292823715,1714204327,1714204583,256
1361292832,1714212800,3,168,56,1361292824677,1361292825509,1714205477,1714206309,832
1361292844,1714224592,1,52,52,1361292817524,1361292817524,1714198116,1714198116,0
1361292844,1714224784,16,3914,244.625,1361292819638,1361292825526,1714200422,1714206310,5888
1361292848,1714228688,1,52,52,1361292823573,1361292823573,1714204261,1714204261,0
1361292852,1714232592,1,52,52,1361292824501,1361292824501,1714205093,1714205093,0
1361292852,1714232700,1,64,64,1361292825930,1361292825930,1714206630,1714206630,0
1361292880,1714260708,7,2689,384.1428571,1361292853121,1361292854273,1714233829,1714234981,1152
1361292964,1714344984,1,46,46,1361292938669,1361292938669,1714319653,1714319653,0
1361292985,1714365196,3,168,56,1361292978366,1361292978494,1714358562,1714358690,128
1361292985,1714365200,4,271,67.75,1361292978876,1361292978940,1714359076,1714359140,64
1361292985,1714365268,3,168,56,1361292978422,1361292978614,1714358690,1714358882,192
1361292985,1714365272,3,168,56,1361292978673,1361292978801,1714358945,1714359073,128
1361292985,1714365304,2,110,55,1361292968211,1361292978259,1714348515,1714358563,10048
1361292988,1714369060,1,460,460,1361292960927,1361292960927,1714341987,1714341987,0
1361292996,1714377080,1,46,46,1361292968652,1361292968652,1714349732,1714349732,0
1361293004,1714385028,1,46,46,1361292977854,1361292977854,1714358882,1714358882,0
1361293004,1714385040,9,3463,384.7777778,1361292979059,1361292979507,1714360099,1714360547,448
1361293061,1714441224,1,46,46,1361293035106,1361293035106,1714415330,1714415330,0
1361293105,1714485700,2,131,65.5,1361293099716,1361293099716,1714480416,1714480416,0
1361293109,1714489460,3,655,218.3333333,1361293083063,1361293087607,1714463523,1714468067,4544
1361293109,1714489496,17,7708,453.4117647,1361293084624,1361293088400,1714465120,1714468896,3776
1361293121,1714501760,1,46,46,1361293094219,1361293094219,1714474979,1714474979,0
1361293129,1714509608,11,5880,534.5454545,1361293115042,1361293120738,1714495650,1714501346,5696
1361293137,1714517516,3,168,56,1361293129533,1361293129661,1714510049,1714510177,128
1361293137,1714517564,3,168,56,1361293129166,1361293129294,1714509730,1714509858,128
1361293137,1714517564,3,168,56,1361293129293,1361293129421,1714509857,1714509985,128
1361293137,1714517592,3,168,56,1361293129584,1361293129648,1714510176,1714510240,64
1361293145,1714525616,2,110,55,1361293129690,1361293139738,1714510306,1714520354,10048
1361293157,1714537576,1,46,46,1361293129411,1361293129411,1714509987,1714509987,0
1361293157,1714537580,17,4665,274.4117647,1361293129917,1361293155005,1714510497,1714535585,25088
1361293157,1714537584,1,52,52,1361293130297,1361293130297,1714510881,1714510881,0
1361293181,1714561712,11,4645,422.2727273,1361293152888,1361293156408,1714533600,1714537120,3520
1361293205,1714585692,2,116,58,1361293180620,1361293180812,1714561312,1714561504,192
1361293329,1714709644,2,104,52,1361293328252,1361293328444,1714708896,1714709088,192
1361293353,1714733980,1,52,52,1361293328553,1361293328553,1714709533,1714709533,0
1361293369,1714749668,7,1609,229.8571429,1361293364064,1361293364640,1714744732,1714745308,576
1361293369,1714750000,2,339,169.5,1361293342356,1361293342356,1714723356,1714723356,0
1361293422,1714802296,1,52,52,1361293396821,1361293396821,1714777117,1714777117,0
1361293434,1714814376,1,52,52,1361293408964,1361293408964,1714789340,1714789340,0
1361293465,1714845588,4,271,67.75,1361293458159,1361293458863,1714838747,1714839451,704
1361293465,1714845704,16,3306,206.625,1361293461179,1361293463099,1714841883,1714843803,1920
1361293486,1714866496,7,3438,491.1428571,1361293459469,1361293460493,1714839965,1714840989,1024
1361293486,1714866628,16,3914,244.625,1361293460936,1361293464136,1714841564,1714844764,3200
1361293490,1714870488,1,52,52,1361293462546,1361293462546,1714843034,1714843034,0
1361293505,1714885736,3,168,56,1361293503836,1361293504540,1714884572,1714885276,704
1361293513,1714893616,3,168,56,1361293506002,1361293506514,1714886618,1714887130,512
1361293513,1714893692,3,168,56,1361293505222,1361293505798,1714885914,1714886490,576
1361293522,1714902572,7,6704,957.7142857,1361293494208,1361293505664,1714874780,1714886236,11456
1361293530,1714910492,1,52,52,1361293505808,1361293505808,1714886300,1714886300,0
1361293530,1714910528,16,3914,244.625,1361293503980,1361293507692,1714884508,1714888220,3712
1361293542,1714922528,1,64,64,1361293515885,1361293515885,1714896413,1714896413,0
1361293554,1714934572,1,64,64,1361293526399,1361293526399,1714906971,1714906971,0
1361293554,1714934576,9,3463,384.7777778,1361293526777,1361293528057,1714907353,1714908633,1280
1361293593,1714973816,5,940,188,1361293582986,1361293588106,1714963802,1714968922,5120
1361293622,1715002804,3,666,222,1361293594901,1361293614933,1714975705,1714995737,20032
1361293649,1715029808,3,210,70,1361293647635,1361293648467,1715028443,1715029275,832
1361293650,1715030744,2,444,222,1361293624977,1361293634961,1715005721,1715015705,9984
1361293657,1715037820,2,158,79,1361293650055,1361293653255,1715030875,1715034075,3200
1361293673,1715053960,2,158,79,1361293659577,1361293672441,1715040537,1715053401,12864
1361293705,1715085932,3,156,52,1361293700054,1361293702486,1715080986,1715083418,2432
1361293726,1715106808,1,79,79,1361293698322,1361293698322,1715079130,1715079130,0
1361293731,1715111196,1,52,52,1361293706420,1361293706420,1715086616,1715086616,0
1361293774,1715154936,1,79,79,1361293749776,1361293749776,1715130712,1715130712,0
1361293897,1715278000,2,116,58,1361293896399,1361293896847,1715277399,1715277847,448
1361293905,1715285968,3,168,56,1361293902124,1361293902828,1715283092,1715283796,704
1361293905,1715285984,3,168,56,1361293903133,1361293903773,1715284117,1715284757,640
1361293905,1715286008,3,168,56,1361293901189,1361293901765,1715282197,1715282773,576
1361293905,1715286048,3,168,56,1361293897439,1361293897887,1715278487,1715278935,448
1361293913,1715293956,3,168,56,1361293906682,1361293907258,1715287638,1715288214,576
1361293913,1715294032,3,168,56,1361293905647,1361293906223,1715286679,1715287255,576
1361293913,1715294048,3,168,56,1361293904734,1361293905310,1715285782,1715286358,576
1361293922,1715303092,18,4016,223.1111111,1361293895025,1361293897585,1715276117,1715278677,2560
1361293922,1715303132,1,52,52,1361293897034,1361293897034,1715278166,1715278166,0
1361293931,1715311240,1,46,46,1361293904902,1361293904902,1715285142,1715285142,0
1361293934,1715315128,1,64,64,1361293907405,1361293907405,1715288533,1715288533,0
1361293961,1715342056,7,1609,229.8571429,1361293957012,1361293959316,1715338068,1715340372,2304
1361294015,1715395184,1,448,448,1361293988412,1361293988412,1715368596,1715368596,0
1361294226,1715606380,3,168,56,1361294225075,1361294225651,1715605455,1715606031,576
1361294226,1715606380,3,168,56,1361294221750,1361294223158,1715602130,1715603538,1408
1361294250,1715630392,2,116,58,1361294249383,1361294249639,1715629775,1715630031,256
1361294251,1715631968,26,7868,302.6153846,1361294224486,1361294234470,1715605454,1715615438,9984
1361294251,1715632040,1,52,52,1361294226402,1361294226402,1715607442,1715607442,0
1361294260,1715640132,1,52,52,1361294233773,1361294233773,1715613905,1715613905,0
1361294275,1715655964,1,52,52,1361294249324,1361294249324,1715630288,1715630288,0
1361294275,1715655972,1,64,64,1361294249636,1361294249636,1715630608,1715630608,0
1361294315,1715695952,3,756,252,1361294289397,1361294289653,1715670349,1715670605,256
1361294368,1715748132,1,52,52,1361294340266,1361294340266,1715720398,1715720398,0
1361294424,1715804460,9,6099,677.6666667,1361294396769,1361294398881,1715777229,1715779341,2112
1361294428,1715808376,21,3488,166.0952381,1361294399990,1361294402102,1715780366,1715782478,2112
1361294498,1715878580,6,870,145,1361294491496,1361294491624,1715872076,1715872204,128
1361294506,1715886500,7,1609,229.8571429,1361294503160,1361294503736,1715883660,1715884236,576
1361294516,1715896580,1,46,46,1361294491560,1361294491560,1715872140,1715872140,0
1361294524,1715904592,2,188,94,1361294497181,1361294497181,1715877773,1715877773,0
1361294528,1715908548,9,3463,384.7777778,1361294499910,1361294500294,1715880458,1715880842,384
1361294554,1715934604,3,168,56,1361294546702,1361294547342,1715927306,1715927946,640
1361294562,1715942452,3,168,56,1361294557863,1361294558503,1715938315,1715938955,640
1361294562,1715942496,3,168,56,1361294556924,1361294557500,1715937420,1715937996,576
1361294572,1715952548,16,3914,244.625,1361294546694,1361294550726,1715927242,1715931274,4032
1361294576,1715956540,1,52,52,1361294548497,1361294548497,1715929037,1715929037,0
1361294584,1715964656,1,64,64,1361294558619,1361294558619,1715939275,1715939275,0
1361294626,1716006520,2,131,65.5,1361294620194,1361294620194,1716000714,1716000714,0
1361294664,1716044708,1,52,52,1361294638630,1361294638630,1716019338,1716019338,0
1361294730,1716110500,3,168,56,1361294727028,1361294727796,1716107528,1716108296,768
1361294730,1716110504,3,168,56,1361294728112,1361294728752,1716108616,1716109256,640
1361294730,1716110532,3,168,56,1361294729044,1361294729684,1716109576,1716110216,640
1361294738,1716118472,3,168,56,1361294730639,1361294731279,1716111111,1716111751,640
1361294738,1716118512,3,168,56,1361294731495,1361294732135,1716112007,1716112647,640
1361294756,1716136668,1,46,46,1361294729804,1361294729804,1716110472,1716110472,0
1361294816,1716196872,2,684,342,1361294789695,1361294799743,1716170567,1716180615,10048
1361294909,1716289228,1,52,52,1361294883137,1361294883137,1716263365,1716263365,0
1361295058,1716438684,4,271,67.75,1361295057144,1361295057784,1716437828,1716438468,640
1361295058,1716438800,3,168,56,1361295056197,1361295056773,1716436997,1716437573,576
1361295066,1716446748,3,168,56,1361295058039,1361295058871,1716438787,1716439619,832
1361295074,1716454716,4,271,67.75,1361295068185,1361295068825,1716448901,1716449541,640
1361295074,1716454728,4,271,67.75,1361295069069,1361295069773,1716449797,1716450501,704
1361295082,1716462704,7,1609,229.8571429,1361295073765,1361295075365,1716454469,1716456069,1600
1361295085,1716465352,16,3915,244.6875,1361295059843,1361295062915,1716440195,1716443267,3072
1361295089,1716469388,1,52,52,1361295061087,1361295061087,1716441475,1716441475,0
1361295090,1716470704,4,220,55,1361295085605,1361295087397,1716466309,1716468101,1792
1361295090,1716470704,2,110,55,1361295070179,1361295084195,1716450883,1716464899,14016
1361295090,1716470732,4,271,67.75,1361295083209,1361295085257,1716463941,1716465989,2048
1361295090,1716470748,3,168,56,1361295081974,1361295082870,1716462722,1716463618,896
1361295098,1716478736,5,266,53.2,1361295091522,1361295094914,1716472258,1716475650,3392
1361295114,1716494784,2,104,52,1361295098644,1361295106004,1716479428,1716486788,7360
1361295121,1716501448,1,46,46,1361295094691,1361295094691,1716475139,1716475139,0
1361295149,1716529464,1,52,52,1361295120914,1361295120914,1716501378,1716501378,0
1361295213,1716593644,1,52,52,1361295185631,1361295185631,1716566275,1716566275,0
1361295266,1716646904,16,3306,206.625,1361295262360,1361295264152,1716643264,1716645056,1792
1361295285,1716665812,7,3438,491.1428571,1361295260597,1361295261685,1716641409,1716642497,1088
1361295289,1716669640,1,46,46,1361295262495,1361295262495,1716643135,1716643135,0
1361295289,1716669668,1,46,46,1361295262725,1361295262725,1716643393,1716643393,0
1361295301,1716681756,8,2741,342.625,1361295274604,1361295276076,1716655360,1716656832,1472
1361295341,1716721748,1,52,52,1361295313523,1361295313523,1716694271,1716694271,0
1361295357,1716737768,1,136,136,1361295330976,1361295330976,1716711744,1716711744,0
1361295373,1716753844,9,3463,384.7777778,1361295346578,1361295347154,1716727422,1716727998,576
1361295405,1716785908,1,52,52,1361295377363,1361295377363,1716758271,1716758271,0
1361295417,1716798108,1,52,52,1361295391690,1361295391690,1716772798,1716772798,0
1361295426,1716806988,3,168,56,1361295422018,1361295422722,1716803006,1716803710,704
1361295426,1716807016,3,168,56,1361295420389,1361295420965,1716801405,1716801981,576
1361295426,1716807056,3,168,56,1361295421245,1361295421629,1716802301,1716802685,384
1361295426,1716807100,3,168,56,1361295422868,1361295423636,1716803968,1716804736,768
1361295449,1716830040,16,3930,245.625,1361295423245,1361295426253,1716804285,1716807293,3008
1361295449,1716830080,1,64,64,1361295424616,1361295424616,1716805696,1716805696,0
1361295449,1716830080,1,52,52,1361295424615,1361295424615,1716805695,1716805695,0
1361295450,1716830156,1,46,46,1361295424707,1361295424707,1716804863,1716804863,0
1361295466,1716846972,3,168,56,1361295465299,1361295465875,1716846271,1716846847,576
1361295474,1716854968,3,168,56,1361295466199,1361295466839,1716847167,1716847807,640
1361295474,1716855052,3,210,70,1361295466688,1361295467008,1716847740,1716848060,320
1361295486,1716866204,3,756,252,1361295460498,1361295461266,1716840702,1716841470,768
1361295506,1716887012,3,168,56,1361295502506,1361295503082,1716883518,1716884094,576
1361295506,1716887040,3,168,56,1361295503374,1361295504078,1716884414,1716885118,704
1361295530,1716910128,1,52,52,1361295502365,1361295502365,1716882493,1716882493,0
1361295530,1716910132,3,240,80,1361295502619,1361295512795,1716882751,1716892927,10176
1361295542,1716922188,1,46,46,1361295516640,1361295516640,1716896828,1716896828,0
1361295542,1716922272,1,46,46,1361295515915,1361295515915,1716896187,1716896187,0
1361295594,1716974416,1,52,52,1361295569851,1361295569851,1716950267,1716950267,0
1361295667,1717047208,7,1609,229.8571429,1361295664972,1361295666188,1717045180,1717046396,1216
1361295747,1717127252,3,168,56,1361295739165,1361295739741,1717119417,1717119993,576
1361295754,1717134908,1,64,64,1361295727949,1361295727949,1717108857,1717108857,0
1361295754,1717135000,17,4079,239.9411765,1361295727923,1361295734067,1717108923,1717115067,6144
1361295758,1717138956,1,52,52,1361295730973,1361295730973,1717111929,1717111929,0
1361295766,1717146896,1,64,64,1361295739482,1361295739482,1717120378,1717120378,0
1361295855,1717235164,1,71,71,1361295828724,1361295828724,1717208888,1717208888,0
1361295915,1717295340,1,46,46,1361295887427,1361295887427,1717267767,1717267767,0
1361295975,1717355560,1,46,46,1361295946983,1361295946983,1717327543,1717327543,0
1361296115,1717495876,2,120,60,1361296087271,1361296090279,1717468147,1717471155,3008
1361296268,1717648628,3,168,56,1361296262301,1361296262877,1717642929,1717643505,576
1361296276,1717656588,14,3214,229.5714286,1361296267845,1361296269829,1717648433,1717650417,1984
1361296276,1717656608,17,5356,315.0588235,1361296273587,1361296275187,1717654195,1717655795,1600
1361296276,1717656636,17,3581,210.6470588,1361296271830,1361296273558,1717652466,1717654194,1728
1361296276,1717656676,21,8423,401.0952381,1361296269741,1361296271661,1717650417,1717652337,1920
1361296284,1717664596,22,4277,194.4090909,1361296280828,1361296282428,1717661424,1717663024,1600
1361296284,1717664636,25,4048,161.92,1361296275412,1361296278548,1717656048,1717659184,3136
1361296284,1717664668,15,3294,219.6,1361296276854,1361296278390,1717657522,1717659058,1536
1361296284,1717664684,13,3106,238.9230769,1361296278887,1361296280679,1717659571,1717661363,1792
1361296284,1717664712,14,6716,479.7142857,1361296275209,1361296276809,1717655921,1717657521,1600
1361296292,1717672424,18,4040,224.4444444,1361296265129,1361296268777,1717645553,1717649201,3648
1361296292,1717672448,8,4629,578.625,1361296265680,1361296267216,1717646128,1717647664,1536
1361296292,1717672520,1,52,52,1361296266698,1361296266698,1717647218,1717647218,0
1361296292,1717672672,3,168,56,1361296287730,1361296288434,1717668402,1717669106,704
1361296292,1717672684,3,168,56,1361296285027,1361296285539,1717665711,1717666223,512
1361296292,1717672688,3,168,56,1361296285985,1361296286689,1717666673,1717667377,704
1361296292,1717672720,61,67214,1101.868852,1361296282305,1361296285633,1717663025,1717666353,3328
1361296292,1717672724,3,168,56,1361296290558,1361296291134,1717671282,1717671858,576
1361296292,1717672752,3,168,56,1361296284130,1361296284706,1717664882,1717665458,576
1361296292,1717672760,3,168,56,1361296288666,1361296289242,1717669426,1717670002,576
1361296292,1717672764,18,3487,193.7222222,1361296285589,1361296287253,1717666353,1717668017,1664
1361296292,1717672768,3,168,56,1361296289616,1361296290192,1717670384,1717670960,576
1361296292,1717672792,16,3195,199.6875,1361296287287,1361296288951,1717668079,1717669743,1664
1361296300,1717680716,3,168,56,1361296291459,1361296292035,1717672175,1717672751,576
1361296312,1717692604,1,46,46,1361296287094,1361296287094,1717667698,1717667698,0
1361296324,1717704628,1,222,222,1361296298205,1361296298205,1717678833,1717678833,0
1361296324,1717704824,32,41637,1301.15625,1361296321754,1361296322138,1717702578,1717702962,384
1361296332,1717712716,13,3522,270.9230769,1361296327109,1361296328901,1717707825,1717709617,1792
1361296332,1717712752,15,3760,250.6666667,1361296324832,1361296326496,1717705584,1717707248,1664
1361296332,1717712752,13,3510,270,1361296328864,1361296330400,1717709616,1717711152,1536
1361296332,1717712768,19,4786,251.8947368,1361296327058,1361296328594,1717707826,1717709362,1536
1361296332,1717712768,13,3522,270.9230769,1361296327122,1361296328914,1717707890,1717709682,1792
1361296356,1717736840,9,3463,384.7777778,1361296328775,1361296329863,1717709615,1717710703,1088
1361296388,1717768856,5,1290,258,1361296379448,1361296380216,1717760304,1717761072,768
1361296400,1717780956,1,46,46,1361296375508,1361296375508,1717756464,1717756464,0
1361296404,1717784872,1,46,46,1361296375911,1361296375911,1717756783,1717756783,0
1361296452,1717832740,2,131,65.5,1361296449707,1361296449707,1717830447,1717830447,0
1361296456,1717836988,1,186,186,1361296431475,1361296431475,1717812463,1717812463,0
1361296460,1717841016,14,7676,548.2857143,1361296433237,1361296435541,1717814253,1717816557,2304
1361296533,1717913456,1,52,52,1361296507204,1361296507204,1717887660,1717887660,0
1361296580,1717960780,3,168,56,1361296577023,1361296577599,1717957803,1717958379,576
1361296593,1717973336,1,76,76,1361296568445,1361296568445,1717948781,1717948781,0
1361296597,1717977284,19,5612,295.3684211,1361296569199,1361296574511,1717949483,1717954795,5312
1361296597,1717977364,1,52,52,1361296572255,1361296572255,1717952619,1717952619,0
1361296601,1717981400,9,3499,388.7777778,1361296573755,1361296575483,1717954155,1717955883,1728
1361296620,1718000812,3,168,56,1361296618656,1361296619296,1717999468,1718000108,640
1361296620,1718000848,3,168,56,1361296617082,1361296617722,1717997930,1717998570,640
1361296620,1718000868,3,168,56,1361296616041,1361296616745,1717996909,1717997613,704
1361296620,1718000868,2,116,58,1361296619495,1361296619815,1718000363,1718000683,320
1361296628,1718008760,3,168,56,1361296620564,1361296621204,1718001324,1718001964,640
1361296628,1718008848,3,168,56,1361296621373,1361296622013,1718002221,1718002861,640
1361296628,1718008856,3,168,56,1361296622261,1361296622901,1718003117,1718003757,640
1361296628,1718008884,3,168,56,1361296623193,1361296623833,1718004077,1718004717,640
1361296645,1718025584,1,46,46,1361296618245,1361296618245,1717998829,1717998829,0
1361296645,1718025628,1,52,52,1361296620376,1361296620376,1718001004,1718001004,0
1361296660,1718040788,3,168,56,1361296657270,1361296658102,1718038058,1718038890,832
1361296660,1718040832,3,168,56,1361296656266,1361296656906,1718037098,1718037738,640
1361296660,1718040864,3,168,56,1361296654250,1361296654954,1718035114,1718035818,704
1361296660,1718040908,3,168,56,1361296655293,1361296655997,1718036201,1718036905,704
1361296681,1718061756,17,3974,233.7647059,1361296655125,1361296659925,1718035881,1718040681,4800
1361296685,1718065632,1,52,52,1361296658580,1361296658580,1718039212,1718039212,0
1361296685,1718065724,1,46,46,1361296658422,1361296658422,1718039146,1718039146,0
1361296685,1718065752,1,64,64,1361296659163,1361296659163,1718039915,1718039915,0
1361296701,1718081696,1,52,52,1361296675859,1361296675859,1718056555,1718056555,0
1361296820,1718200852,7,1609,229.8571429,1361296813235,1361296814579,1718194087,1718195431,1344
1361296820,1718200856,7,1609,229.8571429,1361296813295,1361296814639,1718194151,1718195495,1344
1361296829,1718209204,3,168,56,1361296824187,1361296824827,1718204391,1718205031,640
1361296829,1718209248,3,168,56,1361296823183,1361296823823,1718203431,1718204071,640
1361296841,1718222080,1,52,52,1361296814800,1361296814800,1718195880,1718195880,0
1361296850,1718230172,1,46,46,1361296823070,1361296823070,1718203242,1718203242,0
1361296860,1718240884,3,168,56,1361296857492,1361296858004,1718238376,1718238888,512
1361296860,1718240968,3,168,56,1361296858242,1361296858818,1718239210,1718239786,576
1361296956,1718336980,15,6668,444.5333333,1361296950004,1361296951604,1718330984,1718332584,1600
1361296956,1718337012,13,6661,512.3846154,1361296951954,1361296953106,1718332966,1718334118,1152
1361296956,1718337056,18,12918,717.6666667,1361296948904,1361296949736,1718329960,1718330792,832
1361296956,1718337056,13,6583,506.3846154,1361296950823,1361296951911,1718331879,1718332967,1088
1361296956,1718337092,13,6852,527.0769231,1361296952770,1361296953730,1718333862,1718334822,960
1361296964,1718345072,10,3842,384.2,1361296957270,1361296958550,1718338342,1718339622,1280
1361296972,1718353060,12,3971,330.9166667,1361296963042,1361296964962,1718344102,1718346022,1920
1361296978,1718358484,79,97117,1229.329114,1361296950371,1361296963939,1718330855,1718344423,13568
1361296978,1718358488,30,30303,1010.1,1361296950368,1361296964960,1718330856,1718345448,14592
1361296978,1718358564,20,8104,405.2,1361296950228,1361296969428,1718330792,1718349992,19200
1361296978,1718358564,16,7865,491.5625,1361296950228,1361296971220,1718330792,1718351784,20992
1361296980,1718360980,41,4497,109.6829268,1361296972338,1361296978162,1718353318,1718359142,5824
1361296980,1718360980,10,6221,622.1,1361296972338,1361296978162,1718353318,1718359142,5824
1361296980,1718361024,8,1280,160,1361296968840,1361296972616,1718349864,1718353640,3776
1361296980,1718361024,6,759,126.5,1361296971909,1361296977669,1718352933,1718358693,5760
1361296982,1718362540,9,3808,423.1111111,1361296954473,1361296957225,1718335013,1718337765,2752
1361296982,1718362616,16,7885,492.8125,1361296954397,1361296963933,1718335013,1718344549,9536
1361296986,1718366548,7,3447,492.4285714,1361296961121,1361296962913,1718341669,1718343461,1792
1361296988,1718368976,15,5283,352.2,1361296985591,1361296987703,1718366567,1718368679,2112
1361296988,1718369028,51,9802,192.1960784,1361296979394,1361296987010,1718360422,1718368038,7616
1361296994,1718374504,9,4009,445.4444444,1361296965965,1361296971917,1718346469,1718352421,5952
1361296994,1718374556,1,116,116,1361296968858,1361296968858,1718349414,1718349414,0
1361296994,1718374560,35,11853,338.6571429,1361296968984,1361296987544,1718349544,1718368104,18560
1361296994,1718374636,10,4417,441.7,1361296967627,1361296969483,1718348263,1718350119,1856
1361296994,1718374648,7,3509,501.2857143,1361296968575,1361296969983,1718349223,1718350631,1408
1361296994,1718374648,1,116,116,1361296968766,1361296968766,1718349414,1718349414,0
1361296994,1718374668,1,46,46,1361296968875,1361296968875,1718349543,1718349543,0
1361296996,1718377000,15,3293,219.5333333,1361296993885,1361296994461,1718374885,1718375461,576
1361296996,1718377008,2,131,65.5,1361296994390,1361296994390,1718375398,1718375398,0
1361296996,1718377016,4,624,156,1361296995023,1361296995215,1718376039,1718376231,192
1361296996,1718377048,20,5149,257.45,1361296988142,1361296991790,1718369190,1718372838,3648
1361296996,1718377088,14,6710,479.2857143,1361296991816,1361296993800,1718372904,1718374888,1984
1361296996,1718377092,2,131,65.5,1361296992388,1361296992388,1718373480,1718373480,0
1361296998,1718378624,9,3761,417.8888889,1361296970647,1361296972183,1718351271,1718352807,1536
1361297004,1718384976,51,5681,111.3921569,1361296997495,1361296999799,1718378471,1718380775,2304
1361297004,1718384988,19,4073,214.3684211,1361296996779,1361296997547,1718377767,1718378535,768
1361297004,1718385028,4,624,156,1361296996097,1361296998465,1718377125,1718379493,2368
1361297004,1718385032,78,72290,926.7948718,1361296997951,1361297002687,1718378983,1718383719,4736
1361297004,1718385064,17,3441,202.4117647,1361297002720,1361297003104,1718383784,1718384168,384
1361297004,1718385072,13,3106,238.9230769,1361296995352,1361296996440,1718376424,1718377512,1088
1361297010,1718390664,5,1108,221.6,1361296984237,1361296997805,1718364901,1718378469,13568
1361297012,1718393024,29,3793,130.7931034,1361297003526,1361297004102,1718384550,1718385126,576
1361297012,1718393060,2,381,190.5,1361297002019,1361297007907,1718383079,1718388967,5888
1361297012,1718393064,9,4008,445.3333333,1361296986462,1361297008414,1718367526,1718389478,21952
1361297012,1718393064,69,85015,1232.101449,1361296986462,1361297008414,1718367526,1718389478,21952
1361297018,1718398612,9,4912,545.7777778,1361296991075,1361296996643,1718371687,1718377255,5568
1361297020,1718400984,17,14088,828.7058824,1361297012334,1361297013806,1718393318,1718394790,1472
1361297020,1718401016,57,72935,1279.561404,1361297015820,1361297016908,1718396836,1718397924,1088
1361297022,1718402752,3,1794,598,1361296994645,1361296994773,1718375397,1718375525,128
1361297026,1718406696,14,6784,484.5714286,1361297000525,1361297006029,1718381221,1718386725,5504
1361297026,1718406700,18,9824,545.7777778,1361297001033,1361297006153,1718381733,1718386853,5120
1361297026,1718406768,3,572,190.6666667,1361296999495,1361296999559,1718380263,1718380327,64
1361297028,1718409040,35,45662,1304.628571,1361297021493,1361297027509,1718402533,1718408549,6016
1361297028,1718409044,3,172,57.33333333,1361297019955,1361297026355,1718400999,1718407399,6400
1361297028,1718409044,10,9733,973.3,1361297021746,1361297027634,1718402790,1718408678,5888
1361297028,1718409048,64,89357,1396.203125,1361297020143,1361297027631,1718401191,1718408679,7488
1361297028,1718409056,10,8136,813.6,1361297020711,1361297020967,1718401767,1718402023,256
1361297028,1718409088,21,19278,918,1361297015815,1361297024455,1718396903,1718405543,8640
1361297028,1718409088,2,98,49,1361297011525,1361297021573,1718392613,1718402661,10048
1361297028,1718409096,11,10677,970.6363636,1361297021438,1361297027518,1718402534,1718408614,6080
1361297028,1718409096,11,10098,918,1361297021438,1361297027518,1718402534,1718408614,6080
1361297028,1718409100,3,172,57.33333333,1361297019896,1361297026168,1718400996,1718407268,6272
1361297028,1718409100,3,172,57.33333333,1361297019900,1361297026364,1718401000,1718407464,6464
1361297028,1718409100,5,964,192.8,1361297020089,1361297027577,1718401189,1718408677,7488
1361297028,1718409100,17,17839,1049.352941,1361297020088,1361297027576,1718401188,1718408676,7488
1361297028,1718409104,5,1549,309.8,1361297020084,1361297027572,1718401188,1718408676,7488
1361297029,1718409128,4,1012,253,1361297023430,1361297028486,1718403558,1718408614,5056
1361297029,1718409164,2,98,49,1361297012451,1361297022499,1718392615,1718402663,10048
1361297029,1718409164,3,144,48,1361297012451,1361297022499,1718392615,1718402663,10048
1361297030,1718410632,7,3183,454.7142857,1361297001999,1361297002639,1718382631,1718383271,640
1361297030,1718410720,8,2237,279.625,1361297004727,1361297010807,1718385447,1718391527,6080
1361297034,1718414696,1,52,52,1361297008270,1361297008270,1718388966,1718388966,0
1361297034,1718414732,6,2259,376.5,1361297005930,1361297007210,1718386662,1718387942,1280
1361297034,1718414780,1,52,52,1361297008186,1361297008186,1718388966,1718388966,0
1361297036,1718416980,15,12961,864.0666667,1361297021556,1361297031668,1718402536,1718412648,10112
1361297036,1718416980,19,20246,1065.578947,1361297020018,1361297031666,1718400998,1718412646,11648
1361297036,1718417024,2,112,56,1361297019782,1361297031622,1718400806,1718412646,11840
1361297036,1718417092,2,112,56,1361297019713,1361297031553,1718400805,1718412645,11840
1361297036,1718417092,2,112,56,1361297019713,1361297031553,1718400805,1718412645,11840
1361297036,1718417096,3,164,54.66666667,1361297017278,1361297028350,1718398374,1718409446,11072
1361297036,1718417096,2,112,56,1361297017278,1361297028350,1718398374,1718409446,11072
1361297036,1718417096,2,112,56,1361297017277,1361297028349,1718398373,1718409445,11072
1361297038,1718418704,34,34069,1002.029412,1361297011911,1361297028743,1718392615,1718409447,16832
1361297038,1718418788,15,10782,718.8,1361297011890,1361297013426,1718392678,1718394214,1536
1361297038,1718418804,4,500,125,1361297011875,1361297011939,1718392679,1718392743,64
1361297042,1718422656,78,107139,1373.576923,1361297014518,1361297015926,1718395174,1718396582,1408
1361297042,1718422736,16,16435,1027.1875,1361297014437,1361297014693,1718395173,1718395429,256
1361297042,1718422740,62,86415,1393.790323,1361297014435,1361297014755,1718395175,1718395495,320
1361297042,1718422764,18,5802,322.3333333,1361297015242,1361297019402,1718396006,1718400166,4160
1361297042,1718422812,24,5228,217.8333333,1361297017562,1361297040474,1718398374,1718421286,22912
1361297044,1718425024,4,272,68,1361297042949,1361297043077,1718423973,1718424101,128
1361297044,1718425032,5,549,109.8,1361297019775,1361297040191,1718400807,1718421223,20416
1361297044,1718425068,5,1988,397.6,1361297036186,1361297041114,1718417254,1718422182,4928
1361297046,1718426624,4,500,125,1361297020247,1361297020311,1718400871,1718400935,64
1361297046,1718426628,8,3196,399.5,1361297020369,1361297028881,1718400997,1718409509,8512
1361297046,1718426788,4,500,125,1361297019955,1361297019955,1718400743,1718400743,0
1361297052,1718433048,4,272,68,1361297048175,1361297048367,1718429223,1718429415,192
1361297054,1718434648,1,52,52,1361297028798,1361297028798,1718409446,1718409446,0
1361297054,1718434648,1,52,52,1361297028798,1361297028798,1718409446,1718409446,0
1361297054,1718434648,1,52,52,1361297028798,1361297028798,1718409446,1718409446,0
1361297054,1718434648,1,52,52,1361297028862,1361297028862,1718409510,1718409510,0
1361297054,1718434648,1,52,52,1361297028797,1361297028797,1718409445,1718409445,0
1361297054,1718434652,4,500,125,1361297028923,1361297028987,1718409575,1718409639,64
1361297054,1718434732,1,52,52,1361297028713,1361297028713,1718409445,1718409445,0
1361297054,1718434732,1,52,52,1361297028713,1361297028713,1718409445,1718409445,0
1361297054,1718434732,1,52,52,1361297028713,1361297028713,1718409445,1718409445,0
1361297054,1718434732,1,52,52,1361297028713,1361297028713,1718409445,1718409445,0
1361297054,1718434732,1,52,52,1361297028712,1361297028712,1718409444,1718409444,0
1361297054,1718434736,1,52,52,1361297028711,1361297028711,1718409447,1718409447,0
1361297054,1718434736,1,52,52,1361297028775,1361297028775,1718409511,1718409511,0
1361297066,1718446652,4,500,125,1361297038777,1361297038841,1718419429,1718419493,64
1361297066,1718446656,4,500,125,1361297038967,1361297038967,1718419623,1718419623,0
1361297066,1718446736,44,43092,979.3636364,1361297038693,1361297061605,1718419429,1718442341,22912
1361297066,1718446768,2,534,267,1361297039558,1361297039558,1718420326,1718420326,0
1361297068,1718449000,36,4750,131.9444444,1361297061531,1361297062107,1718442531,1718443107,576
1361297068,1718449092,17,3352,197.1764706,1361297061187,1361297061763,1718442279,1718442855,576
1361297070,1718450772,83,99417,1197.795181,1361297044992,1361297051840,1718425764,1718432612,6848
1361297078,1718458736,11,2865,260.4545455,1361297053732,1361297060708,1718434468,1718441444,6976
1361297084,1718465056,2,131,65.5,1361297081510,1361297081510,1718462566,1718462566,0
1361297086,1718466648,8,3139,392.375,1361297057915,1361297061051,1718438563,1718441699,3136
1361297086,1718466660,4,500,125,1361297058673,1361297058673,1718439333,1718439333,0
1361297086,1718466688,2,566,283,1361297061014,1361297061142,1718441702,1718441830,128
1361297086,1718466700,8,2872,359,1361297059531,1361297062603,1718440231,1718443303,3072
1361297086,1718466728,9,4639,515.4444444,1361297058028,1361297060908,1718438756,1718441636,2880
1361297086,1718466772,4,500,125,1361297058754,1361297058818,1718439526,1718439590,64
1361297090,1718470676,9,3463,384.7777778,1361297062817,1361297063393,1718443493,1718444069,576
1361297092,1718473068,4,232,58,1361297087831,1361297088087,1718468899,1718469155,256
1361297092,1718473068,4,214,53.5,1361297087831,1361297088343,1718468899,1718469411,512
1361297092,1718473120,4,232,58,1361297087781,1361297088037,1718468901,1718469157,256
1361297092,1718473120,4,232,58,1361297087779,1361297088035,1718468899,1718469155,256
1361297093,1718473124,4,190,47.5,1361297088775,1361297089287,1718468899,1718469411,512
1361297094,1718474756,3,1548,516,1361297069647,1361297069839,1718450403,1718450595,192
1361297094,1718474840,1,52,52,1361297067454,1361297067454,1718448294,1718448294,0
1361297098,1718478788,1,52,52,1361297069937,1361297069937,1718450725,1718450725,0
1361297101,1718481132,2,104,52,1361297100417,1361297100737,1718480549,1718480869,320
1361297133,1718513132,3,168,56,1361297125825,1361297128705,1718505957,1718508837,2880
1361297154,1718535020,1,52,52,1361297129671,1361297129671,1718510691,1718510691,0
1361297154,1718535036,19,5268,277.2631579,1361297127287,1361297132727,1718508323,1718513763,5440
1361297154,1718535068,1,46,46,1361297128153,1361297128153,1718509221,1718509221,0
1361297154,1718535108,1,64,64,1361297129263,1361297129263,1718510371,1718510371,0
1361297164,1718545108,3,168,56,1361297158063,1361297158703,1718539171,1718539811,640
1361297165,1718545144,3,168,56,1361297159988,1361297160628,1718540132,1718540772,640
1361297188,1718569084,2,131,65.5,1361297182150,1361297182150,1718563234,1718563234,0
1361297188,1718569092,3,210,70,1361297180350,1361297180606,1718561442,1718561698,256
1361297188,1718569092,2,131,65.5,1361297180350,1361297180350,1718561442,1718561442,0
1361297189,1718569172,2,131,65.5,1361297183641,1361297183641,1718563813,1718563813,0
1361297223,1718603188,1,52,52,1361297197641,1361297197641,1718577829,1718577829,0
1361297230,1718611084,1,46,46,1361297204101,1361297204101,1718585185,1718585185,0
1361297231,1718611236,1,52,52,1361297204310,1361297204310,1718584546,1718584546,0
1361297235,1718615120,1,52,52,1361297209868,1361297209868,1718589988,1718589988,0
1361297235,1718615144,1,52,52,1361297210484,1361297210484,1718590628,1718590628,0
1361297239,1718619132,1,52,52,1361297212734,1361297212734,1718592866,1718592866,0
1361297244,1718625100,2,92,46,1361297242167,1361297242423,1718623267,1718623523,256
1361297245,1718625144,110,145661,1324.190909,1361296993907,1361297239155,1718374051,1718619299,245248
1361297253,1718633268,2,92,46,1361297251317,1361297251573,1718631585,1718631841,256
1361297262,1718643108,1,52,52,1361297236144,1361297236144,1718617252,1718617252,0
1361297267,1718647512,1,52,52,1361297239811,1361297239811,1718620323,1718620323,0
1361297269,1718649148,2,92,46,1361297260652,1361297260908,1718640800,1718641056,256
1361297269,1718649216,2,92,46,1361297260716,1361297260972,1718640932,1718641188,256
1361297275,1718655484,1,52,52,1361297247454,1361297247454,1718627938,1718627938,0
1361297277,1718657192,2,92,46,1361297269506,1361297269698,1718649698,1718649890,192
1361297279,1718659596,1,46,46,1361297252205,1361297252205,1718632801,1718632801,0
1361297284,1718665116,2,92,46,1361297278564,1361297278820,1718659680,1718659936,256
1361297284,1718665120,2,92,46,1361297279203,1361297279459,1718660323,1718660579,256
1361297287,1718667448,9,2935,326.1111111,1361297260994,1361297262274,1718641442,1718642722,1280
1361297287,1718667532,8,2865,358.125,1361297260911,1361297262191,1718641443,1718642723,1280
1361297287,1718667604,8,2741,342.625,1361297260261,1361297261733,1718640865,1718642337,1472
1361297295,1718675500,1,46,46,1361297269007,1361297269007,1718649507,1718649507,0
1361297300,1718681112,2,92,46,1361297298282,1361297298474,1718679394,1718679586,192
1361297307,1718687512,1,46,46,1361297279042,1361297279042,1718659554,1718659554,0
1361297327,1718707440,1,46,46,1361297299144,1361297299144,1718679584,1718679584,0
1361297327,1718707480,1,52,52,1361297301346,1361297301346,1718681826,1718681826,0
1361297365,1718745164,7,1609,229.8571429,1361297359837,1361297361053,1718740001,1718741217,1216
1361297389,1718769200,2,131,65.5,1361297382520,1361297382520,1718762720,1718762720,0
1361297389,1718769200,2,131,65.5,1361297382520,1361297382520,1718762720,1718762720,0
1361297415,1718795648,2,539,269.5,1361297386872,1361297386872,1718767520,1718767520,0
1361297415,1718795652,7,3178,454,1361297387187,1361297387571,1718767839,1718768223,384
1361297424,1718805000,1,46,46,1361297397017,1361297397017,1718778017,1718778017,0
1361297427,1718807956,1,46,46,1361297399170,1361297399170,1718780126,1718780126,0
1361297453,1718833208,3,164,54.66666667,1361297437935,1361297448623,1718818143,1718828831,10688
1361297453,1718833276,3,164,54.66666667,1361297437868,1361297449324,1718818144,1718829600,11456
1361297455,1718835640,12,4729,394.0833333,1361297430525,1361297432957,1718811165,1718813597,2432
1361297459,1718839700,1,186,186,1361297431172,1361297431172,1718811872,1718811872,0
1361297461,1718841196,2,98,49,1361297445563,1361297458043,1718825759,1718838239,12480
1361297461,1718841252,2,98,49,1361297445507,1361297457987,1718825759,1718838239,12480
1361297461,1718841252,2,98,49,1361297445506,1361297457986,1718825758,1718838238,12480
1361297463,1718843736,10,2149,214.9,1361297437408,1361297439584,1718818144,1718820320,2176
1361297463,1718843736,27,6376,236.1481481,1361297437407,1361297446879,1718818143,1718827615,9472
1361297469,1718849284,3,168,56,1361297461346,1361297461410,1718841630,1718841694,64
1361297469,1718849288,3,168,56,1361297461409,1361297461601,1718841697,1718841889,192
1361297471,1718851604,27,28688,1062.518519,1361297445156,1361297447524,1718825760,1718828128,2368
1361297471,1718851632,5,546,109.2,1361297445511,1361297445639,1718826143,1718826271,128
1361297471,1718851636,4,500,125,1361297445698,1361297445826,1718826334,1718826462,128
1361297477,1718857268,2,112,56,1361297466547,1361297476595,1718846815,1718856863,10048
1361297477,1718857336,3,176,58.66666667,1361297466480,1361297476720,1718846816,1718857056,10240
1361297485,1718865204,5,284,56.8,1361297477234,1361297483762,1718857438,1718863966,6528
1361297485,1718865208,5,284,56.8,1361297477229,1361297483757,1718857437,1718863965,6528
1361297487,1718867752,17,4665,274.4117647,1361297461647,1361297468047,1718842399,1718848799,6400
1361297487,1718867780,1,52,52,1361297462131,1361297462131,1718842911,1718842911,0
1361297491,1718871688,19,5340,281.0526316,1361297466127,1361297488015,1718846815,1718868703,21888
1361297491,1718871796,2,112,56,1361297466019,1361297486051,1718846815,1718866847,20032
1361297493,1718873228,159,214168,1346.968553,1361297472794,1361297488346,1718853022,1718868574,15552
1361297495,1718875680,16,8179,511.1875,1361297468118,1361297471894,1718848798,1718852574,3776
1361297527,1718907688,1,46,46,1361297501710,1361297501710,1718882398,1718882398,0
1361297559,1718939812,2,116,58,1361297534544,1361297534736,1718915356,1718915548,192
1361297595,1718975864,2,188,94,1361297568671,1361297568671,1718949535,1718949535,0
1361297629,1719009304,2,92,46,1361297627918,1361297628174,1719008222,1719008478,256
1361297631,1719011896,4,810,202.5,1361297603644,1361297604156,1718984540,1718985052,512
1361297647,1719027896,3,428,142.6666667,1361297620476,1361297644860,1719001372,1719025756,24384
1361297671,1719051968,4,644,161,1361297645554,1361297645746,1719026522,1719026714,192
1361297677,1719057428,2,104,52,1361297673169,1361297673425,1719053597,1719053853,256
1361297685,1719065416,2,104,52,1361297679901,1361297680093,1719060317,1719060509,192
1361297693,1719073460,2,104,52,1361297687152,1361297687408,1719067612,1719067868,256
1361297711,1719091996,1,46,46,1361297685207,1361297685207,1719066203,1719066203,0
1361297711,1719092004,1,46,46,1361297685521,1361297685521,1719066525,1719066525,0
1361297715,1719095952,1,46,46,1361297687233,1361297687233,1719068185,1719068185,0
1361297719,1719099984,7,3160,451.4285714,1361297692386,1361297692578,1719073370,1719073562,192
1361297719,1719100032,19,10146,534,1361297691954,1361297695730,1719072986,1719076762,3776
1361297813,1719193452,2,116,58,1361297811958,1361297812214,1719192410,1719192666,256
1361297832,1719212132,5,1110,222,1361297807222,1361297810038,1719187354,1719190170,2816
1361297839,1719219988,13,6567,505.1538462,1361297811548,1361297818396,1719192536,1719199384,6848
1361297839,1719220012,20,4401,220.05,1361297813764,1361297818436,1719194776,1719199448,4672
1361297839,1719220016,1,64,64,1361297813825,1361297813825,1719194841,1719194841,0
1361297839,1719220052,2,104,52,1361297812380,1361297813404,1719193432,1719194456,1024
1361297867,1719247988,1,46,46,1361297838942,1361297838942,1719219930,1719219930,0
1361297911,1719292112,1,52,52,1361297885601,1361297885601,1719266713,1719266713,0
1361297941,1719321492,2,92,46,1361297933068,1361297933324,1719313560,1719313816,256
1361297941,1719321528,7,1609,229.8571429,1361297934824,1361297936104,1719315352,1719316632,1280
1361297941,1719321612,3,168,56,1361297935379,1361297935955,1719315991,1719316567,576
1361297941,1719321616,2,131,65.5,1361297938642,1361297938642,1719319258,1719319258,0
1361297964,1719344172,1,46,46,1361297936588,1361297936588,1719316760,1719316760,0
1361297964,1719344260,1,64,64,1361297936628,1361297936628,1719316888,1719316888,0
1361298045,1719425592,16,3306,206.625,1361298039078,1361298039462,1719419670,1719420054,384
1361298064,1719444316,7,3438,491.1428571,1361298038716,1361298039036,1719419032,1719419352,320
1361298068,1719448428,1,435,435,1361298042952,1361298042952,1719423380,1719423380,0
1361298069,1719449588,3,144,48,1361298057705,1361298067753,1719438293,1719448341,10048
1361298069,1719449608,2,98,49,1361298057684,1361298067732,1719438292,1719448340,10048
1361298069,1719449660,2,98,49,1361298057634,1361298067682,1719438294,1719448342,10048
1361298072,1719452344,19,11265,592.8947368,1361298046879,1361298053471,1719427223,1719433815,6592
1361298076,1719456296,8,1286,160.75,1361298048783,1361298057551,1719429079,1719437847,8768
1361298084,1719464352,4,500,125,1361298057559,1361298057559,1719437911,1719437911,0
1361298084,1719464352,4,500,125,1361298057494,1361298057558,1719437846,1719437910,64
1361298084,1719464384,44,52452,1192.090909,1361298057911,1361298062007,1719438295,1719442391,4096
1361298084,1719464384,4,500,125,1361298058228,1361298058292,1719438612,1719438676,64
1361298084,1719464388,4,500,125,1361298058355,1361298058355,1719438743,1719438743,0
1361298085,1719465572,2,112,56,1361298060858,1361298077754,1719441430,1719458326,16896
1361298085,1719465664,2,112,56,1361298060765,1361298077661,1719441429,1719458325,16896
1361298085,1719465664,2,112,56,1361298060764,1361298077660,1719441428,1719458324,16896
1361298088,1719468448,7,518,74,1361298060980,1361298085876,1719441428,1719466324,24896
1361298093,1719473644,4,190,47.5,1361298085235,1361298085747,1719465879,1719466391,512
1361298120,1719500520,2,532,266,1361298095086,1361298095086,1719475606,1719475606,0
1361298189,1719569608,3,156,52,1361298180884,1361298186324,1719561492,1719566932,5440
1361298205,1719585616,2,104,52,1361298193610,1361298203594,1719574226,1719584210,9984
1361298229,1719609632,2,104,52,1361298213565,1361298223549,1719594197,1719604181,9984
1361298260,1719640792,1,52,52,1361298233434,1361298233434,1719614226,1719614226,0
1361298285,1719665828,5,260,52,1361298278520,1361298281912,1719659348,1719662740,3392
1361298301,1719681760,5,230,46,1361298297211,1361298300731,1719677971,1719681491,3520
1361298301,1719681768,4,184,46,1361298297908,1361298299572,1719678676,1719680340,1664
1361298301,1719681828,5,230,46,1361298297015,1361298300535,1719677843,1719681363,3520
1361298301,1719681828,5,230,46,1361298297142,1361298300662,1719677970,1719681490,3520
1361298301,1719681836,4,184,46,1361298297902,1361298299566,1719678738,1719680402,1664
1361298309,1719689784,2,92,46,1361298301539,1361298305315,1719682323,1719686099,3776
1361298309,1719689784,2,92,46,1361298301411,1361298305187,1719682195,1719685971,3776
1361298317,1719697836,2,92,46,1361298304368,1361298311920,1719685204,1719692756,7552
1361298317,1719697888,2,92,46,1361298304248,1361298311800,1719685136,1719692688,7552
1361298317,1719697888,2,92,46,1361298304378,1361298311930,1719685266,1719692818,7552
1361298325,1719705888,2,92,46,1361298312633,1361298322681,1719693521,1719703569,10048
1361298325,1719705892,2,92,46,1361298312760,1361298322744,1719693652,1719703636,9984
1361298333,1719713796,2,92,46,1361298321940,1361298331924,1719702736,1719712720,9984
1361298333,1719713872,2,92,46,1361298321932,1361298331980,1719702804,1719712852,10048
1361298333,1719713872,2,92,46,1361298321803,1361298331787,1719702675,1719712659,9984
1361298341,1719721824,5,230,46,1361298334778,1361298338490,1719715602,1719719314,3712
1361298357,1719737916,2,92,46,1361298342303,1361298350111,1719723219,1719731027,7808
1361298361,1719741124,1,46,46,1361298333431,1361298333431,1719713555,1719713555,0
1361298361,1719741212,1,46,46,1361298333407,1361298333407,1719713619,1719713619,0
1361298373,1719753880,2,92,46,1361298360193,1361298370177,1719741073,1719751057,9984
1361298469,1719849524,2,122,61,1361298443812,1361298444004,1719824336,1719824528,192
1361298501,1719881980,8,1661,207.625,1361298496540,1361298499484,1719877520,1719880464,2944
1361298501,1719882020,4,220,55,1361298495157,1361298496437,1719876177,1719877457,1280
1361298509,1719890104,4,232,58,1361298500383,1361298504607,1719881487,1719885711,4224
1361298517,1719898092,3,168,56,1361298510315,1361298511019,1719891407,1719892111,704
1361298518,1719898216,3,168,56,1361298512278,1361298512982,1719892494,1719893198,704
1361298529,1719909612,21,4494,214,1361298501450,1361298509514,1719882062,1719890126,8064
1361298533,1719914080,3,168,56,1361298530296,1361298530872,1719911376,1719911952,576
1361298533,1719914104,2,110,55,1361298519773,1361298530013,1719900877,1719911117,10240
1361298533,1719914108,3,168,56,1361298531162,1361298531802,1719912270,1719912910,640
1361298654,1720034336,3,168,56,1361298649311,1361298649887,1720029647,1720030223,576
1361298654,1720034372,3,168,56,1361298650169,1361298650745,1720030541,1720031117,576
1361298673,1720054072,1,46,46,1361298647931,1361298647931,1720029003,1720029003,0
1361298674,1720054152,7,2689,384.1428571,1361298648533,1361298649493,1720028685,1720029645,960
1361298779,1720159904,1,48,48,1361298751205,1361298751205,1720132109,1720132109,0
1361298838,1720218856,3,168,56,1361298834450,1361298835154,1720215306,1720216010,704
1361298838,1720218880,3,168,56,1361298835449,1361298835897,1720216329,1720216777,448
1361298838,1720218916,3,168,56,1361298832536,1361298833432,1720213452,1720214348,896
1361298858,1720238776,17,3982,234.2352941,1361298833187,1361298836323,1720213963,1720217099,3136
1361298862,1720242740,1,46,46,1361298833925,1361298833925,1720214665,1720214665,0
1361298862,1720242744,1,52,52,1361298834305,1361298834305,1720215049,1720215049,0
1361298862,1720242828,1,64,64,1361298836334,1361298836334,1720217162,1720217162,0
1361298870,1720250952,14,3214,229.5714286,1361298866481,1361298867953,1720247433,1720248905,1472
1361298890,1720270696,7,3438,491.1428571,1361298864883,1361298866035,1720245579,1720246731,1152
1361298914,1720294684,1,46,46,1361298889021,1361298889021,1720269705,1720269705,0
1361299039,1720419400,1,222,222,1361299013654,1361299013654,1720394054,1720394054,0
1361299070,1720450944,7,1609,229.8571429,1361299065205,1361299066421,1720446149,1720447365,1216
1361299097,1720478100,1,46,46,1361299066906,1361299066906,1720448006,1720448006,0
1361299131,1720511500,1,52,52,1361299106225,1361299106225,1720486725,1720486725,0
1361299150,1720530956,3,168,56,1361299146664,1361299147560,1720527620,1720528516,896
1361299150,1720530968,3,168,56,1361299147868,1361299148636,1720528836,1720529604,768
1361299150,1720530992,3,168,56,1361299145030,1361299145670,1720526022,1720526662,640
1361299150,1720531036,3,168,56,1361299143704,1361299144472,1720524740,1720525508,768
1361299171,1720551528,17,3966,233.2941176,1361299145043,1361299148819,1720525571,1720529347,3776
1361299171,1720551568,1,46,46,1361299146414,1361299146414,1720526982,1720526982,0
1361299175,1720555492,1,52,52,1361299146938,1361299146938,1720527430,1720527430,0
1361299175,1720555616,9,3463,384.7777778,1361299148219,1361299149627,1720528835,1720530243,1408
1361299175,1720555648,1,64,64,1361299149340,1361299149340,1720529988,1720529988,0
1361299271,1720651168,2,131,65.5,1361299269948,1361299269948,1720650116,1720650116,0
1361299535,1720915436,4,208,52,1361299530027,1361299533803,1720910463,1720914239,3776
1361299551,1720931388,2,104,52,1361299538204,1361299546844,1720918592,1720927232,8640
1361299567,1720947420,2,104,52,1361299556860,1361299566844,1720937280,1720947264,9984
1361299591,1720971448,2,104,52,1361299576797,1361299586781,1720957245,1720967229,9984
1361299837,1721217352,2,110,55,1361299811193,1361299834617,1721191545,1721214969,23424
1361299839,1721219540,3,168,56,1361299836800,1361299837440,1721217340,1721217980,640
1361299839,1721219552,3,168,56,1361299837746,1361299838130,1721218298,1721218682,384
1361299839,1721219584,2,116,58,1361299838419,1361299838739,1721219003,1721219323,320
1361299839,1721219664,3,168,56,1361299834564,1361299835140,1721215228,1721215804,576
1361299839,1721219676,3,168,56,1361299835767,1361299836407,1721216443,1721217083,640
1361299841,1721221524,18,4293,238.5,1361299814158,1361299818702,1721194682,1721199226,4544
1361299847,1721227540,3,168,56,1361299839487,1361299840319,1721220027,1721220859,832
1361299865,1721245716,1,52,52,1361299838861,1361299838861,1721219577,1721219577,0
1361299877,1721257632,8,2741,342.625,1361299849763,1361299850787,1721230395,1721231419,1024
1361299959,1721339572,3,168,56,1361299958430,1361299958494,1721339002,1721339066,64
1361299959,1721339616,2,110,55,1361299937139,1361299958387,1721317755,1721339003,21248
1361299967,1721347684,4,220,55,1361299963500,1361299965292,1721344184,1721345976,1792
1361299975,1721355672,4,813,203.25,1361299952824,1361299974520,1721333496,1721355192,21696
1361299975,1721355672,4,271,67.75,1361299972344,1361299972472,1721353016,1721353144,128
1361299975,1721355676,3,168,56,1361299972595,1361299972723,1721353271,1721353399,128
1361300001,1721381788,16,4780,298.75,1361299973445,1361299982213,1721354233,1721363001,8768
1361300063,1721443760,4,271,67.75,1361300057120,1361300057696,1721437880,1721438456,576
1361300065,1721446092,3,168,56,1361300060690,1361300061650,1721441782,1721442742,960
1361300071,1721451660,3,168,56,1361300062405,1361300063301,1721443065,1721443961,896
1361300071,1721451688,2,104,52,1361300064871,1361300065127,1721445559,1721445815,256
1361300071,1721451732,3,168,56,1361300063932,1361300064508,1721444664,1721445240,576
1361300071,1721451764,4,214,53.5,1361300064733,1361300068125,1721445497,1721448889,3392
1361300086,1721466228,11,4484,407.6363636,1361300060915,1361300080179,1721441143,1721460407,19264
1361300087,1721467756,2,104,52,1361300071842,1361300079138,1721452598,1721459894,7296
1361300090,1721470252,15,3863,257.5333333,1361300063835,1361300070043,1721444087,1721450295,6208
1361300094,1721474308,1,64,64,1361300067747,1361300067747,1721448055,1721448055,0
1361300103,1721483888,4,232,58,1361300094751,1361300097887,1721475639,1721478775,3136
1361300111,1721491868,3,168,56,1361300108018,1361300108146,1721488886,1721489014,128
1361300111,1721491952,3,168,56,1361300108063,1361300108191,1721489015,1721489143,128
1361300118,1721498336,2,539,269.5,1361300090438,1361300090438,1721470774,1721470774,0
1361300118,1721498368,1,46,46,1361300091109,1361300091109,1721471477,1721471477,0
1361300119,1721499852,12,2390,199.1666667,1361300112449,1361300113985,1721493301,1721494837,1536
1361300119,1721499856,13,3510,270,1361300112448,1361300113600,1721493304,1721494456,1152
1361300119,1721499892,2,104,52,1361300093338,1361300114778,1721474230,1721495670,21440
1361300119,1721500016,13,3510,270,1361300112287,1361300112991,1721493303,1721494007,704
1361300126,1721506368,1,64,64,1361300098406,1361300098406,1721478774,1721478774,0
1361300127,1721507888,12,3354,279.5,1361300114397,1361300120285,1721495285,1721501173,5888
1361300146,1721526460,9,3463,384.7777778,1361300121227,1361300129995,1721501687,1721510455,8768
1361300150,1721530460,1,46,46,1361300125065,1361300125065,1721505525,1721505525,0
1361300178,1721558508,1,60,60,1361300150298,1361300150298,1721530806,1721530806,0
1361300234,1721614640,7,1981,283,1361300209622,1361300233558,1721590262,1721614198,23936
1361300247,1721627868,6,447,74.5,1361300241585,1361300246001,1721622453,1721626869,4416
1361300263,1721643884,2,158,79,1361300250721,1361300260193,1721631605,1721641077,9472
1361300270,1721650692,3,849,283,1361300243486,1361300263518,1721624178,1721644210,20032
1361300306,1721686600,1,79,79,1361300279418,1361300279418,1721660018,1721660018,0
1361300342,1721722796,1,79,79,1361300317046,1361300317046,1721697842,1721697842,0
1361368542,1789922108,1,64,64,1361368514135,1361368514135,1789894243,1789894243,0
1361369817,1791197820,3,180,60,1361369789887,1361369798847,1791170707,1791179667,8960
1361370949,1792329060,2,104,52,1361370920931,1361370923939,1792300991,1792303999,3008
1361370949,1792329140,2,104,52,1361370922002,1361370925010,1792302142,1792305150,3008
1361370949,1792329144,2,104,52,1361370923088,1361370926096,1792303232,1792306240,3008
1361370949,1792329144,2,104,52,1361370923088,1361370926096,1792303232,1792306240,3008
1361370989,1792369184,3,176,58.66666667,1361370963751,1361370972839,1792343935,1792353023,9088
1361371779,1793158876,2,104,52,1361371751760,1361371755472,1793131636,1793135348,3712
1361371779,1793158912,2,104,52,1361371754282,1361371756970,1793134194,1793136882,2688
1361371779,1793158964,2,104,52,1361371753527,1361371756535,1793133491,1793136499,3008
1361371779,1793158992,2,104,52,1361371754205,1361371756893,1793134197,1793136885,2688
1361372173,1793553304,3,168,56,1361372169371,1361372170075,1793549675,1793550379,704
1361372173,1793553328,3,168,56,1361372170374,1361372171078,1793550702,1793551406,704
1361372181,1793561336,3,219,73,1361372180479,1361372180799,1793560815,1793561135,320
1361372196,1793575968,18,4618,256.5555556,1361372169261,1361372193389,1793549229,1793573357,24128
1361372196,1793576004,1,64,64,1361372171080,1361372171080,1793551084,1793551084,0
1361372196,1793576040,1,64,64,1361372169251,1361372169251,1793549291,1793549291,0
1361372197,1793577296,3,168,56,1361372191911,1361372192039,1793572207,1793572335,128
1361372197,1793577332,3,168,56,1361372195137,1361372195201,1793575469,1793575533,64
1361372197,1793577332,4,271,67.75,1361372195521,1361372195649,1793575853,1793575981,128
1361372197,1793577368,3,168,56,1361372195228,1361372195420,1793575596,1793575788,192
1361372205,1793585312,3,168,56,1361372197974,1361372198230,1793578286,1793578542,256
1361372208,1793588012,1,52,52,1361372181377,1361372181377,1793561389,1793561389,0
1361372208,1793588036,1,64,64,1361372181673,1361372181673,1793561709,1793561709,0
1361372216,1793596028,1,60,60,1361372189425,1361372189425,1793569453,1793569453,0
1361372220,1793600100,1,46,46,1361372195624,1361372195624,1793575724,1793575724,0
1361372224,1793604080,4,256,64,1361372198461,1361372219453,1793578541,1793599533,20992
1361372229,1793609424,3,168,56,1361372226661,1361372227557,1793607085,1793607981,896
1361372253,1793633372,16,4347,271.6875,1361372229655,1361372250391,1793610027,1793630763,20736
1361372253,1793633420,3,168,56,1361372248680,1361372249384,1793629100,1793629804,704
1361372253,1793633444,3,168,56,1361372249680,1361372250256,1793630124,1793630700,576
1361372256,1793636120,1,64,64,1361372228307,1361372228307,1793608427,1793608427,0
1361372256,1793636148,1,52,52,1361372231158,1361372231158,1793611306,1793611306,0
1361372268,1793648068,2,92,46,1361372240775,1361372243847,1793620843,1793623915,3072
1361372276,1793656092,1,64,64,1361372250927,1361372250927,1793631019,1793631019,0
1361372276,1793656144,15,3862,257.4666667,1361372249341,1361372255229,1793629485,1793635373,5888
1361372280,1793660428,1,46,46,1361372254881,1361372254881,1793635309,1793635309,0
1361372352,1793732416,2,512,256,1361372326826,1361372326826,1793707242,1793707242,0
1361372368,1793748424,9,3463,384.7777778,1361372343138,1361372343650,1793723562,1793724074,512
1361372416,1793796456,1,52,52,1361372389696,1361372389696,1793770152,1793770152,0
1361372469,1793849640,3,210,70,1361372463304,1361372463560,1793843944,1793844200,256
1361372472,1793852544,1,64,64,1361372445033,1361372445033,1793825577,1793825577,0
1361372472,1793852676,1,46,46,1361372447075,1361372447075,1793827751,1793827751,0
1361372472,1793852680,16,3914,244.625,1361372447585,1361372450529,1793828265,1793831209,2944
1361372476,1793856644,1,52,52,1361372448899,1361372448899,1793829543,1793829543,0
1361372480,1793860604,1,64,64,1361372455595,1361372455595,1793836199,1793836199,0
1361372525,1793905644,3,168,56,1361372517507,1361372518083,1793898151,1793898727,576
1361372525,1793905716,3,168,56,1361372518525,1361372519229,1793899241,1793899945,704
1361372544,1793924672,1,46,46,1361372519785,1361372519785,1793900457,1793900457,0
1361372544,1793924736,16,3914,244.625,1361372518118,1361372521830,1793898854,1793902566,3712
1361372548,1793928620,1,52,52,1361372520285,1361372520285,1793900905,1793900905,0
1361372548,1793928620,1,64,64,1361372520285,1361372520285,1793900905,1793900905,0
1361372549,1793929700,3,168,56,1361372543245,1361372543821,1793923945,1793924521,576
1361372549,1793929712,3,168,56,1361372544190,1361372544830,1793924902,1793925542,640
1361372557,1793937664,4,232,58,1361372545839,1361372549487,1793926503,1793930151,3648
1361372557,1793937696,3,168,56,1361372549774,1361372550158,1793930470,1793930854,384
1361372560,1793940740,1,46,46,1361372535138,1361372535138,1793915878,1793915878,0
1361372572,1793952652,1,52,52,1361372545530,1361372545530,1793926182,1793926182,0
1361372572,1793952716,16,3914,244.625,1361372544124,1361372547068,1793924840,1793927784,2944
1361372572,1793952724,1,46,46,1361372545139,1361372545139,1793925863,1793925863,0
1361372576,1793956732,1,64,64,1361372550444,1361372550444,1793931176,1793931176,0
1361372581,1793961788,11,8029,729.9090909,1361372580725,1361372580789,1793961513,1793961577,64
1361372589,1793969676,2,98,49,1361372580963,1361372580963,1793961639,1793961639,0
1361372589,1793969676,13,6797,522.8461538,1361372581089,1361372581665,1793961765,1793962341,576
1361372589,1793969728,14,11324,808.8571429,1361372581743,1361372581999,1793962471,1793962727,256
1361372589,1793969752,11,9283,843.9090909,1361372582102,1361372582294,1793962854,1793963046,192
1361372597,1793977688,7,1609,229.8571429,1361372592086,1361372592982,1793972774,1793973670,896
1361372604,1793984748,1,487,487,1361372576731,1361372576731,1793957479,1793957479,0
1361372605,1793985748,3,168,56,1361372601178,1361372601370,1793981926,1793982118,192
1361372605,1793985768,3,168,56,1361372601350,1361372601542,1793982118,1793982310,192
1361372608,1793988660,1,64,64,1361372581106,1361372581106,1793961766,1793961766,0
1361372616,1793996688,1,64,64,1361372591126,1361372591126,1793971814,1793971814,0
1361372620,1794000728,1,46,46,1361372595630,1361372595630,1793976358,1793976358,0
1361372621,1794001752,2,110,55,1361372601623,1361372614551,1793982375,1793995303,12928
1361372636,1794016720,1,64,64,1361372611765,1361372611765,1793992485,1793992485,0
1361372669,1794049852,21,3536,168.3809524,1361372661040,1361372661552,1794041892,1794042404,512
1361372680,1794060736,43,43415,1009.651163,1361372653670,1361372668454,1794034406,1794049190,14784
1361372680,1794060800,7,4144,592,1361372653351,1361372654055,1794034151,1794034855,704
1361372680,1794060804,8,5668,708.5,1361372653602,1361372654306,1794034406,1794035110,704
1361372684,1794064748,7,3438,491.1428571,1361372657431,1361372657751,1794038179,1794038499,320
1361372685,1794065808,2,131,65.5,1361372684060,1361372684060,1794064868,1794064868,0
1361372685,1794065812,2,131,65.5,1361372684314,1361372684314,1794065126,1794065126,0
1361372692,1794072780,20,22364,1118.2,1361372666297,1361372668281,1794047077,1794049061,1984
1361372701,1794081884,2,131,65.5,1361372698322,1361372698322,1794079206,1794079206,0
1361372717,1794097824,2,92,46,1361372713548,1361372713612,1794094372,1794094436,64
1361372717,1794097888,2,92,46,1361372713548,1361372713548,1794094436,1794094436,0
1361372729,1794108920,17,22287,1311,1361372703766,1361372708502,1794083686,1794088422,4736
1361372740,1794120832,12,11465,955.4166667,1361372713668,1361372714180,1794094500,1794095012,512
1361372740,1794120832,75,102184,1362.453333,1361372713667,1361372737283,1794094499,1794118115,23616
1361372741,1794120932,9,5313,590.3333333,1361372714890,1361372715466,1794094822,1794095398,576
1361372749,1794129868,2,131,65.5,1361372744031,1361372744031,1794124899,1794124899,0
1361372749,1794129872,2,131,65.5,1361372744540,1361372744540,1794125412,1794125412,0
1361372765,1794145840,2,92,46,1361372763898,1361372763898,1794144738,1794144738,0
1361372765,1794145852,8,3875,484.375,1361372749808,1361372763888,1794130660,1794144740,14080
1361372769,1794148876,9,3463,384.7777778,1361372743105,1361372743745,1794122981,1794123621,640
1361372772,1794152820,29,38004,1310.482759,1361372744657,1361372745937,1794125477,1794126757,1280
1361372772,1794152820,16,16946,1059.125,1361372744720,1361372745296,1794125540,1794126116,576
1361372789,1794169036,20,15383,769.15,1361372764767,1361372769119,1794144803,1794149155,4352
1361372789,1794169036,9,5731,636.7777778,1361372764767,1361372765343,1794144803,1794145379,576
1361372798,1794177936,2,131,65.5,1361372795458,1361372795458,1794175394,1794175394,0
1361372806,1794185892,4,223,55.75,1361372799280,1361372801904,1794179172,1794181796,2624
1361372829,1794209160,10,8401,840.1,1361372801635,1361372803363,1794181795,1794183523,1728
1361372829,1794209176,3,3128,1042.666667,1361372803217,1361372803217,1794183393,1794183393,0
1361372830,1794209964,4,271,67.75,1361372827878,1361372828006,1794207842,1794207970,128
1361372833,1794213088,16,5876,367.25,1361372805805,1361372806445,1794185893,1794186533,640
1361372833,1794213088,1,46,46,1361372805034,1361372805034,1794185122,1794185122,0
1361372833,1794213144,1,46,46,1361372805749,1361372805749,1794185893,1794185893,0
1361372838,1794217868,2,131,65.5,1361372833669,1361372833669,1794213537,1794213537,0
1361372838,1794217952,2,131,65.5,1361372836596,1361372836596,1794216548,1794216548,0
1361372870,1794249984,6,447,74.5,1361372863315,1361372867347,1794243299,1794247331,4032
1361372886,1794265992,2,158,79,1361372871626,1361372880202,1794251618,1794260194,8576
1361372902,1794281980,4,208,52,1361372898519,1361372900375,1794278499,1794280355,1856
1361372925,1794305160,1,79,79,1361372897123,1361372897123,1794277283,1794277283,0
1361372929,1794309176,1,52,52,1361372902354,1361372902354,1794282530,1794282530,0
1361372934,1794313940,7,448,64,1361372926911,1361372933759,1794306851,1794313699,6848
1361372957,1794337220,1,79,79,1361372931301,1361372931301,1794311521,1794311521,0
1361372965,1794345308,2,134,67,1361372940431,1361372954575,1794320739,1794334883,14144
1361372990,1794370024,6,381,63.5,1361372983850,1361372987498,1794363874,1794367522,3648
1361373009,1794389220,1,67,67,1361372982822,1361372982822,1794363042,1794363042,0
1361373017,1794397356,3,201,67,1361372991068,1361373014556,1794371424,1794394912,23488
1361373073,1794453252,1,67,67,1361373046018,1361373046018,1794426270,1794426270,0
1361373206,1794586072,27,18368,680.2962963,1361373196854,1361373202806,1794576926,1794582878,5952
1361373217,1794597504,1,64,64,1361373192583,1361373192583,1794573087,1794573087,0
1361373221,1794601436,16,4510,281.875,1361373195849,1361373202505,1794576285,1794582941,6656
1361373221,1794601604,1,52,52,1361373196321,1361373196321,1794576925,1794576925,0
1361373229,1794609396,51,49201,964.7254902,1361373202098,1361373227506,1794582494,1794607902,25408
1361373293,1794673824,7,2689,384.1428571,1361373265796,1361373266052,1794646620,1794646876,256
1361373301,1794681848,9,3463,384.7777778,1361373272875,1361373273451,1794653723,1794654299,576
1361373350,1794730144,2,131,65.5,1361373347691,1361373347691,1794727835,1794727835,0
1361373398,1794778228,2,131,65.5,1361373393877,1361373393877,1794774105,1794774105,0
1361373422,1794802084,4,304,76,1361373394533,1361373419045,1794774617,1794799129,24512
1361373422,1794802216,11,5880,534.5454545,1361373411490,1361373416866,1794791706,1794797082,5376
1361373430,1794810264,3,168,56,1361373426737,1361373426865,1794807001,1794807129,128
1361373430,1794810268,3,168,56,1361373426864,1361373427056,1794807132,1794807324,192
1361373454,1794834372,3,168,56,1361373448327,1361373448519,1794828699,1794828891,192
1361373454,1794834372,3,168,56,1361373448709,1361373448837,1794829081,1794829209,128
1361373454,1794834432,3,168,56,1361373447945,1361373448073,1794828377,1794828505,128
1361373454,1794834436,3,168,56,1361373448132,1361373448196,1794828568,1794828632,64
1361373462,1794842432,2,110,55,1361373448776,1361373458824,1794829208,1794839256,10048
1361373474,1794854520,1,46,46,1361373448370,1361373448370,1794828890,1794828890,0
1361373510,1794890300,4,184,46,1361373506571,1361373508299,1794886871,1794888599,1728
1361373518,1794898352,2,92,46,1361373510233,1361373514137,1794890585,1794894489,3904
1361373534,1794914360,2,92,46,1361373521935,1361373531919,1794902295,1794912279,9984
1361373566,1794946564,1,46,46,1361373541700,1361373541700,1794922264,1794922264,0
1361373687,1795066920,2,104,52,1361373661382,1361373664326,1795041302,1795044246,2944
1361373759,1795139312,7,1981,283,1361373733822,1361373749118,1795114134,1795129430,15296
1361373787,1795167284,3,849,283,1361373759192,1361373779160,1795139476,1795159444,19968
1361373815,1795195380,1,283,283,1361373789049,1361373789049,1795169429,1795169429,0
1361374344,1795724644,1,46,46,1361374317290,1361374317290,1795697934,1795697934,0
1361374559,1795939012,16,3306,206.625,1361374555676,1361374558172,1795935688,1795938184,2496
1361374567,1795946916,20,8128,406.4,1361374558332,1361374560956,1795938248,1795940872,2624
1361374567,1795946956,16,3536,221,1361374561110,1361374563158,1795941066,1795943114,2048
1361374567,1795946960,2,110,55,1361374548879,1361374559183,1795928839,1795939143,10304
1361374567,1795946960,14,6716,479.7142857,1361374565199,1361374566735,1795945159,1795946695,1536
1361374567,1795946992,3,168,56,1361374559474,1361374560050,1795939466,1795940042,576
1361374567,1795947000,19,5970,314.2105263,1361374563112,1361374564968,1795943112,1795944968,1856
1361374573,1795953540,1,46,46,1361374547659,1361374547659,1795928199,1795928199,0
1361374575,1795954932,15,3293,219.5333333,1361374566764,1361374569708,1795946696,1795949640,2944
1361374575,1795954936,2,110,55,1361374560487,1361374571687,1795940423,1795951623,11200
1361374575,1795955004,15,3198,213.2,1361374571046,1361374572838,1795951050,1795952842,1792
1361374575,1795955036,16,3935,245.9375,1361374572803,1361374574531,1795952839,1795954567,1728
1361374575,1795955036,19,3692,194.3157895,1361374565317,1361374567173,1795945353,1795947209,1856
1361374577,1795957596,18,4451,247.2777778,1361374550806,1361374563030,1795931402,1795943626,12224
1361374577,1795957636,8,3498,437.25,1361374552238,1361374553838,1795932874,1795934474,1600
1361374583,1795962968,15,3149,209.9333333,1361374580232,1361374582088,1795960200,1795962056,1856
1361374583,1795963000,17,3441,202.4117647,1361374578090,1361374580074,1795958090,1795960074,1984
1361374583,1795963012,61,67507,1106.672131,1361374574557,1361374578077,1795954569,1795958089,3520
1361374583,1795963048,15,3761,250.7333333,1361374580921,1361374582265,1795960969,1795962313,1344
1361374591,1795970912,13,3510,270,1361374583104,1361374584704,1795963016,1795964616,1600
1361374591,1795970952,13,3510,270,1361374584728,1361374586072,1795964680,1795966024,1344
1361374591,1795970964,13,3510,270,1361374583053,1361374584653,1795963017,1795964617,1600
1361374591,1795970996,19,4797,252.4736842,1361374582700,1361374584108,1795962696,1795964104,1408
1361374601,1795981560,1,60,60,1361374573497,1361374573497,1795954057,1795954057,0
1361374601,1795981584,1,60,60,1361374573791,1361374573791,1795954375,1795954375,0
1361374605,1795985524,1,60,60,1361374577307,1361374577307,1795957831,1795957831,0
1361374609,1795989640,9,3463,384.7777778,1361374583655,1361374584935,1795964295,1795965575,1280
1361374621,1796001548,2,485,242.5,1361374593477,1361374593477,1795974025,1795974025,0
1361374702,1796081960,1,222,222,1361374677262,1361374677262,1796057222,1796057222,0
1361374711,1796091104,2,131,65.5,1361374705343,1361374705343,1796085447,1796085447,0
1361374738,1796118040,3,240,80,1361374712703,1361374723327,1796092743,1796103367,10624
1361374754,1796133980,28,25896,924.8571429,1361374728508,1361374732796,1796108488,1796112776,4288
1361374767,1796147156,4,223,55.75,1361374762635,1361374766731,1796142791,1796146887,4096
1361374783,1796163172,11,4875,443.1818182,1361374776504,1361374776824,1796156676,1796156996,320
1361374786,1796166052,78,100413,1287.346154,1361374761008,1361374783216,1796141060,1796163268,22208
1361374794,1796174020,14,10417,744.0714286,1361374767120,1361374768656,1796147140,1796148676,1536
1361374794,1796174108,13,9418,724.4615385,1361374766841,1361374767993,1796146949,1796148101,1152
1361374799,1796179036,2,131,65.5,1361374798083,1361374798083,1796178119,1796178119,0
1361374799,1796179040,2,131,65.5,1361374798525,1361374798525,1796178565,1796178565,0
1361374802,1796182084,26,31195,1199.807692,1361374776913,1361374777361,1796156997,1796157445,448
1361374810,1796190072,1,285,285,1361374785182,1361374785182,1796165254,1796165254,0
1361374814,1796194016,18,21334,1185.222222,1361374788374,1361374811542,1796168390,1796191558,23168
1361374814,1796194092,10,5506,550.6,1361374786122,1361374786762,1796166214,1796166854,640
1361374822,1796202112,1,52,52,1361374794358,1361374794358,1796174470,1796174470,0
1361374823,1796203088,2,131,65.5,1361374816782,1361374816782,1796196870,1796196870,0
1361374831,1796211052,2,92,46,1361374823217,1361374823217,1796203269,1796203269,0
1361374846,1796226488,21,23896,1137.904762,1361374819708,1361374829436,1796200196,1796209924,9728
1361374850,1796230376,8,5120,640,1361374822956,1361374833324,1796203332,1796213700,10368
1361374858,1796238436,1,46,46,1361374833199,1361374833199,1796213635,1796213635,0
1361374858,1796238436,10,7594,759.4,1361374833327,1361374849775,1796213763,1796230211,16448
1361374871,1796251084,6,447,74.5,1361374863630,1361374868110,1796243714,1796248194,4480
1361374879,1796259128,2,131,65.5,1361374878757,1361374878757,1796258885,1796258885,0
1361374879,1796259136,7,1609,229.8571429,1361374872538,1361374873050,1796252674,1796253186,512
1361374879,1796259136,7,1609,229.8571429,1361374872477,1361374873053,1796252613,1796253189,576
1361374879,1796259212,7,1609,229.8571429,1361374873040,1361374873680,1796253252,1796253892,640
1361374898,1796278496,1,52,52,1361374873267,1361374873267,1796253763,1796253763,0
1361374898,1796278568,1,79,79,1361374872362,1361374872362,1796252930,1796252930,0
1361374898,1796278572,15,4293,286.2,1361374872934,1361374878950,1796253506,1796259522,6016
1361374942,1796322568,9,3463,384.7777778,1361374914797,1361374916077,1796295365,1796296645,1280
1361374954,1796334540,9,5280,586.6666667,1361374928647,1361374929799,1796309187,1796310339,1152
1361374967,1796347404,2,131,65.5,1361374959951,1361374959951,1796340355,1796340355,0
1361374974,1796354528,2,116,58,1361374947026,1361374947218,1796327554,1796327746,192
1361375015,1796395424,4,247,61.75,1361375010425,1361375011129,1796390849,1796391553,704
1361375031,1796411492,3,168,56,1361375030007,1361375030135,1796410499,1796410627,128
1361375031,1796411492,3,168,56,1361375029750,1361375029878,1796410242,1796410370,128
1361375031,1796411492,3,168,56,1361375029878,1361375030006,1796410370,1796410498,128
1361375031,1796411492,3,168,56,1361375030198,1361375030326,1796410690,1796410818,128
1361375039,1796419536,2,131,65.5,1361375035978,1361375035978,1796416514,1796416514,0
1361375047,1796427444,3,168,56,1361375040614,1361375040742,1796421058,1796421186,128
1361375047,1796427516,3,168,56,1361375040414,1361375040542,1796420930,1796421058,128
1361375047,1796427520,3,168,56,1361375040667,1361375040731,1796421187,1796421251,64
1361375047,1796427552,2,110,55,1361375030265,1361375042745,1796410817,1796423297,12480
1361375055,1796435008,1,46,46,1361375030616,1361375030616,1796410624,1796410624,0
1361375059,1796438908,1,52,52,1361375031614,1361375031614,1796411522,1796411522,0
1361375059,1796438988,17,4572,268.9411765,1361375031212,1361375037932,1796411200,1796417920,6720
1361375063,1796443492,3,168,56,1361375062452,1361375062580,1796442944,1796443072,128
1361375067,1796446936,3,168,56,1361375062816,1361375062880,1796442752,1796442816,64
1361375067,1796447060,1,64,64,1361375041254,1361375041254,1796421314,1796421314,0
1361375091,1796470912,1,64,64,1361375063162,1361375063162,1796443074,1796443074,0
1361375103,1796483620,4,244,61,1361375097782,1361375100790,1796478402,1796481410,3008
1361375111,1796490948,1,46,46,1361375083283,1361375083283,1796463231,1796463231,0
1361375135,1796515100,2,104,52,1361375110715,1361375129275,1796490815,1796509375,18560
1361375159,1796539724,3,168,56,1361375153293,1361375153421,1796534017,1796534145,128
1361375159,1796539724,3,168,56,1361375153483,1361375153611,1796534207,1796534335,128
1361375159,1796539724,3,168,56,1361375153674,1361375153866,1796534398,1796534590,192
1361375159,1796539728,3,168,56,1361375153864,1361375153928,1796534592,1796534656,64
1361375159,1796539728,3,168,56,1361375153992,1361375154184,1796534720,1796534912,192
1361375179,1796559304,1,52,52,1361375152046,1361375152046,1796532350,1796532350,0
1361375179,1796559376,19,4503,237,1361375151209,1361375155497,1796531585,1796535873,4288
1361375179,1796559424,1,46,46,1361375153913,1361375153913,1796534337,1796534337,0
1361375183,1796563612,3,168,56,1361375175420,1361375175484,1796556032,1796556096,64
1361375191,1796571468,1,52,52,1361375165898,1361375165898,1796546366,1796546366,0
1361375199,1796579660,4,238,59.5,1361375175501,1361375192589,1796556161,1796573249,17088
1361375239,1796619496,22,15968,725.8181818,1361375213677,1361375223021,1796594173,1796603517,9344
1361375243,1796623452,23,10744,467.1304348,1361375222874,1361375234650,1796603326,1796615102,11776
1361375243,1796623552,48,56832,1184,1361375217335,1361375223415,1796597887,1796603967,6080
1361375251,1796631524,50,62468,1249.36,1361375223442,1361375228434,1796603966,1796608958,4992
1361375259,1796639640,18,13325,740.2777778,1361375234526,1361375256670,1796615166,1796637310,22144
1361375264,1796644116,19,18159,955.7368421,1361375242282,1361375259114,1796622398,1796639230,16832
1361375272,1796652004,2,92,46,1361375263962,1361375263962,1796643966,1796643966,0
1361375280,1796660000,2,141,70.5,1361375277407,1361375277407,1796657407,1796657407,0
1361375283,1796663600,9,10924,1213.777778,1361375256708,1361375256708,1796637308,1796637308,0
1361375288,1796668044,2,131,65.5,1361375280241,1361375280241,1796660285,1796660285,0
1361375291,1796671488,7,4343,620.4285714,1361375263413,1361375263669,1796643901,1796644157,256
1361375296,1796676052,2,131,65.5,1361375294123,1361375294123,1796674175,1796674175,0
1361375299,1796679596,11,5877,534.2727273,1361375273418,1361375274122,1796654014,1796654718,704
1361375307,1796687640,9,3463,384.7777778,1361375279007,1361375279583,1796659647,1796660223,576
1361375312,1796692000,2,131,65.5,1361375304733,1361375304733,1796684733,1796684733,0
1361375356,1796735908,1,283,283,1361375329976,1361375329976,1796709884,1796709884,0
1361375360,1796740156,14,3214,229.5714286,1361375358530,1361375359042,1796738686,1796739198,512
1361375380,1796759884,7,2689,384.1428571,1361375353935,1361375354319,1796733819,1796734203,384
1361375384,1796763952,7,3438,491.1428571,1361375358094,1361375358414,1796738046,1796738366,320
1361375408,1796788200,9,5284,587.1111111,1361375382163,1361375382611,1796762363,1796762811,448
1361375408,1796788244,3,210,70,1361375399785,1361375400041,1796780029,1796780285,256
1361375408,1796788292,2,113,56.5,1361375404538,1361375404538,1796784830,1796784830,0
1361375416,1796796224,2,131,65.5,1361375412603,1361375412603,1796792827,1796792827,0
1361375420,1796800000,1,285,285,1361375394650,1361375394650,1796774650,1796774650,0
1361375424,1796804228,2,113,56.5,1361375423670,1361375423670,1796803898,1796803898,0
1361375428,1796808004,1,46,46,1361375400855,1361375400855,1796780859,1796780859,0
1361375444,1796824256,1,46,46,1361375417755,1361375417755,1796798011,1796798011,0
1361375444,1796824280,27,25638,949.5555556,1361375417797,1361375430085,1796798077,1796810365,12288
1361375448,1796828152,1,46,46,1361375423749,1361375423749,1796803901,1796803901,0
1361375448,1796828152,18,18341,1018.944444,1361375423813,1361375424197,1796803965,1796804349,384
1361375448,1796828164,35,36573,1044.942857,1361375420984,1361375442488,1796801148,1796822652,21504
1361375448,1796828512,7,1609,229.8571429,1361375442524,1361375443420,1796823036,1796823932,896
1361375456,1796836192,10,7007,700.7,1361375430237,1361375438877,1796810429,1796819069,8640
1361375464,1796844416,2,131,65.5,1361375459965,1361375459965,1796840381,1796840381,0
1361375472,1796852536,2,131,65.5,1361375468546,1361375468546,1796849082,1796849082,0
1361375480,1796860596,11,5880,534.5454545,1361375470984,1361375476424,1796851580,1796857020,5440
1361375488,1796868548,2,92,46,1361375486518,1361375486518,1796867066,1796867066,0
1361375489,1796869672,3,159,53,1361375487419,1361375487419,1796868091,1796868091,0
1361375504,1796884440,10,5564,556.4,1361375477665,1361375478177,1796858105,1796858617,512
1361375504,1796884632,3,179,59.66666667,1361375503138,1361375503138,1796883770,1796883770,0
1361375512,1796892340,24,11941,497.5416667,1361375486853,1361375492997,1796867193,1796873337,6144
1361375512,1796892348,31,33612,1084.258065,1361375487743,1361375506879,1796868091,1796887227,19136
1361375512,1796892524,2,131,65.5,1361375508109,1361375508109,1796888633,1796888633,0
1361375520,1796900304,17,9450,555.8823529,1361375493033,1361375505769,1796873337,1796886073,12736
1361375520,1796900436,1,46,46,1361375492837,1361375492837,1796873273,1796873273,0
1361375528,1796908516,16,16643,1040.1875,1361375503255,1361375504087,1796883771,1796884603,832
1361375528,1796908640,2,131,65.5,1361375522650,1361375522650,1796903290,1796903290,0
1361375544,1796924548,7,4702,671.7142857,1361375523893,1361375537909,1796904441,1796918457,14016
1361375552,1796932412,3,667,222.3333333,1361375527486,1361375528638,1796907898,1796909050,1152
1361375552,1796932620,4,271,67.75,1361375551149,1361375551469,1796931769,1796932089,320
1361375552,1796932668,19,13200,694.7368421,1361375550910,1361375551230,1796931578,1796931898,320
1361375552,1796932668,17,13430,790,1361375551357,1361375551741,1796932025,1796932409,384
1361375556,1796936372,17,7843,461.3529412,1361375528100,1361375530724,1796908472,1796911096,2624
1361375560,1796940568,10,6374,637.4,1361375552354,1361375552482,1796932922,1796933050,128
1361375560,1796940604,10,6623,662.3,1361375551934,1361375552126,1796932538,1796932730,192
1361375572,1796952512,1,46,46,1361375545946,1361375545946,1796926458,1796926458,0
1361375576,1796956636,10,5622,562.2,1361375550877,1361375551709,1796931513,1796932345,832
1361375576,1796956756,2,127,63.5,1361375573092,1361375573092,1796953848,1796953848,0
1361375580,1796960472,7,2845,406.4285714,1361375552258,1361375552514,1796932730,1796932986,256
1361375580,1796960544,11,4447,404.2727273,1361375552185,1361375553081,1796932729,1796933625,896
1361375584,1796964652,4,184,46,1361375580429,1361375580429,1796961081,1796961081,0
1361375584,1796964664,2,131,65.5,1361375581697,1361375581697,1796962361,1796962361,0
1361375608,1796988504,9,3463,384.7777778,1361375580578,1361375581090,1796961082,1796961594,512
1361375616,1796996500,3,730,243.3333333,1361375587941,1361375588261,1796968441,1796968761,320
1361375620,1797000508,1,46,46,1361375593759,1361375593759,1796974267,1796974267,0
1361375624,1797004504,1,46,46,1361375597535,1361375597535,1796978039,1796978039,0
1361375624,1797004504,27,25306,937.2592593,1361375597535,1361375623519,1796978039,1797004023,25984
1361375624,1797004504,1,46,46,1361375597535,1361375597535,1796978039,1796978039,0
1361375624,1797004504,1,52,52,1361375597856,1361375597856,1796978360,1796978360,0
1361375624,1797004568,2,828,414,1361375596256,1361375596320,1796976824,1796976888,64
1361375624,1797004732,3,159,53,1361375620668,1361375620732,1797001400,1797001464,64
1361375649,1797028876,2,131,65.5,1361375643286,1361375643286,1797023162,1797023162,0
1361375649,1797029024,86,111219,1293.244186,1361375621439,1361375623039,1797001463,1797003063,1600
1361375649,1797029152,11,7552,686.5454545,1361375623426,1361375648130,1797003578,1797028282,24704
1361375673,1797052928,6,2249,374.8333333,1361375655969,1361375668769,1797035897,1797048697,12800
1361375681,1797061008,2,92,46,1361375679438,1361375679438,1797059446,1797059446,0
1361375685,1797064976,11,5649,513.5454545,1361375658031,1361375658607,1797038007,1797038583,576
1361375688,1797068868,2,131,65.5,1361375687731,1361375687731,1797068599,1797068599,0
1361375704,1797084820,2,131,65.5,1361375700642,1361375700642,1797081462,1797081462,0
1361375705,1797085088,17,8316,489.1764706,1361375679360,1361375703552,1797059448,1797083640,24192
1361375729,1797108892,15,4194,279.6,1361375712259,1361375725635,1797092151,1797105527,13376
1361375733,1797113156,8,4138,517.25,1361375708283,1361375709243,1797088439,1797089399,960
1361375733,1797113232,1,191,191,1361375707696,1361375707696,1797087928,1797087928,0
1361375745,1797125164,1,46,46,1361375718833,1361375718833,1797098997,1797098997,0
1361375745,1797125216,11,5591,508.2727273,1361375718782,1361375719294,1797098998,1797099510,512
1361375752,1797132876,2,131,65.5,1361375748652,1361375748652,1797129528,1797129528,0
1361375753,1797133136,30,22120,737.3333333,1361375725391,1361375745359,1797105527,1797125495,19968
1361375769,1797149144,14,11757,839.7857143,1361375744712,1361375746504,1797124856,1797126648,1792
1361375769,1797149220,1,46,46,1361375744634,1361375744634,1797124854,1797124854,0
1361375773,1797153212,10,7671,767.1,1361375746436,1361375746948,1797126648,1797127160,512
1361375777,1797156896,2,131,65.5,1361375770749,1361375770749,1797150645,1797150645,0
1361375777,1797157132,2,503,251.5,1361375749011,1361375750419,1797129143,1797130551,1408
1361375801,1797180908,2,92,46,1361375793073,1361375793329,1797172981,1797173237,256
1361375801,1797180924,2,127,63.5,1361375798946,1361375798946,1797178870,1797178870,0
1361375805,1797185348,12,6862,571.8333333,1361375779580,1361375780540,1797159928,1797160888,960
1361375809,1797188968,4,254,63.5,1361375801846,1361375802166,1797181814,1797182134,320
1361375809,1797189000,2,113,56.5,1361375803861,1361375803861,1797183861,1797183861,0
1361375817,1797197004,2,131,65.5,1361375810898,1361375810898,1797190902,1797190902,0
1361375821,1797201444,5,889,177.8,1361375796571,1361375797083,1797177015,1797177527,512
1361375861,1797241392,2,116,58,1361375836814,1361375837070,1797217206,1797217462,256
1361375861,1797241444,1,46,46,1361375836440,1361375836440,1797216884,1797216884,0
1361375913,1797293552,1,193,193,1361375887340,1361375887340,1797267892,1797267892,0
1361375913,1797293560,4,649,162.25,1361375888099,1361375888419,1797268659,1797268979,320
1361376017,1797397140,7,1609,229.8571429,1361376012613,1361376013829,1797392753,1797393969,1216
1361376033,1797413020,1519,1884346,1240.517446,1361375629437,1361375730301,1797009457,1797110321,100864
1361376097,1797477156,4,294,73.5,1361376090934,1361376091190,1797471090,1797471346,256
1361376105,1797485080,4,184,46,1361376099136,1361376099136,1797479216,1797479216,0
1361376126,1797505936,9,3463,384.7777778,1361376099280,1361376099920,1797479216,1797479856,640
1361376154,1797533948,1,52,52,1361376128900,1361376128900,1797508848,1797508848,0
1361376166,1797546012,2,489,244.5,1361376141701,1361376141701,1797521713,1797521713,0
1361376225,1797605240,3,210,70,1361376219552,1361376219808,1797599792,1797600048,256
1361376246,1797626184,1,52,52,1361376220054,1361376220054,1797600238,1797600238,0
1361376346,1797726304,3,554,184.6666667,1361376319647,1361376320223,1797699951,1797700527,576
1361376422,1797802400,3,389,129.6666667,1361376395773,1361376396285,1797776173,1797776685,512
1361376502,1797882608,1,46,46,1361376475885,1361376475885,1797856493,1797856493,0
1361376506,1797886584,4,460,115,1361376479170,1361376479682,1797859754,1797860266,512
1361376574,1797954684,1,52,52,1361376547744,1361376547744,1797928428,1797928428,0
1361376778,1798158000,3,138,46,1361376775495,1361376775559,1798155495,1798155559,64
1361376799,1798179552,2,384,192,1361376774112,1361376774240,1798154664,1798154792,128
1361376803,1798183516,18,9715,539.7222222,1361376775363,1361376779139,1798155879,1798159655,3776
1361377016,1798396040,2,489,244.5,1361376989338,1361376989338,1798369378,1798369378,0
1361377044,1798424104,1,52,52,1361377019549,1361377019549,1798399653,1798399653,0
1361377066,1798446484,3,138,46,1361377062751,1361377062751,1798443235,1798443235,0
1361377066,1798446504,5,230,46,1361377059977,1361377060233,1798440481,1798440737,256
1361377088,1798468364,23,8953,389.2608696,1361377063190,1361377084950,1798443554,1798465314,21760
1361377088,1798468392,8,2741,342.625,1361377060346,1361377061434,1798440738,1798441826,1088
1361377090,1798470544,5,230,46,1361377086307,1361377086499,1798466851,1798467043,192
1361377092,1798472496,4,627,156.75,1361377064531,1361377082131,1798445027,1798462627,17600
1361377112,1798492592,9,3463,384.7777778,1361377086704,1361377087920,1798467296,1798468512,1216
1361377136,1798516500,2,188,94,1361377110159,1361377110159,1798490659,1798490659,0
1361377152,1798532588,9,5719,635.4444444,1361377124980,1361377125556,1798505568,1798506144,576
1361377152,1798532592,35,29533,843.8,1361377125170,1361377132018,1798505762,1798512610,6848
1361377156,1798536532,21,24705,1176.428571,1361377128879,1361377131631,1798509411,1798512163,2752
1361377160,1798540560,46,49656,1079.478261,1361377134162,1361377154962,1798514722,1798535522,20800
1361377160,1798540636,9,5048,560.8888889,1361377134085,1361377134277,1798514721,1798514913,192
1361377162,1798542624,2,131,65.5,1361377155473,1361377155473,1798536097,1798536097,0
1361377170,1798550532,2,131,65.5,1361377162030,1361377162030,1798542562,1798542562,0
1361377172,1798552556,8,1451,181.375,1361377144277,1361377145813,1798524833,1798526369,1536
1361377172,1798552564,1,191,191,1361377144653,1361377144653,1798525217,1798525217,0
1361377204,1798584624,9,9781,1086.777778,1361377176015,1361377188111,1798556639,1798568735,12096
1361377204,1798584636,1,46,46,1361377178502,1361377178502,1798559138,1798559138,0
1361377204,1798584636,22,19320,878.1818182,1361377178564,1361377187396,1798559200,1798568032,8832
1361377208,1798588604,11,5475,497.7272727,1361377182308,1361377182756,1798562912,1798563360,448
1361377210,1798590584,2,131,65.5,1361377207738,1361377207738,1798588322,1798588322,0
1361377212,1798592600,60,81368,1356.133333,1361377184170,1361377184490,1798564770,1798565090,320
1361377212,1798592640,1,46,46,1361377187200,1361377187200,1798567840,1798567840,0
1361377212,1798592716,8,5447,680.875,1361377187187,1361377187571,1798567903,1798568287,384
1361377218,1798598464,2,131,65.5,1361377212913,1361377212913,1798593377,1798593377,0
1361377218,1798598576,2,131,65.5,1361377217343,1361377217343,1798597919,1798597919,0
1361377218,1798598584,2,131,65.5,1361377217722,1361377217722,1798598306,1798598306,0
1361377226,1798606460,2,92,46,1361377224627,1361377224627,1798605087,1798605087,0
1361377226,1798606532,2,92,46,1361377224556,1361377224556,1798605088,1798605088,0
1361377249,1798628940,34,36136,1062.823529,1361377220859,1361377238011,1798600799,1798617951,17152
1361377253,1798632872,10,7108,710.8,1361377225280,1361377236608,1798605152,1798616480,11328
1361377253,1798632952,18,15542,863.4444444,1361377225199,1361377249135,1798605151,1798629087,23936
1361377253,1798632956,33,46013,1394.333333,1361377225322,1361377225322,1798605278,1798605278,0
1361377273,1798652992,11,5674,515.8181818,1361377247303,1361377247815,1798627295,1798627807,512
1361377274,1798654540,4,223,55.75,1361377265954,1361377267810,1798646494,1798648350,1856
1361377274,1798654572,8,3174,396.75,1361377261570,1361377270402,1798642142,1798650974,8832
1361377282,1798662576,2,131,65.5,1361377277182,1361377277182,1798657758,1798657758,0
1361377285,1798665124,1,46,46,1361377260549,1361377260549,1798640673,1798640673,0
1361377293,1798672964,7,3071,438.7142857,1361377268066,1361377268322,1798648030,1798648286,256
1361377293,1798672968,15,10749,716.6,1361377268382,1361377272990,1798648350,1798652958,4608
1361377297,1798677000,42,53043,1262.928571,1361377270847,1361377276287,1798650847,1798656287,5440
1361377297,1798677028,19,16745,881.3157895,1361377270948,1361377283620,1798650976,1798663648,12672
1361377306,1798686656,2,131,65.5,1361377302318,1361377302318,1798682974,1798682974,0
1361377322,1798702516,4,2167,541.75,1361377296697,1361377315577,1798677213,1798696093,18880
1361377322,1798702552,2,113,56.5,1361377315287,1361377315287,1798695839,1798695839,0
1361377337,1798717052,1,46,46,1361377309450,1361377309450,1798689502,1798689502,0
1361377337,1798717052,10,5593,559.3,1361377309449,1361377310217,1798689501,1798690269,768
1361377346,1798726644,2,131,65.5,1361377339642,1361377339642,1798720286,1798720286,0
1361377365,1798744988,3,665,221.6666667,1361377338376,1361377338632,1798718364,1798718620,256
1361377365,1798745024,13,4854,373.3846154,1361377338855,1361377341351,1798718879,1798721375,2496
1361377410,1798790628,4,184,46,1361377408201,1361377408201,1798788829,1798788829,0
1361377425,1798805376,16,1215,75.9375,1361377397124,1361377398148,1798777500,1798778524,1024
1361377425,1798805384,11,2935,266.8181818,1361377397567,1361377398911,1798777951,1798779295,1344
1361377425,1798805420,9,1539,171,1361377398491,1361377414363,1798778911,1798794783,15872
1361377429,1798809432,3,528,176,1361377404621,1361377411469,1798785053,1798791901,6848
1361377433,1798813584,9,3463,384.7777778,1361377408565,1361377409781,1798789149,1798790365,1216
1361377458,1798838608,2,113,56.5,1361377456222,1361377456222,1798836830,1798836830,0
1361377485,1798865604,1,46,46,1361377459426,1361377459426,1798840030,1798840030,0
1361377517,1798897692,2,188,94,1361377488969,1361377488969,1798869661,1798869661,0
1361377530,1798910700,2,131,65.5,1361377529473,1361377529473,1798910173,1798910173,0
1361377589,1798969708,318,348913,1097.210692,1361377275894,1361377286070,1798656602,1798666778,10176
1361377598,1798977888,4,604,151,1361377571817,1361377572585,1798951705,1798952473,768
1361377634,1799014780,2,127,63.5,1361377631342,1361377631342,1799012122,1799012122,0
1361377642,1799022744,2,92,46,1361377637779,1361377638035,1799018523,1799018779,256
1361377666,1799045880,1,46,46,1361377639474,1361377639474,1799019354,1799019354,0
1361377682,1799061972,1,52,52,1361377654551,1361377654551,1799034523,1799034523,0
1361377747,1799127016,8,2459,307.375,1361377741928,1361377743208,1799121944,1799123224,1280
1361377787,1799166980,2,141,70.5,1361377786827,1361377786827,1799166807,1799166807,0
1361377814,1799194260,1,89,89,1361377786803,1361377786803,1799167063,1799167063,0
1361377842,1799222320,1,285,285,1361377817271,1361377817271,1799197591,1799197591,0
1361377898,1799278532,1,52,52,1361377872100,1361377872100,1799252632,1799252632,0
1361377950,1799330448,2,489,244.5,1361377922739,1361377922739,1799303187,1799303187,0
1361378030,1799410732,4,376,94,1361378005529,1361378009305,1799386261,1799390037,3776
1361378082,1799462628,3,389,129.6666667,1361378056961,1361378080129,1799437589,1799460757,23168
1361378107,1799487368,4,184,46,1361378104835,1361378104835,1799485203,1799485203,0
1361378107,1799487440,12,3350,279.1666667,1361378103803,1361378104379,1799484243,1799484819,576
1361378130,1799510688,1,283,283,1361378103874,1361378103874,1799484562,1799484562,0
1361378130,1799510696,9,3463,384.7777778,1361378104570,1361378105082,1799485266,1799485778,512
1361378187,1799567672,4,184,46,1361378180180,1361378180180,1799560852,1799560852,0
1361378199,1799579052,3,391,130.3333333,1361378174142,1361378185534,1799554194,1799565586,11392
1361378207,1799586940,8,3264,408,1361378180973,1361378181485,1799560913,1799561425,512
1361378227,1799607748,2,131,65.5,1361378224900,1361378224900,1799605648,1799605648,0
1361378235,1799614976,2,335,167.5,1361378206858,1361378225866,1799586834,1799605842,19008
1361378283,1799663116,3,144,48,1361378258106,1361378259834,1799638222,1799639950,1728
1361378335,1799715064,2,337,168.5,1361378307630,1361378307630,1799687694,1799687694,0
1361378395,1799775052,5,725,145,1361378369593,1361378390521,1799749645,1799770573,20928
1361378447,1799827132,1,46,46,1361378421289,1361378421289,1799801421,1799801421,0
1361378503,1799883272,3,391,130.3333333,1361378475996,1361378488988,1799856268,1799869260,12992
1361378631,1800011300,3,537,179,1361378602945,1361378603521,1799983245,1799983821,576
1361378741,1800121104,1,48,48,1361378714947,1361378714947,1800095051,1800095051,0
1361378788,1800168744,6,276,46,1361378780034,1361378780034,1800160778,1800160778,0
1361378788,1800168760,19,4785,251.8421053,1361378781170,1361378782002,1800161930,1800162762,832
1361378788,1800168796,15,3759,250.6,1361378779982,1361378780750,1800160778,1800161546,768
1361378788,1800168828,13,3510,270,1361378781100,1361378782316,1800161928,1800163144,1216
1361378788,1800168828,12,3458,288.1666667,1361378781100,1361378781932,1800161928,1800162760,832
1361378795,1800175796,2,487,243.5,1361378768012,1361378768012,1800148808,1800148808,0
1361378808,1800187880,9,3463,384.7777778,1361378783202,1361378783778,1800163082,1800163658,576
1361378867,1800247796,1,52,52,1361378841420,1361378841420,1800222216,1800222216,0
1361378877,1800257608,1,46,46,1361378849926,1361378849926,1800230534,1800230534,0
1361378909,1800289100,2,131,65.5,1361378903297,1361378903297,1800283397,1800283397,0
1361378965,1800345048,20,3490,174.5,1361378962230,1361378962742,1800342278,1800342790,512
1361378965,1800345056,15,3483,232.2,1361378964142,1361378964526,1800344198,1800344582,384
1361378965,1800345124,21,8168,388.952381,1361378962731,1361378963947,1800342855,1800344071,1216
1361378973,1800353028,64,68187,1065.421875,1361378968008,1361378970760,1800348036,1800350788,2752
1361378973,1800353040,17,5354,314.9411765,1361378964607,1361378965375,1800344647,1800345415,768
1361378973,1800353040,33,4336,131.3939394,1361378965695,1361378966527,1800345735,1800346567,832
1361378973,1800353044,14,3247,231.9285714,1361378966075,1361378966587,1800346119,1800346631,512
1361378973,1800353068,15,3198,213.2,1361378967009,1361378967457,1800347077,1800347525,448
1361378973,1800353072,15,3889,259.2666667,1361378967454,1361378967966,1800347526,1800348038,512
1361378973,1800353072,17,3435,202.0588235,1361378970717,1361378971421,1800350789,1800351493,704
1361378973,1800353108,14,6710,479.2857143,1361378965434,1361378966010,1800345542,1800346118,576
1361378973,1800353152,17,3241,190.6470588,1361378971469,1361378972045,1800351621,1800352197,576
1361378988,1800367896,7,3438,491.1428571,1361378961421,1361378961741,1800341317,1800341637,320
1361378988,1800367928,2,188,94,1361378962093,1361378962093,1800342021,1800342021,0
1361378988,1800368012,1,64,64,1361378962201,1361378962201,1800342213,1800342213,0
1361378988,1800368012,1,64,64,1361378962072,1361378962072,1800342084,1800342084,0
1361378988,1800368016,1,64,64,1361378962263,1361378962263,1800342279,1800342279,0
1361378988,1800368016,6,384,64,1361378962263,1361378967447,1800342279,1800347463,5184
1361379008,1800388012,1,46,46,1361378983192,1361378983192,1800363204,1800363204,0
1361379096,1800476048,1,52,52,1361379069365,1361379069365,1800449413,1800449413,0
1361383067,1804447660,2,671,335.5,1361383039251,1361383039315,1804419911,1804419975,64
1361383069,1804449440,7,811,115.8571429,1361383064049,1361383064561,1804444489,1804445001,512
1361383093,1804473444,853,42934,50.33294256,1361383083435,1361383089067,1804463879,1804469511,5632
1361383095,1804475656,2,265,132.5,1361383070679,1361383070743,1804451335,1804451399,64
1361383099,1804479632,4,1342,335.5,1361383074158,1361383098030,1804454790,1804478662,23872
1361383101,1804481468,742,37412,50.42048518,1361383089045,1361383094485,1804469513,1804474953,5440
1361383101,1804481472,819,41329,50.46275946,1361383094480,1361383100304,1804474952,1804480776,5824
1361383109,1804489532,871,43909,50.41216992,1361383100308,1361383106132,1804480840,1804486664,5824
1361383109,1804489540,67,3940,58.80597015,1361383106187,1361383107147,1804486727,1804487687,960
1361383133,442827208,1,46,46,1361383108179,1361383108179,442802387,442802387,0
1361383136,1804515860,1,46,46,1361383110962,1361383110962,1804490822,1804490822,0
1361383136,1804515928,4,186,46.5,1361383110127,1361383110191,1804490055,1804490119,64
1361383137,442831188,1,46,46,1361383109222,1361383109222,442803410,442803410,0
1361383141,1804521460,6,654,109,1361383137116,1361383137628,1804517576,1804518088,512
1361383141,1804521536,6,738,123,1361383137164,1361383137292,1804517700,1804517828,128
1361383141,1804521540,5,686,137.2,1361383137228,1361383137356,1804517768,1804517896,128
1361383149,1804529436,3,140,46.66666667,1361383137009,1361383142385,1804517445,1804522821,5376
1361383149,1804529464,3,351,117,1361383137302,1361383142422,1804517766,1804522886,5120
1361383149,1804529464,3,351,117,1361383137302,1361383142422,1804517766,1804522886,5120
1361383149,1804529464,3,142,47.33333333,1361383137366,1361383142422,1804517830,1804522886,5056
1361383152,1804531936,4,1342,335.5,1361383124006,1361383147110,1804503942,1804527046,23104
1361383152,1804532004,2,265,132.5,1361383126754,1361383126818,1804506758,1804506822,64
1361383157,1804537604,4,562,140.5,1361383152714,1361383152778,1804533318,1804533382,64
1361383157,1804537612,19,6682,351.6842105,1361383137152,1361383152512,1804517764,1804533124,15360
1361383161,442855232,5,1141,228.2,1361383136184,1361383152312,442830416,442846544,16128
1361383163,1804543844,8,6508,813.5,1361383135772,1361383152412,1804516616,1804533256,16640
1361383165,442859252,9,10334,1148.222222,1361383137508,1361383137572,442831760,442831824,64
1361383173,1804553472,7,811,115.8571429,1361383167822,1361383168206,1804548294,1804548678,384
1361383173,1804553476,67,3940,58.80597015,1361383165388,1361383166028,1804545864,1804546504,640
1361383173,1804553480,68,3992,58.70588235,1361383168519,1361383169479,1804548999,1804549959,960
1361383173,1804553556,68,3986,58.61764706,1361383167802,1361383168442,1804548358,1804548998,640
1361383173,1804553568,68,3986,58.61764706,1361383171884,1361383172844,1804552452,1804553412,960
1361383173,1804553592,67,3940,58.80597015,1361383169428,1361383171796,1804550020,1804552388,2368
1361383173,1804553596,69,4038,58.52173913,1361383165970,1361383166546,1804546566,1804547142,576
1361383173,1804553600,62,3711,59.85483871,1361383164687,1361383165199,1804545287,1804545799,512
1361383173,1804553604,68,3986,58.61764706,1361383166538,1361383167626,1804547142,1804548230,1088
1361383181,1804561468,74,4263,57.60810811,1361383174034,1361383174674,1804554502,1804555142,640
1361383181,1804561500,59,3573,60.55932203,1361383174644,1361383175540,1804555144,1804556040,896
1361383181,1804561512,61,3664,60.06557377,1361383172967,1361383173927,1804553479,1804554439,960
1361383189,1804569572,928,46862,50.49784483,1361383175529,1361383182057,1804556101,1804562629,6528
1361383189,1804569588,927,46492,50.15318231,1361383182106,1361383188250,1804562694,1804568838,6144
1361383197,1804577556,987,49523,50.17527862,1361383188347,1361383194939,1804568903,1804575495,6592
1361383200,1804579964,1,46,46,1361383173450,1361383173450,1804553414,1804553414,0
1361383204,1804583936,2,671,335.5,1361383176036,1361383176036,1804555972,1804555972,0
1361383205,1804585600,928,46601,50.21659483,1361383194957,1361383201805,1804575557,1804582405,6848
1361383205,1804585604,69,4032,58.43478261,1361383201863,1361383202759,1804582467,1804583363,896
1361383208,1804588008,2,265,132.5,1361383182685,1361383182749,1804562693,1804562757,64
1361383221,1804601544,16,6124,382.75,1361383206597,1361383220229,1804587141,1804600773,13632
1361383221,1804601576,6,654,109,1361383219365,1361383219813,1804599941,1804600389,448
1361383221,1804601576,6,738,123,1361383219428,1361383219556,1804600004,1804600132,128
1361383229,1804609516,4,562,140.5,1361383228003,1361383228067,1804608519,1804608583,64
1361383229,1804609552,3,142,47.33333333,1361383222718,1361383228414,1804603270,1804608966,5696
1361383229,1804609556,2,94,47,1361383219257,1361383224313,1804599813,1804604869,5056
1361383229,1804609580,3,351,117,1361383219424,1361383225312,1804600004,1804605892,5888
1361383236,1804615948,2,671,335.5,1361383210265,1361383210265,1804590213,1804590213,0
1361383237,1804617564,17,6705,394.4117647,1361383219440,1361383234928,1804600004,1804615492,15488
1361383237,1804617576,3,142,47.33333333,1361383228388,1361383233444,1804608964,1804614020,5056
1361383246,442939512,3,1047,349,1361383219465,1361383228233,442912977,442921745,8768
1361383246,442939576,7,10240,1462.857143,1361383220617,1361383220617,442914193,442914193,0
1361383256,1804636060,3,1351,450.3333333,1361383228073,1361383228393,1804608133,1804608453,320
1361383264,1804644296,10,1719,171.9,1361383239229,1361383244093,1804619525,1804624389,4864
1361383264,1804644332,2,265,132.5,1361383237593,1361383237657,1804617925,1804617989,64
1361383269,1804649588,252,13599,53.96428571,1361383264601,1361383266457,1804645189,1804647045,1856
1361383277,1804657500,60,3624,60.4,1361383272368,1361383274352,1804652868,1804654852,1984
1361383277,1804657604,60,3619,60.31666667,1361383271305,1361383272265,1804651909,1804652869,960
1361383277,1804657656,701,35528,50.68188302,1361383266453,1361383271189,1804647109,1804651845,4736
1361383277,1804657684,50,3159,63.18,1361383274170,1361383274874,1804654854,1804655558,704
1361383285,1804665564,873,44144,50.56586483,1361383274993,1361383280881,1804655557,1804661445,5888
1361383293,1804673508,835,42063,50.3748503,1361383285096,1361383290984,1804665604,1804671492,5888
1361383293,1804673624,643,32920,51.19751166,1361383280885,1361383284917,1804661509,1804665541,4032
1361383296,1804676000,1,78,78,1361383270564,1361383270564,1804650564,1804650564,0
1361383300,1804680124,2,671,335.5,1361383275304,1361383275304,1804655428,1804655428,0
1361383301,1804681616,814,41020,50.39312039,1361383290877,1361383297149,1804671493,1804677765,6272
1361383309,1804689556,63,3762,59.71428571,1361383306361,1361383307321,1804686917,1804687877,960
1361383309,1804689632,672,33775,50.26041667,1361383297132,1361383301996,1804677764,1804682628,4864
1361383309,1804689636,595,30575,51.38655462,1361383302055,1361383306279,1804682691,1804686915,4224
1361383320,1804699992,2,265,132.5,1361383293612,1361383293676,1804673604,1804673668,64
1361383325,1804705520,6,738,123,1361383324506,1361383324570,1804705026,1804705090,64
1361383325,1804705600,5,608,121.6,1361383324364,1361383324812,1804704964,1804705412,448
1361383333,1804713512,14,6029,430.6428571,1361383309348,1361383325028,1804689860,1804705540,15680
1361383333,1804713512,2,94,47,1361383324322,1361383330338,1804704834,1804710850,6016
1361383333,1804713548,4,562,140.5,1361383329728,1361383329792,1804710276,1804710340,64
1361383333,1804713600,3,142,47.33333333,1361383324429,1361383330317,1804705029,1804710917,5888
1361383336,1804716056,4,1342,335.5,1361383310443,1361383334251,1804690499,1804714307,23808
1361383341,1804721520,17,6588,387.5294118,1361383324509,1361383340061,1804705029,1804720581,15552
1361383341,1804721600,3,351,117,1361383328717,1361383334285,1804709317,1804714885,5568
1361383349,1804729628,74,4389,59.31081081,1361383345005,1361383345581,1804725633,1804726209,576
1361383349,1804729660,57,3480,61.05263158,1361383345614,1361383346638,1804726274,1804727298,1024
1361383349,1804729668,57,3481,61.07017544,1361383346694,1361383347334,1804727362,1804728002,640
1361383350,443043544,3,1047,349,1361383324524,1361383329324,443018068,443022868,4800
1361383350,443043568,7,10240,1462.857143,1361383325650,1361383325714,443019218,443019282,64
1361383352,1804732048,1,46,46,1361383325362,1361383325362,1804705410,1804705410,0
1361383356,1804736056,3,1350,450,1361383329261,1361383330093,1804709317,1804710149,832
1361383357,1804737604,792,40161,50.70833333,1361383347463,1361383352839,1804728067,1804733443,5376
1361383365,1804745648,813,41228,50.71094711,1361383352857,1361383358169,1804733505,1804738817,5312
1361383372,1804751964,22662,1145798,50.56032124,1361382772421,1361383064965,1804152385,1804444929,292544
1361383373,1804753580,995,51002,51.25829146,1361383358239,1361383369311,1804738819,1804749891,11072
1361383376,1804756052,2,265,132.5,1361383349488,1361383349552,1804729540,1804729604,64
1361383381,1804761616,3,995,331.6666667,1361383375292,1361383375356,1804755908,1804755972,64
1361383389,1804769640,959,48144,50.20229406,1361383375330,1361383381922,1804755970,1804762562,6592
1361383397,1804777600,1020,51293,50.2872549,1361383381961,1361383388937,1804762561,1804769537,6976
1361383397,1804777644,978,48835,49.93353783,1361383388960,1361383396256,1804769604,1804776900,7296
1361383404,1804784108,9,2246,249.5555556,1361383378166,1361383402550,1804758274,1804782658,24384
1361383405,1804785564,1103,54835,49.71441523,1361383396399,1361383404207,1804776963,1804784771,7808
1361383429,1804809564,5,692,138.4,1361383428654,1361383428846,1804809218,1804809410,192
1361383432,1804812188,14,6029,430.6428571,1361383406951,1361383429799,1804787139,1804809987,22848
1361383432,1804812200,2,265,132.5,1361383405401,1361383405465,1804785601,1804785665,64
1361383434,443127656,2,94,47,1361383429818,1361383434938,443123474,443128594,5120
1361383437,443130964,2,94,47,1361383429511,1361383434631,443123475,443128595,5120
1361383437,1804817580,3,140,46.66666667,1361383428447,1361383434399,1804809027,1804814979,5952
1361383437,1804817580,10,5939,593.9,1361383429727,1361383430175,1804810307,1804810755,448
1361383437,1804817620,6,654,109,1361383435060,1361383435188,1804815680,1804815808,128
1361383437,1804817620,6,738,123,1361383435060,1361383435188,1804815680,1804815808,128
1361383437,1804817620,3,351,117,1361383428853,1361383434357,1804809473,1804814977,5504
1361383437,1804817648,2,94,47,1361383429340,1361383435420,1804809988,1804816068,6080
1361383437,1804817648,6,3614,602.3333333,1361383429465,1361383429593,1804810113,1804810241,128
1361383437,1804817652,6,654,109,1361383428503,1361383429143,1804809155,1804809795,640
1361383437,1804817656,6,2745,457.5,1361383429969,1361383430161,1804810625,1804810817,192
1361383437,1804817688,4,562,140.5,1361383434481,1361383434545,1804815169,1804815233,64
1361383445,1804825576,2,92,46,1361383435488,1361383441440,1804816064,1804822016,5952
1361383445,1804825632,3,142,47.33333333,1361383435114,1361383440362,1804815746,1804820994,5248
1361383445,1804825652,7,751,107.2857143,1361383435416,1361383441112,1804816068,1804821764,5696
1361383445,1804825712,2,94,47,1361383434968,1361383440280,1804815680,1804820992,5312
1361383453,1804833576,31,11959,385.7741935,1361383428898,1361383445538,1804809474,1804826114,16640
1361383453,1804833660,7,3724,532,1361383431632,1361383445712,1804812292,1804826372,14080
1361383454,443147656,3,1047,349,1361383428349,1361383435069,443122005,443128725,6720
1361383456,1804836180,1,46,46,1361383429295,1361383429295,1804809475,1804809475,0
1361383456,1804836220,5,3625,725,1361383429767,1361383429959,1804809987,1804810179,192
1361383458,443151752,4,798,199.5,1361383430172,1361383430940,443123924,443124692,768
1361383458,443151752,42,58583,1394.833333,1361383430171,1361383430747,443123923,443124499,576
1361383458,443151760,7,10240,1462.857143,1361383430997,1361383430997,443124757,443124757,0
1361383460,1804840160,7,2902,414.5714286,1361383433728,1361383435328,1804813888,1804815488,1600
1361383460,1804840172,13,6964,535.6923077,1361383434550,1361383457078,1804814722,1804837250,22528
1361383460,1804840200,6,3732,622,1361383435737,1361383435801,1804815937,1804816001,64
1361383460,1804840292,1,46,46,1361383435455,1361383435455,1804815747,1804815747,0
1361383464,1804844180,2,671,335.5,1361383438702,1361383438702,1804818882,1804818882,0
1361383464,1804844216,36,48232,1339.777778,1361383435848,1361383435976,1804816064,1804816192,128
1361383469,1804849604,2,94,47,1361383464711,1361383464775,1804845315,1804845379,64
1361383469,1804849640,2,94,47,1361383466403,1361383466403,1804847043,1804847043,0
1361383485,443178964,3,140,46.66666667,1361383477961,1361383483145,443171925,443177109,5184
1361383485,443178972,3,140,46.66666667,1361383477951,1361383483135,443171923,443177107,5184
1361383485,443178988,5,707,141.4,1361383484719,1361383484783,443178707,443178771,64
1361383485,1804865620,3,140,46.66666667,1361383477748,1361383482932,1804858368,1804863552,5184
1361383485,1804865656,4,404,101,1361383482513,1361383484753,1804863169,1804865409,2240
1361383485,1804865660,3,410,136.6666667,1361383482831,1361383482895,1804863491,1804863555,64
1361383485,1804865696,6,1942,323.6666667,1361383484008,1361383484136,1804864704,1804864832,128
1361383485,1804865696,3,140,46.66666667,1361383477608,1361383482792,1804858304,1804863488,5184
1361383485,1804865728,3,140,46.66666667,1361383478216,1361383483848,1804858944,1804864576,5632
1361383485,1804865732,5,654,130.8,1361383478660,1361383483524,1804859392,1804864256,4864
1361383485,1804865740,6,1942,323.6666667,1361383482239,1361383482367,1804862979,1804863107,128
1361383485,1804865740,3,923,307.6666667,1361383482237,1361383482301,1804862977,1804863041,64
1361383485,1804865764,4,404,101,1361383482407,1361383482471,1804863171,1804863235,64
1361383488,1804868192,2,265,132.5,1361383460706,1361383460770,1804840898,1804840962,64
1361383492,1804872232,15,2064,137.6,1361383465145,1361383466809,1804845377,1804847041,1664
1361383492,1804872268,12,3955,329.5833333,1361383466452,1361383468500,1804846720,1804848768,2048
1361383492,1804872268,5,433,86.6,1361383466452,1361383466772,1804846720,1804847040,320
1361383492,1804872272,40,34844,871.1,1361383467088,1361383489104,1804847360,1804869376,22016
1361383492,1804872384,9,3477,386.3333333,1361383466657,1361383466849,1804847041,1804847233,192
1361383493,443186964,3,140,46.66666667,1361383481992,1361383487112,443175956,443181076,5120
1361383493,443186964,3,140,46.66666667,1361383482567,1361383488071,443176531,443182035,5504
1361383493,443186964,2,94,47,1361383482631,1361383488071,443176595,443182035,5440
1361383493,443186964,2,94,47,1361383482695,1361383488071,443176659,443182035,5376
1361383493,443186968,2,94,47,1361383484742,1361383489990,443178710,443183958,5248
1361383493,443186972,2,94,47,1361383481153,1361383487105,443175125,443181077,5952
1361383493,443186972,2,94,47,1361383481153,1361383487105,443175125,443181077,5952
1361383493,443186972,2,94,47,1361383481281,1361383487105,443175253,443181077,5824
1361383493,443186972,3,140,46.66666667,1361383482622,1361383488062,443176594,443182034,5440
1361383493,443186972,2,94,47,1361383482626,1361383488066,443176598,443182038,5440
1361383493,443186972,2,94,47,1361383482690,1361383488066,443176662,443182038,5376
1361383493,443186972,2,94,47,1361383482690,1361383488066,443176662,443182038,5376
1361383493,443186972,2,94,47,1361383482690,1361383488066,443176662,443182038,5376
1361383493,443186972,2,94,47,1361383482754,1361383488066,443176726,443182038,5312
1361383493,443186976,3,140,46.66666667,1361383483133,1361383489213,443177109,443183189,6080
1361383493,443186976,2,94,47,1361383479867,1361383485115,443173843,443179091,5248
1361383493,1804873604,7,2368,338.2857143,1361383483590,1361383485830,1804864194,1804866434,2240
1361383493,1804873604,3,140,46.66666667,1361383485252,1361383490692,1804865856,1804871296,5440
1361383493,1804873608,3,138,46,1361383485378,1361383490690,1804865986,1804871298,5312
1361383493,1804873612,3,419,139.6666667,1361383485629,1361383485757,1804866241,1804866369,128
1361383493,1804873612,2,94,47,1361383484092,1361383489724,1804864704,1804870336,5632
1361383493,1804873612,5,507,101.4,1361383484092,1361383485372,1804864704,1804865984,1280
1361383493,1804873612,4,659,164.75,1361383480380,1361383486716,1804860992,1804867328,6336
1361383493,1804873616,3,140,46.66666667,1361383480633,1361383485881,1804861249,1804866497,5248
1361383493,1804873616,3,140,46.66666667,1361383480632,1361383485880,1804861248,1804866496,5248
1361383493,1804873616,3,140,46.66666667,1361383480632,1361383485880,1804861248,1804866496,5248
1361383493,1804873644,7,3190,455.7142857,1361383481501,1361383491677,1804862145,1804872321,10176
1361383493,1804873644,2,94,47,1361383481628,1361383486876,1804862272,1804867520,5248
1361383493,1804873648,2,94,47,1361383481881,1361383487897,1804862529,1804868545,6016
1361383493,1804873648,2,94,47,1361383482136,1361383487896,1804862784,1804868544,5760
1361383493,1804873652,2,94,47,1361383482901,1361383488725,1804863553,1804869377,5824
1361383493,1804873684,4,186,46.5,1361383483511,1361383490935,1804864195,1804871619,7424
1361383493,1804873684,4,404,101,1361383485172,1361383485364,1804865856,1804866048,192
1361383493,1804873688,4,404,101,1361383485361,1361383485553,1804866049,1804866241,192
1361383493,1804873692,3,140,46.66666667,1361383480302,1361383485806,1804860994,1804866498,5504
1361383493,1804873692,3,140,46.66666667,1361383480557,1361383485805,1804861249,1804866497,5248
1361383493,1804873696,3,140,46.66666667,1361383480555,1361383485803,1804861251,1804866499,5248
1361383493,1804873696,3,140,46.66666667,1361383480555,1361383485803,1804861251,1804866499,5248
1361383493,1804873696,4,188,47,1361383480809,1361383489833,1804861505,1804870529,9024
1361383493,1804873724,4,598,149.5,1361383478734,1361383489166,1804859458,1804869890,10432
1361383493,1804873728,2,94,47,1361383481802,1361383487754,1804862530,1804868482,5952
1361383493,1804873728,2,94,47,1361383487178,1361383492618,1804867906,1804873346,5440
1361383493,1804873728,3,140,46.66666667,1361383482312,1361383488008,1804863040,1804868736,5696
1361383493,1804873728,9,585,65,1361383482376,1361383487944,1804863104,1804868672,5568
1361383493,1804873732,11,2454,223.0909091,1361383482183,1361383488199,1804862915,1804868931,6016
1361383493,1804873732,5,664,132.8,1361383482310,1361383492422,1804863042,1804873154,10112
1361383496,1804876260,9,3182,353.5555556,1361383468573,1361383468637,1804848833,1804848897,64
1361383496,1804876280,8,899,112.375,1361383468616,1361383468680,1804848896,1804848960,64
1361383500,1804880224,6,2054,342.3333333,1361383472129,1361383491201,1804852353,1804871425,19072
1361383500,1804880456,3,405,135,1361383473818,1361383479898,1804854274,1804860354,6080
1361383501,443194988,2,94,47,1361383492079,1361383497967,443186067,443191955,5888
1361383501,443194992,2,94,47,1361383489454,1361383494958,443183446,443188950,5504
1361383501,1804881596,2,94,47,1361383491596,1361383496780,1804872192,1804877376,5184
1361383501,1804881600,2,94,47,1361383491848,1361383497736,1804872448,1804878336,5888
1361383501,1804881600,2,94,47,1361383491847,1361383497735,1804872447,1804878335,5888
1361383501,1804881612,15,11384,758.9333333,1361383477755,1361383494011,1804858367,1804874623,16256
1361383501,1804881612,13,2760,212.3076923,1361383480635,1361383499899,1804861247,1804880511,19264
1361383501,1804881616,8,2248,281,1361383489209,1361383494713,1804869825,1804875329,5504
1361383501,1804881644,6,1676,279.3333333,1361383478813,1361383498909,1804859457,1804879553,20096
1361383501,1804881652,5,1492,298.4,1361383482901,1361383495317,1804863553,1804875969,12416
1361383501,1804881672,2,94,47,1361383491519,1361383496639,1804872191,1804877311,5120
1361383501,1804881676,3,459,153,1361383485246,1361383494974,1804865922,1804875650,9728
1361383501,1804881680,11,5598,508.9090909,1361383483898,1361383499194,1804864578,1804879874,15296
1361383501,1804881684,2,94,47,1361383488692,1361383494644,1804869376,1804875328,5952
1361383501,1804881684,4,659,164.75,1361383488756,1361383494964,1804869440,1804875648,6208
1361383501,1804881712,14,9112,650.8571429,1361383478169,1361383495577,1804858881,1804876289,17408
1361383501,1804881724,6,962,160.3333333,1361383481677,1361383499533,1804862401,1804880257,17856
1361383502,443195776,87,102192,1174.62069,1361383477317,1361383490309,443171093,443184085,12992
1361383504,1804884280,3,296,98.66666667,1361383477960,1361383478024,1804858240,1804858304,64
1361383504,1804884320,4,918,229.5,1361383478560,1361383489440,1804858880,1804869760,10880
1361383504,1804884324,3,296,98.66666667,1361383479004,1361383479900,1804859328,1804860224,896
1361383504,1804884324,4,1868,467,1361383479067,1361383488923,1804859391,1804869247,9856
1361383504,1804884324,52,70490,1355.576923,1361383479003,1361383490203,1804859327,1804870527,11200
1361383504,1804884400,20,24896,1244.8,1361383478416,1361383488080,1804858816,1804868480,9664
1361383504,1804884400,57,81065,1422.192982,1361383478416,1361383488976,1804858816,1804869376,10560
1361383506,443199732,77,107792,1399.896104,1361383478191,1361383487919,443171923,443181651,9728
1361383506,443199732,4,623,155.75,1361383478191,1361383478191,443171923,443171923,0
1361383506,443199732,4,736,184,1361383478191,1361383478447,443171923,443172179,256
1361383506,443199732,4,736,184,1361383478191,1361383478447,443171923,443172179,256
1361383506,443199732,14,17519,1251.357143,1361383478191,1361383478191,443171923,443171923,0
1361383506,443199760,55,58909,1071.072727,1361383480149,1361383481365,443173909,443175125,1216
1361383506,443199760,6,2457,409.5,1361383480212,1361383480276,443173972,443174036,64
1361383506,443199760,4,634,158.5,1361383480212,1361383480468,443173972,443174228,256
1361383506,443199760,19,18368,966.7368421,1361383480148,1361383481364,443173908,443175124,1216
1361383506,443199760,10,1807,180.7,1361383480147,1361383480339,443173907,443174099,192
1361383506,443199764,4,2416,604,1361383481102,1361383481358,443174866,443175122,256
1361383506,443199764,9,10235,1137.222222,1361383481102,1361383481358,443174866,443175122,256
1361383506,443199768,14,17910,1279.285714,1361383481101,1361383481357,443174869,443175125,256
1361383506,443199768,14,17184,1227.428571,1361383481355,1361383481419,443175123,443175187,64
1361383506,443199784,8,8301,1037.625,1361383478140,1361383480252,443171924,443174036,2112
1361383506,443199784,13,15202,1169.384615,1361383478140,1361383478140,443171924,443171924,0
1361383506,443199796,11,6073,552.0909091,1361383480050,1361383491570,443173846,443185366,11520
1361383506,443199808,18,15370,853.8888889,1361383480100,1361383481316,443173908,443175124,1216
1361383506,443199808,14,8170,583.5714286,1361383480099,1361383481315,443173907,443175123,1216
1361383506,443199808,3,1382,460.6666667,1361383480163,1361383480227,443173971,443174035,64
1361383506,443199808,7,4796,685.1428571,1361383480163,1361383480355,443173971,443174163,192
1361383506,443199808,6,5315,885.8333333,1361383480163,1361383480163,443173971,443173971,0
1361383506,443199808,14,17493,1249.5,1361383480163,1361383480227,443173971,443174035,64
1361383506,443199808,11,3353,304.8181818,1361383480226,1361383492258,443174034,443186066,12032
1361383506,443199816,12,13847,1153.916667,1361383481054,1361383481310,443174870,443175126,256
1361383506,443199816,11,12390,1126.363636,1361383481307,1361383481371,443175123,443175187,64
1361383508,1804888280,8,1828,228.5,1361383480967,1361383489223,1804861247,1804869503,8256
1361383508,1804888280,11,2258,205.2727273,1361383480967,1361383489287,1804861247,1804869567,8320
1361383508,1804888280,4,1004,251,1361383480967,1361383489863,1804861247,1804870143,8896
1361383508,1804888284,11,2258,205.2727273,1361383480967,1361383491079,1804861251,1804871363,10112
1361383508,1804888304,40,28409,710.225,1361383481713,1361383502129,1804862017,1804882433,20416
1361383508,1804888308,9,9579,1064.333333,1361383482157,1361383482349,1804862465,1804862657,192
1361383508,1804888312,13,5664,435.6923077,1361383482537,1361383490601,1804862849,1804870913,8064
1361383508,1804888312,5,1495,299,1361383482791,1361383485607,1804863103,1804865919,2816
1361383508,1804888340,5,1885,377,1361383482764,1361383485836,1804863104,1804866176,3072
1361383508,1804888348,5,367,73.4,1361383483779,1361383486659,1804864127,1804867007,2880
1361383508,1804888348,4,274,68.5,1361383483843,1361383487683,1804864191,1804868031,3840
1361383508,1804888356,24,13870,577.9166667,1361383480573,1361383480957,1804860929,1804861313,384
1361383508,1804888388,46,40119,872.1521739,1361383480863,1361383490079,1804861251,1804870467,9216
1361383508,1804888388,8,1828,228.5,1361383480863,1361383489119,1804861251,1804869507,8256
1361383508,1804888388,9,1874,208.2222222,1361383480863,1361383489119,1804861251,1804869507,8256
1361383508,1804888388,6,1658,276.3333333,1361383480863,1361383489119,1804861251,1804869507,8256
1361383508,1804888424,28,31608,1128.857143,1361383482107,1361383484795,1804862531,1804865219,2688
1361383508,1804888424,4,2654,663.5,1361383482360,1361383482936,1804862784,1804863360,576
1361383509,1804889600,7,2417,345.2857143,1361383491530,1361383501642,1804872130,1804882242,10112
1361383509,1804889604,80,103014,1287.675,1361383485253,1361383502149,1804865857,1804882753,16896
1361383509,1804889684,5,689,137.8,1361383491571,1361383501619,1804872255,1804882303,10048
1361383509,1804889684,12,8361,696.75,1361383484915,1361383501363,1804865599,1804882047,16448
1361383509,1804889724,4,598,149.5,1361383489291,1361383502027,1804870015,1804882751,12736
1361383509,1804889732,5,663,132.6,1361383491204,1361383501252,1804871936,1804881984,10048
1361383512,1804892288,4,500,125,1361383483969,1361383484225,1804864257,1804864513,256
1361383512,1804892288,4,500,125,1361383483969,1361383484225,1804864257,1804864513,256
1361383512,1804892296,3,366,122,1361383484407,1361383484407,1804864703,1804864703,0
1361383512,1804892316,7,3763,537.5714286,1361383485926,1361383491558,1804866242,1804871874,5632
1361383512,1804892368,5,701,140.2,1361383483887,1361383484143,1804864255,1804864511,256
1361383512,1804892368,5,698,139.6,1361383483887,1361383484143,1804864255,1804864511,256
1361383512,1804892372,4,500,125,1361383483887,1361383484143,1804864259,1804864515,256
1361383512,1804892404,5,2006,401.2,1361383484299,1361383484363,1804864703,1804864767,64
1361383512,1804892404,4,1228,307,1361383484302,1361383484558,1804864706,1804864962,256
1361383512,1804892408,3,524,174.6666667,1361383484426,1361383484490,1804864834,1804864898,64
1361383514,443207784,4,1044,261,1361383486010,1361383486266,443179794,443180050,256
1361383514,443207824,5,1519,303.8,1361383485971,1361383486355,443179795,443180179,384
1361383516,1804896328,3,1074,358,1361383491482,1361383491546,1804871810,1804871874,64
1361383516,1804896332,3,455,151.6666667,1361383491797,1361383491861,1804872129,1804872193,64
1361383516,1804896388,39,55285,1417.564103,1361383490654,1361383515678,1804871042,1804896066,25024
1361383517,1804897704,3,419,139.6666667,1361383514976,1361383515040,1804895680,1804895744,64
1361383517,1804897704,7,3258,465.4285714,1361383514976,1361383515104,1804895680,1804895808,128
1361383517,1804897708,5,507,101.4,1361383515038,1361383515102,1804895746,1804895810,64
1361383517,1804897708,4,940,235,1361383515358,1361383515486,1804896066,1804896194,128
1361383517,1804897708,2,94,47,1361383511644,1361383516700,1804892352,1804897408,5056
1361383517,1804897792,5,1053,210.6,1361383515081,1361383515145,1804895873,1804895937,64
1361383525,443219004,3,140,46.66666667,1361383517601,1361383517729,443211605,443211733,128
1361383525,443219024,2,94,47,1361383514638,1361383519886,443208662,443213910,5248
1361383525,443219024,2,94,47,1361383519691,1361383524811,443213715,443218835,5120
1361383525,1804905628,3,140,46.66666667,1361383511854,1361383517870,1804892482,1804898498,6016
1361383525,1804905640,2,94,47,1361383512928,1361383518752,1804893568,1804899392,5824
1361383525,1804905664,3,419,139.6666667,1361383520969,1361383521033,1804901633,1804901697,64
1361383525,1804905668,8,518,64.75,1361383513286,1361383518726,1804893954,1804899394,5440
1361383525,1804905668,5,1040,208,1361383521348,1361383521412,1804902016,1804902080,64
1361383525,1804905680,3,140,46.66666667,1361383514295,1361383519607,1804894975,1804900287,5312
1361383525,1804905680,3,140,46.66666667,1361383514295,1361383519607,1804894975,1804900287,5312
1361383525,1804905684,5,664,132.8,1361383514422,1361383524790,1804895106,1804905474,10368
1361383525,1804905704,2,94,47,1361383515104,1361383520544,1804895808,1804901248,5440
1361383525,1804905704,2,94,47,1361383514784,1361383520608,1804895488,1804901312,5824
1361383525,1804905704,3,140,46.66666667,1361383514912,1361383520608,1804895616,1804901312,5696
1361383525,1804905704,2,92,46,1361383514976,1361383520608,1804895680,1804901312,5632
1361383525,1804905704,2,275,137.5,1361383515423,1361383520607,1804896127,1804901311,5184
1361383525,1804905708,5,824,164.8,1361383515486,1361383520542,1804896194,1804901250,5056
1361383525,1804905748,7,4726,675.1428571,1361383520949,1361383521269,1804901697,1804902017,320
1361383525,1804905748,2,94,47,1361383518003,1361383523507,1804898751,1804904255,5504
1361383525,1804905756,9,3345,371.6666667,1361383521582,1361383521774,1804902338,1804902530,192
1361383525,1804905756,5,507,101.4,1361383521517,1361383521581,1804902273,1804902337,64
1361383525,1804905760,6,3299,549.8333333,1361383521833,1361383521961,1804902593,1804902721,128
1361383525,1804905760,4,940,235,1361383521960,1361383522152,1804902720,1804902912,192
1361383525,1804905760,2,94,47,1361383518888,1361383524456,1804899648,1804905216,5568
1361383525,1804905780,7,472,67.42857143,1361383519315,1361383524435,1804900095,1804905215,5120
1361383525,1804905784,2,94,47,1361383514191,1361383519503,1804894975,1804900287,5312
1361383525,1804905784,3,140,46.66666667,1361383514191,1361383519503,1804894975,1804900287,5312
1361383525,1804905784,3,140,46.66666667,1361383514191,1361383519503,1804894975,1804900287,5312
1361383525,1804905788,6,2930,488.3333333,1361383514637,1361383524749,1804895425,1804905537,10112
1361383525,1804905788,2,94,47,1361383514701,1361383520525,1804895489,1804901313,5824
1361383525,1804905788,12,7797,649.75,1361383514829,1361383521741,1804895617,1804902529,6912
1361383525,1804905788,2,275,137.5,1361383514956,1361383520524,1804895744,1804901312,5568
1361383525,1804905788,2,94,47,1361383515020,1361383520524,1804895808,1804901312,5504
1361383525,1804905788,2,275,137.5,1361383515084,1361383520524,1804895872,1804901312,5440
1361383525,1804905788,2,94,47,1361383515340,1361383520524,1804896128,1804901312,5184
1361383525,443219032,2,94,47,1361383513542,1361383518982,443207574,443213014,5440
1361383533,443227012,2,94,47,1361383523672,1361383528856,443217684,443222868,5184
1361383533,1804913620,15,11384,758.9333333,1361383511797,1361383526389,1804892417,1804907009,14592
1361383533,1804913628,12,6112,509.3333333,1361383512365,1361383527661,1804892993,1804908289,15296
1361383533,1804913660,2,275,137.5,1361383521099,1361383526667,1804901759,1804907327,5568
1361383533,1804913668,7,1276,182.2857143,1361383513347,1361383526979,1804894015,1804907647,13632
1361383533,1804913672,2,92,46,1361383521666,1361383527618,1804902338,1804908290,5952
1361383533,1804913676,2,275,137.5,1361383521854,1361383527614,1804902530,1804908290,5760
1361383533,1804913676,2,92,46,1361383521981,1361383527613,1804902657,1804908289,5632
1361383533,1804913676,6,984,164,1361383521979,1361383527163,1804902655,1804907839,5184
1361383533,1804913680,2,275,137.5,1361383522042,1361383527610,1804902722,1804908290,5568
1361383533,1804913700,2,94,47,1361383522918,1361383528550,1804903618,1804909250,5632
1361383533,1804913704,2,94,47,1361383522914,1361383528546,1804903618,1804909250,5632
1361383533,1804913704,8,4608,576,1361383523233,1361383531489,1804903937,1804912193,8256
1361383533,1804913744,2,275,137.5,1361383524538,1361383530554,1804905282,1804911298,6016
1361383533,1804913744,3,138,46,1361383520952,1361383526520,1804901696,1804907264,5568
1361383533,1804913756,2,94,47,1361383521709,1361383527533,1804902465,1804908289,5824
1361383533,1804913756,2,94,47,1361383521900,1361383527532,1804902656,1804908288,5632
1361383533,1804913760,2,94,47,1361383521894,1361383527526,1804902654,1804908286,5632
1361383533,1804913784,9,1712,190.2222222,1361383514192,1361383530512,1804894976,1804911296,16320
1361383533,1804913788,7,1435,205,1361383515086,1361383531278,1804895874,1804912066,16192
1361383533,1804913788,9,912,101.3333333,1361383515214,1361383530702,1804896002,1804911490,15488
1361383533,1804913788,8,3716,464.5,1361383515278,1361383525390,1804896066,1804906178,10112
1361383536,1804916404,2,154,77,1361383511628,1361383511884,1804892032,1804892288,256
1361383536,1804916412,6,2054,342.3333333,1361383507974,1361383523590,1804888386,1804904002,15616
1361383536,1804916480,2,123,61.5,1361383510527,1361383510527,1804891007,1804891007,0
1361383536,1804916488,1,77,77,1361383511543,1361383511543,1804892031,1804892031,0
1361383538,443231816,84,124029,1476.535714,1361383512221,1361383512349,443206037,443206165,128
1361383538,443231836,2,1335,667.5,1361383513800,1361383513864,443207636,443207700,64
1361383538,443231836,6,4893,815.5,1361383513800,1361383514248,443207636,443208084,448
1361383538,443231836,4,2998,749.5,1361383513800,1361383514120,443207636,443207956,320
1361383538,443231844,79,101627,1286.417722,1361383510593,1361383519617,443204437,443213461,9024
1361383538,443231884,4,2389,597.25,1361383513754,1361383513818,443207638,443207702,64
1361383538,443231884,4,2842,710.5,1361383513754,1361383514074,443207638,443207958,320
1361383540,1804920300,2,154,77,1361383512692,1361383512948,1804892992,1804893248,256
1361383540,1804920300,34,33768,993.1764706,1361383512756,1361383519412,1804893056,1804899712,6656
1361383540,1804920304,2,826,413,1361383513009,1361383519857,1804893313,1804900161,6848
1361383540,1804920308,6,1514,252.3333333,1361383513262,1361383535278,1804893570,1804915586,22016
1361383540,1804920336,18,10539,585.5,1361383513681,1361383513745,1804894017,1804894081,64
1361383540,1804920336,7,1782,254.5714286,1361383513744,1361383519568,1804894080,1804899904,5824
1361383540,1804920336,9,2166,240.6666667,1361383513744,1361383519568,1804894080,1804899904,5824
1361383540,1804920336,6,1736,289.3333333,1361383513744,1361383519568,1804894080,1804899904,5824
1361383540,1804920336,7,1782,254.5714286,1361383513744,1361383519568,1804894080,1804899904,5824
1361383540,1804920376,19,5785,304.4736842,1361383515559,1361383538151,1804895935,1804918527,22592
1361383540,1804920380,7,5212,744.5714286,1361383515364,1361383516004,1804895744,1804896384,640
1361383540,1804920412,2,154,77,1361383512579,1361383512835,1804892991,1804893247,256
1361383540,1804920412,1,77,77,1361383512579,1361383512579,1804892991,1804892991,0
1361383540,1804920416,60,87011,1450.183333,1361383512642,1361383519234,1804893058,1804899650,6592
1361383540,1804920416,18,24802,1377.888889,1361383512642,1361383518850,1804893058,1804899266,6208
1361383540,1804920420,6,1676,279.3333333,1361383513211,1361383533563,1804893631,1804913983,20352
1361383540,1804920424,7,3893,556.1428571,1361383513527,1361383522167,1804893951,1804902591,8640
1361383540,1804920424,7,1996,285.1428571,1361383513655,1361383523511,1804894079,1804903935,9856
1361383540,1804920452,7,1782,254.5714286,1361383513630,1361383519454,1804894082,1804899906,5824
1361383540,1804920464,29,26294,906.6896552,1361383514513,1361383517649,1804894977,1804898113,3136
1361383540,1804920464,2,910,455,1361383514831,1361383520335,1804895295,1804900799,5504
1361383540,1804920468,35,27580,788,1361383514958,1361383534350,1804895426,1804914818,19392
1361383540,1804920492,3,816,272,1361383515316,1361383515572,1804895808,1804896064,256
1361383541,1804921600,5,683,136.6,1361383523914,1361383534026,1804904514,1804914626,10112
1361383542,443235792,3,4381,1460.333333,1361383514931,1361383514931,443208723,443208723,0
1361383542,443235792,4,3918,979.5,1361383514867,1361383514931,443208659,443208723,64
1361383542,443235792,1,583,583,1361383514866,1361383514866,443208658,443208658,0
1361383542,443235792,1,668,668,1361383514866,1361383514866,443208658,443208658,0
1361383542,443235792,3,367,122.3333333,1361383514934,1361383514934,443208726,443208726,0
1361383542,443235792,3,4051,1350.333333,1361383514934,1361383514934,443208726,443208726,0
1361383542,443235832,5,1378,275.6,1361383513998,1361383524110,443207830,443217942,10112
1361383542,443235840,18,4948,274.8888889,1361383514628,1361383524740,443208468,443218580,10112
1361383542,443235844,4,2830,707.5,1361383517634,1361383517890,443211478,443211734,256
1361383542,443235844,10,14975,1497.5,1361383514881,1361383514881,443208725,443208725,0
1361383542,443235844,5,6592,1318.4,1361383514881,1361383514881,443208725,443208725,0
1361383544,1804924284,9,12728,1414.222222,1361383515907,1361383515907,1804896191,1804896191,0
1361383544,1804924288,1,91,91,1361383515905,1361383515905,1804896193,1804896193,0
1361383544,1804924404,1,91,91,1361383516170,1361383516170,1804896574,1804896574,0
1361383544,1804924408,2,265,132.5,1361383516232,1361383516296,1804896640,1804896704,64
1361383548,1804928348,1,659,659,1361383522117,1361383522117,1804902465,1804902465,0
1361383548,1804928392,13,8387,645.1538462,1361383519894,1361383523990,1804900286,1804904382,4096
1361383548,1804928436,10,4731,473.1,1361383521902,1361383522094,1804902338,1804902530,192
1361383548,1804928436,2,772,386,1361383522220,1361383522284,1804902656,1804902720,64
1361383548,1804928472,13,2129,163.7692308,1361383523146,1361383528522,1804903618,1804908994,5376
1361383548,1804928472,3,378,126,1361383523146,1361383523146,1804903618,1804903618,0
1361383548,1804928472,4,430,107.5,1361383523144,1361383523144,1804903616,1804903616,0
1361383550,443243836,17,23622,1389.529412,1361383523337,1361383523401,443217173,443217237,64
1361383550,443243856,19,23787,1251.947368,1361383524661,1361383524981,443218517,443218837,320
1361383552,1804932324,3,1012,337.3333333,1361383523996,1361383524124,1804904320,1804904448,128
1361383552,1804932332,2,423,211.5,1361383524246,1361383524246,1804904578,1804904578,0
1361383552,1804932416,1,46,46,1361383525182,1361383525182,1804905598,1804905598,0
1361383552,1804932416,1,1410,1410,1361383523966,1361383523966,1804904382,1804904382,0
1361383552,1804932484,2,92,46,1361383524988,1361383525052,1804905472,1804905536,64
1361383552,1804932484,8,4724,590.5,1361383524924,1361383525116,1804905408,1804905600,192
1361383564,1804944468,10,1719,171.9,1361383538634,1361383539210,1804919102,1804919678,576
1361383568,1804948316,2,92,46,1361383541923,1361383542051,1804922239,1804922367,128
1361383568,1804948348,2,92,46,1361383542150,1361383542278,1804922498,1804922626,128
1361383572,1804952440,1,46,46,1361383544873,1361383544873,1804925313,1804925313,0
1361383574,443267780,1,46,46,1361383546112,1361383546112,443239892,443239892,0
1361383574,443267780,1,46,46,1361383546111,1361383546111,443239891,443239891,0
1361383580,1804960352,2,92,46,1361383553279,1361383553279,1804933631,1804933631,0
1361383580,1804960464,2,92,46,1361383553166,1361383553166,1804933630,1804933630,0
1361383580,1804960508,1,77,77,1361383555043,1361383555043,1804935551,1804935551,0
1361383581,443274996,8,1501,187.625,1361383573160,1361383578728,443267156,443272724,5568
1361383581,443274996,6,1356,226,1361383574504,1361383579752,443268500,443273748,5248
1361383581,443274996,7,494,70.57142857,1361383574503,1361383579751,443268499,443273747,5248
1361383581,443275008,7,1455,207.8571429,1361383573149,1361383578717,443267157,443272725,5568
1361383581,443275008,7,1455,207.8571429,1361383573149,1361383578717,443267157,443272725,5568
1361383581,1804961608,3,138,46,1361383575999,1361383577023,1804956607,1804957631,1024
1361383581,1804961612,3,138,46,1361383576252,1361383577340,1804956864,1804957952,1088
1361383581,1804961644,6,1356,226,1361383572701,1361383578461,1804953345,1804959105,5760
1361383581,1804961644,7,1402,200.2857143,1361383572700,1361383578460,1804953344,1804959104,5760
1361383581,1804961644,8,1501,187.625,1361383572700,1361383578460,1804953344,1804959104,5760
1361383581,1804961648,2,92,46,1361383574423,1361383579607,1804955071,1804960255,5184
1361383581,1804961648,11,5357,487,1361383574294,1361383574742,1804954942,1804955390,448
1361383581,1804961652,9,707,78.55555556,1361383574546,1361383574546,1804955198,1804955198,0
1361383581,1804961652,8,3465,433.125,1361383574294,1361383579542,1804954946,1804960194,5248
1361383581,1804961656,3,138,46,1361383575057,1361383576145,1804955713,1804956801,1088
1361383581,1804961660,3,138,46,1361383578381,1361383579469,1804959041,1804960129,1088
1361383581,1804961684,3,138,46,1361383579765,1361383580853,1804960449,1804961537,1088
1361383581,1804961720,7,1402,200.2857143,1361383572623,1361383578383,1804953343,1804959103,5760
1361383581,1804961720,8,1501,187.625,1361383572623,1361383578383,1804953343,1804959103,5760
1361383581,1804961724,13,5361,412.3846154,1361383572621,1361383578445,1804953345,1804959169,5824
1361383581,1804961724,8,531,66.375,1361383574219,1361383579467,1804954943,1804960191,5248
1361383581,1804961728,3,138,46,1361383577222,1361383578310,1804957950,1804959038,1088
1361383581,1804961728,8,540,67.5,1361383574218,1361383579402,1804954946,1804960130,5184
1361383581,1804961732,3,138,46,1361383574725,1361383575813,1804955457,1804956545,1088
1361383581,1804961764,3,138,46,1361383579427,1361383580515,1804960191,1804961279,1088
1361383584,1804964348,2,154,77,1361383557189,1361383557381,1804937537,1804937729,192
1361383584,1804964352,1,77,77,1361383556158,1361383556158,1804936510,1804936510,0
1361383584,1804964356,1,77,77,1361383556157,1361383556157,1804936513,1804936513,0
1361383584,1804964400,2,92,46,1361383558606,1361383558606,1804939006,1804939006,0
1361383584,1804964476,3,200,66.66666667,1361383558019,1361383558275,1804938495,1804938751,256
1361383584,1804964508,1,77,77,1361383557028,1361383557028,1804937536,1804937536,0
1361383584,1804964508,2,154,77,1361383557028,1361383557220,1804937536,1804937728,192
1361383589,1804969620,3,138,46,1361383580917,1361383582005,1804961537,1804962625,1088
1361383589,1804969620,5,506,101.2,1361383583923,1361383584051,1804964543,1804964671,128
1361383589,1804969632,3,138,46,1361383581990,1361383583078,1804962622,1804963710,1088
1361383589,1804969672,3,138,46,1361383583105,1361383584129,1804963777,1804964801,1024
1361383589,1804969716,3,138,46,1361383580562,1361383581650,1804961278,1804962366,1088
1361383592,1804972336,1,77,77,1361383564112,1361383564112,1804944448,1804944448,0
1361383596,1804976444,2,265,132.5,1361383571618,1361383571682,1804952062,1804952126,64
1361383596,1804976444,3,378,126,1361383571490,1361383571490,1804951934,1804951934,0
1361383596,1804976528,4,430,107.5,1361383571408,1361383571408,1804951936,1804951936,0
1361383597,443291004,3,140,46.66666667,1361383583458,1361383589346,443277462,443283350,5888
1361383597,1804977652,2,94,47,1361383583570,1361383589074,1804964222,1804969726,5504
1361383597,1804977656,5,662,132.4,1361383583632,1361383593680,1804964288,1804974336,10048
1361383597,1804977664,2,94,47,1361383584199,1361383590087,1804964863,1804970751,5888
1361383597,1804977672,3,169,56.33333333,1361383584574,1361383590078,1804965246,1804970750,5504
1361383597,1804977752,9,4890,543.3333333,1361383583600,1361383593776,1804964352,1804974528,10176
1361383597,1804977788,2,94,47,1361383584076,1361383589964,1804964864,1804970752,5888
1361383597,1804977788,2,94,47,1361383584075,1361383589963,1804964863,1804970751,5888
1361383597,1804977836,2,92,46,1361383582938,1361383588890,1804963774,1804969726,5952
1361383598,443291784,7,1934,276.2857143,1361383573371,1361383574971,443267155,443268755,1600
1361383598,443291784,17,16543,973.1176471,1361383573371,1361383574843,443267155,443268627,1472
1361383598,443291792,12,3002,250.1666667,1361383573494,1361383585334,443267286,443279126,11840
1361383598,443291868,13,12873,990.2307692,1361383573290,1361383574506,443267158,443268374,1216
1361383598,443291872,8,5358,669.75,1361383573411,1361383574627,443267283,443268499,1216
1361383598,443291908,6,1072,178.6666667,1361383571714,1361383572098,443265622,443266006,384
1361383600,1804980340,13,5172,397.8461538,1361383573259,1361383575307,1804953599,1804955647,2048
1361383600,1804980348,11,4888,444.3636364,1361383573508,1361383574980,1804953856,1804955328,1472
1361383600,1804980356,11,10173,924.8181818,1361383572603,1361383574523,1804952959,1804954879,1920
1361383600,1804980384,8,4470,558.75,1361383572895,1361383574495,1804953279,1804954879,1600
1361383600,1804980388,9,4849,538.7777778,1361383574555,1361383575387,1804954943,1804955775,832
1361383600,1804980392,15,7343,489.5333333,1361383574552,1361383575320,1804954944,1804955712,768
1361383600,1804980392,9,4124,458.2222222,1361383574552,1361383575064,1804954944,1804955456,512
1361383600,1804980396,2,92,46,1361383575253,1361383575253,1804955649,1804955649,0
1361383600,1804980432,11,4846,440.5454545,1361383573422,1361383574894,1804953854,1804955326,1472
1361383600,1804980460,19,19962,1050.631579,1361383572501,1361383572885,1804952961,1804953345,384
1361383600,1804980460,7,1934,276.2857143,1361383572501,1361383573077,1804952961,1804953537,576
1361383600,1804980460,10,9387,938.7,1361383572563,1361383574419,1804953023,1804954879,1856
1361383600,1804980472,11,1233,112.0909091,1361383574473,1361383574729,1804954945,1804955201,256
1361383600,1804980472,12,3931,327.5833333,1361383574472,1361383575048,1804954944,1804955520,576
1361383600,1804980472,9,1066,118.4444444,1361383574471,1361383574727,1804954943,1804955199,256
1361383600,1804980472,13,6980,536.9230769,1361383574470,1361383575174,1804954942,1804955646,704
1361383600,1804980504,2,92,46,1361383575145,1361383575145,1804955649,1804955649,0
1361383604,1804984412,2,92,46,1361383579395,1361383579459,1804959807,1804959871,64
1361383604,1804984488,8,5028,628.5,1361383578166,1361383578422,1804958654,1804958910,256
1361383605,1804985628,7,412,58.85714286,1361383600172,1361383600236,1804980800,1804980864,64
1361383605,1804985628,6,366,61,1361383600170,1361383600170,1804980798,1804980798,0
1361383605,1804985656,6,366,61,1361383601166,1361383601166,1804981822,1804981822,0
1361383605,1804985708,6,366,61,1361383600028,1361383600028,1804980736,1804980736,0
1361383605,1804985716,6,366,61,1361383601106,1361383601106,1804981822,1804981822,0
1361383605,1804985716,6,366,61,1361383601106,1361383601106,1804981822,1804981822,0
1361383608,1804988596,3,138,46,1361383583629,1361383583693,1804964225,1804964289,64
1361383608,1804988676,2,92,46,1361383582841,1361383582905,1804963517,1804963581,64
1361383608,1804988676,58,82328,1419.448276,1361383583100,1361383585020,1804963776,1804965696,1920
1361383608,1804988680,4,3601,900.25,1361383583353,1361383583609,1804964033,1804964289,256
1361383608,1804988768,6,5147,857.8333333,1361383582945,1361383584801,1804963713,1804965569,1856
1361383608,1804988768,5,1209,241.8,1361383583008,1361383584864,1804963776,1804965632,1856
1361383610,443303788,6,927,154.5,1361383583417,1361383583673,443277205,443277461,256
1361383610,443303840,2,395,197.5,1361383584324,1361383584324,443278164,443278164,0
1361383612,1804992632,4,2756,689,1361383583913,1361383583977,1804964545,1804964609,64
1361383612,1804992632,3,415,138.3333333,1361383583911,1361383583975,1804964543,1804964607,64
1361383612,1804992636,3,183,61,1361383584163,1361383584163,1804964799,1804964799,0
1361383612,1804992636,39,54356,1393.74359,1361383584226,1361383584354,1804964862,1804964990,128
1361383612,1804992748,18,26164,1453.555556,1361383583922,1361383583986,1804964670,1804964734,64
1361383613,1804993644,197,121248,615.4720812,1361383464028,1361383611164,1804844672,1804991808,147136
1361383618,443311820,1,46,46,1361383593499,1361383593499,443287319,443287319,0
1361383618,443311820,1,46,46,1361383593499,1361383593499,443287319,443287319,0
1361383618,443311872,1,46,46,1361383593446,1361383593446,443287318,443287318,0
1361383618,443311872,1,46,46,1361383593444,1361383593444,443287316,443287316,0
1361383618,443311872,1,46,46,1361383593447,1361383593447,443287319,443287319,0
1361383620,1805000724,1,46,46,1361383595020,1361383595020,1804975744,1804975744,0
1361383622,443315816,1,46,46,1361383595547,1361383595547,443289363,443289363,0
1361383622,443315844,1,46,46,1361383596481,1361383596481,443290325,443290325,0
1361383622,443315872,1,46,46,1361383595429,1361383595429,443289301,443289301,0
1361383622,443315872,1,46,46,1361383595493,1361383595493,443289365,443289365,0
1361383622,443315872,1,46,46,1361383595493,1361383595493,443289365,443289365,0
1361383622,443315892,1,46,46,1361383596434,1361383596434,443290326,443290326,0
1361383622,443315892,1,46,46,1361383596432,1361383596432,443290324,443290324,0
1361383624,1805004728,1,46,46,1361383598981,1361383598981,1804979709,1804979709,0
1361383624,1805004728,1,46,46,1361383598985,1361383598985,1804979713,1804979713,0
1361383624,1805004728,1,46,46,1361383598985,1361383598985,1804979713,1804979713,0
1361383625,1805004844,1,46,46,1361383599867,1361383599867,1804979711,1804979711,0
1361383625,1805004844,1,46,46,1361383599867,1361383599867,1804979711,1804979711,0
1361383626,443319816,1,46,46,1361383601499,1361383601499,443295315,443295315,0
1361383626,443319820,1,46,46,1361383601499,1361383601499,443295319,443295319,0
1361383628,1805008592,1,46,46,1361383600141,1361383600141,1804980733,1804980733,0
1361383628,1805008596,1,46,46,1361383600140,1361383600140,1804980736,1804980736,0
1361383628,1805008632,1,46,46,1361383601064,1361383601064,1804981696,1804981696,0
1361383628,1805008636,2,92,46,1361383601317,1361383601317,1804981953,1804981953,0
1361383628,1805008636,2,92,46,1361383601316,1361383601316,1804981952,1804981952,0
1361383628,1805008712,1,46,46,1361383600025,1361383600025,1804980737,1804980737,0
1361383628,1805008724,1,46,46,1361383600971,1361383600971,1804981695,1804981695,0
1361383628,1805008760,1,77,77,1361383602023,1361383602023,1804982783,1804982783,0
1361383629,443322996,273,395362,1448.212454,1361383477930,1361383627306,443171926,443321302,149376
1361383636,1805016724,1,77,77,1361383608074,1361383608074,1804988798,1804988798,0
1361383637,443330996,7,494,70.57142857,1361383630823,1361383636327,443324819,443330323,5504
1361383637,443331000,481,694886,1444.669439,1361383479908,1361383630308,443173908,443324308,150400
1361383637,443331008,272,392822,1444.198529,1361383477918,1361383636318,443171926,443330326,158400
1361383637,443331008,7,494,70.57142857,1361383630748,1361383636316,443324756,443330324,5568
1361383637,1805017668,350,511848,1462.422857,1361383478148,1361383635076,1804858816,1805015744,156928
1361383644,1805024696,2,154,77,1361383619111,1361383619303,1804999807,1804999999,192
1361383644,1805024776,2,471,235.5,1361383618071,1361383618135,1804998847,1804998911,64
1361383652,1805032792,2,265,132.5,1361383626825,1361383626889,1805007617,1805007681,64
1361383653,1805033788,7,412,58.85714286,1361383646922,1361383646986,1805027710,1805027774,64
1361383654,443347980,1,46,46,1361383629368,1361383629368,443323348,443323348,0
1361383654,443347980,1,46,46,1361383629367,1361383629367,443323347,443323347,0
1361383654,443348028,1,46,46,1361383629319,1361383629319,443323347,443323347,0
1361383654,443348028,1,46,46,1361383629319,1361383629319,443323347,443323347,0
1361383654,443348032,1,46,46,1361383629319,1361383629319,443323351,443323351,0
1361383654,443348036,1,46,46,1361383627264,1361383627264,443321300,443321300,0
1361383656,1805036672,8,8372,1046.5,1361383630078,1361383655550,1805010750,1805036222,25472
1361383656,1805036676,3,3357,1119,1361383630523,1361383630523,1805011199,1805011199,0
1361383656,1805036676,2,2613,1306.5,1361383630523,1361383630523,1805011199,1805011199,0
1361383656,1805036700,1,46,46,1361383631010,1361383631010,1805011710,1805011710,0
1361383656,1805036704,1,46,46,1361383631005,1361383631005,1805011709,1805011709,0
1361383656,1805036784,1,46,46,1361383630928,1361383630928,1805011712,1805011712,0
1361383658,443351988,1,46,46,1361383630319,1361383630319,443324307,443324307,0
1361383658,443351988,1,46,46,1361383630319,1361383630319,443324307,443324307,0
1361383658,443351988,1,46,46,1361383630319,1361383630319,443324307,443324307,0
1361383658,443351988,1,46,46,1361383630319,1361383630319,443324307,443324307,0
1361383658,443352020,1,46,46,1361383633299,1361383633299,443327319,443327319,0
1361383658,443352036,1,46,46,1361383630272,1361383630272,443324308,443324308,0
1361383658,443352036,1,46,46,1361383630272,1361383630272,443324308,443324308,0
1361383658,443352036,1,46,46,1361383630272,1361383630272,443324308,443324308,0
1361383658,443352036,1,46,46,1361383630272,1361383630272,443324308,443324308,0
1361383658,443352040,7,3906,558,1361383630718,1361383630718,443324758,443324758,0
1361383658,443352040,7,4610,658.5714286,1361383630717,1361383630781,443324757,443324821,64
1361383658,443352040,7,4002,571.7142857,1361383630717,1361383630781,443324757,443324821,64
1361383658,443352040,5,642,128.4,1361383630717,1361383630781,443324757,443324821,64
1361383660,1805040656,1,46,46,1361383634063,1361383634063,1805014719,1805014719,0
1361383660,1805040684,1,46,46,1361383635059,1361383635059,1805015743,1805015743,0
1361383660,1805040684,1,46,46,1361383635059,1361383635059,1805015743,1805015743,0
1361383660,1805040684,1,46,46,1361383635059,1361383635059,1805015743,1805015743,0
1361383660,1805040692,2,109,54.5,1361383635499,1361383635563,1805016191,1805016255,64
1361383660,1805040764,1,46,46,1361383633954,1361383633954,1805014718,1805014718,0
1361383660,1805040772,1,46,46,1361383634970,1361383634970,1805015742,1805015742,0
1361383660,1805040776,1,46,46,1361383634965,1361383634965,1805015741,1805015741,0
1361383661,1805041748,6,366,61,1361383652980,1361383653044,1805033728,1805033792,64
1361383661,1805041796,11,5325,484.0909091,1361383655683,1361383656067,1805036479,1805036863,384
1361383662,443356032,1,46,46,1361383635333,1361383635333,443329365,443329365,0
1361383664,1805044596,1,46,46,1361383637129,1361383637129,1805017725,1805017725,0
1361383664,1805044600,1,46,46,1361383637128,1361383637128,1805017728,1805017728,0
1361383664,1805044644,1,46,46,1361383639066,1361383639066,1805019710,1805019710,0
1361383664,1805044676,1,46,46,1361383636090,1361383636090,1805016766,1805016766,0
1361383664,1805044680,1,46,46,1361383637048,1361383637048,1805017728,1805017728,0
1361383664,1805044716,1,46,46,1361383638034,1361383638034,1805018750,1805018750,0
1361383664,1805044752,1,46,46,1361383638960,1361383638960,1805019712,1805019712,0
1361383666,443359980,1,46,46,1361383638328,1361383638328,443332308,443332308,0
1361383666,443360004,1,46,46,1361383640289,1361383640289,443334293,443334293,0
1361383666,443360036,1,46,46,1361383639297,1361383639297,443333333,443333333,0
1361383669,443363000,6,1356,226,1361383656485,1361383661861,443350485,443355861,5376
1361383669,1805049800,8,531,66.375,1361383655420,1361383661436,1805036220,1805042236,6016
1361383672,1805052652,2,92,46,1361383643985,1361383643985,1805024637,1805024637,0
1361383672,1805052744,2,92,46,1361383644150,1361383644150,1805024894,1805024894,0
1361383672,1805052776,2,92,46,1361383644375,1361383644439,1805025151,1805025215,64
1361383680,1805060752,6,474,79,1361383655728,1361383655856,1805036480,1805036608,128
1361383681,1805060840,9,5626,625.1111111,1361383656320,1361383656384,1805036160,1805036224,64
1361383682,443375980,4,4075,1018.75,1361383655865,1361383655865,443349845,443349845,0
1361383682,443376024,4,4491,1122.75,1361383655884,1361383655884,443349908,443349908,0
1361383682,443376024,3,3565,1188.333333,1361383655819,1361383655819,443349843,443349843,0
1361383684,1805064704,2,471,235.5,1361383658079,1361383658143,1805038783,1805038847,64
1361383693,443387004,3,169,56.33333333,1361383689888,1361383689888,443383892,443383892,0
1361383693,443387020,3,169,56.33333333,1361383687827,1361383687827,443381847,443381847,0
1361383693,1805073700,4,205,51.25,1361383688611,1361383688611,1805069311,1805069311,0
1361383693,1805073700,3,169,56.33333333,1361383688546,1361383688546,1805069246,1805069246,0
1361383693,1805073732,4,205,51.25,1361383689602,1361383689602,1805070334,1805070334,0
1361383693,1805073740,4,205,51.25,1361383690553,1361383690553,1805071293,1805071293,0
1361383693,1805073816,4,205,51.25,1361383690478,1361383690478,1805071294,1805071294,0
1361383693,1805073816,4,205,51.25,1361383690478,1361383690478,1805071294,1805071294,0
1361383693,1805073820,4,205,51.25,1361383690472,1361383690472,1805071292,1805071292,0
1361383693,1805073820,4,205,51.25,1361383690476,1361383690476,1805071296,1805071296,0
1361383701,443394992,2,123,61.5,1361383698861,1361383698861,443392853,443392853,0
1361383701,443395020,3,169,56.33333333,1361383700818,1361383700818,443394838,443394838,0
1361383709,1805088892,2,265,132.5,1361383683403,1361383683467,1805063295,1805063359,64
1361383716,1805096756,2,581,290.5,1361383691561,1361383691625,1805072317,1805072381,64
1361383717,1805096856,1,46,46,1361383691564,1361383691564,1805071420,1805071420,0
1361383717,1805096864,1,46,46,1361383691559,1361383691559,1805071423,1805071423,0
1361383725,1805104864,1,46,46,1361383699494,1361383699494,1805079358,1805079358,0
1361383725,1805104912,1,46,46,1361383700341,1361383700341,1805080253,1805080253,0
1361383725,1805104916,1,46,46,1361383700337,1361383700337,1805080253,1805080253,0
1361383725,1805105132,1,46,46,1361383700120,1361383700120,1805080252,1805080252,0
1361383725,1805105136,1,46,46,1361383700119,1361383700119,1805080255,1805080255,0
1361383726,443419992,1,46,46,1361383699886,1361383699886,443393878,443393878,0
1361383728,1805108740,2,154,77,1361383699962,1361383700154,1805080702,1805080894,192
1361383729,1805108868,1,46,46,1361383701411,1361383701411,1805081279,1805081279,0
1361383749,443443000,2,123,61.5,1361383745894,1361383745894,443439894,443439894,0
1361383749,443443004,3,169,56.33333333,1361383745891,1361383745891,443439895,443439895,0
1361383749,443443004,3,169,56.33333333,1361383745890,1361383745890,443439894,443439894,0
1361383749,443443024,3,169,56.33333333,1361383745870,1361383745870,443439894,443439894,0
1361383750,1805129920,3,169,56.33333333,1361383746350,1361383746350,1805126270,1805126270,0
1361383750,1805129920,3,169,56.33333333,1361383746350,1361383746350,1805126270,1805126270,0
1361383756,1805136756,2,471,235.5,1361383731882,1361383731946,1805112638,1805112702,64
1361383765,1805145092,2,265,132.5,1361383739008,1361383739072,1805119100,1805119164,64
1361383773,1805153132,1,77,77,1361383745497,1361383745497,1805125629,1805125629,0
1361383773,443466996,2,123,61.5,1361383770920,1361383770920,443464916,443464916,0
1361383773,443467008,2,123,61.5,1361383770912,1361383770912,443464920,443464920,0
1361383773,443467020,4,215,53.75,1361383771856,1361383771856,443465876,443465876,0
1361383773,1805153820,3,169,56.33333333,1361383770471,1361383770471,1805151291,1805151291,0
1361383774,1805153896,4,205,51.25,1361383771397,1361383771397,1805151293,1805151293,0
1361383798,1805177884,7,412,58.85714286,1361383790672,1361383790736,1805170556,1805170620,64
1361383801,1805181148,2,471,235.5,1361383772936,1361383773000,1805153084,1805153148,64
1361383821,1805201200,2,265,132.5,1361383794451,1361383794515,1805174651,1805174715,64
1361383841,1805221104,2,471,235.5,1361383813491,1361383813555,1805193595,1805193659,64
1361383845,443539004,7,494,70.57142857,1361383834531,1361383840227,443528535,443534231,5696
1361383845,443539036,7,1402,200.2857143,1361383832643,1361383838275,443526679,443532311,5632
1361383845,443539036,7,1402,200.2857143,1361383832643,1361383838275,443526679,443532311,5632
1361383845,1805225800,11,2990,271.8181818,1361383833274,1361383838842,1805214074,1805219642,5568
1361383846,1805225884,8,531,66.375,1361383834257,1361383839697,1805214141,1805219581,5440
1361383846,1805225884,8,531,66.375,1361383834192,1361383839760,1805214076,1805219644,5568
1361383849,1805229296,7,1622,231.7142857,1361383824501,1361383825077,1805204797,1805205373,576
1361383854,1805233940,11,3946,358.7272727,1361383835225,1361383847577,1805215165,1805227517,12352
1361383861,1805241112,53,55036,1038.415094,1361383833516,1361383834860,1805213628,1805214972,1344
1361383861,1805241112,54,65477,1212.537037,1361383833516,1361383859180,1805213628,1805239292,25664
1361383861,1805241112,47,50659,1077.851064,1361383833515,1361383834475,1805213627,1805214587,960
1361383861,1805241112,42,43868,1044.47619,1361383833515,1361383834475,1805213627,1805214587,960
1361383861,1805241112,45,48743,1083.177778,1361383833515,1361383834475,1805213627,1805214587,960
1361383861,1805241112,10,5834,583.4,1361383833578,1361383834090,1805213690,1805214202,512
1361383861,1805241116,8,3787,473.375,1361383834022,1361383834150,1805214138,1805214266,128
1361383861,1805241204,55,60203,1094.6,1361383833424,1361383859024,1805213628,1805239228,25600
1361383861,1805241224,9,3167,351.8888889,1361383833850,1361383834490,1805214074,1805214714,640
1361383861,1805241228,8,3418,427.25,1361383833848,1361383834040,1805214076,1805214268,192
1361383863,443556464,6,2858,476.3333333,1361383835006,1361383835070,443528470,443528534,64
1361383869,443563012,7,494,70.57142857,1361383858587,1361383863643,443552599,443557655,5056
1361383877,1805257124,2,265,132.5,1361383850142,1361383850206,1805230266,1805230330,64
1361383881,1805261232,2,471,235.5,1361383854130,1361383854258,1805234362,1805234490,128
1361383893,443587000,8,540,67.5,1361383885413,1361383891173,443579413,443585173,5760
1361383893,443587004,8,540,67.5,1361383885412,1361383891172,443579416,443585176,5760
1361383893,443587012,8,1501,187.625,1361383882907,1361383888859,443576919,443582871,5952
1361383893,443587012,8,540,67.5,1361383885402,1361383891162,443579414,443585174,5760
1361383893,1805273824,10,5247,524.7,1361383892453,1361383892901,1805273277,1805273725,448
1361383893,1805273824,8,531,66.375,1361383885219,1361383890467,1805266043,1805271291,5248
1361383893,1805273828,5,1791,358.2,1361383892704,1361383892832,1805273532,1805273660,128
1361383893,1805273832,7,7147,1021,1361383892827,1361383892891,1805273659,1805273723,64
1361383894,1805273904,11,5325,484.0909091,1361383893373,1361383893821,1805273277,1805273725,448
1361383901,443595000,7,494,70.57142857,1361383891301,1361383896357,443585301,443590357,5056
1361383901,443595008,2,94,47,1361383892958,1361383898334,443586966,443592342,5376
1361383901,443595012,7,494,70.57142857,1361383893337,1361383898329,443587349,443592341,4992
1361383901,443595024,7,494,70.57142857,1361383893327,1361383898319,443587351,443592343,4992
1361383901,443595028,7,494,70.57142857,1361383892554,1361383898314,443586582,443592342,5760
1361383901,1805281832,5,425,85,1361383893020,1361383893148,1805273852,1805273980,128
1361383901,1805281832,13,5134,394.9230769,1361383893020,1361383893276,1805273852,1805274108,256
1361383901,1805281832,9,4796,532.8888889,1361383893083,1361383898971,1805273915,1805279803,5888
1361383901,1805281832,24,31102,1295.916667,1361383893083,1361383893467,1805273915,1805274299,384
1361383901,1805281832,5,609,121.8,1361383893147,1361383893339,1805273979,1805274171,192
1361383901,1805281836,2,94,47,1361383893209,1361383898905,1805274045,1805279741,5696
1361383901,1805281836,13,6601,507.7692308,1361383892504,1361383892952,1805273340,1805273788,448
1361383901,1805281840,2,94,47,1361383892755,1361383897939,1805273595,1805278779,5184
1361383901,1805281840,2,94,47,1361383892690,1361383897874,1805273530,1805278714,5184
1361383901,1805281840,2,94,47,1361383893521,1361383898961,1805274361,1805279801,5440
1361383902,1805281912,17,6267,368.6470588,1361383893427,1361383893939,1805273339,1805273851,512
1361383902,1805281912,8,4900,612.5,1361383893427,1361383898867,1805273339,1805278779,5440
1361383902,1805281912,9,4426,491.7777778,1361383893426,1361383896690,1805273338,1805276602,3264
1361383902,1805281912,2,94,47,1361383893425,1361383898865,1805273337,1805278777,5440
1361383902,1805281912,2,94,47,1361383893489,1361383898865,1805273401,1805278777,5376
1361383902,1805281916,2,92,46,1361383893615,1361383898991,1805273531,1805278907,5376
1361383902,1805281916,2,94,47,1361383893678,1361383898862,1805273594,1805278778,5184
1361383902,1805281916,2,94,47,1361383894445,1361383899885,1805274361,1805279801,5440
1361383902,1805281920,2,94,47,1361383893676,1361383898860,1805273596,1805278780,5184
1361383902,1805281920,5,425,85,1361383893739,1361383893995,1805273659,1805273915,256
1361383909,1805289172,10,11662,1166.2,1361383883119,1361383892463,1805263291,1805272635,9344
1361383909,1805289284,5,5991,1198.2,1361383883005,1361383891901,1805263289,1805272185,8896
1361383910,1805289856,3,140,46.66666667,1361383902252,1361383902252,1805282108,1805282108,0
1361383910,1805289860,2,94,47,1361383906086,1361383906086,1805285946,1805285946,0
1361383910,1805289892,3,169,56.33333333,1361383906886,1361383906950,1805286778,1805286842,64
1361383910,1805289948,6,494,82.33333333,1361383894416,1361383907472,1805274364,1805287420,13056
1361383910,1805289948,2,94,47,1361383905999,1361383905999,1805285947,1805285947,0
1361383910,1805289976,2,94,47,1361383902837,1361383902901,1805282813,1805282877,64
1361383911,443604468,15,15591,1039.4,1361383883385,1361383892345,443576853,443585813,8960
1361383917,1805297180,58,63608,1096.689655,1361383890789,1361383897893,1805270969,1805278073,7104
1361383917,1805297312,8,1838,229.75,1361383892515,1361383901731,1805272827,1805282043,9216
1361383918,1805297940,3,169,56.33333333,1361383909846,1361383909910,1805289786,1805289850,64
1361383919,443612456,12,9828,819,1361383892295,1361383893255,443585751,443586711,960
1361383919,443612456,13,11244,864.9230769,1361383892295,1361383893255,443585751,443586711,960
1361383919,443612460,7,973,139,1361383893059,1361383893379,443586519,443586839,320
1361383919,443612508,10,8378,837.8,1361383892243,1361383892435,443585751,443585943,192
1361383921,1805301492,1,46,46,1361383893231,1361383893231,1805273723,1805273723,0
1361383921,1805301496,1,46,46,1361383893291,1361383893291,1805273787,1805273787,0
1361383921,1805301504,4,779,194.75,1361383893476,1361383895780,1805273980,1805276284,2304
1361383921,1805301504,4,792,198,1361383893475,1361383893731,1805273979,1805274235,256
1361383921,1805301532,2,825,412.5,1361383893831,1361383893895,1805274363,1805274427,64
1361383921,1805301612,3,1134,378,1361383892598,1361383892726,1805273210,1805273338,128
1361383921,1805301620,4,517,129.25,1361383892720,1361383892784,1805273340,1805273404,64
1361383921,1805301624,4,3901,975.25,1361383892779,1361383892907,1805273403,1805273531,128
1361383921,1805301628,6,2488,414.6666667,1361383892904,1361383893096,1805273532,1805273724,192
1361383929,1805309508,15,2064,137.6,1361383902366,1361383904158,1805282874,1805284666,1792
1361383929,1805309544,9,1422,158,1361383903739,1361383905403,1805284283,1805285947,1664
1361383929,1805309544,7,2536,362.2857143,1361383903737,1361383904185,1805284281,1805284729,448
1361383929,1805309552,6,526,87.66666667,1361383904498,1361383904754,1805285050,1805285306,256
1361383929,1805309640,7,755,107.8571429,1361383903833,1361383904217,1805284473,1805284857,384
1361383933,1805313508,3,311,103.6666667,1361383905117,1361383915933,1805285625,1805296441,10816
1361383933,1805313516,8,898,112.25,1361383905431,1361383905495,1805285947,1805286011,64
1361383933,1805313632,7,711,101.5714286,1361383905316,1361383905380,1805285948,1805286012,64
1361383934,1805313908,5,1388,277.6,1361383932856,1361383933688,1805312764,1805313596,832
1361383934,1805313940,4,184,46,1361383926357,1361383930709,1805306297,1805310649,4352
1361383950,1805329988,2,92,46,1361383935718,1361383945702,1805315706,1805325690,9984
1361383958,1805337904,6,381,63.5,1361383954298,1361383957882,1805334202,1805337786,3584
1361383958,1805337904,5,314,62.8,1361383954361,1361383956089,1805334265,1805335993,1728
1361383958,1805337944,3,138,46,1361383953233,1361383955409,1805333177,1805335353,2176
1361383958,1805337980,5,314,62.8,1361383954285,1361383956141,1805334265,1805336121,1856
1361383958,1805337984,4,247,61.75,1361383954412,1361383955948,1805334396,1805335932,1536
1361383958,1805338020,6,276,46,1361383952581,1361383956741,1805332601,1805336761,4160
1361383961,1805341580,4,1700,425,1361383934100,1361383949780,1805314680,1805330360,15680
1361383966,1805345892,2,134,67,1361383958021,1361383961861,1805337913,1805341753,3840
1361383966,1805345892,2,134,67,1361383958021,1361383962117,1805337913,1805342009,4096
1361383966,1805345900,2,92,46,1361383958400,1361383964288,1805338300,1805344188,5888
1361383966,1805345944,5,354,70.8,1361383963858,1361383965522,1805343802,1805345466,1664
1361383966,1805345944,6,1399,233.1666667,1361383961425,1361383965521,1805341369,1805345465,4096
1361383966,1805345972,2,134,67,1361383958198,1361383962358,1805338170,1805342330,4160
1361383966,1805346024,5,354,70.8,1361383963777,1361383965377,1805343801,1805345401,1600
1361383974,1805353896,2,134,67,1361383961728,1361383969344,1805341624,1805349240,7616
1361383974,1805353948,2,92,46,1361383961038,1361383969486,1805340986,1805349434,8448
1361383990,1805369992,2,134,67,1361383969569,1361383985057,1805349561,1805365049,15488
1361383990,1805370000,2,134,67,1361383970073,1361383986201,1805350073,1805366201,16128
1361383990,1805370028,2,134,67,1361383970557,1361383987133,1805350585,1805367161,16576
1361383993,1805373608,4,308,77,1361383966713,1361383992697,1805347321,1805373305,25984
1361383993,1805373608,4,308,77,1361383966649,1361383992569,1805347257,1805373177,25920
1361383993,1805373616,1,425,425,1361383967600,1361383967600,1805348216,1805348216,0
1361383993,1805373664,1,46,46,1361383964994,1361383964994,1805345658,1805345658,0
1361383997,1805377584,3,657,219,1361383969235,1361383995475,1805349819,1805376059,26240
1361384001,1805381628,2,92,46,1361383975268,1361383998756,1805355896,1805379384,23488
1361384009,1805389832,1,67,67,1361383983767,1361383983767,1805364599,1805364599,0
1361384013,1805393584,1,46,46,1361383985808,1361383985808,1805366392,1805366392,0
1361384022,1805401900,5,314,62.8,1361384018108,1361384021884,1805398008,1805401784,3776
1361384029,1805409652,1,425,425,1361384003276,1361384003276,1805383928,1805383928,0
1361384030,1805410028,6,431,71.83333333,1361384023807,1361384027199,1805403835,1805407227,3392
1361384033,1805413692,1,46,46,1361384004964,1361384004964,1805385656,1805385656,0
1361384038,1805418012,2,134,67,1361384026061,1361384034701,1805406073,1805414713,8640
1361384038,1805418020,5,354,70.8,1361384034821,1361384036357,1805414841,1805416377,1536
1361384041,1805421688,1,67,67,1361384014569,1361384014569,1805395257,1805395257,0
1361384041,1805421808,1,67,67,1361384015281,1361384015281,1805396089,1805396089,0
1361384045,1805425640,1,67,67,1361384017880,1361384017880,1805398520,1805398520,0
1361384045,1805425672,1,67,67,1361384019577,1361384019577,1805400249,1805400249,0
1361384049,1805429696,1,77,77,1361384022370,1361384022370,1805403066,1805403066,0
1361384049,1805429788,1,77,77,1361384022022,1361384022022,1805402810,1805402810,0
1361384054,1805433964,5,323,64.6,1361384030974,1361384053054,1805410938,1805433018,22080
1361384054,1805434032,11,4616,419.6363636,1361384052857,1361384053049,1805432889,1805433081,192
1361384054,1805434120,11,4616,419.6363636,1361384052383,1361384052575,1805432503,1805432695,192
1361384057,1805437776,1,219,219,1361384030160,1361384030160,1805410936,1805410936,0
1361384061,443755088,2,123,61.5,1361384056080,1361384056080,443750168,443750168,0
1361384066,1805445876,6,400,66.66666667,1361384038356,1361384063892,1805418232,1805443768,25536
1361384069,443763068,13,13183,1014.076923,1361384064034,1361384064482,443758102,443758550,448
1361384069,443763072,8,1434,179.25,1361384064544,1361384068640,443758616,443762712,4096
1361384069,443763072,10,6996,699.6,1361384064544,1361384068896,443758616,443762968,4352
1361384069,443763096,8,1498,187.25,1361384064519,1361384068807,443758615,443762903,4288
1361384070,1805449984,5,1085,217,1361384064552,1361384064616,1805444536,1805444600,64
1361384070,1805450072,5,1049,209.8,1361384064658,1361384064914,1805444730,1805444986,256
1361384077,443771060,7,2150,307.1428571,1361384070381,1361384070573,443764441,443764633,192
1361384077,443771060,7,1596,228,1361384070509,1361384070637,443764569,443764697,128
1361384077,443771060,7,1772,253.1428571,1361384070509,1361384071277,443764569,443765337,768
1361384077,443771060,8,1168,146,1361384070637,1361384070701,443764697,443764761,64
1361384077,443771060,7,1538,219.7142857,1361384069419,1361384069419,443763479,443763479,0
1361384077,443771060,8,2154,269.25,1361384069419,1361384069867,443763479,443763927,448
1361384077,443771060,9,1688,187.5555556,1361384069419,1361384070059,443763479,443764119,640
1361384077,443771060,10,1526,152.6,1361384069419,1361384070507,443763479,443764567,1088
1361384077,443771064,8,2292,286.5,1361384069992,1361384070248,443764056,443764312,256
1361384077,443771064,12,9993,832.75,1361384064551,1361384069351,443758615,443763415,4800
1361384077,443771064,7,2630,375.7142857,1361384070183,1361384070759,443764247,443764823,576
1361384077,443771064,8,1584,198,1361384064550,1361384069414,443758614,443763478,4864
1361384077,443771068,6,1356,226,1361384056677,1361384076645,443750745,443770713,19968
1361384077,443771068,7,1356,193.7142857,1361384070499,1361384070627,443764567,443764695,128
1361384077,443771072,10,1462,146.2,1361384069409,1361384070497,443763481,443764569,1088
1361384077,443771072,9,1912,212.4444444,1361384069409,1361384070049,443763481,443764121,640
1361384077,443771072,10,2560,256,1361384069728,1361384070176,443763800,443764248,448
1361384077,443771072,8,1354,169.25,1361384070111,1361384070751,443764183,443764823,640
1361384077,443771072,8,1418,177.25,1361384070046,1361384070238,443764118,443764310,192
1361384077,443771084,8,2068,258.5,1361384070229,1361384070357,443764313,443764441,128
1361384077,443771084,10,7748,774.8,1361384064533,1361384069333,443758617,443763417,4800
1361384077,443771084,8,1642,205.25,1361384070229,1361384070485,443764313,443764569,256
1361384078,1805458084,1,77,77,1361384050821,1361384050821,1805430905,1805430905,0
1361384078,1805458084,2,154,77,1361384050885,1361384051077,1805430969,1805431161,192
1361384078,1805458084,3,200,66.66666667,1361384050821,1361384051077,1805430905,1805431161,256
1361384078,1805458084,3,200,66.66666667,1361384050821,1361384051077,1805430905,1805431161,256
1361384078,1805458084,46,52695,1145.543478,1361384050820,1361384056836,1805430904,1805436920,6016
1361384078,1805458088,17,2278,134,1361384051136,1361384074240,1805431224,1805454328,23104
1361384078,1805458100,4,326,81.5,1361384052085,1361384052149,1805432185,1805432249,64
1361384078,1805458124,4,326,81.5,1361384052318,1361384052446,1805432442,1805432570,128
1361384078,1805458176,1,77,77,1361384050729,1361384050729,1805430905,1805430905,0
1361384078,1805458176,1,77,77,1361384050728,1361384050728,1805430904,1805430904,0
1361384078,1805458200,9,5365,596.1111111,1361384050895,1361384051215,1805431095,1805431415,320
1361384078,1805458204,12,1368,114,1361384051021,1361384051341,1805431225,1805431545,320
1361384078,1805458204,1,46,46,1361384051084,1361384051084,1805431288,1805431288,0
1361384078,1805458220,2,94,47,1361384052350,1361384052990,1805432570,1805433210,640
1361384082,1805462004,7,2539,362.7142857,1361384057174,1361384057366,1805437178,1805437370,192
1361384082,1805462048,1,76,76,1361384054506,1361384054506,1805434554,1805434554,0
1361384082,1805462088,3,608,202.6666667,1361384056191,1361384056255,1805436279,1805436343,64
1361384083,443776544,17,5978,351.6470588,1361384056623,1361384080303,443750167,443773847,23680
1361384085,443779076,10,7748,774.8,1361384084572,1361384084892,443778648,443778968,320
1361384085,443779080,7,494,70.57142857,1361384070742,1361384084438,443764822,443778518,13696
1361384085,443779096,9,6886,765.1111111,1361384084422,1361384084486,443778518,443778582,64
1361384085,443779096,8,1466,183.25,1361384084550,1361384084742,443778646,443778838,192
1361384093,443787064,8,1274,159.25,1361384085482,1361384085930,443779546,443779994,448
1361384093,443787064,8,1482,185.25,1361384084582,1361384085094,443778646,443779158,512
1361384093,443787064,15,14241,949.4,1361384084582,1361384085478,443778646,443779542,896
1361384093,443787064,7,1458,208.2857143,1361384085993,1361384085993,443780057,443780057,0
1361384093,443787068,9,1272,141.3333333,1361384086053,1361384086245,443780121,443780313,192
1361384093,443787068,8,1434,179.25,1361384086053,1361384086181,443780121,443780249,128
1361384093,443787068,8,1386,173.25,1361384086053,1361384086181,443780121,443780249,128
1361384093,443787072,9,1550,172.2222222,1361384085534,1361384085982,443779606,443780054,448
1361384093,443787072,8,1168,146,1361384085470,1361384085662,443779542,443779734,192
1361384093,443787072,10,1318,131.8,1361384085470,1361384085982,443779542,443780054,512
1361384093,443787072,8,1504,188,1361384085534,1361384085982,443779606,443780054,448
1361384093,443787072,9,1550,172.2222222,1361384085534,1361384085982,443779606,443780054,448
1361384093,443787084,9,2200,244.4444444,1361384084563,1361384085075,443778647,443779159,512
1361384093,443787084,9,1528,169.7777778,1361384084563,1361384085139,443778647,443779223,576
1361384093,443787084,7,1324,189.1428571,1361384086034,1361384086162,443780118,443780246,128
1361384093,443787084,10,7860,786,1361384086034,1361384086162,443780118,443780246,128
1361384093,443787084,8,1658,207.25,1361384086034,1361384086354,443780118,443780438,320
1361384094,1805474244,24,26915,1121.458333,1361384070757,1361384086053,1805451001,1805466297,15296
1361384098,1805478096,1,46,46,1361384071031,1361384071031,1805451127,1805451127,0
1361384098,1805478096,6,2036,339.3333333,1361384071031,1361384071159,1805451127,1805451255,128
1361384101,443795068,3,169,56.33333333,1361384097508,1361384097508,443791576,443791576,0
1361384101,443795068,3,169,56.33333333,1361384097508,1361384097508,443791576,443791576,0
1361384101,443795068,2,123,61.5,1361384097508,1361384097508,443791576,443791576,0
1361384101,443795092,3,169,56.33333333,1361384097486,1361384097486,443791578,443791578,0
1361384101,443795092,2,123,61.5,1361384097550,1361384097550,443791642,443791642,0
1361384102,1805482012,2,92,46,1361384076427,1361384076427,1805456439,1805456439,0
1361384102,1805482164,2,92,46,1361384075893,1361384076021,1805456057,1805456185,128
1361384102,1805482244,2,92,46,1361384097765,1361384097765,1805478009,1805478009,0
1361384102,1805482244,4,205,51.25,1361384097764,1361384097764,1805478008,1805478008,0
1361384102,1805482244,2,92,46,1361384097764,1361384097764,1805478008,1805478008,0
1361384102,1805482244,4,205,51.25,1361384097764,1361384097764,1805478008,1805478008,0
1361384102,1805482248,5,803,160.6,1361384097953,1361384098017,1805478201,1805478265,64
1361384102,1805482252,6,397,66.16666667,1361384094874,1361384097754,1805475126,1805478006,2880
1361384102,1805482252,6,397,66.16666667,1361384094874,1361384097754,1805475126,1805478006,2880
1361384102,1805482252,6,397,66.16666667,1361384094874,1361384097754,1805475126,1805478006,2880
1361384102,1805482252,6,397,66.16666667,1361384094874,1361384097754,1805475126,1805478006,2880
1361384102,1805482284,8,580,72.5,1361384099006,1361384099262,1805479290,1805479546,256
1361384102,1805482328,2,92,46,1361384097679,1361384097679,1805478007,1805478007,0
1361384102,1805482328,2,92,46,1361384097679,1361384097679,1805478007,1805478007,0
1361384102,1805482328,2,92,46,1361384097678,1361384097678,1805478006,1805478006,0
1361384102,1805482328,2,92,46,1361384097678,1361384097678,1805478006,1805478006,0
1361384102,1805482332,233,194752,835.8454936,1361383901772,1361384097676,1805282104,1805478008,195904
1361384102,1805482332,5,337,67.4,1361384097931,1361384098059,1805478263,1805478391,128
1361384102,1805482336,6,397,66.16666667,1361384094791,1361384097671,1805475127,1805478007,2880
1361384102,1805482336,7,474,67.71428571,1361384094791,1361384097671,1805475127,1805478007,2880
1361384102,1805482372,5,803,160.6,1361384098852,1361384098916,1805479224,1805479288,64
1361384110,1805490008,2,265,132.5,1361384084175,1361384084239,1805464183,1805464247,64
1361384110,1805490272,8,531,66.375,1361384104265,1361384109385,1805484537,1805489657,5120
1361384110,1805490272,8,1501,187.625,1361384104264,1361384109384,1805484536,1805489656,5120
1361384110,1805490348,7,1402,200.2857143,1361384104186,1361384109306,1805484534,1805489654,5120
1361384110,1805490352,7,1455,207.8571429,1361384104184,1361384109304,1805484536,1805489656,5120
1361384111,443804552,4,1236,309,1361384085225,1361384104745,443778777,443798297,19520
1361384117,443811072,7,494,70.57142857,1361384104031,1361384109215,443798103,443803287,5184
1361384117,443811072,7,494,70.57142857,1361384104158,1361384110174,443798230,443804246,6016
1361384117,443811096,3,140,46.66666667,1361384104328,1361384110152,443798424,443804248,5824
1361384118,1805498224,2,471,235.5,1361384091064,1361384091128,1805471288,1805471352,64
1361384118,1805498352,2,94,47,1361384104376,1361384110328,1805484728,1805490680,5952
1361384118,1805498352,2,94,47,1361384104503,1361384110327,1805484855,1805490679,5824
1361384118,1805498352,2,94,47,1361384104630,1361384110326,1805484982,1805490678,5696
1361384118,1805498444,2,92,46,1361384104285,1361384110237,1805484729,1805490681,5952
1361384118,1805498444,2,94,47,1361384104413,1361384110237,1805484857,1805490681,5824
1361384122,1805502040,9,5377,597.4444444,1361384095537,1361384096113,1805475577,1805476153,576
1361384126,1805505960,1,46,46,1361384098047,1361384098047,1805478007,1805478007,0
1361384126,1805505960,1,46,46,1361384098047,1361384098047,1805478007,1805478007,0
1361384126,1805505960,1,46,46,1361384098110,1361384098110,1805478070,1805478070,0
1361384126,1805505964,1,46,46,1361384098169,1361384098169,1805478133,1805478133,0
1361384126,1805506048,26,35195,1353.653846,1361384101672,1361384103208,1805481720,1805483256,1536
1361384126,1805506052,1,46,46,1361384097957,1361384097957,1805478009,1805478009,0
1361384126,1805506052,1,46,46,1361384097957,1361384097957,1805478009,1805478009,0
1361384126,1805506208,1,77,77,1361384100937,1361384100937,1805481145,1805481145,0
1361384130,1805510032,6,4198,699.6666667,1361384104503,1361384104695,1805484535,1805484727,192
1361384130,1805510032,4,2186,546.5,1361384104694,1361384104822,1805484726,1805484854,128
1361384130,1805510036,4,2178,544.5,1361384104690,1361384104882,1805484726,1805484918,192
1361384130,1805510036,3,457,152.3333333,1361384104757,1361384104821,1805484793,1805484857,64
1361384130,1805510036,4,3234,808.5,1361384104884,1361384105012,1805484920,1805485048,128
1361384130,1805510036,4,3215,803.75,1361384104947,1361384105139,1805484983,1805485175,192
1361384130,1805510036,4,1312,328,1361384105010,1361384105266,1805485046,1805485302,256
1361384130,1805510036,3,269,89.66666667,1361384105074,1361384105074,1805485110,1805485110,0
1361384130,1805510040,3,693,231,1361384105070,1361384105134,1805485110,1805485174,64
1361384130,1805510060,3,200,66.66666667,1361384102108,1361384102300,1805482168,1805482360,192
1361384130,1805510112,6,4086,681,1361384104422,1361384104614,1805484534,1805484726,192
1361384130,1805510116,7,4899,699.8571429,1361384104418,1361384104610,1805484534,1805484726,192
1361384130,1805510116,7,4723,674.7142857,1361384104420,1361384104612,1805484536,1805484728,192
1361384130,1805510116,4,517,129.25,1361384104676,1361384104740,1805484792,1805484856,64
1361384131,443824492,8,7710,963.75,1361384104932,1361384104932,443798424,443798424,0
1361384134,1805514064,1,46,46,1361384108376,1361384108376,1805488440,1805488440,0
1361384134,1805514092,1,46,46,1361384108860,1361384108860,1805488952,1805488952,0
1361384134,1805514104,1,46,46,1361384105776,1361384105776,1805485880,1805485880,0
1361384149,443843072,8,2650,331.25,1361384145120,1361384145312,443839192,443839384,192
1361384149,443843072,9,1272,141.3333333,1361384145120,1361384145504,443839192,443839576,384
1361384149,443843072,8,1168,146,1361384145119,1361384145311,443839191,443839383,192
1361384149,443843088,11,10411,946.4545455,1361384144463,1361384145039,443838551,443839127,576
1361384149,443843092,8,1056,132,1361384145099,1361384145291,443839191,443839383,192
1361384157,443851072,7,494,70.57142857,1361384145120,1361384150304,443839192,443844376,5184
1361384157,443851088,7,1021,145.8571429,1361384152655,1361384152719,443846743,443846807,64
1361384157,443851088,28,33417,1193.464286,1361384152783,1361384152975,443846871,443847063,192
1361384157,443851092,7,494,70.57142857,1361384145099,1361384150283,443839191,443844375,5184
1361384158,1805538164,3,517,172.3333333,1361384131189,1361384131253,1805511353,1805511417,64
1361384158,1805538436,2,123,61.5,1361384155491,1361384155491,1805535927,1805535927,0
1361384165,443859088,8,540,67.5,1361384152784,1361384157776,443846872,443851864,4992
1361384166,1805546060,2,265,132.5,1361384139738,1361384139802,1805519798,1805519862,64
1361384174,1805554052,1,77,77,1361384147044,1361384147044,1805527096,1805527096,0
1361384174,1805554128,1,77,77,1361384145943,1361384145943,1805526071,1805526071,0
1361384182,1805562404,3,169,56.33333333,1361384181377,1361384181441,1805561781,1805561845,64
1361384190,1805570068,2,92,46,1361384163794,1361384163858,1805543862,1805543926,64
1361384190,1805570080,2,92,46,1361384164487,1361384164551,1805544567,1805544631,64
1361384190,1805570156,2,92,46,1361384163706,1361384163770,1805543862,1805543926,64
1361384190,1805570184,2,92,46,1361384164381,1361384164445,1805544565,1805544629,64
1361384194,1805574784,314,273037,869.544586,1361383568136,1361383890248,1804948920,1805271032,322112
1361384198,1805578064,3,523,174.3333333,1361384170645,1361384170709,1805550709,1805550773,64
1361384198,1805578176,3,2843,947.6666667,1361384170600,1361384170664,1805550776,1805550840,64
1361384198,1805578180,3,2234,744.6666667,1361384171105,1361384171233,1805551285,1805551413,128
1361384198,1805578216,1,46,46,1361384172094,1361384172094,1805552310,1805552310,0
1361384198,1805578372,4,205,51.25,1361384189921,1361384189921,1805570293,1805570293,0
1361384198,1805578380,6,366,61,1361384190427,1361384190491,1805570807,1805570871,64
1361384198,1805578380,3,169,56.33333333,1361384194458,1361384194458,1805574838,1805574838,0
1361384198,1805578488,7,412,58.85714286,1361384191343,1361384191407,1805571831,1805571895,64
1361384206,1805586368,2,123,61.5,1361384198440,1361384198440,1805578808,1805578808,0
1361384210,1805590068,3,1065,355,1361384182032,1361384182096,1805562100,1805562164,64
1361384210,1805590156,22,26105,1186.590909,1361384182009,1361384182137,1805562165,1805562293,128
1361384214,1805594216,1,46,46,1361384186174,1361384186174,1805566390,1805566390,0
1361384221,443915052,3,169,56.33333333,1361384219828,1361384219828,443913880,443913880,0
1361384222,1805602268,2,265,132.5,1361384194761,1361384194825,1805575029,1805575093,64
1361384222,1805602448,4,205,51.25,1361384217880,1361384217880,1805598328,1805598328,0
1361384222,1805602488,2,123,61.5,1361384219821,1361384219821,1805600309,1805600309,0
1361384238,1805618488,11,5576,506.9090909,1361384234284,1361384234348,1805614772,1805614836,64
1361384238,1805618700,3,523,174.3333333,1361384210138,1361384210202,1805590838,1805590902,64
1361384242,1805622468,1,46,46,1361384216832,1361384216832,1805597300,1805597300,0
1361384246,1805626700,1,46,46,1361384219611,1361384219611,1805600311,1805600311,0
1361384246,1805626700,1,46,46,1361384219673,1361384219673,1805600373,1805600373,0
1361384246,1805626780,1,46,46,1361384219529,1361384219529,1805600309,1805600309,0
1361384246,1805626780,1,46,46,1361384219528,1361384219528,1805600308,1805600308,0
1361384246,1805626780,1,46,46,1361384219528,1361384219528,1805600308,1805600308,0
1361384247,443940816,1,46,46,1361384220063,1361384220063,443913879,443913879,0
1361384258,1805638532,1,46,46,1361384230338,1361384230338,1805610870,1805610870,0
1361384258,1805638568,1,46,46,1361384231645,1361384231645,1805612213,1805612213,0
1361384278,1805658768,3,523,174.3333333,1361384250134,1361384250198,1805630902,1805630966,64
1361384278,1805658768,2,265,132.5,1361384250197,1361384250261,1805630965,1805631029,64
1361384319,1805698832,3,523,174.3333333,1361384291323,1361384291387,1805671155,1805671219,64
1361384322,1805702760,1,46,46,1361384296540,1361384296540,1805677300,1805677300,0
1361384323,1805702864,1,46,46,1361384297437,1361384297437,1805677301,1805677301,0
1361384331,1805710888,2,265,132.5,1361384306307,1361384306371,1805686195,1805686259,64
1361384359,1805738964,3,523,174.3333333,1361384331129,1361384331193,1805711093,1805711157,64
1361384381,444075136,43,53243,1238.209302,1361384380259,1361384380707,444074395,444074843,448
1361384381,444075136,12,5354,446.1666667,1361384380259,1361384380451,444074395,444074587,192
1361384387,1805767124,7,1360,194.2857143,1361384361751,1361384373591,1805741875,1805753715,11840
1361384395,1805775192,3,523,174.3333333,1361384370449,1361384370513,1805750641,1805750705,64
1361384399,1805778988,13,2368,182.1538462,1361384374367,1361384374879,1805754355,1805754867,512
1361384405,444099132,4171,6248165,1498.001678,1361384401702,1361384404902,444095834,444099034,3200
1361384405,444099156,7,925,132.1428571,1361384401676,1361384401740,444095832,444095896,64
1361384430,1805810552,3,569,189.6666667,1361384418090,1361384428778,1805798642,1805809330,10688
1361384439,1805819044,2,471,235.5,1361384411557,1361384411621,1805791601,1805791665,64
1361384463,1805843116,2,438,219,1361384437791,1361384455007,1805817907,1805835123,17216
1361384479,1805859284,7,2975,425,1361384451828,1361384468404,1805832112,1805848688,16576
1361384502,1805882632,6,381,63.5,1361384494041,1361384499225,1805874673,1805879857,5184
1361384511,1805891240,1,425,425,1361384485347,1361384485347,1805865587,1805865587,0
1361384515,1805895264,1,219,219,1361384489290,1361384489290,1805869554,1805869554,0
1361384518,1805898668,2,134,67,1361384504820,1361384515956,1805885488,1805896624,11136
1361384539,1805919208,2,492,246,1361384511871,1361384519167,1805892079,1805899375,7296
1361384563,1805943524,1,67,67,1361384538374,1361384538374,1805918898,1805918898,0
1361384611,1805991476,1,67,67,1361384583092,1361384583092,1805963568,1805963568,0
1361385424,1806804668,1,48,48,1361385398953,1361385398953,1806779621,1806779621,0
1361385855,1807234876,1,48,48,1361385827127,1361385827127,1807207003,1807207003,0
1361386656,1808036448,3,168,56,1361386647983,1361386650607,1808028431,1808031055,2624
1361386656,1808036576,3,156,52,1361386644079,1361386655663,1808024655,1808036239,11584
1361386675,1808055496,13,4244,326.4615385,1361386647617,1361386654913,1808028113,1808035409,7296
1361386679,1808059432,1,64,64,1361386651264,1361386651264,1808031696,1808031696,0
1361386731,1808111624,9,2264,251.5555556,1361386705599,1361386712255,1808086223,1808092879,6656
1361386779,1808159644,2,104,52,1361386766826,1361386772330,1808147470,1808152974,5504
1361386801,1808180964,2,104,52,1361386783059,1361386793043,1808163023,1808173007,9984
1361386817,1808196900,2,104,52,1361386803091,1361386813075,1808182991,1808192975,9984
1361386840,1808220776,4,271,67.75,1361386832742,1361386833382,1808213518,1808214158,640
1361386841,1808220844,5,317,63.4,1361386835724,1361386839436,1808215568,1808219280,3712
1361386841,1808220848,3,168,56,1361386833032,1361386833608,1808212880,1808213456,576
1361386841,1808220888,3,168,56,1361386834719,1361386835423,1808214607,1808215311,704
1361386847,1808227716,1,52,52,1361386822305,1361386822305,1808203021,1808203021,0
1361386859,1808239636,23,5776,251.1304348,1361386832499,1361386838259,1808213135,1808218895,5760
1361386859,1808239784,1,52,52,1361386833501,1361386833501,1808214285,1808214285,0
1361386865,1808244864,15,3759,250.6,1361386860789,1361386862389,1808240653,1808242253,1600
1361386865,1808244916,13,3510,270,1361386862848,1361386864320,1808242764,1808244236,1472
1361386867,1808247704,1,64,64,1361386838892,1361386838892,1808219596,1808219596,0
1361386872,1808252808,19,4796,252.4210526,1361386861895,1361386864519,1808242703,1808245327,2624
1361386873,1808252876,3,168,56,1361386870249,1361386870889,1808250125,1808250765,640
1361386873,1808252884,13,3522,270.9230769,1361386862883,1361386865379,1808242767,1808245263,2496
1361386891,1808271708,9,3463,384.7777778,1361386864808,1361386865896,1808245516,1808246604,1088
1361386896,1808275900,1,64,64,1361386871187,1361386871187,1808251087,1808251087,0
1361386961,1808340848,2,110,55,1361386950723,1361386960835,1808330571,1808340683,10112
1361386968,1808348804,3,168,56,1361386959880,1361386959944,1808340684,1808340748,64
1361386972,1808351860,1,46,46,1361386947258,1361386947258,1808327118,1808327118,0
1361386975,1808355808,4,811,202.75,1361386947653,1361386947909,1808328461,1808328717,256
1361386976,1808356820,2,110,55,1361386960056,1361386971000,1808340876,1808351820,10944
1361386992,1808371852,1,46,46,1361386966015,1361386966015,1808345867,1808345867,0
1361386993,1808372840,2,131,65.5,1361386986701,1361386986701,1808366541,1808366541,0
1361387065,1808444848,16,3312,207,1361387061060,1361387062852,1808440908,1808442700,1792
1361387068,1808448060,2,337,168.5,1361387043310,1361387065966,1808423370,1808446026,22656
1361387072,1808452804,15,3484,232.2666667,1361387064391,1361387066311,1808445195,1808447115,1920
1361387072,1808452808,13,3168,243.6923077,1361387064642,1361387066562,1808445450,1808447370,1920
1361387072,1808452816,14,6710,479.2857143,1361387068411,1361387069883,1808449227,1808450699,1472
1361387072,1808452816,23,3876,168.5217391,1361387068538,1361387070266,1808449354,1808451082,1728
1361387073,1808452844,23,5698,247.7391304,1361387067270,1361387069254,1808447114,1808449098,1984
1361387073,1808452932,17,3385,199.1176471,1361387070829,1361387072365,1808450761,1808452297,1536
1361387073,1808452936,28,9750,348.2142857,1361387062763,1361387065131,1808442699,1808445067,2368
1361387081,1808460828,24,3703,154.2916667,1361387072983,1361387074967,1808452811,1808454795,1984
1361387081,1808460836,70,68008,971.5428571,1361387076686,1361387079758,1808456522,1808459594,3072
1361387081,1808460872,17,3981,234.1764706,1361387074924,1361387077868,1808454796,1808457740,2944
1361387084,1808464072,9,4004,444.8888889,1361387058593,1361387060065,1808438665,1808440137,1472
1361387089,1808468904,17,3435,202.0588235,1361387079690,1361387081610,1808459594,1808461514,1920
1361387089,1808468920,25,3675,147,1361387081657,1361387083769,1808461577,1808463689,2112
1361412636,1834016312,1,48,48,1361412609134,1361412609134,1833989446,1833989446,0
1361412683,1834063300,1,48,48,1361412655802,1361412655802,1834036102,1834036102,0
1361412974,1834354084,2,92,46,1361412947599,1361412950607,1834327683,1834330691,3008
1361414287,1835667148,1,46,46,1361414257659,1361414257659,1835637807,1835637807,0
1361480172,1901552360,1,88,88,1361480146502,1361480146502,1901526862,1901526862,0
1361480634,1902014196,1,46,46,1361480605795,1361480605795,1901985991,1901985991,0
1361482112,1903491536,1,46,46,1361482086244,1361482086244,1903465780,1903465780,0
1361482864,1904243756,1,48,48,1361482835388,1361482835388,1904215144,1904215144,0
1361483081,1904461420,2,110,55,1361483054878,1361483077854,1904435298,1904458274,22976
1361483085,1904465348,16,3914,244.625,1361483057959,1361483060711,1904438307,1904441059,2752
1361483170,1904549628,4,230,57.5,1361483145400,1361483145912,1904525028,1904525540,512
1361483407,1904786688,8,1292,161.5,1361483397494,1361483401206,1904777182,1904780894,3712
1361483407,1904786724,6,1008,168,1361483400403,1361483406291,1904780127,1904786015,5888
1361483407,1904786756,10,6276,627.6,1361483400754,1361483406578,1904780510,1904786334,5824
1361483418,1904798504,1,64,64,1361483391879,1361483391879,1904772383,1904772383,0
1361483419,1904798668,9,3475,386.1111111,1361483393740,1361483395084,1904773408,1904774752,1344
1361483423,1904802704,1,46,46,1361483397156,1361483397156,1904776860,1904776860,0
1361483423,1904802708,1,52,52,1361483397411,1361483397411,1904777119,1904777119,0
1361483423,1904802752,8,3569,446.125,1361483395255,1361483396471,1904775007,1904776223,1216
1361483423,1904802772,17,3966,233.2941176,1361483395681,1361483398945,1904775453,1904778717,3264
1361483423,1904802820,25,8866,354.64,1361483397044,1361483403316,1904776864,1904783136,6272
1361483431,1904810524,1,64,64,1361483403801,1361483403801,1904783325,1904783325,0
1361483519,1904899028,2,131,65.5,1361483514530,1361483514530,1904894558,1904894558,0
1361483655,1905034884,1,60,60,1361483627757,1361483627757,1905007641,1905007641,0
1361483663,1905043272,1,52,52,1361483635948,1361483635948,1905016220,1905016220,0
1361483671,1905051236,1,46,46,1361483646605,1361483646605,1905026841,1905026841,0
1361483671,1905051276,1,329,329,1361483644005,1361483644005,1905024281,1905024281,0
1361483671,1905051352,1,462,462,1361483646107,1361483646107,1905026459,1905026459,0
1361483715,1905095400,1,46,46,1361483689322,1361483689322,1905069722,1905069722,0
1361483752,1905131628,3,168,56,1361483748332,1361483748908,1905127960,1905128536,576
1361483752,1905131660,3,168,56,1361483749196,1361483750092,1905128856,1905129752,896
1361483752,1905131676,3,168,56,1361483747324,1361483747900,1905127000,1905127576,576
1361483752,1905131708,3,168,56,1361483750814,1361483751390,1905130522,1905131098,576
1361483760,1905139536,3,168,56,1361483752264,1361483752968,1905131800,1905132504,704
1361483760,1905139572,3,168,56,1361483754215,1361483754727,1905133787,1905134299,512
1361483760,1905139624,3,168,56,1361483753075,1361483753779,1905132699,1905133403,704
1361483768,1905147632,3,168,56,1361483764648,1361483764776,1905144280,1905144408,128
1361483775,1905155392,21,4487,213.6666667,1361483749361,1361483762609,1905129753,1905143001,13248
1361483776,1905155616,11,4172,379.2727273,1361483750842,1361483754746,1905130458,1905134362,3904
1361483779,1905159232,1,52,52,1361483751568,1361483751568,1905131800,1905131800,0
1361483792,1905171692,3,168,56,1361483790254,1361483790958,1905169946,1905170650,704
1361483792,1905171696,2,116,58,1361483791274,1361483791594,1905170970,1905171290,320
1361483820,1905199648,1,52,52,1361483792023,1361483792023,1905171671,1905171671,0
1361483820,1905199688,17,4423,260.1764706,1361483793008,1361483809520,1905172696,1905189208,16512
1361483820,1905199724,1,52,52,1361483794443,1361483794443,1905174167,1905174167,0
1361483836,1905215720,1,68,68,1361483809297,1361483809297,1905189017,1905189017,0
1361483848,1905227912,3,168,56,1361483844113,1361483844561,1905224025,1905224473,448
1361483848,1905227916,3,168,56,1361483840138,1361483841674,1905220054,1905221590,1536
1361483848,1905228020,3,168,56,1361483845668,1361483846500,1905225688,1905226520,832
1361483848,1905228032,3,168,56,1361483843030,1361483843606,1905223062,1905223638,576
1361483848,1905228036,2,116,58,1361483847061,1361483847701,1905227097,1905227737,640
1361483856,1905235984,3,168,56,1361483848391,1361483849031,1905228375,1905229015,640
1361483868,1905247656,18,4034,224.1111111,1361483841937,1361483846865,1905221593,1905226521,4928
1361483872,1905251576,1,52,52,1361483844511,1361483844511,1905224087,1905224087,0
1361483876,1905255724,1,52,52,1361483848330,1361483848330,1905228054,1905228054,0
1361483880,1905259952,3,219,73,1361483877545,1361483878569,1905257497,1905258521,1024
1361483888,1905267988,3,168,56,1361483881412,1361483882692,1905261400,1905262680,1280
1361483896,1905275664,4,888,222,1361483869832,1361483881928,1905249496,1905261592,12096
1361483908,1905287604,1,52,52,1361483880261,1361483880261,1905259865,1905259865,0
1361483908,1905287728,17,3974,233.7647059,1361483880966,1361483886150,1905260694,1905265878,5184
1361483944,1905324100,3,168,56,1361483941523,1361483941971,1905321623,1905322071,448
1361483944,1905324104,5,296,59.2,1361483931151,1361483941135,1905311255,1905321239,9984
1361483944,1905324128,3,168,56,1361483942647,1361483943735,1905322775,1905323863,1088
1361483952,1905331988,4,220,55,1361483944194,1361483945026,1905324182,1905325014,832
1361483952,1905332076,3,168,56,1361483945260,1361483946604,1905325336,1905326680,1344
1361483968,1905347664,19,4086,215.0526316,1361483939909,1361483945349,1905319573,1905325013,5440
1361483968,1905347716,1,46,46,1361483942420,1361483942420,1905322136,1905322136,0
1361483968,1905347744,1,52,52,1361483942775,1361483942775,1905322519,1905322519,0
1361483972,1905352044,1,52,52,1361483943883,1361483943883,1905323927,1905323927,0
1361483980,1905359772,1,52,52,1361483954520,1361483954520,1905334292,1905334292,0
1361484000,1905380144,3,156,52,1361483994215,1361483996903,1905374359,1905377047,2688
1361484008,1905388128,3,168,56,1361484005430,1361484006006,1905385558,1905386134,576
1361484016,1905396136,3,168,56,1361484009455,1361484010351,1905389591,1905390487,896
1361484016,1905396152,4,271,67.75,1361484006878,1361484008734,1905387030,1905388886,1856
1361484028,1905407864,1,52,52,1361484000638,1361484000638,1905380502,1905380502,0
1361484032,1905411716,17,3974,233.7647059,1361484004755,1361484009875,1905384471,1905389591,5120
1361484032,1905411880,1,52,52,1361484006252,1361484006252,1905386132,1905386132,0
1361484232,1905612416,4,271,67.75,1361484230545,1361484231569,1905610961,1905611985,1024
1361484232,1905612448,3,168,56,1361484228529,1361484229297,1905608977,1905609745,768
1361484232,1905612488,3,168,56,1361484229386,1361484230154,1905609874,1905610642,768
1361484241,1905620532,38,6037,158.8684211,1361484232005,1361484233989,1905611537,1905613521,1984
1361484248,1905628396,19,7514,395.4736842,1361484228581,1361484245797,1905608977,1905626193,17216
1361484248,1905628400,23,6561,285.2608696,1361484244643,1361484246499,1905625043,1905626899,1856
1361484248,1905628400,28,6048,216,1361484245026,1361484246946,1905625426,1905627346,1920
1361484248,1905628468,2,110,55,1361484232415,1361484246751,1905612883,1905627219,14336
1361484249,1905628516,3,168,56,1361484247701,1361484247829,1905627217,1905627345,128
1361484249,1905628516,3,168,56,1361484247892,1361484248148,1905627408,1905627664,256
1361484252,543945348,13,14192,1091.692308,1361484249669,1361484249797,543943017,543943145,128
1361484252,1905632156,2,1179,589.5,1361484227733,1361484243285,1905607889,1905623441,15552
1361484256,1905636088,26,23655,909.8076923,1361484228892,1361484243548,1905608980,1905623636,14656
1361484256,1905636196,88,102930,1169.659091,1361484228975,1361484242543,1905609171,1905622739,13568
1361484256,1905636472,17,3815,224.4117647,1361484248218,1361484249050,1905628690,1905629522,832
1361484260,1905640224,1,46,46,1361484232020,1361484232020,1905612244,1905612244,0
1361484264,1905644444,26,5207,200.2692308,1361484258232,1361484259256,1905638676,1905639700,1024
1361484264,1905644444,39,7021,180.025641,1361484258231,1361484261559,1905638675,1905642003,3328
1361484264,1905644448,16,3306,206.625,1361484262578,1361484262962,1905643026,1905643410,384
1361484264,1905644484,32,7001,218.78125,1361484248207,1361484257807,1905628691,1905638291,9600
1361484265,1905644528,15,3907,260.4666667,1361484247051,1361484259531,1905626579,1905639059,12480
1361484272,1905652216,49,6151,125.5306122,1361484245913,1361484271577,1905626129,1905651793,25664
1361484272,1905652436,5,2551,510.2,1361484265468,1361484270332,1905645904,1905650768,4864
1361484276,1905656092,7,3880,554.2857143,1361484248087,1361484248983,1905628179,1905629075,896
1361484276,1905656124,17,22451,1320.647059,1361484249142,1361484249206,1905629266,1905629330,64
1361484276,543969912,5,3772,754.4,1361484249105,1361484249233,543943017,543943145,128
1361484276,1905656212,18,16288,904.8888889,1361484247903,1361484249247,1905628115,1905629459,1344
1361484276,1905656212,18,13746,763.6666667,1361484247966,1361484258142,1905628178,1905638354,10176
1361484276,1905656224,6,5071,845.1666667,1361484248849,1361484249041,1905629073,1905629265,192
1361484280,1905660508,2,131,65.5,1361484273079,1361484273079,1905653587,1905653587,0
1361484281,1905660536,4,1631,407.75,1361484275392,1361484280256,1905654928,1905659792,4864
1361484281,1905660576,2,131,65.5,1361484273177,1361484273177,1905652753,1905652753,0
1361484284,1905664064,14,3639,259.9285714,1361484256689,1361484261233,1905636753,1905641297,4544
1361484288,1905668100,7,3438,491.1428571,1361484262220,1361484262540,1905642320,1905642640,320
1361484289,1905668548,6,2002,333.6666667,1361484281076,1361484287668,1905660624,1905667216,6592
1361484289,1905668584,3,138,46,1361484283026,1361484283026,1905662610,1905662610,0
1361484304,1905684508,19,4784,251.7894737,1361484301619,1361484302195,1905682127,1905682703,576
1361484304,1905684508,13,3522,270.9230769,1361484301623,1361484302391,1905682131,1905682899,768
1361484305,1905684588,13,4206,323.5384615,1361484302539,1361484303243,1905682127,1905682831,704
1361484305,1905684592,12,3470,289.1666667,1361484302539,1361484303307,1905682131,1905682899,768
1361484308,1905688240,84,103807,1235.797619,1361484282432,1361484288256,1905662672,1905668496,5824
1361484321,1905700760,2,131,65.5,1361484318434,1361484318434,1905698194,1905698194,0
1361484328,1905708408,6,1731,288.5,1361484302361,1361484302553,1905682769,1905682961,192
1361484332,1905712496,2,104,52,1361484304258,1361484304322,1905684754,1905684818,64
1361484337,1905716780,4,208,52,1361484333135,1361484335183,1905712915,1905714963,2048
1361484345,1905724712,2,104,52,1361484337615,1361484342351,1905717327,1905722063,4736
1361484353,1905732884,3,156,52,1361484347685,1361484350053,1905727569,1905729937,2368
1361484356,1905736472,1,52,52,1361484330010,1361484330010,1905710482,1905710482,0
1361484357,1905736512,1,52,52,1361484328983,1361484328983,1905708495,1905708495,0
1361484361,1905740736,2,104,52,1361484353398,1361484359798,1905733134,1905739534,6400
1361484369,1905748672,7,1022,146,1361484343353,1361484359801,1905723025,1905739473,16448
1361484377,1905756672,2,104,52,1361484351802,1361484370554,1905731474,1905750226,18752
1361484377,1905756720,6,312,52,1361484369352,1361484376776,1905749072,1905756496,7424
1361484377,1905756800,5,260,52,1361484369464,1361484373112,1905749264,1905752912,3648
1361484385,1905764732,2,104,52,1361484377020,1361484384764,1905756752,1905764496,7744
1361484393,1905772824,4,289,72.25,1361484391710,1361484392606,1905771534,1905772430,896
1361484397,1905776548,1,52,52,1361484372724,1361484372724,1905752272,1905752272,0
1361484401,1905780564,1,146,146,1361484376675,1361484376675,1905756239,1905756239,0
1361484401,1905780908,2,104,52,1361484384202,1361484399562,1905764110,1905779470,15360
1361484401,1905780924,3,237,79,1361484393598,1361484400382,1905773522,1905780306,6784
1361484425,1905804540,1,52,52,1361484398267,1361484398267,1905777807,1905777807,0
1361484425,1905804584,1,52,52,1361484400399,1361484400399,1905779983,1905779983,0
1361484433,1905812704,1,52,52,1361484408151,1361484408151,1905787855,1905787855,0
1361484433,1905812900,2,158,79,1361484409427,1361484427475,1905789327,1905807375,18048
1361484437,1905816668,1,146,146,1361484410045,1361484410045,1905789713,1905789713,0
1361484457,1905836560,1,52,52,1361484430567,1361484430567,1905810127,1905810127,0
1361484457,1905836692,1,52,52,1361484431201,1361484431201,1905810893,1905810893,0
1361484477,1905856848,1,52,52,1361484449030,1361484449030,1905828878,1905828878,0
1361484489,1905868900,1,79,79,1361484463572,1361484463572,1905843472,1905843472,0
1361484501,1905881052,1,146,146,1361484476601,1361484476601,1905856653,1905856653,0
1361484505,1905885216,4,208,52,1361484502423,1361484503959,1905882639,1905884175,1536
1361484533,1905913088,1,52,52,1361484505941,1361484505941,1905886029,1905886029,0
1361484553,1905932988,1,46,46,1361484527291,1361484527291,1905907279,1905907279,0
1361484577,1905957068,1,46,46,1361484550248,1361484550248,1905930316,1905930316,0
1361484577,1905957080,1,46,46,1361484551070,1361484551070,1905931150,1905931150,0
1361484621,1906001212,1,146,146,1361484596504,1361484596504,1905976716,1905976716,0
1361484730,1906109752,7,1750,250,1361484707809,1361484727073,1906087561,1906106825,19264
1361484742,1906121516,1,146,146,1361484717518,1361484717518,1906097034,1906097034,0
1361484754,1906133884,3,156,52,1361484749340,1361484750108,1906129224,1906129992,768
1361484756,544449356,4,208,52,1361484749822,1361484751294,544443178,544444650,1472
1361484762,1906141608,3,849,283,1361484737202,1361484757234,1906116810,1906136842,20032
1361484794,1906174016,1,283,283,1361484766810,1361484766810,1906146826,1906146826,0
1361484862,1906242128,1,146,146,1361484837224,1361484837224,1906217352,1906217352,0
1361484983,1906362516,1,146,146,1361484958157,1361484958157,1906337673,1906337673,0
1361485103,1906482804,1,146,146,1361485078187,1361485078187,1906457991,1906457991,0
1361485223,1906603000,1,146,146,1361485198307,1361485198307,1906578307,1906578307,0
1361487389,1908769400,1,64,64,1361487364085,1361487364085,1908744485,1908744485,0
1361487393,1908773300,17,3974,233.7647059,1361487367254,1361487370582,1908747554,1908750882,3328
1361487474,1908853728,3,156,52,1361487470033,1361487473297,1908849761,1908853025,3264
1361487490,1908869704,2,104,52,1361487477611,1361487486315,1908857315,1908866019,8704
1361487514,1908893812,2,104,52,1361487496190,1361487506174,1908876002,1908885986,9984
1361487530,1908909780,2,104,52,1361487516190,1361487526238,1908895970,1908906018,10048
1361488862,1910241544,1,46,46,1361488833651,1361488833651,1910213195,1910213195,0
1361489297,1910676928,1,48,48,1361489268973,1361489268973,1910648901,1910648901,0
1361489459,1910838884,1,48,48,1361489432791,1361489432791,1910812675,1910812675,0
1361490212,1911591604,1,46,46,1361490187686,1361490187686,1911567290,1911567290,0
1361490416,1911796028,1,46,46,1361490390779,1361490390779,1911770807,1911770807,0
1361490616,1911996248,1,46,46,1361490588124,1361490588124,1911968372,1911968372,0
1361513559,1934938492,1,46,46,1361513531895,1361513531895,1934911387,1934911387,0
1361513666,1935045768,3,138,46,1361513638243,1361513647203,1935018011,1935026971,8960
1361514487,1935867564,1,78,78,1361514462328,1361514462328,1935842892,1935842892,0
1361514952,1936332088,1,46,46,1361514926351,1361514926351,1936306439,1936306439,0
1361515782,1937161596,1,46,46,1361515756333,1361515756333,1937135929,1937135929,0
1361516495,1937874636,4,256,64,1361516469565,1361516490621,1937849201,1937870257,21056
1361516575,1937954708,1,46,46,1361516550257,1361516550257,1937929965,1937929965,0
1361517608,1938988168,1,60,60,1361517580119,1361517580119,1938960287,1938960287,0
1361518731,1940110592,1,46,46,1361518706760,1361518706760,1940086352,1940086352,0
1361518931,1940311384,1,46,46,1361518902378,1361518902378,1940282762,1940282762,0
1361519271,1940651396,1,52,52,1361519244697,1361519244697,1940625093,1940625093,0
1361519400,1940780236,1,46,46,1361519372279,1361519372279,1940752515,1940752515,0
1361520325,1941704772,1,46,46,1361520297724,1361520297724,1941677496,1941677496,0
1361521213,1942592856,1,46,46,1361521184791,1361521184791,1942564647,1942564647,0
1361521981,1943361304,2,230,115,1361521953420,1361521953484,1943333724,1943333788,64
1361522923,1944303336,1,46,46,1361522898080,1361522898080,1944278416,1944278416,0
1361523113,1944492448,1,48,48,1361523087573,1361523087573,1944467021,1944467021,0
1361523180,1944559560,2,96,48,1361523155300,1361523158244,1944534860,1944537804,2944
1361523877,1945256452,1,60,60,1361523851845,1361523851845,1945231297,1945231297,0
1361524041,1945420720,1,60,60,1361524013621,1361524013621,1945393341,1945393341,0
1361524065,1945444764,1,60,60,1361524039435,1361524039435,1945419199,1945419199,0
1361524301,1945681212,1,46,46,1361524275784,1361524275784,1945655996,1945655996,0
1361524887,1946266884,1,60,60,1361524859974,1361524859974,1946239858,1946239858,0
1361526002,1947381556,1,46,46,1361525977020,1361525977020,1947356576,1947356576,0
1361527260,1948639976,1,46,46,1361527232455,1361527232455,1948612431,1948612431,0
1361527300,1948680020,1,60,60,1361527272347,1361527272347,1948652367,1948652367,0
1361527336,1948716096,3,411,137,1361527311436,1361527317516,1948691532,1948697612,6080
1361528110,1949489984,3,144,48,1361528085364,1361528094260,1949465348,1949474244,8896
1361528664,1950043572,3,411,137,1361528639876,1361528645956,1950019448,1950025528,6080
1361530457,1951836496,1,48,48,1361530431606,1361530431606,1951811102,1951811102,0
1361531085,1952464544,3,504,168,1361531060797,1361531066813,1952440341,1952446357,6016
1361531337,1952716956,4,202,50.5,1361531312605,1361531334109,1952692561,1952714065,21504
1361531413,1952793104,1,48,48,1361531387722,1361531387722,1952767826,1952767826,0
1361531436,1952815804,1,46,46,1361531407733,1361531407733,1952787537,1952787537,0
1361532034,1953413948,3,411,137,1361532008603,1361532014619,1953388551,1953394567,6016
1361532709,1954088656,1,46,46,1361532683894,1361532683894,1954063550,1954063550,0
1361533145,1954525056,3,504,168,1361533117151,1361533123167,1954497207,1954503223,6016
1361533158,1954538336,1,46,46,1361533130567,1361533130567,1954510903,1954510903,0
1361533943,1955322716,5,250,50,1361533916072,1361533938088,1955295788,1955317804,22016
1361534019,1955398784,1,48,48,1361533991331,1361533991331,1955371115,1955371115,0
1361534155,1955535184,1,60,60,1361534129103,1361534129103,1955509287,1955509287,0
1361535579,1956958612,3,504,168,1361535553207,1361535559223,1956932819,1956938835,6016
1361535929,595622752,1,46,46,1361535903230,1361535903230,595596982,595596982,0
1361536299,1957679300,3,498,166,1361536274555,1361536280571,1957654855,1957660871,6016
1361536500,1957879772,3,411,137,1361536473737,1361536479753,1957853509,1957859525,6016
1361537834,1959213932,6,1101,183.5,1361537807638,1361537824150,1959187570,1959204082,16512
1361538104,1959483640,1,46,46,1361538076854,1361538076854,1959456494,1959456494,0
1361538784,1960164020,3,411,137,1361538757101,1361538763117,1960137121,1960143137,6016
1361538988,1960368244,3,180,60,1361538962955,1361538965963,1960343199,1960346207,3008
1361539213,1960592436,1,46,46,1361539187441,1361539187441,1960566877,1960566877,0
1361540326,1961706204,1,46,46,1361540298526,1361540298526,1961678730,1961678730,0
1361540499,1961878636,3,504,168,1361540471958,1361540477974,1961851594,1961857610,6016
1361540879,1962259032,1,46,46,1361540853637,1361540853637,1962233669,1962233669,0
1361541085,1962464488,1,48,48,1361541056225,1361541056225,1962435713,1962435713,0
1361541225,1962604684,1,46,46,1361541199386,1361541199386,1962579070,1962579070,0
1361541417,1962796660,3,411,137,1361541390640,1361541396720,1962770300,1962776380,6080
1361548062,1969442120,4,244,61,1361548033918,1361548044478,1969414038,1969424598,10560
1361548170,1969549964,4,244,61,1361548144025,1361548154585,1969523989,1969534549,10560
1361548414,1969793536,4,271,67.75,1361548412739,1361548412867,1969792275,1969792403,128
1361548414,1969793576,5,296,59.2,1361548409497,1361548412633,1969789073,1969792209,3136
1361548414,1969793576,4,220,55,1361548409369,1361548409753,1969788945,1969789329,384
1361548414,1969793604,4,271,67.75,1361548412798,1361548412926,1969792402,1969792530,128
1361548430,1969809592,3,168,56,1361548422986,1361548423114,1969802578,1969802706,128
1361548438,1969817740,12,3362,280.1666667,1361548431924,1361548432436,1969811664,1969812176,512
1361548439,1969818460,18,4613,256.2777778,1361548412684,1361548414924,1969792144,1969794384,2240
1361548439,1969818484,1,64,64,1361548413044,1361548413044,1969792528,1969792528,0
1361548447,1969826452,2,156,78,1361548420564,1361548435668,1969800016,1969815120,15104
1361548451,1969830480,1,64,64,1361548423355,1361548423355,1969802835,1969802835,0
1361548459,1969838480,10,3515,351.5,1361548433018,1361548433786,1969812498,1969813266,768
1361548495,1969874488,7,3030,432.8571429,1361548468272,1361548468528,1969847760,1969848016,256
1361548499,1969878548,1,46,46,1361548472758,1361548472758,1969852306,1969852306,0
1361548558,1969937800,3,210,70,1361548553014,1361548553334,1969932814,1969933134,320
1361555373,1976753200,2,131,65.5,1361555370689,1361555370689,1976750889,1976750889,0
1361555478,1976857344,10,11520,1152,1361555452760,1361555468632,1976832104,1976847976,15872
1361555491,1976870608,1,48,48,1361555462802,1361555462802,1976842410,1976842410,0
1361555510,1976889312,1,1426,1426,1361555484665,1361555484665,1976863977,1976863977,0
1361555538,1976917452,2,1938,969,1361555512747,1361555516523,1976892199,1976895975,3776
1361555618,1976997784,1,52,52,1361555591901,1361555591901,1976971685,1976971685,0
1361555843,1977222304,3,396,132,1361555816444,1361555822460,1977195748,1977201764,6016
1361555999,1977378656,4,319,79.75,1361555992857,1361555996249,1977372513,1977375905,3392
1361556015,1977394596,2,178,89,1361556000723,1361556009683,1977380319,1977389279,8960
1361556055,1977435036,1,89,89,1361556027100,1361556027100,1977407136,1977407136,0
1361556091,1977471028,1,89,89,1361556062884,1361556062884,1977442912,1977442912,0
1361556159,1977539056,1,89,89,1361556134340,1361556134340,1977514396,1977514396,0
1361556380,1977759392,3,435,145,1361556352092,1361556358108,1977731484,1977737500,6016
1361556468,1977847560,3,414,138,1361556440691,1361556446707,1977820251,1977826267,6016
1361556973,1978352824,1,46,46,1361556947363,1361556947363,1978327187,1978327187,0
1361557109,1978489160,3,396,132,1361557082833,1361557088913,1978462993,1978469073,6080
1361557864,1979243604,3,393,131,1361557837807,1361557843823,1979217411,1979223427,6016
1361558040,1979420048,2,120,60,1361558012146,1361558013170,1979392194,1979393218,1024
1361558157,1979536528,1,74,74,1361558132665,1361558132665,1979512193,1979512193,0
1361558895,1980274588,5,2826,565.2,1361558870128,1361558892208,1980249716,1980271796,22080
1361558946,1980325896,3,168,56,1361558943803,1361558944763,1980323699,1980324659,960
1361558946,1980325964,3,168,56,1361558938296,1361558938936,1980318260,1980318900,640
1361558954,1980333932,3,168,56,1361558946007,1361558946519,1980325939,1980326451,512
1361558967,1980346736,18,4618,256.5555556,1361558941915,1361558945563,1980321651,1980325299,3648
1361558971,1980350600,1,46,46,1361558943396,1361558943396,1980322996,1980322996,0
1361558971,1980350672,1,52,52,1361558946141,1361558946141,1980325813,1980325813,0
1361558975,1980354612,1,64,64,1361558947222,1361558947222,1980326834,1980326834,0
1361558975,1980354624,1,46,46,1361558948107,1361558948107,1980327731,1980327731,0
1361559026,1980406056,4,220,55,1361559024284,1361559025756,1980404340,1980405812,1472
1361559034,1980413940,4,232,58,1361559027725,1361559032653,1980407665,1980412593,4928
1361559034,1980414132,3,168,56,1361559026128,1361559027216,1980406260,1980407348,1088
1361559043,1980422780,10,3523,352.3,1361559016943,1361559019183,1980396723,1980398963,2240
1361559130,1980509976,2,104,52,1361559127847,1361559129447,1980507823,1980509423,1600
1361559146,1980526056,4,289,72.25,1361559138585,1361559144473,1980518641,1980524529,5888
1361559146,1980526064,2,104,52,1361559132496,1361559138704,1980512560,1980518768,6208
1361559162,1980541988,2,104,52,1361559148827,1361559158811,1980528815,1980538799,9984
1361559170,1980550020,2,158,79,1361559152446,1361559168190,1980532466,1980548210,15744
1361559186,1980566080,2,104,52,1361559168703,1361559178687,1980548783,1980558767,9984
1361559215,1980594980,1,52,52,1361559188835,1361559188835,1980568815,1980568815,0
1361559218,1980598008,3,168,56,1361559215113,1361559215689,1980595121,1980595697,576
1361559218,1980598044,2,116,58,1361559216932,1361559217636,1980596976,1980597680,704
1361559218,1980598088,4,271,67.75,1361559215929,1361559216505,1980596017,1980596593,576
1361559226,1980606100,2,110,55,1361559210221,1361559220717,1980590321,1980600817,10496
1361559227,1980606956,1,79,79,1361559199804,1361559199804,1980579760,1980579760,0
1361559235,1980614856,17,3970,233.5294118,1361559210528,1361559214560,1980590384,1980594416,4032
1361559243,1980623032,1,52,52,1361559217969,1361559217969,1980598001,1980598001,0
1361559322,1980702040,5,374,74.8,1361559314088,1361559316264,1980694128,1980696304,2176
1361559322,1980702052,3,168,56,1361559316315,1361559316699,1980696367,1980696751,384
1361559338,1980718044,13,4783,367.9230769,1361559330531,1361559334179,1980710575,1980714223,3648
1361559338,1980718044,4,220,55,1361559332001,1361559335521,1980712045,1980715565,3520
1361559338,1980718048,3,168,56,1361559335645,1361559336605,1980715693,1980716653,960
1361559343,1980722936,1,64,64,1361559317006,1361559317006,1980696942,1980696942,0
1361559346,1980726100,5,296,59.2,1361559336873,1361559341609,1980716973,1980721709,4736
1361559354,1980734096,2,116,58,1361559353519,1361559353839,1980733615,1980733935,320
1361559355,1980735016,1,46,46,1361559327551,1361559327551,1980707567,1980707567,0
1361559362,1980742104,2,110,55,1361559342373,1361559356261,1980722477,1980736365,13888
1361559363,1980743204,11,4941,449.1818182,1361559335363,1361559337987,1980715567,1980718191,2624
1361559367,1980747244,1,46,46,1361559341722,1361559341722,1980721966,1980721966,0
1361559375,1980755196,1,46,46,1361559347787,1361559347787,1980727983,1980727983,0
1361559379,1980759272,1,52,52,1361559354044,1361559354044,1980734316,1980734316,0
1361559388,1980767296,2,406,203,1361559360143,1361559360591,1980739439,1980739887,448
1361559466,1980846116,3,210,70,1361559457879,1361559459031,1980837995,1980839147,1152
1361559506,1980886216,3,168,56,1361559505397,1361559505525,1980885613,1980885741,128
1361559506,1980886216,2,116,58,1361559505524,1361559505780,1980885740,1980885996,256
1361559508,1980887320,1,437,437,1361559483571,1361559483571,1980862891,1980862891,0
1361559514,1980894124,3,168,56,1361559506064,1361559506256,1980886188,1980886380,192
1361559514,1980894132,6,2052,342,1361559503689,1361559510473,1980883821,1980890605,6784
1361559514,1980894200,6,2227,371.1666667,1361559503749,1361559510405,1980883949,1980890605,6656
1361559514,1980894200,6,2144,357.3333333,1361559504002,1361559510402,1980884202,1980890602,6400
1361559522,1980902124,5,2554,510.8,1361559511311,1361559517135,1980891435,1980897259,5824
1361559522,1980902128,2,110,55,1361559506253,1361559516365,1980886381,1980896493,10112
1361559522,1980902128,3,168,56,1361559516362,1361559516490,1980896490,1980896618,128
1361559522,1980902132,5,1938,387.6,1361559511622,1361559517126,1980891754,1980897258,5504
1361559522,1980902132,6,1985,330.8333333,1361559511815,1361559519111,1980891947,1980899243,7296
1361559522,1980902240,3,168,56,1361559516442,1361559516634,1980896682,1980896874,192
1361559522,1980902252,5,2351,470.2,1361559513230,1361559518990,1980893482,1980899242,5760
1361559528,1980907676,32,27242,851.3125,1361559501967,1361559508303,1980881643,1980887979,6336
1361559532,1980911720,1,52,52,1361559506404,1361559506404,1980886124,1980886124,0
1361559538,1980918220,2,131,65.5,1361559537710,1361559537710,1980917930,1980917930,0
1361559576,1980955668,2,487,243.5,1361559549333,1361559556821,1980929001,1980936489,7488
1361559883,1981262436,5,2491,498.2,1361559877690,1361559882810,1981257126,1981262246,5120
1361559889,1981268700,8,3264,408,1361559863409,1361559863793,1981243109,1981243493,384
1361559901,1981280772,2,487,243.5,1361559873449,1361559873449,1981253221,1981253221,0
1361559905,1981284732,1,46,46,1361559879634,1361559879634,1981259366,1981259366,0
1361559905,1981284732,1,46,46,1361559879634,1361559879634,1981259366,1981259366,0
1361559905,1981284776,8,4305,538.125,1361559877415,1361559877863,1981257191,1981257639,448
1361559905,1981284820,1,46,46,1361559879544,1361559879544,1981259364,1981259364,0
1361559905,1981284820,1,46,46,1361559879544,1361559879544,1981259364,1981259364,0
1361559909,1981288800,18,12231,679.5,1361559884175,1361559889167,1981263975,1981268967,4992
1361559915,1981294448,2,131,65.5,1361559908205,1361559908205,1981287653,1981287653,0
1361559917,1981296764,1,46,46,1361559889523,1361559889523,1981269287,1981269287,0
1361559923,1981302548,2,131,65.5,1361559919435,1361559919435,1981298983,1981298983,0
1361559933,1981312792,61,66558,1091.114754,1361559908436,1361559919060,1981288228,1981298852,10624
1361559933,1981312872,10,5428,542.8,1361559908358,1361559908998,1981288230,1981288870,640
1361559945,1981324876,38,40241,1058.973684,1361559917123,1361559934723,1981296999,1981314599,17600
1361559947,1981326436,3,210,70,1361559939450,1361559939770,1981318886,1981319206,320
1361559955,1981334484,9,4518,502,1361559934856,1361559953864,1981314340,1981333348,19008
1361559963,1981342500,2,92,46,1361559959930,1361559959994,1981339430,1981339494,64
1361559981,1981360864,1,283,283,1361559955790,1361559955790,1981335654,1981335654,0
1361559985,1981365152,8,5380,672.5,1361559959339,1361559959851,1981339491,1981340003,512
1361559995,1981374544,4,289,72.25,1361559990474,1361559991370,1981370018,1981370914,896
1361560045,1981425156,1,46,46,1361560018793,1361560018793,1981398949,1981398949,0
1361560045,1981425216,13,11787,906.6923077,1361560019818,1361560023146,1981400034,1981403362,3328
1361560046,1981425344,5,959,191.8,1361560018389,1361560020501,1981397733,1981399845,2112
1361560046,1981425356,16,5731,358.1875,1361560020681,1361560025097,1981400037,1981404453,4416
1361560057,1981437204,1,46,46,1361560031417,1361560031417,1981411621,1981411621,0
1361560059,1981438508,2,131,65.5,1361560054959,1361560054959,1981434467,1981434467,0
1361560059,1981438548,2,131,65.5,1361560053832,1361560053832,1981433380,1981433380,0
1361560065,1981445232,1,46,46,1361560038684,1361560038684,1981418916,1981418916,0
1361560115,1981494540,4,425,106.25,1361560110352,1361560110992,1981489892,1981490532,640
1361560115,1981494540,8,5866,733.25,1361560110478,1361560110990,1981490018,1981490530,512
1361560115,1981494548,3,138,46,1361560108166,1361560108166,1981487714,1981487714,0
1361560115,1981494552,5,1408,281.6,1361560111428,1361560111812,1981490980,1981491364,384
1361560115,1981494576,11,11101,1009.181818,1361560111979,1361560112363,1981491555,1981491939,384
1361560115,1981494580,3,325,108.3333333,1361560112424,1361560112552,1981492004,1981492132,128
1361560115,1981494592,5,2433,486.6,1361560110364,1361560111068,1981489956,1981490660,704
1361560115,1981494592,4,641,160.25,1361560110364,1361560110876,1981489956,1981490468,512
1361560115,1981494592,5,373,74.6,1361560110427,1361560110939,1981490019,1981490531,512
1361560123,1981502520,4,1441,360.25,1361560117729,1361560117921,1981497249,1981497441,192
1361560123,1981502532,25,25387,1015.48,1361560111061,1361560118037,1981490593,1981497569,6976
1361560123,1981502560,5,2433,486.6,1361560119676,1361560120316,1981499236,1981499876,640
1361560123,1981502564,2,112,56,1361560111989,1361560122165,1981491553,1981501729,10176
1361560123,1981502568,3,325,108.3333333,1361560120820,1361560120884,1981500388,1981500452,64
1361560123,1981502572,5,2433,486.6,1361560117614,1361560118254,1981497186,1981497826,640
1361560123,1981502596,5,1408,281.6,1361560118358,1361560118486,1981497954,1981498082,128
1361560123,1981502600,10,9206,920.6,1361560118675,1361560118803,1981498275,1981498403,128
1361560123,1981502600,2,113,56.5,1361560115666,1361560115666,1981495266,1981495266,0
1361560123,1981502600,3,325,108.3333333,1361560118865,1361560118993,1981498465,1981498593,128
1361560123,1981502604,17,15759,927,1361560110989,1361560118029,1981490593,1981497633,7040
1361560123,1981502636,10,9199,919.9,1361560111919,1361560120687,1981491555,1981500323,8768
1361560123,1981502636,2,112,56,1361560111918,1361560122094,1981491554,1981501730,10176
1361560123,1981502640,5,1408,281.6,1361560120364,1361560120556,1981500004,1981500196,192
1361560125,1981505212,2,188,94,1361560098862,1361560098862,1981479074,1981479074,0
1361560129,1981509240,1,46,46,1361560103314,1361560103314,1981483554,1981483554,0
1361560131,1981510516,50,61609,1232.18,1361560118118,1361560125734,1981497634,1981505250,7616
1361560134,1981513308,11,3968,360.7272727,1361560108405,1361560111157,1981487713,1981490465,2752
1361560137,1981517216,7,3052,436,1361560110763,1361560111339,1981490979,1981491555,576
1361560137,1981517220,2,112,56,1361560111525,1361560131493,1981491745,1981511713,19968
1361560137,1981517264,1,68,68,1361560110266,1361560110266,1981490530,1981490530,0
1361560139,1981518520,2,112,56,1361560118754,1361560132258,1981498274,1981511778,13504
1361560139,1981518520,2,112,56,1361560118753,1361560132257,1981498273,1981511777,13504
1361560139,1981518580,2,112,56,1361560118694,1361560132134,1981498274,1981511714,13440
1361560142,1981521588,6,3840,640,1361560117664,1361560117920,1981497252,1981497508,256
1361560147,1981526560,10,7618,761.8,1361560140793,1361560144121,1981520353,1981523681,3328
1361560147,1981526564,13,11412,877.8461538,1361560144758,1361560146486,1981524322,1981526050,1728
1361560147,1981526576,258,351888,1363.906977,1361560118057,1361560146665,1981497633,1981526241,28608
1361560147,1981526608,6,2600,433.3333333,1361560144137,1361560144585,1981523745,1981524193,448
1361560147,1981526644,3,325,108.3333333,1361560145638,1361560146022,1981525282,1981525666,384
1361560155,1981534600,2,92,46,1361560147348,1361560147476,1981526948,1981527076,128
1361560155,1981534636,2,112,56,1361560144687,1361560154799,1981524323,1981534435,10112
1361560170,1981549664,4,232,58,1361560144658,1361560164754,1981524322,1981544418,20096
1361560170,1981549664,5,284,56.8,1361560144658,1361560164754,1981524322,1981544418,20096
1361560171,1981550548,11,11303,1027.545455,1361560166662,1361560166790,1981546210,1981546338,128
1361560171,1981550596,5,1404,280.8,1361560166295,1361560166551,1981545891,1981546147,256
1361560171,1981550620,3,325,108.3333333,1361560166783,1361560167039,1981546403,1981546659,256
1361560171,1981550628,5,2433,486.6,1361560165556,1361560166132,1981545184,1981545760,576
1361560174,1981553600,1,52,52,1361560148499,1361560148499,1981528099,1981528099,0
1361560179,1981558548,2,112,56,1361560166662,1361560176710,1981546210,1981556258,10048
1361560179,1981558548,2,112,56,1361560166661,1361560176709,1981546209,1981556257,10048
1361560179,1981558624,2,112,56,1361560166585,1361560176633,1981546209,1981556257,10048
1361560187,1981566552,465,650372,1398.649462,1361560147521,1361560183681,1981527073,1981563233,36160
1361560195,1981574552,29,34125,1176.724138,1361560186945,1361560193153,1981566497,1981572705,6208
1361560195,1981574552,16,14272,892,1361560186944,1361560191168,1981566496,1981570720,4224
1361560195,1981574592,2,92,46,1361560186905,1361560186905,1981566497,1981566497,0
1361560202,1981581604,1,46,46,1361560176462,1361560176462,1981556066,1981556066,0
1361560202,1981581688,1,46,46,1361560176825,1361560176825,1981556513,1981556513,0
1361560203,1981582552,2,112,56,1361560187650,1361560197762,1981567202,1981577314,10112
1361560203,1981582552,2,299,149.5,1361560187713,1361560197761,1981567265,1981577313,10048
1361560203,1981582600,2,112,56,1361560187664,1361560197712,1981567264,1981577312,10048
1361560203,1981582600,2,299,149.5,1361560187664,1361560197712,1981567264,1981577312,10048
1361560203,1981582600,2,299,149.5,1361560187664,1361560197712,1981567264,1981577312,10048
1361560203,1981582600,3,138,46,1361560187664,1361560197712,1981567264,1981577312,10048
1361560203,1981582604,2,112,56,1361560187599,1361560197711,1981567203,1981577315,10112
1361560203,1981582604,3,138,46,1361560187663,1361560197711,1981567267,1981577315,10048
1361560211,1981590568,2,299,149.5,1361560188016,1361560207792,1981567584,1981587360,19776
1361560211,1981590568,2,299,149.5,1361560188016,1361560207792,1981567584,1981587360,19776
1361560211,1981590568,2,299,149.5,1361560187888,1361560207792,1981567456,1981587360,19904
1361560211,1981590568,2,299,149.5,1361560187888,1361560207792,1981567456,1981587360,19904
1361560211,1981590572,2,92,46,1361560188015,1361560207791,1981567587,1981587363,19776
1361560211,1981590572,2,92,46,1361560188079,1361560207791,1981567651,1981587363,19712
1361560211,1981590576,3,164,54.66666667,1361560188971,1361560207723,1981568547,1981587299,18752
1361560211,1981590600,2,299,149.5,1361560192657,1361560207761,1981572257,1981587361,15104
1361560211,1981590612,4,184,46,1361560187652,1361560207748,1981567264,1981587360,20096
1361560211,1981590640,2,299,149.5,1361560187819,1361560207723,1981567459,1981587363,19904
1361560211,1981590640,2,299,149.5,1361560187945,1361560207721,1981567585,1981587361,19776
1361560211,1981590640,2,299,149.5,1361560187945,1361560207721,1981567585,1981587361,19776
1361560211,1981590640,2,299,149.5,1361560187944,1361560207720,1981567584,1981587360,19776
1361560211,1981590640,2,92,46,1361560188008,1361560207720,1981567648,1981587360,19712
1361560211,1981590640,2,299,149.5,1361560187944,1361560207720,1981567584,1981587360,19776
1361560211,1981590648,2,112,56,1361560188895,1361560207647,1981568543,1981587295,18752
1361560211,1981590648,2,112,56,1361560188895,1361560207647,1981568543,1981587295,18752
1361560211,1981590652,2,299,149.5,1361560192605,1361560207709,1981572257,1981587361,15104
1361560211,1981590652,3,359,119.6666667,1361560192605,1361560207709,1981572257,1981587361,15104
1361560214,1981593592,1,46,46,1361560187162,1361560187162,1981566754,1981566754,0
1361560214,1981593600,7,2875,410.7142857,1361560187666,1361560213330,1981567266,1981592930,25664
1361560214,1981593600,6,762,127,1361560187600,1361560213328,1981567200,1981592928,25728
1361560214,1981593620,6,642,107,1361560187964,1361560213372,1981567584,1981592992,25408
1361560214,1981593620,7,2866,409.4285714,1361560187963,1361560213435,1981567583,1981593055,25472
1361560214,1981593624,7,686,98,1361560187962,1361560213498,1981567586,1981593122,25536
1361560214,1981593680,9,8115,901.6666667,1361560187585,1361560187713,1981567265,1981567393,128
1361560214,1981593680,7,2877,411,1361560187776,1361560213376,1981567456,1981593056,25600
1361560214,1981593712,17,20830,1225.294118,1361560188833,1361560189025,1981568545,1981568737,192
1361560218,1981597640,2,866,433,1361560191656,1361560192296,1981571296,1981571936,640
1361560218,1981597648,3,536,178.6666667,1361560192543,1361560192607,1981572191,1981572255,64
1361560219,1981598600,5,539,107.8,1361560213329,1361560213521,1981592929,1981593121,192
1361560219,1981598644,13,13499,1038.384615,1361560212709,1361560213221,1981592353,1981592865,512
1361560222,1981601600,9,5276,586.2222222,1361560194641,1361560195857,1981574241,1981575457,1216
1361560227,1981606612,302,417491,1382.42053,1361560193092,1361560224452,1981572704,1981604064,31360
1361560232,619925868,2,112,56,1361560212905,1361560227369,619906773,619921237,14464
1361560232,619925876,2,112,56,1361560212897,1361560227361,619906773,619921237,14464
1361560232,619925876,2,112,56,1361560212897,1361560227361,619906773,619921237,14464
1361560235,1981614576,2,131,65.5,1361560230311,1361560230311,1981609887,1981609887,0
1361560235,1981614624,4,232,58,1361560213306,1361560227770,1981592930,1981607394,14464
1361560235,1981614624,4,232,58,1361560213306,1361560227770,1981592930,1981607394,14464
1361560235,1981614628,13,13660,1050.769231,1361560233781,1361560234357,1981613409,1981613985,576
1361560235,1981614692,4,232,58,1361560213238,1361560227702,1981592930,1981607394,14464
1361560240,619933296,11,12569,1142.636364,1361560213479,1361560213543,619906775,619906839,64
1361560243,1981622660,2,104,52,1361560242581,1361560242709,1981622241,1981622369,128
1361560243,1981622676,229,319599,1395.628821,1361560224386,1361560241602,1981604062,1981621278,17216
1361560251,1981630572,2,112,56,1361560234926,1361560248110,1981614498,1981627682,13184
1361560251,1981630576,2,112,56,1361560234536,1361560247848,1981614112,1981627424,13312
1361560251,1981630580,2,112,56,1361560234726,1361560247846,1981614306,1981627426,13120
1361560251,1981630580,3,164,54.66666667,1361560234725,1361560247845,1981614305,1981627425,13120
1361560251,1981630628,3,164,54.66666667,1361560234358,1361560247798,1981613986,1981627426,13440
1361560251,1981630628,2,112,56,1361560234358,1361560247798,1981613986,1981627426,13440
1361560251,1981630628,2,112,56,1361560234357,1361560247797,1981613985,1981627425,13440
1361560251,1981630628,2,92,46,1361560250356,1361560250356,1981629984,1981629984,0
1361560251,1981630628,2,112,56,1361560234484,1361560247796,1981614112,1981627424,13312
1361560259,1981638664,10,7618,761.8,1361560254863,1361560258319,1981634527,1981637983,3456
1361560262,1981641668,1,267,267,1361560234316,1361560234316,1981613984,1981613984,0
1361560262,1981641668,4,860,215,1361560234443,1361560234443,1981614111,1981614111,0
1361560262,1981641668,3,1412,470.6666667,1361560234378,1361560234442,1981614046,1981614110,64
1361560262,1981641672,1,1171,1171,1361560234438,1361560234438,1981614110,1981614110,0
1361560262,1981641672,1,209,209,1361560234506,1361560234506,1981614178,1981614178,0
1361560262,1981641672,32,41935,1310.46875,1361560234631,1361560234759,1981614303,1981614431,128
1361560262,1981641756,5,691,138.2,1361560234229,1361560234421,1981613985,1981614177,192
1361560262,1981641756,1,1164,1164,1361560234293,1361560234293,1981614049,1981614049,0
1361560262,1981641756,3,1123,374.3333333,1361560234356,1361560234356,1981614112,1981614112,0
1361560262,1981641756,2,265,132.5,1361560234291,1361560234355,1981614047,1981614111,64
1361560267,1981646656,10,9206,920.6,1361560261976,1361560262104,1981641632,1981641760,128
1361560267,1981646656,3,325,108.3333333,1361560262167,1361560262423,1981641823,1981642079,256
1361560267,1981646664,8,2712,339,1361560258448,1361560261904,1981638112,1981641568,3456
1361560274,1981653700,1,52,52,1361560247725,1361560247725,1981627425,1981627425,0
1361560274,1981653708,1,46,46,1361560248229,1361560248229,1981627937,1981627937,0
1361560275,1981654660,261,358166,1372.283525,1361560250324,1361560273620,1981629984,1981653280,23296
1361560283,1981662612,2,112,56,1361560262020,1361560277828,1981641632,1981657440,15808
1361560283,1981662612,3,359,119.6666667,1361560278146,1361560278274,1981657758,1981657886,128
1361560283,1981662672,2,112,56,1361560261961,1361560277769,1981641633,1981657441,15808
1361560283,1981662672,2,112,56,1361560261961,1361560277769,1981641633,1981657441,15808
1361560291,1981670652,5,539,107.8,1361560287004,1361560288540,1981666656,1981668192,1536
1361560291,1981670684,6,1218,203,1361560282746,1361560284986,1981662430,1981664670,2240
1361560291,1981670688,5,260,52,1361560284472,1361560286776,1981664160,1981666464,2304
1361560291,1981670692,2,92,46,1361560285301,1361560285301,1981664993,1981664993,0
1361560291,1981670724,15,13619,907.9333333,1361560282580,1361560286420,1981662304,1981666144,3840
1361560291,1981670736,6,1774,295.6666667,1361560282697,1361560286089,1981662433,1981665825,3392
1361560291,1981670740,5,260,52,1361560284293,1361560286725,1981664033,1981666465,2432
1361560291,1981670740,6,312,52,1361560284356,1361560287364,1981664096,1981667104,3008
1361560298,1981677968,1,46,46,1361560270623,1361560270623,1981650591,1981650591,0
1361560299,1981678616,3,156,52,1361560294336,1361560297728,1981673952,1981677344,3392
1361560299,1981678620,2,299,149.5,1361560286586,1361560297786,1981666206,1981677406,11200
1361560299,1981678620,5,284,56.8,1361560287034,1361560297786,1981666654,1981677406,10752
1361560299,1981678664,4,208,52,1361560294286,1361560297678,1981673950,1981677342,3392
1361560299,1981678668,16,15472,967,1361560286349,1361560294221,1981666017,1981673889,7872
1361560299,1981678668,2,299,149.5,1361560286540,1361560297740,1981666208,1981677408,11200
1361560299,1981678668,2,299,149.5,1361560286603,1361560297739,1981666271,1981677407,11136
1361560299,1981678668,2,299,149.5,1361560286794,1361560297738,1981666462,1981677406,10944
1361560299,1981678696,4,232,58,1361560286961,1361560297713,1981666657,1981677409,10752
1361560299,1981678696,4,232,58,1361560286961,1361560297713,1981666657,1981677409,10752
1361560307,1981686648,2,299,149.5,1361560290398,1361560301470,1981670046,1981681118,11072
1361560307,1981686648,310,430280,1388,1361560286686,1361560303646,1981666334,1981683294,16960
1361560307,1981686688,15,15155,1010.333333,1361560298103,1361560299447,1981677791,1981679135,1344
1361560307,1981686692,3,359,119.6666667,1361560302261,1361560302389,1981681953,1981682081,128
1361560310,1981689912,5,670,134,1361560297879,1361560299159,1981677791,1981679071,1280
1361560312,1981691616,3,156,52,1361560284478,1361560287038,1981664094,1981666654,2560
1361560312,1981691640,1,46,46,1361560285349,1361560285349,1981664989,1981664989,0
1361560312,620005520,11,14275,1297.727273,1361560286536,1361560286984,619980056,619980504,448
1361560314,1981694032,9,5307,589.6666667,1361560286175,1361560299167,1981666207,1981679199,12992
1361560314,1981694032,11,1874,170.3636364,1361560286302,1361560299166,1981666334,1981679198,12864
1361560314,1981694164,2,866,433,1361560288348,1361560289052,1981668512,1981669216,704
1361560315,1981694628,2,299,149.5,1361560291892,1361560307764,1981671520,1981687392,15872
1361560315,1981694628,2,299,149.5,1361560291892,1361560307764,1981671520,1981687392,15872
1361560315,1981694628,2,299,149.5,1361560291954,1361560307762,1981671582,1981687390,15808
1361560315,1981694628,3,359,119.6666667,1361560292146,1361560307762,1981671774,1981687390,15616
1361560315,1981694632,2,299,149.5,1361560292209,1361560307761,1981671841,1981687393,15552
1361560315,1981694632,2,299,149.5,1361560292208,1361560307760,1981671840,1981687392,15552
1361560315,1981694632,3,172,57.33333333,1361560292526,1361560307758,1981672158,1981687390,15232
1361560315,1981694656,4,232,58,1361560292822,1361560307734,1981672478,1981687390,14912
1361560315,1981694672,486,679561,1398.273663,1361560286665,1361560309897,1981666337,1981689569,23232
1361560315,1981694700,2,299,149.5,1361560291820,1361560307692,1981671520,1981687392,15872
1361560315,1981694704,3,172,57.33333333,1361560292454,1361560307686,1981672158,1981687390,15232
1361560315,1981694704,3,172,57.33333333,1361560292454,1361560307686,1981672158,1981687390,15232
1361560315,1981694708,3,168,56,1361560292773,1361560307685,1981672481,1981687393,14912
1361560315,1981694708,3,168,56,1361560292773,1361560307685,1981672481,1981687393,14912
1361560318,1981698028,8,5179,647.375,1361560290020,1361560301028,1981670048,1981681056,11008
1361560318,1981698056,9,1104,122.6666667,1361560291398,1361560301062,1981671454,1981681118,9664
1361560318,1981698072,3,552,184,1361560292406,1361560293942,1981672478,1981674014,1536
1361560318,1981698144,17,16913,994.8823529,1361560292017,1361560293617,1981672161,1981673761,1600
1361560323,1981702672,2,112,56,1361560299462,1361560317766,1981679134,1981697438,18304
1361560323,1981702672,2,112,56,1361560299462,1361560317830,1981679134,1981697502,18368
1361560326,1981706044,4,860,215,1361560299092,1361560299156,1981679136,1981679200,64
1361560326,1981706044,3,1123,374.3333333,1361560299091,1361560299155,1981679135,1981679199,64
1361560326,1981706044,8,1463,182.875,1361560299091,1361560301011,1981679135,1981681055,1920
1361560326,1981706044,38,53231,1400.815789,1361560299218,1361560302802,1981679262,1981682846,3584
1361560331,1981710624,2,92,46,1361560323126,1361560323126,1981702750,1981702750,0
1361560331,1981710636,4,538,134.5,1361560324139,1361560325547,1981703775,1981705183,1408
1361560331,1981710640,7,2551,364.4285714,1361560324647,1361560326631,1981704287,1981706271,1984
1361560331,1981710664,6,1468,244.6666667,1361560325263,1361560328463,1981704927,1981708127,3200
1361560331,1981710664,3,325,108.3333333,1361560328847,1361560328975,1981708511,1981708639,128
1361560331,1981710672,2,92,46,1361560323078,1361560323078,1981702750,1981702750,0
1361560331,1981710672,46,54053,1175.065217,1361560323078,1361560330566,1981702750,1981710238,7488
1361560331,1981710704,8,2603,325.375,1361560322662,1361560327206,1981702366,1981706910,4544
1361560331,1981710704,4,1138,284.5,1361560322726,1361560322918,1981702430,1981702622,192
1361560331,1981710704,4,1096,274,1361560322729,1361560322921,1981702433,1981702625,192
1361560331,1981710704,5,1408,281.6,1361560323495,1361560323623,1981703199,1981703327,128
1361560331,1981710708,12,12722,1060.166667,1361560323685,1361560323941,1981703393,1981703649,256
1361560331,1981710716,12,12722,1060.166667,1361560328537,1361560328793,1981708253,1981708509,256
1361560334,1981714176,2,104,52,1361560308495,1361560317263,1981688671,1981697439,8768
1361560339,1981718632,82,93906,1145.195122,1361560323118,1361560333934,1981702750,1981713566,10816
1361560339,1981718640,2,112,56,1361560323750,1361560337766,1981703390,1981717406,14016
1361560339,1981718640,2,112,56,1361560323749,1361560337765,1981703389,1981717405,14016
1361560339,1981718708,2,112,56,1361560323682,1361560337698,1981703390,1981717406,14016
1361560347,1981726676,28,32327,1154.535714,1361560333765,1361560341893,1981713441,1981721569,8128
1361560354,1981734100,2,112,56,1361560328156,1361560347356,1981708256,1981727456,19200
1361560354,1981734100,2,112,56,1361560328156,1361560347356,1981708256,1981727456,19200
1361560354,1981734180,2,112,56,1361560328075,1361560347275,1981708255,1981727455,19200
1361560355,1981734652,5,1408,281.6,1361560351900,1361560352092,1981731552,1981731744,192
1361560355,1981734676,11,11101,1009.181818,1361560352193,1361560352385,1981731869,1981732061,192
1361560355,1981734676,3,325,108.3333333,1361560352452,1361560352580,1981732128,1981732256,128
1361560355,1981734680,3,156,52,1361560349504,1361560352192,1981729184,1981731872,2688
1361560355,1981734680,6,2495,415.8333333,1361560349567,1361560351743,1981729247,1981731423,2176
1361560355,1981734680,3,156,52,1361560349694,1361560352190,1981729374,1981731870,2496
1361560362,1981742220,2,92,46,1361560337507,1361560347235,1981717727,1981727455,9728
1361560363,1981742728,83,109015,1313.433735,1361560341838,1361560362318,1981721566,1981742046,20480
1361560371,1981750696,2,112,56,1361560352174,1361560367790,1981731870,1981747486,15616
1361560371,1981750700,2,112,56,1361560352172,1361560367788,1981731872,1981747488,15616
1361560371,1981750756,2,112,56,1361560352113,1361560367729,1981731869,1981747485,15616
1361560378,1981758096,2,104,52,1361560351008,1361560351776,1981731104,1981731872,768
1361560378,1981758132,1,433,433,1361560352699,1361560352699,1981732831,1981732831,0
1361560378,1981758204,1,46,46,1361560351348,1361560351348,1981731552,1981731552,0
1361560379,1981758652,109,142333,1305.807339,1361560362395,1361560375579,1981742047,1981755231,13184
1361560379,1981758688,5,1408,281.6,1361560373109,1361560373301,1981752797,1981752989,192
1361560379,1981758692,5,590,118,1361560373553,1361560378033,1981753245,1981757725,4480
1361560379,1981758744,5,2435,487,1361560372413,1361560372989,1981752157,1981752733,576
1361560379,1981758744,11,10418,947.0909091,1361560373309,1361560373501,1981753053,1981753245,192
1361560386,1981766216,2,104,52,1361560358312,1361560367208,1981738528,1981747424,8896
1361560386,1981766220,2,104,52,1361560358692,1361560367204,1981738912,1981747424,8512
1361560386,1981766220,2,104,52,1361560358691,1361560367203,1981738911,1981747423,8512
1361560387,1981766656,2,92,46,1361560379222,1361560379222,1981758878,1981758878,0
1361560387,1981766656,42,54519,1298.071429,1361560379222,1361560384598,1981758878,1981764254,5376
1361560395,1981774680,2,92,46,1361560387968,1361560387968,1981767648,1981767648,0
1361560395,1981774680,26,32897,1265.269231,1361560387968,1361560393536,1981767648,1981773216,5568
1361560395,1981774700,2,112,56,1361560373354,1361560387818,1981753054,1981767518,14464
1361560395,1981774704,2,112,56,1361560373352,1361560387816,1981753056,1981767520,14464
1361560395,1981774752,2,112,56,1361560373302,1361560387766,1981753054,1981767518,14464
1361560395,1981774788,12,12239,1019.916667,1361560393492,1361560393876,1981773280,1981773664,384
1361560403,1981782740,2,92,46,1361560397888,1361560397888,1981777628,1981777628,0
1361560411,1981790672,2,299,149.5,1361560394437,1361560407813,1981774109,1981787485,13376
1361560411,1981790676,2,299,149.5,1361560394372,1361560407812,1981774048,1981787488,13440
1361560411,1981790676,2,299,149.5,1361560394436,1361560407812,1981774112,1981787488,13376
1361560411,1981790676,2,299,149.5,1361560394436,1361560407812,1981774112,1981787488,13376
1361560411,1981790724,50,64466,1289.32,1361560397907,1361560407507,1981777631,1981787231,9600
1361560411,1981790728,2,112,56,1361560394061,1361560407757,1981773789,1981787485,13696
1361560411,1981790728,3,138,46,1361560394061,1361560407757,1981773789,1981787485,13696
1361560411,1981790728,2,112,56,1361560394061,1361560407757,1981773789,1981787485,13696
1361560411,1981790728,2,299,149.5,1361560394061,1361560407757,1981773789,1981787485,13696
1361560411,1981790728,2,299,149.5,1361560394125,1361560407757,1981773853,1981787485,13632
1361560411,1981790732,2,92,46,1361560394315,1361560407755,1981774047,1981787487,13440
1361560411,1981790732,2,92,46,1361560394315,1361560407755,1981774047,1981787487,13440
1361560411,1981790732,2,299,149.5,1361560394315,1361560407755,1981774047,1981787487,13440
1361560411,1981790732,2,92,46,1361560394315,1361560407755,1981774047,1981787487,13440
1361560411,1981790732,2,299,149.5,1361560394315,1361560407755,1981774047,1981787487,13440
1361560411,1981790804,6,276,46,1361560409091,1361560409091,1981788895,1981788895,0
1361560411,1981790804,16,3836,239.75,1361560409090,1361560409794,1981788894,1981789598,704
1361560411,1981790808,13,3510,270,1361560409916,1361560410748,1981789724,1981790556,832
1361560411,1981790808,2,112,56,1361560393919,1361560407679,1981773727,1981787487,13760
1361560411,1981790808,3,138,46,1361560393983,1361560407679,1981773791,1981787487,13696
1361560411,1981790808,2,299,149.5,1361560393983,1361560407679,1981773791,1981787487,13696
1361560411,1981790808,2,299,149.5,1361560394047,1361560407679,1981773855,1981787487,13632
1361560411,1981790808,2,112,56,1361560393918,1361560407678,1981773726,1981787486,13760
1361560411,1981790808,2,112,56,1361560393982,1361560407678,1981773790,1981787486,13696
1361560411,1981790808,3,138,46,1361560393982,1361560407678,1981773790,1981787486,13696
1361560411,1981790808,2,299,149.5,1361560393982,1361560407678,1981773790,1981787486,13696
1361560411,1981790808,2,299,149.5,1361560394045,1361560407677,1981773853,1981787485,13632
1361560418,1981798196,5,2659,531.8,1361560393530,1361560414842,1981773726,1981795038,21312
1361560418,1981798196,6,762,127,1361560393593,1361560414841,1981773789,1981795037,21248
1361560418,1981798216,5,2669,533.8,1361560393638,1361560414886,1981773854,1981795102,21248
1361560418,1981798216,3,1123,374.3333333,1361560393509,1361560393573,1981773725,1981773789,64
1361560419,1981798276,4,631,157.75,1361560394448,1361560394640,1981773724,1981773916,192
1361560419,1981798276,4,860,215,1361560394448,1361560394512,1981773724,1981773788,64
1361560419,1981798296,29,40397,1393,1361560394559,1361560394751,1981773855,1981774047,192
1361560419,1981798300,9,8115,901.6666667,1361560394492,1361560394556,1981773792,1981773856,64
1361560419,1981798680,13,3510,270,1361560414976,1361560415872,1981794656,1981795552,896
1361560419,1981798728,12,12669,1055.75,1361560414604,1361560415116,1981794332,1981794844,512
1361560419,1981798728,15,4236,282.4,1361560410829,1361560412557,1981790557,1981792285,1728
1361560419,1981798752,2,92,46,1361560411830,1361560411830,1981791582,1981791582,0
1361560422,1981802136,5,582,116.4,1361560393975,1361560415031,1981774111,1981795167,21056
1361560422,1981802136,8,2908,363.5,1361560393910,1361560414966,1981774046,1981795102,21056
1361560422,1981802220,6,642,107,1361560393826,1361560414818,1981774046,1981795038,20992
1361560427,1981806680,58,70246,1211.137931,1361560411900,1361560423740,1981791580,1981803420,11840
1361560427,1981806756,2,92,46,1361560423474,1361560423474,1981803230,1981803230,0
1361560434,1981814200,9,3463,384.7777778,1361560409526,1361560410294,1981789726,1981790494,768
1361560435,1981814680,6,332,55.33333333,1361560415230,1361560428798,1981794910,1981808478,13568
1361560435,1981814680,2,299,149.5,1361560415357,1361560427773,1981795037,1981807453,12416
1361560435,1981814680,2,112,56,1361560415293,1361560427773,1981794973,1981807453,12480
1361560435,1981814684,21,21704,1033.52381,1361560423546,1361560430266,1981803230,1981809950,6720
1361560435,1981814752,2,112,56,1361560415159,1361560427703,1981794911,1981807455,12544
1361560435,1981814752,3,351,117,1361560415285,1361560427701,1981795037,1981807453,12416
1361560435,1981814752,2,299,149.5,1361560415284,1361560427700,1981795036,1981807452,12416
1361560435,1981814796,23,26840,1166.956522,1361560422026,1361560428490,1981801822,1981808286,6464
1361560438,1981818156,1,79,79,1361560410720,1361560410720,1981790876,1981790876,0
1361560442,1981822156,3,536,178.6666667,1361560414881,1361560414945,1981795037,1981795101,64
1361560442,1981822236,11,12363,1123.909091,1361560414675,1361560414803,1981794911,1981795039,128
1361560442,1981822236,1,435,435,1361560414675,1361560414675,1981794911,1981794911,0
1361560443,1981822680,17,14682,863.6470588,1361560435644,1361560439484,1981815324,1981819164,3840
1361560443,1981822788,36,45820,1272.777778,1361560430162,1361560439442,1981809950,1981819230,9280
1361560446,1981826208,1,46,46,1361560421167,1361560421167,1981801375,1981801375,0
1361560451,1981830676,2,92,46,1361560446400,1361560446400,1981826076,1981826076,0
1361560459,1981838688,2,112,56,1361560439606,1361560457846,1981819294,1981837534,18240
1361560459,1981838688,3,164,54.66666667,1361560439606,1361560457782,1981819294,1981837470,18176
1361560459,1981838688,2,112,56,1361560439604,1361560457844,1981819292,1981837532,18240
1361560459,1981838732,24,26278,1094.916667,1361560446347,1361560455563,1981826079,1981835295,9216
1361560459,1981838756,2,112,56,1361560439538,1361560457714,1981819294,1981837470,18176
1361560459,1981838756,2,112,56,1361560439537,1361560457713,1981819293,1981837469,18176
1361560459,1981838756,2,112,56,1361560439537,1361560457777,1981819293,1981837533,18240
1361560463,1981842428,1,46,46,1361560435831,1361560435831,1981815259,1981815259,0
1361560467,1981846460,6,2763,460.5,1361560439770,1361560461018,1981819230,1981840478,21248
1361560467,1981846460,4,522,130.5,1361560439960,1361560461144,1981819420,1981840604,21184
1361560467,1981846464,7,2862,408.8571429,1361560440148,1361560461076,1981819612,1981840540,20928
1361560467,1981846580,57,78485,1376.929825,1361560439713,1361560439841,1981819293,1981819421,128
1361560467,1981846580,3,346,115.3333333,1361560439713,1361560439841,1981819293,1981819421,128
1361560467,1981846580,4,650,162.5,1361560439649,1361560460897,1981819229,1981840477,21248
1361560467,1981846580,6,2761,460.1666667,1361560439776,1361560460960,1981819356,1981840540,21184
1361560467,1981846608,6,634,105.6666667,1361560440006,1361560460934,1981819614,1981840542,20928
1361560467,1981846764,12,12507,1042.25,1361560460136,1361560460584,1981839900,1981840348,448
1361560467,1981846836,18,17551,975.0555556,1361560455457,1361560462241,1981835293,1981842077,6784
1361560475,1981854852,3,359,119.6666667,1361560472401,1361560472657,1981852253,1981852509,256
1361560475,1981854860,50,64083,1281.66,1361560462215,1361560469447,1981842075,1981849307,7232
1361560479,1981858520,2,104,52,1361560453405,1361560458013,1981832925,1981837533,4608
1361560479,1981858608,2,104,52,1361560453318,1361560457862,1981832926,1981837470,4544
1361560483,1981862564,1,46,46,1361560454831,1361560454831,1981834395,1981834395,0
1361560483,1981862764,3,168,56,1361560460713,1361560477737,1981840477,1981857501,17024
1361560483,1981862832,3,168,56,1361560460581,1361560477669,1981840413,1981857501,17088
1361560483,1981862832,3,168,56,1361560460580,1361560477668,1981840412,1981857500,17088
1361560487,1981866520,2,308,154,1361560460892,1361560460956,1981840412,1981840476,64
1361560487,1981866524,3,393,131,1361560461336,1361560467352,1981840860,1981846876,6016
1361560487,1981866600,13,14961,1150.846154,1361560460811,1361560460939,1981840411,1981840539,128
1361560491,1981870608,3,156,52,1361560465475,1361560468419,1981845083,1981848027,2944
1361560491,1981870760,5,373,74.6,1361560490157,1361560490221,1981869917,1981869981,64
1361560499,1981878756,2,104,52,1361560498674,1361560498802,1981878430,1981878558,128
1361560507,1981886864,4,1470,367.5,1361560506437,1361560506501,1981886301,1981886365,64
1361560507,1981886928,4,820,205,1361560505092,1361560505220,1981885020,1981885148,128
1361560515,1981894788,5,1684,336.8,1361560507474,1361560507794,1981887262,1981887582,320
1361560515,1981894832,5,2776,555.2,1361560506469,1361560506917,1981886301,1981886749,448
1361560515,1981894860,5,1725,345,1361560507463,1361560507719,1981887323,1981887579,256
1361560515,1981894860,5,1771,354.2,1361560507527,1361560507719,1981887387,1981887579,192
1361560519,1981898400,27,27017,1000.62963,1361560506902,1361560508182,1981886302,1981887582,1280
1361560523,1981902676,1,285,285,1361560496578,1361560496578,1981876254,1981876254,0
1361560531,1981910676,6,2761,460.1666667,1361560506114,1361560506562,1981885790,1981886238,448
1361560531,1981910680,3,717,239,1361560506430,1361560506494,1981886110,1981886174,64
1361560531,1981910816,3,956,318.6666667,1361560505973,1361560506101,1981885789,1981885917,128
1361560531,1981910872,35,33453,955.8,1361560519995,1361560529595,1981899867,1981909467,9600
1361560531,1981910876,21,21001,1000.047619,1361560520186,1361560528762,1981900062,1981908638,8576
1361560531,1981910900,5,2309,461.8,1361560528546,1361560528738,1981908446,1981908638,192
1361560531,1981910984,2,131,65.5,1361560530381,1361560530381,1981910365,1981910365,0
1361560535,1981914556,31,40984,1322.064516,1361560507768,1361560521464,1981887324,1981901020,13696
1361560535,1981914556,38,50400,1326.315789,1361560507768,1361560521400,1981887324,1981900956,13632
1361560535,1981914556,21,26286,1251.714286,1361560507768,1361560521464,1981887324,1981901020,13696
1361560535,1981914640,43,57174,1329.627907,1361560507686,1361560521446,1981887326,1981901086,13760
1361560535,1981914640,8,6165,770.625,1361560507941,1361560508197,1981887581,1981887837,256
1361560535,1981914640,7,5166,738,1361560507940,1361560508260,1981887580,1981887900,320
1361560535,1981914640,1,52,52,1361560507876,1361560507876,1981887516,1981887516,0
1361560535,1981914640,7,5633,804.7142857,1361560507940,1361560508260,1981887580,1981887900,320
1361560535,1981914640,7,5901,843,1361560507940,1361560507940,1981887580,1981887580,0
1361560539,1981918540,21,11298,538,1361560510793,1361560518601,1981890333,1981898141,7808
1361560539,1981918552,2,104,52,1361560510972,1361560518012,1981890524,1981897564,7040
1361560539,1981918552,2,104,52,1361560511035,1361560518011,1981890587,1981897563,6976
1361560539,1981918632,2,104,52,1361560510829,1361560517933,1981890461,1981897565,7104
1361560539,1981918632,2,104,52,1361560510892,1361560517932,1981890524,1981897564,7040
1361560539,1981918688,2,104,52,1361560514166,1361560517814,1981893854,1981897502,3648
1361560539,1981918848,5,1834,366.8,1361560537365,1361560537429,1981917213,1981917277,64
1361560547,1981926584,28,35428,1265.285714,1361560521372,1361560529692,1981900956,1981909276,8320
1361560547,1981926636,2,104,52,1361560519911,1361560527911,1981899547,1981907547,8000
1361560547,1981926676,25,29416,1176.64,1361560521281,1361560529601,1981900957,1981909277,8320
1361560547,1981926872,3,164,54.66666667,1361560529786,1361560542074,1981909658,1981921946,12288
1361560547,1981926872,2,112,56,1361560529918,1361560542078,1981909790,1981921950,12160
1361560547,1981926872,2,112,56,1361560529918,1361560542078,1981909790,1981921950,12160
1361560547,1981926944,3,164,54.66666667,1361560529715,1361560542003,1981909659,1981921947,12288
1361560547,1981926944,2,112,56,1361560529842,1361560542002,1981909786,1981921946,12160
1361560547,1981926948,2,112,56,1361560529714,1361560542002,1981909662,1981921950,12288
1361560555,1981934584,5,1996,399.2,1361560529052,1361560529180,1981908636,1981908764,128
1361560555,1981934588,10,11196,1119.6,1361560529238,1361560529366,1981908826,1981908954,128
1361560555,1981934668,16,19103,1193.9375,1361560529031,1361560529095,1981908699,1981908763,64
1361560555,1981934672,14,14237,1016.928571,1361560529348,1361560544132,1981909020,1981923804,14784
1361560555,1981934676,6,3492,582,1361560529983,1361560551039,1981909659,1981930715,21056
1361560555,1981934912,5,1874,374.8,1361560551763,1361560551827,1981931675,1981931739,64
1361560555,1981934948,1693,2405746,1420.995865,1361560529840,1361560548592,1981909788,1981928540,18752
1361560563,1981942632,2,104,52,1361560535404,1361560537900,1981915036,1981917532,2496
1361560571,1981950548,3,768,256,1361560544255,1361560544383,1981923803,1981923931,128
1361560571,1981950548,3,709,236.3333333,1361560544255,1361560544319,1981923803,1981923867,64
1361560571,1981950548,3,615,205,1361560544255,1361560544383,1981923803,1981923931,128
1361560571,1981950552,5,2080,416,1361560544250,1361560550970,1981923802,1981930522,6720
1361560571,1981950628,3,524,174.6666667,1361560544367,1361560544367,1981923995,1981923995,0
1361560571,1981950660,9,5589,621,1361560545169,1361560555281,1981924829,1981934941,10112
1361560571,1981950868,2,112,56,1361560550976,1361560570880,1981930844,1981950748,19904
1361560571,1981950936,2,112,56,1361560550906,1361560570810,1981930842,1981950746,19904
1361560571,1981950940,2,112,56,1361560550905,1361560570809,1981930845,1981950749,19904
1361560579,1981958668,82,112918,1377.04878,1361560552198,1361560552454,1981931866,1981932122,256
1361560583,1981962648,4,1050,262.5,1361560555419,1361560575387,1981935067,1981955035,19968
1361560587,1981966560,2,104,52,1361560559730,1361560567986,1981939290,1981947546,8256
1361560595,1981974672,1,283,283,1361560568258,1361560568258,1981947930,1981947930,0
1361560607,1981986612,2,92,46,1361560581501,1361560588029,1981961113,1981967641,6528
1361560611,1981990936,1,46,46,1361560586746,1361560586746,1981966682,1981966682,0
1361560611,1981991092,1,469,469,1361560584926,1361560584926,1981965018,1981965018,0
1361560612,620306000,1,52,52,1361560587431,1361560587431,620281431,620281431,0
1361560643,1982022856,11540,16363443,1417.975997,1361560550986,1361560637002,1981930842,1982016858,86016
1361560659,1982039184,1,283,283,1361560631105,1361560631105,1982011289,1982011289,0
1361560659,1982039232,2,104,52,1361560633684,1361560637332,1982013916,1982017564,3648
1361560715,1982094932,4,184,46,1361560711100,1361560711100,1982091032,1982091032,0
1361560727,1982107188,3,156,52,1361560700285,1361560709181,1982080473,1982089369,8896
1361560735,1982115248,9,3463,384.7777778,1361560710784,1361560711424,1982091032,1982091672,640
1361560747,1982127032,2,92,46,1361560746200,1361560746456,1982126232,1982126488,256
1361560763,1982142948,3,144,48,1361560747628,1361560758188,1982127576,1982138136,10560
1361560763,1982142984,5,1725,345,1361560758024,1361560758152,1982138008,1982138136,128
1361560771,1982150940,3,156,52,1361560768821,1361560769525,1982148761,1982149465,704
1361560771,1982150944,3,156,52,1361560769010,1361560769714,1982148954,1982149658,704
1361560771,1982150944,2,104,52,1361560769263,1361560769519,1982149207,1982149463,256
1361560771,1982151012,3,156,52,1361560768748,1361560769388,1982148760,1982149400,640
1361560772,1982151388,1,52,52,1361560746780,1361560746780,1982126168,1982126168,0
1361560772,1982151468,1,52,52,1361560746445,1361560746445,1982125913,1982125913,0
1361560776,1982155352,2,988,494,1361560748289,1361560748545,1982127641,1982127897,256
1361560776,1982155356,1,52,52,1361560748542,1361560748542,1982127898,1982127898,0
1361560776,1982155428,1,52,52,1361560748467,1361560748467,1982127895,1982127895,0
1361560776,1982155432,1,52,52,1361560748463,1361560748463,1982127895,1982127895,0
1361560784,1982163396,1,46,46,1361560758806,1361560758806,1982138202,1982138202,0
1361560784,1982163468,6,5384,897.3333333,1361560758668,1361560758668,1982138136,1982138136,0
1361560787,1982166976,2,104,52,1361560784015,1361560784271,1982163991,1982164247,256
1361560788,1982167348,4,2804,701,1361560761219,1361560761283,1982140567,1982140631,64
1361560788,1982167376,1,52,52,1361560761575,1361560761575,1982140951,1982140951,0
1361560788,1982167376,1,52,52,1361560761575,1361560761575,1982140951,1982140951,0
1361560788,1982167424,5,1857,371.4,1361560760952,1361560761080,1982140376,1982140504,128
1361560788,1982167452,1,52,52,1361560761499,1361560761499,1982140951,1982140951,0
1361560788,1982167452,1,52,52,1361560761499,1361560761499,1982140951,1982140951,0
1361560795,1982174976,2,104,52,1361560790543,1361560792079,1982170519,1982172055,1536
1361560795,1982174980,2,104,52,1361560790731,1361560790923,1982170711,1982170903,192
1361560804,1982183468,1,283,283,1361560777036,1361560777036,1982156504,1982156504,0
1361560812,1982191396,1,52,52,1361560784402,1361560784402,1982163798,1982163798,0
1361560812,1982191400,1,52,52,1361560784464,1361560784464,1982163864,1982163864,0
1361560812,1982191400,1,52,52,1361560784527,1361560784527,1982163927,1982163927,0
1361560812,1982191400,1,52,52,1361560784527,1361560784527,1982163927,1982163927,0
1361560827,1982207004,2,104,52,1361560825012,1361560825268,1982205016,1982205272,256
1361560835,1982214924,3,210,70,1361560831618,1361560831874,1982211542,1982211798,256
1361560835,1982214980,2,92,46,1361560832204,1361560832460,1982212184,1982212440,256
1361560844,1982223488,116,159382,1373.982759,1361560537847,1361560542455,1981917335,1981921943,4608
1361560852,1982231620,1,52,52,1361560825844,1361560825844,1982205464,1982205464,0
1361560881,1982261104,1,48,48,1361560853711,1361560853711,1982233815,1982233815,0
1361560923,1982302968,4,1627,406.75,1361560920920,1361560920984,1982300888,1982300952,64
1361560923,1982302968,2,92,46,1361560920983,1361560920983,1982300951,1982300951,0
1361560928,1982307868,2,339,169.5,1361560900923,1361560900923,1982280791,1982280791,0
1361560931,1982311288,4,1131,282.75,1361560928215,1361560928535,1982308503,1982308823,320
1361560931,1982311296,2,92,46,1361560929167,1361560929167,1982309463,1982309463,0
1361560932,1982311324,28,17915,639.8214286,1361560919385,1361560930713,1982298709,1982310037,11328
1361560932,1982311364,3,138,46,1361560929266,1361560929330,1982308630,1982308694,64
1361560932,1982311372,6,1842,307,1361560925992,1361560926312,1982305364,1982305684,320
1361560932,1982311372,5,1876,375.2,1361560930729,1361560930857,1982310101,1982310229,128
1361560939,1982319056,2,92,46,1361560933949,1361560933949,1982314005,1982314005,0
1361560947,1982326996,2,112,56,1361560929020,1361560939196,1982309016,1982319192,10176
1361560947,1982326996,2,112,56,1361560929020,1361560939196,1982309016,1982319192,10176
1361560947,1982327000,1213,1717344,1415.782358,1361560929399,1361560945975,1982309399,1982325975,16576
1361560947,1982327064,2,112,56,1361560928951,1361560939127,1982309015,1982319191,10176
1361560948,1982327940,5,3424,684.8,1361560921075,1361560921075,1982301015,1982301015,0
1361560952,1982331840,55,53196,967.2,1361560925078,1361560939990,1982304918,1982319830,14912
1361560952,1982331988,5,5712,1142.4,1361560925696,1361560928384,1982305684,1982308372,2688
1361560955,1982335100,2,112,56,1361560929299,1361560949011,1982309399,1982329111,19712
1361560955,1982335100,2,112,56,1361560929298,1361560949010,1982309398,1982329110,19712
1361560955,1982335156,3,164,54.66666667,1361560929244,1361560948956,1982309400,1982329112,19712
1361560956,1982335852,20,17631,881.55,1361560928648,1361560929352,1982308500,1982309204,704
1361560956,1982335876,15,17916,1194.4,1361560929648,1361560930032,1982309524,1982309908,384
1361560956,1982335884,69,88386,1280.956522,1361560930345,1361560931433,1982310229,1982311317,1088
1361560956,1982335960,4,471,117.75,1361560928733,1361560928861,1982308693,1982308821,128
1361560956,1982335964,4,1824,456,1361560929051,1361560929243,1982309015,1982309207,192
1361560960,1982339880,3,581,193.6666667,1361560934127,1361560934255,1982314007,1982314135,128
1361560960,1982339880,2,988,494,1361560934127,1361560950511,1982314007,1982330391,16384
1361560980,1982359876,2,1045,522.5,1361560953457,1361560953713,1982333333,1982333589,256
1361560987,1982367096,4,1700,425,1361560982037,1361560982101,1982362133,1982362197,64
1361560987,1982367108,5,1876,375.2,1361560986633,1361560986697,1982366741,1982366805,64
1361560995,1982375124,1169,1655974,1416.573139,1361560986042,1361560988538,1982366166,1982368662,2496
1361561003,1982383136,3,156,52,1361560998059,1361560998699,1982378195,1982378835,640
1361561004,1982384008,6,2092,348.6666667,1361560977838,1361560989806,1982357846,1982369814,11968
1361561008,1982387912,13,18398,1415.230769,1361560982157,1361560982157,1982362069,1982362069,0
1361561008,1982388004,2,2695,1347.5,1361560982191,1361560982191,1982362195,1982362195,0
1361561011,1982391116,2,112,56,1361560986047,1361561006079,1982366163,1982386195,20032
1361561011,1982391168,2,112,56,1361560985996,1361561005964,1982366164,1982386132,19968
1361561011,1982391168,2,112,56,1361560985996,1361561006028,1982366164,1982386196,20032
1361561012,1982391912,3,411,137,1361560985869,1361560985933,1982365781,1982365845,64
1361561012,1982391996,2,1712,856,1361560986104,1361560986104,1982366100,1982366100,0
1361561012,1982392008,95,126099,1327.357895,1361560986795,1361560987051,1982366803,1982367059,256
1361561016,1982395912,1,469,469,1361560989902,1361560989902,1982369814,1982369814,0
1361561032,1982411908,1,283,283,1361561004816,1361561004816,1982384724,1982384724,0
1361561032,1982411948,2,988,494,1361561006311,1361561009383,1982386259,1982389331,3072
1361561075,1982455200,2,131,65.5,1361561073260,1361561073260,1982453460,1982453460,0
1361561101,1982480288,1,52,52,1361561074426,1361561074426,1982453714,1982453714,0
1361561123,1982503240,4,184,46,1361561121796,1361561121924,1982502036,1982502164,128
1361561149,1982528360,8,2741,342.625,1361561122803,1361561123571,1982502163,1982502931,768
1361561171,1982551168,2,104,52,1361561168204,1361561168396,1982548372,1982548564,192
1361561171,1982551180,153,201716,1318.405229,1361560749247,1361561169535,1982129427,1982549715,420288
1361561235,1982615204,2,104,52,1361561229605,1361561229861,1982609809,1982610065,256
1361561249,1982628740,1,95,95,1361561222071,1361561222071,1982601811,1982601811,0
1361561249,1982628852,1,52,52,1361561222279,1361561222279,1982602131,1982602131,0
1361561249,1982628852,1,52,52,1361561222342,1361561222342,1982602194,1982602194,0
1361561251,1982631252,3,144,48,1361561225846,1361561249654,1982606098,1982629906,23808
1361561253,1982632856,1,52,52,1361561225986,1361561225986,1982605842,1982605842,0
1361561277,1982656760,1,52,52,1361561249568,1361561249568,1982629328,1982629328,0
1361561389,1982768984,1,46,46,1361561363006,1361561363006,1982742990,1982742990,0
1361561393,1982773248,8,3390,423.75,1361561366198,1361561367734,1982746446,1982747982,1536
1361561421,621115024,3,426,142,1361561392982,1361561398998,621087006,621093022,6016
1361561532,1982911600,21,19888,947.047619,1361561527740,1361561529788,1982907340,1982909388,2048
1361561546,1982925404,1,188,188,1361561521599,1361561521599,1982901003,1982901003,0
1361561550,1982929636,11,5101,463.7272727,1361561522647,1361561525143,1982902283,1982904779,2496
1361892380,2313758764,1,46,46,1361892352656,1361892352656,2313731420,2313731420,0
1361892536,2313915044,4,208,52,1361892531766,1361892534134,2313910810,2313913178,2368
1361892544,2313923012,2,104,52,1361892536853,1361892542165,2313915865,2313921177,5312
1361892568,2313947064,2,104,52,1361892552095,1361892562143,2313931159,2313941207,10048
1361892600,2313978256,1,52,52,1361892572935,1361892572935,2313951191,2313951191,0
1361892977,2314355276,5,260,52,1361892970990,1361892974958,2314349266,2314353234,3968
1361892993,2314371280,2,104,52,1361892979179,1361892987563,2314357459,2314365843,8384
1361893009,2314387340,2,104,52,1361892997551,1361893007535,2314375891,2314385875,9984
1361893101,2314479208,1,52,52,1361893075759,1361893075759,2314453967,2314453967,0
1361893707,2315086116,1,46,46,1361893681241,1361893681241,2315060357,2315060357,0
1361894905,2316284032,1,46,46,1361894879131,1361894879131,2316258163,2316258163,0
1361895406,2316785148,1,46,46,1361895378467,1361895378467,2316757615,2316757615,0
1361895859,2317237740,3,168,56,1361895851443,1361895851635,2317230183,2317230375,192
1361895859,2317237772,11,7474,679.4545455,1361895854612,1361895855764,2317233384,2317234536,1152
1361895859,2317237816,17,13230,778.2352941,1361895856040,1361895856744,2317234856,2317235560,704
1361895859,2317237856,3,168,56,1361895854528,1361895854592,2317233384,2317233448,64
1361895867,2317245776,12,6515,542.9166667,1361895857167,1361895860175,2317235943,2317238951,3008
1361895867,2317245776,2,110,55,1361895854733,1361895865613,2317233509,2317244389,10880
1361895867,2317245816,11,7822,711.0909091,1361895860584,1361895860776,2317239400,2317239592,192
1361895867,2317245820,3,168,56,1361895864737,1361895864801,2317243557,2317243621,64
1361895867,2317245824,3,168,56,1361895864861,1361895864989,2317243685,2317243813,128
1361895875,2317253780,3,168,56,1361895870155,1361895870283,2317248935,2317249063,128
1361895875,2317253832,3,168,56,1361895869848,1361895869976,2317248680,2317248808,128
1361895875,2317253832,3,168,56,1361895869975,1361895870103,2317248807,2317248935,128
1361895875,2317253836,4,271,67.75,1361895870356,1361895870420,2317249192,2317249256,64
1361895876,2317254520,1,76,76,1361895851406,1361895851406,2317229926,2317229926,0
1361895880,2317258500,1,64,64,1361895852064,1361895852064,2317230564,2317230564,0
1361895880,2317258544,10,4625,462.5,1361895854840,1361895855480,2317233384,2317234024,640
1361895880,2317258544,1,76,76,1361895854647,1361895854647,2317233191,2317233191,0
1361895880,2317258544,8,2272,284,1361895854711,1361895855415,2317233255,2317233959,704
1361895880,2317258620,11,4393,399.3636364,1361895854760,1361895856936,2317233380,2317235556,2176
1361895883,2317261788,2,110,55,1361895870531,1361895880579,2317249319,2317259367,10048
1361895891,2317269864,4,232,58,1361895880566,1361895883638,2317259430,2317262502,3072
1361895907,2317285872,2,110,55,1361895883694,1361895899886,2317262566,2317278758,16192
1361895932,2317310540,1,46,46,1361895904123,1361895904123,2317282663,2317282663,0
1361895944,2317322668,1,52,52,1361895916345,1361895916345,2317295013,2317295013,0
1361895947,2317325904,3,168,56,1361895938895,1361895939023,2317317799,2317317927,128
1361896043,2317422060,13,6021,463.1538462,1361896039730,1361896040818,2317418790,2317419878,1088
1361896059,2317438084,3,168,56,1361896054167,1361896054231,2317433251,2317433315,64
1361896067,2317446096,2,110,55,1361896054284,1361896064332,2317433380,2317443428,10048
1361896075,2317454112,17,6229,366.4117647,1361896069565,1361896070525,2317448677,2317449637,960
1361896113,2317491260,1,64,64,1361896086414,1361896086414,2317464674,2317464674,0
1361896125,2317503280,1,46,46,1361896097338,1361896097338,2317475618,2317475618,0
1361896153,2317531268,2,116,58,1361896125637,1361896125829,2317503905,2317504097,192
1361975151,2396529060,1,46,46,1361975127025,1361975127025,2396505085,2396505085,0
1361975152,2396530900,1,46,46,1361975137576,1361975137576,2396516476,2396516476,0
1361975454,2396832472,1,46,46,1361975428111,1361975428111,2396806583,2396806583,0
1361975553,2396931136,1,46,46,1361975528349,1361975528349,2396906485,2396906485,0
1361977362,1037054688,1,46,46,1361977333532,1361977333532,1037026220,1037026220,0
1361977908,2399286244,1,46,46,1361977883918,1361977883918,2399262162,2399262162,0
1361978255,2399633220,12,6622,551.8333333,1361978249056,1361978249184,2399627276,2399627404,128
1361978255,2399633220,14,11399,814.2142857,1361978249441,1361978249633,2399627661,2399627853,192
1361978255,2399633224,3,168,56,1361978248095,1361978248287,2399626319,2399626511,192
1361978255,2399633268,11,6688,608,1361978248563,1361978248947,2399626831,2399627215,384
1361978255,2399633300,10,6360,636,1361978248018,1361978248338,2399626318,2399626638,320
1361978255,2399633304,3,168,56,1361978248204,1361978248588,2399626508,2399626892,384
1361978255,2399633328,13,6021,463.1538462,1361978251189,1361978252085,2399629517,2399630413,896
1361978263,2399641260,3,168,56,1361978258810,1361978258938,2399637070,2399637198,128
1361978263,2399641284,13,6021,463.1538462,1361978255009,1361978255713,2399633293,2399633997,704
1361978263,2399641328,3,168,56,1361978258934,1361978259062,2399637262,2399637390,128
1361978271,2399649308,2,110,55,1361978248713,1361978263305,2399627021,2399641613,14592
1361978271,2399649320,3,168,56,1361978269182,1361978269246,2399647502,2399647566,64
1361978272,2399650756,1,76,76,1361978244233,1361978244233,2399622989,2399622989,0
1361978272,2399650760,1,64,64,1361978244359,1361978244359,2399623119,2399623119,0
1361978272,2399650764,1,76,76,1361978247552,1361978247552,2399626316,2399626316,0
1361978272,2399650788,8,2272,284,1361978247528,1361978248488,2399626316,2399627276,960
1361978272,2399650844,10,4625,462.5,1361978247601,1361978248689,2399626445,2399627533,1088
1361978272,2399650844,12,5145,428.75,1361978247665,1361978249137,2399626509,2399627981,1472
1361978276,2399654732,1,46,46,1361978248099,1361978248099,2399626831,2399626831,0
1361978279,2399657232,9,4478,497.5555556,1361978269269,1361978273685,2399647501,2399651917,4416
1361978279,2399657232,19,16018,843.0526316,1361978269269,1361978273749,2399647501,2399651981,4480
1361978279,2399657236,16,17327,1082.9375,1361978272082,1361978273426,2399650318,2399651662,1344
1361978279,2399657316,2,110,55,1361978259074,1361978270914,2399637390,2399649230,11840
1361978279,2399657340,10,5371,537.1,1361978275433,1361978276393,2399653773,2399654733,960
1361978279,2399657340,21,12700,604.7619048,1361978267176,1361978273640,2399645516,2399651980,6464
1361978287,2399665224,48,47066,980.5416667,1361978271708,1361978283804,2399649932,2399662028,12096
1361978287,2399665232,5,1939,387.8,1361978282581,1361978283157,2399660813,2399661389,576
1361978287,2399665260,23,14077,612.0434783,1361978283897,1361978285753,2399662157,2399664013,1856
1361978287,2399665272,19,14705,773.9473684,1361978281261,1361978282925,2399659533,2399661197,1664
1361978287,2399665304,23,19019,826.9130435,1361978282510,1361978284750,2399660814,2399663054,2240
1361978295,2399673240,24,17648,735.3333333,1361978288716,1361978290828,2399666956,2399669068,2112
1361978295,2399673244,12,6447,537.25,1361978292810,1361978294410,2399671054,2399672654,1600
1361978295,2399673248,12,5371,447.5833333,1361978287493,1361978288389,2399665741,2399666637,896
1361978295,2399673280,12,6070,505.8333333,1361978290982,1361978292262,2399669262,2399670542,1280
1361978295,2399673288,13,7003,538.6923077,1361978292764,1361978294364,2399671052,2399672652,1600
1361978295,2399673324,10,5173,517.3,1361978290938,1361978292090,2399669262,2399670414,1152
1361978295,2399673328,6,4493,748.8333333,1361978294517,1361978294709,2399672845,2399673037,192
1361978296,2399674844,1,64,64,1361978268849,1361978268849,2399647693,2399647693,0
1361978303,2399681260,4,1408,352,1361978296378,1361978296570,2399674638,2399674830,192
1361978303,2399681260,4,592,148,1361978301945,1361978302073,2399680205,2399680333,128
1361978303,2399681272,17,12019,707,1361978296492,1361978298092,2399674764,2399676364,1600
1361978311,2399689260,10,7040,704,1361978308216,1361978308728,2399686476,2399686988,512
1361978311,2399689264,13,5288,406.7692308,1361978302902,1361978303734,2399681166,2399681998,832
1361978319,2399697292,24,22711,946.2916667,1361978308247,1361978312151,2399686539,2399690443,3904
1361978319,2399697292,13,8855,681.1538462,1361978308247,1361978312151,2399686539,2399690443,3904
1361978327,2399705300,11,5423,493,1361978324623,1361978325647,2399702923,2399703947,1024
1361978327,2399705416,18,21915,1217.5,1361978323036,1361978323420,2399701452,2399701836,384
1361978335,2399713324,23,14084,612.3478261,1361978325945,1361978327673,2399704269,2399705997,1728
1361978336,2399714916,1,52,52,1361978309607,1361978309607,2399688523,2399688523,0
1361978343,2399721360,11,5401,491,1361978335573,1361978336405,2399713933,2399714765,832
1361978495,2399873324,2,92,46,1361978489716,1361978489908,2399868040,2399868232,192
1361978517,2399895304,1,52,52,1361978490249,1361978490249,2399868553,2399868553,0
1361978645,2400023796,1,64,64,1361978620763,1361978620763,2399999559,2399999559,0
1361978649,2400027804,13,2630,202.3076923,1361978623316,1361978626196,2400002120,2400005000,2880
1361978653,2400031708,1,52,52,1361978625653,1361978625653,2400004361,2400004361,0
1361978655,2400033796,3,168,56,1361978651355,1361978651995,2400030151,2400030791,640
1361978655,2400033804,3,168,56,1361978652242,1361978652882,2400031046,2400031686,640
1361978681,2400059824,1,64,64,1361978653246,1361978653246,2400032070,2400032070,0
1361978842,2400220368,5,250,50,1361978816452,1361978838660,2400194820,2400217028,22208
1361978890,2400268648,1,48,48,1361978862891,1361978862891,2400241539,2400241539,0
1361978918,2400296744,1,48,48,1361978891980,1361978891980,2400270724,2400270724,0
1361979233,2400611020,1,46,46,1361979205211,1361979205211,2400583231,2400583231,0
1361979456,2400834796,2,116,58,1361979455312,1361979455632,2400834108,2400834428,320
1361979464,2400842880,3,168,56,1361979456188,1361979456764,2400835068,2400835644,576
1361979484,2400862072,1,52,52,1361979456674,1361979456674,2400834746,2400834746,0
1361979484,2400862108,1,64,64,1361979457919,1361979457919,2400836027,2400836027,0
1361979484,2400862120,15,7169,477.9333333,1361979459124,1361979465652,2400837244,2400843772,6528
1361979492,2400870220,1,52,52,1361979465294,1361979465294,2400843514,2400843514,0
1361979496,2400874180,1,64,64,1361979471541,1361979471541,2400849721,2400849721,0
1361979513,2400891544,1,46,46,1361979484169,1361979484169,2400862713,2400862713,0
1361979632,2401010604,1,46,46,1361979604750,1361979604750,2400983354,2400983354,0
1361979665,2401043636,4,271,67.75,1361979664174,1361979664686,2401042810,2401043322,512
1361979665,2401043728,3,168,56,1361979662289,1361979663761,2401041017,2401042489,1472
1361979673,2401051620,3,168,56,1361979665022,1361979665406,2401043642,2401044026,384
1361979676,2401054628,5,1961,392.2,1361979649972,1361979650740,2401028600,2401029368,768
1361979684,2401062776,9,2324,258.2222222,1361979659361,1361979661153,2401038137,2401039929,1792
1361979688,2401066584,1,52,52,1361979661086,1361979661086,2401039670,2401039670,0
1361979692,2401070596,1,64,64,1361979665877,1361979665877,2401044473,2401044473,0
1361979713,2401091684,2,104,52,1361979710650,1361979712762,2401089334,2401091446,2112
1361979729,2401107648,2,116,58,1361979728289,1361979728801,2401106937,2401107449,512
1361979729,2401107652,2,104,52,1361979717145,1361979725721,2401095797,2401104373,8576
1361979729,2401107688,3,168,56,1361979726711,1361979727287,2401105399,2401105975,576
1361979729,2401107724,3,168,56,1361979725842,1361979726354,2401104566,2401105078,512
1361979732,2401110716,1,46,46,1361979705372,1361979705372,2401084088,2401084088,0
1361979737,2401115692,3,168,56,1361979729330,1361979730034,2401108022,2401108726,704
1361979752,2401130692,1,46,46,1361979727603,1361979727603,2401106295,2401106295,0
1361979756,2401134660,1,52,52,1361979729107,1361979729107,2401107767,2401107767,0
1361979756,2401134672,9,2324,258.2222222,1361979728776,1361979730504,2401107448,2401109176,1728
1361979756,2401134696,1,52,52,1361979730157,1361979730157,2401108853,2401108853,0
1361979756,2401134776,1,64,64,1361979730270,1361979730270,2401109046,2401109046,0
1361979888,2401266880,1,46,46,1361979862071,1361979862071,2401240951,2401240951,0
1361979937,2401315744,3,168,56,1361979933949,1361979934013,2401312693,2401312757,64
1361979937,2401315816,3,168,56,1361979934005,1361979934133,2401312821,2401312949,128
1361979948,2401326904,1,64,64,1361979923740,1361979923740,2401302644,2401302644,0
1361979961,2401339816,13,7896,607.3846154,1361979957748,1361979958068,2401336564,2401336884,320
1361979961,2401339820,17,13073,769,1361979958065,1361979958321,2401336885,2401337141,256
1361979961,2401339820,3,168,56,1361979958065,1361979958385,2401336885,2401337205,320
1361979961,2401339824,17,13381,787.1176471,1361979958508,1361979958828,2401337332,2401337652,320
1361979961,2401339828,10,6602,660.2,1361979959015,1361979959079,2401337843,2401337907,64
1361979968,2401346888,1,46,46,1361979942189,1361979942189,2401321077,2401321077,0
1361979980,2401358916,1,52,52,1361979952848,1361979952848,2401331764,2401331764,0
1361979984,2401362904,1,64,64,1361979958301,1361979958301,2401337205,2401337205,0
1361979984,2401362908,7,3083,440.4285714,1361979958871,1361979962007,2401337779,2401340915,3136
1361980201,2401579076,1,52,52,1361980173972,1361980173972,2401552048,2401552048,0
1361980201,2401579112,1,46,46,1361980175472,1361980175472,2401553584,2401553584,0
1361980201,2401579192,1,46,46,1361980175905,1361980175905,2401554097,2401554097,0
1361980210,2401588080,2,92,46,1361980202894,1361980203150,2401580974,2401581230,256
1361980610,2401988532,3,168,56,1361980608775,1361980609415,2401987307,2401987947,640
1361980617,2401995740,9,3198,355.3333333,1361980591990,1361980594742,2401970730,2401973482,2752
1361980657,2402035708,2,129,64.5,1361980632148,1361980632148,2402010856,2402010856,0
1361980862,2402240136,1,46,46,1361980834254,1361980834254,2402212390,2402212390,0
1361981347,2402724932,1,60,60,1361981320403,1361981320403,2402698335,2402698335,0
1361981563,2402941244,1,77,77,1361981536216,1361981536216,2402914460,2402914460,0
1361981948,2403326364,3,168,56,1361981946842,1361981947418,2403325206,2403325782,576
1361981956,2403334272,5,2088,417.6,1361981948854,1361981949814,2403327126,2403328086,960
1361981956,2403334312,41,30856,752.5853659,1361981943567,1361981948495,2403321879,2403326807,4928
1361981956,2403334344,11,4594,417.6363636,1361981948845,1361981951213,2403327189,2403329557,2368
1361981972,2403350144,1,64,64,1361981947701,1361981947701,2403325845,2403325845,0
1361981976,2403354144,11,5506,500.5454545,1361981948725,1361981950645,2403326869,2403328789,1920
1361982465,2403843356,4,295,73.75,1361982439320,1361982441112,2403817676,2403819468,1792
1361982700,2404078748,3,168,56,1361982695375,1361982695503,2404074123,2404074251,128
1361982700,2404078748,3,168,56,1361982695501,1361982695565,2404074249,2404074313,64
1361982700,2404078752,3,168,56,1361982695628,1361982695756,2404074380,2404074508,128
1361982700,2404078836,3,168,56,1361982695798,1361982695926,2404074634,2404074762,128
1361982721,2404099728,1,46,46,1361982695776,1361982695776,2404074504,2404074504,0
1361982733,2404111744,1,52,52,1361982706576,1361982706576,2404085320,2404085320,0
1361982797,2404175836,1,52,52,1361982771571,1361982771571,2404150407,2404150407,0
1361982801,2404179872,1,46,46,1361982773135,1361982773135,2404152007,2404152007,0
1361982842,2404220180,1,52,52,1361982816262,1361982816262,2404194442,2404194442,0
1361983159,2404537016,1,52,52,1361983131683,1361983131683,2404509699,2404509699,0
1361983395,2404773504,2,129,64.5,1361983367224,1361983367224,2404745728,2404745728,0
1361983885,2405263716,3,168,56,1361983878108,1361983878236,2405256824,2405256952,128
1361983893,2405271720,2,110,55,1361983878234,1361983891226,2405256954,2405269946,12992
1361983893,2405271752,2,116,58,1361983891384,1361983892408,2405270136,2405271160,1024
1361983909,2405287048,10,3795,379.5,1361983882103,1361983882743,2405260151,2405260791,640
1361983909,2405287056,1,52,52,1361983882546,1361983882546,2405260602,2405260602,0
1361983909,2405287784,2,104,52,1361983895639,1361983901975,2405274423,2405280759,6336
1361983941,2405319236,2,104,52,1361983914939,1361983939579,2405293175,2405317815,24640
1361983973,2405351784,3,168,56,1361983970456,1361983971160,2405349240,2405349944,704
1361983973,2405351792,3,168,56,1361983971597,1361983972237,2405350389,2405351029,640
1361983981,2405359748,4,220,55,1361983972730,1361983974138,2405351478,2405352886,1408
1361983981,2405359760,3,168,56,1361983974320,1361983974960,2405353080,2405353720,640
1361983981,2405359788,3,168,56,1361983975250,1361983975634,2405354038,2405354422,384
1361983997,2405375888,2,98,49,1361983988013,1361983993069,2405366901,2405371957,5056
1361984001,2405379300,10,2385,238.5,1361983974587,1361983976251,2405352887,2405354551,1664
1361984001,2405379408,1,52,52,1361983975761,1361983975761,2405354169,2405354169,0
1361984001,2405379412,1,64,64,1361983976459,1361983976459,2405354871,2405354871,0
1361984005,2405383776,4,220,55,1361983997279,1361983999263,2405376055,2405378039,1984
1361984081,2405459404,1,46,46,1361984055762,1361984055762,2405434166,2405434166,0
1361984125,2405503472,1,64,64,1361984099341,1361984099341,2405477813,2405477813,0
1361984149,2405527916,3,168,56,1361984146834,1361984147410,2405525750,2405526326,576
1361984161,2405539556,1,64,64,1361984136633,1361984136633,2405515189,2405515189,0
1361984165,2405543496,9,2325,258.3333333,1361984138803,1361984140339,2405517299,2405518835,1536
1361984165,2405543520,1,46,46,1361984139548,1361984139548,2405518068,2405518068,0
1361984165,2405543528,1,52,52,1361984140054,1361984140054,2405518582,2405518582,0
1361984478,2405856336,3,168,56,1361984475790,1361984476494,2405854126,2405854830,704
1361984478,2405856348,3,168,56,1361984476866,1361984477570,2405855214,2405855918,704
1361984506,2405884092,1,52,52,1361984480642,1361984480642,2405858734,2405858734,0
1361984506,2405884132,10,2377,237.7,1361984479258,1361984501786,2405857390,2405879918,22528
1361984534,2405912068,1,46,46,1361984507737,1361984507737,2405885805,2405885805,0
1361984614,2405992648,2,104,52,1361984586455,1361984587031,2405965103,2405965679,576
1361984706,2406084784,1,52,52,1361984681611,1361984681611,2406060395,2406060395,0
1361984738,2406116788,7,3036,433.7142857,1361984713224,1361984717384,2406092012,2406096172,4160
1361984782,2406160628,2,116,58,1361984781541,1361984781861,2406160169,2406160489,320
1361984798,2406176592,2,110,55,1361984782474,1361984792586,2406161066,2406171178,10112
1361984798,2406176596,3,168,56,1361984794439,1361984795079,2406173035,2406173675,640
1361984798,2406176680,3,168,56,1361984792692,1361984794036,2406171372,2406172716,1344
1361984807,2406185004,1,52,52,1361984782742,1361984782742,2406160746,2406160746,0
1361984811,2406188944,14,2950,210.7142857,1361984783060,1361984785876,2406161004,2406163820,2816
1361984811,2406189068,1,52,52,1361984785432,1361984785432,2406163500,2406163500,0
1361984983,2406361120,1,46,46,1361984958050,1361984958050,2406336170,2406336170,0
1361985150,2406528884,3,168,56,1361985147039,1361985147743,2406525923,2406526627,704
1361985151,2406528932,3,168,56,1361985147033,1361985147609,2406524965,2406525541,576
1361985175,2406553492,10,2385,238.5,1361985149546,1361985151146,2406528038,2406529638,1600
1361985179,2406557320,1,52,52,1361985151061,1361985151061,2406529381,2406529381,0
1361985280,2406658044,1,60,60,1361985251881,1361985251881,2406629925,2406629925,0
1361985511,2406889004,3,168,56,1361985509004,1361985509900,2406887008,2406887904,896
1361985511,2406889100,3,168,56,1361985506733,1361985507309,2406884833,2406885409,576
1361985511,2406889104,3,168,56,1361985502760,1361985503464,2406880864,2406881568,704
1361985511,2406889104,3,168,56,1361985507558,1361985508582,2406885662,2406886686,1024
1361985531,2406909840,10,2385,238.5,1361985503878,1361985506886,2406882718,2406885726,3008
1361985531,2406909892,1,52,52,1361985506325,1361985506325,2406885217,2406885217,0
1361985607,2406985076,4,1556,389,1361985604929,1361985605697,2406983005,2406983773,768
1361985607,2406985116,32,29544,923.25,1361985598361,1361985603225,2406976477,2406981341,4864
1361985607,2406985196,12,5560,463.3333333,1361985603211,1361985604875,2406981407,2406983071,1664
1361985607,2406985196,9,4479,497.6666667,1361985603530,1361985604874,2406981726,2406983070,1344
1361985847,2407225252,3,168,56,1361985844175,1361985844751,2407222427,2407223003,576
1361985847,2407225268,3,168,56,1361985845118,1361985845694,2407223386,2407223962,576
1361987837,2409215300,3,441,147,1361987810242,1361987816258,2409188542,2409194558,6016
1361988042,2409419980,1,46,46,1361988014587,1361988014587,2409392567,2409392567,0
1361988062,2409439916,3,405,135,1361988035071,1361988041087,2409412987,2409419003,6016
1361988086,2409464008,1,46,46,1361988058720,1361988058720,2409436728,2409436728,0
1361988182,2409560228,3,408,136,1361988157379,1361988163459,2409535607,2409541687,6080
1361988282,2409660260,3,429,143,1361988254048,1361988260064,2409632308,2409638324,6016
1361988446,2409824588,3,411,137,1361988421399,1361988427415,2409799987,2409806003,6016
1361988530,2409908308,374,180953,483.8315508,1361986864172,1361988509804,2408242480,2409888112,1645632
1361988566,2409944880,1,60,60,1361988539636,1361988539636,2409918516,2409918516,0
1361988598,2409976676,2,121,60.5,1361988570302,1361988570366,2409948978,2409949042,64
1361988626,2410004824,1,60,60,1361988600553,1361988600553,2409979377,2409979377,0
1361988637,1048329532,3,408,136,1361988611203,1361988617219,1048303735,1048309751,6016
1361988659,2410036912,1,60,60,1361988631864,1361988631864,2410009776,2410009776,0
1361988687,2410065016,15,14938,995.8666667,1361988662222,1361988665614,2410040238,2410043630,3392
1361988719,2410097144,1,60,60,1361988692497,1361988692497,2410070641,2410070641,0
1361988751,2410129048,1,60,60,1361988722992,1361988722992,2410101040,2410101040,0
1361988779,2410157116,1,60,60,1361988753385,1361988753385,2410131501,2410131501,0
1361988811,2410189564,2,121,60.5,1361988783336,1361988810600,2410161900,2410189164,27264
1361988871,2410249444,1,60,60,1361988844320,1361988844320,2410222764,2410222764,0
1361988899,2410277484,1,60,60,1361988874682,1361988874682,2410253166,2410253166,0
1361988931,2410309636,1,60,60,1361988904992,1361988904992,2410283628,2410283628,0
1361988963,2410341492,1,60,60,1361988935537,1361988935537,2410314029,2410314029,0
1361988991,2410369852,1,60,60,1361988965575,1361988965575,2410344427,2410344427,0
1361989023,2410401844,1,60,60,1361988996048,1361988996048,2410374892,2410374892,0
1361989052,2410430024,2,121,60.5,1361989027265,1361989051201,2410405289,2410429225,23936
1361989072,2410450028,3,411,137,1361989045373,1361989051453,2410423401,2410429481,6080
1361989080,2410457976,10,609,60.9,1361989052274,1361989061298,2410430250,2410439274,9024
1361989116,2410494016,1,60,60,1361989088135,1361989088135,2410466151,2410466151,0
1361989240,2410618152,1,56,56,1361989212736,1361989212736,2410590888,2410590888,0
1361989240,2410618256,3,399,133,1361989214745,1361989220825,2410593001,2410599081,6080
1361989418,1049110780,3,402,134,1361989392272,1361989398288,1049085052,1049091068,6016
1361989592,2410970860,1,48,48,1361989565365,1361989565365,2410944225,2410944225,0
1361989668,2411046864,1,46,46,1361989641200,1361989641200,2411020064,2411020064,0
1361989692,2411070872,3,411,137,1361989666537,1361989672553,2411045409,2411051425,6016
1361989717,2411094968,1,46,46,1361989688945,1361989688945,2411066913,2411066913,0
1361989717,2411095016,1,46,46,1361989689920,1361989689920,2411067936,2411067936,0
1361990039,1049731616,3,441,147,1361990014073,1361990020089,1049706689,1049712705,6016
1361990181,2411559624,3,399,133,1361990155800,1361990161944,2411534424,2411540568,6144
1361990764,1050456544,1,77,77,1361990737669,1361990737669,1050430213,1050430213,0
1361990764,1050456596,1,58,58,1361990738641,1361990738641,1050431237,1050431237,0
1361991167,2412545496,3,408,136,1361991141642,1361991147658,2412520138,2412526154,6016
1361991252,2412630536,3,168,56,1361991247329,1361991248161,2412625865,2412626697,832
1361991252,2412630536,3,168,56,1361991243744,1361991244384,2412622280,2412622920,640
1361991252,2412630572,3,168,56,1361991248445,1361991249149,2412627017,2412627721,704
1361991252,2412630584,3,168,56,1361991246387,1361991246963,2412624971,2412625547,576
1361991252,2412630592,4,271,67.75,1361991250090,1361991250730,2412628682,2412629322,640
1361991271,2412649884,9,2325,258.3333333,1361991246342,1361991248262,2412625226,2412627146,1920
1361991275,2412653760,1,46,46,1361991249281,1361991249281,2412628041,2412628041,0
1361991569,2412947164,1,46,46,1361991541263,1361991541263,2412919427,2412919427,0
1361991612,2412990688,3,168,56,1361991608517,1361991609029,2412987205,2412987717,512
1361991612,2412990720,3,168,56,1361991609634,1361991610274,2412988354,2412988994,640
1361991612,2412990796,3,168,56,1361991608983,1361991609559,2412987779,2412988355,576
1362062116,2483494048,1,46,46,1362062091292,1362062091292,2483469340,2483469340,0
1362062584,2483962088,1,46,46,1362062556908,1362062556908,2483934996,2483934996,0
1362063943,2485321384,1,46,46,1362063917040,1362063917040,2485295424,2485295424,0
1362063943,2485321464,1,46,46,1362063917278,1362063917278,2485295742,2485295742,0
1362065322,2486700292,4,271,67.75,1362065321336,1362065321400,2486699628,2486699692,64
1362065322,2486700292,3,168,56,1362065321527,1362065321655,2486699819,2486699947,128
1362065330,2486708204,3,168,56,1362065321743,1362065321807,2486699947,2486700011,64
1362065334,2486712052,1,64,64,1362065306536,1362065306536,2486684588,2486684588,0
1362065338,2486716316,3,168,56,1362065331807,1362065331935,2486710123,2486710251,128
1362065342,2486720064,8,2273,284.125,1362065314716,1362065322652,2486692780,2486700716,7936
1362065350,2486728056,1,64,64,1362065322016,1362065322016,2486700072,2486700072,0
1362065362,2486740060,1,64,64,1362065335326,1362065335326,2486713386,2486713386,0
1362065362,2486740300,3,168,56,1362065355181,1362065355309,2486733481,2486733609,128
1362065362,2486740376,4,271,67.75,1362065355299,1362065355427,2486733675,2486733803,128
1362065370,2486748256,1,64,64,1362065345178,1362065345178,2486723434,2486723434,0
1362065643,2487020908,1,64,64,1362065618354,1362065618354,2486996262,2486996262,0
1362065651,2487028804,9,2368,263.1111111,1362065626712,1362065627608,2487004516,2487005412,896
1362065655,2487032808,1,52,52,1362065627478,1362065627478,2487005286,2487005286,0
1362065655,2487032920,3,192,64,1362065628580,1362065631652,2487006500,2487009572,3072
1362065667,2487044972,1,64,64,1362065641778,1362065641778,2487019750,2487019750,0
1362065714,2487092648,3,156,52,1362065711821,1362065712781,2487090469,2487091429,960
1362065722,2487100544,3,168,56,1362065714166,1362065714294,2487092710,2487092838,128
1362065722,2487100552,3,168,56,1362065716523,1362065716715,2487095075,2487095267,192
1362065722,2487100592,4,271,67.75,1362065713989,1362065714117,2487092581,2487092709,128
1362065722,2487100620,3,168,56,1362065716328,1362065716392,2487094948,2487095012,64
1362065722,2487100624,3,168,56,1362065716642,1362065716706,2487095266,2487095330,64
1362065727,2487104968,1,76,76,1362065700722,1362065700722,2487078690,2487078690,0
1362065730,2487108552,9,6267,696.3333333,1362065723819,1362065723947,2487102371,2487102499,128
1362065730,2487108556,12,6565,547.0833333,1362065724647,1362065724711,2487103203,2487103267,64
1362065730,2487108612,10,6461,646.1,1362065724849,1362065724913,2487103461,2487103525,64
1362065730,2487108624,2,110,55,1362065714277,1362065724645,2487092901,2487103269,10368
1362065730,2487108628,3,168,56,1362065726814,1362065726878,2487105442,2487105506,64
1362065731,2487108660,3,168,56,1362065725354,1362065725418,2487103014,2487103078,64
1362065731,2487108664,10,6537,653.7,1362065726244,1362065726308,2487103908,2487103972,64
1362065731,2487109064,1,76,76,1362065704277,1362065704277,2487082341,2487082341,0
1362065735,2487113004,10,2392,239.2,1362065710159,1362065712527,2487088163,2487090531,2368
1362065735,2487113068,26,12470,479.6153846,1362065708750,1362065722126,2487086818,2487100194,13376
1362065743,2487120988,1,64,64,1362065717409,1362065717409,2487095397,2487095397,0
1362065743,2487120988,9,3702,411.3333333,1362065717409,1362065718305,2487095397,2487096293,896
1362065743,2487121068,10,4625,462.5,1362065717393,1362065718097,2487095461,2487096165,704
1362065746,2487124652,3,168,56,1362065739528,1362065739656,2487118180,2487118308,128
1362065751,2487129084,1,64,64,1362065725055,1362065725055,2487103139,2487103139,0
1362065755,2487133064,1,64,64,1362065727508,1362065727508,2487105572,2487105572,0
1362065762,2487140584,2,110,55,1362065739722,1362065756874,2487118306,2487135458,17152
1362065762,2487140652,2,110,55,1362065747337,1362065760841,2487125989,2487139493,13504
1362065763,2487141064,1,64,64,1362065737682,1362065737682,2487115746,2487115746,0
1362065770,2487148596,3,168,56,1362065767551,1362065767679,2487146147,2487146275,128
1362065770,2487148624,2,110,55,1362065749731,1362065768227,2487128355,2487146851,18496
1362065778,2487156564,3,168,56,1362065769953,1362065770273,2487148517,2487148837,320
1362065778,2487156576,2,110,55,1362065759893,1362065770197,2487138469,2487148773,10304
1362065783,2487161056,1,64,64,1362065757977,1362065757977,2487136033,2487136033,0
1362065787,2487165080,2,731,365.5,1362065762756,1362065762884,2487140836,2487140964,128
1362065807,2487185080,1,52,52,1362065779076,1362065779076,2487157156,2487157156,0
1362065963,2487340756,2,92,46,1362065962438,1362065962694,2487340194,2487340450,256
1362065979,2487357292,1,52,52,1362065953965,1362065953965,2487332257,2487332257,0
1362066027,2487405268,1,46,46,1362066002754,1362066002754,2487381022,2487381022,0
1362066648,2488026100,2,129,64.5,1362066623651,1362066623651,2488001751,2488001751,0
1362066819,2488197332,5,230,46,1362066815159,1362066815415,2488193491,2488193747,256
1362066841,2488219028,7,2689,384.1428571,1362066815974,1362066817062,2488194002,2488195090,1088
1362067081,2488459464,1,46,46,1362067056686,1362067056686,2488435150,2488435150,0
1362067588,2488966260,5,325,65,1362067584821,1362067585397,2488963081,2488963657,576
1362067626,2489004316,9,2324,258.2222222,1362067599162,1362067600890,2488977478,2488979206,1728
1362068108,2489485888,1,76,76,1362068081248,1362068081248,2489459136,2489459136,0
1362068112,2489490064,1,64,64,1362068084848,1362068084848,2489462912,2489462912,0
1362068112,2489490144,1,46,46,1362068084639,1362068084639,2489462783,2489462783,0
1362068112,2489490172,1,76,76,1362068085189,1362068085189,2489463361,2489463361,0
1362068116,2489494500,11,6582,598.3636364,1362068109306,1362068109434,2489487806,2489487934,128
1362068116,2489494516,10,6476,647.6,1362068109676,1362068109740,2489488192,2489488256,64
1362068116,2489494572,3,168,56,1362068108658,1362068108786,2489487230,2489487358,128
1362068116,2489494572,9,6281,697.8888889,1362068108790,1362068108918,2489487362,2489487490,128
1362068116,2489494580,10,6516,651.6,1362068109805,1362068109997,2489488385,2489488577,192
1362068124,2489502048,20,10991,549.55,1362068097217,1362068107265,2489475265,2489485313,10048
1362068124,2489502072,1,52,52,1362068097960,1362068097960,2489476032,2489476032,0
1362068124,2489502080,7,2884,412,1362068099359,1362068100127,2489477439,2489478207,768
1362068124,2489502120,8,2272,284,1362068096695,1362068097975,2489474815,2489476095,1280
1362068124,2489502160,1,64,64,1362068098960,1362068098960,2489477120,2489477120,0
1362068124,2489502520,9,3702,411.3333333,1362068099241,1362068100521,2489477761,2489479041,1280
1362068124,2489502568,3,168,56,1362068119161,1362068119289,2489497729,2489497857,128
1362068124,2489502568,3,168,56,1362068119032,1362068119096,2489497600,2489497664,64
1362068125,2489502648,3,168,56,1362068119824,1362068119888,2489497472,2489497536,64
1362068128,2489506064,10,4625,462.5,1362068100207,1362068101743,2489478271,2489479807,1536
1362068132,2489510548,2,110,55,1362068119437,1362068131405,2489497985,2489509953,11968
1362068133,2489510684,3,168,56,1362068130347,1362068130411,2489508031,2489508095,64
1362068136,2489514112,1,64,64,1362068109311,1362068109311,2489487423,2489487423,0
1362068144,2489522208,1,46,46,1362068119646,1362068119646,2489497854,2489497854,0
1362068148,2489526516,3,168,56,1362068139949,1362068140077,2489518465,2489518593,128
1362068148,2489526520,9,6247,694.1111111,1362068139881,1362068139945,2489518401,2489518465,64
1362068148,2489526520,10,6516,651.6,1362068140520,1362068140584,2489519040,2489519104,64
1362068148,2489526572,12,8008,667.3333333,1362068140020,1362068140148,2489518592,2489518720,128
1362068148,2489526596,10,6476,647.6,1362068140700,1362068140892,2489519296,2489519488,192
1362068156,2489534180,2,110,55,1362068130043,1362068148475,2489508223,2489526655,18432
1362068156,2489534572,3,168,56,1362068150132,1362068150260,2489528704,2489528832,128
1362068156,2489534572,3,168,56,1362068150259,1362068150451,2489528831,2489529023,192
1362068164,2489542124,1,46,46,1362068136370,1362068136370,2489514494,2489514494,0
1362068168,2489546136,1,46,46,1362068140456,1362068140456,2489518592,2489518592,0
1362068168,2489546136,1,64,64,1362068140518,1362068140518,2489518654,2489518654,0
1362068172,2489550624,2,110,55,1362068160446,1362068170750,2489539070,2489549374,10304
1362068176,2489554284,1,64,64,1362068150741,1362068150741,2489529025,2489529025,0
1362068188,2489566208,1,52,52,1362068162591,1362068162591,2489540799,2489540799,0
1362068196,2489574340,1,64,64,1362068170843,1362068170843,2489549183,2489549183,0
1362068196,2489574616,3,168,56,1362068190663,1362068190791,2489569279,2489569407,128
1362068208,2489586260,1,64,64,1362068180971,1362068180971,2489559231,2489559231,0
1362068213,2489591068,30,28814,960.4666667,1362068207339,1362068212011,2489585407,2489590079,4672
1362068213,2489591072,10,5430,543,1362068207848,1362068212008,2489585920,2489590080,4160
1362068213,2489591148,9,4478,497.5555556,1362068207257,1362068211929,2489585405,2489590077,4672
1362068220,2489598584,25,14977,599.08,1362068211559,1362068213799,2489590143,2489592383,2240
1362068228,2489606584,18,20050,1113.888889,1362068219879,1362068221095,2489598463,2489599679,1216
1362068228,2489606620,23,13442,584.4347826,1362068225472,1362068226944,2489604092,2489605564,1472
1362068228,2489606624,6,3074,512.3333333,1362068223038,1362068223614,2489601662,2489602238,576
1362068228,2489606636,6,3810,635,1362068220082,1362068220338,2489598718,2489598974,256
1362068229,2489606664,5,2516,503.2,1362068221824,1362068222272,2489599488,2489599936,448
1362068229,2489606668,18,17030,946.1111111,1362068223033,1362068225401,2489600701,2489603069,2368
1362068229,2489606700,10,5367,536.7,1362068224218,1362068226010,2489601918,2489603710,1792
1362068260,2489638624,23,13447,584.6521739,1362068256895,1362068258687,2489635519,2489637311,1792
1362068261,2489638732,10,5367,536.7,1362068256187,1362068257467,2489633919,2489635199,1280
1362068277,2489654780,10,5204,520.4,1362068268424,1362068269192,2489646204,2489646972,768
1362068293,2489670820,14,6160,440,1362068289827,1362068291043,2489667647,2489668863,1216
1362068293,2489670900,11,4403,400.2727273,1362068289744,1362068290960,2489667644,2489668860,1216
1362068309,2489686860,9,4420,491.1111111,1362068301369,1362068302137,2489679229,2489679997,768
1362068309,2489686860,13,5287,406.6923077,1362068301368,1362068302136,2489679228,2489679996,768
1362068325,2489702864,15,7130,475.3333333,1362068317363,1362068319027,2489695227,2489696891,1664
1362068325,2489702948,10,5573,557.3,1362068317855,1362068318943,2489695803,2489696891,1088
1362068333,2489710892,14,8542,610.1428571,1362068330457,1362068331993,2489708349,2489709885,1536
1362068357,2489734932,10,5368,536.8,1362068351857,1362068353521,2489729789,2489731453,1664
1362068357,2489734940,13,8166,628.1538462,1362068348073,1362068349225,2489726013,2489727165,1152
1362068365,2489742728,1,46,46,1362068340542,1362068340542,2489718270,2489718270,0
1362068365,2489742916,11,4403,400.2727273,1362068362048,1362068362688,2489739964,2489740604,640
1362068365,2489742916,11,6004,545.8181818,1362068362046,1362068362686,2489739962,2489740602,640
1362068365,2489742980,13,5291,407,1362068358273,1362068358977,2489736253,2489736957,704
1362068369,2489746688,1,46,46,1362068341348,1362068341348,2489719036,2489719036,0
1362068373,2489750936,1,46,46,1362068347371,1362068347371,2489725307,2489725307,0
1362068421,2489798948,13,7766,597.3846154,1362068417441,1362068418977,2489795389,2489796925,1536
1362068421,2489798976,8,5967,745.875,1362068418885,1362068419013,2489796861,2489796989,128
1362068421,2489798980,6,3312,552,1362068419456,1362068419776,2489797436,2489797756,320
1362068421,2489798980,10,5204,520.4,1362068419582,1362068420414,2489797562,2489798394,832
1362068421,2489799060,7,5152,736,1362068420016,1362068420208,2489798076,2489798268,192
1362068421,2489799060,13,13656,1050.461538,1362068419695,1362068420015,2489797755,2489798075,320
1362068429,2489807024,22,13594,617.9090909,1362068418965,1362068421333,2489796989,2489799357,2368
1362068445,2489823008,9,4299,477.6666667,1362068442468,1362068443492,2489820476,2489821500,1024
1362068445,2489823028,71,93640,1318.873239,1362068442383,1362068442831,2489820411,2489820859,448
1362068445,2489823068,24,13704,571,1362068437542,1362068439910,2489815610,2489817978,2368
1362068445,2489823084,11,6014,546.7272727,1362068442389,1362068443413,2489820473,2489821497,1024
1362068445,2489823120,11,7236,657.8181818,1362068435763,1362068437363,2489813883,2489815483,1600
1362068469,2489846968,11,5184,471.2727273,1362068463948,1362068465036,2489841916,2489843004,1088
1362068469,2489847112,9,4420,491.1111111,1362068463804,1362068464892,2489841916,2489843004,1088
1362068501,2489878976,11,5314,483.0909091,1362068496000,1362068496896,2489873976,2489874872,896
1362068541,2489918992,12,6507,542.25,1362068537713,1362068538993,2489915705,2489916985,1280
1362068541,2489919068,15,6559,437.2666667,1362068534502,1362068536166,2489912570,2489914234,1664
1362068549,2489927052,23,13736,597.2173913,1362068539511,1362068540919,2489917563,2489918971,1408
1362068597,2489975092,11,5198,472.5454545,1362068594829,1362068595469,2489972921,2489973561,640
1362068621,2489999076,10,6005,600.5,1362068611869,1362068613661,2489989945,2489991737,1792
1362068621,2489999100,26,14026,539.4615385,1362068613636,1362068615364,2489991736,2489993464,1728
1362068645,2490023104,4,184,46,1362068641216,1362068641216,2490019320,2490019320,0
1362068653,2490031084,31,29859,963.1935484,1362068640531,1362068646675,2490018615,2490024759,6144
1362068653,2490031120,16,14388,899.25,1362068645294,1362068645486,2490023414,2490023606,192
1362068661,2490039072,10,5962,596.2,1362068653854,1362068655326,2490031926,2490033398,1472
1362068661,2490039104,23,13512,587.4782609,1362068655552,1362068657344,2490033656,2490035448,1792
1362068665,2490043632,7,2887,412.4285714,1362068640752,1362068641392,2490019384,2490020024,640
1362068677,2490055196,10,4379,437.9,1362068671588,1362068672228,2490049784,2490050424,640
1362068685,2490063108,13,6889,529.9230769,1362068680700,1362068682428,2490058808,2490060536,1728
1362068693,2490071176,21,13719,653.2857143,1362068682423,1362068684855,2490060599,2490063031,2432
1362068693,2490071184,14,7381,527.2142857,1362068691310,1362068692142,2490069494,2490070326,832
1362068693,2490071188,11,6236,566.9090909,1362068691309,1362068692141,2490069497,2490070329,832
1362068725,2490103104,12,6232,519.3333333,1362068717437,1362068719421,2490095541,2490097525,1984
1362068725,2490103184,22,13433,610.5909091,1362068721646,1362068723374,2490099830,2490101558,1728
1362068725,2490103228,11,6244,567.6363636,1362068719810,1362068721346,2490098038,2490099574,1536
1362068749,2490127216,10,4379,437.9,1362068744718,1362068745294,2490122934,2490123510,576
1362068829,2490207288,16,10884,680.25,1362068820997,1362068823877,2490199285,2490202165,2880
1362068829,2490207408,21,12555,597.8571429,1362068824077,1362068826189,2490202485,2490204597,2112
1362068834,2490212128,3,168,56,1362068807143,1362068817703,2490185271,2490195831,10560
1362068837,2490215348,12,5342,445.1666667,1362068832777,1362068833929,2490211125,2490212277,1152
1362068837,2490215388,8,5833,729.125,1362068830881,1362068831265,2490209269,2490209653,384
1362068837,2490215428,13,8538,656.7692308,1362068832696,1362068833848,2490211124,2490212276,1152
1362068885,2490263460,11,5314,483.0909091,1362068880730,1362068881306,2490259190,2490259766,576
1362068906,2490284548,1,46,46,1362068881473,1362068881473,2490260021,2490260021,0
1362068966,2490343688,13,6315,485.7692308,1362068962523,1362068964379,2490340211,2490342067,1856
1362068973,2490351580,12,8775,731.25,1362068969950,1362068971934,2490348530,2490350514,1984
1362068981,2490359636,24,14880,620,1362068972326,1362068974374,2490350962,2490353010,2048
1362068982,2490359720,9,6261,695.6666667,1362068973052,1362068974524,2490350772,2490352244,1472
1362068989,2490367624,9,8553,950.3333333,1362068984497,1362068984625,2490363121,2490363249,128
1362068989,2490367624,12,4502,375.1666667,1362068984564,1362068985716,2490363188,2490364340,1152
1362068989,2490367624,12,6105,508.75,1362068984564,1362068985716,2490363188,2490364340,1152
1362068997,2490375580,10,6026,602.6,1362068989727,1362068991135,2490368307,2490369715,1408
1362068997,2490375592,4,1408,352,1362068990676,1362068990932,2490369268,2490369524,256
1362068998,2490375656,13,7149,549.9230769,1362068990202,1362068992058,2490367858,2490369714,1856
1362068998,2490375664,30,26017,867.2333333,1362068991793,1362068992433,2490369457,2490370097,640
1362068998,2490375672,12,5245,437.0833333,1362068996524,1362068997676,2490374196,2490375348,1152
1362069005,2490383640,20,23250,1162.5,1362069003043,1362069003363,2490381683,2490382003,320
1362069005,2490383640,9,4299,477.6666667,1362069003169,1362069004193,2490381809,2490382833,1024
1362069005,2490383644,12,6072,506,1362069003295,1362069004191,2490381939,2490382835,896
1362069022,2490399732,10,5139,513.9,1362069020656,1362069021296,2490398388,2490399028,640
1362069022,2490399732,9,4420,491.1111111,1362069020654,1362069021294,2490398386,2490399026,640
1362069022,2490399804,11,5372,488.3636364,1362069017893,1362069018725,2490395697,2490396529,832
1362069022,2490399808,14,9258,661.2857143,1362069018020,1362069020068,2490395828,2490397876,2048
1362069026,2490404636,2,129,64.5,1362068997990,1362068997990,2490376626,2490376626,0
1362069030,2490407712,75,90381,1205.08,1362069024260,1362069024772,2490401972,2490402484,512
1362069030,2490407712,11,6016,546.9090909,1362069024388,1362069025092,2490402100,2490402804,704
1362069030,2490407712,9,4299,477.6666667,1362069024388,1362069025092,2490402100,2490402804,704
1362069030,2490407736,4,184,46,1362069025899,1362069025899,2490403635,2490403635,0
1362069030,2490407744,10,5141,514.1,1362069022944,1362069023968,2490400688,2490401712,1024
1362069030,2490407792,24,14916,621.5,1362069020468,1362069023092,2490398260,2490400884,2624
1362069051,2490428840,7,2689,384.1428571,1362069025792,1362069026560,2490403632,2490404400,768
1362069086,2490463736,25,15534,621.36,1362069079339,1362069082347,2490457075,2490460083,3008
1362069086,2490463740,13,8734,671.8461538,1362069083365,1362069084645,2490461105,2490462385,1280
1362069086,2490463748,13,5448,419.0769231,1362069080925,1362069082013,2490458673,2490459761,1088
1362069086,2490463772,12,6006,500.5,1362069076934,1362069079110,2490454706,2490456882,2176
1362069086,2490463812,11,5343,485.7272727,1362069079263,1362069079903,2490457075,2490457715,640
1362069086,2490463816,13,5288,406.7692308,1362069083289,1362069084697,2490461105,2490462513,1408
1362069086,2490463856,21,12734,606.3809524,1362069082353,1362069084081,2490460209,2490461937,1728
1362069142,2490519796,12,6258,521.5,1362069139052,1362069140588,2490516848,2490518384,1536
1362069142,2490519844,11,5285,480.4545455,1362069140734,1362069141374,2490518578,2490519218,640
1362069158,2490535868,11,6003,545.7272727,1362069152931,1362069153635,2490530799,2490531503,704
1362069158,2490535868,9,4299,477.6666667,1362069152931,1362069153635,2490530799,2490531503,704
1362069166,2490543836,5,2277,455.4,1362069164867,1362069165059,2490542703,2490542895,192
1362069166,2490543848,12,6695,557.9166667,1362069162809,1362069164601,2490540657,2490542449,1792
1362069174,2490551808,24,14881,620.0416667,1362069167970,1362069169826,2490545778,2490547634,1856
1362069174,2490551928,22,13432,610.5454545,1362069165482,1362069167722,2490543410,2490545650,2240
1362069174,2490551928,15,10190,679.3333333,1362069165609,1362069167337,2490543537,2490545265,1728
1362069270,2490647932,11,5285,480.4545455,1362069267556,1362069269028,2490645488,2490646960,1472
1362069291,2490669348,1,46,46,1362069266051,1362069266051,2490644399,2490644399,0
1362069291,2490669464,1,52,52,1362069266446,1362069266446,2490644910,2490644910,0
1362069358,2490736120,24,15132,630.5,1362069351526,1362069354534,2490729646,2490732654,3008
1362069358,2490736164,14,11019,787.0714286,1362069348985,1362069351353,2490727149,2490729517,2368
1362069358,2490736208,5,2936,587.2,1362069352462,1362069352846,2490730670,2490731054,384
1362069358,2490736240,10,5335,533.5,1362069356524,1362069357676,2490734764,2490735916,1152
1362069366,2490744192,23,13488,586.4347826,1362069359710,1362069361822,2490737902,2490740014,2112
1362069372,2490749676,1,52,52,1362069347617,1362069347617,2490725293,2490725293,0
1362069374,2490752232,13,8883,683.3076923,1362069365365,1362069366709,2490743597,2490744941,1344
1362069374,2490752232,12,5240,436.6666667,1362069365364,1362069366708,2490743596,2490744940,1344
1362069384,2490761672,3,222,74,1362069358499,1362069359139,2490736171,2490736811,640
1362069414,2490792220,11,5343,485.7272727,1362069406464,1362069407104,2490784684,2490785324,640
1362069416,2490794252,1,48,48,1362069389152,1362069389152,2490767404,2490767404,0
1362069422,2490800132,12,6294,524.5,1362069419927,1362069421399,2490798059,2490799531,1472
1362069454,2490832148,11,4403,400.2727273,1362069448649,1362069449417,2490826797,2490827565,768
1362069454,2490832176,12,5241,436.75,1362069445226,1362069445994,2490823402,2490824170,768
1362069454,2490832220,13,6111,470.0769231,1362069448575,1362069449343,2490826795,2490827563,768
1362069454,2490832228,9,4433,492.5555556,1362069445176,1362069445944,2490823404,2490824172,768
1362069486,2490864220,12,6798,566.5,1362069480000,1362069481152,2490858220,2490859372,1152
1362069598,2490976408,12,6241,520.0833333,1362069591234,1362069592770,2490969642,2490971178,1536
1362069606,2490984352,13,10385,798.8461538,1362069595963,1362069597883,2490974315,2490976235,1920
1362069606,2490984356,26,15111,581.1923077,1362069598775,1362069601271,2490977131,2490979627,2496
1362069606,2490984424,10,8503,850.3,1362069598642,1362069599026,2490977066,2490977450,384
1362069622,2491000372,14,9165,654.6428571,1362069612836,1362069614116,2490991208,2490992488,1280
1362069622,2491000372,12,5238,436.5,1362069612836,1362069614116,2490991208,2490992488,1280
1362069654,2491032504,13,5909,454.5384615,1362069651232,1362069652640,2491029736,2491031144,1408
1362069686,2491064616,12,6287,523.9166667,1362069684017,1362069685617,2491062633,2491064233,1600
1362069694,2491072552,14,11168,797.7142857,1362069687601,1362069689457,2491066153,2491068009,1856
1362069695,2491072672,22,13403,609.2272727,1362069690785,1362069692513,2491068457,2491070185,1728
1362069710,2491088552,12,5371,447.5833333,1362069705008,1362069706032,2491083560,2491084584,1024
1362069711,2491088664,22,13523,614.6818182,1362069707368,1362069709288,2491085032,2491086952,1920
1362069718,2491096544,12,5492,457.6666667,1362069710841,1362069712057,2491089385,2491090601,1216
1362069718,2491096624,23,13500,586.9565217,1362069712359,1362069714279,2491090983,2491092903,1920
1362069726,2491104508,11,6936,630.5454545,1362069718237,1362069718429,2491096745,2491096937,192
1362069726,2491104580,4,184,46,1362069718036,1362069718036,2491096616,2491096616,0
1362069726,2491104624,18,14492,805.1111111,1362069717479,1362069717863,2491096103,2491096487,384
1362069744,2491122136,7,2890,412.8571429,1362069718481,1362069718993,2491096617,2491097129,512
1362069750,2491128596,11,5314,483.0909091,1362069744260,1362069744964,2491122856,2491123560,704
1362069832,2491210244,1,52,52,1362069807330,1362069807330,2491185574,2491185574,0
1362069903,2491280788,4,220,55,1362069902122,1362069902826,2491279910,2491280614,704
1362069903,2491280792,10,6400,640,1362069899431,1362069899559,2491277223,2491277351,128
1362069903,2491280796,26,20517,789.1153846,1362069900703,1362069902111,2491278499,2491279907,1408
1362069903,2491280816,3,168,56,1362069897356,1362069897484,2491275172,2491275300,128
1362069903,2491280828,14,7190,513.5714286,1362069898243,1362069898883,2491276071,2491276711,640
1362069911,2491288772,3,156,52,1362069902906,1362069903610,2491280678,2491281382,704
1362069911,2491288800,2,110,55,1362069897563,1362069908443,2491275363,2491286243,10880
1362069919,2491296860,5,296,59.2,1362069907681,1362069913953,2491285541,2491291813,6272
1362069924,2491302616,1,76,76,1362069896236,1362069896236,2491274852,2491274852,0
1362069924,2491302628,9,3341,371.2222222,1362069897313,1362069898657,2491275941,2491277285,1344
1362069924,2491302656,15,5169,344.6,1362069897606,1362069900230,2491276262,2491278886,2624
1362069925,2491302672,1,76,76,1362069900572,1362069900572,2491278244,2491278244,0
1362069925,2491302688,11,2880,261.8181818,1362069900492,1362069903500,2491278180,2491281188,3008
1362069927,2491305036,16,13889,868.0625,1362069912050,1362069925618,2491290086,2491303654,13568
1362069928,2491306600,20,12621,631.05,1362069901499,1362069912763,2491280099,2491291363,11264
1362069929,2491306680,5,300,60,1362069902355,1362069911443,2491280035,2491289123,9088
1362069936,2491314620,5,300,60,1362069909480,1362069928552,2491288100,2491307172,19072
1362069948,2491326620,1,46,46,1362069922601,1362069922601,2491301221,2491301221,0
1362069949,2491326708,5,320,64,1362069923066,1362069944186,2491300774,2491321894,21120
1362069949,2491326740,4,256,64,1362069924313,1362069945369,2491302053,2491323109,21056
1362069967,2491345140,5,230,46,1362069958984,1362069964680,2491337124,2491342820,5696
1362069975,2491353216,3,156,52,1362069972219,1362069974075,2491350435,2491352291,1856
1362069983,2491361124,2,92,46,1362069970774,1362069980758,2491348898,2491358882,9984
1362069983,2491361136,2,104,52,1362069976523,1362069981387,2491354659,2491359523,4864
1362069985,2491362740,1,64,64,1362069957400,1362069957400,2491335140,2491335140,0
1362069991,2491369116,3,168,56,1362069989473,1362069989601,2491367589,2491367717,128
1362069991,2491369144,3,168,56,1362069990019,1362069990083,2491368163,2491368227,64
1362069991,2491369188,3,168,56,1362069989142,1362069989270,2491367330,2491367458,128
1362069991,2491369188,3,168,56,1362069989272,1362069989400,2491367460,2491367588,128
1362069991,2491369192,3,168,56,1362069989524,1362069989652,2491367716,2491367844,128
1362069991,2491369192,4,271,67.75,1362069989650,1362069989714,2491367842,2491367906,64
1362069991,2491369196,3,168,56,1362069989776,1362069989904,2491367972,2491368100,128
1362069991,2491369220,3,168,56,1362069990070,1362069990198,2491368290,2491368418,128
1362070007,2491385080,3,168,56,1362070000451,1362070000515,2491378531,2491378595,64
1362070007,2491385084,12,5558,463.1666667,1362070000577,1362070001601,2491378661,2491379685,1024
1362070007,2491385136,11,4595,417.7272727,1362070000458,1362070001546,2491378594,2491379682,1088
1362070007,2491385164,14,14284,1020.285714,1362070001329,1362070001969,2491379493,2491380133,640
1362070015,2491393136,13,6831,525.4615385,1362070005772,1362070007564,2491383908,2491385700,1792
1362070015,2491393184,22,16500,750,1362070007580,1362070010332,2491385764,2491388516,2752
1362070017,2491394696,1,64,64,1362069990723,1362069990723,2491368419,2491368419,0
1362070017,2491394700,1,46,46,1362069991167,1362069991167,2491368867,2491368867,0
1362070017,2491394708,1,52,52,1362069991543,1362069991543,2491369251,2491369251,0
1362070021,2491398932,9,2324,258.2222222,1362069992663,1362070020311,2491370595,2491398243,27648
1362070021,2491398940,1,52,52,1362069993038,1362069993038,2491370978,2491370978,0
1362070023,2491401160,3,168,56,1362070018995,1362070019123,2491397155,2491397283,128
1362070023,2491401160,3,168,56,1362070019186,1362070019378,2491397346,2491397538,192
1362070023,2491401236,3,168,56,1362070018536,1362070018664,2491396772,2491396900,128
1362070023,2491401236,3,168,56,1362070018727,1362070018919,2491396963,2491397155,192
1362070023,2491401240,3,168,56,1362070019299,1362070019427,2491397539,2491397667,128
1362070029,2491406948,7,3265,466.4285714,1362070001160,1362070001544,2491379108,2491379492,384
1362070031,2491409112,20,12665,633.25,1362070028898,1362070030498,2491407010,2491408610,1600
1362070031,2491409128,3,168,56,1362070029652,1362070029780,2491407780,2491407908,128
1362070031,2491409160,12,5371,447.5833333,1362070027442,1362070028274,2491405602,2491406434,832
1362070045,2491423084,8,2272,284,1362070019455,1362070020287,2491397539,2491398371,832
1362070045,2491423088,1,64,64,1362070019645,1362070019645,2491397733,2491397733,0
1362070047,2491425164,3,168,56,1362070039920,1362070040048,2491418084,2491418212,128
1362070047,2491425236,3,168,56,1362070039720,1362070039848,2491417956,2491418084,128
1362070047,2491425272,6,3936,656,1362070043075,1362070043267,2491421347,2491421539,192
1362070047,2491425276,10,7515,751.5,1362070043775,1362070044671,2491422051,2491422947,896
1362070055,2491433152,10,5139,513.9,1362070046970,1362070048634,2491425122,2491426786,1664
1362070055,2491433152,55,75827,1378.672727,1362070046970,1362070048122,2491425122,2491426274,1152
1362070055,2491433232,13,5381,413.9230769,1362070046889,1362070048553,2491425121,2491426785,1664
1362070057,2491434988,1,64,64,1362070029917,1362070029917,2491407905,2491407905,0
1362070063,2491441148,13,8847,680.5384615,1362070061119,1362070061631,2491439267,2491439779,512
1362070063,2491441196,55,77287,1405.218182,1362070052620,1362070054924,2491430816,2491433120,2304
1362070071,2491449168,54,75711,1402.055556,1362070063339,1362070063531,2491441507,2491441699,192
1362070079,2491457264,54,75711,1402.055556,1362070071180,1362070071372,2491449444,2491449636,192
1362070095,2491473288,11,7501,681.9090909,1362070089713,1362070092081,2491468001,2491470369,2368
1362070095,2491473324,6,4133,688.8333333,1362070091982,1362070092174,2491470306,2491470498,192
1362070103,2491481232,23,15065,655,1362070092137,1362070095017,2491470369,2491473249,2880
1362070111,2491489232,3,168,56,1362070105897,1362070106089,2491484129,2491484321,192
1362070111,2491489300,3,168,56,1362070105702,1362070105830,2491484002,2491484130,128
1362070127,2491505256,3,168,56,1362070126163,1362070126355,2491504419,2491504611,192
1362070127,2491505340,10,4379,437.9,1362070123644,1362070124220,2491501984,2491502560,576
1362070133,2491511244,1,52,52,1362070107101,1362070107101,2491485345,2491485345,0
1362070133,2491511336,1,64,64,1362070105987,1362070105987,2491484323,2491484323,0
1362070133,2491511396,8,2272,284,1362070106438,1362070107078,2491484834,2491485474,640
1362070141,2491519296,1,64,64,1362070116072,1362070116072,2491494368,2491494368,0
1362070143,2491521388,4,271,67.75,1362070136267,1362070136395,2491514655,2491514783,128
1362070143,2491521388,3,168,56,1362070136461,1362070136589,2491514849,2491514977,128
1362070143,2491521416,3,168,56,1362070136626,1362070136754,2491515042,2491515170,128
1362070153,2491531280,1,64,64,1362070126331,1362070126331,2491504611,2491504611,0
1362070161,2491539256,1,46,46,1362070136719,1362070136719,2491514975,2491514975,0
1362070165,2491543228,1,46,46,1362070139054,1362070139054,2491517282,2491517282,0
1362070165,2491543344,1,46,46,1362070139899,1362070139899,2491518243,2491518243,0
1362070269,2491647516,1,46,46,1362070241037,1362070241037,2491619553,2491619553,0
1362070269,2491647520,2,116,58,1362070241349,1362070241541,2491619869,2491620061,192
1362070423,2491801504,3,168,56,1362070421523,1362070422099,2491800027,2491800603,576
1362070423,2491801512,2,116,58,1362070422349,1362070422669,2491800861,2491801181,320
1362070423,2491801544,3,168,56,1362070419307,1362070419883,2491797851,2491798427,576
1362070423,2491801576,3,168,56,1362070417742,1362070418318,2491796318,2491796894,576
1362070423,2491801628,3,168,56,1362070420120,1362070420888,2491798748,2491799516,768
1362070431,2491809556,3,168,56,1362070423327,1362070424031,2491801883,2491802587,704
1362070431,2491809592,3,168,56,1362070424381,1362070424957,2491802973,2491803549,576
1362070446,2491823944,1,46,46,1362070419270,1362070419270,2491797214,2491797214,0
1362070446,2491824000,9,2324,258.2222222,1362070421259,1362070424075,2491799259,2491802075,2816
1362070450,2491828024,1,64,64,1362070425716,1362070425716,2491803740,2491803740,0
1362070450,2491828028,1,52,52,1362070423600,1362070423600,2491801628,2491801628,0
1362070450,2491828076,1,52,52,1362070422658,1362070422658,2491800734,2491800734,0
1362070655,2492033132,1,46,46,1362070626823,1362070626823,2492004955,2492004955,0
1362070744,2492121804,3,168,56,1362070743051,1362070743627,2492120855,2492121431,576
1362070744,2492121876,3,168,56,1362070741126,1362070741766,2492119002,2492119642,640
1362070744,2492121880,3,168,56,1362070742081,1362070742657,2492119961,2492120537,576
1362070752,2492129820,3,168,56,1362070744188,1362070745084,2492122008,2492122904,896
1362070755,2492133056,1,64,64,1362070730384,1362070730384,2492108440,2492108440,0
1362070759,2492136928,9,2324,258.2222222,1362070733391,1362070735055,2492111319,2492112983,1664
1362070759,2492137048,1,52,52,1362070734616,1362070734616,2492112664,2492112664,0
1362070771,2492149036,1,46,46,1362070745189,1362070745189,2492123225,2492123225,0
1362070771,2492149060,1,64,64,1362070745804,1362070745804,2492123864,2492123864,0
1362070819,2492197280,1,46,46,1362070793198,1362070793198,2492171478,2492171478,0
1362070992,2492370404,3,168,56,1362070991472,1362070991536,2492369876,2492369940,64
1362071000,2492378412,9,6305,700.5555556,1362070999018,1362070999210,2492377430,2492377622,192
1362071000,2492378452,3,168,56,1362070993408,1362070993536,2492371860,2492371988,128
1362071000,2492378452,3,168,56,1362070993535,1362070993663,2492371987,2492372115,128
1362071000,2492378456,3,168,56,1362070993662,1362070993854,2492372118,2492372310,192
1362071000,2492378456,3,168,56,1362070993852,1362070994044,2492372308,2492372500,192
1362071000,2492378456,3,168,56,1362070993979,1362070994107,2492372435,2492372563,128
1362071000,2492378456,4,271,67.75,1362070994106,1362070994298,2492372562,2492372754,192
1362071000,2492378500,10,6504,650.4,1362070999570,1362070999762,2492378070,2492378262,192
1362071000,2492378508,4,271,67.75,1362070993096,1362070993224,2492371604,2492371732,128
1362071007,2492385408,1,76,76,1362070981931,1362070981931,2492360339,2492360339,0
1362071008,2492386408,9,6339,704.3333333,1362071000107,1362071000235,2492378515,2492378643,128
1362071008,2492386476,10,6506,650.6,1362071000359,1362071000423,2492378835,2492378899,64
1362071011,2492389516,1,76,76,1362070985089,1362070985089,2492363605,2492363605,0
1362071015,2492393396,10,2376,237.6,1362070987703,1362070988727,2492366099,2492367123,1024
1362071015,2492393424,1,52,52,1362070988636,1362070988636,2492367060,2492367060,0
1362071015,2492393516,21,12098,576.0952381,1362070988672,1362070997952,2492367188,2492376468,9280
1362071016,2492394440,4,271,67.75,1362071015118,1362071015310,2492393558,2492393750,192
1362071016,2492394444,2,110,55,1362070991558,1362071010374,2492370002,2492388818,18816
1362071016,2492394488,3,168,56,1362071014876,1362071015004,2492393364,2492393492,128
1362071016,2492394516,3,168,56,1362071015234,1362071015298,2492393750,2492393814,64
1362071016,2492394516,4,232,58,1362071011649,1362071014785,2492390165,2492393301,3136
1362071016,2492394516,3,168,56,1362071015360,1362071015552,2492393876,2492394068,192
1362071019,2492397420,1,46,46,1362070993824,1362070993824,2492372244,2492372244,0
1362071019,2492397512,7,3205,457.8571429,1362070993602,1362070994306,2492372114,2492372818,704
1362071019,2492397528,10,3622,362.2,1362070993779,1362070995059,2492372307,2492373587,1280
1362071023,2492401496,10,4625,462.5,1362070994900,1362070995476,2492373396,2492373972,576
1362071027,2492405512,1,64,64,1362071001540,1362071001540,2492380052,2492380052,0
1362071043,2492421420,1,46,46,1362071015073,1362071015073,2492393493,2492393493,0
1362071043,2492421544,1,64,64,1362071015526,1362071015526,2492394070,2492394070,0
1362071047,2492425448,3,1055,351.6666667,1362071020997,1362071021061,2492399445,2492399509,64
1362071064,2492442520,6,312,52,1362071056443,1362071063739,2492434963,2492442259,7296
1362071088,2492466480,2,104,52,1362071071330,1362071086370,2492449810,2492464850,15040
1362071096,2492474456,3,168,56,1362071092219,1362071092347,2492470675,2492470803,128
1362071096,2492474520,4,220,55,1362071091579,1362071092027,2492470099,2492470547,448
1362071104,2492482524,3,168,56,1362071102584,1362071102648,2492481108,2492481172,64
1362071112,2492490488,14,9815,701.0714286,1362071104475,1362071109403,2492482963,2492487891,4928
1362071118,1130810500,1,76,76,1362071091071,1362071091071,1130783571,1130783571,0
1362071119,2492497476,1,46,46,1362071092392,1362071092392,2492470868,2492470868,0
1362071119,2492497584,1,64,64,1362071092348,1362071092348,2492470932,2492470932,0
1362071122,1130814548,1,76,76,1362071095951,1362071095951,1130788499,1130788499,0
1362071127,2492505516,9,3576,397.3333333,1362071100862,1362071106238,2492479378,2492484754,5376
1362071127,2492505524,1,52,52,1362071101493,1362071101493,2492480017,2492480017,0
1362071127,2492505568,1,64,64,1362071099596,1362071099596,2492478164,2492478164,0
1362071127,2492505600,8,2272,284,1362071100460,1362071101484,2492479060,2492480084,1024
1362071128,2492505644,1,64,64,1362071103653,1362071103653,2492481297,2492481297,0
1362071128,2492506480,3,168,56,1362071120099,1362071120163,2492498579,2492498643,64
1362071128,2492506484,3,168,56,1362071120224,1362071120352,2492498708,2492498836,128
1362071128,2492506492,3,168,56,1362071120792,1362071120856,2492499284,2492499348,64
1362071128,2492506528,2,110,55,1362071109811,1362071119923,2492488339,2492498451,10112
1362071128,2492506536,3,168,56,1362071119914,1362071119978,2492498450,2492498514,64
1362071128,2492506564,3,168,56,1362071120397,1362071120525,2492498961,2492499089,128
1362071135,2492513556,22,11507,523.0454545,1362071109717,1362071119637,2492488273,2492498193,9920
1362071144,2492521640,1,52,52,1362071117290,1362071117290,2492494930,2492494930,0
1362071144,2492522528,15,10613,707.5333333,1362071139507,1362071140851,2492518035,2492519379,1344
1362071147,2492525664,1,46,46,1362071120235,1362071120235,2492498899,2492498899,0
1362071147,2492525676,1,64,64,1362071120735,1362071120735,2492499411,2492499411,0
1362071159,2492537632,1,64,64,1362071130827,1362071130827,2492509459,2492509459,0
1362071188,2492565784,2,1015,507.5,1362071161624,1362071161688,2492539408,2492539472,64
1362071240,2492617848,1,52,52,1362071213210,1362071213210,2492591058,2492591058,0
1362071240,2492618624,2,92,46,1362071234195,1362071234451,2492612819,2492613075,256
1362071264,2492641812,1,46,46,1362071238654,1362071238654,2492616466,2492616466,0
1362071264,2492641932,1,46,46,1362071239556,1362071239556,2492617488,2492617488,0
1362071268,2492645800,1,46,46,1362071241031,1362071241031,2492618831,2492618831,0
1362071288,2492665908,1,46,46,1362071261596,1362071261596,2492639504,2492639504,0
1362071388,2492766012,1,46,46,1362071360178,1362071360178,2492738190,2492738190,0
1362071409,2492786768,5,230,46,1362071401701,1362071405349,2492779469,2492783117,3648
1362071425,2492802756,2,92,46,1362071409202,1362071416882,2492786958,2492794638,7680
1362071425,2492802792,4,271,67.75,1362071422607,1362071423247,2492800399,2492801039,640
1362071425,2492802804,3,168,56,1362071420546,1362071421122,2492798350,2492798926,576
1362071425,2492802836,3,168,56,1362071421408,1362071422048,2492799244,2492799884,640
1362071433,2492810772,4,220,55,1362071425634,1362071426466,2492803406,2492804238,832
1362071433,2492810840,4,271,67.75,1362071424478,1362071425246,2492802318,2492803086,768
1362071433,2492810852,3,168,56,1362071426449,1362071427025,2492804301,2492804877,576
1362071433,2492810880,3,168,56,1362071427060,1362071427636,2492804940,2492805516,576
1362071433,2492810888,3,168,56,1362071427885,1362071428525,2492805773,2492806413,640
1362071448,2492826160,9,2324,258.2222222,1362071423517,1362071425501,2492801677,2492803661,1984
1362071448,2492826160,1,46,46,1362071423517,1362071423517,2492801677,2492801677,0
1362071448,2492826240,10,4625,462.5,1362071423438,1362071425038,2492801678,2492803278,1600
1362071448,2492826240,1,64,64,1362071423438,1362071423438,2492801678,2492801678,0
1362071452,2492830140,1,46,46,1362071426546,1362071426546,2492804686,2492804686,0
1362071452,2492830220,1,52,52,1362071424992,1362071424992,2492803212,2492803212,0
1362071456,2492834332,1,64,64,1362071428402,1362071428402,2492806734,2492806734,0
1362071497,2492875540,1,52,52,1362071469986,1362071469986,2492848526,2492848526,0
1362071512,2492890288,1,52,52,1362071485980,1362071485980,2492864268,2492864268,0
1362071545,2492923276,1,52,52,1362071517225,1362071517225,2492895501,2492895501,0
1362071729,2493107148,2,116,58,1362071728230,1362071728614,2493106378,2493106762,384
1362071729,2493107180,3,168,56,1362071727236,1362071727876,2493105416,2493106056,640
1362071737,2493115132,3,168,56,1362071729972,1362071730676,2493108104,2493108808,704
1362071737,2493115204,3,168,56,1362071732783,1362071733359,2493110987,2493111563,576
1362071737,2493115208,3,168,56,1362071733672,1362071734248,2493111880,2493112456,576
1362071737,2493115248,3,168,56,1362071730819,1362071731459,2493109067,2493109707,640
1362071737,2493115256,3,168,56,1362071731770,1362071732410,2493110026,2493110666,640
1362071752,2493130612,9,2324,258.2222222,1362071726807,1362071728855,2493105419,2493107467,2048
1362071756,2493134640,1,52,52,1362071728439,1362071728439,2493107079,2493107079,0
1362071757,2493134668,1,46,46,1362071729667,1362071729667,2493107335,2493107335,0
1362071757,2493134668,1,52,52,1362071729347,1362071729347,2493107015,2493107015,0
1362071760,2493138584,1,64,64,1362071734256,1362071734256,2493112840,2493112840,0
1362071769,2493146736,5,250,50,1362071740737,1362071762881,2493118473,2493140617,22144
1362071817,2493194900,1,64,64,1362071792540,1362071792540,2493170440,2493170440,0
1362084178,2505556160,2,283,141.5,1362084152349,1362084152477,2505530509,2505530637,128
1362084234,2505612316,2,283,141.5,1362084207809,1362084207937,2505586125,2505586253,128
1362084290,2505668376,2,283,141.5,1362084262916,1362084263044,2505641292,2505641420,128
1362084347,2505724652,2,283,141.5,1362084318872,1362084319000,2505696524,2505696652,128
1362084379,2505756872,10,5654,565.4,1362084375868,1362084375996,2505753740,2505753868,128
1362084399,2505776656,2,283,141.5,1362084374546,1362084374674,2505752202,2505752330,128
1362084403,2505780648,5,4390,878,1362084375129,1362084375961,2505752777,2505753609,832
1362084455,2505832876,2,283,141.5,1362084430261,1362084430389,2505808137,2505808265,128
1362084511,2505889148,2,283,141.5,1362084486052,1362084486180,2505864200,2505864328,128
1362084516,1144209092,12,6203,516.9166667,1362084509381,1362084509573,1144202473,1144202665,192
1362084516,1144209092,11,8622,783.8181818,1362084509573,1362084509701,1144202665,1144202793,128
1362084516,1144209092,7,554,79.14285714,1362084509769,1362084515337,1144202861,1144208429,5568
1362084516,1144209092,7,554,79.14285714,1362084509769,1362084515273,1144202861,1144208365,5504
1362084516,1144209096,7,554,79.14285714,1362084509764,1362084515332,1144202860,1144208428,5568
1362084516,1144209104,10,5172,517.2,1362084509370,1362084509434,1144202474,1144202538,64
1362084516,1144209104,8,606,75.75,1362084509753,1362084515257,1144202857,1144208361,5504
1362084516,1144209104,7,554,79.14285714,1362084509757,1362084515325,1144202861,1144208429,5568
1362084516,1144209104,7,554,79.14285714,1362084509756,1362084515260,1144202860,1144208364,5504
1362084567,2505945144,2,283,141.5,1362084542185,1362084542313,2505920329,2505920457,128
1362084623,2506001368,2,283,141.5,1362084597831,1362084598023,2505976199,2505976391,192
1362084676,2506053796,5,379,75.8,1362084671680,1362084671808,2506049476,2506049604,128
1362084676,2506053856,5,867,173.4,1362084670468,1362084670660,2506048324,2506048516,192
1362084679,2506057440,2,283,141.5,1362084653117,1362084653245,2506031557,2506031685,128
1362084692,2506069636,6,4450,741.6666667,1362084666785,1362084670561,2506044421,2506048197,3776
1362084695,2506073436,5,4390,878,1362084670144,1362084670912,2506048580,2506049348,768
1362084735,2506113580,2,283,141.5,1362084708977,1362084709105,2506087557,2506087685,128
1362084964,2506341888,1,46,46,1362084938530,1362084938530,2506316418,2506316418,0
1362085790,2507168496,1,48,48,1362085763893,1362085763893,2507142389,2507142389,0
1362085854,2507231980,2,104,52,1362085829623,1362085830007,2507207603,2507207987,384
1362085854,2507232200,2,104,52,1362085828955,1362085829595,2507207155,2507207795,640
1362085858,2507235940,2,104,52,1362085829856,1362085830304,2507207796,2507208244,448
1362085858,2507235940,2,104,52,1362085829855,1362085830239,2507207795,2507208179,384
1362086457,2507834600,1,46,46,1362086428586,1362086428586,2507806186,2507806186,0
1362086871,2508248764,5,456,91.2,1362086864962,1362086865282,2508242726,2508243046,320
1362086879,2508256724,7,498,71.14285714,1362086864487,1362086872999,2508242211,2508250723,8512
1362086887,2508264752,9,2637,293,1362086864970,1362086882570,2508242722,2508260322,17600
1362086892,2508269900,2,152,76,1362086865401,1362086880377,2508243301,2508258277,14976
1362086892,1146584532,3,313,104.3333333,1362086864711,1362086864711,1146557243,1146557243,0
1362086900,2508277928,11,3267,297,1362086873758,1362086874270,2508251686,2508252198,512
1362086900,2508278044,4,342,85.5,1362086873129,1362086873385,2508251173,2508251429,256
1362086920,2508298188,2,152,76,1362086895129,1362086910105,2508273317,2508288293,14976
1362086927,2508304680,11,5337,485.1818182,1362086920852,1362086921556,2508298532,2508299236,704
1362086948,1146640752,1,52,52,1362086923436,1362086923436,1146616188,1146616188,0
1362086948,2508326268,18,7277,404.2777778,1362086921095,1362086922695,2508299363,2508300963,1600
1362086952,2508330296,1,76,76,1362086925036,1362086925036,2508303332,2508303332,0
1362087199,2508577076,6,497,82.83333333,1362087192132,1362087195780,2508570208,2508573856,3648
1362087205,2508582988,5,1795,359,1362087179739,1362087195547,2508557727,2508573535,15808
1362087207,2508585092,7,820,117.1428571,1362087184181,1362087203125,2508562273,2508581217,18944
1362087215,2508593112,2,178,89,1362087199585,1362087207329,2508577697,2508585441,7744
1362087237,2508615196,1,359,359,1362087211530,1362087211530,2508589726,2508589726,0
1362087249,2508627056,1,89,89,1362087222870,1362087222870,2508600926,2508600926,0
1362087269,2508647112,1,359,359,1362087243868,1362087243868,2508621980,2508621980,0
1362087281,2508659132,1,89,89,1362087253769,1362087253769,2508631901,2508631901,0
1362087319,2508697148,2,405,202.5,1362087307834,1362087313786,2508685982,2508691934,5952
1362087743,2509121444,4,271,67.75,1362087739785,1362087740489,2509118229,2509118933,704
1362087743,2509121448,3,168,56,1362087740550,1362087741190,2509118998,2509119638,640
1362087743,2509121452,3,168,56,1362087737475,1362087738115,2509115927,2509116567,640
1362087743,2509121480,3,168,56,1362087741481,1362087742249,2509119961,2509120729,768
1362087743,2509121492,3,168,56,1362087738587,1362087739227,2509117079,2509117719,640
1362087743,2509121528,4,271,67.75,1362087739769,1362087740409,2509118297,2509118937,640
1362087743,2509121528,3,168,56,1362087736502,1362087737142,2509115030,2509115670,640
1362087766,2509144576,9,2325,258.3333333,1362087739717,1362087741765,2509118293,2509120341,2048
1362087770,2509148432,1,64,64,1362087743189,1362087743189,2509121621,2509121621,0
1362087770,2509148552,1,46,46,1362087742430,1362087742430,2509120982,2509120982,0
1362088063,2509441296,1,46,46,1362088037531,1362088037531,2509415827,2509415827,0
1362088063,2509441300,1,46,46,1362088037847,1362088037847,2509416147,2509416147,0
1362088064,2509441952,3,168,56,1362088059442,1362088060018,2509437394,2509437970,576
1362088064,2509441992,3,168,56,1362088061066,1362088061642,2509439058,2509439634,576
1362088064,2509442004,3,168,56,1362088062206,1362088062654,2509440210,2509440658,448
1362088064,2509442040,3,168,56,1362088060250,1362088060634,2509438290,2509438674,384
1362088064,2509442112,3,168,56,1362088062930,1362088063378,2509441042,2509441490,448
1362088072,2509449960,3,168,56,1362088064812,1362088065324,2509442772,2509443284,512
1362088072,2509449992,3,168,56,1362088066505,1362088067145,2509444497,2509445137,640
1362088072,2509450032,3,168,56,1362088063778,1362088064482,2509441810,2509442514,704
1362088072,2509450064,3,168,56,1362088065539,1362088066179,2509443603,2509444243,640
1362088087,2509465352,9,2325,258.3333333,1362088061987,1362088063843,2509440339,2509442195,1856
1362088091,2509469504,1,52,52,1362088063371,1362088063371,2509441875,2509441875,0
1362088095,2509473284,1,64,64,1362088067173,1362088067173,2509445457,2509445457,0
1362088176,2509554500,1,46,46,1362088147342,1362088147342,2509525842,2509525842,0
1362088248,2509626324,3,168,56,1362088244477,1362088245053,2509622801,2509623377,576
1362088248,2509626432,3,168,56,1362088245265,1362088246161,2509623697,2509624593,896
1362088248,2509626440,3,168,56,1362088246598,1362088247302,2509625038,2509625742,704
1362088256,2509634400,3,168,56,1362088247726,1362088248558,2509626126,2509626958,832
1362088256,2509634424,4,271,67.75,1362088248854,1362088249238,2509627278,2509627662,384
1362088276,2509653600,1,64,64,1362088250639,1362088250639,2509628239,2509628239,0
1362088276,2509653652,10,3795,379.5,1362088248091,1362088250267,2509625743,2509627919,2176
1362088276,2509653688,1,52,52,1362088249717,1362088249717,2509627405,2509627405,0
1362088560,2509938524,3,168,56,1362088556398,1362088556846,2509934922,2509935370,448
1362088560,2509938572,4,220,55,1362088558206,1362088559230,2509936778,2509937802,1024
1362088561,2509938644,3,168,56,1362088558046,1362088558750,2509935690,2509936394,704
1362088561,2509938652,3,168,56,1362088555477,1362088556117,2509933129,2509933769,640
1362088561,2509938656,3,168,56,1362088556241,1362088556945,2509933897,2509934601,704
1362088580,2509958312,9,2325,258.3333333,1362088554819,1362088556803,2509933131,2509935115,1984
1362088584,2509962208,1,52,52,1362088556395,1362088556395,2509934603,2509934603,0
1362088588,2509966168,1,64,64,1362088559890,1362088559890,2509938058,2509938058,0
1362088600,2509978540,2,116,58,1362088599518,1362088599838,2509978058,2509978378,320
1362088608,2509986572,3,168,56,1362088600445,1362088601085,2509979017,2509979657,640
1362088609,2509986584,3,168,56,1362088602332,1362088602972,2509979916,2509980556,640
1362088609,2509986700,3,168,56,1362088603176,1362088603752,2509980876,2509981452,576
1362088624,2510002188,1,46,46,1362088599679,1362088599679,2509977867,2509977867,0
1362088628,2510006212,1,52,52,1362088600484,1362088600484,2509978696,2509978696,0
