unix_secs,sysuptime,dpkts,doctets,doctets/dpkts,Real First Packet,Real End Packet,first,last,Duration
1362082190,2503567796,19,9348,492,1362082185957,1362082186917,2503563753,2503564713,960
1362082190,2503567864,4,395,98.75,1362082184161,1362082186209,2503562025,2503564073,2048
1362082190,2503567908,19,5169,272.0526316,1362082182901,1362082183285,2503560809,2503561193,384
1362082197,2503575016,4,373,93.25,1362082184524,1362082193612,2503562540,2503571628,9088
1362082204,2503582092,28,7551,269.6785714,1362082176512,1362082183680,2503554604,2503561772,7168
1362082206,1141898256,7,6581,940.1428571,1362082181820,1362082181884,1141874076,1141874140,64
1362082208,2503586120,36,17091,474.75,1362082181409,1362082184289,2503559529,2503562409,2880
1362082208,2503586124,2,92,46,1362082181600,1362082181664,2503559724,2503559788,64
1362082208,2503586164,21,12916,615.047619,1362082182648,1362082183160,2503560812,2503561324,512
1362082208,2503586240,14,11929,852.0714286,1362082181164,1362082181420,2503559404,2503559660,256
1362082208,2503586240,11,12760,1160,1362082181164,1362082181420,2503559404,2503559660,256
1362082208,2503586244,1,46,46,1362082181480,1362082181480,2503559724,2503559724,0
1362082208,2503586244,1,46,46,1362082181480,1362082181480,2503559724,2503559724,0
1362082208,2503586244,3,138,46,1362082181480,1362082181480,2503559724,2503559724,0
1362082208,2503586244,9,1162,129.1111111,1362082181607,1362082181735,2503559851,2503559979,128
1362082208,2503586244,9,1170,130,1362082181606,1362082181734,2503559850,2503559978,128
1362082208,2503586288,5,441,88.2,1362082183098,1362082183226,2503561386,2503561514,128
1362082210,1141902212,19,22689,1194.157895,1362082181993,1362082182057,1141874205,1141874269,64
1362082212,2503590072,3,527,175.6666667,1362082184018,1362082184018,2503562090,2503562090,0
1362082212,2503590160,16,12673,792.0625,1362082186940,1362082187132,2503565100,2503565292,192
1362082212,2503590164,18,12901,716.7222222,1362082187256,1362082187896,2503565420,2503566060,640
1362082212,2503590168,4,1338,334.5,1362082183859,1362082183923,2503562027,2503562091,64
1362082212,2503590192,4,431,107.75,1362082183897,1362082183961,2503562089,2503562153,64
1362082212,2503590196,4,1262,315.5,1362082184023,1362082184087,2503562219,2503562283,64
1362082212,2503590196,4,377,94.25,1362082184086,1362082184150,2503562282,2503562346,64
1362082212,2503590196,4,1333,333.25,1362082184086,1362082184150,2503562282,2503562346,64
1362082212,2503590240,1,52,52,1362082185707,1362082185707,2503563947,2503563947,0
1362082212,2503590240,1,52,52,1362082185707,1362082185707,2503563947,2503563947,0
1362082212,2503590284,6,1190,198.3333333,1362082186943,1362082187071,2503565227,2503565355,128
1362082214,1141906248,5,1270,254,1362082187716,1362082188228,1141879964,1141880476,512
1362082224,2503602096,2,152,76,1362082195833,1362082210873,2503573929,2503588969,15040
1362082236,2503614204,1,52,52,1362082211278,1362082211278,2503589482,2503589482,0
1362082240,2503618336,1,52,52,1362082213641,1362082213641,2503591977,2503591977,0
1362082240,2503618460,1,46,46,1362082213519,1362082213519,2503591979,2503591979,0
1362082244,2503622576,3,138,46,1362082236059,1362082236123,2503614635,2503614699,64
1362082244,2503622592,3,138,46,1362082240972,1362082240972,2503619564,2503619564,0
1362082244,2503622592,3,138,46,1362082240972,1362082241036,2503619564,2503619628,64
1362082245,2503622684,3,138,46,1362082241876,1362082241940,2503619560,2503619624,64
1362082245,2503622684,3,138,46,1362082242008,1362082242008,2503619692,2503619692,0
1362082252,1141944708,139,190411,1369.863309,1362082187578,1362082246906,1141880286,1141939614,59328
1362082252,2503630192,2,152,76,1362082225753,1362082240729,2503603945,2503618921,14976
1362082253,2503630640,3,209,69.66666667,1362082247424,1362082247424,2503625064,2503625064,0
1362082253,2503630724,5,325,65,1362082247343,1362082247407,2503625067,2503625131,64
1362082253,2503630724,2,157,78.5,1362082247343,1362082247343,2503625067,2503625067,0
1362082256,2503634324,2,104,52,1362082231318,1362082241046,2503609642,2503619370,9728
1362082260,2503638160,2,104,52,1362082234170,1362082243834,2503612330,2503621994,9664
1362082260,2503638160,2,104,52,1362082234170,1362082243834,2503612330,2503621994,9664
1362082260,2503638280,2,104,52,1362082233794,1362082243714,2503612074,2503621994,9920
1362082266,1141958256,1,52,52,1362082241790,1362082241790,1141934046,1141934046,0
1362082268,2503646152,1,52,52,1362082241218,1362082241218,2503619370,2503619370,0
1362082268,2503646204,2,104,52,1362082243470,1362082243790,2503621674,2503621994,320
1362082268,2503646252,1,52,52,1362082241117,1362082241117,2503619369,2503619369,0
1362082268,2503646324,1,52,52,1362082243668,1362082243668,2503621992,2503621992,0
1362082270,1141962168,1,52,52,1362082242004,1362082242004,1141934172,1141934172,0
1362082274,1141966172,1,52,52,1362082247441,1362082247441,1141939613,1141939613,0
1362082280,2503658336,2,152,76,1362082255627,1362082270603,2503633963,2503648939,14976
1362082312,2503690548,2,152,76,1362082285428,1362082300404,2503663976,2503678952,14976
1362082340,2503718600,2,152,76,1362082315393,1362082330369,2503693993,2503708969,14976
1362082373,2503750616,2,152,76,1362082346392,1362082361368,2503724008,2503738984,14976
1362082373,2503751124,5,492,98.4,1362082359390,1362082368286,2503737514,2503746410,8896
1362082385,2503762620,12,13086,1090.5,1362082358869,1362082359253,2503736489,2503736873,384
1362082385,2503762648,3,346,115.3333333,1362082359415,1362082359479,2503737063,2503737127,64
1362082385,2503762656,4,1403,350.75,1362082359599,1362082359663,2503737255,2503737319,64
1362082385,2503762660,4,1262,315.5,1362082359724,1362082359788,2503737384,2503737448,64
1362082385,2503762808,4,1396,349,1362082359321,1362082359385,2503737129,2503737193,64
1362082385,2503762808,4,443,110.75,1362082359321,1362082359385,2503737129,2503737193,64
1362082385,2503762808,57,78485,1376.929825,1362082359321,1362082359385,2503737129,2503737193,64
1362082385,2503762808,4,377,94.25,1362082359576,1362082359640,2503737384,2503737448,64
1362082401,2503778708,2,152,76,1362082376251,1362082391291,2503753959,2503768999,15040
1362082417,2503794632,1,46,46,1362082389383,1362082389383,2503767015,2503767015,0
1362082433,2503810640,2,152,76,1362082406335,1362082421375,2503783975,2503799015,15040
1362082437,2503814620,2,104,52,1362082409236,1362082418836,2503786856,2503796456,9600
1362082437,2503814624,2,104,52,1362082409679,1362082419407,2503787303,2503797031,9728
1362082437,2503814624,2,104,52,1362082409806,1362082419406,2503787430,2503797030,9600
1362082437,2503814768,2,104,52,1362082409406,1362082419262,2503787174,2503797030,9856
1362082445,2503823132,2,104,52,1362082418642,1362082418898,2503796774,2503797030,256
1362082445,2503823136,1,52,52,1362082418894,1362082418894,2503797030,2503797030,0
1362082445,2503823284,2,104,52,1362082418617,1362082418745,2503796901,2503797029,128
1362082457,2503835072,1,78,78,1362082430797,1362082430797,2503808869,2503808869,0
1362082461,2503839304,2,152,76,1362082435687,1362082450663,2503813991,2503828967,14976
1362082493,2503871236,2,152,76,1362082465771,1362082480811,2503844007,2503859047,15040
1362082509,2503887076,13,11804,908,1362082481419,1362082481739,2503859495,2503859815,320
1362082513,2503891164,17,12725,748.5294118,1362082486769,1362082487089,2503864933,2503865253,320
1362082513,2503891172,18,12901,716.7222222,1362082487147,1362082487915,2503865319,2503866087,768
1362082514,1142206392,7,1374,196.2857143,1362082487476,1362082488116,1142179868,1142180508,640
1362082514,1142206408,90,123671,1374.122222,1362082488102,1362082488230,1142180510,1142180638,128
1362082537,2503915220,29,7609,262.3793103,1362082511352,1362082511992,2503889572,2503890212,640
1362082537,2503915224,1,52,52,1362082511479,1362082511479,2503889703,2503889703,0
1362082537,2503915228,14,3248,232,1362082511793,1362082511985,2503890021,2503890213,192
1362082537,2503915228,9,1152,128,1362082511792,1362082511920,2503890020,2503890148,128
1362082541,2503919608,6,1923,320.5,1362082516343,1362082516855,2503894951,2503895463,512
1362082545,2503923144,9,9803,1089.222222,1362082517125,1362082517125,2503895269,2503895269,0
1362082545,2503923160,32,40307,1259.59375,1362082517751,1362082518199,2503895911,2503896359,448
1362082545,2503923272,13,1549,119.1538462,1362082517063,1362082539847,2503895335,2503918119,22784
1362082549,2503927536,5,325,65,1362082546429,1362082546429,2503924965,2503924965,0
1362082549,2503927536,5,325,65,1362082546428,1362082546428,2503924964,2503924964,0
1362082569,2503947164,1,52,52,1362082541298,1362082541298,2503919462,2503919462,0
1362082573,2503951204,11,1141,103.7272727,1362082547083,1362082571083,2503925287,2503949287,24000
1362082573,2503951204,6,505,84.16666667,1362082547083,1362082571083,2503925287,2503949287,24000
1362082573,2503951464,172,236917,1377.424419,1362082516996,1362082570692,2503895460,2503949156,53696
1362082573,2503951468,203,280132,1379.960591,1362082516992,1362082570688,2503895460,2503949156,53696
1362082573,2503951468,10,603,60.3,1362082569090,1362082569346,2503947558,2503947814,256
1362082573,2503951472,126,173862,1379.857143,1362082517438,1362082570686,2503895910,2503949158,53248
1362082573,2503951512,3,138,46,1362082571093,1362082571157,2503949605,2503949669,64
1362082573,2503951552,133,182041,1368.729323,1362082516909,1362082570605,2503895461,2503949157,53696
1362082574,2503951600,3,138,46,1362082572007,1362082572007,2503949607,2503949607,0
1362082574,1142266412,1,52,52,1362082547042,1362082547042,1142239454,1142239454,0
1362082574,1142266460,1,52,52,1362082546995,1362082546995,1142239455,1142239455,0
1362082593,2503971488,2,104,52,1362082566958,1362082570798,2503945446,2503949286,3840
1362082597,2503975384,16,4969,310.5625,1362082570454,1362082573718,2503948838,2503952102,3264
1362082597,2503975584,1,52,52,1362082570254,1362082570254,2503948838,2503948838,0
1362082597,2503975584,1,52,52,1362082570573,1362082570573,2503949157,2503949157,0
1362082601,2503979416,6,1923,320.5,1362082573366,1362082573686,2503951782,2503952102,320
1362082601,2503979416,10,1216,121.6,1362082573428,1362082573556,2503951844,2503951972,128
1362082601,2503979564,14,11910,850.7142857,1362082573218,1362082573538,2503951782,2503952102,320
1362082601,2503979564,1,60,60,1362082573218,1362082573218,2503951782,2503951782,0
1362082601,2503979564,20,11515,575.75,1362082573218,1362082574114,2503951782,2503952678,896
1362082601,2503979564,7,718,102.5714286,1362082573281,1362082574817,2503951845,2503953381,1536
1362082630,2504007708,1,52,52,1362082604217,1362082604217,2503981925,2503981925,0
1362082638,2504015736,1,213,213,1362082611997,1362082611997,2503989733,2503989733,0
1362082638,2504015820,3,138,46,1362082633994,1362082633994,2504011814,2504011814,0
1362082638,2504015832,3,138,46,1362082631804,1362082631804,2504009636,2504009636,0
1362082638,2504015916,3,138,46,1362082631657,1362082631721,2504009573,2504009637,64
1362082661,2504039524,1,52,52,1362082633159,1362082633159,2504011683,2504011683,0
1362082662,2504039764,1,52,52,1362082633918,1362082633918,2504011682,2504011682,0
1362082670,2504047784,6,2076,346,1362082644395,1362082647979,2504022179,2504025763,3584
1362082710,2504087628,7,858,122.5714286,1362082685192,1362082685320,2504062820,2504062948,128
1362082710,2504087732,21,13258,631.3333333,1362082684768,1362082685088,2504062500,2504062820,320
1362082710,2504087808,7,858,122.5714286,1362082685010,1362082685138,2504062818,2504062946,128
1362082710,2504087808,18,12901,716.7222222,1362082685074,1362082685586,2504062882,2504063394,512
1362082710,2504087812,6,806,134.3333333,1362082685005,1362082685069,2504062817,2504062881,64
1362082710,2504087816,7,858,122.5714286,1362082685005,1362082685133,2504062821,2504062949,128
1362082710,1142402680,5,1270,254,1362082684696,1362082685144,1142377376,1142377824,448
1362082714,2504091648,1,213,213,1362082685876,1362082685876,2504063524,2504063524,0
1362082742,2504119684,7,2128,304,1362082714766,1362082721166,2504092450,2504098850,6400
1362082748,1142440820,109,149276,1369.504587,1362082684876,1362082743180,1142377696,1142436000,58304
1362082750,2504127968,3,209,69.66666667,1362082743476,1362082743476,2504121444,2504121444,0
1362082750,2504127968,5,325,65,1362082743476,1362082743540,2504121444,2504121508,64
1362082750,2504127968,5,325,65,1362082743476,1362082743540,2504121444,2504121508,64
1362082750,2504127968,5,325,65,1362082743539,1362082743539,2504121507,2504121507,0
1362082750,2504128048,5,325,65,1362082743394,1362082743458,2504121442,2504121506,64
1362082750,2504128048,5,325,65,1362082743458,1362082743458,2504121506,2504121506,0
1362082770,1142462920,1,52,52,1362082743079,1362082743079,1142435999,1142435999,0
1362082778,2504155840,1,52,52,1362082753778,1362082753778,2504131618,2504131618,0
1362082782,2504160004,2,273,136.5,1362082757008,1362082757072,2504135012,2504135076,64
1362082810,2504188132,6,2076,346,1362082784780,1362082793548,2504162912,2504171680,8768
1362082818,2504196116,18,10441,580.0555556,1362082792541,1362082792925,2504170657,2504171041,384
1362082818,2504196144,7,858,122.5714286,1362082792836,1362082792964,2504170980,2504171108,128
1362082818,2504196144,7,858,122.5714286,1362082792835,1362082793027,2504170979,2504171171,192
1362082818,2504196144,15,10692,712.8,1362082792835,1362082793283,2504170979,2504171427,448
1362082818,1142510908,4,884,221,1362082792628,1362082792948,1142485536,1142485856,320
1362082818,1142510960,31,41086,1325.354839,1362082792897,1362082792961,1142485857,1142485921,64
1362082854,2504232028,1,213,213,1362082828981,1362082828981,2504207009,2504207009,0
1362082854,2504232336,5,325,65,1362082852291,1362082852291,2504230627,2504230627,0
1362082854,2504232336,3,221,73.66666667,1362082852291,1362082852355,2504230627,2504230691,64
1362082854,2504232336,2,157,78.5,1362082852608,1362082852608,2504230944,2504230944,0
1362082854,2504232444,2,157,78.5,1362082852500,1362082852500,2504230944,2504230944,0
1362082878,1142571088,1,52,52,1362082852097,1362082852097,1142545185,1142545185,0
1362082878,1142571124,1,52,52,1362082852062,1362082852062,1142545186,1142545186,0
1362082882,2504260220,6,2076,346,1362082854965,1362082866293,2504233185,2504244513,11328
1362082890,2504268080,7,858,122.5714286,1362082865855,1362082865919,2504243935,2504243999,64
1362082890,2504268164,15,6575,438.3333333,1362082864557,1362082865773,2504242721,2504243937,1216
1362082890,1142583108,4,884,221,1362082865387,1362082865579,1142558495,1142558687,192
1362082891,1142583168,51,67911,1331.588235,1362082866328,1362082866520,1142558496,1142558688,192
1362082894,2504271944,10,4795,479.5,1362082865991,1362082866247,2504243935,2504244191,256
1362082898,2504276184,14,12176,869.7142857,1362082873496,1362082873816,2504251680,2504252000,320
1362082926,2504304300,6,2078,346.3333333,1362082901794,1362082925602,2504280094,2504303902,23808
1362082927,2504304704,5,325,65,1362082925047,1362082925047,2504302751,2504302751,0
1362082927,2504304784,5,325,65,1362082924904,1362082924968,2504302688,2504302752,64
1362082927,2504304784,5,325,65,1362082924903,1362082924967,2504302687,2504302751,64
1362082930,2504308344,2,104,52,1362082903480,1362082906616,2504281824,2504284960,3136
1362082950,1142643136,1,52,52,1362082924113,1362082924113,1142617249,1142617249,0
1362082950,1142643136,1,52,52,1362082924111,1362082924111,1142617247,1142617247,0
1362082963,1142655156,4,884,221,1362082938467,1362082938787,1142630623,1142630943,320
1362082963,1142655204,30,39316,1310.533333,1362082938420,1362082938484,1142630624,1142630688,64
1362082963,2504340788,15,6559,437.2666667,1362082938019,1362082938339,2504315807,2504316127,320
1362082963,2504340940,15,10692,712.8,1362082938125,1362082938573,2504316065,2504316513,448
1362082963,2504340940,7,858,122.5714286,1362082938125,1362082938253,2504316065,2504316193,128
1362082966,2504344580,1,213,213,1362082938187,1362082938187,2504316767,2504316767,0
1362082998,2504376576,6,2078,346.3333333,1362082973646,1362082995662,2504352222,2504374238,22016
1362082999,2504376828,5,325,65,1362082998012,1362082998012,2504375840,2504375840,0
1362082999,2504376828,5,325,65,1362082998012,1362082998012,2504375840,2504375840,0
1362082999,2504376916,5,325,65,1362082997924,1362082997924,2504375840,2504375840,0
1362083023,1142715244,1,52,52,1362082998091,1362082998091,1142690335,1142690335,0
1362083023,1142715248,1,52,52,1362082998090,1362082998090,1142690338,1142690338,0
1362083034,2504412516,17,6687,393.3529412,1362083009417,1362083009673,2504387933,2504388189,256
1362083034,2504412520,10,4827,482.7,1362083009669,1362083009989,2504388189,2504388509,320
1362083035,1142727168,4,884,221,1362083010585,1362083010841,1142702753,1142703009,256
1362083034,2504412636,7,858,122.5714286,1362083009553,1362083009681,2504388189,2504388317,128
1362083038,2504416548,1,213,213,1362083010283,1362083010283,2504388831,2504388831,0
1362083071,1142763200,18,22359,1242.166667,1362083046331,1362083046395,1142738531,1142738595,64
1362083071,2504448900,6,2078,346.3333333,1362083046515,1362083066675,2504424415,2504444575,20160
1362083071,2504449152,5,325,65,1362083069749,1362083069813,2504447901,2504447965,64
1362083071,2504449240,5,325,65,1362083069662,1362083069726,2504447902,2504447966,64
1362083071,2504449240,5,325,65,1362083069662,1362083069726,2504447902,2504447966,64
1362083076,1142768892,157,218070,1388.980892,1362083009861,1362083069573,1142702753,1142762465,59712
1362083095,1142787204,1,52,52,1362083070261,1362083070261,1142762465,1142762465,0
1362083107,1142799164,4,884,221,1362083082780,1362083083100,1142774944,1142775264,320
1362083107,2504484828,17,10373,610.1764706,1362083082169,1362083082553,2504459997,2504460381,384
1362083107,2504484856,15,10724,714.9333333,1362083082523,1362083082907,2504460379,2504460763,384
1362083107,2504484976,7,858,122.5714286,1362083082405,1362083082533,2504460381,2504460509,128
1362083111,2504488944,1,213,213,1362083083143,1362083083143,2504461087,2504461087,0
1362083119,2504497288,6,493,82.16666667,1362083117548,1362083117804,2504495836,2504496092,256
1362083119,2504497288,10,603,60.3,1362083117548,1362083117804,2504495836,2504496092,256
1362083131,1142823452,1,52,52,1362083106047,1362083106047,1142798499,1142798499,0
1362083135,2504513292,15,10152,676.8,1362083133993,1362083134249,2504512285,2504512541,256
1362083143,2504521248,41,12789,311.9268293,1362083117846,1362083140758,2504496094,2504519006,22912
1362083143,2504521348,1,52,52,1362083116592,1362083116592,2504494940,2504494940,0
1362083143,2504521456,7,465,66.42857143,1362083139142,1362083139270,2504517598,2504517726,128
1362083143,2504521476,7,465,66.42857143,1362083136239,1362083136367,2504514715,2504514843,128
1362083143,2504521516,5,325,65,1362083141450,1362083141514,2504519966,2504520030,64
1362083143,2504521516,5,325,65,1362083141447,1362083141511,2504519963,2504520027,64
1362083144,2504521608,5,325,65,1362083142420,1362083142420,2504520028,2504520028,0
1362083159,2504536820,32,18688,584,1362083132994,1362083137154,2504510814,2504514974,4160
1362083159,2504536824,18,3822,212.3333333,1362083133308,1362083136956,2504511132,2504514780,3648
1362083159,2504536984,12,10014,834.5,1362083134237,1362083134429,2504512221,2504512413,192
1362083163,2504540908,11,1288,117.0909091,1362083135400,1362083139752,2504513308,2504517660,4352
1362083167,1142859408,1,52,52,1362083142120,1362083142120,1142834528,1142834528,0
1362083175,2504553052,14,5226,373.2857143,1362083147799,1362083148503,2504525851,2504526555,704
1362083183,2504561388,3,138,46,1362083177738,1362083177802,2504556126,2504556190,64
1362083191,2504568884,1,52,52,1362083164417,1362083164417,2504542301,2504542301,0
1362083191,2504569296,3708,5281323,1424.305016,1362083177826,1362083190562,2504556122,2504568858,12736
1362083195,2504572960,7,858,122.5714286,1362083169586,1362083169714,2504547546,2504547674,128
1362083195,2504572964,7,858,122.5714286,1362083169582,1362083169710,2504547546,2504547674,128
1362083195,2504572964,7,858,122.5714286,1362083169585,1362083169713,2504547549,2504547677,128
1362083195,2504573100,7,858,122.5714286,1362083169446,1362083169574,2504547546,2504547674,128
1362083195,2504573104,11,1391,126.4545455,1362083169445,1362083169701,2504547549,2504547805,256
1362083195,2504573104,1,52,52,1362083169572,1362083169572,2504547676,2504547676,0
1362083199,2504577240,3,138,46,1362083192538,1362083192602,2504570778,2504570842,64
1362083207,2504585228,3837,5463695,1423.9497,1362083190696,1362083203816,2504568924,2504582044,13120
1362083207,2504585276,2,157,78.5,1362083201528,1362083201528,2504579804,2504579804,0
1362083207,2504585276,2,157,78.5,1362083201528,1362083201528,2504579804,2504579804,0
1362083207,2504585276,2,157,78.5,1362083201528,1362083201528,2504579804,2504579804,0
1362083207,2504585356,2,157,78.5,1362083201447,1362083201447,2504579803,2504579803,0
1362083207,2504585356,2,157,78.5,1362083201447,1362083201447,2504579803,2504579803,0
1362083215,2504593004,4,640,160,1362083189895,1362083189959,2504567899,2504567963,64
1362083215,2504593384,3,138,46,1362083207499,1362083207563,2504585883,2504585947,64
1362083255,2504633336,3,580,193.3333333,1362083228602,1362083228666,2504606938,2504607002,64
1362083280,2504657748,4,632,158,1362083269192,1362083279304,2504646940,2504657052,10112
1362083303,2504681444,1,46,46,1362083277711,1362083277711,2504656155,2504656155,0
1362083304,2504681636,1,46,46,1362083278518,1362083278518,2504656154,2504656154,0
1362083308,2504685604,15,5337,355.8,1362083280982,1362083281750,2504658586,2504659354,768
1362083436,2504813776,17,2068,121.6470588,1362083409894,1362083415782,2504787670,2504793558,5888
1362083436,2504813780,1,46,46,1362083409890,1362083409890,2504787670,2504787670,0
1362083436,2504813900,11,1393,126.6363636,1362083409963,1362083410091,2504787863,2504787991,128
1362083468,2504845920,1,46,46,1362083440600,1362083440600,2504818520,2504818520,0
1362083468,2504845920,1,46,46,1362083440599,1362083440599,2504818519,2504818519,0
1362083468,2504846040,12,1501,125.0833333,1362083440479,1362083440671,2504818519,2504818711,192
1362083520,2504898328,25,28851,1154.04,1362083504320,1362083514944,2504882648,2504893272,10624
1362083528,2504906236,11,1394,126.7272727,1362083502042,1362083502170,2504880278,2504880406,128
1362083528,2504906260,1,46,46,1362083502020,1362083502020,2504880280,2504880280,0
1362083532,2504910040,7,6199,885.5714286,1362083506206,1362083531294,2504884246,2504909334,25088
1362083536,2504914484,3,138,46,1362083533218,1362083533282,2504911702,2504911766,64
1362083560,2504938256,1,52,52,1362083534343,1362083534343,2504912599,2504912599,0
1362083560,2504938376,1,52,52,1362083534286,1362083534286,2504912662,2504912662,0
1362083632,2505010244,1,52,52,1362083607569,1362083607569,2504985813,2504985813,0
1362083676,2505054264,15,5337,355.8,1362083648189,1362083648445,2505026453,2505026709,256
1362083889,2505267528,3,189,63,1362083881714,1362083884722,2505260242,2505263250,3008
1362083906,2505283960,2,126,63,1362083889321,1362083897385,2505267281,2505275345,8064
1362083909,2505287508,1,46,46,1362083882245,1362083882245,2505260753,2505260753,0
1362085781,1145473264,2,98,49,1362085775437,1362085775693,1145467701,1145467957,256
1362085781,1145473264,2,98,49,1362085775437,1362085775693,1145467701,1145467957,256
1362085781,1145473264,2,98,49,1362085775437,1362085775693,1145467701,1145467957,256
1362085781,1145473264,2,98,49,1362085775501,1362085775693,1145467765,1145467957,192
1362085781,1145473264,2,98,49,1362085775500,1362085775692,1145467764,1145467956,192
1362085781,1145473264,2,98,49,1362085775436,1362085775692,1145467700,1145467956,256
1362085781,1145473264,2,98,49,1362085775436,1362085775692,1145467700,1145467956,256
1362085781,1145473264,2,98,49,1362085775500,1362085775692,1145467764,1145467956,192
1362085781,1145473268,5,2064,412.8,1362085777032,1362085777544,1145469300,1145469812,512
1362085781,1145473272,2,98,49,1362085775429,1362085775685,1145467701,1145467957,256
1362085781,1145473272,2,98,49,1362085775493,1362085775685,1145467765,1145467957,192
1362085781,1145473272,2,98,49,1362085775493,1362085775685,1145467765,1145467957,192
1362085781,1145473272,2,98,49,1362085775493,1362085775685,1145467765,1145467957,192
1362085781,1145473272,2,98,49,1362085775493,1362085775685,1145467765,1145467957,192
1362085781,1145473296,6,3696,616,1362085776107,1362085777515,1145468403,1145469811,1408
1362085781,1145473296,40,53810,1345.25,1362085776745,1362085777513,1145469041,1145469809,768
1362085781,1145473300,5,409,81.8,1362085780326,1362085780390,1145472626,1145472690,64
1362085781,2507159528,8,2637,329.625,1362085774614,1362085774870,2507153142,2507153398,256
1362085781,2507159528,7,2511,358.7142857,1362085774678,1362085774934,2507153206,2507153462,256
1362085781,2507159528,2,98,49,1362085774614,1362085774934,2507153142,2507153462,320
1362085781,2507159528,7,2511,358.7142857,1362085774678,1362085774934,2507153206,2507153462,256
1362085781,2507159528,5,2788,557.6,1362085774677,1362085774869,2507153205,2507153397,192
1362085781,2507159532,4,632,158,1362085775888,1362085776720,2507154420,2507155252,832
1362085782,2507159736,7,2511,358.7142857,1362085775468,1362085775724,2507153204,2507153460,256
1362085782,2507159736,5,2158,431.6,1362085775404,1362085775916,2507153140,2507153652,512
1362085782,2507159736,5,2158,431.6,1362085775468,1362085775852,2507153204,2507153588,384
1362085782,2507159736,7,2511,358.7142857,1362085775468,1362085775724,2507153204,2507153460,256
1362085782,2507159736,5,2172,434.4,1362085775468,1362085775724,2507153204,2507153460,256
1362085782,2507159760,30,31701,1056.7,1362085776212,1362085777492,2507153972,2507155252,1280
1362085782,2507159760,2,98,49,1362085776275,1362085777491,2507154035,2507155251,1216
1362085790,2507168000,5,759,151.8,1362085788389,1362085788517,2507166389,2507166517,128
1362085791,2507168932,1,48,48,1362085764136,1362085764136,2507142068,2507142068,0
1362085797,2507175564,4,1648,412,1362085793202,1362085793266,2507171766,2507171830,64
1362085798,2507175608,11,5698,518,1362085780524,1362085796012,2507158132,2507173620,15488
1362085798,2507176020,5,759,151.8,1362085790608,1362085790800,2507168628,2507168820,192
1362085802,2507180092,3,228,76,1362085776265,1362085783817,2507154357,2507161909,7552
1362085802,2507180136,2,213,106.5,1362085777246,1362085777438,2507155382,2507155574,192
1362085802,2507180136,3,324,108,1362085777373,1362085778653,2507155509,2507156789,1280
1362085802,2507180136,1,137,137,1362085777309,1362085777309,2507155445,2507155445,0
1362085806,2507183884,29,25981,895.8965517,1362085777879,1362085779991,2507155763,2507157875,2112
1362085806,2507184004,7,5345,763.5714286,1362085777697,1362085801121,2507155701,2507179125,23424
1362085806,2507184088,2,98,49,1362085780043,1362085780235,2507158131,2507158323,192
1362085810,2507188032,57,72944,1279.719298,1362085784837,1362085784965,2507162869,2507162997,128
1362085813,2507191576,4,372,93,1362085793316,1362085808484,2507171892,2507187060,15168
1362085814,2507191936,4,863,215.75,1362085786917,1362085791397,2507164853,2507169333,4480
1362085814,2507191976,11,3180,289.0909091,1362085788411,1362085789435,2507166387,2507167411,1024
1362085814,1145507112,25,27958,1118.32,1362085786362,1362085787514,1145479474,1145480626,1152
1362085815,1145507160,43,52095,1211.511628,1362085789044,1362085809716,1145481204,1145501876,20672
1362085815,1145507184,40,50234,1255.85,1362085787932,1362085789340,1145480116,1145481524,1408
1362085818,2507195816,5,3113,622.6,1362085791131,1362085791579,2507168947,2507169395,448
1362085818,2507195940,75,95694,1275.92,1362085790686,1362085806686,2507168626,2507184626,16000
1362085818,2507196028,3,513,171,1362085792970,1362085793034,2507170998,2507171062,64
1362085830,2507207676,6,622,103.6666667,1362085818281,1362085821929,2507195957,2507199605,3648
1362085838,2507215708,4,1648,412,1362085831049,1362085831177,2507208757,2507208885,128
1362085838,2507216048,1,953,953,1362085810036,1362085810036,2507188084,2507188084,0
1362085843,1145535256,10,2231,223.1,1362085818131,1362085818515,1145510387,1145510771,384
1362085846,2507224160,4,349,87.25,1362085819140,1362085819204,2507197300,2507197364,64
1362085850,2507227960,1,52,52,1362085824907,1362085824907,2507202867,2507202867,0
1362085850,2507228088,2,265,132.5,1362085825293,1362085825357,2507203381,2507203445,64
1362085854,2507231904,4,366,91.5,1362085830981,1362085846085,2507208885,2507223989,15104
1362085858,2507235944,1,52,52,1362085830107,1362085830107,2507208051,2507208051,0
1362085859,1145551180,1,52,52,1362085833184,1362085833184,1145525364,1145525364,0
1362085859,1145551188,1,52,52,1362085834328,1362085834328,1145526516,1145526516,0
1362085862,2507240204,1,46,46,1362085836185,1362085836185,2507214389,2507214389,0
1362085862,2507240204,1,46,46,1362085836248,1362085836248,2507214452,2507214452,0
1362085866,2507244168,1,52,52,1362085837946,1362085837946,2507216114,2507216114,0
1362085870,2507247804,4,1648,412,1362085868009,1362085868073,2507245813,2507245877,64
1362085878,2507256188,38,48783,1283.763158,1362085851496,1362085867752,2507229684,2507245940,16256
1362085879,1145571184,22,25754,1170.636364,1362085854748,1362085869276,1145546932,1145561460,14528
1362085882,2507260020,4,2249,562.25,1362085855120,1362085869200,2507233140,2507247220,14080
1362085886,2507263756,4,366,91.5,1362085868120,1362085883224,2507245876,2507260980,15104
1362085890,2507268152,1,52,52,1362085864205,1362085864205,2507242357,2507242357,0
1362085898,2507276144,1,52,52,1362085869781,1362085869781,2507247925,2507247925,0
1362085902,2507280328,1,52,52,1362085874779,1362085874779,2507253107,2507253107,0
1362085906,2507284380,2,265,132.5,1362085880935,1362085880999,2507259315,2507259379,64
1362085907,1145599156,1,52,52,1362085879354,1362085879354,1145571510,1145571510,0
1362085910,2507287724,4,1650,412.5,1362085905142,1362085905206,2507282866,2507282930,64
1362085910,2507288288,1,52,52,1362085882818,1362085882818,2507261106,2507261106,0
1362085926,2507303836,4,366,91.5,1362085905096,1362085920200,2507282932,2507298036,15104
1362085934,2507311820,2,98,49,1362085914456,1362085928920,2507292276,2507306740,14464
1362085934,2507312392,1,52,52,1362085908956,1362085908956,2507287348,2507287348,0
1362085938,2507316256,1,46,46,1362085912673,1362085912673,2507290929,2507290929,0
1362085942,2507320208,1,52,52,1362085914771,1362085914771,2507292979,2507292979,0
1362085946,2507324336,1,52,52,1362085919761,1362085919761,2507298097,2507298097,0
1362085950,2507327844,4,1650,412.5,1362085942079,1362085942143,2507319923,2507319987,64
1362085951,1145643168,1,52,52,1362085924397,1362085924397,1145616565,1145616565,0
1362085951,1145643468,1,52,52,1362085922945,1362085922945,1145615413,1145615413,0
1362085954,2507332236,1,52,52,1362085927864,1362085927864,2507306100,2507306100,0
1362085954,2507332304,1,46,46,1362085926130,1362085926130,2507304434,2507304434,0
1362085954,2507332304,1,46,46,1362085926256,1362085926256,2507304560,2507304560,0
1362085958,2507335936,4,366,91.5,1362085942113,1362085957153,2507320049,2507335089,15040
1362085962,2507340340,2,265,132.5,1362085936781,1362085936909,2507315121,2507315249,128
1362085962,2507340372,1,46,46,1362085937455,1362085937455,2507315827,2507315827,0
1362085982,2507359856,4,1650,412.5,1362085979122,1362085979186,2507356978,2507357042,64
1362085982,2507360380,1,52,52,1362085954022,1362085954022,2507332402,2507332402,0
1362085982,2507360380,1,46,46,1362085957605,1362085957605,2507335985,2507335985,0
1362085986,2507364328,1,52,52,1362085959643,1362085959643,2507337971,2507337971,0
1362085986,2507364328,12,5978,498.1666667,1362085959833,1362085960345,2507338161,2507338673,512
1362085987,1145679216,1,52,52,1362085959292,1362085959292,1145651508,1145651508,0
1362085990,2507368344,1,52,52,1362085964808,1362085964808,2507343152,2507343152,0
1362085995,1145687220,1,52,52,1362085968184,1362085968184,1145660404,1145660404,0
1362085995,1145687284,1,52,52,1362085969272,1362085969272,1145661556,1145661556,0
1362085998,2507375964,4,366,91.5,1362085979076,1362085994180,2507357040,2507372144,15104
1362085998,2507376332,1,46,46,1362085971158,1362085971158,2507349490,2507349490,0
1362085998,2507376380,1,52,52,1362085972775,1362085972775,2507351155,2507351155,0
1362085998,2507376452,1,46,46,1362085971167,1362085971167,2507349619,2507349619,0
1362086018,2507396516,2,265,132.5,1362085992669,1362085992733,2507371185,2507371249,64
1362086022,2507399904,2,123,61.5,1362086020802,1362086020802,2507398706,2507398706,0
1362086022,2507399948,4,1650,412.5,1362086016087,1362086016151,2507394035,2507394099,64
1362086022,2507399980,5,326,65.2,1362086005047,1362086019959,2507383027,2507397939,14912
1362086026,2507404488,1,52,52,1362085998907,1362085998907,2507377395,2507377395,0
1362086030,2507407888,5,326,65.2,1362086010259,1362086025107,2507388147,2507402995,14848
1362086030,2507408504,1,46,46,1362086002536,1362086002536,2507381040,2507381040,0
1362086031,1145723460,1,52,52,1362086004170,1362086004170,1145696630,1145696630,0
1362086038,2507415896,2,98,49,1362086018313,1362086033161,2507396209,2507411057,14848
1362086038,2507415928,4,366,91.5,1362086016168,1362086031272,2507394096,2507409200,15104
1362086039,1145731404,1,52,52,1362086012995,1362086012995,1145705399,1145705399,0
1362086039,1145731476,1,52,52,1362086014071,1362086014071,1145706547,1145706547,0
1362086042,2507420408,1,46,46,1362086016137,1362086016137,2507394545,2507394545,0
1362086042,2507420528,1,46,46,1362086016145,1362086016145,2507394673,2507394673,0
1362086050,2507428472,35,26777,765.0571429,1362086025415,1362086025735,2507403887,2507404207,320
1362086054,2507432032,4,1650,412.5,1362086053058,1362086053122,2507431090,2507431154,64
1362086062,2507439928,5,326,65.2,1362086044520,1362086059432,2507422448,2507437360,14912
1362086062,2507440468,1,46,46,1362086037326,1362086037326,2507415794,2507415794,0
1362086070,2507448024,4,366,91.5,1362086053127,1362086068231,2507431151,2507446255,15104
1362086074,2507452444,1,46,46,1362086047653,1362086047653,2507426097,2507426097,0
1362086075,2507452916,2,265,132.5,1362086049204,1362086049268,2507427120,2507427184,64
1362086075,1145767488,1,52,52,1362086049132,1362086049132,1145741620,1145741620,0
1362086083,1145775436,2,98,49,1362086058016,1362086078368,1145750452,1145770804,20352
1362086085,1145777336,3,144,48,1362086059269,1362086078853,1145751605,1145771189,19584
1362086086,2507463940,2,98,49,1362086071325,1362086078301,2507449265,2507456241,6976
1362086086,2507464008,2,92,46,1362086078298,1362086078298,2507456306,2507456306,0
1362086086,2507464096,3,138,46,1362086061440,1362086078208,2507439536,2507456304,16768
1362086086,2507464276,3,138,46,1362086061389,1362086078029,2507439665,2507456305,16640
1362086086,2507464408,3,1312,437.3333333,1362086061385,1362086061449,2507439793,2507439857,64
1362086086,2507464412,24,32202,1341.75,1362086061510,1362086061574,2507439922,2507439986,64
1362086086,2507464528,7,8475,1210.714286,1362086061394,1362086061458,2507439922,2507439986,64
1362086087,2507464616,3,1173,391,1362086062049,1362086062177,2507439665,2507439793,128
1362086087,2507464616,6,2624,437.3333333,1362086062049,1362086062369,2507439665,2507439985,320
1362086094,2507472080,4,1650,412.5,1362086090064,1362086090128,2507468144,2507468208,64
1362086102,2507480424,1,76,76,1362086077686,1362086077686,2507456110,2507456110,0
1362086103,1145795504,1,46,46,1362086078299,1362086078299,1145770803,1145770803,0
1362086106,2507484536,1,76,76,1362086079048,1362086079048,2507457584,2507457584,0
1362086106,2507484544,1,137,137,1362086079425,1362086079425,2507457969,2507457969,0
1362086107,2507484628,8,871,108.875,1362086078868,1362086079060,2507456496,2507456688,192
1362086107,2507484668,1,137,137,1362086080301,1362086080301,2507457969,2507457969,0
1362086110,2507487920,4,366,91.5,1362086090352,1362086105456,2507468272,2507483376,15104
1362086131,2507508660,2,265,132.5,1362086104690,1362086104754,2507482350,2507482414,64
1362086134,2507511940,4,1650,412.5,1362086127261,1362086127325,2507505201,2507505265,64
1362086142,2507520560,1,137,137,1362086115824,1362086115824,2507494384,2507494384,0
1362086150,2507527956,4,372,93,1362086127307,1362086142411,2507505263,2507520367,15104
1362086150,2507528556,1,52,52,1362086123188,1362086123188,2507501744,2507501744,0
1362086163,2507540652,3,871,290.3333333,1362086135673,1362086135673,2507513325,2507513325,0
1362086166,2507544108,4,1650,412.5,1362086164147,1362086164211,2507542255,2507542319,64
1362086166,2507544580,4,2126,531.5,1362086138781,1362086138845,2507517361,2507517425,64
1362086182,2507560108,4,372,93,1362086164212,1362086179316,2507542320,2507557424,15104
1362086183,2507560772,30,32253,1075.1,1362086158085,1362086169285,2507535857,2507547057,11200
1362086183,2507560816,1,137,137,1362086157080,1362086157080,2507534896,2507534896,0
1362086187,2507564628,2,265,132.5,1362086159957,1362086160021,2507537585,2507537649,64
1362086187,1145879832,3,1058,352.6666667,1362086160855,1362086160855,1145853687,1145853687,0
1362086187,1145879848,12,12926,1077.166667,1362086161860,1362086162116,1145854708,1145854964,256
1362086191,2507568716,4,2180,545,1362086162941,1362086163133,2507540657,2507540849,192
1362086195,2507572656,1,52,52,1362086169078,1362086169078,2507546734,2507546734,0
1362086195,2507572800,3,2304,768,1362086169062,1362086169190,2507546862,2507546990,128
1362086206,2507584044,4,1650,412.5,1362086201204,1362086201332,2507579248,2507579376,128
1362086207,2507584664,1,52,52,1362086180719,1362086180719,2507558383,2507558383,0
1362086211,2507588828,1,52,52,1362086184586,1362086184586,2507562414,2507562414,0
1362086222,2507600052,4,366,91.5,1362086201322,1362086216426,2507579374,2507594478,15104
1362086223,2507600728,1,137,137,1362086197935,1362086197935,2507575663,2507575663,0
1362086230,2507608128,2,98,49,1362086207582,1362086221918,2507585710,2507600046,14336
1362086231,1145923744,1,52,52,1362086205936,1362086205936,1145898680,1145898680,0
1362086235,1145927712,1,52,52,1362086207247,1362086207247,1145899959,1145899959,0
1362086239,2507616808,1,52,52,1362086213980,1362086213980,2507591788,2507591788,0
1362086239,2507616836,1,46,46,1362086214147,1362086214147,2507591983,2507591983,0
1362086239,2507616840,1,46,46,1362086214271,1362086214271,2507592111,2507592111,0
1362086243,2507620852,2,265,132.5,1362086215667,1362086215795,2507593519,2507593647,128
1362086246,2507624036,4,1650,412.5,1362086238266,1362086238650,2507616302,2507616686,384
1362086251,2507628788,1,52,52,1362086225586,1362086225586,2507603374,2507603374,0
1362086254,2507632056,4,366,91.5,1362086238374,1362086253478,2507616430,2507631534,15104
1362086255,2507632904,1,52,52,1362086229565,1362086229565,2507607469,2507607469,0
1362086259,2507636720,1,46,46,1362086231350,1362086231350,2507609070,2507609070,0
1362086263,2507641044,1,137,137,1362086235826,1362086235826,2507613870,2507613870,0
1362086278,2507656184,4,1650,412.5,1362086275237,1362086275301,2507653421,2507653485,64
1362086279,1145971756,1,52,52,1362086252259,1362086252259,1145945015,1145945015,0
1362086279,1145971780,1,52,52,1362086250891,1362086250891,1145943671,1145943671,0
1362086287,2507664896,1,52,52,1362086258950,1362086258950,2507636846,2507636846,0
1362086287,2507664900,1,46,46,1362086259136,1362086259136,2507637036,2507637036,0
1362086287,2507664904,1,46,46,1362086259263,1362086259263,2507637167,2507637167,0
1362086294,2507672188,4,372,93,1362086275299,1362086290403,2507653487,2507668591,15104
1362086295,2507672932,2,265,132.5,1362086270754,1362086270818,2507648686,2507648750,64
1362086295,2507673040,1,52,52,1362086270389,1362086270389,2507648429,2507648429,0
1362086299,2507677004,1,52,52,1362086274459,1362086274459,2507652463,2507652463,0
1362086299,2507677004,1,137,137,1362086274394,1362086274394,2507652398,2507652398,0
1362086318,2507696240,4,1650,412.5,1362086312174,1362086312238,2507690414,2507690478,64
1362086323,1146015816,1,52,52,1362086295912,1362086295912,1145988728,1145988728,0
1362086323,1146015832,1,52,52,1362086297174,1362086297174,1145990006,1145990006,0
1362086326,2507704148,5,326,65.2,1362086303687,1362086318599,2507681835,2507696747,14912
1362086331,2507709016,1,46,46,1362086304076,1362086304076,2507682092,2507682092,0
1362086331,2507709020,1,46,46,1362086304202,1362086304202,2507682222,2507682222,0
1362086334,2507712232,4,366,91.5,1362086312308,1362086327412,2507690540,2507705644,15104
1362086335,2507713052,1,137,137,1362086309096,1362086309096,2507687148,2507687148,0
1362086343,2507721132,1,52,52,1362086315287,1362086315287,2507693419,2507693419,0
1362086347,2507725100,1,52,52,1362086319417,1362086319417,2507697517,2507697517,0
1362086350,2507728168,4,1650,412.5,1362086349301,1362086349365,2507727469,2507727533,64
1362086351,2507729012,2,265,132.5,1362086326481,1362086326545,2507704493,2507704557,64
1362086359,2507737188,2,638,319,1362086331617,1362086331681,2507709805,2507709869,64
1362086366,2507744208,4,366,91.5,1362086349387,1362086364491,2507727595,2507742699,15104
1362086367,1146059940,1,52,52,1362086342061,1362086342061,1146035001,1146035001,0
1362086367,1146059960,1,52,52,1362086340759,1362086340759,1146033719,1146033719,0
1362086371,2507749020,1,137,137,1362086343879,1362086343879,2507721899,2507721899,0
1362086375,2507753112,1,46,46,1362086349038,1362086349038,2507727150,2507727150,0
1362086382,2507760128,3,144,48,1362086360348,1362086375260,2507738476,2507753388,14912
1362086382,2507760232,2,98,49,1362086364275,1362086379187,2507742507,2507757419,14912
1362086389,1146081432,2,98,49,1362086386280,1362086388392,1146078712,1146080824,2112
1362086389,1146081432,2,98,49,1362086387558,1362086388390,1146079990,1146080822,832
1362086390,2507768184,2,92,46,1362086388131,1362086388131,2507766315,2507766315,0
1362086390,2507768224,4,1650,412.5,1362086386299,1362086386363,2507764523,2507764587,64
1362086390,2507768264,3,138,46,1362086376659,1362086388051,2507754923,2507766315,11392
1362086403,2507781164,1,137,137,1362086375609,1362086375609,2507753773,2507753773,0
1362086406,2507784176,4,366,91.5,1362086386477,1362086401581,2507764653,2507779757,15104
1362086407,2507785364,2,265,132.5,1362086381360,1362086381488,2507759724,2507759852,128
1362086411,2507789112,1,46,46,1362086385260,1362086385260,2507763372,2507763372,0
1362086415,2507793272,9,2895,321.6666667,1362086388045,1362086388173,2507766317,2507766445,128
1362086430,2507808180,4,1650,412.5,1362086423401,1362086423465,2507801581,2507801645,64
1362086439,2507817200,1,137,137,1362086414418,1362086414418,2507792618,2507792618,0
1362086446,2507824268,4,366,91.5,1362086423374,1362086438478,2507801642,2507816746,15104
1362086458,2507835852,1,46,46,1362086428334,1362086428334,2507806186,2507806186,0
1362086459,2507837336,1,52,52,1362086433099,1362086433099,2507811435,2507811435,0
1362086462,2507840196,4,1650,412.5,1362086460438,1362086460502,2507838634,2507838698,64
1362086463,2507841264,2,265,132.5,1362086436628,1362086436692,2507814892,2507814956,64
1362086478,2507856216,4,366,91.5,1362086460483,1362086475587,2507838699,2507853803,15104
1362086483,2507861236,1,137,137,1362086455086,1362086455086,2507833322,2507833322,0
1362086502,2507880232,4,1650,412.5,1362086497460,1362086497524,2507875692,2507875756,64
1362086503,2507881244,1,52,52,1362086478245,1362086478245,2507856489,2507856489,0
1362086515,2507893500,1,137,137,1362086490088,1362086490088,2507868588,2507868588,0
1362086518,2507896248,4,372,93,1362086497505,1362086512609,2507875753,2507890857,15104
1362086519,2507897280,2,265,132.5,1362086492482,1362086492610,2507870762,2507870890,128
1362086542,2507920280,4,1650,412.5,1362086534464,1362086534528,2507912744,2507912808,64
1362086547,2507925384,1,137,137,1362086521624,1362086521624,2507900008,2507900008,0
1362086550,2507928220,4,366,91.5,1362086534589,1362086549693,2507912809,2507927913,15104
1362086551,2507929428,1,52,52,1362086523117,1362086523117,2507901545,2507901545,0
1362086574,2507952220,4,1650,412.5,1362086571581,1362086571645,2507949801,2507949865,64
1362086575,2507953484,2,265,132.5,1362086547830,1362086547894,2507926314,2507926378,64
1362086583,2507961444,1,137,137,1362086554846,1362086554846,2507933290,2507933290,0
1362086590,2507968324,4,366,91.5,1362086571542,1362086586646,2507949866,2507964970,15104
1362086595,2507973464,1,52,52,1362086568072,1362086568072,2507946536,2507946536,0
1362086614,2507992356,4,1650,412.5,1362086608502,1362086608566,2507986858,2507986922,64
1362086619,2507997440,1,137,137,1362086593633,1362086593633,2507972073,2507972073,0
1362086630,2508008260,4,366,91.5,1362086608659,1362086623763,2507986919,2508002023,15104
1362086630,2508008356,5,326,65.2,1362086613236,1362086628148,2507991592,2508006504,14912
1362086631,2508009356,2,265,132.5,1362086603510,1362086603574,2507981866,2507981930,64
1362086646,2508024556,4,1650,412.5,1362086645356,1362086645420,2508023912,2508023976,64
1362086651,2508029544,1,137,137,1362086624889,1362086624889,2508003433,2508003433,0
1362086663,2508040672,4,366,91.5,1362086646305,1362086661409,2508023977,2508039081,15104
1362086671,2508049496,42,50093,1192.690476,1362086646694,1362086654054,2508025190,2508032550,7360
1362086675,2508053548,6,4401,733.5,1362086647028,1362086652852,2508025576,2508031400,5824
1362086676,1146368424,4,614,153.5,1362086648559,1362086648815,1146340983,1146341239,256
1362086680,1146372440,3,1058,352.6666667,1362086655008,1362086655008,1146347448,1146347448,0
1362086683,2508061488,2,265,132.5,1362086658608,1362086658672,2508037096,2508037160,64
1362086683,2508061560,4,2548,637,1362086656743,1362086656935,2508035303,2508035495,192
1362086684,1146376452,12,12926,1077.166667,1362086656981,1362086657173,1146349433,1146349625,192
1362086686,2508064580,4,1650,412.5,1362086682324,1362086682452,2508060904,2508061032,128
1362086696,2508073588,1,137,137,1362086669172,1362086669172,2508046760,2508046760,0
1362086703,2508080600,4,366,91.5,1362086683430,1362086698534,2508061030,2508076134,15104
1362086703,2508080628,3,138,46,1362086699980,1362086701644,2508077608,2508079272,1664
1362086703,2508080676,3,138,46,1362086698780,1362086701596,2508076456,2508079272,2816
1362086709,1146401552,2,98,49,1362086699890,1362086701298,1146392442,1146393850,1408
1362086727,2508104656,4,1650,412.5,1362086720302,1362086720366,2508097958,2508098022,64
1362086727,2508105544,1,46,46,1362086700728,1362086700728,2508079272,2508079272,0
1362086727,2508105556,9,2895,321.6666667,1362086701739,1362086701867,2508080295,2508080423,128
1362086728,1146420488,1,46,46,1362086701361,1362086701361,1146393849,1146393849,0
1362086728,1146420488,1,46,46,1362086701361,1362086701361,1146393849,1146393849,0
1362086739,2508117492,1,137,137,1362086711339,1362086711339,2508089831,2508089831,0
1362086739,2508117576,2,265,132.5,1362086714008,1362086714136,2508092584,2508092712,128
1362086743,2508120636,4,366,91.5,1362086720450,1362086735554,2508098086,2508113190,15104
1362086759,2508136604,4,1650,412.5,1362086757410,1362086757474,2508135014,2508135078,64
1362086772,2508149824,1,52,52,1362086747654,1362086747654,2508125478,2508125478,0
1362086775,2508152608,4,366,91.5,1362086757532,1362086772572,2508135140,2508150180,15040
1362086776,2508153740,1,137,137,1362086748185,1362086748185,2508125925,2508125925,0
1362086796,2508173784,2,265,132.5,1362086770031,1362086770095,2508147815,2508147879,64
1362086799,2508176720,4,1650,412.5,1362086794349,1362086794413,2508172069,2508172133,64
1362086812,2508189976,1,137,137,1362086785645,1362086785645,2508163621,2508163621,0
1362086815,2508192620,4,366,91.5,1362086794515,1362086809619,2508172135,2508187239,15104
1362086820,2508197820,1,52,52,1362086792649,1362086792649,2508170469,2508170469,0
1362086839,2508216624,4,1650,412.5,1362086831503,1362086831567,2508209127,2508209191,64
1362086840,2508217992,15,15411,1027.4,1362086815516,1362086816092,2508193508,2508194084,576
1362086844,2508221952,3,2128,709.3333333,1362086815814,1362086815878,2508193766,2508193830,64
1362086847,2508224784,4,372,93,1362086831469,1362086846573,2508209253,2508224357,15104
1362086852,2508229976,2,265,132.5,1362086825581,1362086825645,2508203557,2508203621,64
1362086856,2508233912,1,137,137,1362086829868,1362086829868,2508207780,2508207780,0
1362086871,2508248728,4,1650,412.5,1362086868452,1362086868516,2508246180,2508246244,64
1362086887,2508264724,4,366,91.5,1362086868582,1362086883622,2508246306,2508261346,15040
1362086888,2508265896,1,46,46,1362086860988,1362086860988,2508238884,2508238884,0
1362086888,2508266024,1,46,46,1362086861116,1362086861116,2508239140,2508239140,0
1362086896,2508273964,1,137,137,1362086870009,1362086870009,2508247973,2508247973,0
1362086908,2508285900,2,265,132.5,1362086881078,1362086881142,2508258978,2508259042,64
1362086908,2508286060,1,52,52,1362086882454,1362086882454,2508260514,2508260514,0
1362086911,2508288772,4,1650,412.5,1362086905464,1362086905528,2508283236,2508283300,64
1362086927,2508304708,4,366,91.5,1362086905592,1362086920696,2508283300,2508298404,15104
1362086932,2508310176,1,46,46,1362086905956,1362086905956,2508284132,2508284132,0
1362086932,2508310284,1,46,46,1362086905655,1362086905655,2508283939,2508283939,0
1362086932,2508310320,1,137,137,1362086906834,1362086906834,2508285154,2508285154,0
1362086943,2508320724,5,326,65.2,1362086927849,1362086942761,2508305573,2508320485,14912
1362086943,2508320760,4,1650,412.5,1362086942533,1362086942597,2508320293,2508320357,64
1362086959,2508336784,4,366,91.5,1362086942572,1362086957676,2508320356,2508335460,15104
1362086964,2508342252,2,265,132.5,1362086936661,1362086936725,2508314913,2508314977,64
1362086968,2508346464,1,137,137,1362086940290,1362086940290,2508318754,2508318754,0
1362086976,2508354288,1,46,46,1362086950898,1362086950898,2508329186,2508329186,0
1362086976,2508354364,1,46,46,1362086950630,1362086950630,2508328994,2508328994,0
1362086983,2508360832,4,1650,412.5,1362086979515,1362086979579,2508357347,2508357411,64
1362086999,2508376804,4,372,93,1362086979670,1362086994710,2508357474,2508372514,15040
1362087008,2508386400,1,137,137,1362086982273,1362086982273,2508360673,2508360673,0
1362087015,2508392760,3,138,46,1362086996481,1362087011521,2508374241,2508389281,15040
1362087015,2508392928,3,138,46,1362086996124,1362087011356,2508374052,2508389284,15232
1362087020,2508398452,2,265,132.5,1362086992462,1362086992526,2508370914,2508370978,64
1362087023,2508400768,4,1650,412.5,1362087016634,1362087016698,2508394402,2508394466,64
1362087036,2508414492,9,2895,321.6666667,1362087010855,1362087010919,2508389347,2508389411,64
1362087039,2508416924,4,366,91.5,1362087016540,1362087031644,2508394464,2508409568,15104
1362087048,2508426312,1,137,137,1362087019865,1362087019865,2508398177,2508398177,0
1362087055,2508432964,4,1650,412.5,1362087053494,1362087053558,2508431458,2508431522,64
1362087071,2508448908,4,366,91.5,1362087053615,1362087068719,2508431523,2508446627,15104
1362087077,2508454644,2,265,132.5,1362087048886,1362087048950,2508426530,2508426594,64
1362087084,2508462588,1,52,52,1362087055879,1362087055879,2508434467,2508434467,0
1362087089,2508466692,1,137,137,1362087060806,1362087060806,2508438498,2508438498,0
1362087095,2508472964,4,1650,412.5,1362087090487,1362087090551,2508468451,2508468515,64
1362087111,2508489032,4,366,91.5,1362087090545,1362087105649,2508468577,2508483681,15104
1362087125,2508502908,78,103487,1326.75641,1362087100078,1362087119342,2508477986,2508497250,19264
1362087128,1146820968,3,1058,352.6666667,1362087100755,1362087100755,1146793723,1146793723,0
1362087128,1146821028,45,55910,1242.444444,1362087100759,1362087120471,1146793787,1146813499,19712
1362087129,2508506880,2,265,132.5,1362087104135,1362087104199,2508482015,2508482079,64
1362087129,2508506896,7,5226,746.5714286,1362087101815,1362087121591,2508479711,2508499487,19776
1362087129,2508506988,1,52,52,1362087101532,1362087101532,2508479520,2508479520,0
1362087129,2508506996,1,137,137,1362087104278,1362087104278,2508482274,2508482274,0
1362087135,2508513048,4,1650,412.5,1362087127520,1362087127584,2508505568,2508505632,64
1362087143,2508521136,4,366,91.5,1362087127496,1362087142600,2508505632,2508520736,15104
1362087165,2508542968,1,137,137,1362087139953,1362087139953,2508517921,2508517921,0
1362087167,2508545172,4,1650,412.5,1362087164388,1362087164452,2508542560,2508542624,64
1362087172,1146865048,1,52,52,1362087145732,1362087145732,1146838780,1146838780,0
1362087173,2508551056,1,52,52,1362087146457,1362087146457,2508524513,2508524513,0
1362087183,2508561080,2,98,49,1362087166401,1362087180417,2508544481,2508558497,14016
1362087183,2508561108,4,366,91.5,1362087164578,1362087179682,2508542686,2508557790,15104
1362087185,2508562996,2,265,132.5,1362087159123,1362087159187,2508537119,2508537183,64
1362087189,2508566956,1,46,46,1362087164348,1362087164348,2508542304,2508542304,0
1362087192,1146884988,1,52,52,1362087165568,1362087165568,1146858556,1146858556,0
1362087197,1146889724,2,98,49,1362087191050,1362087193098,1146883774,1146885822,2048
1362087199,2508577040,2,92,46,1362087193256,1362087193256,2508571296,2508571296,0
1362087199,2508577124,2,98,49,1362087191444,1362087193172,2508569568,2508571296,1728
1362087207,2508585060,4,1650,412.5,1362087201555,1362087201619,2508579615,2508579679,64
1362087209,2508586928,1,137,137,1362087181334,1362087181334,2508559262,2508559262,0
1362087217,2508594992,1,46,46,1362087190359,1362087190359,2508568351,2508568351,0
1362087220,1146913048,1,46,46,1362087192773,1362087192773,1146885821,1146885821,0
1362087221,2508599028,7,825,117.8571429,1362087193332,1362087193396,2508571360,2508571424,64
1362087223,2508601192,4,372,93,1362087201552,1362087216656,2508579744,2508594848,15104
1362087237,2508615220,1,137,137,1362087211762,1362087211762,2508589982,2508589982,0
1362087239,2508617124,4,1650,412.5,1362087238545,1362087238609,2508616669,2508616733,64
1362087241,2508619272,2,265,132.5,1362087214016,1362087214080,2508592288,2508592352,64
1362087255,2508633232,4,366,91.5,1362087238568,1362087253672,2508616800,2508631904,15104
1362087265,2508643132,1,52,52,1362087238347,1362087238347,2508616479,2508616479,0
1362087279,2508657120,4,1650,412.5,1362087275606,1362087275670,2508653726,2508653790,64
1362087281,2508659104,1,137,137,1362087255527,1362087255527,2508633631,2508633631,0
1362087295,2508673128,4,366,91.5,1362087275725,1362087290829,2508653853,2508668957,15104
1362087297,2508675160,2,265,132.5,1362087269677,1362087269741,2508647837,2508647901,64
1362087309,2508687168,1,52,52,1362087283302,1362087283302,2508661470,2508661470,0
1362087313,2508691160,1,137,137,1362087287727,1362087287727,2508665887,2508665887,0
1362087319,2508697148,4,1650,412.5,1362087312635,1362087312699,2508690783,2508690847,64
1362087335,2508713228,4,366,91.5,1362087312617,1362087327721,2508690845,2508705949,15104
1362087351,2508729208,4,1650,412.5,1362087349629,1362087349693,2508727837,2508727901,64
1362087353,2508731272,1,52,52,1362087328255,1362087328255,2508706527,2508706527,0
1362087353,2508731324,2,265,132.5,1362087325255,1362087325319,2508703579,2508703643,64
1362087357,2508735424,1,137,137,1362087330405,1362087330405,2508708829,2508708829,0
1362087367,2508745208,4,372,93,1362087349692,1362087364796,2508727900,2508743004,15104
1362087390,2508767652,1,137,137,1362087363753,1362087363753,2508741405,2508741405,0
1362087391,2508769236,4,1650,412.5,1362087386658,1362087386722,2508764894,2508764958,64
1362087397,2508775504,3,2171,723.6666667,1362087371093,1362087371093,2508749597,2508749597,0
1362087398,2508775620,14,14405,1028.928571,1362087371719,1362087372295,2508749339,2508749915,576
1362087401,2508779460,1,52,52,1362087373119,1362087373119,2508751579,2508751579,0
1362087405,2508783540,2,265,132.5,1362087380207,1362087380271,2508758747,2508758811,64
1362087407,2508785156,4,366,91.5,1362087386798,1362087401902,2508764954,2508780058,15104
1362087422,2508799632,1,137,137,1362087394428,1362087394428,2508772060,2508772060,0
1362087431,2508809156,4,1650,412.5,1362087423794,1362087423858,2508801950,2508802014,64
1362087439,2508817164,5,326,65.2,1362087418408,1362087433320,2508796572,2508811484,14912
1362087441,2508819580,4,2262,565.5,1362087416070,1362087424198,2508794650,2508802778,8128
1362087442,2508819584,13,13384,1029.538462,1362087417386,1362087424746,2508794970,2508802330,7360
1362087447,2508825284,4,372,93,1362087423791,1362087438831,2508802075,2508817115,15040
1362087450,2508827688,1,137,137,1362087424580,1362087424580,2508802268,2508802268,0
1362087462,2508839764,2,265,132.5,1362087436473,1362087436537,2508814237,2508814301,64
1362087463,2508841220,4,1650,412.5,1362087460785,1362087460849,2508839005,2508839069,64
1362087474,2508851612,3,2161,720.3333333,1362087447695,1362087448655,2508825307,2508826267,960
1362087474,2508851780,12,12013,1001.083333,1362087447270,1362087447846,2508825050,2508825626,576
1362087479,2508857320,4,372,93,1362087460746,1362087475850,2508839066,2508854170,15104
1362087482,2508859768,1,137,137,1362087456117,1362087456117,2508833885,2508833885,0
1362087503,2508881280,4,1650,412.5,1362087497781,1362087497845,2508876061,2508876125,64
1362087511,2508889276,3,138,46,1362087493047,1362087503031,2508871323,2508881307,9984
1362087511,2508889356,3,138,46,1362087492326,1362087502950,2508870682,2508881306,10624
1362087518,2508895760,2,265,132.5,1362087491900,1362087491964,2508869660,2508869724,64
1362087519,2508897212,4,366,91.5,1362087497910,1362087513014,2508876122,2508891226,15104
1362087526,2508903788,1,137,137,1362087500318,1362087500318,2508878106,2508878106,0
1362087530,2508907720,9,2895,321.6666667,1362087503587,1362087503715,2508881307,2508881435,128
1362087535,2508913356,4,1650,412.5,1362087534759,1362087534823,2508913115,2508913179,64
1362087551,2508929320,4,372,93,1362087534858,1362087549962,2508913178,2508928282,15104
1362087562,2508939900,1,137,137,1362087535278,1362087535278,2508913178,2508913178,0
1362087574,2508952004,1,52,52,1362087548485,1362087548485,2508926489,2508926489,0
1362087574,2508952092,2,265,132.5,1362087547504,1362087547568,2508925596,2508925660,64
1362087575,2508953372,4,1650,412.5,1362087571799,1362087571863,2508950171,2508950235,64
1362087591,2508969372,4,366,91.5,1362087571862,1362087586966,2508950234,2508965338,15104
1362087594,2508972060,1,137,137,1362087569421,1362087569421,2508947481,2508947481,0
1362087615,2508993368,4,1650,412.5,1362087608856,1362087608920,2508987224,2508987288,64
1362087618,2508996188,1,52,52,1362087593358,1362087593358,2508971546,2508971546,0
1362087630,2509008128,2,265,132.5,1362087603335,1362087603399,2508981463,2508981527,64
1362087630,2509008208,1,137,137,1362087601976,1362087601976,2508980184,2508980184,0
1362087631,2509009424,4,366,91.5,1362087608864,1362087623968,2508987288,2509002392,15104
1362087647,2509025260,4,1650,412.5,1362087645958,1362087646022,2509024218,2509024282,64
1362087662,2509040204,1,137,137,1362087635710,1362087635710,2509013914,2509013914,0
1362087663,2509041384,4,372,93,1362087645959,1362087661063,2509024343,2509039447,15104
1362087666,2509044196,1,52,52,1362087638342,1362087638342,2509016538,2509016538,0
1362087686,2509064196,2,265,132.5,1362087658371,1362087658499,2509036567,2509036695,128
1362087687,2509065304,4,1650,412.5,1362087682968,1362087683032,2509061272,2509061336,64
1362087703,2509081296,4,372,93,1362087683104,1362087698208,2509061400,2509076504,15104
1362087706,2509084444,1,137,137,1362087680139,1362087680139,2509058583,2509058583,0
1362087710,2509088520,1,52,52,1362087683073,1362087683073,2509061593,2509061593,0
1362087727,2509105424,4,1650,412.5,1362087719905,1362087719969,2509098329,2509098393,64
1362087738,2509116516,2,265,132.5,1362087713154,1362087713218,2509091670,2509091734,64
1362087743,2509121436,4,372,93,1362087720020,1362087735124,2509098456,2509113560,15104
1362087746,2509124444,1,137,137,1362087719754,1362087719754,2509098198,2509098198,0
1362087751,2509129532,5,326,65.2,1362087728115,1362087742963,2509106647,2509121495,14848
1362087759,2509137508,4,1650,412.5,1362087756876,1362087756940,2509135384,2509135448,64
1362087776,2509153636,4,372,93,1362087757811,1362087772915,2509135447,2509150551,15104
1362087778,2509156568,1,137,137,1362087749776,1362087749776,2509128344,2509128344,0
1362087794,2509172532,2,265,132.5,1362087768945,1362087769009,2509147477,2509147541,64
1362087799,2509177560,4,1650,412.5,1362087793878,1362087793942,2509172438,2509172502,64
1362087807,2509184660,1,137,137,1362087782299,1362087782299,2509159959,2509159959,0
1362087815,2509193536,4,372,93,1362087794029,1362087809069,2509172565,2509187605,15040
1362087838,2509216580,7,825,117.8571429,1362087812738,1362087812802,2509191318,2509191382,64
1362087839,2509217500,4,1650,412.5,1362087830992,1362087831056,2509209492,2509209556,64
1362087847,2509225520,4,366,91.5,1362087831038,1362087846142,2509209558,2509224662,15104
1362087850,2509228568,2,265,132.5,1362087824526,1362087824590,2509203094,2509203158,64
1362087851,2509228712,1,137,137,1362087825831,1362087825831,2509203543,2509203543,0
1362087859,2509236788,9,4318,479.7777778,1362087834587,1362087834715,2509212375,2509212503,128
1362087859,2509236916,26,17814,685.1538462,1362087834585,1362087834841,2509212501,2509212757,256
1362087872,2509249624,4,1650,412.5,1362087868927,1362087868991,2509246551,2509246615,64
1362087883,2509260912,1,52,52,1362087858525,1362087858525,2509236437,2509236437,0
1362087887,2509265572,4,366,91.5,1362087868105,1362087883209,2509246677,2509261781,15104
1362087895,2509272840,1,137,137,1362087869157,1362087869157,2509246997,2509246997,0
1362087907,2509284836,1,52,52,1362087879719,1362087879719,2509257555,2509257555,0
1362087907,2509284852,1,52,52,1362087879897,1362087879897,2509257749,2509257749,0
1362087907,2509284876,2,265,132.5,1362087880704,1362087880768,2509258580,2509258644,64
1362087912,2509289596,4,1650,412.5,1362087906008,1362087906072,2509283604,2509283668,64
1362087928,2509305672,4,372,93,1362087905996,1362087921100,2509283668,2509298772,15104
1362087931,2509308848,1,52,52,1362087903644,1362087903644,2509281492,2509281492,0
1362087935,2509312808,1,137,137,1362087906886,1362087906886,2509284694,2509284694,0
1362087946,2509324444,4,1650,412.5,1362087942216,1362087942280,2509320660,2509320724,64
1362087951,2509329036,1,52,52,1362087924578,1362087924578,2509302614,2509302614,0
1362087951,2509329036,1,52,52,1362087924768,1362087924768,2509302804,2509302804,0
1362087960,2509337788,4,372,93,1362087942936,1362087958040,2509320724,2509335828,15104
1362087963,2509341032,2,265,132.5,1362087936419,1362087936483,2509314451,2509314515,64
1362087971,2509348944,1,137,137,1362087944509,1362087944509,2509322453,2509322453,0
1362087975,2509352924,1,52,52,1362087948561,1362087948561,2509326485,2509326485,0
1362087984,2509362008,4,1650,412.5,1362087979706,1362087979770,2509357714,2509357778,64
1362087995,2509372980,1,52,52,1362087969814,1362087969814,2509347794,2509347794,0
1362087995,2509373072,1,52,52,1362087969533,1362087969533,2509347605,2509347605,0
1362088000,2509378016,4,372,93,1362087979764,1362087994868,2509357780,2509372884,15104
1362088015,2509393276,1,137,137,1362087987695,1362087987695,2509365971,2509365971,0
1362088019,2509397276,2,265,132.5,1362087991407,1362087991471,2509369683,2509369747,64
1362088019,2509397308,1,52,52,1362087993230,1362087993230,2509371538,2509371538,0
1362088024,2509401952,4,1650,412.5,1362088016820,1362088016884,2509394772,2509394836,64
1362088039,2509417412,1,52,52,1362088014245,1362088014245,2509392657,2509392657,0
1362088039,2509417420,1,52,52,1362088014430,1362088014430,2509392850,2509392850,0
1362088040,2509417984,4,372,93,1362088016850,1362088031954,2509394834,2509409938,15104
1362088047,2509425372,1,137,137,1362088020112,1362088020112,2509398484,2509398484,0
1362088056,2509434164,4,1650,412.5,1362088053661,1362088053725,2509431825,2509431889,64
1362088056,2509434192,5,326,65.2,1362088038338,1362088053250,2509416530,2509431442,14912
1362088071,2509449580,2,265,132.5,1362088046400,1362088046528,2509424980,2509425108,128
1362088072,2509450072,4,366,91.5,1362088053817,1362088068921,2509431889,2509446993,15104
1362088080,2509458036,5,326,65.2,1362088059680,1362088074528,2509437716,2509452564,14848
1362088080,2509458036,5,326,65.2,1362088059806,1362088074718,2509437842,2509452754,14912
1362088083,2509461468,1,137,137,1362088057263,1362088057263,2509435731,2509435731,0
1362088096,2509474036,4,1650,412.5,1362088090784,1362088090912,2509468820,2509468948,128
1362088112,2509490036,4,366,91.5,1362088090910,1362088106014,2509468946,2509484050,15104
1362088123,2509501324,1,137,137,1362088096061,1362088096061,2509474385,2509474385,0
1362088128,2509505584,2,265,132.5,1362088102944,1362088103008,2509480528,2509480592,64
1362088136,2509514008,4,1650,412.5,1362088127866,1362088127930,2509505874,2509505938,64
1362088144,2509522004,4,366,91.5,1362088127999,1362088143103,2509506003,2509521107,15104
1362088151,2509529508,8,871,108.875,1362088122822,1362088122886,2509501330,2509501394,64
1362088155,2509533516,1,137,137,1362088129020,1362088129020,2509507536,2509507536,0
1362088168,2509546072,4,1650,412.5,1362088164922,1362088164986,2509542994,2509543058,64
1362088177,2509555512,1,46,46,1362088147265,1362088147265,2509525777,2509525777,0
1362088183,2509561452,2,265,132.5,1362088157628,1362088157692,2509536080,2509536144,64
1362088184,2509562420,4,366,91.5,1362088164637,1362088179741,2509543057,2509558161,15104
1362088195,2509573400,1,52,52,1362088168050,1362088168050,2509546450,2509546450,0
1362088195,2509573468,1,137,137,1362088169838,1362088169838,2509548306,2509548306,0
1362088208,2509586328,4,1650,412.5,1362088201656,1362088201720,2509579984,2509580048,64
1362088224,2509602488,4,372,93,1362088201622,1362088216726,2509580110,2509595214,15104
1362088235,2509613524,1,137,137,1362088209778,1362088209778,2509588302,2509588302,0
1362088239,2509617524,1,52,52,1362088212980,1362088212980,2509591504,2509591504,0
1362088240,2509617760,2,265,132.5,1362088214127,1362088214191,2509591887,2509591951,64
1362088240,2509618364,4,1650,412.5,1362088238674,1362088238738,2509617038,2509617102,64
1362088259,2509637468,4,372,93,1362088238636,1362088253740,2509617104,2509632208,15104
1362088268,2509645600,4,1306,326.5,1362088240081,1362088240145,2509617681,2509617745,64
1362088271,2509649508,1,137,137,1362088245443,1362088245443,2509623951,2509623951,0
1362088280,2509658380,4,1650,412.5,1362088275715,1362088275779,2509654095,2509654159,64
1362088284,2509661736,1,52,52,1362088258757,1362088258757,2509636493,2509636493,0
1362088296,2509673640,2,265,132.5,1362088269606,1362088269670,2509647246,2509647310,64
1362088296,2509674380,4,372,93,1362088275780,1362088290884,2509654160,2509669264,15104
1362088312,2509690392,3,144,48,1362088298999,1362088309047,2509677391,2509687439,10048
1362088315,2509693536,1,137,137,1362088287335,1362088287335,2509665871,2509665871,0
1362088320,2509697632,6,4276,712.6666667,1362088294319,1362088299759,2509671951,2509677391,5440
1362088320,2509697744,72,85860,1192.5,1362088293821,1362088312317,2509671565,2509690061,18496
1362088320,2509698436,4,1650,412.5,1362088312714,1362088312778,2509691150,2509691214,64
1362088326,1148018688,3,1058,352.6666667,1362088300402,1362088300466,1147993090,1147993154,64
1362088326,1148018748,32,38582,1205.6875,1362088300473,1362088313337,1147993221,1148006085,12864
1362088328,2509705592,6,4702,783.6666667,1362088301461,1362088314133,2509679053,2509691725,12672
1362088331,2509709572,1,52,52,1362088302980,1362088302980,2509681552,2509681552,0
1362088336,2509714352,4,366,91.5,1362088312928,1362088327968,2509691280,2509706320,15040
1362088352,2509729728,2,265,132.5,1362088324812,1362088324876,2509702540,2509702604,64
1362088352,2509730476,4,1650,412.5,1362088349731,1362088349795,2509728207,2509728271,64
1362088356,2509733768,1,137,137,1362088331367,1362088331367,2509709135,2509709135,0
1362088368,2509746376,4,366,91.5,1362088349895,1362088364999,2509728271,2509743375,15104
1362088368,2509746412,5,326,65.2,1362088348196,1362088363044,2509726608,2509741456,14848
1362088370,1148062704,1,52,52,1362088345444,1362088345444,1148038148,1148038148,0
1362088372,2509749680,1,46,46,1362088344764,1362088344764,2509722444,2509722444,0
1362088376,2509754388,2,98,49,1362088358393,1362088372857,2509736781,2509751245,14464
1362088384,2509761624,1,46,46,1362088357495,1362088357495,2509735119,2509735119,0
1362088386,1148078736,1,52,52,1362088358339,1362088358339,1148051075,1148051075,0
1362088392,2509769796,1,137,137,1362088363786,1362088363786,2509741582,2509741582,0
1362088392,2509770388,4,1650,412.5,1362088386874,1362088386938,2509765262,2509765326,64
1362088404,2509781896,1,46,46,1362088379559,1362088379559,2509757455,2509757455,0
1362088408,2509785824,2,265,132.5,1362088380207,1362088380271,2509758031,2509758095,64
1362088408,2509786504,4,372,93,1362088386820,1362088401924,2509765324,2509780428,15104
1362088416,2509793728,1,46,46,1362088389774,1362088389774,2509767502,2509767502,0
1362088418,1148110696,1,52,52,1362088390444,1362088390444,1148083140,1148083140,0
1362088420,2509797772,1,137,137,1362088395232,1362088395232,2509773004,2509773004,0
1362088428,2509805748,1,46,46,1362088402424,1362088402424,2509780172,2509780172,0
1362088430,1148122700,1,52,52,1362088403432,1362088403432,1148096132,1148096132,0
1362088432,2509810428,4,1650,412.5,1362088423890,1362088423954,2509802318,2509802382,64
1362088440,2509818380,2,92,46,1362088432897,1362088432897,2509811277,2509811277,0
1362088440,2509818428,4,366,91.5,1362088423951,1362088439055,2509802379,2509817483,15104
1362088440,2509818468,2,92,46,1362088432809,1362088432809,2509811277,2509811277,0
1362088458,1148150724,1,46,46,1362088433106,1362088433106,1148125830,1148125830,0
1362088458,1148150768,1,46,46,1362088433059,1362088433059,1148125827,1148125827,0
1362088460,2509837796,1,137,137,1362088435337,1362088435337,2509813133,2509813133,0
1362088460,2509837872,7,823,117.5714286,1362088433469,1362088433533,2509811341,2509811405,64
1362088464,2509841832,2,265,132.5,1362088435941,1362088436005,2509813773,2509813837,64
1362088464,2509842580,4,1650,412.5,1362088460792,1362088460856,2509839372,2509839436,64
1362088480,2509858576,4,366,91.5,1362088460926,1362088476030,2509839502,2509854606,15104
1362088492,2509869992,1,137,137,1362088466242,1362088466242,2509844234,2509844234,0
1362088504,2509881832,1,52,52,1362088478627,1362088478627,2509856459,2509856459,0
1362088504,2509882516,4,1650,412.5,1362088497912,1362088497976,2509876428,2509876492,64
1362088516,2509894256,2,265,132.5,1362088491260,1362088491324,2509869516,2509869580,64
1362088521,2509898604,4,366,91.5,1362088498889,1362088513993,2509876493,2509891597,15104
1362088528,2509906012,1,137,137,1362088499888,1362088499888,2509877900,2509877900,0
1362088532,2509910048,3,2279,759.6666667,1362088505163,1362088505227,2509883211,2509883275,64
1362088532,2509910144,9,8611,956.7777778,1362088504813,1362088505261,2509882957,2509883405,448
1362088537,2509914608,4,1650,412.5,1362088535877,1362088535941,2509913485,2509913549,64
1362088548,2509926252,1,52,52,1362088523265,1362088523265,2509901517,2509901517,0
1362088553,2509930608,4,366,91.5,1362088535940,1362088551044,2509913548,2509928652,15104
1362088560,2509938072,1,137,137,1362088533237,1362088533237,2509911309,2509911309,0
1362088572,2509950308,2,265,132.5,1362088547144,1362088547208,2509925452,2509925516,64
1362088576,2509954284,4,2312,578,1362088550047,1362088555551,2509928331,2509933835,5504
1362088576,2509954284,10,7732,773.2,1362088550175,1362088555103,2509928459,2509933387,4928
1362088577,2509954608,4,1650,412.5,1362088572865,1362088572993,2509950473,2509950601,128
1362088592,2509970088,1,137,137,1362088563939,1362088563939,2509942027,2509942027,0
1362088592,2509970544,4,366,91.5,1362088572059,1362088587163,2509950603,2509965707,15104
1362088596,2509974112,1,52,52,1362088568460,1362088568460,2509946572,2509946572,0
1362088612,2509990180,29,23850,822.4137931,1362088587335,1362088597191,2509965515,2509975371,9856
1362088612,2509990304,14,6495,463.9285714,1362088587402,1362088598218,2509965706,2509976522,10816
1362088616,2509994176,15,3211,214.0666667,1362088591496,1362088597192,2509969672,2509975368,5696
1362088616,2509994288,25,21362,854.48,1362088591384,1362088597080,2509969672,2509975368,5696
1362088616,2509994288,26,19874,764.3846154,1362088591384,1362088608792,2509969672,2509987080,17408
1362088616,2509994296,18,10439,579.9444444,1362088591376,1362088598160,2509969672,2509976456,6784
1362088616,2509994556,4,1650,412.5,1362088608975,1362088609103,2509987531,2509987659,128
1362088618,1148311032,33,38628,1170.545455,1362088591840,1362088609760,1148284872,1148302792,17920
1362088620,2509998124,6,4925,820.8333333,1362088592957,1362088610045,2509971081,2509988169,17088
1362088628,2510006148,2,265,132.5,1362088602408,1362088602472,2509980556,2509980620,64
1362088628,2510006184,1,137,137,1362088603456,1362088603456,2509981640,2509981640,0
1362088633,2510010608,4,372,93,1362088611074,1362088626178,2509988682,2510003786,15104
1362088634,1148327056,3,1058,352.6666667,1362088609221,1362088609221,1148302277,1148302277,0
1362088640,2510018176,1,52,52,1362088613386,1362088613386,2509991562,2509991562,0
1362088649,2510026624,4,1650,412.5,1362088646962,1362088647026,2510024586,2510024650,64
1362088650,1148343060,11,12874,1170.363636,1362088625537,1362088625921,1148318597,1148318981,384
1362088652,2510030160,19,25112,1321.684211,1362088624408,1362088625560,2510002568,2510003720,1152
1362088652,2510030240,1,1212,1212,1362088626506,1362088626506,2510004746,2510004746,0
1362088660,2510038268,3,408,136,1362088633199,1362088639215,2510011467,2510017483,6016
1362088664,2510042220,1,137,137,1362088639262,1362088639262,2510017482,2510017482,0
1362088665,2510042716,4,366,91.5,1362088646997,1362088662101,2510024713,2510039817,15104
1362088668,2510046236,1,46,46,1362088642190,1362088642190,2510020426,2510020426,0
1362088668,2510046256,1,46,46,1362088643259,1362088643259,2510021515,2510021515,0
1362088668,2510046360,1,46,46,1362088642064,1362088642064,2510020424,2510020424,0
1362088668,2510046364,1,46,46,1362088641999,1362088641999,2510020363,2510020363,0
1362088668,2510046404,1,46,46,1362088643111,1362088643111,2510021515,2510021515,0
1362088681,2510058720,5,326,65.2,1362088658898,1362088673746,2510036618,2510051466,14848
1362088682,1148375016,1,52,52,1362088654256,1362088654256,1148347272,1148347272,0
1362088684,2510062180,2,265,132.5,1362088657605,1362088657733,2510035785,2510035913,128
1362088689,2510066644,4,1650,412.5,1362088683997,1362088684061,2510061641,2510061705,64
1362088689,2510066668,2,98,49,1362088672199,1362088686535,2510049867,2510064203,14336
1362088696,2510074216,1,46,46,1362088670626,1362088670626,2510048842,2510048842,0
1362088698,1148391012,1,52,52,1362088671025,1362088671025,1148364037,1148364037,0
1362088700,2510078368,1,137,137,1362088675401,1362088675401,2510053769,2510053769,0
1362088705,2510082772,4,372,93,1362088683996,1362088699100,2510061768,2510076872,15104
1362088712,2510090292,1,46,46,1362088687126,1362088687126,2510065418,2510065418,0
1362088712,2510090292,1,46,46,1362088687189,1362088687189,2510065481,2510065481,0
1362088712,2510090412,1,46,46,1362088687068,1362088687068,2510065480,2510065480,0
1362088716,2510094188,1,46,46,1362088688381,1362088688381,2510066569,2510066569,0
1362088716,2510094328,1,46,46,1362088688241,1362088688241,2510066569,2510066569,0
1362088716,2510094412,1,46,46,1362088691291,1362088691291,2510069703,2510069703,0
1362088727,1148419192,1,52,52,1362088700134,1362088700134,1148392326,1148392326,0
1362088729,2510106620,4,1650,412.5,1362088721078,1362088721142,2510098698,2510098762,64
1362088737,2510114716,4,366,91.5,1362088721109,1362088736213,2510098825,2510113929,15104
1362088740,2510118240,2,265,132.5,1362088713098,1362088713162,2510091338,2510091402,64
1362088740,2510118416,1,137,137,1362088714650,1362088714650,2510093066,2510093066,0
1362088740,2510118424,1,46,46,1362088715407,1362088715407,2510093831,2510093831,0
1362088743,1148435240,1,52,52,1362088716791,1362088716791,1148409031,1148409031,0
1362088745,2510122620,3,138,46,1362088732851,1362088743731,2510110471,2510121351,10880
1362088745,2510122620,3,138,46,1362088732850,1362088743730,2510110470,2510121350,10880
1362088745,2510122624,3,138,46,1362088732849,1362088743729,2510110473,2510121353,10880
1362088745,2510122636,3,138,46,1362088733990,1362088743718,2510111626,2510121354,9728
1362088745,2510122708,3,138,46,1362088733914,1362088743642,2510111622,2510121350,9728
1362088745,2510122748,2,92,46,1362088743603,1362088743603,2510121351,2510121351,0
1362088750,1148442520,2,92,46,1362088743389,1362088743581,1148435909,1148436101,192
1362088750,1148442520,2,92,46,1362088743389,1362088743709,1148435909,1148436229,320
1362088761,2510138736,4,1650,412.5,1362088758016,1362088758144,2510135752,2510135880,128
1362088772,2510150208,8,871,108.875,1362088744168,1362088744232,2510122376,2510122440,64
1362088776,2510154376,1,137,137,1362088749825,1362088749825,2510128201,2510128201,0
1362088777,2510154656,4,366,91.5,1362088758223,1362088773327,2510135879,2510150983,15104
1362088796,2510174244,2,265,132.5,1362088768580,1362088768644,2510146824,2510146888,64
1362088801,2510178700,4,1650,412.5,1362088795107,1362088795171,2510172807,2510172871,64
1362088816,2510194428,1,52,52,1362088789067,1362088789067,2510167495,2510167495,0
1362088817,2510194696,4,366,91.5,1362088795174,1362088810278,2510172870,2510187974,15104
1362088820,2510198320,1,137,137,1362088794423,1362088794423,2510172743,2510172743,0
1362088833,2510210824,4,1650,412.5,1362088832039,1362088832103,2510209863,2510209927,64
1362088849,2510226800,4,366,91.5,1362088832127,1362088847231,2510209927,2510225031,15104
1362088852,2510230380,2,265,132.5,1362088824443,1362088824507,2510202823,2510202887,64
1362088861,2510238644,1,52,52,1362088834905,1362088834905,2510212549,2510212549,0
1362088865,2510242720,1,137,137,1362088839118,1362088839118,2510216838,2510216838,0
1362088873,2510250876,4,1650,412.5,1362088869040,1362088869104,2510246916,2510246980,64
1362088889,2510266804,4,372,93,1362088869178,1362088884282,2510246982,2510262086,15104
1362088896,2510274576,1,137,137,1362088870712,1362088870712,2510249288,2510249288,0
1362088901,2510278628,4,731,182.75,1362088875434,1362088875626,2510253062,2510253254,192
1362088905,2510282820,1,52,52,1362088879786,1362088879786,2510257606,2510257606,0
1362088905,2510282828,2,265,132.5,1362088880291,1362088880355,2510258119,2510258183,64
1362088913,2510290976,4,1650,412.5,1362088907215,1362088907279,2510285191,2510285255,64
1362088929,2510307124,4,366,91.5,1362088907128,1362088922232,2510285252,2510300356,15104
1362088941,2510318632,1,137,137,1362088913254,1362088913254,2510290886,2510290886,0
1362088945,2510322724,9,6539,726.5555556,1362088920586,1362088943882,2510298310,2510321606,23296
1362088945,2510323088,4,1650,412.5,1362088942943,1362088943007,2510321031,2510321095,64
1362088949,2510327580,1,46,46,1362088923953,1362088923953,2510302533,2510302533,0
1362088950,2510328136,1,52,52,1362088924460,1362088924460,2510302596,2510302596,0
1362088961,2510338796,2,265,132.5,1362088935807,1362088935871,2510313603,2510313667,64
1362088961,2510339504,4,372,93,1362088942587,1362088957691,2510321091,2510336195,15104
1362088969,2510346832,45,58292,1295.377778,1362088943645,1362088960925,2510321477,2510338757,17280
1362088973,2510350676,1,137,137,1362088945274,1362088945274,2510322950,2510322950,0
1362088977,2510354892,5,3732,746.4,1362088952543,1362088964639,2510330435,2510342531,12096
1362088979,1148671536,3,1058,352.6666667,1362088951950,1362088951950,1148644486,1148644486,0
1362088979,1148671572,23,26847,1167.26087,1362088951979,1362088963563,1148644551,1148656135,11584
1362088985,2510363568,5,326,65.2,1362088969083,1362088983931,2510347651,2510362499,14848
1362088986,2510363692,4,1650,412.5,1362088980327,1362088980455,2510358019,2510358147,128
1362089002,2510379688,4,366,91.5,1362088980459,1362088995563,2510358147,2510373251,15104
1362089009,2510386852,1,137,137,1362088984711,1362088984711,2510362563,2510362563,0
1362089017,2510394872,1,46,46,1362088988789,1362088988789,2510366661,2510366661,0
1362089017,2510394944,2,265,132.5,1362088991594,1362088991658,2510369538,2510369602,64
1362089018,2510395668,4,1650,412.5,1362089017409,1362089017537,2510395077,2510395205,128
1362089023,1148715568,1,52,52,1362088996913,1362088996913,1148689481,1148689481,0
1362089026,2510403580,2,98,49,1362089010006,1362089024854,2510387586,2510402434,14848
1362089033,2510410900,1,46,46,1362089005910,1362089005910,2510383810,2510383810,0
1362089034,2510411668,4,366,91.5,1362089017534,1362089032638,2510395202,2510410306,15104
1362089035,1148727600,1,52,52,1362089008530,1362089008530,1148701130,1148701130,0
1362089045,2510422924,1,137,137,1362089017279,1362089017279,2510395203,2510395203,0
1362089054,1148746524,2,98,49,1362089042013,1362089053341,1148734537,1148745865,11328
1362089058,2510435692,3,138,46,1362089034024,1362089053608,2510411716,2510431300,19584
1362089058,2510435728,4,1650,412.5,1362089054469,1362089054533,2510432197,2510432261,64
1362089058,2510435728,3,138,46,1362089051138,1362089053570,2510428866,2510431298,2432
1362089061,2510439040,1,46,46,1362089033612,1362089033612,2510411652,2510411652,0
1362089073,2510450976,2,265,132.5,1362089047178,1362089047242,2510425154,2510425218,64
1362089074,2510451668,4,372,93,1362089054657,1362089069761,2510432325,2510447429,15104
1362089077,2510455144,1,137,137,1362089049315,1362089049315,2510427459,2510427459,0
1362089079,1148772032,1,46,46,1362089052834,1362089052834,1148745866,1148745866,0
1362089081,2510459136,7,825,117.8571429,1362089053162,1362089053290,2510431298,2510431426,128
1362089098,2510475644,4,1650,412.5,1362089091544,1362089091672,2510469188,2510469316,128
1362089114,2510491660,4,366,91.5,1362089091656,1362089106760,2510469316,2510484420,15104
1362089117,2510495112,1,137,137,1362089092034,1362089092034,2510470146,2510470146,0
1362089125,2510503072,1,52,52,1362089098409,1362089098409,2510476481,2510476481,0
1362089129,2510507088,2,265,132.5,1362089102938,1362089103002,2510481026,2510481090,64
1362089130,2510507780,4,1650,412.5,1362089128463,1362089128591,2510506243,2510506371,128
1362089146,2510523788,4,366,91.5,1362089128582,1362089143622,2510506370,2510521410,15040
1362089153,2510531168,1,137,137,1362089124745,1362089124745,2510502913,2510502913,0
1362089169,2510547260,1,52,52,1362089143214,1362089143214,2510521474,2510521474,0
1362089170,2510547664,4,1650,412.5,1362089165634,1362089165698,2510543298,2510543362,64
1362089181,2510559380,1,137,137,1362089154806,1362089154806,2510533186,2510533186,0
1362089185,2510563380,2,265,132.5,1362089158581,1362089158709,2510536961,2510537089,128
1362089186,2510563668,4,366,91.5,1362089165759,1362089180799,2510543427,2510558467,15040
1362089210,2510587812,4,1650,412.5,1362089202604,1362089202668,2510580416,2510580480,64
1362089214,2510591624,1,52,52,1362089188906,1362089188906,2510566530,2510566530,0
1362089214,2510591628,1,137,137,1362089189475,1362089189475,2510567103,2510567103,0
1362089218,2510595760,4,366,91.5,1362089202721,1362089217825,2510580481,2510595585,15104
1362089226,2510603788,11,5666,515.0909091,1362089206915,1362089222211,2510584703,2510599999,15296
1362089241,2510619572,2,265,132.5,1362089213876,1362089213940,2510592448,2510592512,64
1362089242,2510619908,4,1650,412.5,1362089239500,1362089239564,2510617408,2510617472,64
1362089245,2510623524,1,137,137,1362089219812,1362089219812,2510598336,2510598336,0
1362089258,2510635832,4,366,91.5,1362089239640,1362089254744,2510617472,2510632576,15104
1362089262,2510639616,1,52,52,1362089233904,1362089233904,2510611520,2510611520,0
1362089278,2510655644,3,408,136,1362089252181,1362089258261,2510629825,2510635905,6080
1362089281,2510659468,1,137,137,1362089253661,1362089253661,2510632129,2510632129,0
1362089282,2510659924,4,1650,412.5,1362089276541,1362089276605,2510654465,2510654529,64
1362089297,2510675512,2,265,132.5,1362089269550,1362089269614,2510648062,2510648126,64
1362089298,2510675884,4,372,93,1362089276646,1362089291750,2510654530,2510669634,15104
1362089298,2510675928,5,326,65.2,1362089278646,1362089293494,2510656574,2510671422,14848
1362089310,2510687596,1,137,137,1362089284612,1362089284612,2510662208,2510662208,0
1362089314,2510691864,4,1650,412.5,1362089313655,1362089313719,2510691519,2510691583,64
1362089330,2510708224,4,366,91.5,1362089313361,1362089328465,2510691585,2510706689,15104
1362089346,2510723852,1,137,137,1362089318659,1362089318659,2510696511,2510696511,0
1362089354,2510732028,2,265,132.5,1362089325777,1362089325841,2510703805,2510703869,64
1362089354,2510732192,4,1650,412.5,1362089350381,1362089350445,2510728573,2510728637,64
1362089370,2510748168,4,366,91.5,1362089350469,1362089365573,2510728637,2510743741,15104
1362089386,2510763848,1,137,137,1362089358856,1362089358856,2510736704,2510736704,0
1362089390,2510767864,7,825,117.8571429,1362089363446,1362089363574,2510741310,2510741438,128
1362089394,2510772216,4,1650,412.5,1362089387415,1362089387479,2510765631,2510765695,64
1362089406,2510784120,2,265,132.5,1362089381046,1362089381174,2510759166,2510759294,128
1362089410,2510788224,4,366,91.5,1362089387471,1362089402575,2510765695,2510780799,15104
1362089426,2510804008,1,137,137,1362089401508,1362089401508,2510779516,2510779516,0
1362089426,2510804320,4,1650,412.5,1362089424367,1362089424431,2510802687,2510802751,64
1362089430,2510807988,19,21894,1152.315789,1362089404729,1362089405433,2510782717,2510783421,704
1362089430,2510807992,3,2183,727.6666667,1362089404983,1362089405111,2510782975,2510783103,128
1362089434,2510812216,1,52,52,1362089408212,1362089408212,2510786428,2510786428,0
1362089442,2510820380,4,366,91.5,1362089424371,1362089439539,2510802751,2510817919,15168
1362089462,2510839884,18,20399,1133.277778,1362089434144,1362089434528,2510812028,2510812412,384
1362089462,2510839964,2,265,132.5,1362089436945,1362089437009,2510814909,2510814973,64
1362089466,2510844060,1,137,137,1362089439602,1362089439602,2510817662,2510817662,0
1362089466,2510844252,4,1650,412.5,1362089461488,1362089461552,2510839740,2510839804,64
1362089478,2510856020,1,46,46,1362089450137,1362089450137,2510828157,2510828157,0
1362089478,2510856112,1,52,52,1362089453373,1362089453373,2510831485,2510831485,0
1362089482,2510860248,4,372,93,1362089461558,1362089476662,2510839806,2510854910,15104
1362089506,2510884416,4,1650,412.5,1362089498379,1362089498443,2510876795,2510876859,64
1362089506,2510884568,1,46,46,1362089478900,1362089478900,2510857468,2510857468,0
1362089510,2510888468,1,137,137,1362089482585,1362089482585,2510861053,2510861053,0
1362089514,2510892408,4,372,93,1362089498515,1362089513619,2510876923,2510892027,15104
1362089518,2510896288,2,265,132.5,1362089492108,1362089492172,2510870396,2510870460,64
1362089523,2510900672,1,46,46,1362089495539,1362089495539,2510873211,2510873211,0
1362089526,2510904268,1,52,52,1362089498273,1362089498273,2510876541,2510876541,0
1362089538,2510916432,4,1650,412.5,1362089535354,1362089535418,2510913786,2510913850,64
1362089539,2510916608,1,137,137,1362089514419,1362089514419,2510892027,2510892027,0
1362089550,2510928444,1,46,46,1362089524081,1362089524081,2510902525,2510902525,0
1362089554,2510932364,4,366,91.5,1362089535552,1362089550656,2510913916,2510929020,15104
1362089566,2510944484,1,46,46,1362089539783,1362089539783,2510918267,2510918267,0
1362089571,2510948656,1,52,52,1362089543874,1362089543874,2510921530,2510921530,0
1362089574,2510952488,1,137,137,1362089546946,1362089546946,2510925434,2510925434,0
1362089574,2510952516,2,265,132.5,1362089547624,1362089547688,2510926140,2510926204,64
1362089578,2510956360,4,1650,412.5,1362089572482,1362089572546,2510950842,2510950906,64
1362089594,2510972372,4,366,91.5,1362089572600,1362089587704,2510950972,2510966076,15104
1362089595,2510972748,1,46,46,1362089569830,1362089569830,2510947578,2510947578,0
1362089610,2510988388,5,326,65.2,1362089588198,1362089603110,2510966586,2510981498,14912
1362089610,2510988420,4,1650,412.5,1362089609477,1362089609541,2510987897,2510987961,64
1362089611,2510988760,1,46,46,1362089585561,1362089585561,2510963321,2510963321,0
1362089615,2510992644,1,137,137,1362089590479,1362089590479,2510968123,2510968123,0
1362089622,1149314600,14,12849,917.7857143,1362089621077,1362089621269,1149313677,1149313869,192
1362089626,2511004360,4,366,91.5,1362089609668,1362089624772,2510988028,2511003132,15104
1362089627,2511004624,29,21222,731.7931034,1362089601444,1362089601700,2510979068,2510979324,256
1362089627,2511004736,9,4448,494.2222222,1362089601138,1362089601330,2510978874,2510979066,192
1362089630,1149322584,16,13857,866.0625,1362089621093,1362089629477,1149313677,1149322061,8384
1362089630,1149322584,11,5679,516.2727273,1362089621093,1362089628965,1149313677,1149321549,7872
1362089630,1149322584,13,12089,929.9230769,1362089621093,1362089629541,1149313677,1149322125,8448
1362089630,1149322584,8,1588,198.5,1362089629795,1362089629795,1149322379,1149322379,0
1362089630,1149322604,13,11337,872.0769231,1362089621071,1362089629071,1149313675,1149321675,8000
1362089630,1149322604,10,5713,571.3,1362089621071,1362089628943,1149313675,1149321547,7872
1362089630,1149322608,8,1588,198.5,1362089629773,1362089629773,1149322381,1149322381,0
1362089631,2511008712,2,265,132.5,1362089604426,1362089604490,2510982138,2510982202,64
1362089638,1149330576,8,2158,269.75,1362089630062,1362089630062,1149322638,1149322638,0
1362089638,1149330576,8,1438,179.75,1362089630061,1362089630509,1149322637,1149323085,448
1362089638,1149330576,8,2296,287,1362089630061,1362089630317,1149322637,1149322893,256
1362089638,1149330576,7,1312,187.4285714,1362089630061,1362089630573,1149322637,1149323149,512
1362089638,1149330576,7,1376,196.5714286,1362089630061,1362089630189,1149322637,1149322765,128
1362089638,1149330576,7,1600,228.5714286,1362089630187,1362089630379,1149322763,1149322955,192
1362089638,1149330576,7,1360,194.2857143,1362089630314,1362089630378,1149322890,1149322954,64
1362089638,1149330580,10,7752,775.2,1362089633256,1362089633448,1149325836,1149326028,192
1362089638,1149330580,7,1440,205.7142857,1362089633384,1362089633640,1149325964,1149326220,256
1362089638,1149330584,7,1126,160.8571429,1362089634406,1362089634406,1149326990,1149326990,0
1362089638,1149330584,7,1184,169.1428571,1362089634534,1362089634598,1149327118,1149327182,64
1362089638,1149330584,7,2378,339.7142857,1362089630051,1362089630243,1149322635,1149322827,192
1362089638,1149330584,7,1328,189.7142857,1362089630051,1362089630499,1149322635,1149323083,448
1362089638,1149330588,8,2200,275,1362089630304,1362089630432,1149322892,1149323020,128
1362089638,1149330588,8,1172,146.5,1362089630431,1362089630431,1149323019,1149323019,0
1362089638,1149330588,10,6936,693.6,1362089633058,1362089633122,1149325646,1149325710,64
1362089638,1149330600,12,10717,893.0833333,1362089633621,1362089634069,1149326221,1149326669,448
1362089638,1149330600,8,1470,183.75,1362089633237,1362089633365,1149325837,1149325965,128
1362089638,1149330600,7,2112,301.7142857,1362089633556,1362089633556,1149326156,1149326156,0
1362089643,2511020936,1,46,46,1362089614634,1362089614634,2510992570,2510992570,0
1362089643,2511021124,6,2498,416.3333333,1362089616815,1362089616879,2510994939,2510995003,64
1362089646,1149338580,7,1126,160.8571429,1362089639144,1362089639144,1149331724,1149331724,0
1362089646,1149338580,7,1184,169.1428571,1362089639271,1362089639271,1149331851,1149331851,0
1362089646,1149338580,13,11173,859.4615385,1362089642602,1362089643306,1149335182,1149335886,704
1362089646,1149338584,8,1230,153.75,1362089643557,1362089643621,1149336141,1149336205,64
1362089646,1149338584,8,1172,146.5,1362089643429,1362089643493,1149336013,1149336077,64
1362089646,1149338588,7,1438,205.4285714,1362089621088,1362089644576,1149313676,1149337164,23488
1362089647,2511024728,10,5415,541.5,1362089619449,1362089619513,2510997177,2510997241,64
1362089648,1149340452,3,1058,352.6666667,1362089622120,1362089622120,1149314572,1149314572,0
1362089648,1149340476,34,41139,1209.970588,1362089621200,1362089644688,1149313676,1149337164,23488
1362089650,2511028336,4,1650,412.5,1362089646618,1362089646682,2511024954,2511025018,64
1362089651,2511028740,1,137,137,1362089626544,1362089626544,2511004284,2511004284,0
1362089654,1149346576,7,1025,146.4285714,1362089648428,1362089648556,1149341004,1149341132,128
1362089654,1149346576,11,8640,785.4545455,1362089648939,1362089649067,1149341515,1149341643,128
1362089654,1149346588,29,34922,1204.206897,1362089648865,1362089648993,1149341453,1149341581,128
1362089654,1149346588,348,514145,1477.428161,1362089648993,1362089649825,1149341581,1149342413,832
1362089655,2511032824,1,46,46,1362089630488,1362089630488,2511008312,2511008312,0
1362089655,2511032892,11,3180,289.0909091,1362089628246,1362089629462,2511006138,2511007354,1216
1362089666,2511044268,6,1010,168.3333333,1362089646813,1362089663837,2511025081,2511042105,17024
1362089671,2511048840,1,52,52,1362089646281,1362089646281,2511024121,2511024121,0
1362089671,2511048956,1,52,52,1362089646359,1362089646359,2511024315,2511024315,0
1362089674,2511052264,3,502,167.3333333,1362089666081,1362089671201,2511044345,2511049465,5120
1362089674,2511052272,3,138,46,1362089659354,1362089673050,2511037626,2511051322,13696
1362089674,2511052276,5,395,79,1362089659608,1362089672984,2511037884,2511051260,13376
1362089674,2511052316,2,92,46,1362089673006,1362089673006,2511051322,2511051322,0
1362089674,2511052392,115,114337,994.2347826,1362089616548,1362089673188,2510994940,2511051580,56640
1362089676,1149368512,12,13077,1089.75,1362089649132,1362089673324,1149341644,1149365836,24192
1362089678,1149370580,2,92,46,1362089673322,1362089673322,1149365902,1149365902,0
1362089683,2511060924,1,137,137,1362089656948,1362089656948,2511034872,2511034872,0
1362089687,2511064876,2,265,132.5,1362089659494,1362089659558,2511037370,2511037434,64
1362089690,2511068364,4,1650,412.5,1362089683645,1362089683709,2511062009,2511062073,64
1362089699,2511076768,1,46,46,1362089674768,1362089674768,2511052536,2511052536,0
1362089699,2511076768,1,46,46,1362089674769,1362089674769,2511052537,2511052537,0
1362089699,2511076920,1,46,46,1362089673336,1362089673336,2511051256,2511051256,0
1362089699,2511076920,1,46,46,1362089673336,1362089673336,2511051256,2511051256,0
1362089699,2511076920,1,46,46,1362089673336,1362089673336,2511051256,2511051256,0
1362089699,2511076924,8,871,108.875,1362089673398,1362089673526,2511051322,2511051450,128
1362089699,2511077040,1,46,46,1362089673283,1362089673283,2511051323,2511051323,0
1362089706,2511084356,4,372,93,1362089683716,1362089698820,2511062072,2511077176,15104
1362089719,2511096880,1,137,137,1362089693665,1362089693665,2511071545,2511071545,0
1362089722,2511100348,11,11515,1046.818182,1362089711951,1362089717135,2511090299,2511095483,5184
1362089722,2511100356,14,14344,1024.571429,1362089712519,1362089717703,2511090875,2511096059,5184
1362089722,2511100356,8,5604,700.5,1362089712518,1362089717830,2511090874,2511096186,5312
1362089722,2511100356,5,1911,382.2,1362089712518,1362089717830,2511090874,2511096186,5312
1362089722,2511100356,13,13033,1002.538462,1362089712517,1362089717829,2511090873,2511096185,5312
1362089722,2511100400,4,752,188,1362089711896,1362089717080,2511090296,2511095480,5184
1362089722,2511100400,5,1374,274.8,1362089711960,1362089717080,2511090360,2511095480,5120
1362089722,2511100424,5,1362,272.4,1362089711872,1362089716992,2511090296,2511095416,5120
1362089722,2511100428,35,45367,1296.2,1362089711935,1362089717759,2511090363,2511096187,5824
1362089722,2511100432,9,7398,822,1362089712443,1362089717627,2511090875,2511096059,5184
1362089722,2511100432,4,1650,412.5,1362089720633,1362089720697,2511099065,2511099129,64
1362089722,2511100432,22,28029,1274.045455,1362089712441,1362089717561,2511090873,2511095993,5120
1362089735,2511112900,14,8985,641.7857143,1362089707661,1362089709581,2511085561,2511087481,1920
1362089738,2511116332,16,16533,1033.3125,1362089711772,1362089731996,2511090104,2511110328,20224
1362089738,2511116360,4,366,91.5,1362089720768,1362089735872,2511099128,2511114232,15104
1362089738,2511116452,7,1322,188.8571429,1362089712551,1362089732135,2511091003,2511110587,19584
1362089739,2511116840,6,2498,416.3333333,1362089711751,1362089711879,2511089591,2511089719,128
1362089739,2511116912,2,265,132.5,1362089714752,1362089714880,2511092664,2511092792,128
1362089739,2511116960,4,395,98.75,1362089711634,1362089711698,2511089594,2511089658,64
1362089740,1149432536,3,504,168,1362089714262,1362089714262,1149406798,1149406798,0
1362089747,2511124824,1,46,46,1362089722458,1362089722458,2511100282,2511100282,0
1362089747,2511124824,1,46,46,1362089722458,1362089722458,2511100282,2511100282,0
1362089747,2511124824,1,46,46,1362089722457,1362089722457,2511100281,2511100281,0
1362089747,2511124824,1,46,46,1362089722457,1362089722457,2511100281,2511100281,0
1362089747,2511124824,1,46,46,1362089722457,1362089722457,2511100281,2511100281,0
1362089747,2511124944,1,46,46,1362089722339,1362089722339,2511100283,2511100283,0
1362089747,2511124944,1,46,46,1362089722339,1362089722339,2511100283,2511100283,0
1362089747,2511124944,1,46,46,1362089722338,1362089722338,2511100282,2511100282,0
1362089747,2511124944,1,46,46,1362089722338,1362089722338,2511100282,2511100282,0
1362089747,2511124944,1,46,46,1362089722338,1362089722338,2511100282,2511100282,0
1362089747,2511124944,1,46,46,1362089722338,1362089722338,2511100282,2511100282,0
1362089751,2511128816,6,2562,427,1362089723105,1362089723169,2511100921,2511100985,64
1362089751,2511128816,11,3179,289,1362089723103,1362089723167,2511100919,2511100983,64
1362089755,2511132932,1,137,137,1362089730348,1362089730348,2511108280,2511108280,0
1362089762,2511140396,4,1650,412.5,1362089757727,1362089757791,2511136123,2511136187,64
1362089767,2511144936,1,46,46,1362089742378,1362089742378,2511120314,2511120314,0
1362089778,2511156476,4,366,91.5,1362089757709,1362089772813,2511136185,2511151289,15104
1362089779,2511156828,1,52,52,1362089754646,1362089754646,2511132474,2511132474,0
1362089779,2511156876,4,347,86.75,1362089753060,1362089753060,2511130936,2511130936,0
1362089783,2511160916,1,52,52,1362089756798,1362089756798,2511134714,2511134714,0
1362089783,2511160916,1,52,52,1362089756798,1362089756798,2511134714,2511134714,0
1362089784,1149476576,1,52,52,1362089759214,1362089759214,1149451790,1149451790,0
1362089791,2511168964,1,137,137,1362089762894,1362089762894,2511140858,2511140858,0
1362089795,2511172888,1,52,52,1362089768087,1362089768087,2511145975,2511145975,0
1362089795,2511173064,2,265,132.5,1362089769702,1362089769766,2511147766,2511147830,64
1362089799,2511177428,1,46,46,1362089774142,1362089774142,2511152570,2511152570,0
1362089802,2511180364,4,1650,412.5,1362089794813,1362089794877,2511173177,2511173241,64
1362089818,2511196360,4,366,91.5,1362089794945,1362089810049,2511173305,2511188409,15104
1362089823,2511201352,1,52,52,1362089797576,1362089797576,2511175928,2511175928,0
1362089827,2511205172,1,52,52,1362089799356,1362089799356,2511177528,2511177528,0
1362089827,2511205260,1,52,52,1362089801442,1362089801442,2511179702,2511179702,0
1362089827,2511205376,1,52,52,1362089801328,1362089801328,2511179704,2511179704,0
1362089831,2511209212,1,137,137,1362089805076,1362089805076,2511183288,2511183288,0
1362089832,1149524740,1,52,52,1362089804043,1362089804043,1149496783,1149496783,0
1362089834,2511212392,4,1650,412.5,1362089831838,1362089831902,2511210230,2511210294,64
1362089839,2511217324,1,52,52,1362089812707,1362089812707,2511191031,2511191031,0
1362089850,2511228368,4,366,91.5,1362089831927,1362089847031,2511210295,2511225399,15104
1362089851,2511229352,2,265,132.5,1362089825289,1362089825353,2511203641,2511203705,64
1362089867,2511245260,1,52,52,1362089842725,1362089842725,2511220985,2511220985,0
1362089871,2511249340,1,52,52,1362089844179,1362089844179,2511222519,2511222519,0
1362089871,2511249392,1,52,52,1362089846305,1362089846305,2511224697,2511224697,0
1362089871,2511249392,1,52,52,1362089846369,1362089846369,2511224761,2511224761,0
1362089871,2511249408,1,46,46,1362089846607,1362089846607,2511225015,2511225015,0
1362089874,2511252496,4,1650,412.5,1362089868792,1362089868856,2511247288,2511247352,64
1362089875,2511253284,1,137,137,1362089846987,1362089846987,2511225271,2511225271,0
1362089876,1149568736,1,52,52,1362089849103,1362089849103,1149541839,1149541839,0
1362089883,2511261284,1,52,52,1362089857741,1362089857741,2511236025,2511236025,0
1362089890,2511268512,4,366,91.5,1362089868839,1362089883943,2511247351,2511262455,15104
1362089903,2511281512,1,137,137,1362089877925,1362089877925,2511256437,2511256437,0
1362089907,2511285360,2,265,132.5,1362089880384,1362089880512,2511258744,2511258872,128
1362089914,2511292420,4,1650,412.5,1362089905924,1362089905988,2511284344,2511284408,64
1362089915,2511293248,1,52,52,1362089887726,1362089887726,2511265974,2511265974,0
1362089915,2511293284,1,52,52,1362089889227,1362089889227,2511267511,2511267511,0
1362089919,2511297304,1,52,52,1362089891447,1362089891447,2511269751,2511269751,0
1362089919,2511297304,1,52,52,1362089891446,1362089891446,2511269750,2511269750,0
1362089920,1149612764,1,52,52,1362089894065,1362089894065,1149586829,1149586829,0
1362089922,2511300480,4,372,93,1362089905926,1362089921030,2511284406,2511299510,15104
1362089931,2511309196,1,52,52,1362089902881,1362089902881,2511281077,2511281077,0
1362089943,2511321324,1,137,137,1362089918432,1362089918432,2511296756,2511296756,0
1362089946,2511324508,4,1650,412.5,1362089942889,1362089942953,2511321397,2511321461,64
1362089950,1149642792,123,178829,1453.894309,1362089648343,1362089648663,1149341135,1149341455,320
1362089954,2511332460,4,280,70,1362089936282,1362089951194,2511314742,2511329654,14912
1362089954,2511332552,4,280,70,1362089936256,1362089951168,2511314808,2511329720,14912
1362089954,2511332556,5,326,65.2,1362089934009,1362089948921,2511312565,2511327477,14912
1362089959,2511337284,1,52,52,1362089932745,1362089932745,2511311029,2511311029,0
1362089962,2511340428,180,134366,746.4777778,1362089706298,1362089955578,2511084726,2511334006,249280
1362089962,2511340512,4,366,91.5,1362089942951,1362089958055,2511321463,2511336567,15104
1362089963,2511341288,2,265,132.5,1362089935879,1362089935943,2511314167,2511314231,64
1362089964,1149656804,1,52,52,1362089939019,1362089939019,1149631823,1149631823,0
1362089970,2511348456,4,280,70,1362089947615,1362089962527,2511326071,2511340983,14912
1362089983,2511361292,1,137,137,1362089955649,1362089955649,2511333941,2511333941,0
1362089986,2511364448,4,1650,412.5,1362089979940,1362089980004,2511358388,2511358452,64
1362089987,2511364876,2,98,49,1362089978146,1362089983394,2511356022,2511361270,5248
1362089987,2511365356,1,46,46,1362089961345,1362089961345,2511339701,2511339701,0
1362089987,2511365448,1,46,46,1362089961252,1362089961252,2511339700,2511339700,0
1362089999,2511377356,3,1312,437.3333333,1362089972672,1362089972736,2511351028,2511351092,64
1362089999,2511377440,1,46,46,1362089971244,1362089971244,2511349684,2511349684,0
1362089999,2511377480,5,2009,401.8,1362089972486,1362089972614,2511350966,2511351094,128
1362089999,2511377480,3,1002,334,1362089972550,1362089972614,2511351030,2511351094,64
1362089999,2511377484,10,11575,1157.5,1362089972675,1362089972739,2511351159,2511351223,64
1362089999,2511377484,22,27528,1251.272727,1362089972801,1362089972865,2511351285,2511351349,64
1362090002,2511380512,4,372,93,1362089980003,1362089995107,2511358515,2511373619,15104
1362090008,1149701032,1,46,46,1362089982821,1362089982821,1149675853,1149675853,0
1362090011,2511389452,8,871,108.875,1362089982880,1362089983008,2511361332,2511361460,128
1362090018,2511396504,4,1650,412.5,1362090016941,1362090017069,2511395445,2511395573,128
1362090019,2511397356,2,265,132.5,1362089991555,1362089991619,2511369911,2511369975,64
1362090023,2511401312,1,137,137,1362089994859,1362089994859,2511373171,2511373171,0
1362090034,2511412556,4,366,91.5,1362090017015,1362090032119,2511395571,2511410675,15104
1362090055,2511433368,1,137,137,1362090027126,1362090027126,2511405494,2511405494,0
1362090055,2511433400,1,52,52,1362090028053,1362090028053,2511406453,2511406453,0
1362090059,2511436624,4,1650,412.5,1362090054877,1362090054941,2511432501,2511432565,64
1362090074,2511452500,4,372,93,1362090054127,1362090069231,2511432627,2511447731,15104
1362090075,2511453524,2,265,132.5,1362090046742,1362090046806,2511425266,2511425330,64
1362090091,2511469468,1,137,137,1362090064209,1362090064209,2511442677,2511442677,0
1362090098,2511476488,4,1650,412.5,1362090091130,1362090091194,2511469618,2511469682,64
1362090100,2511477624,1,52,52,1362090073883,1362090073883,2511451507,2511451507,0
1362090115,2511492604,4,366,91.5,1362090092078,1362090107182,2511469682,2511484786,15104
1362090124,2511501608,1,137,137,1362090096747,1362090096747,2511474355,2511474355,0
1362090128,2511505664,2,265,132.5,1362090103282,1362090103410,2511480946,2511481074,128
1362090131,2511508656,4,1650,412.5,1362090128954,1362090129082,2511506610,2511506738,128
1362090144,2511521772,1,52,52,1362090118792,1362090118792,2511496564,2511496564,0
1362090147,2511524632,4,366,91.5,1362090129108,1362090144212,2511506740,2511521844,15104
1362090156,2511533616,1,137,137,1362090129892,1362090129892,2511507508,2511507508,0
1362090171,2511548576,4,1650,412.5,1362090166090,1362090166154,2511543666,2511543730,64
1362090184,2511561620,2,265,132.5,1362090158622,1362090158686,2511536242,2511536306,64
1362090187,2511564592,4,366,91.5,1362090166136,1362090181240,2511543728,2511558832,15104
1362090192,2511569584,1,52,52,1362090164036,1362090164036,2511541620,2511541620,0
1362090192,2511569620,1,137,137,1362090165533,1362090165533,2511543153,2511543153,0
1362090211,2511588588,4,1650,412.5,1362090203132,1362090203196,2511580720,2511580784,64
1362090219,2511596588,4,372,93,1362090203198,1362090218302,2511580786,2511595890,15104
1362090224,2511601752,1,137,137,1362090197082,1362090197082,2511574834,2511574834,0
1362090227,2511604612,5,326,65.2,1362090208997,1362090223909,2511586609,2511601521,14912
1362090228,2511605700,4,2200,550,1362090200780,1362090201228,2511578480,2511578928,448
1362090228,2511605820,18,19923,1106.833333,1362090200342,1362090201046,2511578162,2511578866,704
1362090240,2511617812,2,265,132.5,1362090213982,1362090214046,2511591794,2511591858,64
1362090243,2511620584,4,1650,412.5,1362090240194,1362090240258,2511617778,2511617842,64
1362090259,2511636772,4,366,91.5,1362090240132,1362090255172,2511617904,2511632944,15040
1362090260,2511637780,1,137,137,1362090232316,1362090232316,2511610096,2511610096,0
1362090272,2511649728,1,46,46,1362090246191,1362090246191,2511623919,2511623919,0
1362090272,2511649728,1,46,46,1362090246258,1362090246258,2511623986,2511623986,0
1362090283,2511660804,4,1650,412.5,1362090277028,1362090277092,2511654832,2511654896,64
1362090296,2511673864,2,265,132.5,1362090269543,1362090269607,2511647407,2511647471,64
1362090299,2511676716,3,138,46,1362090291516,1362090294076,2511669232,2511671792,2560
1362090299,2511676824,3,138,46,1362090291345,1362090293969,2511669169,2511671793,2624
1362090299,2511676836,4,366,91.5,1362090277062,1362090292166,2511654898,2511670002,15104
1362090300,2511677964,1,137,137,1362090273093,1362090273093,2511651057,2511651057,0
1362090304,2511681940,3,885,295,1362090276958,1362090276958,2511654898,2511654898,0
1362090315,2511692760,4,1650,412.5,1362090314130,1362090314194,2511691890,2511691954,64
1362090320,2511698072,8,871,108.875,1362090293784,1362090293848,2511671856,2511671920,64
1362090331,2511709084,4,366,91.5,1362090313868,1362090328972,2511691952,2511707056,15104
1362090340,2511718124,1,137,137,1362090313508,1362090313508,2511691632,2511691632,0
1362090352,2511730104,2,265,132.5,1362090325047,1362090325111,2511703151,2511703215,64
1362090355,2511732796,4,1650,412.5,1362090351149,1362090351213,2511728945,2511729009,64
1362090364,2511742084,1,52,52,1362090338893,1362090338893,2511716977,2511716977,0
1362090371,2511748800,4,366,91.5,1362090351209,1362090366313,2511729009,2511744113,15104
1362090372,2511750012,1,137,137,1362090344659,1362090344659,2511722671,2511722671,0
1362090395,2511772820,4,1650,412.5,1362090388179,1362090388243,2511765999,2511766063,64
1362090396,2511774248,4,731,182.75,1362090370214,1362090370470,2511748462,2511748718,256
1362090408,2511786096,1,137,137,1362090380544,1362090380544,2511758640,2511758640,0
1362090408,2511786276,2,265,132.5,1362090380490,1362090380554,2511758766,2511758830,64
1362090411,2511788748,4,372,93,1362090388315,1362090403419,2511766063,2511781167,15104
1362090412,2511790080,1,52,52,1362090383949,1362090383949,2511762029,2511762029,0
1362090427,2511804884,4,1650,412.5,1362090425169,1362090425233,2511803053,2511803117,64
1362090440,2511818308,1,46,46,1362090415468,1362090415468,2511793776,2511793776,0
1362090443,2511820888,4,366,91.5,1362090425231,1362090440335,2511803119,2511818223,15104
1362090444,2511822208,1,137,137,1362090418320,1362090418320,2511796528,2511796528,0
1362090456,2511834564,1,52,52,1362090428457,1362090428457,2511807021,2511807021,0
1362090464,2511842468,2,265,132.5,1362090436296,1362090436424,2511814764,2511814892,128
1362090467,2511844844,4,1650,412.5,1362090462200,1362090462264,2511840044,2511840108,64
1362090483,2511860848,4,366,91.5,1362090462327,1362090477431,2511840175,2511855279,15104
1362090488,2511866500,1,46,46,1362090460267,1362090460267,2511838767,2511838767,0
1362090488,2511866528,1,137,137,1362090461198,1362090461198,2511839726,2511839726,0
1362090500,2511878540,1,52,52,1362090473537,1362090473537,2511852077,2511852077,0
1362090507,2511884904,4,1650,412.5,1362090499196,1362090499260,2511877100,2511877164,64
1362090508,2511886568,9,3839,426.5555556,1362090481509,1362090481573,2511860077,2511860141,64
1362090515,2511892908,4,366,91.5,1362090499323,1362090514363,2511877231,2511892271,15040
1362090516,2511894472,2,265,132.5,1362090491718,1362090491846,2511870190,2511870318,128
1362090516,2511894504,3,408,136,1362090490340,1362090496292,2511868844,2511874796,5952
1362090528,2511906532,1,137,137,1362090502279,1362090502279,2511880811,2511880811,0
1362090533,2511910592,1,46,46,1362090506228,1362090506228,2511883820,2511883820,0
1362090539,2511916984,4,1650,412.5,1362090536175,1362090536239,2511914159,2511914223,64
1362090539,2511917032,5,326,65.2,1362090519099,1362090533947,2511897131,2511911979,14848
1362090552,2511930480,1,52,52,1362090526718,1362090526718,2511905198,2511905198,0
1362090555,2511932832,4,366,91.5,1362090536451,1362090551555,2511914283,2511929387,15104
1362090571,2511948836,1,137,137,1362090544450,1362090544450,2511922286,2511922286,0
1362090573,2511950652,2,265,132.5,1362090548536,1362090548600,2511926188,2511926252,64
1362090577,2511954580,1,46,46,1362090551298,1362090551298,2511928878,2511928878,0
1362090579,2511956940,4,1650,412.5,1362090573272,1362090573336,2511951212,2511951276,64
1362090595,2511972872,4,372,93,1362090573403,1362090588507,2511951275,2511966379,15104
1362090597,2511974644,1,52,52,1362090572544,1362090572544,2511950188,2511950188,0
1362090604,2511982452,8,5022,627.75,1362090576024,1362090603352,2511954476,2511981804,27328
1362090605,2511982572,3,576,192,1362090577160,1362090604232,2511954732,2511981804,27072
1362090609,2511986596,3,886,295.3333333,1362090581297,1362090581297,2511958893,2511958893,0
1362090609,2511986600,1,137,137,1362090581804,1362090581804,2511959404,2511959404,0
1362090611,2511988928,3,138,46,1362090596003,1362090603875,2511973931,2511981803,7872
1362090611,2511989072,4,1650,412.5,1362090610196,1362090610260,2511988268,2511988332,64
1362090627,2512004932,4,366,91.5,1362090610462,1362090625566,2511988394,2512003498,15104
1362090629,2512006852,1,46,46,1362090603950,1362090603950,2511981802,2511981802,0
1362090629,2512006856,8,870,108.75,1362090604012,1362090604076,2511981868,2511981932,64
1362090629,2512006964,2,265,132.5,1362090603774,1362090603838,2511981738,2511981802,64
1362090641,2512018908,18,18815,1045.277778,1362090615607,1362090617143,2511993515,2511995051,1536
1362090641,1150333788,3,1058,352.6666667,1362090616863,1362090616863,1150309651,1150309651,0
1362090645,2512022832,1,137,137,1362090619522,1362090619522,2511997354,2511997354,0
1362090645,2512022872,4,2962,740.5,1362090618010,1362090618202,2511995882,2511996074,192
1362090645,1150337752,12,12926,1077.166667,1362090617221,1362090617477,1150309973,1150310229,256
1362090651,2512029016,4,1650,412.5,1362090647307,1362090647371,2512025323,2512025387,64
1362090667,2512044940,4,372,93,1362090647511,1362090662551,2512025451,2512040491,15040
1362090677,2512054868,1,52,52,1362090649119,1362090649119,2512026987,2512026987,0
1362090681,2512058868,1,137,137,1362090653917,1362090653917,2512031785,2512031785,0
1362090683,2512061040,2,98,49,1362090662964,1362090677172,2512041004,2512055212,14208
1362090685,2512062924,2,265,132.5,1362090659813,1362090659877,2512037737,2512037801,64
1362090689,2512066884,4,725,181.25,1362090662159,1362090679247,2512040043,2512057131,17088
1362090689,1150382020,1,52,52,1362090661687,1362090661687,1150354707,1150354707,0
1362090689,1150382020,1,52,52,1362090662199,1362090662199,1150355219,1150355219,0
1362090691,2512068952,4,1650,412.5,1362090684425,1362090684489,2512062377,2512062441,64
1362090707,2512084948,4,366,91.5,1362090684558,1362090699662,2512062506,2512077610,15104
1362090713,2512091096,1,46,46,1362090686970,1362090686970,2512065066,2512065066,0
1362090721,2512098956,1,52,52,1362090694021,1362090694021,2512071977,2512071977,0
1362090723,2512101000,4,1650,412.5,1362090721433,1362090721497,2512099433,2512099497,64
1362090725,2512103116,1,137,137,1362090697637,1362090697637,2512075753,2512075753,0
1362090733,1150426012,1,52,52,1362090706689,1362090706689,1150399701,1150399701,0
1362090733,1150426012,1,52,52,1362090707263,1362090707263,1150400275,1150400275,0
1362090739,2512117080,4,366,91.5,1362090721419,1362090736523,2512099499,2512114603,15104
1362090741,2512118984,2,265,132.5,1362090715051,1362090715115,2512093035,2512093099,64
1362090749,2512127128,1,46,46,1362090724057,1362090724057,2512102185,2512102185,0
1362090763,2512140972,4,1650,412.5,1362090758517,1362090758581,2512136489,2512136553,64
1362090765,2512142984,1,52,52,1362090739050,1362090739050,2512117034,2512117034,0
1362090769,2512147452,1,137,137,1362090741908,1362090741908,2512120360,2512120360,0
1362090777,1150470028,1,52,52,1362090751665,1362090751665,1150444693,1150444693,0
1362090777,1150470032,1,52,52,1362090752235,1362090752235,1150445267,1150445267,0
1362090779,2512156996,4,366,91.5,1362090758557,1362090773661,2512136553,2512151657,15104
1362090797,2512175404,1,46,46,1362090768838,1362090768838,2512147242,2512147242,0
1362090797,2512175408,2,265,132.5,1362090770562,1362090770626,2512148970,2512149034,64
1362090803,2512181036,4,1650,412.5,1362090795511,1362090795575,2512173547,2512173611,64
1362090805,2512183456,1,137,137,1362090777491,1362090777491,2512155947,2512155947,0
1362090809,2512187364,1,52,52,1362090783724,1362090783724,2512162088,2512162088,0
1362090811,2512189012,4,366,91.5,1362090795660,1362090810764,2512173672,2512188776,15104
1362090821,1150514072,1,52,52,1362090796612,1362090796612,1150489684,1150489684,0
1362090825,1150517992,1,52,52,1362090797270,1362090797270,1150490262,1150490262,0
1362090835,2512213100,4,1650,412.5,1362090832502,1362090832566,2512210602,2512210666,64
1362090841,2512219320,6,2081,346.8333333,1362090813144,1362090813464,2512191464,2512191784,320
1362090841,2512219332,1,46,46,1362090813966,1362090813966,2512192298,2512192298,0
1362090841,2512219396,1,137,137,1362090815564,1362090815564,2512193960,2512193960,0
1362090841,2512219416,11,4231,384.6363636,1362090812857,1362090812985,2512191273,2512191401,128
1362090851,2512229084,4,372,93,1362090832580,1362090847684,2512210664,2512225768,15104
1362090851,2512229156,5,326,65.2,1362090828988,1362090843836,2512207144,2512221992,14848
1362090853,2512231464,2,265,132.5,1362090826058,1362090826122,2512204522,2512204586,64
1362090870,1150562304,1,52,52,1362090842949,1362090842949,1150535253,1150535253,0
1362090870,1150562344,1,52,52,1362090842334,1362090842334,1150534678,1150534678,0
1362090875,2512253128,4,1650,412.5,1362090869530,1362090869594,2512247658,2512247722,64
1362090875,2512253160,2,98,49,1362090858489,1362090874425,2512236649,2512252585,15936
1362090877,2512255400,1,137,137,1362090849609,1362090849609,2512228009,2512228009,0
1362090885,2512263492,1,46,46,1362090858794,1362090858794,2512237286,2512237286,0
1362090885,2512263536,1,52,52,1362090857854,1362090857854,2512236390,2512236390,0
1362090891,2512269124,4,366,91.5,1362090869594,1362090884698,2512247718,2512262822,15104
1362090907,2512285156,4,1650,412.5,1362090906557,1362090906621,2512284713,2512284777,64
1362090909,2512287400,1,46,46,1362090883207,1362090883207,2512261607,2512261607,0
1362090909,2512287444,3,886,295.3333333,1362090884442,1362090884442,2512262886,2512262886,0
1362090909,2512287492,2,265,132.5,1362090881516,1362090881580,2512260008,2512260072,64
1362090914,1150606316,1,52,52,1362090887417,1362090887417,1150579733,1150579733,0
1362090914,1150606316,1,52,52,1362090887991,1362090887991,1150580307,1150580307,0
1362090915,2512293156,2,98,49,1362090903291,1362090914171,2512281447,2512292327,10880
1362090915,2512293192,3,138,46,1362090904152,1362090914136,2512282344,2512292328,9984
1362090921,2512299504,1,137,137,1362090893151,1362090893151,2512271655,2512271655,0
1362090923,2512301084,4,366,91.5,1362090906690,1362090921794,2512284774,2512299878,15104
1362090941,2512319556,7,825,117.8571429,1362090913833,1362090913897,2512292389,2512292453,64
1362090942,1150634308,1,46,46,1362090914563,1362090914563,1150606871,1150606871,0
1362090942,1150634308,1,46,46,1362090914563,1362090914563,1150606871,1150606871,0
1362090947,2512325152,4,1650,412.5,1362090943551,1362090943615,2512321703,2512321767,64
1362090950,2512327656,26,23482,903.1538462,1362090923309,1362090944685,2512300965,2512322341,21376
1362090953,2512331492,1,137,137,1362090924908,1362090924908,2512303400,2512303400,0
1362090962,2512339620,2,265,132.5,1362090937747,1362090937811,2512315367,2512315431,64
1362090963,2512341132,4,366,91.5,1362090943698,1362090958802,2512321830,2512336934,15104
1362090970,2512347612,4,2239,559.75,1362090944473,1362090944665,2512322085,2512322277,192
1362090970,2512347624,4,2520,630,1362090945293,1362090945421,2512322917,2512323045,128
1362090970,2512347708,4,2239,559.75,1362090944316,1362090944508,2512322024,2512322216,192
1362090970,1150662332,12,12926,1077.166667,1362090944744,1362090944936,1150637076,1150637268,192
1362090970,1150662380,3,1058,352.6666667,1362090944570,1362090944570,1150636950,1150636950,0
1362090986,2512363600,1,52,52,1362090959912,1362090959912,2512337512,2512337512,0
1362090987,2512365240,4,1650,412.5,1362090980581,1362090980645,2512358821,2512358885,64
1362090994,2512371792,1,137,137,1362090969573,1362090969573,2512347365,2512347365,0
1362091003,2512381132,4,366,91.5,1362090980817,1362090995921,2512358949,2512374053,15104
1362091011,2512389220,2,98,49,1362090989754,1362091004218,2512367974,2512382438,14464
1362091014,2512391656,1,46,46,1362090989612,1362090989612,2512367268,2512367268,0
1362091014,2512391780,1,46,46,1362090989552,1362090989552,2512367332,2512367332,0
1362091014,2512391780,1,46,46,1362090989556,1362090989556,2512367336,2512367336,0
1362091014,1150706444,1,52,52,1362090989563,1362090989563,1150682007,1150682007,0
1362091018,1150710368,1,52,52,1362090989957,1362090989957,1150682325,1150682325,0
1362091018,2512395776,2,265,132.5,1362090993272,1362090993336,2512371048,2512371112,64
1362091019,2512397180,4,1650,412.5,1362091017635,1362091017699,2512395815,2512395879,64
1362091026,2512403676,1,137,137,1362091001434,1362091001434,2512379110,2512379110,0
1362091030,2512407816,1,52,52,1362091004748,1362091004748,2512382564,2512382564,0
1362091035,2512413108,4,366,91.5,1362091017835,1362091032875,2512395943,2512410983,15040
1362091042,2512419616,1,46,46,1362091014615,1362091014615,2512392231,2512392231,0
1362091058,2512435812,1,137,137,1362091033491,1362091033491,2512411303,2512411303,0
1362091059,2512437168,4,1650,412.5,1362091054701,1362091054765,2512432869,2512432933,64
1362091062,2512439660,1,46,46,1362091034667,1362091034667,2512412327,2512412327,0
1362091062,2512439660,1,46,46,1362091034731,1362091034731,2512412391,2512412391,0
1362091062,2512439776,1,46,46,1362091034614,1362091034614,2512412390,2512412390,0
1362091062,1150754468,1,52,52,1362091034529,1362091034529,1150726997,1150726997,0
1362091062,1150754520,1,52,52,1362091034799,1362091034799,1150727319,1150727319,0
1362091074,2512451648,2,265,132.5,1362091048628,1362091048692,2512426276,2512426340,64
1362091075,2512453216,4,372,93,1362091054781,1362091069821,2512432997,2512448037,15040
1362091078,2512455612,1,52,52,1362091050010,1362091050010,2512427622,2512427622,0
1362091090,2512467776,1,137,137,1362091063860,1362091063860,2512441636,2512441636,0
1362091099,2512477228,4,1650,412.5,1362091091696,1362091091760,2512469924,2512469988,64
1362091106,2512483676,1,46,46,1362091079768,1362091079768,2512457444,2512457444,0
1362091106,2512483796,1,46,46,1362091079583,1362091079583,2512457379,2512457379,0
1362091106,2512483796,1,46,46,1362091079586,1362091079586,2512457382,2512457382,0
1362091106,1150798464,1,52,52,1362091079847,1362091079847,1150772311,1150772311,0
1362091106,1150798504,1,52,52,1362091079486,1362091079486,1150771990,1150771990,0
1362091115,2512493236,4,366,91.5,1362091091817,1362091106857,2512470053,2512485093,15040
1362091122,2512499840,1,52,52,1362091094774,1362091094774,2512472614,2512472614,0
1362091122,2512499932,1,137,137,1362091097305,1362091097305,2512475237,2512475237,0
1362091130,2512507872,2,265,132.5,1362091103894,1362091103958,2512481766,2512481830,64
1362091131,2512509192,4,1650,412.5,1362091128788,1362091128916,2512506980,2512507108,128
1362091147,2512525304,4,372,93,1362091128804,1362091143908,2512507108,2512522212,15104
1362091150,2512527924,1,46,46,1362091124513,1362091124513,2512502437,2512502437,0
1362091150,2512527928,1,46,46,1362091124509,1362091124509,2512502437,2512502437,0
1362091150,2512527928,1,46,46,1362091124571,1362091124571,2512502499,2512502499,0
1362091150,1150842528,1,52,52,1362091124453,1362091124453,1150816981,1150816981,0
1362091150,1150842532,1,52,52,1362091124769,1362091124769,1150817301,1150817301,0
1362091155,2512533312,5,326,65.2,1362091139354,1362091154202,2512517666,2512532514,14848
1362091166,2512543768,1,137,137,1362091140026,1362091140026,2512517794,2512517794,0
1362091171,2512549252,4,1650,412.5,1362091165783,1362091165847,2512544035,2512544099,64
1362091186,2512563844,2,265,132.5,1362091159470,1362091159598,2512537314,2512537442,128
1362091187,2512565340,4,366,91.5,1362091165759,1362091180863,2512544099,2512559203,15104
1362091194,2512571920,4,2296,574,1362091169571,1362091185507,2512547491,2512563427,15936
1362091194,2512571920,17,19258,1132.823529,1362091169634,1362091185634,2512547554,2512563554,16000
1362091194,1150886560,1,52,52,1362091169416,1362091169416,1150861976,1150861976,0
1362091194,2512572036,1,46,46,1362091169389,1362091169389,2512547425,2512547425,0
1362091194,1150886608,1,52,52,1362091169685,1362091169685,1150862293,1150862293,0
1362091202,2512579996,1,137,137,1362091176407,1362091176407,2512554403,2512554403,0
1362091203,2512581284,4,1650,412.5,1362091202807,1362091202871,2512581091,2512581155,64
1362091214,2512591948,3,883,294.3333333,1362091188935,1362091188999,2512566883,2512566947,64
1362091219,2512597268,4,366,91.5,1362091202886,1362091217990,2512581154,2512596258,15104
1362091227,2512605276,3,138,46,1362091214206,1362091223614,2512592482,2512601890,9408
1362091227,2512605312,2,92,46,1362091223580,1362091223580,2512601892,2512601892,0
1362091227,2512605384,2,92,46,1362091223505,1362091223505,2512601889,2512601889,0
1362091231,1150923172,2,98,49,1362091215177,1362091224265,1150907349,1150916437,9088
1362091231,1150923184,2,98,49,1362091214846,1362091224254,1150907030,1150916438,9408
1362091242,2512619896,2,265,132.5,1362091215355,1362091215419,2512593251,2512593315,64
1362091242,2512619936,1,137,137,1362091216786,1362091216786,2512594722,2512594722,0
1362091243,2512621404,4,1650,412.5,1362091239743,1362091239807,2512618147,2512618211,64
1362091250,2512628016,8,871,108.875,1362091223873,1362091224001,2512601889,2512602017,128
1362091259,2512637340,4,372,93,1362091239935,1362091255039,2512618275,2512633379,15104
1362091274,2512652100,1,137,137,1362091248557,1362091248557,2512626657,2512626657,0
1362091283,2512661440,4,1650,412.5,1362091276763,1362091276827,2512655203,2512655267,64
1362091294,2512672252,1,52,52,1362091268757,1362091268757,2512647009,2512647009,0
1362091298,2512676192,2,265,132.5,1362091270611,1362091270675,2512648803,2512648867,64
1362091299,2512677356,4,372,93,1362091276974,1362091292078,2512655330,2512670434,15104
1362091302,2512680244,4,731,182.75,1362091276446,1362091276638,2512654690,2512654882,192
1362091310,2512688196,1,137,137,1362091281999,1362091281999,2512660195,2512660195,0
1362091315,2512693356,4,1650,412.5,1362091313903,1362091313967,2512692259,2512692323,64
1362091331,2512709324,4,366,91.5,1362091313999,1362091329103,2512692323,2512707427,15104
1362091338,2512716148,9,4110,456.6666667,1362091310267,1362091310331,2512688415,2512688479,64
1362091338,2512716148,18,10293,571.8333333,1362091310398,1362091310526,2512688546,2512688674,128
1362091342,2512720160,1,52,52,1362091313904,1362091313904,2512692064,2512692064,0
1362091346,2512724232,1,46,46,1362091321704,1362091321704,2512699936,2512699936,0
1362091350,2512728372,2,265,132.5,1362091325596,1362091325660,2512703968,2512704032,64
1362091354,2512732176,1,137,137,1362091326944,1362091326944,2512705120,2512705120,0
1362091355,2512733344,4,1650,412.5,1362091350967,1362091351031,2512729311,2512729375,64
1362091371,2512749352,4,366,91.5,1362091351025,1362091366129,2512729377,2512744481,15104
1362091382,2512760304,1,52,52,1362091355422,1362091355422,2512733726,2512733726,0
1362091382,2512760408,1,52,52,1362091355128,1362091355128,2512733536,2512733536,0
1362091386,2512764308,1,52,52,1362091358811,1362091358811,2512737119,2512737119,0
1362091394,2512772392,1,137,137,1362091365894,1362091365894,2512744286,2512744286,0
1362091394,2512772420,1,46,46,1362091366572,1362091366572,2512744992,2512744992,0
1362091395,2512773428,4,1650,412.5,1362091387939,1362091388003,2512766367,2512766431,64
1362091406,2512784408,2,265,132.5,1362091381432,1362091381496,2512759840,2512759904,64
1362091411,2512789560,4,366,91.5,1362091387871,1362091402975,2512766431,2512781535,15104
1362091422,2512800420,1,137,137,1362091397290,1362091397290,2512775710,2512775710,0
1362091426,2512804564,1,52,52,1362091399963,1362091399963,2512778527,2512778527,0
1362091427,2512804688,1,52,52,1362091401032,1362091401032,2512778720,2512778720,0
1362091427,2512805512,4,1650,412.5,1362091424913,1362091424977,2512803425,2512803489,64
1362091431,2512808640,1,52,52,1362091404472,1362091404472,2512782112,2512782112,0
1362091438,2512816544,17,17431,1025.352941,1362091411502,1362091420782,2512790046,2512799326,9280
1362091443,2512821520,4,366,91.5,1362091424968,1362091440072,2512803488,2512818592,15104
1362091463,2512840608,2,265,132.5,1362091437335,1362091437399,2512814943,2512815007,64
1362091467,2512844708,1,137,137,1362091440244,1362091440244,2512817952,2512817952,0
1362091467,2512845516,5,326,65.2,1362091448650,1362091463562,2512827166,2512842078,14912
1362091467,2512845524,4,1650,412.5,1362091461891,1362091461955,2512840415,2512840479,64
1362091471,2512848712,1,52,52,1362091445870,1362091445870,2512823582,2512823582,0
1362091471,2512848716,1,52,52,1362091446060,1362091446060,2512823776,2512823776,0
1362091483,2512861412,4,366,91.5,1362091462130,1362091477234,2512840542,2512855646,15104
1362091491,2512868676,1,46,46,1362091466706,1362091466706,2512844382,2512844382,0
1362091499,2512876728,1,137,137,1362091471261,1362091471261,2512848989,2512848989,0
1362091507,2512885512,4,1650,412.5,1362091498958,1362091499022,2512877470,2512877534,64
1362091515,2512893524,4,366,91.5,1362091499075,1362091514179,2512877599,2512892703,15104
1362091519,2512896644,1,52,52,1362091490928,1362091490928,2512868572,2512868572,0
1362091519,2512896652,1,52,52,1362091491114,1362091491114,2512868766,2512868766,0
1362091519,2512896688,2,265,132.5,1362091492358,1362091492422,2512870046,2512870110,64
1362091519,2512896812,3,885,295,1362091493130,1362091493130,2512870942,2512870942,0
1362091539,2512916764,1,137,137,1362091511290,1362091511290,2512889054,2512889054,0
1362091539,2512916768,3,138,46,1362091511605,1362091534069,2512889373,2512911837,22464
1362091539,2512917492,4,1650,412.5,1362091536033,1362091536097,2512914525,2512914589,64
1362091555,2512933544,4,366,91.5,1362091536110,1362091551214,2512914654,2512929758,15104
1362091559,2512936728,1,46,46,1362091534047,1362091534047,2512911775,2512911775,0
1362091559,2512936848,1,46,46,1362091533927,1362091533927,2512911775,2512911775,0
1362091559,2512936848,8,871,108.875,1362091534052,1362091534116,2512911900,2512911964,64
1362091575,2512952680,2,265,132.5,1362091547789,1362091547853,2512925469,2512925533,64
1362091580,2512957612,4,1650,412.5,1362091573969,1362091574033,2512951581,2512951645,64
1362091583,2512961088,1,137,137,1362091554740,1362091554740,2512932828,2512932828,0
1362091596,2512973636,4,366,91.5,1362091574071,1362091589175,2512951707,2512966811,15104
1362091607,2512984964,1,52,52,1362091579056,1362091579056,2512957020,2512957020,0
1362091611,2512989012,1,137,137,1362091585154,1362091585154,2512963166,2512963166,0
1362091612,2512989660,4,1650,412.5,1362091610976,1362091611040,2512988636,2512988700,64
1362091627,2513005504,2,265,132.5,1362091602326,1362091602390,2512980830,2512980894,64
1362091627,2513005560,4,372,93,1362091610139,1362091625243,2512988699,2513003803,15104
1362091651,2513029236,1,52,52,1362091623777,1362091623777,2513002013,2513002013,0
1362091651,2513029272,4,731,182.75,1362091624956,1362091625276,2513003228,2513003548,320
1362091651,2513029276,1,137,137,1362091625209,1362091625209,2513003485,2513003485,0
1362091651,2513029532,4,1650,412.5,1362091647160,1362091647224,2513025692,2513025756,64
1362091668,2513045656,4,366,91.5,1362091648101,1362091663205,2513025757,2513040861,15104
1362091683,2513061252,1,137,137,1362091655950,1362091655950,2513034202,2513034202,0
1362091683,2513061316,2,265,132.5,1362091658064,1362091658128,2513036380,2513036444,64
1362091692,2513069732,4,1650,412.5,1362091685014,1362091685078,2513062746,2513062810,64
1362091695,2513073296,1,52,52,1362091668773,1362091668773,2513047069,2513047069,0
1362091695,2513073456,1,46,46,1362091670148,1362091670148,2513048604,2513048604,0
1362091708,2513086028,4,372,93,1362091684784,1362091699888,2513062812,2513077916,15104
1362091724,2513101784,4,1650,412.5,1362091722017,1362091722081,2513099801,2513099865,64
1362091727,2513105308,1,137,137,1362091699736,1362091699736,2513078044,2513078044,0
1362091739,2513117488,1,52,52,1362091713636,1362091713636,2513092124,2513092124,0
1362091740,2513117580,2,265,132.5,1362091714541,1362091714605,2513092121,2513092185,64
1362091740,2513117748,4,366,91.5,1362091722117,1362091737221,2513099865,2513114969,15104
1362091743,2513121392,1,46,46,1362091715267,1362091715267,2513093659,2513093659,0
1362091764,2513141788,4,1650,412.5,1362091759069,1362091759133,2513136857,2513136921,64
1362091767,2513145504,1,137,137,1362091742609,1362091742609,2513121113,2513121113,0
1362091780,2513157816,4,366,91.5,1362091759107,1362091774211,2513136923,2513152027,15104
1362091780,2513157816,5,326,65.2,1362091759297,1362091774209,2513137113,2513152025,14912
1362091787,2513165548,1,46,46,1362091760166,1362091760166,2513138714,2513138714,0
1362091795,2513173516,2,265,132.5,1362091768967,1362091769031,2513147483,2513147547,64
1362091804,2513181872,4,1650,412.5,1362091796043,1362091796107,2513173915,2513173979,64
1362091808,2513185648,1,137,137,1362091783464,1362091783464,2513161112,2513161112,0
1362091812,2513189848,4,372,93,1362091796129,1362091811233,2513173977,2513189081,15104
1362091823,2513201484,3,886,295.3333333,1362091796583,1362091796583,2513175067,2513175067,0
1362091824,2513201576,3,1176,392,1362091797490,1362091797554,2513175066,2513175130,64
1362091832,2513209628,1,46,46,1362091806141,1362091806141,2513183769,2513183769,0
1362091836,2513213848,4,1650,412.5,1362091833121,1362091833185,2513210969,2513211033,64
1362091839,2513217548,1,137,137,1362091814438,1362091814438,2513192986,2513192986,0
1362091852,2513229600,2,265,132.5,1362091824987,1362091825115,2513202587,2513202715,128
1362091852,2513229876,4,366,91.5,1362091833155,1362091848259,2513211031,2513226135,15104
1362091852,2513229924,2,92,46,1362091844372,1362091844372,2513222296,2513222296,0
1362091872,2513249624,8,871,108.875,1362091844736,1362091844800,2513222360,2513222424,64
1362091876,2513253948,4,1650,412.5,1362091870076,1362091870140,2513248024,2513248088,64
1362091883,2513261532,1,137,137,1362091856182,1362091856182,2513234714,2513234714,0
1362091892,2513270176,4,372,93,1362091869914,1362091885018,2513248090,2513263194,15104
1362091908,2513285672,2,265,132.5,1362091880912,1362091880976,2513258584,2513258648,64
1362091908,2513285956,5,3150,630,1362091907060,1362091907700,2513285016,2513285656,640
1362091920,2513297716,1,46,46,1362091893158,1362091893158,2513270874,2513270874,0
1362091924,2513301640,1,137,137,1362091899055,1362091899055,2513276695,2513276695,0
1362091924,2513301944,4,366,91.5,1362091907777,1362091922881,2513285721,2513300825,15104
1362091948,2513325944,4,1650,412.5,1362091944129,1362091944257,2513322073,2513322201,128
1362091956,2513333740,1,137,137,1362091931213,1362091931213,2513308953,2513308953,0
1362091960,2513337824,1,52,52,1362091934713,1362091934713,2513312537,2513312537,0
1362091964,2513341676,2,265,132.5,1362091936716,1362091936780,2513314392,2513314456,64
1362091964,2513342044,4,372,93,1362091944156,1362091959260,2513322200,2513337304,15104
1362091988,2513366040,10,6298,629.8,1362091981087,1362091983711,2513359127,2513361751,2624
1362091992,2513369748,1,137,137,1362091965955,1362091965955,2513343703,2513343703,0
1362091996,2513373832,1,46,46,1362091968560,1362091968560,2513346392,2513346392,0
1362092004,2513381880,1,52,52,1362091979646,1362091979646,2513357526,2513357526,0
1362092020,2513397740,2,265,132.5,1362091992585,1362091992649,2513370325,2513370389,64
1362092020,2513398152,4,1650,412.5,1362092018029,1362092018093,2513396181,2513396245,64
1362092024,2513401776,1,137,137,1362091997480,1362091997480,2513375256,2513375256,0
1362092036,2513414184,4,366,91.5,1362092018127,1362092033231,2513396311,2513411415,15104
1362092052,2513429796,1,52,52,1362092024786,1362092024786,2513402582,2513402582,0
1362092060,2513438504,4,1650,412.5,1362092054733,1362092054797,2513433237,2513433301,64
1362092064,2513441920,1,137,137,1362092037844,1362092037844,2513415764,2513415764,0
1362092076,2513453756,2,265,132.5,1362092048250,1362092048314,2513426006,2513426070,64
1362092077,2513454624,4,366,91.5,1362092055677,1362092070781,2513433301,2513448405,15104
1362092092,2513470496,5,326,65.2,1362092069077,1362092083989,2513447573,2513462485,14912
1362092093,2513470568,4,1650,412.5,1362092092727,1362092092855,2513470295,2513470423,128
1362092096,2513473932,1,137,137,1362092069769,1362092069769,2513447701,2513447701,0
1362092108,2513486536,4,366,91.5,1362092091884,1362092106988,2513470420,2513485524,15104
1362092128,2513505904,3,886,295.3333333,1362092101030,1362092101094,2513478934,2513478998,64
1362092132,2513509768,2,265,132.5,1362092104174,1362092104238,2513481942,2513482006,64
1362092132,2513510560,4,1650,412.5,1362092128788,1362092128852,2513507348,2513507412,64
1362092136,2513513816,1,137,137,1362092110205,1362092110205,2513488021,2513488021,0
1362092148,2513526560,4,366,91.5,1362092128854,1362092143958,2513507414,2513522518,15104
1362092173,2513550604,4,1650,412.5,1362092166799,1362092166863,2513544403,2513544467,64
1362092180,2513558032,7,825,117.8571429,1362092154338,1362092154402,2513532370,2513532434,64
1362092180,2513558108,1,137,137,1362092152601,1362092152601,2513530709,2513530709,0
1362092184,2513562176,2,265,132.5,1362092159507,1362092159571,2513537683,2513537747,64
1362092189,2513566572,4,372,93,1362092166960,1362092182064,2513544532,2513559636,15104
1362092205,2513582648,4,1650,412.5,1362092203814,1362092203878,2513581462,2513581526,64
1362092212,2513590276,1,137,137,1362092187119,1362092187119,2513565395,2513565395,0
1362092221,2513598664,4,372,93,1362092203860,1362092218964,2513581524,2513596628,15104
1362092224,2513602252,1,52,52,1362092199241,1362092199241,2513577493,2513577493,0
1362092240,2513618368,2,265,132.5,1362092214996,1362092215060,2513593364,2513593428,64
1362092245,2513622588,4,1650,412.5,1362092240928,1362092240992,2513618516,2513618580,64
1362092248,1151940148,12,12926,1077.166667,1362092223656,1362092223848,1151915804,1151915996,192
1362092248,1151940180,4,2018,504.5,1362092223499,1362092223755,1151915679,1151915935,256
1362092248,2513626256,21,19649,935.6666667,1362092220354,1362092235266,2513598610,2513613522,14912
1362092248,2513626328,1,137,137,1362092222716,1362092222716,2513601044,2513601044,0
1362092248,2513626364,4,2530,632.5,1362092223256,1362092223384,2513601620,2513601748,128
1362092261,2513638596,4,366,91.5,1362092240984,1362092256088,2513618580,2513633684,15104
1362092272,2513650208,1,52,52,1362092244275,1362092244275,2513622483,2513622483,0
1362092272,2513650376,1,52,52,1362092246156,1362092246156,2513624532,2513624532,0
1362092276,1151968164,10,12828,1282.8,1362092249691,1362092249883,1151941855,1151942047,192
1362092276,2513654244,1,1216,1216,1362092249421,1362092249421,2513627665,2513627665,0
1362092276,2513654296,35,37567,1073.342857,1362092247836,1362092273372,2513626132,2513651668,25536
1362092276,2513654328,3,2036,678.6666667,1362092248826,1362092248890,2513627154,2513627218,64
1362092280,2513658284,1,137,137,1362092254886,1362092254886,2513633170,2513633170,0
1362092285,2513662612,11,5666,515.0909091,1362092266502,1362092281798,2513644114,2513659410,15296
1362092285,2513662628,4,1650,412.5,1362092277944,1362092278008,2513655572,2513655636,64
1362092296,1151988168,1,52,52,1362092268564,1362092268564,1151960732,1151960732,0
1362092296,2513674348,2,265,132.5,1362092270824,1362092270888,2513649172,2513649236,64
1362092301,2513678600,4,366,91.5,1362092278033,1362092293137,2513655633,2513670737,15104
1362092316,2513694244,1,52,52,1362092289293,1362092289293,2513667537,2513667537,0
1362092317,2513694688,3,144,48,1362092295035,1362092313403,2513672723,2513691091,18368
1362092317,2513694688,4,1650,412.5,1362092314937,1362092315001,2513692625,2513692689,64
1362092320,1152012264,1,52,52,1362092294839,1362092294839,1151987103,1151987103,0
1362092320,2513698192,2,2170,1085,1362092292481,1362092292481,2513670673,2513670673,0
1362092320,2513698196,14,15830,1130.714286,1362092292222,1362092292798,2513670418,2513670994,576
1362092324,2513702368,1,137,137,1362092298516,1362092298516,2513676884,2513676884,0
1362092333,2513710704,4,372,93,1362092314986,1362092330090,2513692690,2513707794,15104
1362092340,1152032304,1,52,52,1362092313420,1362092313420,1152005724,1152005724,0
1362092352,2513730412,2,265,132.5,1362092325860,1362092325924,2513704272,2513704336,64
1362092357,2513734664,4,1650,412.5,1362092352018,1362092352082,2513729682,2513729746,64
1362092360,2513738312,1,52,52,1362092334281,1362092334281,2513712593,2513712593,0
1362092364,2513742300,4,2221,555.25,1362092337365,1362092356117,2513715665,2513734417,18752
1362092364,2513742396,15,16451,1096.733333,1362092337653,1362092355893,2513716049,2513734289,18240
1362092364,1152056624,1,52,52,1362092339469,1362092339469,1152032093,1152032093,0
1362092368,2513746300,1,137,137,1362092340692,1362092340692,2513718992,2513718992,0
1362092372,2513750484,3,408,136,1362092343901,1362092349981,2513722385,2513728465,6080
1362092373,2513750832,4,366,91.5,1362092351914,1362092367018,2513729746,2513744850,15104
1362092375,1152067452,22,25748,1170.363636,1362092366396,1362092373372,1152058848,1152065824,6976
1362092375,1152067464,2,98,49,1362092358256,1362092373360,1152050720,1152065824,15104
1362092381,2513758644,2,92,46,1362092373670,1362092373670,2513751314,2513751314,0
1362092381,2513758672,5,2536,507.2,1362092368201,1362092373641,2513745873,2513751313,5440
1362092381,2513758684,7,2912,416,1362092373309,1362092373629,2513750993,2513751313,320
1362092381,2513758684,7,2544,363.4285714,1362092373309,1362092373629,2513750993,2513751313,320
1362092381,2513758684,33,38697,1172.636364,1362092364861,1362092373629,2513742545,2513751313,8768
1362092389,2513766676,7,1445,206.4285714,1362092376327,1362092386503,2513754003,2513764179,10176
1362092401,2513778704,1,46,46,1362092373608,1362092373608,2513751312,2513751312,0
1362092405,2513782632,1,76,76,1362092376943,1362092376943,2513754575,2513754575,0
1362092417,2513794804,2,438,219,1362092390725,1362092399493,2513768529,2513777297,8768
1362092445,2513822740,1,219,219,1362092416963,1362092416963,2513794703,2513794703,0
1362092477,2513854836,1,219,219,1362092451746,1362092451746,2513829582,2513829582,0
1362092593,2513971108,1,46,46,1362092565392,1362092565392,2513943500,2513943500,0
1362092633,2514011232,3,426,142,1362092605396,1362092611412,2513983628,2513989644,6016
1362092770,2514147728,2,122,61,1362092744586,1362092747082,2514122314,2514124810,2496
1362093139,2514517316,1,46,46,1362093110201,1362093110201,2514488517,2514488517,0
