unix_secs,sysuptime,dpkts,doctets,doctets/dpkts,Real First Packet,Real End Packet,first,last,Duration
1359741752,163138080,1,46,46,1359741723607,1359741723607,163109687,163109687,0
1359742321,3096985644,1,46,46,1359742293691,1359742293691,3096958335,3096958335,0
1359742574,163960100,1,48,48,1359742547830,1359742547830,163933930,163933930,0
1359743784,165169476,1,46,46,1359743770198,1359743770198,165155674,165155674,0
1359744732,166117300,6,569,94.83333333,1359744726902,1359744727990,166112202,166113290,1088
1359744740,166125168,14,5009,357.7857143,1359744736570,1359744737658,166121738,166122826,1088
1359744740,166125176,13,3583,275.6153846,1359744737268,1359744739572,166122444,166124748,2304
1359744740,166125204,15,5325,355,1359744737624,1359744739608,166122828,166124812,1984
1359744740,166125208,25,4988,199.52,1359744730067,1359744734611,166115275,166119819,4544
1359744740,166125208,16,7549,471.8125,1359744730129,1359744737233,166115337,166122441,7104
1359744740,166125212,33,40247,1219.606061,1359744731533,1359744732941,166116745,166118153,1408
1359744740,166125280,26,7303,280.8846154,1359744729611,1359744734859,166114891,166120139,5248
1359744740,166125280,14,4495,321.0714286,1359744730057,1359744736457,166115337,166121737,6400
1359744740,166125284,7,620,88.57142857,1359744731461,1359744734085,166116745,166119369,2624
1359744748,166133176,15,9532,635.4666667,1359744740467,1359744740915,166125643,166126091,448
1359744748,166133220,179,24229,135.3575419,1359744729671,1359744747591,166114891,166132811,17920
1359744748,166133228,2,158,79,1359744739836,1359744740348,166125064,166125576,512
1359744748,166133228,17,7628,448.7058824,1359744739966,1359744743102,166125194,166128330,3136
1359744748,166133256,6,564,94,1359744733282,1359744740130,166118538,166125386,6848
1359744751,166136944,4,481,120.25,1359744723186,1359744724018,166109130,166109962,832
1359744751,166137024,20,4734,236.7,1359744725987,1359744739939,166112011,166125963,13952
1359744755,166141024,23,29478,1281.652174,1359744726819,1359744728867,166112843,166114891,2048
1359744756,166141124,41,17841,435.1463415,1359744730213,1359744750309,166115337,166135433,20096
1359744756,166141200,20,4558,227.9,1359744752540,1359744753948,166137740,166139148,1408
1359744756,166141204,5,780,156,1359744753110,1359744754454,166138314,166139658,1344
1359744756,166141232,12,3173,264.4166667,1359744753915,1359744754619,166139147,166139851,704
1359744756,166141236,5,577,115.4,1359744754232,1359744755320,166139468,166140556,1088
1359744756,166141248,6,419,69.83333333,1359744748202,1359744751466,166133450,166136714,3264
1359744756,166141280,10,4844,484.4,1359744750024,1359744750664,166135304,166135944,640
1359744756,166141312,17,4222,248.3529412,1359744754536,1359744755368,166139848,166140680,832
1359744762,3099426744,10,4181,418.1,1359744753321,1359744754729,3099418065,3099419473,1408
1359744763,166148964,80,10852,135.65,1359744735454,1359744754078,166121418,166140042,18624
1359744764,166149244,12,3179,264.9166667,1359744759340,1359744759724,166144584,166144968,384
1359744764,166149248,16,4584,286.5,1359744750891,1359744756715,166136139,166141963,5824
1359744764,166149248,6,637,106.1666667,1359744754602,1359744756330,166139850,166141578,1728
1359744764,166149284,17,4226,248.5882353,1359744756741,1359744757701,166142025,166142985,960
1359744764,166149292,13,3234,248.7692308,1359744757821,1359744759357,166143113,166144649,1536
1359744764,166149328,28,6328,226,1359744755356,1359744756764,166140684,166142092,1408
1359744767,166152960,10,3558,355.8,1359744739235,1359744742371,166125195,166128331,3136
1359744767,166153084,21,22177,1056.047619,1359744741095,1359744741799,166127179,166127883,704
1359744768,166153096,10,3449,344.9,1359744743171,1359744745475,166128267,166130571,2304
1359744771,166156992,10,2621,262.1,1359744744450,1359744746114,166130442,166132106,1664
1359744771,166156992,10,2621,262.1,1359744744514,1359744746050,166130506,166132042,1536
1359744771,166157016,18,3280,182.2222222,1359744745000,1359744749160,166131016,166135176,4160
1359744775,166160972,93,85922,923.8924731,1359744747285,1359744759381,166133257,166145353,12096
1359744775,166161060,9,5396,599.5555556,1359744747325,1359744749053,166133385,166135113,1728
1359744779,166165032,4,816,204,1359744753304,1359744754200,166139336,166140232,896
1359744779,166165036,1,52,52,1359744753878,1359744753878,166139914,166139914,0
1359744779,166165080,90,111133,1234.811111,1359744751787,1359744758123,166137867,166144203,6336
1359744779,166165080,14,16776,1198.285714,1359744751914,1359744752170,166137994,166138250,256
1359744780,166165176,8,6354,794.25,1359744754800,1359744759344,166139976,166144520,4544
1359744780,166165208,13,3106,238.9230769,1359744755475,1359744756627,166140683,166141835,1152
1359744780,166165240,4,223,55.75,1359744775792,1359744776048,166161032,166161288,256
1359744780,166165296,4,223,55.75,1359744775736,1359744775992,166161032,166161288,256
1359744795,166181080,14,3573,255.2142857,1359744767400,1359744768168,166153480,166154248,768
1359744799,166185032,1,52,52,1359744771864,1359744771864,166157896,166157896,0
1359744812,166197156,3,982,327.3333333,1359744786374,1359744786694,166171530,166171850,320
1359744816,166201140,1,52,52,1359744788055,1359744788055,166173195,166173195,0
1359744820,166205260,23,5953,258.826087,1359744816156,1359744818332,166201416,166203592,2176
1359744828,166213412,17,4193,246.6470588,1359744826180,1359744826692,166211592,166212104,512
1359744843,166229056,12,1045,87.08333333,1359744815039,1359744819711,166201095,166205767,4672
1359744844,166229104,1,52,52,1359744818679,1359744818679,166203783,166203783,0
1359744844,166229164,17,3371,198.2941176,1359744816379,1359744823867,166201543,166209031,7488
1359744844,166229196,23,22163,963.6086957,1359744817180,1359744838172,166202376,166223368,20992
1359744847,166233064,10,5887,588.7,1359744820281,1359744827641,166206345,166213705,7360
1359744868,166253468,2,131,65.5,1359744862862,1359744862862,166248330,166248330,0
1359744876,166261404,2,131,65.5,1359744874572,1359744874572,166259976,166259976,0
1359744884,166269444,2,131,65.5,1359744876387,1359744876387,166261831,166261831,0
1359744892,166277484,4,208,52,1359744864058,1359744888634,166249542,166274118,24576
1359744892,166277684,2,131,65.5,1359744888116,1359744888116,166273800,166273800,0
1359744892,166277724,15,6698,446.5333333,1359744889740,1359744891148,166275464,166276872,1408
1359744896,166281524,21,3757,178.9047619,1359744870228,1359744870804,166255752,166256328,576
1359744900,166285540,1,52,52,1359744872582,1359744872582,166258122,166258122,0
1359744907,3099570844,80,87462,1093.275,1359744892205,1359744906413,3099556049,3099570257,14208
1359744907,3099570868,17,4980,292.9411765,1359744892180,1359744903892,3099556048,3099567760,11712
1359744907,3099570868,55,51114,929.3454545,1359744892180,1359744906708,3099556048,3099570576,14528
1359744908,166293644,37,26629,719.7027027,1359744889820,1359744907036,166275464,166292680,17216
1359744908,166293644,4,289,72.25,1359744905884,1359744906908,166291528,166292552,1024
1359744908,166293688,17,2376,139.7647059,1359744897072,1359744906928,166282760,166292616,9856
1359744915,3099578844,2,139,69.5,1359744910061,1359744911469,3099573905,3099575313,1408
1359744915,3099578844,2,139,69.5,1359744910060,1359744910828,3099573904,3099574672,768
1359744915,3099578848,3,214,71.33333333,1359744907369,1359744914729,3099571217,3099578577,7360
1359744916,166301576,8,2860,357.5,1359744890209,1359744890977,166275785,166276553,768
1359744916,166301644,2,158,79,1359744908316,1359744911068,166293960,166296712,2752
1359744916,166301656,2,131,65.5,1359744909712,1359744910608,166295368,166296264,896
1359744916,166301688,3,210,70,1359744907823,1359744909999,166293511,166295687,2176
1359744919,3099583332,68,84713,1245.779412,1359744891715,1359744918211,3099556047,3099582543,26496
1359744924,166309420,36,35623,989.5277778,1359744896570,1359744922362,166281990,166307782,25792
1359744924,166309464,20,13417,670.85,1359744898382,1359744916878,166283846,166302342,18496
1359744924,166309464,72,56830,789.3055556,1359744898446,1359744920334,166283910,166305798,21888
1359744924,166309620,15,12185,812.3333333,1359744898036,1359744916340,166283656,166301960,18304
1359744931,3099594848,3,179,59.66666667,1359744926824,1359744926824,3099590672,3099590672,0
1359744932,166317708,3,179,59.66666667,1359744924122,1359744924122,166309830,166309830,0
1359744932,166317736,39,28920,741.5384615,1359744917694,1359744930238,166303430,166315974,12544
1359744940,166325720,8,3604,450.5,1359744934096,1359744935184,166319816,166320904,1088
1359744940,166325760,27,7059,261.4444444,1359744935910,1359744939046,166321670,166324806,3136
1359744944,166329568,1,189,189,1359744918377,1359744918377,166303945,166303945,0
1359744948,166333708,27,7279,269.5925926,1359744940827,1359744945627,166326535,166331335,4800
1359744948,166333740,12,3557,296.4166667,1359744942588,1359744943292,166328328,166329032,704
1359744948,166333748,20,4933,246.65,1359744939443,1359744941043,166325191,166326791,1600
1359744948,166333820,17,3799,223.4705882,1359744939370,1359744940522,166325190,166326342,1152
1359744963,3099627316,5,2034,406.8,1359744935830,1359744936598,3099600146,3099600914,768
1359744963,3099627356,9,3078,342,1359744935854,1359744937582,3099600210,3099601938,1728
1359744964,166349504,29,25515,879.8275862,1359744936807,1359744938919,166322311,166324423,2112
1359744964,166349508,12,9212,767.6666667,1359744937251,1359744938275,166322759,166323783,1024
1359744964,166349580,16,14767,922.9375,1359744936154,1359744937242,166321734,166322822,1088
1359744964,166349612,23,20093,873.6086957,1359744937402,1359744938746,166323014,166324358,1344
1359744964,166349844,223,305312,1369.112108,1359744831826,1359744957586,166217670,166343430,125760
1359744968,166353504,13,3243,249.4615385,1359744940967,1359744941671,166326471,166327175,704
1359744968,166353628,2,538,269,1359744942700,1359744942764,166328328,166328392,64
1359744968,166353628,8,3100,387.5,1359744942700,1359744943276,166328328,166328904,576
1359744968,166353660,25,24795,991.8,1359744943434,1359744946314,166329094,166331974,2880
1359744996,166381620,2,378,189,1359744969969,1359744970289,166355589,166355909,320
1359745004,166389764,19,3938,207.2631579,1359745001060,1359745002596,166386824,166388360,1536
1359745004,166389792,30,12330,411,1359744990854,1359744996742,166376646,166382534,5888
1359745004,166389796,27,7172,265.6296296,1359745002243,1359745003395,166388039,166389191,1152
1359745004,166389828,32,7459,233.09375,1359744996897,1359745000801,166382725,166386629,3904
1359745004,166389836,18,4802,266.7777778,1359745000988,1359745001948,166386824,166387784,960
1359745004,166389872,22,4583,208.3181818,1359745001908,1359745003636,166387780,166389508,1728
1359745012,166397860,19,5891,310.0526316,1359745003712,1359745004544,166389572,166390404,832
1359745012,166397872,2,127,63.5,1359745009205,1359745009205,166395077,166395077,0
1359745020,166405796,49,18810,383.877551,1359745007744,1359745016512,166393540,166402308,8768
1359745020,166405884,3,138,46,1359745016555,1359745016555,166402439,166402439,0
1359745020,166405892,6,629,104.8333333,1359745014563,1359745017251,166400455,166403143,2688
1359745028,166413884,33,41689,1263.30303,1359745021225,1359745021737,166407109,166407621,512
1359745035,3099698884,11,7665,696.8181818,1359745030790,1359745031174,3099694674,3099695058,384
1359745036,166421608,15,2328,155.2,1359745008064,1359745009472,166393672,166395080,1408
1359745040,166425648,7,8106,1158,1359745013782,1359745030422,166399430,166416070,16640
1359745043,3099706856,16,11071,691.9375,1359745042146,1359745042850,3099706002,3099706706,704
1359745044,166429844,24,18530,772.0833333,1359745016530,1359745043538,166402374,166429382,27008
1359745045,166430212,20,6160,308,1359745042506,1359745043402,166427718,166428614,896
1359745048,166433640,1,76,76,1359745021279,1359745021279,166406919,166406919,0
1359745048,166433688,1,46,46,1359745023471,1359745023471,166409159,166409159,0
1359745052,166437948,27,7625,282.4074074,1359745043496,1359745044712,166429444,166430660,1216
1359745052,166437960,35,7911,226.0285714,1359745044894,1359745046686,166430854,166432646,1792
1359745052,166437960,17,3748,220.4705882,1359745044894,1359745045406,166430854,166431366,512
1359745068,166453608,11,6487,589.7272727,1359745041598,1359745042174,166427206,166427782,576
1359745068,166453624,13,9832,756.3076923,1359745042989,1359745043437,166428613,166429061,448
1359745068,166453644,17,11852,697.1764706,1359745043800,1359745047128,166429444,166432772,3328
1359745068,166453692,41,29811,727.097561,1359745041577,1359745047081,166427269,166432773,5504
1359745068,166454048,2,131,65.5,1359745062276,1359745062276,166448324,166448324,0
1359745080,166465704,21,3757,178.9047619,1359745053917,1359745054621,166439621,166440325,704
1359745088,166473708,17,1658,97.52941176,1359745060506,1359745060890,166446214,166446598,384
1359745096,166481604,4,208,52,1359745068416,1359745075008,166454020,166460612,6592
1359745124,166509668,1,46,46,1359745096319,1359745096319,166481987,166481987,0
1359745132,166517732,51,41825,820.0980392,1359745104769,1359745105473,166490501,166491205,704
1359745136,166521760,3,1514,504.6666667,1359745107810,1359745108194,166493570,166493954,384
1359745136,166521760,5,542,108.4,1359745107814,1359745119846,166493574,166505606,12032
1359745136,166521760,14,1350,96.42857143,1359745107877,1359745108325,166493637,166494085,448
1359745140,166526060,4,208,52,1359745135162,1359745138938,166521222,166524998,3776
1359745148,166534036,2,104,52,1359745140818,1359745141074,166526854,166527110,256
1359745164,166549764,13,1439,110.6923077,1359745139232,1359745141536,166524996,166527300,2304
1359745164,166549764,19,5511,290.0526316,1359745139295,1359745146527,166525059,166532291,7232
1359745164,166550080,2,131,65.5,1359745161701,1359745161701,166547781,166547781,0
1359745164,166550088,3,210,70,1359745162909,1359745163165,166548997,166549253,256
1359745165,166550120,168,220268,1311.119048,1359745017315,1359745162211,166402435,166547331,144896
1359745168,166553844,1,52,52,1359745143502,1359745143502,166529346,166529346,0
1359745180,166566036,7,689,98.42857143,1359745177423,1359745179855,166563459,166565891,2432
1359745188,166573796,34,12823,377.1470588,1359745160129,1359745183745,166545925,166569541,23616
1359745188,166574064,6,629,104.8333333,1359745178354,1359745180018,166564418,166566082,1664
1359745208,166593724,37,24797,670.1891892,1359745179974,1359745205126,166565698,166590850,25152
1359745208,166593724,24,17986,749.4166667,1359745180359,1359745194311,166566083,166580035,13952
1359745208,166593804,1,52,52,1359745180341,1359745180341,166566145,166566145,0
1359745211,3099874976,21,10621,505.7619048,1359745186667,1359745204331,3099850643,3099868307,17664
1359745212,166597776,1,52,52,1359745186195,1359745186195,166571971,166571971,0
1359745212,166597832,44,54046,1228.318182,1359745185242,1359745186010,166571074,166571842,768
1359745213,166598160,20,4546,227.3,1359745210491,1359745212603,166595651,166597763,2112
1359745229,166614108,2,131,65.5,1359745228462,1359745228462,166613570,166613570,0
1359745229,166614112,2,131,65.5,1359745228650,1359745228650,166613762,166613762,0
1359745229,166614172,34,11911,350.3235294,1359745224301,1359745227053,166609473,166612225,2752
1359745236,166622076,4,316,79,1359745227941,1359745231909,166614017,166617985,3968
1359745236,166622084,3,237,79,1359745228257,1359745232673,166614341,166618757,4416
1359745240,166625908,1,79,79,1359745212174,1359745212174,166598082,166598082,0
1359745240,166625912,7,6520,931.4285714,1359745211977,1359745215881,166597889,166601793,3904
1359745248,166633916,23,7818,339.9130435,1359745221061,1359745243717,166606977,166629633,22656
1359745252,166637880,20,14885,744.25,1359745226221,1359745249005,166612101,166634885,22784
1359745253,166638120,2,158,79,1359745239523,1359745251363,166624643,166636483,11840
1359745253,166638136,2,158,79,1359745237331,1359745246291,166622467,166631427,8960
1359745253,166638172,5,352,70.4,1359745249903,1359745251503,166635075,166636675,1600
1359745261,166646100,4,208,52,1359745255160,1359745256696,166640260,166641796,1536
1359745261,166646168,2,104,52,1359745258099,1359745260851,166643267,166646019,2752
1359745261,166646204,2,104,52,1359745259342,1359745260046,166644546,166645250,704
1359745261,166646208,3,202,67.33333333,1359745260170,1359745260362,166645378,166645570,192
1359745280,166665952,4,300,75,1359745252576,1359745278304,166638528,166664256,25728
1359745284,166669956,2,1116,558,1359745256480,1359745272480,166642436,166658436,16000
1359745285,166670228,2,307,153.5,1359745263924,1359745283188,166649152,166668416,19264
1359745288,166673940,5,375,75,1359745260078,1359745273902,166646018,166659842,13824
1359745288,166674024,1,79,79,1359745263385,1359745263385,166649409,166649409,0
1359745300,166685988,1,79,79,1359745274109,1359745274109,166660097,166660097,0
1359745309,166694332,4,289,72.25,1359745306252,1359745307404,166691584,166692736,1152
1359745316,166702028,1,75,75,1359745288598,1359745288598,166674626,166674626,0
1359745316,166702072,7,2317,331,1359745290858,1359745313898,166676930,166699970,23040
1359745317,166702356,2,158,79,1359745308853,1359745311797,166694209,166697153,2944
1359745325,166710268,1,79,79,1359745300045,1359745300045,166685313,166685313,0
1359745329,166714144,1,187,187,1359745303049,1359745303049,166688193,166688193,0
1359745333,166718268,1,75,75,1359745308364,1359745308364,166693632,166693632,0
1359745333,166718308,2,158,79,1359745317733,1359745329445,166703041,166714753,11712
1359745345,166730108,1,75,75,1359745319022,1359745319022,166704130,166704130,0
1359745345,166730140,1,1064,1064,1359745320524,1359745320524,166705664,166705664,0
1359745349,166734128,1,79,79,1359745322136,1359745322136,166707264,166707264,0
1359745365,166750164,1,331,331,1359745338165,1359745338165,166723329,166723329,0
1359745380,166766072,1,79,79,1359745352232,1359745352232,166738304,166738304,0
1359745413,166798160,1,331,331,1359745385017,1359745385017,166770177,166770177,0
1359745425,166810268,1,79,79,1359745400140,1359745400140,166785408,166785408,0
1359745443,3100106940,6,427,71.16666667,1359745436942,1359745441166,3100100882,3100105106,4224
1359745443,3100106944,5,352,70.4,1359745437965,1359745440653,3100101909,3100104597,2688
1359745445,166830592,6,427,71.16666667,1359745437766,1359745443078,166823358,166828670,5312
1359745451,3100114932,2,150,75,1359745443672,1359745449688,3100107604,3100113620,6016
1359745459,3100122956,2,150,75,1359745445569,1359745454529,3100109525,3100118485,8960
1359745477,166862408,2,150,75,1359745448960,1359745460352,166834368,166845760,11392
1359745487,3100151424,2,150,75,1359745461291,1359745485483,3100125715,3100149907,24192
1359745499,3100163440,1,75,75,1359745471900,1359745471900,3100136340,3100136340,0
1359745505,166890368,1,331,331,1359745478503,1359745478503,166863871,166863871,0
1359745509,166894372,1,75,75,1359745483107,1359745483107,166868479,166868479,0
1359745517,166902476,1,46,46,1359745491707,1359745491707,166877183,166877183,0
1359745535,3100199412,1,75,75,1359745507575,1359745507575,3100171987,3100171987,0
1359745549,166934916,5,352,70.4,1359745546817,1359745548481,166932733,166934397,1664
1359745549,166934916,5,352,70.4,1359745546817,1359745548609,166932733,166934525,1792
1359745553,166938800,1,75,75,1359745528247,1359745528247,166914047,166914047,0
1359745559,3100223468,1,75,75,1359745533759,1359745533759,3100198227,3100198227,0
1359745577,166962680,3,225,75,1359745550828,1359745562732,166936508,166948412,11904
1359745577,166962764,4,300,75,1359745550488,1359745576664,166936252,166962428,26176
1359745581,166966840,8,5760,720,1359745556173,1359745579341,166942013,166965181,23168
1359745605,166990740,1,75,75,1359745578611,1359745578611,166964351,166964351,0
1359745617,167002728,3,2160,720,1359745589437,1359745609405,166975165,166995133,19968
1359745625,167010732,1,410,410,1359745597432,1359745597432,166983164,166983164,0
1359745633,167018704,1,75,75,1359745606547,1359745606547,166992251,166992251,0
1359745637,167022688,1,75,75,1359745610404,1359745610404,166996092,166996092,0
1359745677,167062760,2,131,65.5,1359745649371,1359745649371,167035131,167035131,0
1359745693,167079008,3,202,67.33333333,1359745685988,1359745689700,167071996,167075708,3712
1359745718,167103252,4,277,69.25,1359745712664,1359745715160,167097916,167100412,2496
1359745725,167110756,2,150,75,1359745697310,1359745712030,167083066,167097786,14720
1359745745,167130812,3,225,75,1359745717991,1359745738215,167103803,167124027,20224
1359745769,167154816,1,75,75,1359745741477,1359745741477,167127293,167127293,0
1359745793,167178836,1,75,75,1359745765136,1359745765136,167150972,167150972,0
1359746022,167407624,2,131,65.5,1359746019997,1359746019997,167405621,167405621,0
1359747426,168811296,1,60,60,1359747399121,1359747399121,168784417,168784417,0
1359747512,168897784,5,504,100.8,1359747510566,1359747511782,168896350,168897566,1216
1359747512,168897816,23,12056,524.173913,1359747505543,1359747509767,168891359,168895583,4224
1359747512,168897824,41,50349,1228.02439,1359747504191,1359747506815,168890015,168892639,2624
1359747520,168905836,6,615,102.5,1359747515701,1359747515893,168901537,168901729,192
1359747520,168905836,33,7275,220.4545455,1359747511605,1359747519029,168897441,168904865,7424
1359747520,168905848,2,116,58,1359747511912,1359747512040,168897760,168897888,128
1359747520,168905884,28,9581,342.1785714,1359747507141,1359747519685,168893025,168905569,12544
1359747520,168905892,7,1404,200.5714286,1359747516730,1359747519226,168902622,168905118,2496
1359747520,168905916,21,9912,472,1359747505444,1359747519140,168891360,168905056,13696
1359747520,168905920,19,8478,446.2105263,1359747517345,1359747518753,168903265,168904673,1408
1359747526,168911760,6,862,143.6666667,1359747498688,1359747500416,168884448,168886176,1728
1359747526,168911792,20,5004,250.2,1359747499806,1359747510942,168885598,168896734,11136
1359747526,168911808,25,32323,1292.92,1359747501328,1359747503376,168887136,168889184,2048
1359747528,168913792,18,4291,238.3888889,1359747522079,1359747523487,168907871,168909279,1408
1359747528,168913832,6,629,104.8333333,1359747519224,1359747520504,168905056,168906336,1280
1359747528,168913876,8,1042,130.25,1359747518666,1359747520458,168904542,168906334,1792
1359747528,168913880,31,6156,198.5806452,1359747520838,1359747523462,168906718,168909342,2624
1359747528,168913884,18,4302,239,1359747521155,1359747522243,168907039,168908127,1088
1359747528,168913924,34,9961,292.9705882,1359747505627,1359747520283,168891551,168906207,14656
1359747530,168915896,1,76,76,1359747503094,1359747503094,168888990,168888990,0
1359747530,168915920,2,120,60,1359747503390,1359747506398,168889310,168892318,3008
1359747536,168921788,23,3516,152.8695652,1359747514787,1359747535715,168900575,168921503,20928
1359747536,168921792,2,104,52,1359747528801,1359747530337,168914593,168916129,1536
1359747539,3102203736,10,3890,389,1359747534977,1359747536065,3102199713,3102200801,1088
1359747542,168927772,13,5964,458.7692308,1359747514611,1359747516211,168900383,168901983,1600
1359747546,168931844,33,6081,184.2727273,1359747519212,1359747523628,168905056,168909472,4416
1359747546,168931876,18,15951,886.1666667,1359747519690,1359747536010,168905566,168921886,16320
1359747546,168931960,6,482,80.33333333,1359747519353,1359747519865,168905313,168905825,512
1359747552,168937848,4,223,55.75,1359747546022,1359747546214,168931870,168932062,192
1359747554,168939816,13,9783,752.5384615,1359747528649,1359747529865,168914465,168915681,1216
1359747558,168943820,1,52,52,1359747531649,1359747531649,168917469,168917469,0
1359747582,168967888,16,4229,264.3125,1359747554622,1359747561534,168940510,168947422,6912
1359747586,168971848,1,76,76,1359747559143,1359747559143,168944991,168944991,0
1359747586,168971888,12,1514,126.1666667,1359747560128,1359747561792,168946016,168947680,1664
1359747600,168985908,17,2463,144.8823529,1359747595435,1359747596459,168981343,168982367,1024
1359747620,3102283848,19,15485,815,1359747615481,1359747616313,3102279329,3102280161,832
1359747624,169009848,27,7067,261.7407407,1359747618342,1359747619558,169004190,169005406,1216
1359747624,169009928,21,8699,414.2380952,1359747614998,1359747617046,169000926,169002974,2048
1359747632,169017896,18,3951,219.5,1359747619703,1359747624823,169005599,169010719,5120
1359747632,169017896,28,7405,264.4642857,1359747625013,1359747626677,169010909,169012573,1664
1359747632,169017940,19,5352,281.6842105,1359747626633,1359747627145,169012573,169013085,512
1359747632,169017952,18,3862,214.5555556,1359747619645,1359747624765,169005597,169010717,5120
1359747634,169019976,30,23959,798.6333333,1359747605799,1359747615527,168991775,169001503,9728
1359747642,169027904,11,6480,589.0909091,1359747617837,1359747618285,169003741,169004189,448
1359747642,169027916,25,14884,595.36,1359747614369,1359747618721,169000285,169004637,4352
1359747642,169028024,10,6584,658.4,1359747614261,1359747622965,169000285,169008989,8704
1359747642,169028036,9,4303,478.1111111,1359747614762,1359747615978,169000798,169002014,1216
1359747645,3102309176,5,2077,415.4,1359747618033,1359747623345,3102282209,3102287521,5312
1359747646,169032020,88,116846,1327.795455,1359747619577,1359747620601,169005597,169006621,1024
1359747646,169032024,82,108636,1324.829268,1359747619512,1359747621048,169005536,169007072,1536
1359747648,169033884,2,131,65.5,1359747643520,1359747643520,169029404,169029404,0
1359747650,169036048,15,3363,224.2,1359747624796,1359747626844,169010844,169012892,2048
1359747680,169065960,3,138,46,1359747674677,1359747674677,169060637,169060637,0
1359747682,169068012,37,4336,117.1891892,1359747653823,1359747681343,169039835,169067355,27520
1359747702,169087940,35,7852,224.3428571,1359747674696,1359747695560,169060636,169081500,20864
1359747702,169088088,18,15707,872.6111111,1359747676531,1359747677171,169062619,169063259,640
1359747702,169088088,6,4567,761.1666667,1359747676662,1359747676982,169062750,169063070,320
1359747706,169092012,24,6278,261.5833333,1359747681345,1359747703233,169067357,169089245,21888
1359747713,169098152,6,966,161,1359747712411,1359747712539,169097563,169097691,128
1359747718,169104092,8,2892,361.5,1359747691055,1359747691503,169077147,169077595,448
1359747739,169124084,1,244,244,1359747712287,1359747712287,169097371,169097371,0
1359747745,169130148,6,447,74.5,1359747739041,1359747742753,169124189,169127901,3712
1359747745,169130180,4,289,72.25,1359747743809,1359747744641,169128989,169129821,832
1359747745,169130184,5,368,73.6,1359747740923,1359747742779,169126107,169127963,1856
1359747745,169130188,6,447,74.5,1359747740918,1359747744630,169126106,169129818,3712
1359747753,169138108,2,158,79,1359747744968,1359747749192,169130076,169134300,4224
1359747753,169138192,3,237,79,1359747745781,1359747752693,169130973,169137885,6912
1359747761,169146124,2,158,79,1359747748664,1359747756536,169133788,169141660,7872
1359747761,169146200,2,158,79,1359747746670,1359747754670,169131870,169139870,8000
1359747777,169162172,2,158,79,1359747757640,1359747774664,169142812,169159836,17024
1359747785,169170212,2,158,79,1359747761823,1359747780191,169147035,169165403,18368
1359747795,169180196,1,79,79,1359747770545,1359747770545,169155741,169155741,0
1359747799,169184148,1,79,79,1359747772384,1359747772384,169157532,169157532,0
1359747817,169202200,5,368,73.6,1359747812394,1359747815466,169197594,169200666,3072
1359747825,169210268,4,289,72.25,1359747823910,1359747824742,169209178,169210010,832
1359747827,169212208,1,79,79,1359747802337,1359747802337,169187545,169187545,0
1359747831,169216172,1,79,79,1359747804040,1359747804040,169189212,169189212,0
1359747833,169218172,5,352,70.4,1359747830857,1359747832521,169216029,169217693,1664
1359747833,169218172,2,158,79,1359747819078,1359747826246,169204250,169211418,7168
1359747833,169218184,3,237,79,1359747825915,1359747832443,169211099,169217627,6528
1359747835,169220336,1,79,79,1359747808483,1359747808483,169193819,169193819,0
1359747841,169226212,2,150,75,1359747834401,1359747838241,169219613,169223453,3840
1359747841,169226220,5,352,70.4,1359747838806,1359747840662,169224026,169225882,1856
1359747843,169228300,1,79,79,1359747816837,1359747816837,169202137,169202137,0
1359747849,169234220,2,150,75,1359747842710,1359747846870,169227930,169232090,4160
1359747865,169250256,2,158,79,1359747841138,1359747858674,169226394,169243930,17536
1359747865,169250304,2,150,75,1359747845763,1359747861059,169231067,169246363,15296
1359747867,169252452,1,79,79,1359747840239,1359747840239,169225691,169225691,0
1359747873,169258248,2,150,75,1359747855162,1359747871802,169240410,169257050,16640
1359747887,169272436,7,1323,189,1359747861950,1359747881598,169247386,169267034,19648
1359747895,169280468,1,79,79,1359747868766,1359747868766,169254234,169254234,0
1359747919,169304436,1,75,75,1359747891452,1359747891452,169276888,169276888,0
1359747919,169304484,1,79,79,1359747893452,1359747893452,169278936,169278936,0
1359747927,169312480,1,189,189,1359747901588,1359747901588,169287068,169287068,0
1359747931,169316424,1,75,75,1359747904905,1359747904905,169290329,169290329,0
1359747951,169336552,1,46,46,1359747924233,1359747924233,169309785,169309785,0
1359747967,169352552,1,189,189,1359747941578,1359747941578,169327130,169327130,0
1359748047,169432624,1,189,189,1359748021630,1359748021630,169407254,169407254,0
1359748124,3102787964,3,202,67.33333333,1359748123595,1359748123787,3102787559,3102787751,192
1359748132,3102795964,4,300,75,1359748124234,1359748130250,3102788198,3102794214,6016
1359748139,169525012,1,252,252,1359748111225,1359748111225,169497237,169497237,0
1359748143,169529012,8,577,72.125,1359748115963,1359748130363,169501975,169516375,14400
1359748156,3102819968,2,150,75,1359748137159,1359748150919,3102801127,3102814887,13760
1359748171,169557000,1,75,75,1359748144967,1359748144967,169530967,169530967,0
1359748197,169582380,1,46,46,1359748168496,1359748168496,169553876,169553876,0
1359748200,169585088,1,75,75,1359748175126,1359748175126,169560214,169560214,0
1359748206,3102870204,1,75,75,1359748178264,1359748178264,3102842468,3102842468,0
1359748332,169717404,7,1309,187,1359748305750,1359748321942,169691154,169707346,16192
1359748360,169745456,3,561,187,1359748331875,1359748351907,169717331,169737363,20032
1359748388,169773600,1,187,187,1359748361745,1359748361745,169747345,169747345,0
1359748425,169810472,2,131,65.5,1359748420369,1359748420369,169805841,169805841,0
1359749755,171140888,2,122,61,1359749727903,1359749730207,171113791,171116095,2304
1359751964,173350016,1,48,48,1359751937658,1359751937658,173323674,173323674,0
1359752116,173501748,5,456,91.2,1359752109831,1359752111367,173495579,173497115,1536
1359752125,3106789264,5,573,114.6,1359752117817,1359752118009,3106782081,3106782273,192
1359752132,173517692,10,3210,321,1359752129147,1359752129723,173514839,173515415,576
1359752132,173517776,13,6747,519,1359752113832,1359752127912,173499608,173513688,14080
1359752132,173517800,9,2861,317.8888889,1359752130639,1359752131407,173516439,173517207,768
1359752135,3106799540,7,4808,686.8571429,1359752109668,1359752133732,3106774208,3106798272,24064
1359752135,3106799552,4,514,128.5,1359752109656,1359752109976,3106774208,3106774528,320
1359752136,173521288,13,5256,404.3076923,1359752110994,1359752112786,173496282,173498074,1792
1359752140,173525240,22,9258,420.8181818,1359752113409,1359752116737,173498649,173501977,3328
1359752140,173525240,2,152,76,1359752113536,1359752128640,173498776,173513880,15104
1359752140,173525284,9,2837,315.2222222,1359752114903,1359752124823,173500187,173510107,9920
1359752140,173525728,11,1140,103.6363636,1359752136283,1359752137435,173522011,173523163,1152
1359752140,173525728,17,3623,213.1176471,1359752132634,1359752133722,173518362,173519450,1088
1359752140,173525728,14,3971,283.6428571,1359752132825,1359752133977,173518553,173519705,1152
1359752140,173525764,14,4976,355.4285714,1359752134772,1359752135476,173520536,173521240,704
1359752140,173525768,11,1141,103.7272727,1359752138162,1359752138930,173523930,173524698,768
1359752140,173525800,14,5516,394,1359752116882,1359752133842,173502682,173519642,16960
1359752143,3106807512,18,22317,1239.833333,1359752115262,1359752115326,3106779774,3106779838,64
1359752144,173529232,14,10611,757.9285714,1359752119239,1359752120519,173504471,173505751,1280
1359752148,173533840,14,6177,441.2142857,1359752141480,1359752143016,173527320,173528856,1536
1359752148,173533876,7,498,71.14285714,1359752137798,1359752144582,173523674,173530458,6784
1359752148,173533952,2,92,46,1359752142650,1359752142650,173528602,173528602,0
1359752156,173541152,24,5160,215,1359752129175,1359752133143,173514327,173518295,3968
1359752156,173541176,10,4604,460.4,1359752129663,1359752130303,173514839,173515479,640
1359752156,173541176,9,6541,726.7777778,1359752129663,1359752130943,173514839,173516119,1280
1359752156,173541184,2,120,60,1359752130232,1359752130552,173515416,173515736,320
1359752156,173541188,8,969,121.125,1359752130486,1359752130614,173515674,173515802,128
1359752156,173541192,9,860,95.55555556,1359752130802,1359752130930,173515994,173516122,128
1359752156,173541216,5,714,142.8,1359752131226,1359752131482,173516442,173516698,256
1359752156,173541216,9,1345,149.4444444,1359752131032,1359752131160,173516248,173516376,128
1359752156,173541264,55,56001,1018.2,1359752129578,1359752145258,173514842,173530522,15680
1359752156,173541264,10,4596,459.6,1359752129578,1359752130154,173514842,173515418,576
1359752156,173541296,9,4388,487.5555556,1359752130187,1359752130699,173515483,173515995,512
1359752156,173541296,8,987,123.375,1359752130313,1359752130505,173515609,173515801,192
1359752156,173541300,8,806,100.75,1359752130628,1359752130756,173515928,173516056,128
1359752156,173541304,8,1181,147.625,1359752130944,1359752131072,173516248,173516376,128
1359752156,173541308,7,760,108.5714286,1359752131516,1359752131900,173516824,173517208,384
1359752156,173541908,11,1141,103.7272727,1359752148069,1359752148517,173533977,173534425,448
1359752160,173545148,5,807,161.4,1359752131869,1359752132701,173517017,173517849,832
1359752160,173545148,6,722,120.3333333,1359752131869,1359752133341,173517017,173518489,1472
1359752160,173545156,9,1156,128.4444444,1359752132181,1359752134741,173517337,173519897,2560
1359752160,173545184,8,969,121.125,1359752133431,1359752134647,173518615,173519831,1216
1359752160,173545192,15,10604,706.9333333,1359752134063,1359752134383,173519255,173519575,320
1359752160,173545228,8,814,101.75,1359752135308,1359752135500,173520536,173520728,192
1359752160,173545244,7,1258,179.7142857,1359752132030,1359752132990,173517274,173518234,960
1359752160,173545316,9,852,94.66666667,1359752135028,1359752135220,173520344,173520536,192
1359752160,173545320,10,1925,192.5,1359752135344,1359752135472,173520664,173520792,128
1359752164,173549164,8,806,100.75,1359752136267,1359752136843,173521431,173522007,576
1359752164,173549164,8,801,100.125,1359752136523,1359752137035,173521687,173522199,512
1359752164,173549168,7,755,107.8571429,1359752136583,1359752137031,173521751,173522199,448
1359752164,173549196,8,814,101.75,1359752137643,1359752137835,173522839,173523031,192
1359752164,173549204,7,763,109,1359752137959,1359752138407,173523163,173523611,448
1359752164,173549244,7,760,108.5714286,1359752135933,1359752136253,173521177,173521497,320
1359752164,173549244,7,760,108.5714286,1359752135996,1359752136380,173521240,173521624,384
1359752164,173549248,10,1862,186.2,1359752136186,1359752136506,173521434,173521754,320
1359752164,173549276,10,1789,178.9,1359752136733,1359752137053,173522009,173522329,320
1359752164,173549280,8,967,120.875,1359752136922,1359752137114,173522202,173522394,192
1359752164,173549284,10,1554,155.4,1359752137238,1359752139606,173522522,173524890,2368
1359752164,173549288,8,1016,127,1359752137807,1359752138255,173523095,173523543,448
1359752164,173549288,10,1202,120.2,1359752137871,1359752138319,173523159,173523607,448
1359752164,173549324,17,7316,430.3529412,1359752139372,1359752148332,173524696,173533656,8960
1359752164,173549852,11,1263,114.8181818,1359752156252,1359752159708,173542104,173545560,3456
1359752164,173549900,7,498,71.14285714,1359752146606,1359752159790,173532506,173545690,13184
1359752168,173553224,11,5664,514.9090909,1359752142994,1359752144594,173528218,173529818,1600
1359752168,173553344,2,152,76,1359752143577,1359752158617,173528921,173543961,15040
1359752172,173557196,1,281,281,1359752145325,1359752145325,173530521,173530521,0
1359752172,173557276,61,19228,315.2131148,1359752144924,1359752154524,173530200,173539800,9600
1359752172,173557888,2,92,46,1359752166007,1359752166391,173551895,173552279,384
1359752172,173557888,3,138,46,1359752166328,1359752166456,173552216,173552344,128
1359752172,173557892,2,92,46,1359752166646,1359752166710,173552538,173552602,64
1359752172,173557892,3,138,46,1359752169781,1359752169909,173555673,173555801,128
1359752172,173557968,3,138,46,1359752166570,1359752166634,173552538,173552602,64
1359752173,3106837304,4,220,55,1359752169553,1359752170257,3106833857,3106834561,704
1359752176,173561332,9,1879,208.7777778,1359752150246,1359752152934,173535578,173538266,2688
1359752176,173561404,7,1459,208.4285714,1359752148957,1359752149213,173534361,173534617,256
1359752180,173565864,2,157,78.5,1359752176530,1359752176530,173562394,173562394,0
1359752180,173565940,4,342,85.5,1359752168643,1359752176259,173554583,173562199,7616
1359752188,173573272,12,2258,188.1666667,1359752162847,1359752181727,173548119,173566999,18880
1359752188,173573276,8,719,89.875,1359752163098,1359752165530,173548374,173550806,2432
1359752192,173577232,2,128,64,1359752165192,1359752168136,173550424,173553368,2944
1359752192,173577360,15,5696,379.7333333,1359752166665,1359752170953,173552025,173556313,4288
1359752192,173577360,12,5218,434.8333333,1359752166663,1359752167239,173552023,173552599,576
1359752196,173581848,3,138,46,1359752195361,1359752195553,173581209,173581401,192
1359752196,173581904,2,104,52,1359752194537,1359752194729,173580441,173580633,192
1359752196,173581904,3,156,52,1359752194537,1359752195753,173580441,173581657,1216
1359752196,173581904,3,138,46,1359752194857,1359752195113,173580761,173581017,256
1359752196,173581904,3,138,46,1359752195239,1359752195495,173581143,173581399,256
1359752196,173581904,3,138,46,1359752195239,1359752195431,173581143,173581335,192
1359752196,173581940,2,220,110,1359752180740,1359752188100,173566680,173574040,7360
1359752196,173581976,2,104,52,1359752194463,1359752194655,173580439,173580631,192
1359752196,173581980,3,138,46,1359752194714,1359752194906,173580694,173580886,192
1359752196,173581980,3,138,46,1359752194714,1359752194970,173580694,173580950,256
1359752196,173581980,4,184,46,1359752194718,1359752194974,173580698,173580954,256
1359752196,173581980,3,138,46,1359752194782,1359752194974,173580762,173580954,192
1359752196,173581980,3,138,46,1359752194910,1359752195230,173580890,173581210,320
1359752196,173581980,3,138,46,1359752194910,1359752195166,173580890,173581146,256
1359752200,173585232,1,76,76,1359752173833,1359752173833,173559065,173559065,0
1359752203,3106867480,1,52,52,1359752176352,1359752176352,3106840832,3106840832,0
1359752204,173589884,2,104,52,1359752195901,1359752195901,173581785,173581785,0
1359752204,173589888,2,92,46,1359752199672,1359752199928,173585560,173585816,256
1359752204,173589888,3,138,46,1359752196279,1359752196343,173582167,173582231,64
1359752204,173589892,3,138,46,1359752196658,1359752197682,173582550,173583574,1024
1359752204,173589896,3,138,46,1359752196849,1359752196913,173582745,173582809,64
1359752204,173589896,3,138,46,1359752196976,1359752197040,173582872,173582936,64
1359752204,173589920,2,92,46,1359752197719,1359752197719,173583639,173583639,0
1359752204,173589968,3,138,46,1359752196198,1359752196262,173582166,173582230,64
1359752204,173589968,3,138,46,1359752196202,1359752196266,173582170,173582234,64
1359752204,173589968,3,138,46,1359752196201,1359752196265,173582169,173582233,64
1359752204,173589968,3,138,46,1359752196201,1359752196265,173582169,173582233,64
1359752204,173589972,3,138,46,1359752196517,1359752196581,173582489,173582553,64
1359752204,173589972,2,92,46,1359752196644,1359752196644,173582616,173582616,0
1359752204,173589972,2,92,46,1359752196834,1359752196834,173582806,173582806,0
1359752204,173589972,3,138,46,1359752196834,1359752196834,173582806,173582806,0
1359752204,173589976,3,138,46,1359752196897,1359752196961,173582873,173582937,64
1359752204,173589976,3,138,46,1359752197214,1359752197278,173583190,173583254,64
1359752204,173590000,3,138,46,1359752198024,1359752198088,173584024,173584088,64
1359752204,173590004,5,248,49.6,1359752201539,1359752202563,173587543,173588567,1024
1359752224,173609312,1,76,76,1359752196920,1359752196920,173582232,173582232,0
1359752224,173609352,13,5688,437.5384615,1359752198352,1359752202064,173583704,173587416,3712
1359752228,173613376,1,64,64,1359752203384,1359752203384,173588760,173588760,0
1359752288,173673320,1,46,46,1359752260144,1359752260144,173645464,173645464,0
1359752304,173689468,1,46,46,1359752277785,1359752277785,173663253,173663253,0
1359752336,173721692,1,46,46,1359752309819,1359752309819,173695511,173695511,0
1359752405,173790172,3,189,63,1359752400577,1359752403585,173785749,173788757,3008
1359752421,173806264,2,126,63,1359752407523,1359752415587,173792787,173800851,8064
1359752461,173846172,4,252,63,1359752453759,1359752460799,173838931,173845971,7040
1359752470,173855300,1,46,46,1359752443202,1359752443202,173828502,173828502,0
1359752472,173857584,3,189,63,1359752462565,1359752465637,173848149,173851221,3072
1359752472,173857680,2,126,63,1359752466693,1359752467717,173852373,173853397,1024
1359752477,173862908,2,126,63,1359752469473,1359752473505,173855381,173859413,4032
1359752485,173870916,2,126,63,1359752469270,1359752477334,173855186,173863250,8064
1359752497,173882100,1,63,63,1359752468935,1359752468935,173854035,173854035,0
1359752509,173894116,1,63,63,1359752482358,1359752482358,173867474,173867474,0
1359752541,3107205428,587,833313,1419.613288,1359752157975,1359752241495,3106822403,3106905923,83520
1359752646,174031148,3,262,87.33333333,1359752645396,1359752645588,174030544,174030736,192
1359752646,174031220,4,415,103.75,1359752644555,1359752645259,174029775,174030479,704
1359752673,174058592,4,468,117,1359752645850,1359752658906,174031442,174044498,13056
1359752673,174058668,5,525,105,1359752645579,1359752660171,174031247,174045839,14592
1359752701,174086560,1,117,117,1359752673850,1359752673850,174059410,174059410,0
1359752701,174086704,1,105,105,1359752675751,1359752675751,174061455,174061455,0
1359752725,174110600,1,46,46,1359752698578,1359752698578,174084178,174084178,0
1359752729,174114624,1,117,117,1359752703671,1359752703671,174089295,174089295,0
1359752733,174118628,1,105,105,1359752706995,1359752706995,174092623,174092623,0
1359753015,174400552,1,64,64,1359752988285,1359752988285,174373837,174373837,0
1359753055,3107718832,1,48,48,1359753025902,1359753025902,3107689734,3107689734,0
1359753936,175321352,4,208,52,1359753932853,1359753934773,175318205,175320125,1920
1359753944,175329368,2,104,52,1359753936932,1359753941348,175322300,175326716,4416
1359753960,175345432,5,260,52,1359753954085,1359753959397,175339517,175344829,5312
1359753968,175353428,2,104,52,1359753950055,1359753960103,175335483,175345531,10048
1359753976,175361396,2,104,52,1359753964999,1359753975047,175350395,175360443,10048
1359753997,175382404,1,52,52,1359753970113,1359753970113,175355517,175355517,0
1359754000,175385340,2,104,52,1359753985090,1359753995074,175370430,175380414,9984
1359756339,177724624,1,46,46,1359756314304,1359756314304,177699928,177699928,0
1359985973,407357696,1,46,46,1359985945123,1359985945123,407329819,407329819,0
1359986129,407513620,2,120,60,1359986102381,1359986105389,407487001,407490009,3008
1359986129,407513624,2,120,60,1359986103463,1359986106471,407488087,407491095,3008
1359986129,407513656,2,120,60,1359986101192,1359986104200,407485848,407488856,3008
1359986129,407513668,2,120,60,1359986103423,1359986106431,407488091,407491099,3008
1359987029,408413708,1,46,46,1359987002375,1359987002375,408387083,408387083,0
1359989544,410928920,105,136073,1295.933333,1359989540686,1359989542158,410925606,410927078,1472
1359989552,410936972,13,8228,632.9230769,1359989542744,1359989544600,410927716,410929572,1856
1359989555,410940216,20,15159,757.95,1359989530212,1359989537508,410915428,410922724,7296
1359989555,410940232,16,3403,212.6875,1359989528470,1359989535126,410913702,410920358,6656
1359989560,410944964,15,6096,406.4,1359989551841,1359989553249,410936805,410938213,1408
1359989563,410948228,30,34939,1164.633333,1359989538202,1359989539866,410923430,410925094,1664
1359989568,410952924,13,3571,274.6923077,1359989551815,1359989562311,410936739,410947235,10496
1359989568,410952924,15,4182,278.8,1359989552518,1359989562950,410937442,410947874,10432
1359989568,410952928,32,12025,375.78125,1359989552773,1359989561285,410937701,410946213,8512
1359989568,410952980,14,4997,356.9285714,1359989553936,1359989562256,410938916,410947236,8320
1359989568,410952996,15,6103,406.8666667,1359989562625,1359989565505,410947621,410950501,2880
1359989572,3344235744,38,45546,1198.578947,1359989571290,1359989571802,3344235034,3344235546,512
1359989579,410964244,26,5921,227.7307692,1359989551752,1359989564744,410936996,410949988,12992
1359989579,410964256,9,4564,507.1111111,1359989553147,1359989562107,410938403,410947363,8960
1359989580,410964320,27,3697,136.9259259,1359989554403,1359989557411,410938723,410941731,3008
1359989595,410980280,42,50635,1205.595238,1359989568997,1359989569701,410954277,410954981,704
1359989596,410980308,39,47487,1217.615385,1359989570800,1359989571184,410955108,410955492,384
1359989596,410980348,10,7257,725.7,1359989569862,1359989570822,410954210,410955170,960
1359989596,410980348,6,3098,516.3333333,1359989569862,1359989570758,410954210,410955106,896
1359989596,410980356,40,48445,1211.125,1359989570814,1359989571454,410955170,410955810,640
1359989604,410988348,15,3778,251.8666667,1359989579078,1359989585030,410963426,410969378,5952
1359989607,410992288,1,185,185,1359989580954,1359989580954,410966242,410966242,0
1359989624,411009000,13,4043,311,1359989621947,1359989623291,411006947,411008291,1344
1359989644,411028324,14,1350,96.42857143,1359989617312,1359989617760,411001636,411002084,448
1359989648,411032336,2,745,372.5,1359989622930,1359989623186,411007266,411007522,256
1359989648,411032340,8,2812,351.5,1359989623248,1359989623568,411007588,411007908,320
1359989664,411049032,4,235,58.75,1359989660314,1359989660314,411045346,411045346,0
1359989672,411057044,6,1644,274,1359989667405,1359989667661,411052449,411052705,256
1359989672,411057092,9,1927,214.1111111,1359989665567,1359989667039,411050659,411052131,1472
1359989680,411064396,8,7913,989.125,1359989654038,1359989667734,411038434,411052130,13696
1359989680,411064468,3,2855,951.6666667,1359989653967,1359989653967,411038435,411038435,0
1359989680,411065044,18,4982,276.7777778,1359989674124,1359989674956,411059168,411060000,832
1359989688,411072420,13,1388,106.7692308,1359989660605,1359989669245,411045025,411053665,8640
1359989696,411080400,8,2860,357.5,1359989668306,1359989669010,411052706,411053410,704
1359989696,411080444,10,3365,336.5,1359989668261,1359989669157,411052705,411053601,896
1359989696,411081052,2,131,65.5,1359989690120,1359989690120,411075172,411075172,0
1359989696,411081052,2,131,65.5,1359989690373,1359989690373,411075425,411075425,0
1359989696,411081056,2,131,65.5,1359989690755,1359989690755,411075811,411075811,0
1359989696,411081092,15,6698,446.5333333,1359989684896,1359989688352,411069988,411073444,3456
1359989696,411081092,2,131,65.5,1359989689822,1359989689822,411074914,411074914,0
1359989700,411084404,11,964,87.63636364,1359989674572,1359989675340,411058976,411059744,768
1359989700,411084476,15,3228,215.2,1359989675013,1359989681029,411059489,411065505,6016
1359989704,411088400,1,52,52,1359989675923,1359989675923,411060323,411060323,0
1359989704,411089072,19,10752,565.8947368,1359989688564,1359989696052,411073636,411081124,7488
1359989704,411089080,17,6944,408.4705882,1359989698729,1359989699817,411083809,411084897,1088
1359989704,411089144,18,7249,402.7222222,1359989694634,1359989703786,411079778,411088930,9152
1359989708,3344371808,9,3914,434.8888889,1359989691545,1359989700313,3344355353,3344364121,8768
1359989708,3344371808,10,2491,249.1,1359989692184,1359989700376,3344355992,3344364184,8192
1359989712,411096408,78,48697,624.3205128,1359989685260,1359989710220,411069668,411094628,24960
1359989712,411097040,85,73156,860.6588235,1359989688594,1359989709074,411073634,411094114,20480
1359989712,411097040,90,78427,871.4111111,1359989688593,1359989709841,411073633,411094881,21248
1359989712,411097040,96,78020,812.7083333,1359989688593,1359989709905,411073633,411094945,21312
1359989712,411097044,18,5911,328.3888889,1359989708559,1359989709775,411093603,411094819,1216
1359989712,411097048,2,158,79,1359989705867,1359989709771,411090915,411094819,3904
1359989712,411097048,16,6168,385.5,1359989698121,1359989706633,411083169,411091681,8512
1359989712,411097052,37,8829,238.6216216,1359989707206,1359989711878,411092258,411096930,4672
1359989712,411097068,12,3339,278.25,1359989710708,1359989711604,411095776,411096672,896
1359989712,411097072,18,5904,328,1359989703923,1359989705267,411088995,411090339,1344
1359989712,411097076,11,3515,319.5454545,1359989700142,1359989709806,411085218,411094882,9664
1359989712,411097084,26,6064,233.2307692,1359989707237,1359989708517,411092321,411093601,1280
1359989720,411105064,21,4859,231.3809524,1359989712379,1359989715003,411097443,411100067,2624
1359989720,411105116,23,5511,239.6086957,1359989715015,1359989716295,411100131,411101411,1280
1359989720,411105136,22,5029,228.5909091,1359989709936,1359989717616,411095072,411102752,7680
1359989732,411116708,11,7957,723.3636364,1359989706207,1359989706847,411090915,411091555,640
1359989732,411116740,31,21958,708.3225806,1359989703868,1359989717372,411088608,411102112,13504
1359989732,411116744,48,38819,808.7291667,1359989703867,1359989713083,411088611,411097827,9216
1359989732,411116776,11,8050,731.8181818,1359989706649,1359989707737,411091425,411092513,1088
1359989733,3344396460,13,9173,705.6153846,1359989705589,1359989706677,3344369049,3344370137,1088
1359989736,411121056,2,158,79,1359989717570,1359989733250,411102626,411118306,15680
1359989736,411121096,20,5549,277.45,1359989729499,1359989731355,411114595,411116451,1856
1359989740,411124760,7,490,70,1359989714152,1359989739048,411098912,411123808,24896
1359989740,411124804,16,3649,228.0625,1359989713087,1359989719039,411097891,411103843,5952
1359989744,411129136,2,131,65.5,1359989742258,1359989742258,411127394,411127394,0
1359989768,411153132,15,4561,304.0666667,1359989764275,1359989764787,411149407,411149919,512
1359989768,411153164,18,5122,284.5555556,1359989763094,1359989763862,411148258,411149026,768
1359989776,411160808,15,1417,94.46666667,1359989748985,1359989762553,411133793,411147361,13568
1359989776,411161068,23,5511,239.6086957,1359989769139,1359989770355,411154207,411155423,1216
1359989792,411176824,1,79,79,1359989764775,1359989764775,411149599,411149599,0
1359989792,411177068,2,131,65.5,1359989788339,1359989788339,411173407,411173407,0
1359989792,411177116,2,131,65.5,1359989788485,1359989788485,411173601,411173601,0
1359989796,411180788,5,647,129.4,1359989770702,1359989770830,411155490,411155618,128
1359989808,411192836,1,52,52,1359989780124,1359989780124,411164960,411164960,0
1359989808,411192868,6,578,96.33333333,1359989782203,1359989804219,411167071,411189087,22016
1359989832,411216860,4,1566,391.5,1359989804038,1359989813062,411188898,411197922,9024
1359989832,411217112,294,398157,1354.27551,1359989703497,1359989829129,411088609,411214241,125632
1359989848,411233108,28,5542,197.9285714,1359989824522,1359989840714,411209630,411225822,16192
1359989848,411233116,18,4900,272.2222222,1359989841795,1359989842563,411226911,411227679,768
1359989852,411236880,5,999,199.8,1359989824878,1359989840110,411209758,411224990,15232
1359989852,411236920,1,52,52,1359989824455,1359989824455,411209375,411209375,0
1359989868,3344531780,2,127,63.5,1359989866424,1359989866424,3344530204,3344530204,0
1359989868,411252892,1,711,711,1359989840931,1359989840931,411225823,411225823,0
1359989872,411257152,2,127,63.5,1359989865888,1359989865888,411251040,411251040,0
1359989872,411257200,3,183,61,1359989865905,1359989865905,411251105,411251105,0
1359989872,411257220,2,127,63.5,1359989866013,1359989866013,411251233,411251233,0
1359989872,411257220,2,127,63.5,1359989866013,1359989866013,411251233,411251233,0
1359989872,411257220,2,127,63.5,1359989866013,1359989866013,411251233,411251233,0
1359989872,411257224,3,183,61,1359989866073,1359989866073,411251297,411251297,0
1359989872,411257236,17,7359,432.8823529,1359989863500,1359989864076,411248736,411249312,576
1359989880,411265160,12,3339,278.25,1359989876313,1359989876761,411261473,411261921,448
1359989880,411265168,15,6128,408.5333333,1359989874639,1359989877071,411259807,411262239,2432
1359989880,411265236,21,4428,210.8571429,1359989874507,1359989875915,411259743,411261151,1408
1359989889,411273332,25,7026,281.04,1359989875476,1359989880916,411259808,411265248,5440
1359989889,411273376,21,5688,270.8571429,1359989883433,1359989886377,411267809,411270753,2944
1359989889,411273396,22,6257,284.4090909,1359989875474,1359989882322,411259870,411266718,6848
1359989900,411285148,12,3928,327.3333333,1359989875684,1359989877476,411260832,411262624,1792
1359989904,411289196,18,7170,398.3333333,1359989877043,1359989900275,411262239,411285471,23232
1359989904,411289212,26,4046,155.6153846,1359989877413,1359989886565,411262625,411271777,9152
1359989908,411293148,38,10171,267.6578947,1359989882725,1359989907621,411267873,411292769,24896
1359989908,411293180,15,3889,259.2666667,1359989880580,1359989881284,411265760,411266464,704
1359989913,411297308,17,4642,273.0588235,1359989907433,1359989911337,411291741,411295645,3904
1359989913,411297316,17,4273,251.3529412,1359989911460,1359989912164,411295776,411296480,704
1359989913,411297376,29,6672,230.0689655,1359989908392,1359989910504,411292768,411294880,2112
1359989921,411305348,28,8644,308.7142857,1359989918146,1359989919874,411302494,411304222,1728
1359989921,411305352,25,6834,273.36,1359989910589,1359989915773,411294941,411300125,5184
1359989924,411309288,1,646,646,1359989897559,1359989897559,411282847,411282847,0
1359989929,411313388,8,1717,214.625,1359989903771,1359989921819,411288159,411306207,18048
1359989929,411313548,33,7751,234.8787879,1359989920060,1359989922428,411304608,411306976,2368
1359989933,3344596808,3,870,290,1359989907225,1359989907225,3344571033,3344571033,0
1359989936,411321272,78,102507,1314.192308,1359989907750,1359989908454,411293022,411293726,704
1359989940,411325292,51,62515,1225.784314,1359989913618,1359989914194,411298910,411299486,576
1359989940,411325292,31,20941,675.516129,1359989913618,1359989919186,411298910,411304478,5568
1359989940,411325300,9,4521,502.3333333,1359989914764,1359989915532,411300064,411300832,768
1359989941,411325336,21,12750,607.1428571,1359989914573,1359989917197,411298909,411301533,2624
1359989945,411329332,14,9810,700.7142857,1359989917202,1359989918418,411301534,411302750,1216
1359989945,411329412,12,4041,336.75,1359989920192,1359989920832,411304604,411305244,640
1359989957,411341372,8,2872,359,1359989931883,1359989932459,411316255,411316831,576
1359989961,411345400,4,208,52,1359989934479,1359989946767,411318879,411331167,12288
1359989977,411361576,20,2622,131.1,1359989976223,1359989976863,411360799,411361439,640
1359989981,411365408,16,15420,963.75,1359989954885,1359989978245,411339293,411362653,23360
1359990009,411393588,2,131,65.5,1359990001809,1359990001809,411386397,411386397,0
1359990017,411401552,4,235,58.75,1359990012981,1359990012981,411397533,411397533,0
1359990017,411401568,18,4769,264.9444444,1359990014691,1359990016227,411399259,411400795,1536
1359990017,411401596,18,4705,261.3888889,1359990012873,1359990014153,411397469,411398749,1280
1359990025,411409612,14,4204,300.2857143,1359990017337,1359990017913,411401949,411402525,576
1359990029,411413472,2,537,268.5,1359990003717,1359990003909,411388189,411388381,192
1359990033,411417604,18,4760,264.4444444,1359990028419,1359990029443,411413023,411414047,1024
1359990033,411417608,2,131,65.5,1359990028796,1359990028796,411413404,411413404,0
1359990033,411417620,18,4715,261.9444444,1359990027056,1359990028144,411411676,411412764,1088
1359990033,411417644,329,444875,1352.203647,1359989908376,1359990029848,411293020,411414492,121472
1359990037,411421516,11,1135,103.1818182,1359990012697,1359990016089,411397213,411400605,3392
1359990041,411425596,2,131,65.5,1359990034762,1359990034762,411419358,411419358,0
1359990041,411425636,2,131,65.5,1359990037215,1359990037215,411421851,411421851,0
1359990049,411433584,6,419,69.83333333,1359990040918,1359990041174,411425502,411425758,256
1359990049,411433688,2,131,65.5,1359990042668,1359990042668,411427356,411427356,0
1359990053,411437672,12,1061,88.41666667,1359990026366,1359990027070,411411038,411411742,704
1359990053,411437720,22,4348,197.6363636,1359990027853,1359990029133,411412573,411413853,1280
1359990053,411437720,1,52,52,1359990027917,1359990027917,411412637,411412637,0
1359990053,411437732,15,3228,215.2,1359990026623,1359990033215,411411355,411417947,6592
1359990057,411441912,9,3463,384.7777778,1359990029453,1359990029773,411414365,411414685,320
1359990061,411445724,3,591,197,1359990034314,1359990034442,411419038,411419166,128
1359990065,411449580,5,421,84.2,1359990053463,1359990057111,411438043,411441691,3648
1359990065,411449708,6,467,77.83333333,1359990056282,1359990062490,411440990,411447198,6208
1359990073,411457600,6,419,69.83333333,1359990069379,1359990071107,411453979,411455707,1728
1359990073,411457612,6,419,69.83333333,1359990068471,1359990071095,411453083,411455707,2624
1359990081,411465572,3,183,61,1359990077792,1359990077792,411462364,411462364,0
1359990081,411465576,6,652,108.6666667,1359990074398,1359990077790,411458974,411462366,3392
1359990081,411465620,3,183,61,1359990077744,1359990077744,411462364,411462364,0
1359990081,411465624,5,287,57.4,1359990066474,1359990077738,411451098,411462362,11264
1359990101,411485844,8,4292,536.5,1359990073617,1359990077457,411458461,411462301,3840
1359990105,411489588,3,164,54.66666667,1359990097104,1359990097296,411481692,411481884,192
1359990105,411489588,5,501,100.2,1359990101200,1359990101200,411485788,411485788,0
1359990105,411489592,18,20581,1143.388889,1359990101709,1359990101773,411486301,411486365,64
1359990105,411489592,5,1757,351.4,1359990101836,1359990101900,411486428,411486492,64
1359990105,411489600,7,5311,758.7142857,1359990100994,1359990101058,411485594,411485658,64
1359990105,411489604,3,1054,351.3333333,1359990100993,1359990101185,411485597,411485789,192
1359990105,411489648,4,723,180.75,1359990101141,1359990101205,411485789,411485853,64
1359990105,411489648,4,615,153.75,1359990101331,1359990101459,411485979,411486107,128
1359990105,411489648,23,26995,1173.695652,1359990101458,1359990101650,411486106,411486298,192
1359990105,411489652,37,48353,1306.837838,1359990101650,1359990101778,411486302,411486430,128
1359990105,411489652,7,4169,595.5714286,1359990101585,1359990101777,411486237,411486429,192
1359990105,411489652,103,142616,1384.621359,1359990101713,1359990102097,411486365,411486749,384
1359990105,411489652,4,1036,259,1359990101649,1359990101713,411486301,411486365,64
1359990105,411489652,69,86548,1254.318841,1359990097808,1359990100752,411482460,411485404,2944
1359990105,411489652,6,3889,648.1666667,1359990101839,1359990101903,411486491,411486555,64
1359990105,411489652,24,29753,1239.708333,1359990101839,1359990102095,411486491,411486747,256
1359990105,411489656,8,4353,544.125,1359990099466,1359990102602,411484122,411487258,3136
1359990105,411489660,5,929,185.8,1359990100294,1359990100358,411484954,411485018,64
1359990105,411489688,5,2198,439.6,1359990100586,1359990100714,411485274,411485402,128
1359990105,411489692,13,13260,1020,1359990104358,1359990104486,411489050,411489178,128
1359990105,411489692,4,356,89,1359990104553,1359990104681,411489245,411489373,128
1359990105,411489816,8,4238,529.75,1359990077869,1359990078701,411462685,411463517,832
1359990105,411489888,8,4288,536,1359990078947,1359990088739,411463835,411473627,9792
1359990109,411493824,1,64,64,1359990084835,1359990084835,411469659,411469659,0
1359990109,411493872,1,64,64,1359990084724,1359990084724,411469596,411469596,0
1359990109,411493912,2,120,60,1359990083533,1359990086541,411468445,411471453,3008
1359990109,411493916,1,64,64,1359990084616,1359990084616,411469532,411469532,0
1359990113,411497592,4,1025,256.25,1359990104909,1359990105101,411489501,411489693,192
1359990113,411497592,56,59815,1068.125,1359990097291,1359990109131,411481883,411493723,11840
1359990113,411497596,29,31311,1079.689655,1359990097864,1359990106824,411482460,411491420,8960
1359990113,411497600,15,9875,658.3333333,1359990106882,1359990107202,411491482,411491802,320
1359990113,411497604,7,3375,482.1428571,1359990099648,1359990107072,411484252,411491676,7424
1359990113,411497604,5,2651,530.2,1359990099519,1359990107071,411484123,411491675,7552
1359990113,411497608,10,7978,797.8,1359990100667,1359990109243,411485275,411493851,8576
1359990113,411497636,5,373,74.6,1359990104801,1359990104929,411489437,411489565,128
1359990113,411497644,4,444,111,1359990105562,1359990105818,411490206,411490462,256
1359990113,411497652,33,38854,1177.393939,1359990099409,1359990107025,411484061,411491677,7616
1359990113,411497652,6,4078,679.6666667,1359990099536,1359990107024,411484188,411491676,7488
1359990113,411497672,4,352,88,1359990107709,1359990107773,411492381,411492445,64
1359990117,411501940,8,4232,529,1359990089008,1359990089904,411473948,411474844,896
1359990117,411501980,8,4234,529.25,1359990090249,1359990094217,411475229,411479197,3968
1359990121,411505580,4,431,107.75,1359990107671,1359990115287,411492251,411499867,7616
1359990121,411505896,1,52,52,1359990094365,1359990094365,411479261,411479261,0
1359990121,411505896,8,4234,529.25,1359990094875,1359990095835,411479771,411480731,960
1359990125,411509888,13,9733,748.6923077,1359990097507,1359990097763,411482395,411482651,256
1359990125,411509900,1,52,52,1359990099225,1359990099225,411484125,411484125,0
1359990129,411513584,2,131,65.5,1359990123730,1359990123730,411508314,411508314,0
1359990133,411517912,1,52,52,1359990105803,1359990105803,411490715,411490715,0
1359990137,411521608,168,21900,130.3571429,1359989875258,1359990136698,411259866,411521306,261440
1359990137,411521908,25,24796,991.84,1359990110417,1359990113425,411495325,411498333,3008
1359990137,411521960,16,3373,210.8125,1359990110620,1359990117148,411495580,411502108,6528
1359990161,411545620,2,127,63.5,1359990153839,1359990153839,411538459,411538459,0
1359990169,411553640,2,127,63.5,1359990167515,1359990167515,411552155,411552155,0
1359990193,411577724,2,127,63.5,1359990187589,1359990187589,411572313,411572313,0
1359990209,411593688,15,2867,191.1333333,1359990205992,1359990207464,411590680,411592152,1472
1359990209,411594152,1,187,187,1359990184282,1359990184282,411569434,411569434,0
1359990212,3344875920,9,4121,457.8888889,1359990210669,1359990211117,3344874589,3344875037,448
1359990212,3344875924,10,3478,347.8,1359990211498,1359990211882,3344875422,3344875806,384
1359990217,411601660,15,6224,414.9333333,1359990206855,1359990214343,411591515,411599003,7488
1359990225,411609648,12,3173,264.4166667,1359990217810,1359990218578,411602458,411603226,768
1359990225,411609652,17,4237,249.2352941,1359990218764,1359990219660,411603416,411604312,896
1359990225,411609652,51,9440,185.0980392,1359990206348,1359990217804,411591000,411602456,11456
1359990225,411609656,14,4034,288.1428571,1359990206793,1359990220937,411591449,411605593,14144
1359990225,411609660,14,4122,294.4285714,1359990215300,1359990218692,411599960,411603352,3392
1359990225,411609700,12,3172,264.3333333,1359990217949,1359990218653,411602649,411603353,704
1359990225,411609704,12,3179,264.9166667,1359990218712,1359990219416,411603416,411604120,704
1359990225,411609736,17,4271,251.2352941,1359990220283,1359990221051,411605019,411605787,768
1359990233,411618156,22,17388,790.3636364,1359990208535,1359990224471,411593691,411609627,15936
1359990233,411618156,61,61059,1000.967213,1359990208724,1359990224468,411593880,411609624,15744
1359990233,411618208,8,2488,311,1359990205347,1359990206243,411590555,411591451,896
1359990237,411622180,42,50635,1205.595238,1359990210620,1359990211068,411595800,411596248,448
1359990241,411626168,13,15350,1180.769231,1359990216585,1359990216713,411601753,411601881,128
1359990241,411626216,29,34517,1190.241379,1359990216473,1359990216665,411601689,411601881,192
1359990241,411626220,50,56066,1121.32,1359990216535,1359990218007,411601755,411603227,1472
1359990245,3344909200,5,2901,580.2,1359990217111,1359990219031,3344881311,3344883231,1920
1359990245,411630272,13,3106,238.9230769,1359990220512,1359990221024,411605784,411606296,512
1359990265,411650220,12,992,82.66666667,1359990237078,1359990237846,411622298,411623066,768
1359990273,411657688,16,3800,237.5,1359990267049,1359990269161,411651737,411653849,2112
1359990273,411657736,31,9894,319.1612903,1359990249211,1359990265723,411633947,411650459,16512
1359990285,411670236,18,16773,931.8333333,1359990258950,1359990266438,411644186,411651674,7488
1359990286,411670308,47,38475,818.6170213,1359990259813,1359990266277,411644121,411650585,6464
1359990289,411674264,10,7905,790.5,1359990262698,1359990263146,411647962,411648410,448
1359990289,411674300,17,2434,143.1764706,1359990261444,1359990286788,411646744,411672088,25344
1359990290,3344953376,6,2924,487.3333333,1359990262799,1359990263503,3344926175,3344926879,704
1359990290,3344953388,11,9035,821.3636364,1359990263680,1359990264064,3344927068,3344927452,384
1359990294,411678316,17,4686,275.6470588,1359990267421,1359990269725,411651737,411654041,2304
1359990310,411694312,4,481,120.25,1359990285151,1359990285407,411669463,411669719,256
1359990318,411702308,19,2149,113.1052632,1359990291365,1359990317093,411675673,411701401,25728
1359990326,411710300,14,16167,1154.785714,1359990298349,1359990321837,411682649,411706137,23488
1359990337,411721752,2,131,65.5,1359990331434,1359990331434,411716186,411716186,0
1359990342,411726312,1,52,52,1359990315424,1359990315424,411699736,411699736,0
1359990354,411738368,2,104,52,1359990326312,1359990326376,411710680,411710744,64
1359990361,411745756,5,260,52,1359990353572,1359990357092,411738328,411741848,3520
1359990362,411746628,1,52,52,1359990337126,1359990337126,411721754,411721754,0
1359990370,411754576,1,1426,1426,1359990345176,1359990345176,411729752,411729752,0
1359990393,411777720,114,146407,1284.27193,1359990265925,1359990387973,411650645,411772693,122048
1359990393,411777732,17,9986,587.4117647,1359990391035,1359990392571,411775767,411777303,1536
1359990393,411777772,338,461462,1365.272189,1359990262420,1359990387668,411647192,411772440,125248
1359990393,411777800,2,131,65.5,1359990389176,1359990389176,411773976,411773976,0
1359990409,411793736,10,2659,265.9,1359990394424,1359990401336,411779160,411786072,6912
1359990409,411793924,18,6521,362.2777778,1359990400635,1359990408123,411785559,411793047,7488
1359990414,411798796,1,189,189,1359990388281,1359990388281,411773077,411773077,0
1359990417,411801724,31,13886,447.9354839,1359990403906,1359990409794,411788630,411794518,5888
1359990417,411801724,15,10716,714.4,1359990412417,1359990415105,411797141,411799829,2688
1359990417,411801808,2,127,63.5,1359990416749,1359990416749,411801557,411801557,0
1359990418,411802764,1,1426,1426,1359990393116,1359990393116,411777880,411777880,0
1359990425,411809824,102,89963,881.9901961,1359990391969,1359990422689,411776793,411807513,30720
1359990426,411810740,8,2832,354,1359990401459,1359990407923,411786199,411792663,6464
1359990426,411810780,8,2918,364.75,1359990400780,1359990401292,411785560,411786072,512
1359990426,411810780,9,3463,384.7777778,1359990400843,1359990401547,411785623,411786327,704
1359990426,411810784,1,52,52,1359990401159,1359990401159,411785943,411785943,0
1359990430,411814836,6,5444,907.3333333,1359990403028,1359990403092,411787864,411787928,64
1359990433,411817784,25,9228,369.12,1359990431112,1359990432328,411815896,411817112,1216
1359990434,3345097468,1,52,52,1359990407601,1359990407601,3345071069,3345071069,0
1359990434,411818788,8,3138,392.25,1359990407492,1359990408452,411792280,411793240,960
1359990441,411825796,2,131,65.5,1359990436603,1359990436603,411821399,411821399,0
1359990442,411826824,15,3226,215.0666667,1359990417376,1359990423456,411802200,411808280,6080
1359990449,411833772,17,4107,241.5882353,1359990434066,1359990448274,411818838,411833046,14208
1359990449,411833776,7,990,141.4285714,1359990438477,1359990442829,411823253,411827605,4352
1359990449,411833784,6,987,164.5,1359990447045,1359990447173,411831829,411831957,128
1359990449,411833808,6,832,138.6666667,1359990437677,1359990442797,411822485,411827605,5120
1359990454,411838808,21,3368,160.3809524,1359990429103,1359990431535,411813911,411816343,2432
1359990454,411838856,9,2540,282.2222222,1359990428799,1359990429759,411813655,411814615,960
1359990454,411838856,9,2540,282.2222222,1359990428799,1359990429503,411813655,411814359,704
1359990457,411841816,17,3852,226.5882353,1359990453158,1359990453798,411837974,411838614,640
1359990457,411841824,29,8838,304.7586207,1359990450781,1359990452445,411835605,411837269,1664
1359990457,411841860,16,4215,263.4375,1359990448443,1359990449531,411833303,411834391,1088
1359990458,411842808,11,8376,761.4545455,1359990432623,1359990433519,411817431,411818327,896
1359990458,411842816,50,62406,1248.12,1359990433573,1359990434149,411818389,411818965,576
1359990458,411842852,43,52461,1220.023256,1359990432578,1359990433282,411817430,411818134,704
1359990465,411849800,4,223,55.75,1359990459254,1359990459446,411844054,411844246,192
1359990465,411849848,4,223,55.75,1359990459269,1359990459397,411844117,411844245,128
1359990474,411858788,8,2847,355.875,1359990449410,1359990452098,411834198,411836886,2688
1359990474,411858832,16,3262,203.875,1359990449558,1359990450454,411834390,411835286,896
1359990478,411862872,13,3954,304.1538462,1359990453103,1359990453679,411837975,411838551,576
1359990481,411865800,13,3243,249.4615385,1359990453815,1359990454391,411838615,411839191,576
1359990481,411865840,5,352,70.4,1359990477837,1359990479437,411862677,411864277,1600
1359990506,411890860,3,225,75,1359990481272,1359990492280,411866132,411877140,11008
1359990529,411913860,4,289,72.25,1359990527739,1359990528507,411912599,411913367,768
1359990534,411919160,1,75,75,1359990506765,1359990506765,411891925,411891925,0
1359990537,411921896,3,237,79,1359990529557,1359990535701,411914453,411920597,6144
1359990542,411927156,7,1015,145,1359990516879,1359990532879,411902035,411918035,16000
1359990550,411935152,8,1496,187,1359990523861,1359990549845,411909013,411934997,25984
1359990561,411945824,7,526,75.14285714,1359990553246,1359990560862,411938070,411945686,7616
1359990561,411945836,2,158,79,1359990543951,1359990560399,411928787,411945235,16448
1359990561,411945872,6,447,74.5,1359990554028,1359990557420,411938900,411942292,3392
1359990562,411947264,1,75,75,1359990536165,1359990536165,411921429,411921429,0
1359990569,411953880,2,158,79,1359990561059,1359990568355,411945939,411953235,7296
1359990574,411959208,1,145,145,1359990549150,1359990549150,411934358,411934358,0
1359990577,411961856,6,447,74.5,1359990570300,1359990574332,411955156,411959188,4032
1359990577,411961868,4,289,72.25,1359990571952,1359990574384,411956820,411959252,2432
1359990577,411961900,5,368,73.6,1359990574098,1359990575890,411958998,411960790,1792
1359990577,411961940,5,368,73.6,1359990573478,1359990575206,411958418,411960146,1728
1359990585,411969876,2,158,79,1359990577639,1359990584103,411962515,411968979,6464
1359990585,411969920,2,158,79,1359990577278,1359990581310,411962198,411966230,4032
1359990585,411969924,2,158,79,1359990577850,1359990581882,411962774,411966806,4032
1359990585,411969952,2,158,79,1359990568540,1359990584284,411953492,411969236,15744
1359990586,411971272,3,561,187,1359990559708,1359990579676,411944980,411964948,19968
1359990593,411977876,2,158,79,1359990578600,1359990587112,411963476,411971988,8512
1359990606,411991308,1,145,145,1359990581624,1359990581624,411966932,411966932,0
1359990609,411993916,2,158,79,1359990589953,1359990606017,411974869,411990933,16064
1359990609,411993960,2,158,79,1359990589266,1359990605394,411974226,411990354,16128
1359990610,411995300,1,79,79,1359990582528,1359990582528,411967828,411967828,0
1359990619,412003376,1,79,79,1359990593690,1359990593690,411978066,411978066,0
1359990623,412007400,1,79,79,1359990597570,1359990597570,411981970,411981970,0
1359990631,412015408,1,79,79,1359990604732,1359990604732,411989140,411989140,0
1359990639,412023356,1,79,79,1359990612591,1359990612591,411996947,411996947,0
1359990643,412027436,1,79,79,1359990616224,1359990616224,412000660,412000660,0
1359990651,412035372,1,79,79,1359990623519,1359990623519,412007891,412007891,0
1359990659,412043388,1,46,46,1359990634704,1359990634704,412019092,412019092,0
1359990663,412047416,1,79,79,1359990638133,1359990638133,412022549,412022549,0
1359990663,412047420,1,79,79,1359990638768,1359990638768,412023188,412023188,0
1359990667,412051384,1,79,79,1359990639057,1359990639057,412023441,412023441,0
1359990675,412059564,1,145,145,1359990647518,1359990647518,412032082,412032082,0
1359990703,412087672,1,79,79,1359990675187,1359990675187,412059859,412059859,0
1359990721,412105972,3,156,52,1359990716869,1359990717573,412101841,412102545,704
1359990721,412106000,3,156,52,1359990718251,1359990718955,412103251,412103955,704
1359990724,3345388008,4,208,52,1359990719194,1359990720794,3345383202,3345384802,1600
1359990763,412147736,1,46,46,1359990735664,1359990735664,412120400,412120400,0
1359990763,412147808,1,46,46,1359990738153,1359990738153,412122961,412122961,0
1359990764,3345428004,3,202,67.33333333,1359990763547,1359990763803,3345427551,3345427807,256
1359990764,3345428012,4,277,69.25,1359990762901,1359990763605,3345426913,3345427617,704
1359990769,412153996,6,427,71.16666667,1359990763373,1359990766765,412148369,412151761,3392
1359990769,412154032,5,352,70.4,1359990766663,1359990768263,412151695,412153295,1600
1359990769,412154052,5,352,70.4,1359990765495,1359990767095,412150547,412152147,1600
1359990772,3345436008,3,225,75,1359990764570,1359990770458,3345428578,3345434466,5888
1359990772,3345436016,4,300,75,1359990764178,1359990770258,3345428194,3345434274,6080
1359990795,412179708,1,145,145,1359990767819,1359990767819,412152527,412152527,0
1359990795,412179712,3,225,75,1359990770442,1359990781514,412155154,412166226,11072
1359990795,412179744,4,300,75,1359990769258,1359990794730,412154002,412179474,25472
1359990795,412179776,3,225,75,1359990770569,1359990792265,412155345,412177041,21696
1359990796,3345460004,2,150,75,1359990778270,1359990793822,3345442274,3345457826,15552
1359990796,3345460008,2,150,75,1359990777176,1359990791064,3345441184,3345455072,13888
1359990823,412207716,1,75,75,1359990796227,1359990796227,412180943,412180943,0
1359990846,3345509976,1,75,75,1359990818810,1359990818810,3345482786,3345482786,0
1359990847,412232076,1,75,75,1359990820764,1359990820764,412205840,412205840,0
1359990850,3345514016,1,75,75,1359990825040,1359990825040,3345489056,3345489056,0
1359990851,412235992,1,75,75,1359990825521,1359990825521,412210513,412210513,0
1359990851,412235996,1,75,75,1359990823595,1359990823595,412208591,412208591,0
1359990905,412290040,2,656,328,1359990887808,1359990900288,412272848,412285328,12480
1359990937,412322092,6,427,71.16666667,1359990933257,1359990936777,412318349,412321869,3520
1359990953,412338088,15,6086,405.7333333,1359990947725,1359990948621,412332813,412333709,896
1359990961,412346120,22,25108,1141.272727,1359990956016,1359990956976,412341136,412342096,960
1359990967,412352188,2,150,75,1359990940458,1359990948074,412325646,412333262,7616
1359990967,412352220,4,481,120.25,1359990942283,1359990942347,412327503,412327567,64
1359990967,412352220,15,3226,215.0666667,1359990942347,1359990948363,412327567,412333583,6016
1359990967,412352264,10,901,90.1,1359990942173,1359990942557,412327437,412327821,384
1359990975,412360200,9,4564,507.1111111,1359990948255,1359990949663,412333455,412334863,1408
1359990975,412360200,34,5746,169,1359990948508,1359990951004,412333708,412336204,2496
1359990975,412360248,9,3463,384.7777778,1359990947760,1359990948208,412333008,412333456,448
1359990977,412362136,12,3557,296.4166667,1359990971487,1359990971935,412356623,412357071,448
1359990984,412368444,4,452,113,1359990957841,1359990957969,412342285,412342413,128
1359990985,412370084,5,532,106.4,1359990971603,1359990977939,412356687,412363023,6336
1359990985,412370084,16,6718,419.875,1359990971921,1359990979921,412357005,412365005,8000
1359990988,3345651992,22,22075,1003.409091,1359990972649,1359990980009,3345636641,3345644001,7360
1359990988,3345651996,12,4585,382.0833333,1359990973479,1359990982119,3345637475,3345646115,8640
1359990988,3345652000,13,9157,704.3846154,1359990972640,1359990980000,3345636640,3345644000,7360
1359990988,3345652000,54,64277,1190.314815,1359990972640,1359990982240,3345636640,3345646240,9600
1359990988,3345652000,12,7775,647.9166667,1359990972640,1359990980000,3345636640,3345644000,7360
1359990992,412376428,7,3666,523.7142857,1359990964065,1359990965793,412348493,412350221,1728
1359991000,412384448,1,52,52,1359990973132,1359990973132,412357580,412357580,0
1359991000,412384492,12,4316,359.6666667,1359990972257,1359990983009,412356749,412367501,10752
1359991001,412386156,20,2813,140.65,1359990992137,1359990993161,412377293,412378317,1024
1359991008,412392528,48,64303,1339.645833,1359990983295,1359990983615,412367823,412368143,320
1359991008,412392572,8,3298,412.25,1359990982483,1359990982931,412367055,412367503,448
1359991009,412394148,22,6464,293.8181818,1359990999441,1359991008849,412384589,412393997,9408
1359991012,3345676088,17,15018,883.4117647,1359991010444,1359991010828,3345674532,3345674916,384
1359991016,412400536,1,52,52,1359990987894,1359990987894,412372430,412372430,0
1359991025,412410156,32,7798,243.6875,1359990999496,1359991019720,412384652,412404876,20224
1359991025,412410160,33,6919,209.6666667,1359991019911,1359991021703,412405071,412406863,1792
1359991028,412412544,5,755,151,1359991000686,1359991006766,412385230,412391310,6080
1359991034,3345698264,5,2034,406.8,1359991007900,1359991008348,3345672164,3345672612,448
1359991034,3345698304,5,2027,405.4,1359991007987,1359991008499,3345672291,3345672803,512
1359991036,412420572,10,7209,720.9,1359991010256,1359991010960,412394828,412395532,704
1359991036,412420576,38,25823,679.5526316,1359991008591,1359991022351,412393167,412406927,13760
1359991036,412420600,24,14598,608.25,1359991009269,1359991022261,412393869,412406861,12992
1359991048,412432540,13,3676,282.7692308,1359991020464,1359991020976,412405004,412405516,512
1359991057,412442128,21,4785,227.8571429,1359991048419,1359991050339,412433547,412435467,1920
1359991073,412458148,2,131,65.5,1359991069584,1359991069584,412454732,412454732,0
1359991073,412458224,2,131,65.5,1359991070853,1359991070853,412456077,412456077,0
1359991084,412468644,38,42020,1105.789474,1359991057352,1359991058632,412441996,412443276,1280
1359991097,412482188,3,138,46,1359991093927,1359991093927,412479115,412479115,0
1359991097,412482188,12,3339,278.25,1359991093927,1359991094503,412479115,412479691,576
1359991099,3345762352,1,913,913,1359991072746,1359991072746,3345736098,3345736098,0
1359991100,412484596,14,3339,238.5,1359991073081,1359991091513,412457677,412476109,18432
1359991100,412484644,15,6636,442.4,1359991072778,1359991088842,412457422,412473486,16064
1359991100,412484664,73,100026,1370.219178,1359991073010,1359991089458,412457674,412474122,16448
1359991108,412492652,43,48354,1124.511628,1359991083456,1359991092928,412468108,412477580,9472
1359991113,412498164,2,131,65.5,1359991106238,1359991106238,412491402,412491402,0
1359991120,412504600,1,76,76,1359991093492,1359991093492,412478092,412478092,0
1359991120,412504648,1,168,168,1359991093188,1359991093188,412477836,412477836,0
1359991121,412506204,3,138,46,1359991117528,1359991117592,412502732,412502796,64
1359991124,412508672,35,5107,145.9142857,1359991097770,1359991104874,412482442,412489546,7104
1359991128,412512732,1,48,48,1359991103153,1359991103153,412487885,412487885,0
1359991137,412522312,33,41689,1263.30303,1359991134764,1359991134956,412520076,412520268,192
1359991144,412528960,15,3210,214,1359991117837,1359991118413,412502797,412503373,576
1359991148,412532880,6,312,52,1359991121499,1359991141531,412506379,412526411,20032
1359991160,412545004,1,76,76,1359991135008,1359991135008,412520012,412520012,0
1359991176,412561020,6,312,52,1359991151376,1359991171472,412536396,412556492,20096
1359991178,412562316,135,175967,1303.459259,1359991052177,1359991177681,412436493,412561997,125504
1359991186,412570320,2,131,65.5,1359991178891,1359991178891,412563211,412563211,0
1359991208,412593048,19,1662,87.47368421,1359991181364,1359991202164,412566412,412587212,20800
1359991210,412594320,2,131,65.5,1359991203596,1359991203596,412587916,412587916,0
1359991210,412594320,11,2487,226.0909091,1359991203658,1359991204298,412587978,412588618,640
1359991210,412594332,2,131,65.5,1359991209021,1359991209021,412593353,412593353,0
1359991218,412602372,27,5351,198.1851852,1359991216024,1359991217304,412600396,412601676,1280
1359991220,412605008,1,52,52,1359991192665,1359991192665,412577673,412577673,0
1359991234,412618316,3,138,46,1359991230157,1359991230157,412614473,412614473,0
1359991234,412618352,19,5681,299,1359991226090,1359991227370,412610442,412611722,1280
1359991234,412618360,14,4245,303.2142857,1359991225636,1359991226148,412609996,412610508,512
1359991234,412618692,17,3749,220.5294118,1359991230168,1359991230936,412614860,412615628,768
1359991234,412618696,26,5847,224.8846154,1359991227985,1359991229713,412612681,412614409,1728
1359991240,412625016,1,52,52,1359991212433,1359991212433,412597449,412597449,0
1359991240,412625104,1,225,225,1359991214332,1359991214332,412599436,412599436,0
1359991242,412626332,2,131,65.5,1359991238911,1359991238911,412623243,412623243,0
1359991242,412626332,12,3414,284.5,1359991239038,1359991239678,412623370,412624010,640
1359991242,412626400,3,138,46,1359991238907,1359991238971,412623307,412623371,64
1359991244,412629036,29,22869,788.5862069,1359991216704,1359991229440,412601740,412614476,12736
1359991252,412637056,26,28703,1103.961538,1359991226857,1359991227497,412611913,412612553,640
1359991252,412637060,11,6814,619.4545455,1359991227044,1359991227556,412612104,412612616,512
1359991252,412637136,19,12867,677.2105263,1359991226971,1359991229339,412612107,412614475,2368
1359991252,412637136,5,4312,862.4,1359991227289,1359991227609,412612425,412612745,320
1359991255,3345918540,1,1028,1028,1359991228530,1359991228530,3345892070,3345892070,0
1359991256,412641036,32,6001,187.53125,1359991229884,1359991251388,412614920,412636424,21504
1359991256,412641108,38,45724,1203.263158,1359991229367,1359991229943,412614475,412615051,576
1359991258,412642344,12,3339,278.25,1359991256307,1359991257075,412640651,412641419,768
1359991258,412642388,3,138,46,1359991256263,1359991256263,412640651,412640651,0
1359991264,412649052,1,46,46,1359991238124,1359991238124,412623176,412623176,0
1359991264,412649076,29,37660,1298.62069,1359991238804,1359991238932,412623880,412624008,128
1359991264,412649120,10,3725,372.5,1359991238251,1359991238955,412623371,412624075,704
1359991265,412650300,17,4275,251.4705882,1359991257206,1359991258870,412642506,412644170,1664
1359991266,412650340,22,5472,248.7272727,1359991256309,1359991258165,412640649,412642505,1856
1359991268,412653068,1,46,46,1359991240284,1359991240284,412625352,412625352,0
1359991268,412653152,7,1049,149.8571429,1359991242634,1359991266186,412627786,412651338,23552
1359991274,412658336,14,4210,300.7142857,1359991267065,1359991267513,412651401,412651849,448
1359991274,412658380,28,8837,315.6071429,1359991265741,1359991267405,412650121,412651785,1664
1359991274,412658408,18,4937,274.2777778,1359991267763,1359991268595,412652171,412653003,832
1359991284,412669120,31,6270,202.2580645,1359991259051,1359991278507,412644171,412663627,19456
1359991292,412677196,1,725,725,1359991267614,1359991267614,412652810,412652810,0
1359991305,412689396,13,3132,240.9230769,1359991279038,1359991279678,412663434,412664074,640
1359991305,412689476,7,490,70,1359991279983,1359991301423,412664459,412685899,21440
1359991330,412714348,14,4209,300.6428571,1359991323372,1359991323756,412707720,412708104,384
1359991330,412714384,11,2479,225.3636364,1359991322376,1359991322952,412706760,412707336,576
1359991333,412717416,1,187,187,1359991308841,1359991308841,412693257,412693257,0
1359991337,412721444,18,8368,464.8888889,1359991309710,1359991311246,412694154,412695690,1536
1359991337,412721476,14,1518,108.4285714,1359991311407,1359991330671,412695883,412715147,19264
1359991354,412738332,2,131,65.5,1359991348091,1359991348091,412732423,412732423,0
1359991354,412738376,2,131,65.5,1359991350608,1359991350608,412734984,412734984,0
1359991354,412738396,2,131,65.5,1359991348222,1359991348222,412732618,412732618,0
1359991362,412746332,2,131,65.5,1359991359613,1359991359613,412743945,412743945,0
1359991378,412762324,14,4176,298.2857143,1359991369218,1359991370754,412753542,412755078,1536
1359991378,412762376,19,4929,259.4210526,1359991371150,1359991373710,412755526,412758086,2560
1359991381,412765520,12,1398,116.5,1359991353409,1359991354113,412737929,412738633,704
1359991385,412769628,1,52,52,1359991359315,1359991359315,412743943,412743943,0
1359991393,412777620,4,764,191,1359991368219,1359991368923,412752839,412753543,704
1359991394,412778376,4,994,248.5,1359991368976,1359991370128,412753352,412754504,1152
1359991421,412805568,4,450,112.5,1359991393294,1359991420110,412777862,412804678,26816
1359991441,412825548,1,52,52,1359991413412,1359991413412,412797960,412797960,0
1359991445,412829588,2,783,391.5,1359991417145,1359991417209,412801733,412801797,64
1359991445,412829612,13,3132,240.9230769,1359991417507,1359991418211,412802119,412802823,704
1359991450,412834444,11,2420,220,1359991446602,1359991447178,412831046,412831622,576
1359991450,412834476,13,4120,316.9230769,1359991447596,1359991447980,412832072,412832456,384
1359991457,412841896,13,1253,96.38461538,1359991429765,1359991445573,412814661,412830469,15808
1359991458,412842420,6,984,164,1359991451489,1359991451617,412835909,412836037,128
1359991458,412842460,17,4275,251.4705882,1359991453884,1359991454908,412838344,412839368,1024
1359991458,412842492,23,5502,239.2173913,1359991451035,1359991452187,412835527,412836679,1152
1359991461,412845904,1,60,60,1359991436030,1359991436030,412820934,412820934,0
1359991466,412850456,27,5096,188.7407407,1359991458173,1359991459261,412842629,412843717,1088
1359991477,412861888,28,5120,182.8571429,1359991451984,1359991471312,412836872,412856200,19328
1359991477,412861892,13,3106,238.9230769,1359991452745,1359991453385,412837637,412838277,640
1359991485,412869868,2,1683,841.5,1359991459044,1359991459044,412843912,412843912,0
1359991490,412874500,3,305,101.6666667,1359991484305,1359991484561,412868805,412869061,256
1359991493,412877916,1,225,225,1359991468531,1359991468531,412853447,412853447,0
1359991501,412885996,1,46,46,1359991476580,1359991476580,412861576,412861576,0
1359991506,412890428,18,4861,270.0555556,1359991499418,1359991501274,412883846,412885702,1856
1359991506,412890460,14,4202,300.1428571,1359991497531,1359991499003,412881991,412883463,1472
1359991516,3346180248,2,127,63.5,1359991508397,1359991508397,3346172645,3346172645,0
1359991521,412905936,15,1495,99.66666667,1359991496158,1359991514782,412881094,412899718,18624
1359991521,412905984,1,46,46,1359991495853,1359991495853,412880837,412880837,0
1359991525,412909968,4,1013,253.25,1359991497599,1359991507839,412882567,412892807,10240
1359991537,412921908,2,783,391.5,1359991509945,1359991510009,412894853,412894917,64
1359991537,412921912,13,3132,240.9230769,1359991510327,1359991510967,412895239,412895879,640
1359991541,412925940,1,46,46,1359991513688,1359991513688,412898628,412898628,0
1359991545,412930000,1,60,60,1359991520031,1359991520031,412905031,412905031,0
1359991549,412934000,17,1630,95.88235294,1359991524702,1359991544222,412909702,412929222,19520
1359991554,412938440,8,1842,230.25,1359991545806,1359991546126,412930246,412930566,320
1359991554,412938484,18,4886,271.4444444,1359991546528,1359991547424,412931012,412931908,896
1359991578,412962452,3,210,70,1359991573760,1359991574016,412958212,412958468,256
1359991585,412969980,23,2429,105.6086957,1359991559090,1359991561010,412944070,412945990,1920
1359991589,412974056,2,450,225,1359991563044,1359991563364,412948100,412948420,320
1359991602,412986536,13,4116,316.6153846,1359991597166,1359991599022,412981702,412983558,1856
1359991610,412994608,18,4847,269.2777778,1359991599523,1359991602467,412984131,412987075,2944
1359991622,413006648,4,901,225.25,1359991597117,1359991606013,412981765,412990661,8896
1359991622,413006688,12,1290,107.5,1359991595859,1359991621267,412980547,413005955,25408
1359991634,413018580,14,4161,297.2142857,1359991629566,1359991630782,413014146,413015362,1216
1359991634,413018624,23,5479,238.2173913,1359991617109,1359991629141,413001733,413013765,12032
1359991642,413026392,2,783,391.5,1359991617468,1359991617532,413001860,413001924,64
1359991654,413038388,12,1351,112.5833333,1359991626943,1359991634943,413011331,413019331,8000
1359991658,413042388,21,3757,178.9047619,1359991632446,1359991633214,413016834,413017602,768
1359991670,413054392,20,2975,148.75,1359991642173,1359991644285,413026565,413028677,2112
1359991674,413058660,9,1896,210.6666667,1359991666926,1359991667502,413051586,413052162,576
1359991674,413058668,18,4808,267.1111111,1359991667880,1359991670120,413052548,413054788,2240
1359991678,413062360,1,46,46,1359991649882,1359991649882,413034242,413034242,0
1359991682,413066404,1,46,46,1359991654961,1359991654961,413039365,413039365,0
1359991690,413074364,1,46,46,1359991664472,1359991664472,413048836,413048836,0
1359991690,413074372,4,764,191,1359991665489,1359991666449,413049861,413050821,960
1359991694,413078312,1,683,683,1359991666444,1359991666444,413050756,413050756,0
1359991718,413102480,1,242,242,1359991693474,1359991693474,413077954,413077954,0
1359991730,413114660,2,127,63.5,1359991728111,1359991728111,413112771,413112771,0
1359991730,413114692,2,127,63.5,1359991729744,1359991729744,413114436,413114436,0
1359991732,3346396264,3,179,59.66666667,1359991727775,1359991728095,3346392039,3346392359,320
1359991758,413142428,1,75,75,1359991730263,1359991730263,413114691,413114691,0
1359991770,413154660,2,131,65.5,1359991763500,1359991763500,413148160,413148160,0
1359991822,413206500,1,52,52,1359991796431,1359991796431,413180931,413180931,0
1359991826,413210468,13,3132,240.9230769,1359991799855,1359991800495,413184323,413184963,640
1359991826,413210468,8,3138,392.25,1359991799855,1359991800303,413184323,413184771,448
1359991826,413210540,1,46,46,1359991799462,1359991799462,413184002,413184002,0
1359991826,413210548,7,490,70,1359991800859,1359991822107,413185407,413206655,21248
1359991834,413218944,14,4186,299,1359991829008,1359991829456,413213952,413214400,448
1359991834,413218988,11,2436,221.4545455,1359991827750,1359991828326,413212738,413213314,576
1359991842,413226976,16,4229,264.3125,1359991837232,1359991838256,413222208,413223232,1024
1359991842,413226980,35,6750,192.8571429,1359991832494,1359991836334,413217474,413221314,3840
1359991842,413226992,6,984,164,1359991835425,1359991835617,413220417,413220609,192
1359991850,413234940,28,8786,313.7857143,1359991837843,1359991842387,413222783,413227327,4544
1359991854,413238468,17,2316,136.2352941,1359991826668,1359991853676,413211136,413238144,27008
1359991858,413242944,18,4849,269.3888889,1359991854930,1359991857554,413239874,413242498,2624
1359991858,413242972,30,6980,232.6666667,1359991840691,1359991854067,413225663,413239039,13376
1359991862,413246544,1,46,46,1359991837601,1359991837601,413222145,413222145,0
1359991862,413246616,13,3106,238.9230769,1359991837017,1359991837529,413221633,413222145,512
1359991862,413246620,31,5204,167.8709677,1359991837654,1359991856342,413222274,413240962,18688
1359991878,413262628,3,2010,670,1359991853644,1359991854220,413238272,413238848,576
1359991882,413266488,2,104,52,1359991853974,1359991854422,413238462,413238910,448
1359991906,413290932,19,7039,370.4736842,1359991901530,1359991903002,413286462,413287934,1472
1359991906,413290980,41,7458,181.902439,1359991885548,1359991900588,413270528,413285568,15040
1359991910,413294536,1,52,52,1359991883174,1359991883174,413267710,413267710,0
1359991910,413294660,9,1534,170.4444444,1359991885611,1359991903659,413270271,413288319,18048
1359991914,413298548,13,802,61.69230769,1359991887068,1359991913884,413271616,413298432,26816
1359991922,413307252,13,4112,316.3076923,1359991915933,1359991916445,413301185,413301697,512
1359991922,413307288,18,4807,267.0555556,1359991914616,1359991915576,413299904,413300864,960
1359991926,413310664,4,3806,951.5,1359991901607,1359991901607,413286271,413286271,0
1359991942,413326552,7,1097,156.7142857,1359991913943,1359991924311,413298495,413308863,10368
1359991954,413339228,14,4213,300.9285714,1359991945906,1359991949042,413331134,413334270,3136
1359991954,413339272,18,4820,267.7777778,1359991949512,1359991951176,413334784,413336448,1664
1359991962,413347240,3,210,70,1359991956838,1359991957094,413342078,413342334,256
1359991970,413354680,11,1109,100.8181818,1359991944984,1359991969112,413329664,413353792,24128
1359991970,413354684,2,718,359,1359991945620,1359991966932,413330304,413351616,21312
1359991974,413358564,28,3296,117.7142857,1359991947339,1359991969675,413331903,413354239,22336
1359991994,413378700,12,3080,256.6666667,1359991969347,1359991970243,413354047,413354943,896
1359991998,413382580,4,682,170.5,1359991970746,1359991995770,413355326,413380350,25024
1359992026,413410612,3,504,168,1359991998875,1359992017883,413383487,413402495,19008
1359992070,413454652,1,168,168,1359992043122,1359992043122,413427774,413427774,0
1359992090,413475312,3,210,70,1359992089372,1359992089692,413474684,413475004,320
1359992091,413475356,3,210,70,1359992089816,1359992090328,413474172,413474684,512
1359992098,413483284,3,237,79,1359992090488,1359992097144,413475772,413482428,6656
1359992099,413483328,3,237,79,1359992091190,1359992094646,413475518,413478974,3456
1359992115,413499324,2,158,79,1359992099191,1359992108279,413483515,413492603,9088
1359992118,413502784,1,168,168,1359992093549,1359992093549,413478333,413478333,0
1359992131,413515340,2,158,79,1359992106858,1359992124522,413491198,413508862,17664
1359992154,413538736,1,79,79,1359992125979,1359992125979,413510715,413510715,0
1359992186,413570872,1,79,79,1359992159188,1359992159188,413544060,413544060,0
1359992190,413574808,1,79,79,1359992162259,1359992162259,413547067,413547067,0
1359992222,413606808,1,168,168,1359992194643,1359992194643,413579451,413579451,0
1359992342,413726952,1,168,168,1359992314818,1359992314818,413699770,413699770,0
1359992403,413787724,4,277,69.25,1359992401572,1359992402276,413786296,413787000,704
1359992430,413815068,4,300,75,1359992402829,1359992415885,413787897,413800953,13056
1359992454,413839260,1,339,339,1359992427275,1359992427275,413812535,413812535,0
1359992459,413843336,1,75,75,1359992431462,1359992431462,413815798,413815798,0
1359992487,413871308,1,75,75,1359992461251,1359992461251,413845559,413845559,0
1359992603,413987972,13,4119,316.8461538,1359992600298,1359992601514,413985270,413986486,1216
1359992603,413987972,15,6088,405.8666667,1359992600360,1359992601832,413985332,413986804,1472
1359992603,413987972,28,7818,279.2142857,1359992600424,1359992602408,413985396,413987380,1984
1359992611,413996000,25,4789,191.56,1359992603342,1359992605262,413988342,413990262,1920
1359992611,413996000,18,4705,261.3888889,1359992604043,1359992604811,413989043,413989811,768
1359992619,414003968,5,871,174.2,1359992608364,1359992611244,413993332,413996212,2880
1359992619,414004000,8,2950,368.75,1359992610190,1359992613198,413995190,413998198,3008
1359992619,414004040,5,864,172.8,1359992609572,1359992611172,413994612,413996212,1600
1359992627,414011692,15,3057,203.8,1359992602690,1359992604674,413987382,413989366,1984
1359992627,414011692,15,3228,215.2,1359992602690,1359992611330,413987382,413996022,8640
1359992627,414011704,8,3138,392.25,1359992600563,1359992606067,413985267,413990771,5504
1359992627,414012080,30,9893,329.7666667,1359992605114,1359992622458,413990194,414007538,17344
1359992631,414015720,6,2955,492.5,1359992604005,1359992609189,413988725,413993909,5184
1359992631,414015752,20,4245,212.25,1359992605508,1359992619460,413990260,414004212,13952
1359992631,414015832,1,52,52,1359992605877,1359992605877,413990709,413990709,0
1359992635,414019728,8,5799,724.875,1359992608349,1359992609309,413993077,413994037,960
1359992635,414019732,47,56734,1207.106383,1359992609239,1359992609751,413993971,413994483,512
1359992635,414019804,12,5549,462.4166667,1359992609041,1359992609681,413993845,413994485,640
1359992635,414020048,17,4275,251.4705882,1359992633500,1359992634140,414018548,414019188,640
1359992643,414028028,31,10991,354.5483871,1359992639088,1359992640688,414024116,414025716,1600
1359992659,414044020,32,8260,258.125,1359992652471,1359992656759,414037491,414041779,4288
1359992659,414044052,30,8748,291.6,1359992650519,1359992652311,414035571,414037363,1792
1359992669,3347332656,14,8127,580.5,1359992660804,1359992661380,3347324460,3347325036,576
1359992675,414059752,27,17693,655.2962963,1359992649858,1359992654402,414034610,414039154,4544
1359992675,414059752,11,6593,599.3636364,1359992649858,1359992650434,414034610,414035186,576
1359992675,414059796,12,9904,825.3333333,1359992649687,1359992650199,414034483,414034995,512
1359992675,414059800,8,4448,556,1359992650324,1359992650772,414035124,414035572,448
1359992675,414060048,5,895,179,1359992673370,1359992674202,414058418,414059250,832
1359992675,414060052,4,444,111,1359992674521,1359992674713,414059573,414059765,192
1359992679,414063800,11,3429,311.7272727,1359992652690,1359992654482,414037490,414039282,1792
1359992683,414067760,11,6698,608.9090909,1359992655420,1359992655996,414040180,414040756,576
1359992683,414068100,27,31537,1168.037037,1359992674217,1359992676777,414059317,414061877,2560
1359992691,414076040,4,356,89,1359992676514,1359992684066,414061554,414069106,7552
1359992691,414076112,4,431,107.75,1359992677594,1359992683994,414062706,414069106,6400
1359992691,414076112,14,14573,1040.928571,1359992677725,1359992683997,414062837,414069109,6272
1359992707,414091724,3,817,272.3333333,1359992679072,1359992679136,414063796,414063860,64
1359992707,414091772,13,1462,112.4615385,1359992679086,1359992679790,414063858,414064562,704
1359992723,414108064,5,352,70.4,1359992720204,1359992721868,414105268,414106932,1664
1359992723,414108068,5,352,70.4,1359992721222,1359992722822,414106290,414107890,1600
1359992731,414116144,6,447,74.5,1359992725497,1359992729465,414110641,414114609,3968
1359992747,414132108,2,158,79,1359992733664,1359992741984,414118772,414127092,8320
1359992751,414135764,4,300,75,1359992724024,1359992750136,414108788,414134900,26112
1359992751,414135768,3,225,75,1359992724977,1359992736113,414109745,414120881,11136
1359992771,414156144,4,289,72.25,1359992770041,1359992770745,414155185,414155889,704
1359992779,414163788,1,75,75,1359992751007,1359992751007,414135795,414135795,0
1359992779,414163916,7,1372,196,1359992754399,1359992770783,414139315,414155699,16384
1359992779,414164060,121,154071,1273.31405,1359992655116,1359992777420,414040176,414162480,122304
1359992779,414164108,3,237,79,1359992771741,1359992777501,414156849,414162609,5760
1359992779,414164112,5,368,73.6,1359992775641,1359992777369,414160753,414162481,1728
1359992779,414164140,242,318538,1316.272727,1359992649344,1359992778496,414034484,414163636,129152
1359992779,414164140,6,447,74.5,1359992774015,1359992777855,414159155,414162995,3840
1359992787,414171864,1,79,79,1359992758930,1359992758930,414143794,414143794,0
1359992787,414172080,2,158,79,1359992779449,1359992783481,414164529,414168561,4032
1359992787,414172084,3,237,79,1359992779508,1359992785076,414164592,414170160,5568
1359992787,414172128,2,158,79,1359992779275,1359992783179,414164403,414168307,3904
1359992795,414180216,2,158,79,1359992781810,1359992789938,414167026,414175154,8128
1359992803,414188148,2,158,79,1359992785141,1359992800437,414170289,414185585,15296
1359992803,414188184,5,368,73.6,1359992799187,1359992800979,414184371,414186163,1792
1359992807,414191888,1,75,75,1359992779897,1359992779897,414164785,414164785,0
1359992807,414191896,1,75,75,1359992780659,1359992780659,414165555,414165555,0
1359992811,414196152,2,158,79,1359992803122,1359992807218,414188274,414192370,4096
1359992811,414196152,2,158,79,1359992790961,1359992806641,414176113,414191793,15680
1359992811,414196156,2,158,79,1359992791470,1359992807534,414176626,414192690,16064
1359992811,414196164,2,158,79,1359992792423,1359992807271,414177587,414192435,14848
1359992815,414199896,1,196,196,1359992787378,1359992787378,414172274,414172274,0
1359992819,414203992,1,79,79,1359992792144,1359992792144,414177136,414177136,0
1359992831,414216072,1,79,79,1359992806274,1359992806274,414191346,414191346,0
1359992835,414220180,2,158,79,1359992815381,1359992831829,414200561,414217009,16448
1359992847,414231980,1,196,196,1359992820571,1359992820571,414205551,414205551,0
1359992859,414243948,1,79,79,1359992831293,1359992831293,414216241,414216241,0
1359992863,414248008,1,79,79,1359992837185,1359992837185,414222193,414222193,0
1359992863,414248016,1,79,79,1359992838074,1359992838074,414223090,414223090,0
1359992863,414248100,1,79,79,1359992838692,1359992838692,414223792,414223792,0
1359992867,414251964,8,1480,185,1359992838891,1359992864107,414223855,414249071,25216
1359992867,414252064,1,79,79,1359992839818,1359992839818,414224882,414224882,0
1359992891,414276108,1,79,79,1359992864795,1359992864795,414249903,414249903,0
1359992899,414284152,3,555,185,1359992873967,1359992893935,414259119,414279087,19968
1359992915,414300024,1,196,196,1359992887088,1359992887088,414272112,414272112,0
1359992924,414308748,5,260,52,1359992919108,1359992922692,414303856,414307440,3584
1359992940,414324728,2,104,52,1359992926487,1359992934103,414311215,414318831,7616
1359992956,414340704,2,104,52,1359992944113,1359992954097,414328817,414338801,9984
1359992975,414360204,1,46,46,1359992949372,1359992949372,414334576,414334576,0
1359992983,414368240,1,46,46,1359992958551,1359992958551,414343791,414343791,0
1359992987,414372148,1,46,46,1359992961268,1359992961268,414346416,414346416,0
1359993035,414420200,1,196,196,1359993006975,1359993006975,414392175,414392175,0
1359993140,414524588,1,340,340,1359993114975,1359993114975,414499563,414499563,0
1359993156,414540800,6,427,71.16666667,1359993150797,1359993155085,414535597,414539885,4288
1359993172,414556896,2,150,75,1359993159533,1359993168685,414544429,414553581,9152
1359993212,414596840,1,75,75,1359993187042,1359993187042,414571882,414571882,0
1359993248,414633184,1,75,75,1359993223306,1359993223306,414608490,414608490,0
1359993282,3347945576,3,144,48,1359993256857,1359993265817,3347920433,3347929393,8960
1359993286,3347949548,3,144,48,1359993258486,1359993267446,3347922034,3347930994,8960
1360078356,499740336,13,3571,274.6923077,1360078353653,1360078355061,499737989,499739397,1408
1360078364,499748248,17,6876,404.4705882,1360078361165,1360078363469,499745413,499747717,2304
1360078364,499748284,16,5029,314.3125,1360078353641,1360078361577,499737925,499745861,7936
1360078364,499748296,18,4817,267.6111111,1360078360542,1360078361246,499744838,499745542,704
1360078372,499756384,15,6112,407.4666667,1360078362822,1360078364166,499747206,499748550,1344
1360078376,499760840,13,4986,383.5384615,1360078351486,1360078356414,499736326,499741254,4928
1360078376,499760908,18,4249,236.0555556,1360078351288,1360078357816,499736196,499742724,6528
1360078384,499768952,6,482,80.33333333,1360078359755,1360078360139,499744707,499745091,384
1360078388,499772220,18,7592,421.7777778,1360078385127,1360078387175,499769347,499771395,2048
1360078388,499772228,14,4138,295.5714286,1360078361440,1360078386528,499745668,499770756,25088
1360078388,499772264,12,3174,264.5,1360078387132,1360078387580,499771396,499771844,448
1360078388,499772268,24,5558,231.5833333,1360078363706,1360078385466,499747974,499769734,21760
1360078388,499772796,24,2267,94.45833333,1360078360040,1360078383656,499744836,499768452,23616
1360078396,499780256,17,4229,248.7647059,1360078388227,1360078389379,499772483,499773635,1152
1360078396,499780268,26,6628,254.9230769,1360078385656,1360078387960,499769924,499772228,2304
1360078396,499780336,28,5688,203.1428571,1360078389685,1360078390581,499774021,499774917,896
1360078396,499780344,4,223,55.75,1360078390445,1360078390573,499774789,499774917,128
1360078404,499788252,28,5761,205.75,1360078400841,1360078403145,499785093,499787397,2304
1360078404,499788260,19,4275,225,1360078398017,1360078400577,499782277,499784837,2560
1360078406,3433069256,19,14826,780.3157895,1360078396548,1360078399748,3433059804,3433063004,3200
1360078412,499796332,31,11266,363.4193548,1360078407481,1360078409401,499791813,499793733,1920
1360078412,499796808,9,6735,748.3333333,1360078387549,1360078395741,499772357,499780549,8192
1360078412,499796896,19,15165,798.1578947,1360078386950,1360078409030,499771846,499793926,22080
1360078416,499800876,10,4938,493.8,1360078388185,1360078390169,499773061,499775045,1984
1360078416,499800900,13,3106,238.9230769,1360078388800,1360078389696,499773700,499774596,896
1360078424,499808920,15,9960,664,1360078398955,1360078401579,499783875,499786499,2624
1360078428,499812264,19,5573,293.3157895,1360078422010,1360078422650,499806274,499806914,640
1360078436,499820928,21,24825,1182.142857,1360078409058,1360078409634,499793986,499794562,576
1360078444,499828896,4,208,52,1360078419589,1360078420869,499804485,499805765,1280
1360078448,499832936,24,17472,728,1360078422042,1360078432282,499806978,499817218,10240
1360078462,3433125304,14,8455,603.9285714,1360078458453,1360078459029,3433121757,3433122333,576
1360078485,499869168,11,9642,876.5454545,1360078458586,1360078459738,499842754,499843906,1152
1360078485,499869172,84,109278,1300.928571,1360078458712,1360078475672,499842884,499859844,16960
1360078493,499877228,18,3071,170.6111111,1360078464990,1360078467870,499849218,499852098,2880
1360078516,499900460,6,447,74.5,1360078510455,1360078515063,499894915,499899523,4608
1360078516,499900528,6,447,74.5,1360078510002,1360078514354,499894530,499898882,4352
1360078517,499901332,1,1426,1426,1360078490998,1360078490998,499875330,499875330,0
1360078524,499908412,3,210,70,1360078521192,1360078522152,499905604,499906564,960
1360078532,499916440,2,158,79,1360078519947,1360078529675,499904387,499914115,9728
1360078532,499916448,2,158,79,1360078524036,1360078527876,499908484,499912324,3840
1360078532,499916484,2,158,79,1360078519008,1360078528224,499903492,499912708,9216
1360078537,499921340,7,1169,167,1360078511407,1360078528751,499895747,499913091,17344
1360078541,499925264,8,9683,1210.375,1360078516604,1360078531452,499900868,499915716,14848
1360078548,499932452,6,427,71.16666667,1360078543550,1360078547454,499928002,499931906,3904
1360078549,499933316,1,1426,1426,1360078521988,1360078521988,499906304,499906304,0
1360078556,499940456,2,158,79,1360078535548,1360078550972,499920004,499935428,15424
1360078564,499948452,2,150,75,1360078551548,1360078559868,499936000,499944320,8320
1360078572,499956524,4,277,69.25,1360078567478,1360078569526,499952002,499954050,2048
1360078573,499957288,1,167,167,1360078546465,1360078546465,499930753,499930753,0
1360078573,499957292,1,79,79,1360078546910,1360078546910,499931202,499931202,0
1360078573,499957440,1,1426,1426,1360078546634,1360078546634,499931074,499931074,0
1360078577,499961300,1,79,79,1360078549334,1360078549334,499933634,499933634,0
1360078580,499964432,2,150,75,1360078572369,1360078577809,499956801,499962241,5440
1360078588,499972524,2,1490,745,1360078577334,1360078586294,499961858,499970818,8960
1360078601,499985308,1,75,75,1360078576524,1360078576524,499960832,499960832,0
1360078604,499988508,5,260,52,1360078596740,1360078600644,499981248,499985152,3904
1360078605,499989380,1,79,79,1360078579654,1360078579654,499964034,499964034,0
1360078609,499993368,1,167,167,1360078581650,1360078581650,499966018,499966018,0
1360078609,499993372,1,79,79,1360078581839,1360078581839,499966211,499966211,0
1360078609,499993384,1,79,79,1360078583808,1360078583808,499968192,499968192,0
1360078612,499996468,2,150,75,1360078588780,1360078610668,499973248,499995136,21888
1360078613,499997344,1,79,79,1360078588266,1360078588266,499972610,499972610,0
1360078637,500021376,1,75,75,1360078609609,1360078609609,499993985,499993985,0
1360078677,500061580,1,167,167,1360078651964,1360078651964,500036544,500036544,0
1360078681,500065604,1,75,75,1360078654307,1360078654307,500038911,500038911,0
1360078733,500117740,1,46,46,1360078705179,1360078705179,500089919,500089919,0
1360078789,500173728,1,46,46,1360078761126,1360078761126,500145854,500145854,0
1360078798,500182100,1,167,167,1360078772763,1360078772763,500156863,500156863,0
1360078916,500300668,6,427,71.16666667,1360078909793,1360078913569,500294461,500298237,3776
1360078918,500302176,1,167,167,1360078893006,1360078893006,500277182,500277182,0
1360078932,500316676,2,150,75,1360078917527,1360078925527,500302203,500310203,8000
1360078970,500354144,1,75,75,1360078942124,1360078942124,500326268,500326268,0
1360078970,500354180,1,369,369,1360078944455,1360078944455,500328635,500328635,0
1360079002,500386128,1,75,75,1360078974204,1360078974204,500358332,500358332,0
1360079278,500662512,1,56,56,1360079251829,1360079251829,500636341,500636341,0
1360079743,501127232,8,1512,189,1360079715081,1360079742665,501099313,501126897,27584
1360079779,501163264,3,567,189,1360079752616,1360079772648,501136880,501156912,20032
1360080689,502073148,1,46,46,1360080662990,1360080662990,502047138,502047138,0
1360081782,503167196,16,7516,469.75,1360081777636,1360081779620,503162832,503164816,1984
1360081791,503175344,24,8222,342.5833333,1360081781177,1360081784825,503165521,503169169,3648
1360081791,503175344,18,7780,432.2222222,1360081778104,1360081785784,503162448,503170128,7680
1360081791,503175424,16,4837,302.3125,1360081786984,1360081789352,503171408,503173776,2368
1360081791,503175512,31,8340,269.0322581,1360081778256,1360081788496,503162768,503173008,10240
1360081798,503183204,35,10084,288.1142857,1360081784284,1360081792732,503169488,503177936,8448
1360081799,3436462504,19,17197,905.1052632,1360081794532,1360081794916,3436458036,3436458420,384
1360081799,503183972,19,4025,211.8421053,1360081770946,1360081778882,503155918,503163854,7936
1360081799,503184016,8,3304,413,1360081772249,1360081772953,503157265,503157969,704
1360081807,503191984,13,3785,291.1538462,1360081779832,1360081789112,503164816,503174096,9280
1360081807,503192012,11,946,86,1360081780444,1360081784284,503165456,503169296,3840
1360081811,503196108,25,16262,650.48,1360081785853,1360081807421,503170961,503192529,21568
1360081811,503196108,19,13660,718.9473684,1360081785852,1360081793468,503170960,503178576,7616
1360081815,503199256,32,12756,398.625,1360081804304,1360081807312,503188560,503191568,3008
1360081815,503199332,18,4406,244.7777778,1360081812802,1360081813250,503197134,503197582,448
1360081831,503215300,22,7674,348.8181818,1360081814116,1360081824420,503198416,503208720,10304
1360081848,503232248,11,6782,616.5454545,1360081823129,1360081824729,503207377,503208977,1600
1360081852,503236192,19,13428,706.7368421,1360081824721,1360081837329,503208913,503221521,12608
1360081863,503247264,20,6308,315.4,1360081861127,1360081861959,503245391,503246223,832
1360081884,503268336,22,16329,742.2272727,1360081859006,1360081880190,503243342,503264526,21184
1360081888,503272320,4,2396,599,1360081862032,1360081862416,503246352,503246736,384
1360081903,503287288,18,4711,261.7222222,1360081898223,1360081898799,503282511,503283087,576
1360081903,503287352,18,4723,262.3888889,1360081897197,1360081897709,503281549,503282061,512
1360081903,503287396,2,241,120.5,1360081883649,1360081900161,503268045,503284557,16512
1360081911,503295356,2,131,65.5,1360081909610,1360081909610,503293966,503293966,0
1360081911,503295384,22,7356,334.3636364,1360081899725,1360081909005,503284109,503293389,9280
1360081919,503303348,29,8073,278.3793103,1360081911539,1360081913843,503295887,503298191,2304
1360081919,503303424,35,11510,328.8571429,1360081913893,1360081917477,503298317,503301901,3584
1360081924,503308484,14,1008,72,1360081896873,1360081898089,503281357,503282573,1216
1360081924,503308512,17,3648,214.5882353,1360081897807,1360081906063,503282319,503290575,8256
1360081935,3436598560,21,17921,853.3809524,1360081928813,1360081929453,3436592373,3436593013,640
1360081935,3436598560,24,20480,853.3333333,1360081929196,1360081929964,3436592756,3436593524,768
1360081936,503320556,36,29837,828.8055556,1360081910435,1360081927779,503294991,503312335,17344
1360081936,503320556,32,20467,639.59375,1360081910499,1360081929635,503295055,503314191,19136
1360081940,503324436,13,3857,296.6923077,1360081913883,1360081915419,503298319,503299855,1536
1360081951,503335652,2,131,65.5,1360081944322,1360081944322,503328974,503328974,0
1360081951,503335736,230,303760,1320.695652,1360081802475,1360081942571,503187211,503327307,140096
1360081955,3436618788,5,2077,415.4,1360081928008,1360081928648,3436591796,3436592436,640
1360081956,503340436,10,8480,848,1360081928027,1360081928731,503312463,503313167,704
1360081959,503343348,13,3571,274.6923077,1360081956528,1360081958192,503340876,503342540,1664
1360081959,503343360,14,4448,317.7142857,1360081954983,1360081956455,503339343,503340815,1472
1360081959,503343420,2,127,63.5,1360081953577,1360081953577,503337997,503337997,0
1360081959,503343428,18,6661,370.0555556,1360081954914,1360081958242,503339342,503342670,3328
1360081959,503343428,22,4660,211.8181818,1360081949665,1360081951073,503334093,503335501,1408
1360081960,503344440,59,75903,1286.491525,1360081935382,1360081936150,503319822,503320590,768
1360081975,503359348,19,5148,270.9473684,1360081969519,1360081970223,503353867,503354571,704
1360081975,503359428,3,202,67.33333333,1360081973537,1360081973793,503357965,503358221,256
1360081983,503367396,21,5931,282.4285714,1360081979073,1360081982017,503363469,503366413,2944
1360081983,503367448,207,278309,1344.487923,1360081793932,1360081978892,503178380,503363340,184960
1360081996,503380544,5,3815,763,1360081970156,1360081981548,503354700,503366092,11392
1360081999,503383404,28,7734,276.2142857,1360081990520,1360081993144,503374924,503377548,2624
1360081999,503383448,2,127,63.5,1360081994507,1360081994507,503378955,503378955,0
1360082008,503392416,19,5709,300.4736842,1360081998827,1360081999339,503383243,503383755,512
1360082015,503399452,2,92,46,1360082009286,1360082009286,503393738,503393738,0
1360082015,503399452,20,5806,290.3,1360082007816,1360082009160,503392268,503393612,1344
1360082024,503408636,8,6311,788.875,1360081999314,1360082009298,503383950,503393934,9984
1360082024,503408640,26,14348,551.8461538,1360081999629,1360082005581,503384269,503390221,5952
1360082031,503415400,28,7961,284.3214286,1360082023612,1360082024828,503408012,503409228,1216
1360082031,503415404,36,9306,258.5,1360082024953,1360082027001,503409357,503411405,2048
1360082031,503415480,18,3951,219.5,1360082024876,1360082025708,503409356,503410188,832
1360082031,503415488,20,6307,315.35,1360082021603,1360082022819,503406091,503407307,1216
1360082036,503420560,17,9884,581.4117647,1360082009179,1360082023067,503393739,503407627,13888
1360082040,503424636,1,52,52,1360082013326,1360082013326,503397962,503397962,0
1360082044,503428600,67,93518,1395.791045,1360082018163,1360082020275,503402763,503404875,2112
1360082047,503431424,17,5159,303.4705882,1360082026530,1360082046050,503410954,503430474,19520
1360082052,503436916,16,5151,321.9375,1360082025335,1360082027063,503410251,503411979,1728
1360082052,503436932,78,106276,1362.512821,1360082027047,1360082030823,503411979,503415755,3776
1360082052,503437008,15,7090,472.6666667,1360082026011,1360082048795,503411019,503433803,22784
1360082055,503439400,3,237,79,1360082047098,1360082053498,503431498,503437898,6400
1360082076,503460756,7,1204,172,1360082047832,1360082064664,503432588,503449420,16832
1360082079,503463440,6,427,71.16666667,1360082072531,1360082076691,503456971,503461131,4160
1360082079,503463488,2,158,79,1360082061861,1360082078821,503446349,503463309,16960
1360082080,503464852,2,1830,915,1360082053432,1360082062328,503438284,503447180,8896
1360082095,503479420,2,150,75,1360082081191,1360082090087,503465611,503474507,8896
1360082095,503479496,6,427,71.16666667,1360082089500,1360082093724,503473996,503478220,4224
1360082108,503492712,1,915,915,1360082080195,1360082080195,503464907,503464907,0
1360082108,503492804,1,172,172,1360082081701,1360082081701,503466505,503466505,0
1360082111,503495664,246,332404,1351.235772,1360081910322,1360082110642,503294986,503495306,200320
1360082119,503503544,3,237,79,1360082111596,1360082116460,503496140,503501004,4864
1360082119,503503588,18,4743,263.5,1360082117696,1360082118464,503502284,503503052,768
1360082120,503504856,6,360,60,1360082093619,1360082103091,503478475,503487947,9472
1360082127,503511436,18,4759,264.3888889,1360082119062,1360082120278,503503498,503504714,1216
1360082127,503511516,19,10754,566,1360082121160,1360082123336,503505676,503507852,2176
1360082132,503516908,1,75,75,1360082107389,1360082107389,503492297,503492297,0
1360082135,3436798532,15,8626,575.0666667,1360082122377,1360082133449,3436785909,3436796981,11072
1360082135,503519464,5,530,106,1360082121019,1360082127227,503505483,503511691,6208
1360082135,503519540,17,6700,394.1176471,1360082121070,1360082129326,503505610,503513866,8256
1360082135,503519552,12,3644,303.6666667,1360082130465,1360082131553,503515017,503516105,1088
1360082140,503524748,1,79,79,1360082112414,1360082112414,503497162,503497162,0
1360082140,503524884,1,915,915,1360082115606,1360082115606,503500490,503500490,0
1360082143,503527496,16,6501,406.3125,1360082135961,1360082140313,503520457,503524809,4352
1360082143,503527528,14,7843,560.2142857,1360082126200,1360082135352,503510728,503519880,9152
1360082143,503527528,13,6946,534.3076923,1360082126138,1360082135354,503510666,503519882,9216
1360082143,503527532,16,6075,379.6875,1360082131831,1360082135351,503516363,503519883,3520
1360082143,503527572,15,4617,307.8,1360082136013,1360082142541,503520585,503527113,6528
1360082143,503527576,2,131,65.5,1360082138186,1360082138186,503522762,503522762,0
1360082143,503527580,14,9042,645.8571429,1360082126088,1360082135304,503510668,503519884,9216
1360082143,503527580,16,9138,571.125,1360082126088,1360082135304,503510668,503519884,9216
1360082144,503528808,10,848,84.8,1360082117348,1360082117988,503502156,503502796,640
1360082144,503528816,1,52,52,1360082118362,1360082118362,503503178,503503178,0
1360082144,503528820,1,172,172,1360082115864,1360082115864,503500684,503500684,0
1360082144,503528888,15,3228,215.2,1360082117456,1360082123792,503502344,503508680,6336
1360082148,503532872,10,4600,460,1360082120739,1360082122851,503505611,503507723,2112
1360082151,503535516,14,5075,362.5,1360082141960,1360082145544,503526476,503530060,3584
1360082151,503535572,2,131,65.5,1360082146958,1360082146958,503531530,503531530,0
1360082156,503540840,16,16078,1004.875,1360082131585,1360082136321,503516425,503521161,4736
1360082159,503543492,14,4589,327.7857143,1360082144989,1360082156893,503529481,503541385,11904
1360082160,503544884,8,8100,1012.5,1360082135000,1360082135576,503519884,503520460,576
1360082160,503544884,7,4559,651.2857143,1360082135064,1360082135448,503519948,503520332,384
1360082160,503544884,26,26613,1023.576923,1360082135063,1360082138519,503519947,503523403,3456
1360082164,503548820,14,13343,953.0714286,1360082137302,1360082138070,503522122,503522890,768
1360082164,503548840,10,9263,926.3,1360082137732,1360082137988,503522572,503522828,256
1360082164,503548900,17,15218,895.1764706,1360082137415,1360082138631,503522315,503523531,1216
1360082164,503548924,14,12573,898.0714286,1360082137837,1360082138285,503522761,503523209,448
1360082167,503551500,11,3471,315.5454545,1360082161174,1360082162774,503545674,503547274,1600
1360082167,503551504,12,3615,301.25,1360082161620,1360082163284,503546124,503547788,1664
1360082167,503551508,3,305,101.6666667,1360082162447,1360082162767,503546955,503547275,320
1360082167,503551576,12,3917,326.4166667,1360082162891,1360082163723,503547467,503548299,832
1360082168,503552864,1,75,75,1360082142953,1360082142953,503527817,503527817,0
1360082172,503556832,1,52,52,1360082147211,1360082147211,503532043,503532043,0
1360082175,503559532,12,3471,289.25,1360082173048,1360082174264,503557580,503558796,1216
1360082175,503559560,12,3664,305.3333333,1360082173082,1360082174234,503557642,503558794,1152
1360082183,503567536,19,5568,293.0526316,1360082180656,1360082181168,503565192,503565704,512
1360082192,503576888,1,79,79,1360082165010,1360082165010,503549898,503549898,0
1360082200,503584856,14,6160,440,1360082174577,1360082198065,503559433,503582921,23488
1360082200,503584932,14,5922,423,1360082174372,1360082197540,503559304,503582472,23168
1360082208,503592932,7,3244,463.4285714,1360082180837,1360082194405,503565769,503579337,13568
1360082212,503596828,1,172,172,1360082184207,1360082184207,503569035,503569035,0
1360082228,503612888,6,1529,254.8333333,1360082202002,1360082220562,503586890,503605450,18560
1360082228,503612972,6,2569,428.1666667,1360082202238,1360082220606,503587210,503605578,18368
1360082231,503615528,29,5989,206.5172414,1360082228218,1360082230650,503612746,503615178,2432
1360082231,503615572,33,8215,248.9393939,1360082229965,1360082230797,503614537,503615369,832
1360082239,503623532,3,183,61,1360082232499,1360082232499,503617031,503617031,0
1360082239,503623532,2,127,63.5,1360082232502,1360082232502,503617034,503617034,0
1360082239,503623532,3,183,61,1360082232502,1360082232502,503617034,503617034,0
1360082239,503623532,664,921944,1388.46988,1360082136438,1360082232438,503520970,503616970,96000
1360082239,503623580,181,245904,1358.585635,1360082138950,1360082238214,503523530,503622794,99264
1360082239,503623584,3,183,61,1360082232383,1360082232383,503616967,503616967,0
1360082239,503623584,3,183,61,1360082232447,1360082232447,503617031,503617031,0
1360082247,503631524,20,4513,225.65,1360082244347,1360082246203,503628871,503630727,1856
1360082247,503631620,23,8010,348.2608696,1360082238108,1360082243100,503622728,503627720,4992
1360082247,503631644,15,6099,406.6,1360082243781,1360082246725,503628425,503631369,2944
1360082255,503639584,12,3557,296.4166667,1360082246785,1360082249409,503631369,503633993,2624
1360082260,503644868,1,52,52,1360082232163,1360082232163,503617031,503617031,0
1360082260,503644868,1,52,52,1360082232163,1360082232163,503617031,503617031,0
1360082260,503644872,1,52,52,1360082232162,1360082232162,503617034,503617034,0
1360082260,503644872,1,52,52,1360082232162,1360082232162,503617034,503617034,0
1360082260,503644948,1,52,52,1360082232085,1360082232085,503617033,503617033,0
1360082260,503644948,1,52,52,1360082232084,1360082232084,503617032,503617032,0
1360082260,503644948,1,52,52,1360082232084,1360082232084,503617032,503617032,0
1360082260,503644948,1,52,52,1360082232084,1360082232084,503617032,503617032,0
1360082268,503652916,9,2587,287.4444444,1360082242549,1360082243765,503627465,503628681,1216
1360082268,503652916,8,2860,357.5,1360082242484,1360082243764,503627400,503628680,1280
1360082268,503652928,18,5477,304.2777778,1360082243561,1360082247337,503628489,503632265,3776
1360082268,503652996,1,46,46,1360082242022,1360082242022,503627018,503627018,0
1360082268,503652996,26,5428,208.7692308,1360082242404,1360082244068,503627400,503629064,1664
1360082268,503653004,12,968,80.66666667,1360082243419,1360082244763,503628423,503629767,1344
1360082272,503656928,9,3869,429.8888889,1360082246055,1360082250791,503630983,503635719,4736
1360082279,503663652,5,368,73.6,1360082273340,1360082276796,503657992,503661448,3456
1360082295,503679600,2,158,79,1360082280753,1360082288625,503665353,503673225,7872
1360082303,503687716,4,208,52,1360082300029,1360082301757,503684745,503686473,1728
1360082311,503695692,2,104,52,1360082303764,1360082307668,503688456,503692360,3904
1360082327,503711648,2,104,52,1360082315584,1360082325568,503700232,503710216,9984
1360082333,503717060,1,79,79,1360082304844,1360082304844,503688904,503688904,0
1360082351,503735656,2,104,52,1360082335543,1360082345527,503720199,503730183,9984
1360082361,503745084,1,79,79,1360082336243,1360082336243,503720327,503720327,0
1360082367,503751644,5,368,73.6,1360082364099,1360082365955,503748743,503750599,1856
1360082367,503751720,5,368,73.6,1360082363895,1360082365815,503748615,503750535,1920
1360082375,503759604,5,368,73.6,1360082367594,1360082371050,503752198,503755654,3456
1360082375,503759636,2,158,79,1360082368139,1360082372491,503752775,503757127,4352
1360082375,503759640,4,289,72.25,1360082369992,1360082372808,503754632,503757448,2816
1360082375,503759696,2,158,79,1360082368142,1360082372494,503752838,503757190,4352
1360082377,503761084,157,18446,117.4904459,1360082244596,1360082374196,503628680,503758280,129600
1360082381,503765224,1,52,52,1360082356006,1360082356006,503740230,503740230,0
1360082383,503767616,2,158,79,1360082374943,1360082382751,503759559,503767367,7808
1360082383,503767628,2,158,79,1360082375763,1360082379923,503760391,503764551,4160
1360082391,503775692,2,158,79,1360082376465,1360082383889,503761157,503768581,7424
1360082399,503783624,2,158,79,1360082381335,1360082398871,503765959,503783495,17536
1360082407,503791624,2,158,79,1360082381333,1360082398933,503765957,503783557,17600
1360082407,503791740,2,158,79,1360082388130,1360082404834,503772870,503789574,16704
1360082425,503809528,1,79,79,1360082398454,1360082398454,503782982,503782982,0
1360082425,503809532,1,79,79,1360082398961,1360082398961,503783493,503783493,0
1360082431,3437094592,5,352,70.4,1360082428816,1360082430352,3437092408,3437093944,1536
1360082431,503815684,5,352,70.4,1360082428442,1360082430234,503813126,503814918,1792
1360082439,3437102584,2,150,75,1360082432154,1360082435674,3437095738,3437099258,3520
1360082439,503823672,2,150,75,1360082432293,1360082436389,503816965,503821061,4096
1360082447,503831644,2,112,56,1360082442178,1360082442306,503826822,503826950,128
1360082453,503837452,1,79,79,1360082428737,1360082428737,503813189,503813189,0
1360082455,503839632,5,1311,262.2,1360082441101,1360082450765,503825733,503835397,9664
1360082455,503839632,102,140928,1381.647059,1360082441101,1360082448717,503825733,503833349,7616
1360082455,503839648,39,45283,1161.102564,1360082440382,1360082450750,503825030,503835398,10368
1360082455,503839648,4,356,89,1360082442878,1360082450686,503827526,503835334,7808
1360082457,503841388,1,79,79,1360082429825,1360082429825,503814213,503814213,0
1360082461,503845384,1,79,79,1360082434180,1360082434180,503818564,503818564,0
1360082461,503845388,1,79,79,1360082434370,1360082434370,503818758,503818758,0
1360082461,503845408,18,3439,191.0555556,1360082434859,1360082441003,503819267,503825411,6144
1360082461,503845468,11,916,83.27272727,1360082434671,1360082435631,503819139,503820099,960
1360082465,503849404,3,839,279.6666667,1360082439792,1360082439856,503824196,503824260,64
1360082465,503849516,1,79,79,1360082438464,1360082438464,503822980,503822980,0
1360082487,503871800,44,54192,1231.636364,1360082474788,1360082483300,503859588,503868100,8512
1360082487,503871808,7,506,72.28571429,1360082475805,1360082484061,503860613,503868869,8256
1360082492,3437155668,1,76,76,1360082466052,1360082466052,3437129720,3437129720,0
1360082599,503983808,5,895,179,1360082597211,1360082597531,503982019,503982339,320
1360082607,503991760,104,142771,1372.798077,1360082597515,1360082600459,503982275,503985219,2944
1360082607,503991760,15,13902,926.8,1360082597515,1360082600331,503982275,503985091,2816
1360082609,503993888,1,52,52,1360082582217,1360082582217,503967105,503967105,0
1360082613,503997912,1,188,188,1360082585205,1360082585205,503970117,503970117,0
1360082625,504009868,23,29286,1273.304348,1360082597600,1360082597728,503982468,503982596,128
1360082625,504009976,3,304,101.3333333,1360082599668,1360082599732,503984644,503984708,64
1360082625,504009988,3,379,126.3333333,1360082600295,1360082600423,503985283,503985411,128
1360082687,504071812,5,260,52,1360082679447,1360082683095,504064259,504067907,3648
1360082687,504071852,2,131,65.5,1360082684462,1360082684462,504069314,504069314,0
1360082695,504079852,2,104,52,1360082686892,1360082694636,504071744,504079488,7744
1360082719,504103880,2,104,52,1360082704592,1360082714640,504089472,504099520,10048
1360082762,504146276,7,1218,174,1360082735788,1360082760172,504120064,504144448,24384
1360082810,504194432,1,174,174,1360082784849,1360082784849,504169281,504169281,0
1360082839,504223952,3,156,52,1360082837575,1360082838407,504222527,504223359,832
1360082847,504231972,5,260,52,1360082840499,1360082844147,504225471,504229119,3648
1360082848,504232008,3,156,52,1360082840502,1360082847414,504224510,504231422,6912
1360082848,504232008,5,260,52,1360082840693,1360082844085,504224701,504228093,3392
1360082862,504246432,1,174,174,1360082834382,1360082834382,504218814,504218814,0
1360082864,504248040,2,104,52,1360082848983,1360082856791,504233023,504240831,7808
1360082872,504256036,2,104,52,1360082856604,1360082866652,504240640,504250688,10048
1360082880,504264048,2,104,52,1360082866765,1360082876813,504250813,504260861,10048
1360082902,504286520,1,52,52,1360082876149,1360082876149,504260669,504260669,0
1360163686,585070268,1,60,60,1360163658767,1360163658767,585043035,585043035,0
1360163891,585275036,1,46,46,1360163864694,1360163864694,585248730,585248730,0
1360164407,585791580,1,46,46,1360164379855,1360164379855,585764435,585764435,0
1360164407,585791580,1,46,46,1360164380172,1360164380172,585764752,585764752,0
1360165024,586408644,1,46,46,1360164996548,1360164996548,586381192,586381192,0
1360165175,586559836,1,46,46,1360165146435,1360165146435,586531271,586531271,0
1360165521,586905096,6,524,87.33333333,1360165514398,1360165514590,586898494,586898686,192
1360165521,586905104,6,569,94.83333333,1360165514969,1360165515161,586899073,586899265,192
1360165521,586905144,33,41623,1261.30303,1360165514225,1360165514929,586898369,586899073,704
1360165537,586921228,2,112,56,1360165529373,1360165529821,586913601,586914049,448
1360165542,586925972,10,6254,625.4,1360165514331,1360165515227,586898303,586899199,896
1360165546,586930216,9,6219,691,1360165521257,1360165525801,586905473,586910017,4544
1360165546,586930224,12,9821,818.4166667,1360165519073,1360165538657,586903297,586922881,19584
1360165550,586934264,5,1766,353.2,1360165524278,1360165527222,586908542,586911486,2944
1360165550,586934304,12,13642,1136.833333,1360165522640,1360165542864,586906944,586927168,20224
1360165554,586938232,56,76904,1373.285714,1360165526679,1360165548055,586910911,586932287,21376
1360165554,586938308,4,452,113,1360165527818,1360165528266,586912126,586912574,448
1360165558,586942228,14,16167,1154.785714,1360165530074,1360165549338,586914302,586933566,19264
1360165561,586945188,2,104,52,1360165558403,1360165559811,586942591,586943999,1408
1360165561,586945272,3,156,52,1360165556079,1360165559791,586940351,586944063,3712
1360165569,586953192,2,104,52,1360165562559,1360165568063,586946751,586952255,5504
1360165570,586954336,1,46,46,1360165544432,1360165544432,586928768,586928768,0
1360165574,586958312,3,4278,1426,1360165548552,1360165568584,586932864,586952896,20032
1360165577,586961568,2,104,52,1360165564360,1360165574152,586948928,586958720,9792
1360165578,586962232,3,4278,1426,1360165552981,1360165572949,586937213,586957181,19968
1360165585,586969204,6,740,123.3333333,1360165568948,1360165580724,586953152,586964928,11776
1360165585,586969208,24,20324,846.8333333,1360165566318,1360165578606,586950526,586962814,12288
1360165585,586969220,16,4163,260.1875,1360165572068,1360165578852,586956288,586963072,6784
1360165585,586969252,163,221923,1361.490798,1360165566017,1360165582657,586950269,586966909,16640
1360165585,586969256,6,750,125,1360165570045,1360165582653,586954301,586966909,12608
1360165585,586969256,40,51853,1296.325,1360165570112,1360165578688,586954368,586962944,8576
1360165585,586969288,4,707,176.75,1360165571166,1360165578782,586955454,586963070,7616
1360165586,586970304,2,2852,1426,1360165557969,1360165568017,586942273,586952321,10048
1360165593,586977284,17,13120,771.7647059,1360165590436,1360165591716,586974720,586976000,1280
1360165594,586978268,16,3943,246.4375,1360165566451,1360165583603,586950719,586967871,17152
1360165594,586978308,1,1426,1426,1360165568649,1360165568649,586952957,586952957,0
1360165601,586985276,21,19770,941.4285714,1360165592105,1360165593129,586976381,586977405,1024
1360165602,586986368,8,2865,358.125,1360165576271,1360165577999,586960639,586962367,1728
1360165606,586990292,24,21400,891.6666667,1360165578586,1360165583514,586962878,586967806,4928
1360165606,586990292,12,5373,447.75,1360165578649,1360165591385,586962941,586975677,12736
1360165606,586990296,15,7803,520.2,1360165579349,1360165580053,586963645,586964349,704
1360165606,586990300,10,4947,494.7,1360165580177,1360165580945,586964477,586965245,768
1360165606,586990404,23,16646,723.7391304,1360165581036,1360165590892,586965440,586975296,9856
1360165634,587018372,1,1426,1426,1360165607241,1360165607241,586991613,586991613,0
1360165670,587054452,1,210,210,1360165643384,1360165643384,587027836,587027836,0
1360165697,587081312,9,3619,402.1111111,1360165690117,1360165690757,587074429,587075069,640
1360165705,587089364,2,127,63.5,1360165699344,1360165699344,587083708,587083708,0
1360165710,587094720,1,52,52,1360165682539,1360165682539,587067259,587067259,0
1360165714,587098692,8,3138,392.25,1360165688520,1360165689544,587073212,587074236,1024
1360165714,587098708,6,3407,567.8333333,1360165686584,1360165687096,587071292,587071804,512
1360165755,587138744,6,1302,217,1360165727677,1360165729725,587111421,587113469,2048
1360165755,587138776,1,187,187,1360165728603,1360165728603,587112379,587112379,0
1360165783,587166784,1,52,52,1360165755346,1360165755346,587139130,587139130,0
1360165791,587174820,1,52,52,1360165765681,1360165765681,587149501,587149501,0
1360165793,587177612,16,4302,268.875,1360165787287,1360165788311,587171899,587172923,1024
1360165793,587177620,18,5162,286.7777778,1360165788624,1360165789584,587173244,587174204,960
1360165793,587177668,14,4284,306,1360165785952,1360165786720,587170620,587171388,768
1360165793,587177684,6,990,165,1360165785102,1360165785550,587169786,587170234,448
1360165799,587183656,1,48,48,1360165771307,1360165771307,587155963,587155963,0
1360165815,587198836,3,819,273,1360165790814,1360165791518,587174650,587175354,704
1360165825,587209564,5,548,109.6,1360165806534,1360165819718,587191098,587204282,13184
1360165825,587209616,43,42160,980.4651163,1360165801556,1360165819668,587186172,587204284,18112
1360165833,587217572,7,4326,618,1360165826497,1360165831937,587211069,587216509,5440
1360165833,587217576,4,837,209.25,1360165825850,1360165830906,587210426,587215482,5056
1360165833,587217620,5,1777,355.4,1360165826639,1360165831887,587211259,587216507,5248
1360165833,587217624,17,17316,1018.588235,1360165825994,1360165831882,587210618,587216506,5888
1360165833,587217656,4,356,89,1360165823594,1360165831658,587208250,587216314,8064
1360165841,587225572,8,4259,532.375,1360165826497,1360165833729,587211069,587218301,7232
1360165841,587225572,51,57772,1132.784314,1360165822784,1360165833728,587207356,587218300,10944
1360165841,587225624,15,16528,1101.866667,1360165827085,1360165833677,587211709,587218301,6592
1360165847,587230828,1,52,52,1360165820517,1360165820517,587204345,587204345,0
1360165847,587230904,1,52,52,1360165821277,1360165821277,587205181,587205181,0
1360165849,587233592,10,9076,907.6,1360165844397,1360165844461,587228989,587229053,64
1360165849,587233592,4,591,147.75,1360165844460,1360165844524,587229052,587229116,64
1360165849,587233628,5,2355,471,1360165842441,1360165847561,587227069,587232189,5120
1360165849,587233660,6,3722,620.3333333,1360165843688,1360165844072,587228348,587228732,384
1360165857,587241580,12,12708,1059,1360165842423,1360165849719,587227003,587234299,7296
1360165857,587241584,18,21198,1177.666667,1360165842609,1360165849713,587227193,587234297,7104
1360165857,587241584,12,12386,1032.166667,1360165842993,1360165849713,587227577,587234297,6720
1360165857,587241588,6,3724,620.6666667,1360165843565,1360165851757,587228153,587236345,8192
1360165857,587241624,12,5847,487.25,1360165842189,1360165849741,587226813,587234365,7552
1360165857,587241628,5,2263,452.6,1360165842823,1360165849671,587227451,587234299,6848
1360165857,587241628,32,39920,1247.5,1360165842950,1360165851718,587227578,587236346,8768
1360165859,587242820,1,52,52,1360165834544,1360165834544,587218364,587218364,0
1360165859,587242820,1,52,52,1360165834478,1360165834478,587218298,587218298,0
1360165859,587242824,1,52,52,1360165831851,1360165831851,587215675,587215675,0
1360165859,587243192,1,52,52,1360165834105,1360165834105,587218297,587218297,0
1360165859,587243192,1,52,52,1360165834169,1360165834169,587218361,587218361,0
1360165875,587258892,1,52,52,1360165850470,1360165850470,587234362,587234362,0
1360165889,587273648,6,3692,615.3333333,1360165879728,1360165887856,587264376,587272504,8128
1360165889,587273688,7,4154,593.4285714,1360165873802,1360165885770,587258490,587270458,11968
1360165889,587273720,6,3516,586,1360165879532,1360165887788,587264252,587272508,8256
1360165889,587273728,4,352,88,1360165888417,1360165888609,587273145,587273337,192
1360165889,587273732,16,16171,1010.6875,1360165885726,1360165888286,587270458,587273018,2560
1360165889,587273732,5,895,179,1360165885533,1360165885917,587270265,587270649,384
1360165897,587281640,7,1872,267.4285714,1360165874490,1360165890170,587259130,587274810,15680
1360165897,587281688,16,11876,742.25,1360165873355,1360165889867,587258043,587274555,16512
1360165897,587281720,4,356,89,1360165887980,1360165894124,587272700,587278844,6144
1360165897,587281728,28,34020,1215,1360165885987,1360165896099,587270715,587280827,10112
1360165903,587286888,16,3403,212.6875,1360165875689,1360165881769,587259577,587265657,6080
1360165903,587286896,1,52,52,1360165876387,1360165876387,587260283,587260283,0
1360165903,587286900,8,3227,403.375,1360165876892,1360165877980,587260792,587261880,1088
1360165930,587313796,25,5550,222,1360165927685,1360165929285,587311481,587313081,1600
1360165930,587313804,12,3999,333.25,1360165925948,1360165928892,587309752,587312696,2944
1360165930,587313840,15,6093,406.2,1360165927258,1360165929690,587311098,587313530,2432
1360165938,587321888,13,4162,320.1538462,1360165929514,1360165930282,587313402,587314170,768
1360165951,587334984,8,2488,311,1360165926280,1360165927112,587310264,587311096,832
1360165951,587334988,20,4548,227.4,1360165926276,1360165929924,587310264,587313912,3648
1360165951,587334988,21,1792,85.33333333,1360165926788,1360165942404,587310776,587326392,15616
1360165962,587345836,4,223,55.75,1360165956764,1360165956828,587340600,587340664,64
1360165962,587345876,18,4753,264.0555556,1360165955765,1360165956725,587339641,587340601,960
1360165962,587345904,6,339,56.5,1360165952408,1360165955224,587336312,587339128,2816
1360165970,587353816,17,1381,81.23529412,1360165955314,1360165967858,587339130,587351674,12544
1360165978,587361876,24,2328,97,1360165967797,1360165973685,587351673,587357561,5888
1360165978,587361900,13,4123,317.1538462,1360165970972,1360165971740,587354872,587355640,768
1360165978,587361908,20,5926,296.3,1360165957143,1360165970519,587341051,587354427,13376
1360165986,587369888,33,16597,502.9393939,1360165977386,1360165985578,587361274,587369466,8192
1360165986,587369932,14,1225,87.5,1360165973692,1360165979004,587357624,587362936,5312
1360165994,587377880,8,3079,384.875,1360165987056,1360165989808,587370936,587373688,2752
1360165994,587377884,6,1072,178.6666667,1360165987500,1360165989804,587371384,587373688,2304
1360165994,587377884,8,2588,323.5,1360165987627,1360165989803,587371511,587373687,2176
1360165994,587377892,6,1287,214.5,1360165986791,1360165987367,587370683,587371259,576
1360165998,3520661928,39,48511,1243.871795,1360165991718,1360165992358,3520655646,3520656286,640
1360166007,587391064,10,990,99,1360165978871,1360165979383,587362935,587363447,512
1360166011,587395008,6,3258,543,1360165986033,1360165996721,587370041,587380729,10688
1360166011,587395052,6,3355,559.1666667,1360165986051,1360165992259,587370103,587376311,6208
1360166015,587399016,18,5062,281.2222222,1360165989352,1360166013800,587373368,587397816,24448
1360166018,587401880,29,7095,244.6551724,1360166014127,1360166015215,587398007,587399095,1088
1360166027,587411112,1,76,76,1360165999881,1360165999881,587383993,587383993,0
1360166043,587427108,9,6001,666.7777778,1360166016970,1360166020042,587401078,587404150,3072
1360166043,587427152,11,7145,649.5454545,1360166016481,1360166016801,587400633,587400953,320
1360166051,587434956,2,131,65.5,1360166049766,1360166049766,587433722,587433722,0
1360166051,587435128,3,250,83.33333333,1360166023610,1360166045818,587407738,587429946,22208
1360166059,587443100,1,52,52,1360166031252,1360166031252,587415352,587415352,0
1360166090,587473932,2,127,63.5,1360166086781,1360166086781,587470713,587470713,0
1360166138,587522072,3,138,46,1360166132142,1360166132142,587516214,587516214,0
1360166138,587522104,2,131,65.5,1360166136782,1360166136782,587520886,587520886,0
1360166138,587522120,2,127,63.5,1360166131584,1360166131584,587515704,587515704,0
1360166143,587527356,1,52,52,1360166117523,1360166117523,587501879,587501879,0
1360177053,598437124,4,208,52,1360177049420,1360177051276,598433544,598435400,1856
1360177061,598445132,2,104,52,1360177053380,1360177057604,598437512,598441736,4224
1360177077,598461232,2,104,52,1360177065955,1360177075939,598450187,598460171,9984
1360177114,598497728,1,52,52,1360177086423,1360177086423,598470151,598470151,0
1360177197,598581436,6,2157,359.5,1360177190162,1360177194002,598574598,598578438,3840
1360177226,598609728,3,1263,421,1360177198742,1360177216854,598582470,598600582,18112
1360177254,598637872,1,421,421,1360177226693,1360177226693,598610565,598610565,0
1360177749,599133712,4,208,52,1360177746807,1360177748663,599131519,599133375,1856
1360177758,599141796,2,104,52,1360177751756,1360177756044,599135552,599139840,4288
1360177782,599165748,2,104,52,1360177764731,1360177774715,599148479,599158463,9984
1360177811,599195444,1,52,52,1360177784000,1360177784000,599168444,599168444,0
1360178062,599446104,5,260,52,1360178054099,1360178058707,599438203,599442811,4608
1360178078,599462048,2,104,52,1360178063691,1360178073611,599447739,599457659,9920
1360178094,599478164,2,104,52,1360178083476,1360178093460,599467640,599477624,9984
1360179559,600943476,3,219,73,1360179557829,1360179558213,600942305,600942689,384
1360179567,600951384,3,168,56,1360179563232,1360179564576,600947616,600948960,1344
1360179567,600951500,4,271,67.75,1360179565420,1360179566764,600949920,600951264,1344
1360179583,600967452,4,220,55,1360179576606,1360179577950,600961058,600962402,1344
1360179583,600967560,3,168,56,1360179580080,1360179581040,600964640,600965600,960
1360179583,600967572,3,168,56,1360179578279,1360179579495,600962851,600964067,1216
1360179587,600971272,2,104,52,1360179560720,1360179563088,600944992,600947360,2368
1360179587,600971276,19,4249,223.6315789,1360179560783,1360179567119,600945059,600951395,6336
1360179611,600995268,1,46,46,1360179586325,1360179586325,600970593,600970593,0
1360179611,600995336,1,52,52,1360179584529,1360179584529,600968865,600968865,0
1360179736,601119872,2,104,52,1360179731616,1360179733280,601115488,601117152,1664
1360179744,601127960,2,104,52,1360179736456,1360179743048,601120416,601127008,6592
1360179768,601151852,2,104,52,1360179753201,1360179763185,601137053,601147037,9984
1360179784,601167896,2,104,52,1360179773126,1360179783110,601157022,601167006,9984
1360179819,601203680,1,52,52,1360179792375,1360179792375,601177055,601177055,0
1360250077,671460492,1,60,60,1360250049166,1360250049166,671432658,671432658,0
1360250077,671460492,1,60,60,1360250049165,1360250049165,671432657,671432657,0
1360250077,671460536,11,3267,297,1360250048992,1360250050912,671432528,671434448,1920
1360250099,671483148,3,209,69.66666667,1360250091390,1360250091390,671475538,671475538,0
1360250099,671483192,3,209,69.66666667,1360250091344,1360250091344,671475536,671475536,0
1360250118,3604781056,1,52,52,1360250091188,1360250091188,3604754244,3604754244,0
1360250123,671507248,5,676,135.2,1360250118490,1360250118682,671502738,671502930,192
1360250145,671528584,10,4192,419.2,1360250119537,1360250135473,671503121,671519057,15936
1360250145,671528652,4,403,100.75,1360250119212,1360250119852,671502864,671503504,640
1360250146,3604809160,3,1566,522,1360250119306,1360250119370,3604782466,3604782530,64
1360250179,671563252,3,209,69.66666667,1360250178323,1360250178323,671562575,671562575,0
1360250179,671563260,4,630,157.5,1360250178766,1360250178830,671563026,671563090,64
1360250203,671587308,2,181,90.5,1360250197659,1360250197659,671581967,671581967,0
1360250205,671588616,1,46,46,1360250179601,1360250179601,671563217,671563217,0
1360250206,3604869220,1,52,52,1360250178704,1360250178704,3604841924,3604841924,0
1360250243,671627288,5,676,135.2,1360250239086,1360250239278,671623374,671623566,192
1360250308,671691548,5,676,135.2,1360250300050,1360250300242,671683598,671683790,192
1360250324,671707616,1920,2869216,1494.383333,1360250319373,1360250323469,671702989,671707085,4096
1360250332,671715708,1871,2799141,1496.066809,1360250323698,1360250328562,671707406,671712270,4864
1360250345,671729048,23,12978,564.2608696,1360250318684,1360250335324,671702732,671719372,16640
1360250345,671729052,3,302,100.6666667,1360250319256,1360250319320,671703308,671703372,64
1360250346,3605009412,4,1798,449.5,1360250319057,1360250319121,3604982469,3604982533,64
1360250364,671747676,5,676,135.2,1360250360208,1360250360400,671743884,671744076,192
1360250386,3605049384,1,52,52,1360250359595,1360250359595,3605022979,3605022979,0
1360250396,671779708,5,325,65,1360250389810,1360250389874,671773518,671773582,64
1360250428,671811696,5,676,135.2,1360250420414,1360250420606,671804110,671804302,192
1360250484,671867780,5,676,135.2,1360250480552,1360250480744,671864332,671864524,192
1360250510,3605173612,3,313,104.3333333,1360250485770,1360250485834,3605149382,3605149446,64
1360250516,671899768,2,141,70.5,1360250512497,1360250512497,671896265,671896265,0
1360250538,671921588,1,60,60,1360250511592,1360250511592,671895180,671895180,0
1360250538,671921660,12,3319,276.5833333,1360250511517,1360250512733,671895177,671896393,1216
1360250548,671931824,5,676,135.2,1360250540728,1360250540920,671924552,671924744,192
1360250566,671949960,2,104,52,1360250541616,1360250541872,671925576,671925832,256
1360250570,671953956,4,403,100.75,1360250542965,1360250547253,671926921,671931209,4288
1360250574,671957976,12,6151,512.5833333,1360250547297,1360250550113,671931273,671934089,2816
1360250574,671958024,13,6555,504.2307692,1360250546802,1360250562738,671930826,671946762,15936
1360250574,3605237584,4,2382,595.5,1360250546597,1360250546725,3605210181,3605210309,128
1360250574,3605237620,1,52,52,1360250546881,1360250546881,3605210501,3605210501,0
1360250578,671961952,9,861,95.66666667,1360250550649,1360250551033,671934601,671934985,384
1360250578,671961956,9,861,95.66666667,1360250551093,1360250551221,671935049,671935177,128
1360250578,671962000,15,6289,419.2666667,1360250550281,1360250550537,671934281,671934537,256
1360250604,671987816,3,209,69.66666667,1360250600707,1360250600707,671984523,671984523,0
1360250604,671987816,5,676,135.2,1360250601025,1360250601217,671984841,671985033,192
1360250612,671995860,3,138,46,1360250607381,1360250607445,671991241,671991305,64
1360250612,671995860,3,138,46,1360250607380,1360250607444,671991240,671991304,64
1360250612,671995860,4,184,46,1360250607380,1360250607828,671991240,671991688,448
1360250612,671995864,3,138,46,1360250607760,1360250607824,671991624,671991688,64
1360250626,3605289608,1,52,52,1360250600272,1360250600272,3605263880,3605263880,0
1360250668,672051820,5,676,135.2,1360250661372,1360250661756,672045192,672045576,384
1360250686,672070212,1,46,46,1360250661045,1360250661045,672045257,672045257,0
1360250724,672107880,5,676,135.2,1360250721662,1360250721854,672105542,672105734,192
1360250788,672171920,1532,2291029,1495.449739,1360250768725,1360250783701,672152645,672167621,14976
1360250788,672171924,157,229600,1462.420382,1360250769044,1360250780244,672152968,672164168,11200
1360250788,672171932,5,676,135.2,1360250782793,1360250783497,672166725,672167429,704
1360250795,672178508,23,11790,512.6086957,1360250767922,1360250788530,672151430,672172038,20608
1360250795,672178520,3,302,100.6666667,1360250769447,1360250769447,672152967,672152967,0
1360250795,3605458000,4,2058,514.5,1360250769326,1360250769646,3605432326,3605432646,320
1360250795,3605458000,1,60,60,1360250769518,1360250769518,3605432518,3605432518,0
1360250804,672187992,208,304647,1464.649038,1360250800396,1360250803148,672184388,672187140,2752
1360250804,672188020,2,157,78.5,1360250801011,1360250801011,672185031,672185031,0
1360250811,672194576,1,46,46,1360250783406,1360250783406,672166982,672166982,0
1360250827,3605489928,3,313,104.3333333,1360250803639,1360250803639,3605466567,3605466567,0
1360250827,672210544,9,1975,219.4444444,1360250799823,1360250800783,672183367,672184327,960
1360250828,672211968,2,141,70.5,1360250825445,1360250825445,672209413,672209413,0
1360250844,672227896,5,676,135.2,1360250843631,1360250843823,672227527,672227719,192
1360250851,672234576,1,60,60,1360250824814,1360250824814,672208390,672208390,0
1360250851,672234640,11,3267,297,1360250824687,1360250826095,672208327,672209735,1408
1360250855,3605518136,1,52,52,1360250827625,1360250827625,3605490761,3605490761,0
1360250860,672243976,3,221,73.66666667,1360250857502,1360250857502,672241478,672241478,0
1360250887,3605550164,1,52,52,1360250859084,1360250859084,3605522248,3605522248,0
1360250908,672291944,5,676,135.2,1360250903805,1360250904189,672287749,672288133,384
1360250972,672355988,5,676,135.2,1360250964177,1360250964369,672348165,672348357,192
1360250975,672358800,4,402,100.5,1360250947469,1360250951885,672331269,672335685,4416
1360250979,672362776,12,5447,453.9166667,1360250951525,1360250967461,672335301,672351237,15936
1360250979,3605642424,4,2307,576.75,1360250951241,1360250951305,3605614665,3605614729,64
1360251012,672396168,3,221,73.66666667,1360251011163,1360251011227,672395331,672395395,64
1360251028,672412128,5,676,135.2,1360251024387,1360251024579,672408515,672408707,192
1360251039,3605702412,1,52,52,1360251011606,1360251011606,3605675018,3605675018,0
1360251092,672476172,5,676,135.2,1360251084757,1360251084949,672468929,672469121,192
1360251103,672486812,1502,2247356,1496.242344,1360250784124,1360250800572,672167936,672184384,16448
1360251132,672516168,2,141,70.5,1360251130842,1360251130842,672515010,672515010,0
1360251135,3605798424,3,313,104.3333333,1360251110344,1360251110344,3605773768,3605773768,0
1360251148,672532232,5,676,135.2,1360251145048,1360251145176,672529280,672529408,128
1360251155,672538932,11,3267,297,1360251130051,1360251131203,672513983,672515135,1152
1360251156,672540184,1680,2510946,1494.610714,1360251147015,1360251152583,672531199,672536767,5568
1360251164,672548244,1571,2348152,1494.686187,1360251152462,1360251156814,672536706,672541058,4352
1360251171,672554952,3,301,100.3333333,1360251145520,1360251147504,672529472,672531456,1984
1360251171,672554952,15,7949,529.9333333,1360251145711,1360251163695,672529663,672547647,17984
1360251175,3605838464,4,2478,619.5,1360251147170,1360251147362,3605810634,3605810826,192
1360251195,3605858440,1,52,52,1360251169146,1360251169146,3605832586,3605832586,0
1360251212,672596220,3,209,69.66666667,1360251204901,1360251204965,672589121,672589185,64
1360251212,672596296,5,676,135.2,1360251205142,1360251205398,672589438,672589694,256
1360251231,672615268,1,46,46,1360251205236,1360251205236,672589504,672589504,0
1360251231,3605894688,1,52,52,1360251204804,1360251204804,3605868492,3605868492,0
1360251271,672655104,5,676,135.2,1360251266775,1360251267799,672650879,672651903,1024
1360251295,672679200,1,46,46,1360251268406,1360251268406,672652606,672652606,0
1360251332,672716308,5,676,135.2,1360251326984,1360251327176,672711292,672711484,192
1360251367,672751248,4,402,100.5,1360251341063,1360251345287,672725311,672729535,4224
1360251371,3606034652,4,2231,557.75,1360251344872,1360251345128,3606008524,3606008780,256
1360251371,672755320,15,6615,441,1360251344892,1360251360828,672729212,672745148,15936
1360251396,672780404,5,676,135.2,1360251388456,1360251391016,672772860,672775420,2560
1360251412,3606075136,1,52,52,1360251387500,1360251387500,3606050636,3606050636,0
1360251415,672799268,1,46,46,1360251388722,1360251388722,672772990,672772990,0
1360251420,672804380,3,221,73.66666667,1360251416961,1360251417025,672801341,672801405,64
1360251468,672852456,5,408,81.6,1360251462642,1360251465906,672847098,672850362,3264
1360251484,672868448,2,178,89,1360251469628,1360251476988,672854076,672861436,7360
1360251520,672903548,1,89,89,1360251492735,1360251492735,672876283,672876283,0
1360251547,672931456,1,89,89,1360251521459,1360251521459,672905915,672905915,0
1360251608,672991516,1,89,89,1360251581663,1360251581663,672965179,672965179,0
1360253272,674655900,2,96,48,1360253246979,1360253259395,674630879,674643295,12416
1360253300,674683856,1,48,48,1360253274222,1360253274222,674658078,674658078,0
1360253368,674752136,1,46,46,1360253343507,1360253343507,674727643,674727643,0
1360253390,674773940,38,18665,491.1842105,1360253385623,1360253389591,674769563,674773531,3968
1360253390,674774016,17,6241,367.1176471,1360253385294,1360253386766,674769310,674770782,1472
1360253398,674781976,6,524,87.33333333,1360253395443,1360253395635,674779419,674779611,192
1360253398,674782012,5,504,100.8,1360253390738,1360253395538,674774750,674779550,4800
1360253398,674782048,22,25109,1141.318182,1360253395501,1360253396525,674779549,674780573,1024
1360253398,674782048,7,621,88.71428571,1360253395565,1360253395821,674779613,674779869,256
1360253399,3608061976,20,18834,941.7,1360253394200,1360253394712,3608057176,3608057688,512
1360253399,3608061992,14,7378,527,1360253396297,1360253397257,3608059289,3608060249,960
1360253399,3608061996,17,15667,921.5882353,1360253390150,1360253391110,3608053146,3608054106,960
1360253406,674789932,7,681,97.28571429,1360253400607,1360253404383,674784539,674788315,3776
1360253406,674789944,23,6998,304.2608696,1360253385621,1360253401877,674769565,674785821,16256
1360253406,674789968,15,4209,280.6,1360253391419,1360253400507,674775387,674784475,9088
1360253406,674789976,17,9889,581.7058824,1360253387444,1360253399668,674771420,674783644,12224
1360253406,674789976,16,7089,443.0625,1360253387316,1360253400244,674771292,674784220,12928
1360253406,674789980,17,6524,383.7647059,1360253400241,1360253403633,674784221,674787613,3392
1360253406,674790092,6,629,104.8333333,1360253401791,1360253404223,674785883,674788315,2432
1360253412,674796072,1,76,76,1360253386069,1360253386069,674770141,674770141,0
1360253412,674796132,18,5442,302.3333333,1360253385370,1360253400538,674769502,674784670,15168
1360253412,674796164,4,968,242,1360253386616,1360253387128,674770780,674771292,512
1360253414,674797944,18,4102,227.8888889,1360253405206,1360253406294,674789150,674790238,1088
1360253414,674797980,19,4886,257.1578947,1360253410929,1360253411761,674794909,674795741,832
1360253416,674800040,9,5521,613.4444444,1360253388276,1360253389364,674772316,674773404,1088
1360253416,674800040,75,96239,1283.186667,1360253390067,1360253399219,674774107,674783259,9152
1360253416,674800048,17,3764,221.4117647,1360253390444,1360253405036,674774492,674789084,14592
1360253416,674800092,10,7543,754.3,1360253389826,1360253396802,674773918,674780894,6976
1360253416,674800120,20,1364,68.2,1360253388196,1360253393636,674772316,674777756,5440
1360253416,674800136,71,91932,1294.816901,1360253390739,1360253391251,674774875,674775387,512
1360253417,674801236,15,4651,310.0666667,1360253415920,1360253416432,674800156,674800668,512
1360253417,674801264,4,452,113,1360253397972,1360253398036,674782236,674782300,64
1360253417,674801304,25,21864,874.56,1360253392301,1360253404205,674776605,674788509,11904
1360253417,674801452,87,118576,1362.942529,1360253396569,1360253398553,674781021,674783005,1984
1360253418,674801816,11,5200,472.7272727,1360253400342,1360253403094,674784158,674786910,2752
1360253418,674801840,8,2875,359.375,1360253400445,1360253402173,674784285,674786013,1728
1360253418,674801852,23,26321,1144.391304,1360253396400,1360253398832,674780252,674782684,2432
1360253418,674802140,23,21282,925.3043478,1360253407122,1360253413650,674791262,674797790,6528
1360253418,674802176,12,7665,638.75,1360253394027,1360253406379,674778203,674790555,12352
1360253418,674802336,9,5107,567.4444444,1360253403341,1360253405517,674787677,674789853,2176
1360253422,674805904,4,235,58.75,1360253416828,1360253416828,674800732,674800732,0
1360253430,674813964,20,5089,254.45,1360253422656,1360253423808,674806620,674807772,1152
1360253444,674828196,1,52,52,1360253417111,1360253417111,674801307,674801307,0
1360253456,674840288,1,52,52,1360253428029,1360253428029,674812317,674812317,0
1360253464,674848312,15,8369,557.9333333,1360253436386,1360253445922,674820698,674830234,9536
1360253468,674852264,3,555,185,1360253443860,1360253444244,674828124,674828508,384
1360253468,674852276,28,4133,147.6071429,1360253441415,1360253455687,674825691,674839963,14272
1360253472,674856424,9,4246,471.7777778,1360253446003,1360253447283,674830427,674831707,1280
1360253478,674862032,18,4406,244.7777778,1360253472188,1360253472828,674856220,674856860,640
1360253500,674884312,3,567,189,1360253473317,1360253473317,674857629,674857629,0
1360253513,674897116,1,46,46,1360253484264,1360253484264,674868380,674868380,0
1360253518,674902000,4,289,72.25,1360253511129,1360253512089,674895129,674896089,960
1360253526,674910020,2,131,65.5,1360253519173,1360253519173,674903193,674903193,0
1360253526,674910048,2,131,65.5,1360253521962,1360253521962,674906010,674906010,0
1360253528,674912408,2,798,399,1360253500033,1360253500097,674884441,674884505,64
1360253529,674912532,21,3757,178.9047619,1360253503087,1360253503919,674886619,674887451,832
1360253540,674924416,10,867,86.7,1360253512123,1360253512763,674896539,674897179,640
1360253540,674924420,15,3226,215.0666667,1360253512436,1360253518772,674896856,674903192,6336
1360253540,674924428,1,52,52,1360253513581,1360253513581,674898009,674898009,0
1360253541,674924468,9,3463,384.7777778,1360253513198,1360253513518,674896666,674896986,320
1360253557,674940556,22,4655,211.5909091,1360253532245,1360253556693,674915801,674940249,24448
1360253566,674950112,6,996,166,1360253561769,1360253561897,674945881,674946009,128
1360253589,674972484,1,146,146,1360253561887,1360253561887,674945371,674945371,0
1360253593,674976476,23,7596,330.2608696,1360253588582,1360253589862,674972058,674973338,1280
1360253606,674990136,2,127,63.5,1360253602323,1360253602323,674986459,674986459,0
1360253622,675006080,2,131,65.5,1360253620363,1360253620363,675004443,675004443,0
1360253625,675008840,6,3913,652.1666667,1360253598010,1360253602810,674981850,674986650,4800
1360253629,675012748,48,59364,1236.75,1360253602964,1360253603540,674986712,674987288,576
1360253630,675014072,2,131,65.5,1360253622992,1360253622992,675007064,675007064,0
1360253638,675022148,14,4335,309.6428571,1360253634053,1360253634949,675018201,675019097,896
1360253647,3608310060,17,12040,708.2352941,1360253643909,1360253644613,3608306969,3608307673,704
1360253649,675032792,23,3861,167.8695652,1360253623978,1360253648874,675007770,675032666,24896
1360253649,675032796,1,46,46,1360253624357,1360253624357,675008153,675008153,0
1360253654,675038048,26,10313,396.6538462,1360253648616,1360253651944,675032664,675035992,3328
1360253654,675038096,22,11348,515.8181818,1360253634167,1360253651127,675018263,675035223,16960
1360253657,675040788,1,52,52,1360253629614,1360253629614,675013402,675013402,0
1360253665,675048800,1,52,52,1360253638754,1360253638754,675022554,675022554,0
1360253669,675052860,1,52,52,1360253643044,1360253643044,675026904,675026904,0
1360253670,675054136,2,104,52,1360253666642,1360253666898,675050778,675051034,256
1360253670,675054140,2,127,63.5,1360253667276,1360253667276,675051416,675051416,0
1360253673,675056788,52,72069,1385.942308,1360253645803,1360253646251,675029591,675030039,448
1360253673,675056828,34,39879,1172.911765,1360253646339,1360253646851,675030167,675030679,512
1360253673,675056836,1,52,52,1360253646717,1360253646717,675030553,675030553,0
1360253673,675056848,18,23955,1330.833333,1360253645745,1360253652465,675029593,675036313,6720
1360253673,675056868,1,52,52,1360253645979,1360253645979,675029847,675029847,0
1360253689,675072880,4,580,145,1360253663183,1360253665103,675047063,675048983,1920
1360253693,675076864,14,3244,231.7142857,1360253665953,1360253672353,675049817,675056217,6400
1360253693,675076944,13,1022,78.61538462,1360253665743,1360253685263,675049687,675069207,19520
1360253705,675088940,9,3463,384.7777778,1360253679061,1360253679445,675063001,675063385,384
1360253710,675094212,10,2008,200.8,1360253707076,1360253707460,675091288,675091672,384
1360253711,3608374220,73,94242,1290.986301,1360253703207,1360253703975,3608366427,3608367195,768
1360253713,675096928,1,52,52,1360253686303,1360253686303,675070231,675070231,0
1360253719,3608382232,58,69769,1202.913793,1360253715611,1360253716635,3608378843,3608379867,1024
1360253721,675104932,9,4579,508.7777778,1360253696157,1360253697949,675080089,675081881,1792
1360253721,675105012,3,156,52,1360253696010,1360253696138,675080022,675080150,128
1360253726,675110104,34,14389,423.2058824,1360253717359,1360253719151,675101463,675103255,1792
1360253729,675113000,14,10621,758.6428571,1360253703128,1360253728216,675087128,675112216,25088
1360253729,675113008,91,116855,1284.120879,1360253703887,1360253728335,675087895,675112343,24448
1360253734,675118092,6,629,104.8333333,1360253727737,1360253733433,675111829,675117525,5696
1360253741,675124976,1,52,52,1360253713646,1360253713646,675097622,675097622,0
1360253742,675126156,19,5500,289.4736842,1360253737274,1360253738298,675121430,675122454,1024
1360253750,675134148,20,6064,303.2,1360253747137,1360253749185,675131285,675133333,2048
1360253750,675134156,19,4886,257.1578947,1360253744890,1360253745530,675129046,675129686,640
1360253758,675142132,43,6585,153.1395349,1360253746385,1360253752017,675130517,675136149,5632
1360253758,675142156,17,3852,226.5882353,1360253751741,1360253752189,675135897,675136345,448
1360253766,675150120,2,131,65.5,1360253765472,1360253765472,675149592,675149592,0
1360253766,675150204,6,996,166,1360253762060,1360253762252,675146264,675146456,192
1360253766,675150212,32,6476,202.375,1360253752130,1360253758082,675136342,675142294,5952
1360253774,675158120,5,368,73.6,1360253766429,1360253769501,675150549,675153621,3072
1360253774,675158168,4,316,79,1360253765872,1360253772016,675150040,675156184,6144
1360253777,675160960,11,6626,602.3636364,1360253750527,1360253750975,675134487,675134935,448
1360253777,675160968,33,26560,804.8484848,1360253749750,1360253751094,675133718,675135062,1344
1360253777,675161040,13,8806,677.3846154,1360253749678,1360253758446,675133718,675142486,8768
1360253777,675161068,8,5360,670,1360253751059,1360253751635,675135127,675135703,576
1360253782,675166248,32,6184,193.25,1360253771550,1360253777630,675155798,675161878,6080
1360253789,675173048,1,145,145,1360253762023,1360253762023,675146071,675146071,0
1360253798,675182252,4,277,69.25,1360253796186,1360253796954,675180438,675181206,768
1360253806,675190124,3,225,75,1360253798106,1360253804122,675182230,675188246,6016
1360253830,675214196,2,150,75,1360253812113,1360253828305,675196309,675212501,16192
1360253845,675229144,7,1498,214,1360253816966,1360253834374,675201110,675218518,17408
1360253854,675238248,6,447,74.5,1360253848092,1360253853148,675232340,675237396,5056
1360253870,675254324,2,158,79,1360253858385,1360253869137,675242709,675253461,10752
1360253877,675261248,1,214,214,1360253851996,1360253851996,675236244,675236244,0
1360253878,675262232,6,447,74.5,1360253870571,1360253874155,675254803,675258387,3584
1360253885,675269280,1,75,75,1360253860542,1360253860542,675244822,675244822,0
1360253886,675270220,246,324931,1320.857724,1360253708921,1360253884857,675093141,675269077,175936
1360253886,675270300,2,158,79,1360253877864,1360253885416,675262164,675269716,7552
1360253902,675286280,4,277,69.25,1360253900154,1360253900922,675284434,675285202,768
1360253902,675286320,5,352,70.4,1360253898578,1360253900754,675282898,675285074,2176
1360253910,675294248,3,225,75,1360253901917,1360253907869,675286165,675292117,5952
1360253910,675294348,2,150,75,1360253903225,1360253908153,675287573,675292501,4928
1360253910,675294392,2,158,79,1360253891662,1360253905678,675276054,675290070,14016
1360253910,675294392,5,352,70.4,1360253907022,1360253908686,675291414,675293078,1664
1360253913,675297268,1,214,214,1360253887368,1360253887368,675271636,675271636,0
1360253917,675301144,1,79,79,1360253890755,1360253890755,675274899,675274899,0
1360253918,675302336,2,150,75,1360253910598,1360253914374,675294934,675298710,3776
1360253925,675309296,1,79,79,1360253900524,1360253900524,675284820,675284820,0
1360253934,675318288,2,150,75,1360253915826,1360253931698,675300114,675315986,15872
1360253942,675326244,2,150,75,1360253918239,1360253938143,675302483,675322387,19904
1360253942,675326252,2,150,75,1360253921944,1360253936984,675306196,675321236,15040
1360253957,675341272,1,79,79,1360253930882,1360253930882,675315154,675315154,0
1360253961,675345188,1,79,79,1360253933527,1360253933527,675317715,675317715,0
1360253961,675345272,1,79,79,1360253933764,1360253933764,675318036,675318036,0
1360253985,675369220,1,214,214,1360253958200,1360253958200,675342420,675342420,0
1360253989,675373384,1,75,75,1360253963409,1360253963409,675347793,675347793,0
1360253993,675377260,1,75,75,1360253966990,1360253966990,675351250,675351250,0
1360254005,675389236,1,75,75,1360253977896,1360253977896,675362132,675362132,0
1360254057,675441312,1,46,46,1360254031192,1360254031192,675415504,675415504,0
1360254077,675461316,1,46,46,1360254051286,1360254051286,675435602,675435602,0
1360254085,675469436,1,46,46,1360254059806,1360254059806,675444242,675444242,0
1360254105,675489396,1,214,214,1360254078085,1360254078085,675462481,675462481,0
1360254218,675601740,1,218,218,1360254193813,1360254193813,675577553,675577553,0
1360254218,675601816,1,48,48,1360254193481,1360254193481,675577297,675577297,0
1360254254,675638492,5,352,70.4,1360254251170,1360254252962,675635662,675637454,1792
1360254262,675646508,2,150,75,1360254254996,1360254259028,675639504,675643536,4032
1360254286,675670488,2,150,75,1360254267112,1360254283240,675651600,675667728,16128
1360254295,675678580,2,131,65.5,1360254294196,1360254294196,675677776,675677776,0
1360254342,675726004,1,75,75,1360254316042,1360254316042,675700046,675700046,0
1360608447,1029829860,2,128,64,1360608420877,1360608421837,1029803737,1029804697,960
1360609116,1030499000,1,46,46,1360609088824,1360609088824,1030471824,1030471824,0
1360609116,1030499032,3,313,104.3333333,1360609089623,1360609089815,1030472655,1030472847,192
1360609116,1030499184,1,46,46,1360609088640,1360609088640,1030471824,1030471824,0
1360609116,1030499184,3,138,46,1360609088640,1360609088640,1030471824,1030471824,0
1360609116,1030499184,2,92,46,1360609088640,1360609088960,1030471824,1030472144,320
1360609124,1030507184,1,76,76,1360609097601,1360609097601,1030480785,1030480785,0
1360609156,1030539060,1,76,76,1360609127804,1360609127804,1030510864,1030510864,0
1360609200,1030583132,1,76,76,1360609173617,1360609173617,1030556749,1030556749,0
1360609204,1030587120,1,52,52,1360609178433,1360609178433,1030561553,1030561553,0
1360609325,1030707712,1,76,76,1360609297686,1360609297686,1030680398,1030680398,0
1360609356,3964019012,3,313,104.3333333,1360609331235,1360609331299,3963994247,3963994311,64
1360609390,1030772576,7,465,66.42857143,1360609383197,1360609384925,1030765773,1030767501,1728
1360609401,1030784008,1,76,76,1360609374444,1360609374444,1030757452,1030757452,0
1360609401,1030784016,15,3228,215.2,1360609374884,1360609380836,1030757900,1030763852,5952
1360609409,1030791816,3,591,197,1360609380906,1360609380970,1030763722,1030763786,64
1360609413,1030796220,4,375,93.75,1360609411478,1360609412246,1030794698,1030795466,768
1360609413,1030796220,4,375,93.75,1360609411864,1360609412632,1030795084,1030795852,768
1360609413,1030796220,4,375,93.75,1360609411543,1360609412439,1030794763,1030795659,896
1360609413,1030796220,4,375,93.75,1360609411543,1360609412439,1030794763,1030795659,896
1360609413,1030796228,6,419,69.83333333,1360609408401,1360609409681,1030791629,1030792909,1280
1360609413,1030796260,4,375,93.75,1360609409392,1360609412016,1030792652,1030795276,2624
1360609413,1030796304,6,419,69.83333333,1360609408068,1360609409604,1030791372,1030792908,1536
1360609421,1030803840,8,4234,529.25,1360609393877,1360609394709,1030776717,1030777549,832
1360609421,1030803872,8,4290,536.25,1360609394997,1360609395765,1030777869,1030778637,768
1360609421,1030804096,8,4238,529.75,1360609395924,1360609396756,1030779020,1030779852,832
1360609421,1030804172,2,92,46,1360609413449,1360609415369,1030796621,1030798541,1920
1360609421,1030804220,4,375,93.75,1360609411799,1360609413079,1030795019,1030796299,1280
1360609421,1030804220,4,375,93.75,1360609411991,1360609413079,1030795211,1030796299,1088
1360609421,1030804248,6,479,79.83333333,1360609409212,1360609414204,1030792460,1030797452,4992
1360609425,1030807836,8,4290,536.25,1360609397398,1360609398294,1030780234,1030781130,896
1360609425,1030807872,8,4292,536.5,1360609398836,1360609399540,1030781708,1030782412,704
1360609425,1030807904,9,4350,483.3333333,1360609399892,1360609403220,1030782796,1030786124,3328
1360609429,1030811864,1,52,52,1360609403260,1360609403260,1030786124,1030786124,0
1360609429,1030812332,14,14571,1040.785714,1360609414630,1360609420838,1030797962,1030804170,6208
1360609430,1030812416,5,373,74.6,1360609424699,1360609424763,1030807115,1030807179,64
1360609437,1030820056,15,3226,215.0666667,1360609412220,1360609419644,1030795276,1030802700,7424
1360609441,1030824028,1,46,46,1360609413783,1360609413783,1030796811,1030796811,0
1360609445,1030828288,6,419,69.83333333,1360609438162,1360609439314,1030821450,1030822602,1152
1360609445,1030828332,15,6793,452.8666667,1360609431654,1360609437542,1030814986,1030820874,5888
1360609446,1030828400,18,7509,417.1666667,1360609440458,1360609441098,1030822858,1030823498,640
1360609449,1030831936,24,23395,974.7916667,1360609421683,1360609427379,1030804619,1030810315,5696
1360609457,1030840068,1,46,46,1360609429680,1360609429680,1030812748,1030812748,0
1360609462,1030844336,4,375,93.75,1360609460426,1360609461450,1030842762,1030843786,1024
1360609462,1030844376,4,375,93.75,1360609458852,1360609459876,1030841228,1030842252,1024
1360609473,1030856060,1,52,52,1360609445751,1360609445751,1030828811,1030828811,0
1360609478,1030860436,5,373,74.6,1360609472167,1360609472295,1030854603,1030854731,128
1360609481,1030864240,8,4234,529.25,1360609454276,1360609455108,1030837516,1030838348,832
1360609481,1030864280,8,4296,537,1360609455450,1360609456282,1030838730,1030839562,832
1360609485,1030868088,1,52,52,1360609457883,1360609457883,1030840971,1030840971,0
1360609485,1030868176,8,4292,536.5,1360609456899,1360609457667,1030840075,1030840843,768
1360609485,1030868280,8,4232,529,1360609458201,1360609459033,1030841481,1030842313,832
1360609485,1030868320,8,4294,536.75,1360609459571,1360609460211,1030842891,1030843531,640
1360609489,1030872144,8,4294,536.75,1360609461026,1360609461858,1030844170,1030845002,832
1360609489,1030872180,2,98,49,1360609461951,1360609461951,1030845131,1030845131,0
1360609505,1030888264,21,4486,213.6190476,1360609478313,1360609500201,1030861577,1030883465,21888
1360609538,1030920372,3,630,210,1360609511076,1360609531044,1030893448,1030913416,19968
1360609566,1030948332,1,210,210,1360609541133,1360609541133,1030923465,1030923465,0
1360609670,1031052888,4,208,52,1360609667422,1360609669150,1031050310,1031052038,1728
1360609698,1031080560,1,52,52,1360609671398,1360609671398,1031053958,1031053958,0
1360609833,3964495612,3,156,52,1360609831670,1360609832438,3964494282,3964495050,768
1360610416,1031798680,4,481,120.25,1360610389286,1360610389414,1031771966,1031772094,128
1360610416,1031798680,8,2851,356.375,1360610389350,1360610390950,1031772030,1031773630,1600
1360610416,1031798804,16,3589,224.3125,1360610389287,1360610395879,1031772091,1031778683,6592
1360610416,1031798812,26,13493,518.9615385,1360610389471,1360610402527,1031772283,1031785339,13056
1360610416,1031798996,32,35963,1123.84375,1360610404137,1360610414761,1031787133,1031797757,10624
1360610416,1031799024,6,2754,459,1360610405005,1360610414733,1031788029,1031797757,9728
1360610416,1031799044,4,356,89,1360610407035,1360610414715,1031790079,1031797759,7680
1360610416,1031799080,102,140292,1375.411765,1360610404948,1360610412692,1031788028,1031795772,7744
1360610444,1031826876,1,52,52,1360610419234,1360610419234,1031802110,1031802110,0
1360610456,1031839036,43,49516,1151.534884,1360610445056,1360610453696,1031828092,1031836732,8640
1360610456,1031839148,4,356,89,1360610446290,1360610453586,1031829438,1031836734,7296
1360610456,1031839152,5,654,130.8,1360610446860,1360610453580,1031830012,1031836732,6720
1360610480,1031863012,31,23000,741.9354839,1360610455001,1360610466969,1031838013,1031849981,11968
1360610480,1031863140,58,68119,1174.465517,1360610467801,1360610477465,1031850941,1031860605,9664
1360610480,1031863148,12,12716,1059.666667,1360610468303,1360610476431,1031851451,1031859579,8128
1360610480,1031863156,5,408,81.6,1360610469001,1360610476617,1031852157,1031859773,7616
1360610489,1031871448,5,2861,572.2,1360610487498,1360610487562,1031869946,1031870010,64
1360610489,3965151692,5,2239,447.8,1360610486378,1360610486506,3965149070,3965149198,128
1360610489,3965151692,20,23252,1162.6,1360610486633,1360610487081,3965149325,3965149773,448
1360610489,3965151692,51,65714,1288.509804,1360610486632,1360610487144,3965149324,3965149836,512
1360610489,3965151704,243,338178,1391.679012,1360610482653,1360610487645,3965145357,3965150349,4992
1360610492,1031875216,4,491,122.75,1360610466315,1360610466379,1031849531,1031849595,64
1360610496,1031879304,5,1444,288.8,1360610481522,1360610488242,1031864826,1031871546,6720
1360610497,1031879328,29,36239,1249.62069,1360610491333,1360610491845,1031873661,1031874173,512
1360610497,1031879328,9,7812,868,1360610491523,1360610491843,1031873851,1031874171,320
1360610497,1031879368,48,63878,1330.791667,1360610488794,1360610489050,1031871162,1031871418,256
1360610497,1031879412,13,7001,538.5384615,1360610491119,1360610491951,1031873531,1031874363,832
1360610497,3965159692,6,4033,672.1666667,1360610490537,1360610490601,3965153229,3965153293,64
1360610497,3965159696,57,64242,1127.052632,1360610494632,1360610496680,3965157328,3965159376,2048
1360610497,3965159696,15,12452,830.1333333,1360610484197,1360610494053,3965146893,3965156749,9856
1360610497,3965159696,11,9342,849.2727273,1360610484197,1360610490725,3965146893,3965153421,6528
1360610497,3965159696,10,8587,858.7,1360610484261,1360610493989,3965146957,3965156685,9728
1360610497,3965159696,98,127819,1304.27551,1360610491877,1360610494629,3965154573,3965157325,2752
1360610497,3965159696,4,799,199.75,1360610484840,1360610494312,3965147536,3965157008,9472
1360610497,3965159700,73,75463,1033.739726,1360610492388,1360610496676,3965155088,3965159376,4288
1360610497,3965159704,7,5499,785.5714286,1360610490526,1360610490526,3965153230,3965153230,0
1360610497,3965159704,7,5477,782.4285714,1360610490526,1360610490590,3965153230,3965153294,64
1360610504,1031887244,42,54020,1286.190476,1360610484462,1360610500398,1031867706,1031883642,15936
1360610504,1031887248,47,61939,1317.851064,1360610496301,1360610496813,1031879549,1031880061,512
1360610504,1031887248,4,652,163,1360610488812,1360610496620,1031872060,1031879868,7808
1360610504,1031887248,5,2107,421.4,1360610500650,1360610500842,1031883898,1031884090,192
1360610504,1031887248,6,1052,175.3333333,1360610500650,1360610501482,1031883898,1031884730,832
1360610504,1031887260,4,993,248.25,1360610501217,1360610501409,1031884477,1031884669,192
1360610504,1031887280,4,835,208.75,1360610501388,1360610501580,1031884668,1031884860,192
1360610504,1031887288,8,4379,547.375,1360610490946,1360610498434,1031874234,1031881722,7488
1360610504,1031887292,4,519,129.75,1360610494015,1360610500351,1031877307,1031883643,6336
1360610504,1031887292,36,39753,1104.25,1360610494079,1360610503039,1031877371,1031886331,8960
1360610505,1031887332,4,792,198,1360610497662,1360610497982,1031879994,1031880314,320
1360610505,1031887336,28,33506,1196.642857,1360610497721,1360610498233,1031880057,1031880569,512
1360610505,1031887336,23,26631,1157.869565,1360610502010,1360610502330,1031884346,1031884666,320
1360610505,1031887360,6,1776,296,1360610502306,1360610502626,1031884666,1031884986,320
1360610505,1031887360,4,832,208,1360610502306,1360610502498,1031884666,1031884858,192
1360610505,1031887368,8,3486,435.75,1360610491866,1360610499354,1031874234,1031881722,7488
1360610505,1031887376,9,6163,684.7777778,1360610495443,1360610497427,1031877819,1031879803,1984
1360610505,3965167700,22,25979,1180.863636,1360610500834,1360610500962,3965163534,3965163662,128
1360610505,3965167700,42,55140,1312.857143,1360610500962,1360610501154,3965163662,3965163854,192
1360610505,3965167716,41,41938,1022.878049,1360610497680,1360610500944,3965160396,3965163660,3264
1360610505,3965167720,52,68848,1324,1360610500942,1360610501198,3965163662,3965163918,256
1360610510,3965172564,82,88556,1079.95122,1360610484331,1360610509227,3965146895,3965171791,24896
1360610512,1031895268,10,1554,155.4,1360610496279,1360610507671,1031879547,1031890939,11392
1360610512,1031895272,43,41584,967.0697674,1360610496595,1360610508755,1031879867,1031892027,12160
1360610512,1031895304,21,7562,360.0952381,1360610490164,1360610509108,1031873468,1031892412,18944
1360610513,1031895348,5,296,59.2,1360610504944,1360610510704,1031887292,1031893052,5760
1360610513,1031895464,7,1828,261.1428571,1360610502009,1360610510585,1031884473,1031893049,8576
1360610513,1031895500,4,289,72.25,1360610511065,1360610511961,1031893565,1031894461,896
1360610513,3965175720,48,46754,974.0416667,1360610497421,1360610511309,3965160141,3965174029,13888
1360610513,3965175724,8,2004,250.5,1360610499531,1360610510283,3965162255,3965173007,10752
1360610521,1031903392,2,104,52,1360610512836,1360610517060,1031895228,1031899452,4224
1360610521,1031903396,3,237,79,1360610513216,1360610520320,1031895612,1031902716,7104
1360610521,3965183728,2,92,46,1360610513351,1360610519495,3965176079,3965182223,6144
1360610528,1031910988,13,11930,917.6923077,1360610501937,1360610518129,1031884925,1031901117,16192
1360610528,1031911164,3,192,64,1360610501759,1360610510719,1031884923,1031893883,8960
1360610528,1031911280,3,168,56,1360610512845,1360610520525,1031896125,1031903805,7680
1360610529,1031911352,2,110,55,1360610513643,1360610522283,1031895995,1031904635,8640
1360610529,1031911364,2,92,46,1360610515166,1360610525406,1031897530,1031907770,10240
1360610529,3965191692,2,92,46,1360610514729,1360610521513,3965177421,3965184205,6784
1360610536,1031919312,13,3571,274.6923077,1360610531564,1360610534252,1031914876,1031917564,2688
1360610536,1031919316,2,92,46,1360610523689,1360610529065,1031907005,1031912381,5376
1360610537,1031919352,2,92,46,1360610518378,1360610533802,1031900730,1031916154,15424
1360610537,1031919364,13,3571,274.6923077,1360610531871,1360610535071,1031914235,1031917435,3200
1360610537,1031919396,5,263,52.6,1360610529791,1360610532479,1031912187,1031914875,2688
1360610537,1031919448,18,4442,246.7777778,1360610532365,1360610535629,1031914813,1031918077,3264
1360610537,3965199696,5,1586,317.2,1360610509928,1360610536744,3965172624,3965199440,26816
1360610544,1031927336,5,1244,248.8,1360610532628,1360610539028,1031915964,1031922364,6400
1360610544,1031927376,34,21068,619.6470588,1360610530285,1360610542445,1031913661,1031925821,12160
1360610544,1031927384,16,4463,278.9375,1360610534883,1360610537827,1031918267,1031921211,2944
1360610545,1031927420,5,1462,292.4,1360610533353,1360610541673,1031915773,1031924093,8320
1360610545,1031927424,5,537,107.4,1360610533604,1360610541988,1031916028,1031924412,8384
1360610545,1031927448,8,1069,133.625,1360610534794,1360610543498,1031917242,1031925946,8704
1360610545,1031927448,6,3423,570.5,1360610534858,1360610543050,1031917306,1031925498,8192
1360610545,1031927452,5,2948,589.6,1360610542983,1360610543879,1031925435,1031926331,896
1360610545,1031927456,12,1467,122.25,1360610523461,1360610541381,1031905917,1031923837,17920
1360610552,1031935384,8,1473,184.125,1360610538467,1360610546275,1031921851,1031929659,7808
1360610552,1031935388,22,14684,667.4545455,1360610538976,1360610548128,1031922364,1031931516,9152
1360610552,1031935388,16,9536,596,1360610539166,1360610547870,1031922554,1031931258,8704
1360610553,1031935424,4,591,147.75,1360610544101,1360610546277,1031926525,1031928701,2176
1360610553,1031935476,17,16516,971.5294118,1360610542961,1360610550129,1031925437,1031932605,7168
1360610553,1031935480,22,16218,737.1818182,1360610540075,1360610550187,1031922555,1031932667,10112
1360610553,3965215700,5,1821,364.2,1360610543267,1360610551779,3965205967,3965214479,8512
1360610553,3965215700,37,41958,1134,1360610539490,1360610549794,3965202190,3965212494,10304
1360610553,3965215708,263,342470,1302.1673,1360610486617,1360610546905,3965149325,3965209613,60288
1360610556,1031939096,1,46,46,1360610531074,1360610531074,1031914170,1031914170,0
1360610558,3965220636,1,46,46,1360610531746,1360610531746,3965194382,3965194382,0
1360610560,1031943344,10,6089,608.9,1360610544714,1360610556746,1031928058,1031940090,12032
1360610560,1031943348,3,421,140.3333333,1360610556742,1360610556870,1031940090,1031940218,128
1360610560,1031943352,8,5206,650.75,1360610556929,1360610557185,1031940281,1031940537,256
1360610560,1031943376,4,589,147.25,1360610557163,1360610557355,1031940539,1031940731,192
1360610560,1031943376,4,476,119,1360610549353,1360610557417,1031932729,1031940793,8064
1360610560,1031943380,33,43186,1308.666667,1360610542054,1360610559462,1031925434,1031942842,17408
1360610560,1031943384,6,2062,343.6666667,1360610554596,1360610554660,1031937980,1031938044,64
1360610560,1031943384,7,741,105.8571429,1360610554722,1360610556642,1031938106,1031940026,1920
1360610560,1031943384,6,721,120.1666667,1360610554977,1360610556705,1031938361,1031940089,1728
1360610560,1031943388,10,2292,229.2,1360610558176,1360610558880,1031941564,1031942268,704
1360610561,1031943436,3,1076,358.6666667,1360610549910,1360610558358,1031932346,1031940794,8448
1360610561,1031943460,22,26750,1215.909091,1360610546686,1360610557566,1031929146,1031940026,10880
1360610561,1031943460,91,117141,1287.263736,1360610558333,1360610559293,1031940793,1031941753,960
1360610561,1031943468,11,4012,364.7272727,1360610555509,1360610558069,1031937977,1031940537,2560
1360610561,1031943468,5,1297,259.4,1360610555512,1360610555640,1031937980,1031938108,128
1360610561,1031943472,5,935,187,1360610559410,1360610559666,1031941882,1031942138,256
1360610561,1031943476,6,1592,265.3333333,1360610559599,1360610559791,1031942075,1031942267,192
1360610558,3965220664,138,183479,1329.557971,1360610545864,1360610559240,3965208528,3965221904,13376
1360610561,3965223704,69,86238,1249.826087,1360610548192,1360610560672,3965210896,3965223376,12480
1360610561,3965223720,5,821,164.2,1360610558863,1360610558991,3965221583,3965221711,128
1360610562,3965224576,1,46,46,1360610535262,1360610535262,3965197838,3965197838,0
1360610564,1031946980,10,4003,400.3,1360610535928,1360610537720,1031918908,1031920700,1792
1360610564,1031947064,1,46,46,1360610538978,1360610538978,1031922042,1031922042,0
1360610568,1031951084,9,3475,386.1111111,1360610542416,1360610548112,1031925500,1031931196,5696
1360610568,1031951348,4,842,210.5,1360610559878,1360610560006,1031943226,1031943354,128
1360610568,1031951352,4,526,131.5,1360610560068,1360610560260,1031943420,1031943612,192
1360610568,1031951352,5,1297,259.4,1360610560257,1360610560641,1031943609,1031943993,384
1360610568,1031951364,12,5590,465.8333333,1360610553656,1360610563768,1031937020,1031947132,10112
1360610569,1031951484,5,657,131.4,1360610564134,1360610564134,1031946618,1031946618,0
1360610569,1031951512,4,843,210.75,1360610560459,1360610560715,1031942971,1031943227,256
1360610569,1031951552,11,6934,630.3636364,1360610558242,1360610561506,1031940794,1031944058,3264
1360610569,1031951560,3,421,140.3333333,1360610564123,1360610564187,1031946683,1031946747,64
1360610569,1031951564,32,24192,756,1360610551317,1360610562325,1031933881,1031944889,11008
1360610569,3965231752,8,1548,193.5,1360610555119,1360610566255,3965217871,3965229007,11136
1360610569,3965231756,9,5892,654.6666667,1360610559723,1360610566251,3965222479,3965229007,6528
1360610569,3965231780,4,1154,288.5,1360610559889,1360610566225,3965222669,3965229005,6336
1360610572,1031955148,1,46,46,1360610545421,1360610545421,1031928569,1031928569,0
1360610577,1031959440,90,113165,1257.388889,1360610558419,1360610570835,1031940859,1031953275,12416
1360610577,1031959448,5,1562,312.4,1360610563788,1360610570892,1031946236,1031953340,7104
1360610577,3965239704,7,2292,327.4285714,1360610557277,1360610570333,3965219981,3965233037,13056
1360610577,3965239704,8,3349,418.625,1360610557341,1360610570397,3965220045,3965233101,13056
1360610625,1032007412,6,480,80,1360610617007,1360610623407,1031999419,1032005819,6400
1360610625,1032007464,2,98,49,1360610616826,1360610617082,1031999290,1031999546,256
1360610649,1032031656,9,2922,324.6666667,1360610647354,1360610647930,1032030010,1032030586,576
1360610649,3965311696,6,587,97.83333333,1360610646374,1360610646438,3965309070,3965309134,64
1360610649,3965311708,24,22486,936.9166667,1360610646170,1360610647578,3965308878,3965310286,1408
1360610649,3965311728,55,64961,1181.109091,1360610647561,1360610648841,3965310289,3965311569,1280
1360610649,3965311728,50,63606,1272.12,1360610647497,1360610648777,3965310225,3965311505,1280
1360610657,1032039540,12,9658,804.8333333,1360610649899,1360610650091,1032032439,1032032631,192
1360610657,1032039540,4,582,145.5,1360610649967,1360610650095,1032032507,1032032635,128
1360610657,1032039568,5,1941,388.2,1360610651089,1360610651281,1032033657,1032033849,192
1360610657,1032039568,11,3920,356.3636364,1360610651408,1360610651536,1032033976,1032034104,128
1360610657,1032039568,23,26631,1157.869565,1360610651408,1360610651536,1032033976,1032034104,128
1360610657,1032039572,4,832,208,1360610651534,1360610651662,1032034106,1032034234,128
1360610657,1032039572,6,999,166.5,1360610651788,1360610651916,1032034360,1032034488,128
1360610657,1032039572,8,1705,213.125,1360610651916,1360610652300,1032034488,1032034872,384
1360610657,1032039576,7,755,107.8571429,1360610652234,1360610653386,1032034810,1032035962,1152
1360610657,1032039576,6,626,104.3333333,1360610655370,1360610655754,1032037946,1032038330,384
1360610657,1032039576,6,626,104.3333333,1360610655370,1360610655754,1032037946,1032038330,384
1360610657,1032039576,5,756,151.2,1360610655368,1360610655752,1032037944,1032038328,384
1360610657,1032039580,3,421,140.3333333,1360610652421,1360610652549,1032035001,1032035129,128
1360610657,1032039608,8,3531,441.375,1360610652777,1360610653033,1032035385,1032035641,256
1360610657,1032039620,27,28718,1063.62963,1360610642203,1360610652763,1032024823,1032035383,10560
1360610657,1032039624,19,8690,457.3684211,1360610650969,1360610651673,1032033593,1032034297,704
1360610657,1032039624,7,4032,576,1360610642840,1360610650712,1032025464,1032033336,7872
1360610657,1032039652,4,356,89,1360610643389,1360610650685,1032026041,1032033337,7296
1360610657,1032039656,4,604,151,1360610651768,1360610651832,1032034424,1032034488,64
1360610657,1032039656,5,657,131.4,1360610652216,1360610652280,1032034872,1032034936,64
1360610657,1032039664,8,4304,538,1360610647471,1360610654703,1032030135,1032037367,7232
1360610657,3965319692,24,21750,906.25,1360610646378,1360610649642,3965309070,3965312334,3264
1360610657,3965319700,86,112981,1313.732558,1360610647716,1360610650148,3965310416,3965312848,2432
1360610657,3965319700,4,1293,323.25,1360610653539,1360610653667,3965316239,3965316367,128
1360610657,3965319700,5,547,109.4,1360610654113,1360610654369,3965316813,3965317069,256
1360610657,3965319704,31,38759,1250.290323,1360610650145,1360610651489,3965312849,3965314193,1344
1360610657,3965319704,25,11836,473.44,1360610646431,1360610650783,3965309135,3965313487,4352
1360610657,3965319704,6,1348,224.6666667,1360610646430,1360610653534,3965309134,3965316238,7104
1360610657,3965319716,5,1796,359.2,1360610651604,1360610651668,3965314320,3965314384,64
1360610657,3965319716,4,486,121.5,1360610646867,1360610654483,3965309583,3965317199,7616
1360610657,3965319716,4,464,116,1360610652626,1360610652690,3965315342,3965315406,64
1360610657,3965319720,4,729,182.25,1360610653521,1360610653649,3965316241,3965316369,128
1360610664,1032047292,16,8859,553.6875,1360610637567,1360610640831,1032020859,1032024123,3264
1360610665,1032047368,8,1572,196.5,1360610640408,1360610642456,1032022776,1032024824,2048
1360610665,1032047540,5,649,129.8,1360610652652,1360610660844,1032035192,1032043384,8192
1360610665,1032047548,3,183,61,1360610657701,1360610658341,1032040249,1032040889,640
1360610665,1032047552,16,17806,1112.875,1360610661856,1360610662112,1032044408,1032044664,256
1360610665,1032047572,6,963,160.5,1360610654221,1360610662797,1032036793,1032045369,8576
1360610665,1032047572,14,15532,1109.428571,1360610650828,1360610658764,1032033400,1032041336,7936
1360610665,1032047584,12,4301,358.4166667,1360610651971,1360610660803,1032034555,1032043387,8832
1360610665,1032047584,4,232,58,1360610655488,1360610658624,1032038072,1032041208,3136
1360610665,1032047592,4,747,186.75,1360610660539,1360610660731,1032043131,1032043323,192
1360610665,1032047612,6,850,141.6666667,1360610652707,1360610659811,1032035319,1032042423,7104
1360610665,1032047616,17,10542,620.1176471,1360610648674,1360610658722,1032031290,1032041338,10048
1360610665,1032047620,8,3362,420.25,1360610661212,1360610662492,1032043832,1032045112,1280
1360610665,1032047632,5,634,126.8,1360610650451,1360610658771,1032033083,1032041403,8320
1360610665,1032047664,6,626,104.3333333,1360610655218,1360610663026,1032037882,1032045690,7808
1360610665,1032047664,5,1944,388.8,1360610663985,1360610664241,1032046649,1032046905,256
1360610665,3965327696,4,1074,268.5,1360610661799,1360610661927,3965324495,3965324623,128
1360610665,3965327704,5,792,158.4,1360610659488,1360610661536,3965322192,3965324240,2048
1360610665,3965327724,11,5444,494.9090909,1360610659466,1360610661898,3965322190,3965324622,2432
1360610665,3965327728,5,538,107.6,1360610659721,1360610659913,3965322449,3965322641,192
1360610665,3965327728,160,220406,1377.5375,1360610647112,1360610658440,3965309840,3965321168,11328
1360610673,1032055548,4,591,147.75,1360610668518,1360610668582,1032051066,1032051130,64
1360610673,1032055548,3,421,140.3333333,1360610668581,1360610668709,1032051129,1032051257,128
1360610673,1032055552,4,589,147.25,1360610668707,1360610668835,1032051259,1032051387,128
1360610673,1032055600,4,519,129.75,1360610668274,1360610668466,1032050874,1032051066,192
1360610673,1032055600,6,1496,249.3333333,1360610663856,1360610671408,1032046456,1032054008,7552
1360610673,1032055604,4,476,119,1360610668460,1360610668588,1032051064,1032051192,128
1360610673,1032055604,2,131,65.5,1360610668524,1360610668524,1032051128,1032051128,0
1360610673,1032055604,5,657,131.4,1360610668523,1360610668651,1032051127,1032051255,128
1360610673,1032055608,5,892,178.4,1360610664423,1360610671719,1032047031,1032054327,7296
1360610673,1032055628,7,1062,151.7142857,1360610665110,1360610668438,1032047738,1032051066,3328
1360610673,1032055664,22,26871,1221.409091,1360610662514,1360610668722,1032045178,1032051386,6208
1360610673,1032055668,4,604,151,1360610668011,1360610668203,1032050679,1032050871,192
1360610673,3965335688,74,79646,1076.297297,1360610657838,1360610668590,3965320526,3965331278,10752
1360610673,3965335700,7,4537,648.1428571,1360610660323,1360610666531,3965323023,3965329231,6208
1360610673,3965335700,7,4783,683.2857143,1360610660322,1360610666530,3965323022,3965329230,6208
1360610673,3965335700,19,18554,976.5263158,1360610660450,1360610668578,3965323150,3965331278,8128
1360610673,3965335720,74,74634,1008.567568,1360610659726,1360610670798,3965322446,3965333518,11072
1360610673,3965335724,18,17887,993.7222222,1360610660428,1360610668556,3965323152,3965331280,8128
1360610674,3965336668,1,46,46,1360610649028,1360610649028,3965311696,3965311696,0
1360610681,1032063584,8,2415,301.875,1360610668674,1360610679042,1032051258,1032061626,10368
1360610681,1032063636,6,1655,275.8333333,1360610672142,1360610678990,1032054778,1032061626,6848
1360610681,1032063672,8,2108,263.5,1360610673962,1360610674026,1032056634,1032056698,64
1360610681,1032063812,5,290,58,1360610664220,1360610673692,1032047032,1032056504,9472
1360610681,1032063816,4,843,210.75,1360610672087,1360610678807,1032054903,1032061623,6720
1360610681,1032063816,5,764,152.8,1360610672151,1360610672791,1032054967,1032055607,640
1360610681,3965343704,6,2113,352.1666667,1360610667551,1360610674719,3965330255,3965337423,7168
1360610681,3965343712,11,1869,169.9090909,1360610670039,1360610678743,3965332751,3965341455,8704
1360610681,3965343728,6,1808,301.3333333,1360610668487,1360610676743,3965331215,3965339471,8256
1360610689,1032071548,18,9104,505.7777778,1360610664484,1360610685092,1032047032,1032067640,20608
1360610697,1032079612,5,1940,388,1360610692453,1360610694565,1032075065,1032077177,2112
1360610697,1032079616,7,1808,258.2857143,1360610692770,1360610692834,1032075386,1032075450,64
1360610697,1032079616,7,1808,258.2857143,1360610692770,1360610693026,1032075386,1032075642,256
1360610697,1032079620,4,604,151,1360610693276,1360610693404,1032075896,1032076024,128
1360610697,1032079628,4,591,147.75,1360610693908,1360610694036,1032076536,1032076664,128
1360610697,1032079648,7,2351,335.8571429,1360610694145,1360610694337,1032076793,1032076985,192
1360610697,1032079696,4,832,208,1360610692687,1360610692943,1032075383,1032075639,256
1360610697,1032079700,5,935,187,1360610693135,1360610693263,1032075835,1032075963,128
1360610697,1032079708,5,657,131.4,1360610693894,1360610693958,1032076602,1032076666,64
1360610697,1032079708,3,421,140.3333333,1360610693958,1360610694022,1032076666,1032076730,64
1360610697,1032079708,4,589,147.25,1360610694021,1360610694149,1032076729,1032076857,128
1360610697,1032079708,4,476,119,1360610694021,1360610694149,1032076729,1032076857,128
1360610697,3965359704,4,464,116,1360610693920,1360610694112,3965356624,3965356816,192
1360610697,3965359704,5,1748,349.6,1360610694048,1360610694176,3965356752,3965356880,128
1360610697,3965359704,51,56388,1105.647059,1360610686239,1360610696799,3965348943,3965359503,10560
1360610697,3965359728,11,2048,186.1818182,1360610689032,1360610695944,3965351760,3965358672,6912
1360610697,3965359732,17,14614,859.6470588,1360610689285,1360610696773,3965352017,3965359505,7488
1360610697,3965359740,5,1817,363.4,1360610693052,1360610693180,3965355792,3965355920,128
1360610701,1032083480,1,52,52,1360610675047,1360610675047,1032057527,1032057527,0
1360610705,3965367700,51,48659,954.0980392,1360610689381,1360610698789,3965352081,3965361489,9408
1360610705,1032087628,14,6561,468.6428571,1360610689877,1360610699221,1032072505,1032081849,9344
1360610705,3965367708,9,1344,149.3333333,1360610690396,1360610704796,3965353104,3965367504,14400
1360610705,3965367720,64,67642,1056.90625,1360610689360,1360610698768,3965352080,3965361488,9408
1360610705,1032087740,4,519,129.75,1360610695909,1360610702949,1032078649,1032085689,7040
1360610725,1032107496,1,52,52,1360610699226,1360610699226,1032081722,1032081722,0
1360610729,1032111636,4,519,129.75,1360610721038,1360610721358,1032103674,1032103994,320
1360610729,1032111636,7,1812,258.8571429,1360610721038,1360610721358,1032103674,1032103994,320
1360610729,1032111640,5,934,186.8,1360610721417,1360610721609,1032104057,1032104249,192
1360610729,1032111640,4,604,151,1360610721416,1360610721608,1032104056,1032104248,192
1360610729,1032111640,4,591,147.75,1360610721543,1360610721671,1032104183,1032104311,128
1360610729,1032111644,3,421,140.3333333,1360610721602,1360610721730,1032104246,1032104374,128
1360610729,1032111644,4,589,147.25,1360610721670,1360610721798,1032104314,1032104442,128
1360610729,1032111644,4,476,119,1360610721734,1360610721798,1032104378,1032104442,64
1360610729,1032111644,6,2287,381.1666667,1360610721733,1360610721861,1032104377,1032104505,128
1360610729,1032111684,59,77556,1314.508475,1360610716318,1360610725278,1032099002,1032107962,8960
1360610729,1032111688,6,4430,738.3333333,1360610728218,1360610728410,1032110906,1032111098,192
1360610729,1032111688,6,2775,462.5,1360610728218,1360610728410,1032110906,1032111098,192
1360610729,1032111712,6,1744,290.6666667,1360610720960,1360610721280,1032103672,1032103992,320
1360610729,1032111712,4,832,208,1360610720960,1360610721280,1032103672,1032103992,320
1360610729,1032111716,5,657,131.4,1360610721532,1360610721596,1032104248,1032104312,64
1360610729,1032111756,9,7529,836.5555556,1360610723988,1360610724244,1032106744,1032107000,256
1360610729,1032111760,14,5915,422.5,1360610715858,1360610727698,1032098618,1032110458,11840
1360610729,1032111764,5,1270,254,1360610728140,1360610728332,1032110904,1032111096,192
1360610729,1032111764,8,2701,337.625,1360610719755,1360610727307,1032102519,1032110071,7552
1360610729,3965391700,5,1748,349.6,1360610722149,1360610722213,3965384849,3965384913,64
1360610729,3965391704,60,66308,1105.133333,1360610715806,1360610725086,3965378510,3965387790,9280
1360610729,3965391712,6,3244,540.6666667,1360610721178,1360610722010,3965383890,3965384722,832
1360610729,3965391724,9,1476,164,1360610715019,1360610722123,3965377743,3965384847,7104
1360610729,3965391724,67,73722,1100.328358,1360610715338,1360610725066,3965378062,3965387790,9728
1360610729,3965391728,4,487,121.75,1360610723529,1360610723593,3965386257,3965386321,64
1360610729,3965391728,24,19638,818.25,1360610715785,1360610727369,3965378513,3965390097,11584
1360610729,3965391728,32,28143,879.46875,1360610713480,1360610723080,3965376208,3965385808,9600
1360610737,1032119680,5,1932,386.4,1360610734881,1360610735073,1032117561,1032117753,192
1360610737,1032119688,4,591,147.75,1360610735770,1360610735834,1032118458,1032118522,64
1360610737,1032119688,3,421,140.3333333,1360610735834,1360610735898,1032118522,1032118586,64
1360610737,1032119764,7,1812,258.8571429,1360610735051,1360610735179,1032117815,1032117943,128
1360610737,1032119764,4,832,208,1360610735114,1360610735242,1032117878,1032118006,128
1360610737,1032119768,7,1812,258.8571429,1360610735050,1360610735114,1032117818,1032117882,64
1360610737,1032119772,4,604,151,1360610735621,1360610735621,1032118393,1032118393,0
1360610737,1032119772,5,657,131.4,1360610735684,1360610735812,1032118456,1032118584,128
1360610737,1032119772,4,476,119,1360610735748,1360610735876,1032118520,1032118648,128
1360610737,1032119772,4,589,147.25,1360610735748,1360610735876,1032118520,1032118648,128
1360610737,1032119772,7,2343,334.7142857,1360610735812,1360610736132,1032118584,1032118904,320
1360610737,3965399700,5,1748,349.6,1360610735780,1360610736036,3965398480,3965398736,256
1360610737,3965399704,5,825,165,1360610722082,1360610735266,3965384786,3965397970,13184
1360610737,3965399720,5,1818,363.6,1360610735441,1360610735569,3965398161,3965398289,128
1360610737,3965399720,4,464,116,1360610735697,1360610735761,3965398417,3965398481,64
1360610745,1032127732,4,519,129.75,1360610737645,1360610737709,1032120377,1032120441,64
1360610745,1032127780,5,934,186.8,1360610735484,1360610743292,1032118264,1032126072,7808
1360610745,1032127780,13,5843,449.4615385,1360610732412,1360610741308,1032115192,1032124088,8896
1360610745,3965407704,15,2800,186.6666667,1360610723424,1360610743264,3965386128,3965405968,19840
1360610745,3965407708,45,47272,1050.488889,1360610732381,1360610741277,3965395089,3965403985,8896
1360610745,3965407724,79,85515,1082.468354,1360610731019,1360610741259,3965393743,3965403983,10240
1360610745,3965407728,15,4078,271.8666667,1360610731402,1360610743242,3965394130,3965405970,11840
1360610745,3965407728,23,16523,718.3913043,1360610731976,1360610741192,3965394704,3965403920,9216
1360610745,3965407728,21,18726,891.7142857,1360610732359,1360610741255,3965395087,3965403983,8896
1360610761,1032143768,5,2962,592.4,1360610756742,1360610756870,1032139510,1032139638,128
1360610761,1032143772,4,356,89,1360610748613,1360610755397,1032131385,1032138169,6784
1360610761,1032143780,4,399,99.75,1360610749245,1360610757373,1032132025,1032140153,8128
1360610761,1032143784,4,832,208,1360610758199,1360610758263,1032140983,1032141047,64
1360610761,1032143808,4,1069,267.25,1360610758686,1360610758878,1032141494,1032141686,192
1360610761,1032143808,5,1023,204.6,1360610758686,1360610758814,1032141494,1032141622,128
1360610761,1032143812,5,1410,282,1360610758748,1360610758940,1032141560,1032141752,192
1360610761,1032143812,25,27537,1101.48,1360610747420,1360610759324,1032130232,1032142136,11904
1360610761,1032143816,5,935,187,1360610759129,1360610759193,1032141945,1032142009,64
1360610761,1032143816,4,467,116.75,1360610759447,1360610759831,1032142263,1032142647,384
1360610761,1032143816,4,591,147.75,1360610759382,1360610759446,1032142198,1032142262,64
1360610761,1032143816,6,2968,494.6666667,1360610756118,1360610756310,1032138934,1032139126,192
1360610761,1032143820,4,476,119,1360610759506,1360610759634,1032142326,1032142454,128
1360610761,1032143820,4,589,147.25,1360610759509,1360610759637,1032142329,1032142457,128
1360610761,1032143820,6,1438,239.6666667,1360610759828,1360610759956,1032142648,1032142776,128
1360610761,1032143820,6,946,157.6666667,1360610760402,1360610760530,1032143222,1032143350,128
1360610761,1032143824,6,1042,173.6666667,1360610760528,1360610760656,1032143352,1032143480,128
1360610761,1032143856,6,1744,290.6666667,1360610758063,1360610758191,1032140919,1032141047,128
1360610761,1032143860,15,12537,835.8,1360610758250,1360610758954,1032141110,1032141814,704
1360610761,1032143860,7,2351,335.8571429,1360610758444,1360610758636,1032141304,1032141496,192
1360610761,1032143888,6,876,146,1360610758735,1360610758927,1032141623,1032141815,192
1360610761,1032143896,5,657,131.4,1360610759369,1360610759497,1032142265,1032142393,128
1360610761,1032143896,5,1027,205.4,1360610759495,1360610759623,1032142391,1032142519,128
1360610761,1032143896,8,3553,444.125,1360610759942,1360610760134,1032142838,1032143030,192
1360610761,1032143900,5,926,185.2,1360610759813,1360610759941,1032142713,1032142841,128
1360610761,1032143900,5,1248,249.6,1360610759941,1360610760069,1032142841,1032142969,128
1360610761,1032143900,6,809,134.8333333,1360610760196,1360610760324,1032143096,1032143224,128
1360610761,3965423852,11,10406,946,1360610758091,1360610758283,3965420943,3965421135,192
1360610761,3965423856,61,76935,1261.229508,1360610753160,1360610756552,3965416016,3965419408,3392
1360610761,3965423860,11,10580,961.8181818,1360610756102,1360610756230,3965418962,3965419090,128
1360610761,3965423864,55,70469,1281.254545,1360610753984,1360610758336,3965416848,3965421200,4352
1360610761,3965423864,6,2168,361.3333333,1360610757951,1360610758335,3965420815,3965421199,384
1360610761,3965423884,5,1820,364,1360610758958,1360610759086,3965421842,3965421970,128
1360610761,3965423884,4,525,131.25,1360610759660,1360610759724,3965422544,3965422608,64
1360610765,1032147500,26,16526,635.6153846,1360610739989,1360610745941,1032122489,1032128441,5952
1360610769,1032151708,8,5892,736.5,1360610764549,1360610765061,1032147257,1032147769,512
1360610769,1032151712,6,809,134.8333333,1360610765056,1360610765248,1032147768,1032147960,192
1360610769,1032151712,6,3245,540.8333333,1360610765246,1360610765950,1032147958,1032148662,704
1360610769,1032151712,5,492,98.4,1360610765118,1360610765246,1032147830,1032147958,128
1360610769,1032151724,7,1808,258.2857143,1360610758197,1360610765429,1032140921,1032148153,7232
1360610769,1032151724,8,6573,821.625,1360610762613,1360610762677,1032145337,1032145401,64
1360610769,1032151748,19,21775,1146.052632,1360610763099,1360610763355,1032145847,1032146103,256
1360610769,1032151764,7,907,129.5714286,1360610760013,1360610768333,1032142777,1032151097,8320
1360610769,1032151792,10,8744,874.4,1360610764976,1360610765040,1032147768,1032147832,64
1360610769,1032151792,5,492,98.4,1360610764976,1360610765104,1032147768,1032147896,128
1360610769,1032151792,7,2654,379.1428571,1360610765039,1360610766063,1032147831,1032148855,1024
1360610769,1032151792,34,43651,1283.852941,1360610765166,1360610766318,1032147958,1032149110,1152
1360610769,1032151800,5,284,56.8,1360610765478,1360610768678,1032148278,1032151478,3200
1360610769,1032151832,10,4529,452.9,1360610755719,1360610760839,1032138551,1032143671,5120
1360610769,1032151836,14,15465,1104.642857,1360610759173,1360610767301,1032142009,1032150137,8128
1360610769,1032151836,7,1780,254.2857143,1360610764290,1360610764546,1032147126,1032147382,256
1360610769,3965431864,129,167458,1298.124031,1360610752833,1360610767169,3965415697,3965430033,14336
1360610769,3965431868,18,13713,761.8333333,1360610763069,1360610764093,3965425937,3965426961,1024
1360610769,3965431868,157,216538,1379.22293,1360610753276,1360610761084,3965416144,3965423952,7808
1360610769,3965431868,24,24643,1026.791667,1360610761404,1360610762364,3965424272,3965425232,960
1360610769,3965431868,38,40605,1068.552632,1360610761404,1360610762684,3965424272,3965425552,1280
1360610769,3965431872,6,576,96,1360610759353,1360610761465,3965422225,3965424337,2112
1360610769,3965431876,5,1822,364.4,1360610757685,1360610765109,3965420561,3965427985,7424
1360610769,3965431892,47,51927,1104.829787,1360610762854,1360610764134,3965425746,3965427026,1280
1360610769,3965431892,15,9758,650.5333333,1360610753125,1360610767141,3965416017,3965430033,14016
1360610769,3965431892,15,7629,508.6,1360610763109,1360610764709,3965426001,3965427601,1600
1360610769,3965431892,30,31175,1039.166667,1360610761379,1360610762339,3965424271,3965425231,960
1360610769,3965431892,70,91910,1313,1360610756259,1360610763107,3965419151,3965425999,6848
1360610769,3965431892,46,53912,1172,1360610761379,1360610762275,3965424271,3965425167,896
1360610769,3965431892,6,1030,171.6666667,1360610767266,1360610767522,3965430158,3965430414,256
1360610769,3965431896,9,2274,252.6666667,1360610763937,1360610764705,3965426833,3965427601,768
1360610769,3965431896,9,1173,130.3333333,1360610764129,1360610764705,3965427025,3965427601,576
1360610769,3965431896,5,1213,242.6,1360610760607,1360610761311,3965423503,3965424207,704
1360610773,1032155476,2,393,196.5,1360610747564,1360610747564,1032130040,1032130040,0
1360610777,1032159784,6,2436,406,1360610765367,1360610773559,1032148151,1032156343,8192
1360610777,1032159812,6,3013,502.1666667,1360610773914,1360610774042,1032156726,1032156854,128
1360610777,1032159816,3,499,166.3333333,1360610774104,1360610774232,1032156920,1032157048,128
1360610777,1032159820,5,2966,593.2,1360610774293,1360610774357,1032157113,1032157177,64
1360610777,1032159852,7,3720,531.4285714,1360610775605,1360610775733,1032158457,1032158585,128
1360610777,1032159856,3,809,269.6666667,1360610775793,1360610775921,1032158649,1032158777,128
1360610777,1032159856,5,519,103.8,1360610775857,1360610776049,1032158713,1032158905,192
1360610777,1032159856,10,9645,964.5,1360610775601,1360610775729,1032158457,1032158585,128
1360610777,1032159856,7,1808,258.2857143,1360610775665,1360610775729,1032158521,1032158585,64
1360610777,1032159856,4,999,249.75,1360610775728,1360610775920,1032158584,1032158776,192
1360610777,1032159856,5,935,187,1360610775984,1360610776048,1032158840,1032158904,64
1360610777,1032159912,3,172,57.33333333,1360610767416,1360610770552,1032150328,1032153464,3136
1360610777,1032159912,5,284,56.8,1360610767414,1360610770550,1032150326,1032153462,3136
1360610777,1032159936,23,18315,796.3043478,1360610760287,1360610769311,1032143223,1032152247,9024
1360610777,1032159940,4,659,164.75,1360610775517,1360610775645,1032158457,1032158585,128
1360610777,1032159940,5,884,176.8,1360610775644,1360610775964,1032158584,1032158904,320
1360610777,1032159940,4,663,165.75,1360610776027,1360610776155,1032158967,1032159095,128
1360610777,3965439896,15,8863,590.8666667,1360610763041,1360610771105,3965425937,3965434001,8064
1360610777,3965439900,5,1825,365,1360610775836,1360610775900,3965438736,3965438800,64
1360610785,1032167744,6,615,102.5,1360610780767,1360610780895,1032163511,1032163639,128
1360610785,1032167748,4,591,147.75,1360610777052,1360610777116,1032159800,1032159864,64
1360610785,1032167748,4,467,116.75,1360610777114,1360610777434,1032159862,1032160182,320
1360610785,1032167748,7,2008,286.8571429,1360610781210,1360610781274,1032163958,1032164022,64
1360610785,1032167752,4,589,147.25,1360610777241,1360610777369,1032159993,1032160121,128
1360610785,1032167756,40,27998,699.95,1360610781716,1360610781972,1032164472,1032164728,256
1360610785,1032167760,5,801,160.2,1360610778576,1360610778960,1032161336,1032161720,384
1360610785,1032167784,8,4138,517.25,1360610778741,1360610779125,1032161525,1032161909,384
1360610785,1032167788,6,615,102.5,1360610779506,1360610779634,1032162294,1032162422,128
1360610785,1032167792,7,679,97,1360610779697,1360610779761,1032162489,1032162553,64
1360610785,1032167796,4,1438,359.5,1360610772266,1360610779562,1032155062,1032162358,7296
1360610785,1032167800,4,267,66.75,1360610772265,1360610779561,1032155065,1032162361,7296
1360610785,1032167800,4,1358,339.5,1360610784231,1360610784295,1032167031,1032167095,64
1360610785,1032167816,9,3340,371.1111111,1360610775766,1360610778326,1032158582,1032161142,2560
1360610785,1032167820,9,1230,136.6666667,1360610780692,1360610783892,1032163512,1032166712,3200
1360610785,1032167824,4,576,144,1360610781073,1360610781137,1032163897,1032163961,64
1360610785,1032167824,17,15596,917.4117647,1360610776785,1360610777681,1032159609,1032160505,896
1360610785,1032167824,17,17449,1026.411765,1360610764944,1360610779536,1032147768,1032162360,14592
1360610785,1032167824,6,3867,644.5,1360610776784,1360610776912,1032159608,1032159736,128
1360610785,1032167824,5,657,131.4,1360610777039,1360610777103,1032159863,1032159927,64
1360610785,1032167824,6,592,98.66666667,1360610777230,1360610780878,1032160054,1032163702,3648
1360610785,1032167824,5,492,98.4,1360610781198,1360610781262,1032164022,1032164086,64
1360610785,1032167828,5,1664,332.8,1360610781517,1360610781581,1032164345,1032164409,64
1360610785,1032167832,5,492,98.4,1360610781577,1360610781705,1032164409,1032164537,128
1360610785,1032167832,4,779,194.75,1360610781640,1360610781768,1032164472,1032164600,128
1360610785,1032167836,9,7581,842.3333333,1360610781956,1360610782020,1032164792,1032164856,64
1360610785,1032167836,7,1511,215.8571429,1360610778755,1360610778819,1032161591,1032161655,64
1360610785,1032167860,7,2339,334.1428571,1360610778473,1360610778601,1032161333,1032161461,128
1360610785,1032167860,4,711,177.75,1360610778793,1360610778857,1032161653,1032161717,64
1360610785,1032167864,7,679,97,1360610782696,1360610782760,1032165560,1032165624,64
1360610785,1032167864,8,2860,357.5,1360610779111,1360610782119,1032161975,1032164983,3008
1360610785,1032167864,9,3665,407.2222222,1360610779430,1360610779686,1032162294,1032162550,256
1360610785,1032167868,6,615,102.5,1360610779297,1360610779361,1032162165,1032162229,64
1360610785,1032167872,8,1037,129.625,1360610780065,1360610780193,1032162937,1032163065,128
1360610785,1032167876,6,1770,295,1360610783964,1360610784156,1032166840,1032167032,192
1360610785,1032167876,4,710,177.5,1360610784028,1360610784156,1032166904,1032167032,128
1360610785,1032167900,4,542,135.5,1360610784196,1360610784324,1032167096,1032167224,128
1360610785,1032167900,4,576,144,1360610775490,1360610783490,1032158390,1032166390,8000
1360610785,3965447860,5,524,104.8,1360610777029,1360610779077,3965439889,3965441937,2048
1360610785,3965447860,12,11740,978.3333333,1360610778436,1360610778500,3965441296,3965441360,64
1360610785,3965447860,21,23999,1142.809524,1360610778436,1360610778500,3965441296,3965441360,64
1360610785,3965447864,9,3066,340.6666667,1360610774913,1360610781889,3965437777,3965444753,6976
1360610785,3965447868,35,39088,1116.8,1360610772285,1360610783357,3965435153,3965446225,11072
1360610785,3965447872,4,525,131.25,1360610778679,1360610778743,3965441551,3965441615,64
1360610785,3965447872,20,24231,1211.55,1360610777143,1360610777271,3965440015,3965440143,128
1360610793,1032175792,4,267,66.75,1360610785007,1360610785135,1032167799,1032167927,128
1360610793,1032175828,8,4792,599,1360610781901,1360610789581,1032164729,1032172409,7680
1360610793,1032175828,5,824,164.8,1360610782027,1360610789579,1032164855,1032172407,7552
1360610793,1032175832,7,679,97,1360610786760,1360610786824,1032169592,1032169656,64
1360610793,1032175948,5,514,102.8,1360610783828,1360610791508,1032166776,1032174456,7680
1360610793,1032175948,6,858,143,1360610783828,1360610792724,1032166776,1032175672,8896
1360610793,1032175968,16,9178,573.625,1360610773504,1360610787392,1032156472,1032170360,13888
1360610793,1032175996,20,14009,700.45,1360610779364,1360610787428,1032162360,1032170424,8064
1360610793,3965455872,22,21472,976,1360610772023,1360610787319,3965434895,3965450191,15296
1360610793,3965455892,4,673,168.25,1360610779365,1360610787301,3965442257,3965450193,7936
1360610801,1032183868,7,679,97,1360610794721,1360610794849,1032177589,1032177717,128
1360610801,1032183980,5,492,98.4,1360610796019,1360610796147,1032178999,1032179127,128
1360610809,1032191832,4,772,193,1360610802502,1360610802950,1032185334,1032185782,448
1360610809,1032191852,4,832,208,1360610806132,1360610806644,1032188984,1032189496,512
1360610809,1032191856,5,2974,594.8,1360610803312,1360610803376,1032186168,1032186232,64
1360610809,1032191856,3,602,200.6666667,1360610806638,1360610806766,1032189494,1032189622,128
1360610809,1032191860,3,421,140.3333333,1360610806829,1360610806893,1032189689,1032189753,64
1360610809,1032191860,5,2979,595.8,1360610803629,1360610803693,1032186489,1032186553,64
1360610809,1032191860,4,777,194.25,1360610806955,1360610807019,1032189815,1032189879,64
1360610809,1032191860,3,557,185.6666667,1360610807019,1360610807147,1032189879,1032190007,128
1360610809,1032191912,8,1860,232.5,1360610805816,1360610806520,1032188728,1032189432,704
1360610809,1032191912,4,440,110,1360610802424,1360610802488,1032185336,1032185400,64
1360610809,1032191940,5,536,107.2,1360610806492,1360610807644,1032189432,1032190584,1152
1360610809,1032191940,5,934,186.8,1360610806554,1360610806682,1032189494,1032189622,128
1360610809,1032191940,4,591,147.75,1360610806682,1360610806746,1032189622,1032189686,64
1360610809,1032191940,5,657,131.4,1360610806682,1360610806746,1032189622,1032189686,64
1360610809,1032191944,6,3058,509.6666667,1360610807061,1360610807317,1032190005,1032190261,256
1360610809,1032191948,8,2184,273,1360610804308,1360610807444,1032187256,1032190392,3136
1360610809,1032191948,5,698,139.6,1360610799249,1360610805713,1032182197,1032188661,6464
1360610809,1032191952,7,2347,335.2857143,1360610807313,1360610807505,1032190265,1032190457,192
1360610809,1032191956,5,804,160.8,1360610808201,1360610808649,1032191157,1032191605,448
1360610809,3965471876,5,1829,365.8,1360610806388,1360610806452,3965469264,3965469328,64
1360610809,3965471884,4,571,142.75,1360610808108,1360610808172,3965470992,3965471056,64
1360610809,3965471888,4,571,142.75,1360610808553,1360610808617,3965471441,3965471505,64
1360610809,3965471904,4,464,116,1360610807321,1360610807385,3965470225,3965470289,64
1360610809,3965471908,4,571,142.75,1360610808532,1360610808596,3965471440,3965471504,64
1360610809,3965471908,6,2942,490.3333333,1360610805586,1360610806354,3965468494,3965469262,768
1360610817,1032199888,6,1392,232,1360610804749,1360610813581,1032187637,1032196469,8832
1360610817,1032199900,7,1808,258.2857143,1360610805764,1360610813572,1032188664,1032196472,7808
1360610817,1032199932,17,9021,530.6470588,1360610802915,1360610811491,1032185847,1032194423,8576
1360610817,1032199944,4,576,144,1360610804312,1360610811480,1032187256,1032194424,7168
1360610817,3965479876,6,790,131.6666667,1360610802803,1360610813427,3965465679,3965476303,10624
1360610817,3965479876,5,524,104.8,1360610802994,1360610809650,3965465870,3965472526,6656
1360610817,3965479888,13,9182,706.3076923,1360610802153,1360610809577,3965465041,3965472465,7424
1360610825,1032207964,22,14137,642.5909091,1360610809156,1360610817668,1032192120,1032200632,8512
1360610825,1032207964,5,936,187.2,1360610809156,1360610819652,1032192120,1032202616,10496
1360610825,1032208004,6,1078,179.6666667,1360610806683,1360610819611,1032189687,1032202615,12928
1360610825,1032208008,7,2096,299.4285714,1360610804374,1360610819606,1032187382,1032202614,15232
1360610841,1032223880,11,8609,782.6363636,1360610833048,1360610840088,1032215928,1032222968,7040
1360610841,1032223884,15,11996,799.7333333,1360610833425,1360610840017,1032216309,1032222901,6592
1360610841,1032223884,17,17195,1011.470588,1360610833492,1360610834132,1032216376,1032217016,640
1360610841,1032223884,4,596,149,1360610837396,1360610837716,1032220280,1032220600,320
1360610841,1032223888,3,421,140.3333333,1360610834064,1360610834128,1032216952,1032217016,64
1360610841,1032223888,4,774,193.5,1360610837712,1360610837840,1032220600,1032220728,128
1360610841,1032223888,10,2263,226.3,1360610837712,1360610837968,1032220600,1032220856,256
1360610841,1032223888,4,1034,258.5,1360610837839,1360610838031,1032220727,1032220919,192
1360610841,1032223888,4,487,121.75,1360610837838,1360610838030,1032220726,1032220918,192
1360610841,1032223888,5,760,152,1360610837838,1360610838030,1032220726,1032220918,192
1360610841,1032223912,6,986,164.3333333,1360610838200,1360610839544,1032221112,1032222456,1344
1360610841,1032223916,5,931,186.2,1360610838452,1360610838708,1032221368,1032221624,256
1360610841,1032223916,6,1035,172.5,1360610838514,1360610838578,1032221430,1032221494,64
1360610841,1032223916,3,421,140.3333333,1360610838577,1360610838641,1032221493,1032221557,64
1360610841,1032223920,4,589,147.25,1360610838895,1360610839023,1032221815,1032221943,128
1360610841,1032223920,4,476,119,1360610838895,1360610839023,1032221815,1032221943,128
1360610841,1032223924,12,4021,335.0833333,1360610831722,1360610834346,1032214646,1032217270,2624
1360610841,1032223924,5,754,150.8,1360610839273,1360610839401,1032222197,1032222325,128
1360610841,1032223928,3,164,54.66666667,1360610839400,1360610839464,1032222328,1032222392,64
1360610841,1032223956,16,16486,1030.375,1360610833356,1360610834060,1032216312,1032217016,704
1360610841,1032223956,11,8849,804.4545455,1360610833356,1360610839948,1032216312,1032222904,6592
1360610841,1032223956,3,683,227.6666667,1360610833673,1360610833993,1032216629,1032216949,320
1360610841,1032223956,4,703,175.75,1360610833737,1360610834057,1032216693,1032217013,320
1360610841,1032223956,5,1150,230,1360610837513,1360610837769,1032220469,1032220725,256
1360610841,1032223960,7,3126,446.5714286,1360610837510,1360610837766,1032220470,1032220726,256
1360610841,1032223988,8,3080,385,1360610838249,1360610838377,1032221237,1032221365,128
1360610841,1032223992,6,3082,513.6666667,1360610838310,1360610838502,1032221302,1032221494,192
1360610841,1032223992,6,707,117.8333333,1360610838438,1360610838758,1032221430,1032221750,320
1360610841,1032223992,4,1103,275.75,1360610838373,1360610838437,1032221365,1032221429,64
1360610841,1032224000,4,224,56,1360610838877,1360610839773,1032221877,1032222773,896
1360610841,1032224000,3,788,262.6666667,1360610839070,1360610839326,1032222070,1032222326,256
1360610841,1032224004,5,1664,332.8,1360610839132,1360610839196,1032222136,1032222200,64
1360610841,1032224004,24,26142,1089.25,1360610839259,1360610839387,1032222263,1032222391,128
1360610841,1032224008,4,382,95.5,1360610839576,1360610839704,1032222584,1032222712,128
1360610841,3965503876,12,12100,1008.333333,1360610839030,1360610839158,3965501906,3965502034,128
1360610841,3965503884,10,3385,338.5,1360610835499,1360610839019,3965498383,3965501903,3520
1360610841,3965503896,9,5394,599.3333333,1360610835874,1360610838114,3965498770,3965501010,2240
1360610841,3965503900,7,2862,408.8571429,1360610832413,1360610834013,3965495313,3965496913,1600
1360610849,1032231904,10,3188,318.8,1360610835071,1360610846143,1032217975,1032229047,11072
1360610849,1032231904,3,172,57.33333333,1360610838591,1360610841727,1032221495,1032224631,3136
1360610849,1032231908,7,2343,334.7142857,1360610839034,1360610846138,1032221942,1032229046,7104
1360610849,1032231952,5,884,176.8,1360610837774,1360610844046,1032220726,1032226998,6272
1360610849,3965511868,5,1511,302.2,1360610833275,1360610846011,3965496143,3965508879,12736
1360610857,1032239932,3,138,46,1360610850083,1360610850083,1032233015,1032233015,0
1360610877,1032259516,19,8469,445.7368421,1360610849794,1360610851842,1032232310,1032234358,2048
1360610877,1032259672,9,3463,384.7777778,1360610850342,1360610850726,1032233014,1032233398,384
1360610881,1032264084,7,908,129.7142857,1360610871114,1360610873482,1032254198,1032256566,2368
1360610886,1032268772,1,46,46,1360610858242,1360610858242,1032241014,1032241014,0
1360610890,1032272676,6,1859,309.8333333,1360610864481,1360610865441,1032247157,1032248117,960
1360610890,1032272756,4,356,89,1360610875154,1360610882706,1032257910,1032265462,7552
1360610890,1032272796,41,50024,1220.097561,1360610873769,1360610882665,1032256565,1032265461,8896
1360610893,1032275664,10,4669,466.9,1360610865261,1360610870189,1032247925,1032252853,4928
1360610901,1032283624,16,3436,214.75,1360610876436,1360610882772,1032259060,1032265396,6336
1360610905,1032287700,1,52,52,1360610877256,1360610877256,1032259956,1032259956,0
1360610913,3965575876,12,12441,1036.75,1360610903988,1360610912372,3965566864,3965575248,8384
1360610913,3965575876,5,2251,450.2,1360610903988,1360610912372,3965566864,3965575248,8384
1360610913,3965575896,12,11512,959.3333333,1360610903968,1360610912352,3965566864,3965575248,8384
1360610913,1032296092,7,932,133.1428571,1360610900099,1360610908035,1032283191,1032291127,7936
1360610921,1032304012,6,938,156.3333333,1360610919762,1360610920338,1032302774,1032303350,576
1360610921,3965583900,16,12020,751.25,1360610914910,1360610919710,3965577810,3965582610,4800
1360610921,3965583900,5,541,108.2,1360610915165,1360610915421,3965578065,3965578321,256
1360610921,1032304096,6,2368,394.6666667,1360610920063,1360610920447,1032303159,1032303543,384
1360610929,1032311964,22,12830,583.1818182,1360610922178,1360610924738,1032305142,1032307702,2560
1360610929,1032311964,16,9160,572.5,1360610915199,1360610927103,1032298163,1032310067,11904
1360610929,1032312000,3,421,140.3333333,1360610927070,1360610927454,1032310070,1032310454,384
1360610929,3965591876,7,5478,782.5714286,1360610914931,1360610922483,3965577807,3965585359,7552
1360610929,1032312008,10,2824,282.4,1360610920276,1360610925524,1032303284,1032308532,5248
1360610929,3965591880,5,528,105.6,1360610927026,1360610927410,3965589906,3965590290,384
1360610929,3965591900,7,5499,785.5714286,1360610914909,1360610922589,3965577809,3965585489,7680
1360610929,3965591904,5,1748,349.6,1360610927386,1360610927514,3965590290,3965590418,128
1360610929,3965591908,188,251252,1336.446809,1360610900757,1360610925333,3965563665,3965588241,24576
1360610929,1032312036,5,2026,405.2,1360610921912,1360610922488,1032304948,1032305524,576
1360610929,1032312036,12,6893,574.4166667,1360610915192,1360610922552,1032298228,1032305588,7360
1360610929,1032312072,4,832,208,1360610922900,1360610923028,1032305972,1032306100,128
1360610929,1032312076,5,655,131,1360610926865,1360610927377,1032309941,1032310453,512
1360610929,1032312076,5,657,131.4,1360610926992,1360610927376,1032310068,1032310452,384
1360610937,1032319976,3,172,57.33333333,1360610928502,1360610932086,1032311478,1032315062,3584
1360610937,1032319980,6,2275,379.1666667,1360610924723,1360610931891,1032307703,1032314871,7168
1360610937,1032319980,20,10879,543.95,1360610929074,1360610931698,1032312054,1032314678,2624
1360610937,1032319992,7,1038,148.2857143,1360610925861,1360610936229,1032308853,1032319221,10368
1360610937,3965599876,22,16747,761.2272727,1360610915446,1360610934966,3965578322,3965597842,19520
1360610937,3965599896,29,18764,647.0344828,1360610915491,1360610928931,3965578387,3965591827,13440
1360610937,3965599896,3,164,54.66666667,1360610931554,1360610932002,3965594450,3965594898,448
1360610937,1032320016,5,1690,338,1360610922639,1360610929487,1032305655,1032312503,6848
1360610937,1032320016,7,1812,258.8571429,1360610922894,1360610931790,1032305910,1032314806,8896
1360610937,1032320020,2,112,56,1360610931592,1360610931976,1032314612,1032314996,384
1360610937,1032320028,7,1146,163.7142857,1360610927811,1360610935939,1032310839,1032318967,8128
1360610937,1032320060,4,476,119,1360610928930,1360610929250,1032311990,1032312310,320
1360610937,1032320072,24,26695,1112.291667,1360610922452,1360610931796,1032305524,1032314868,9344
1360610937,1032320116,22,26750,1215.909091,1360610928171,1360610928875,1032311287,1032311991,704
1360610942,3965605088,88,101042,1148.204545,1360610914977,1360610931617,3965578065,3965594705,16640
1360610945,1032327712,16,8363,522.6875,1360610918907,1360610932283,1032301619,1032314995,13376
1360610945,1032328044,2,104,52,1360610938353,1360610942577,1032321397,1032325621,4224
1360610945,1032328116,5,260,52,1360610937064,1360610944232,1032320180,1032327348,7168
1360610945,1032328120,9,652,72.44444444,1360610933283,1360610944611,1032316403,1032327731,11328
1360610953,1032335912,13,9848,757.5384615,1360610927926,1360610931958,1032310838,1032314870,4032
1360610957,1032339744,61,64449,1056.540984,1360610932123,1360610954459,1032314867,1032337203,22336
1360610961,1032344036,2,98,49,1360610945146,1360610953914,1032328182,1032336950,8768
1360610961,1032344044,3,162,54,1360610945775,1360610957615,1032328819,1032340659,11840
1360610973,1032355928,1,46,46,1360610948259,1360610948259,1032331187,1032331187,0
1360610977,1032360064,6,447,74.5,1360610970269,1360610974173,1032353333,1032357237,3904
1360610977,1032360180,4,1498,374.5,1360610960103,1360610972775,1032343283,1032355955,12672
1360610993,1032376224,6,276,46,1360610985211,1360610992763,1032368435,1032375987,7552
1360610993,1032376236,2,158,79,1360610978162,1360610986482,1032361398,1032369718,8320
1360610993,1032376236,5,230,46,1360610986799,1360610991279,1032370035,1032374515,4480
1360611001,1032383888,8,416,52,1360610973133,1360610982413,1032356021,1032365301,9280
1360611005,1032388024,1,700,700,1360610980291,1360610980291,1032363315,1032363315,0
1360611009,1032392248,2,92,46,1360610996002,1360611005538,1032379250,1032388786,9536
1360611017,1032400180,2,92,46,1360611000617,1360611010665,1032383797,1032393845,10048
1360611021,1032403956,8,416,52,1360610995080,1360611004552,1032378036,1032387508,9472
1360611025,1032408132,2,192,96,1360611021145,1360611021145,1032404277,1032404277,0
1360611025,1032408224,5,1476,295.2,1360611014778,1360611021562,1032398002,1032404786,6784
1360611029,1032411892,1,79,79,1360611003464,1360611003464,1032386356,1032386356,0
1360611033,1032415820,1,46,46,1360611007183,1360611007183,1032390003,1032390003,0
1360611033,3965695880,250,344904,1379.616,1360611015666,1360611032818,3965678546,3965695698,17152
1360611037,1032419816,1,46,46,1360611009749,1360611009749,1032392565,1032392565,0
1360611041,1032423868,1,46,46,1360611015904,1360611015904,1032398772,1032398772,0
1360611041,1032424152,4,703,175.75,1360611037122,1360611038018,1032420274,1032421170,896
1360611041,1032424204,7,994,142,1360611036559,1360611039887,1032419763,1032423091,3328
1360611041,1032424240,55,71983,1308.781818,1360611033962,1360611040746,1032417202,1032423986,6784
1360611041,1032424244,3,485,161.6666667,1360611037927,1360611039975,1032421171,1032423219,2048
1360611043,3965705384,42,51140,1217.619048,1360611016867,1360611042083,3965679251,3965704467,25216
1360611049,1032431900,23,20126,875.0434783,1360611023743,1360611046591,1032406643,1032429491,22848
1360611049,3965711876,4,464,116,1360611046326,1360611046838,3965709202,3965709714,512
1360611049,3965711876,8,705,88.125,1360611030904,1360611044344,3965693780,3965707220,13440
1360611049,3965711884,46,60708,1319.73913,1360611036718,1360611047790,3965699602,3965710674,11072
1360611049,3965711888,4,525,131.25,1360611046313,1360611046569,3965709201,3965709457,256
1360611049,1032432164,5,657,131.4,1360611045369,1360611046201,1032428533,1032429365,832
1360611049,1032432172,3,421,140.3333333,1360611046511,1360611047023,1032429683,1032430195,512
1360611049,1032432200,12,6169,514.0833333,1360611030868,1360611042452,1032414068,1032425652,11584
1360611049,1032432200,5,804,160.8,1360611047060,1360611047444,1032430260,1032430644,384
1360611049,1032432200,10,3910,391,1360611047060,1360611047316,1032430260,1032430516,256
1360611049,1032432204,19,19702,1036.947368,1360611036174,1360611047630,1032419378,1032430834,11456
1360611049,1032432204,7,1808,258.2857143,1360611036174,1360611044174,1032419378,1032427378,8000
1360611049,1032432244,5,643,128.6,1360611045288,1360611046056,1032428532,1032429300,768
1360611049,1032432248,2,116,58,1360611042403,1360611043939,1032425651,1032427187,1536
1360611049,1032432248,7,1539,219.8571429,1360611042403,1360611044195,1032425651,1032427443,1792
1360611049,1032432284,4,589,147.25,1360611046721,1360611046977,1032430005,1032430261,256
1360611049,1032432288,7,1796,256.5714286,1360611036092,1360611044092,1032419380,1032427380,8000
1360611050,3965713096,12,3020,251.6666667,1360611023387,1360611038427,3965686483,3965701523,15040
1360611050,3965713140,4,618,154.5,1360611023343,1360611024111,3965686483,3965687251,768
1360611053,1032435808,20,25100,1255,1360611025821,1360611026333,1032408629,1032409141,512
1360611053,1032435836,28,37166,1327.357143,1360611026240,1360611047744,1032409076,1032430580,21504
1360611057,3965719888,17,6477,381,1360611034155,1360611055147,3965697043,3965718035,20992
1360611057,3965719900,4,769,192.25,1360611049565,1360611049693,3965712465,3965712593,128
1360611057,1032440004,63,80002,1269.873016,1360611031190,1360611049878,1032414194,1032432882,18688
1360611057,1032440220,5,1226,245.2,1360611055038,1360611056382,1032438258,1032439602,1344
1360611057,1032440220,8,664,83,1360611051390,1360611054718,1032434610,1032437938,3328
1360611057,1032440224,6,1044,174,1360611051517,1360611051645,1032434741,1032434869,128
1360611057,1032440224,5,606,121.2,1360611055228,1360611055548,1032438452,1032438772,320
1360611057,1032440224,31,39328,1268.645161,1360611051770,1360611052090,1032434994,1032435314,320
1360611057,1032440224,4,697,174.25,1360611051962,1360611052090,1032435186,1032435314,128
1360611057,1032440228,3,1041,347,1360611052217,1360611052409,1032435445,1032435637,192
1360611057,1032440228,21,15445,735.4761905,1360611047544,1360611055736,1032430772,1032438964,8192
1360611057,1032440228,4,476,119,1360611044215,1360611051703,1032427443,1032434931,7488
1360611057,1032440228,4,652,163,1360611052343,1360611052407,1032435571,1032435635,64
1360611057,1032440252,7,2347,335.2857143,1360611040094,1360611049694,1032423346,1032432946,9600
1360611057,1032440260,6,987,164.5,1360611040791,1360611049559,1032424051,1032432819,8768
1360611057,1032440296,6,544,90.66666667,1360611051122,1360611051186,1032434418,1032434482,64
1360611057,1032440296,5,1408,281.6,1360611055026,1360611055154,1032438322,1032438450,128
1360611057,1032440300,5,824,164.8,1360611051504,1360611051568,1032434804,1032434868,64
1360611057,1032440304,5,560,112,1360611047211,1360611055851,1032430515,1032439155,8640
1360611058,1032440576,4,542,135.5,1360611057026,1360611057090,1032439602,1032439666,64
1360611058,3965721144,60,69585,1159.75,1360611030760,1360611057704,3965693904,3965720848,26944
1360611061,1032443972,1,79,79,1360611036662,1360611036662,1032419634,1032419634,0
1360611061,1032444060,16,3286,205.375,1360611035552,1360611047584,1032418612,1032430644,12032
1360611062,3965725112,1,46,46,1360611037704,1360611037704,3965700816,3965700816,0
1360611065,3965727892,25,30244,1209.76,1360611043431,1360611057959,3965706323,3965720851,14528
1360611065,3965727892,18,11218,623.2222222,1360611049383,1360611057959,3965712275,3965720851,8576
1360611065,3965727896,9,5108,567.5555556,1360611051940,1360611060516,3965714836,3965723412,8576
1360611066,1032448364,7,3134,447.7142857,1360611051992,1360611058648,1032434356,1032441012,6656
1360611066,1032448372,7,3126,446.5714286,1360611045070,1360611060558,1032427442,1032442930,15488
1360611066,1032448444,5,1096,219.2,1360611055878,1360611062214,1032438322,1032444658,6336
1360611069,1032451976,1,52,52,1360611040946,1360611040946,1032423922,1032423922,0
1360611073,1032456268,7,820,117.1428571,1360611066381,1360611068109,1032449649,1032451377,1728
1360611073,1032456312,5,331,66.2,1360611055971,1360611068067,1032439283,1032451379,12096
1360611081,1032463940,1,1426,1426,1360611056598,1360611056598,1032439538,1032439538,0
1360611090,1032472324,5,492,98.4,1360611087805,1360611088189,1032470129,1032470513,384
1360611097,1032480216,6,544,90.66666667,1360611092740,1360611092868,1032475956,1032476084,128
1360611105,1032488232,4,382,95.5,1360611092978,1360611099186,1032476210,1032482418,6208
1360611105,1032488304,4,772,193,1360611092713,1360611101417,1032476017,1032484721,8704
1360611113,3965775980,4,494,123.5,1360611102414,1360611109262,3965765394,3965772242,6848
1360611113,3965775980,6,4119,686.5,1360611102414,1360611109262,3965765394,3965772242,6848
1360611113,1032496220,3,156,52,1360611104895,1360611105599,1032488115,1032488819,704
1360611113,1032496224,2,104,52,1360611109626,1360611109882,1032492850,1032493106,256
1360611113,1032496304,5,1544,308.8,1360611101355,1360611109099,1032484659,1032492403,7744
1360611121,3965783992,9,1444,160.4444444,1360611114244,1360611114500,3965777236,3965777492,256
1360611121,3965784008,62,79208,1277.548387,1360611111794,1360611120306,3965774802,3965783314,8512
1360611121,3965784012,106,136879,1291.311321,1360611102189,1360611120301,3965765201,3965783313,18112
1360611121,3965784016,12,2279,189.9166667,1360611114219,1360611117163,3965777235,3965780179,2944
1360611121,1032504240,11,3484,316.7272727,1360611114217,1360611116073,1032497457,1032499313,1856
1360611122,1032504320,4,576,144,1360611115329,1360611115457,1032497649,1032497777,128
1360611122,1032504364,6,2118,353,1360611121111,1360611121367,1032503475,1032503731,256
1360611125,1032507984,1,52,52,1360611099241,1360611099241,1032482225,1032482225,0
1360611129,3965791996,7,1364,194.8571429,1360611114240,1360611122112,3965777236,3965785108,7872
1360611129,3965791996,17,19389,1140.529412,1360611114432,1360611125248,3965777428,3965788244,10816
1360611129,3965791996,16,15460,966.25,1360611114368,1360611125248,3965777364,3965788244,10880
1360611129,3965791996,162,222293,1372.179012,1360611102718,1360611122110,3965765714,3965785106,19392
1360611129,1032512252,5,1578,315.6,1360611122015,1360611122143,1032505267,1032505395,128
1360611129,1032512292,4,576,144,1360611120184,1360611127928,1032503476,1032511220,7744
1360611130,1032512328,52,39541,760.4038462,1360611123899,1360611129339,1032506227,1032511667,5440
1360611130,1032512360,6,2298,383,1360611125211,1360611127451,1032507571,1032509811,2240
1360611137,3965800008,8,833,104.125,1360611124145,1360611131569,3965787153,3965794577,7424
1360611137,3965800008,9,1536,170.6666667,1360611124209,1360611130097,3965787217,3965793105,5888
1360611137,3965800020,92,116910,1270.76087,1360611111782,1360611129510,3965774802,3965792530,17728
1360611137,3965800024,4,417,104.25,1360611133411,1360611133923,3965796435,3965796947,512
1360611137,3965800024,5,1809,361.8,1360611129954,1360611130146,3965792978,3965793170,192
1360611137,1032520236,6,2283,380.5,1360611128749,1360611129453,1032511985,1032512689,704
1360611137,1032520244,5,643,128.6,1360611129703,1360611129831,1032512947,1032513075,128
1360611137,1032520244,4,476,119,1360611129703,1360611129831,1032512947,1032513075,128
1360611137,1032520244,5,657,131.4,1360611129766,1360611129894,1032513010,1032513138,128
1360611137,1032520280,8,3270,408.75,1360611128065,1360611134593,1032511345,1032517873,6528
1360611137,1032520284,7,2119,302.7142857,1360611120189,1360611129405,1032503473,1032512689,9216
1360611137,1032520284,7,914,130.5714286,1360611128317,1360611135997,1032511601,1032519281,7680
1360611137,1032520284,6,643,107.1666667,1360611120572,1360611129404,1032503856,1032512688,8832
1360611138,1032520324,22,26750,1215.909091,1360611130367,1360611130687,1032512691,1032513011,320
1360611138,1032520328,3,421,140.3333333,1360611130744,1360611130808,1032513072,1032513136,64
1360611138,1032520328,17,9984,587.2941176,1360611115066,1360611134842,1032497394,1032517170,19776
1360611143,3965805324,8,7435,929.375,1360611117855,1360611131295,3965780179,3965793619,13440
1360611145,3965807996,4,771,192.75,1360611131454,1360611139262,3965794450,3965802258,7808
1360611145,3965807996,7,2173,310.4285714,1360611129533,1360611137597,3965792529,3965800593,8064
1360611146,1032528516,5,934,186.8,1360611130175,1360611138239,1032512691,1032520755,8064
1360611146,1032528552,5,574,114.8,1360611132442,1360611142042,1032514994,1032524594,9600
1360611146,1032528588,4,589,147.25,1360611130484,1360611138164,1032513072,1032520752,7680
1360611146,1032528628,6,920,153.3333333,1360611132428,1360611141964,1032515056,1032524592,9536
1360611149,1032532240,3,2892,964,1360611121323,1360611122987,1032504563,1032506227,1664
1360611153,3965815996,123,168038,1366.162602,1360611130495,1360611147327,3965793491,3965810323,16832
1360611153,3965816000,4,1089,272.25,1360611148025,1360611148089,3965811025,3965811089,64
1360611153,3965816000,4,1520,380,1360611147897,1360611147961,3965810897,3965810961,64
1360611153,3965816008,6,4020,670,1360611139249,1360611147313,3965802257,3965810321,8064
1360611153,3965816020,5,2524,504.8,1360611147750,1360611147814,3965810770,3965810834,64
1360611153,3965816020,4,1504,376,1360611147878,1360611147942,3965810898,3965810962,64
1360611153,3965816020,4,1089,272.25,1360611147941,1360611148069,3965810961,3965811089,128
1360611154,1032536544,7,4746,678,1360611146403,1360611151779,1032528947,1032534323,5376
1360611154,1032536544,4,1177,294.25,1360611146403,1360611147107,1032528947,1032529651,704
1360611154,1032536544,6,782,130.3333333,1360611146593,1360611147681,1032529137,1032530225,1088
1360611154,1032536620,5,876,175.2,1360611149591,1360611149911,1032532211,1032532531,320
1360611154,1032536668,8,2305,288.125,1360611148518,1360611149478,1032531186,1032532146,960
1360611154,1032536672,6,1291,215.1666667,1360611148515,1360611149027,1032531187,1032531699,512
1360611161,3965823996,6,2396,399.3333333,1360611145599,1360611153407,3965808595,3965816403,7808
1360611162,1032544388,1,52,52,1360611134076,1360611134076,1032516464,1032516464,0
1360611162,1032544512,15,7583,505.5333333,1360611146432,1360611154112,1032528944,1032536624,7680
1360611162,1032544520,3,675,225,1360611147130,1360611154106,1032529650,1032536626,6976
1360611162,1032544548,14,14058,1004.142857,1360611148063,1360611158111,1032530611,1032540659,10048
1360611162,1032544588,5,1154,230.8,1360611146358,1360611153974,1032528946,1032536562,7616
1360611162,1032544600,8,5989,748.625,1360611147752,1360611156008,1032530352,1032538608,8256
1360611162,1032544604,4,530,132.5,1360611148134,1360611156006,1032530738,1032538610,7872
1360611165,1032548236,1,46,46,1360611137837,1360611137837,1032521073,1032521073,0
1360611177,3965840000,22,13509,614.0454545,1360611169401,1360611174137,3965832401,3965837137,4736
1360611177,3965840008,12,12100,1008.333333,1360611176180,1360611176308,3965839188,3965839316,128
1360611177,3965840008,6,2473,412.1666667,1360611173426,1360611173938,3965836434,3965836946,512
1360611178,1032560716,7,2195,313.5714286,1360611174455,1360611174519,1032557171,1032557235,64
1360611178,1032560716,5,684,136.8,1360611174644,1360611175924,1032557360,1032558640,1280
1360611178,1032560720,4,877,219.25,1360611174770,1360611174898,1032557490,1032557618,128
1360611178,1032560720,2,92,46,1360611172143,1360611172911,1032554863,1032555631,768
1360611178,1032560756,27,26286,973.5555556,1360611176524,1360611176972,1032559280,1032559728,448
1360611178,1032560760,18,19173,1065.166667,1360611176778,1360611177098,1032559538,1032559858,320
1360611178,1032560760,4,490,122.5,1360611176905,1360611177097,1032559665,1032559857,192
1360611178,1032560760,5,563,112.6,1360611177097,1360611177161,1032559857,1032559921,64
1360611178,1032560792,4,576,144,1360611174378,1360611174442,1032557170,1032557234,64
1360611178,1032560796,5,563,112.6,1360611174563,1360611174627,1032557359,1032557423,64
1360611178,1032560796,8,3128,391,1360611174695,1360611176487,1032557491,1032559283,1792
1360611178,1032560828,8,2143,267.875,1360611173191,1360611176583,1032556019,1032559411,3392
1360611178,1032560828,4,1036,259,1360611176452,1360611176644,1032559280,1032559472,192
1360611178,1032560832,5,1664,332.8,1360611176576,1360611176640,1032559408,1032559472,64
1360611178,1032560832,4,909,227.25,1360611176643,1360611176835,1032559475,1032559667,192
1360611178,1032560832,8,1860,232.5,1360611176769,1360611177025,1032559601,1032559857,256
1360611178,1032560832,8,1860,232.5,1360611176833,1360611177153,1032559665,1032559985,320
1360611178,1032560832,5,563,112.6,1360611177088,1360611177280,1032559920,1032560112,192
1360611182,1032564384,1,46,46,1360611154175,1360611154175,1032536559,1032536559,0
1360611185,3965848000,5,1826,365.2,1360611178428,1360611178620,3965841428,3965841620,192
1360611185,3965848000,5,2741,548.2,1360611178556,1360611178684,3965841556,3965841684,128
1360611185,3965848024,5,499,99.8,1360611169572,1360611177764,3965832596,3965840788,8192
1360611186,1032568440,14,4723,337.3571429,1360611161543,1360611163911,1032543983,1032546351,2368
1360611186,1032568612,8,1378,172.25,1360611174557,1360611183965,1032557169,1032566577,9408
1360611186,1032568612,5,935,187,1360611179036,1360611179164,1032561648,1032561776,128
1360611186,1032568616,6,1777,296.1666667,1360611179290,1360611179546,1032561906,1032562162,256
1360611186,1032568616,5,563,112.6,1360611179354,1360611179546,1032561970,1032562162,192
1360611186,1032568616,8,1615,201.875,1360611179545,1360611184345,1032562161,1032566961,4800
1360611186,1032568644,6,1235,205.8333333,1360611175163,1360611184315,1032557807,1032566959,9152
1360611186,1032568652,12,5956,496.3333333,1360611173237,1360611184117,1032555889,1032566769,10880
1360611186,1032568652,11,3728,338.9090909,1360611173236,1360611185588,1032555888,1032568240,12352
1360611186,1032568688,4,519,129.75,1360611178831,1360611179023,1032561519,1032561711,192
1360611186,1032568692,5,2164,432.8,1360611179022,1360611179086,1032561714,1032561778,64
1360611186,1032568692,3,833,277.6666667,1360611179086,1360611179150,1032561778,1032561842,64
1360611186,1032568692,3,421,140.3333333,1360611179086,1360611179150,1032561778,1032561842,64
1360611186,1032568692,4,476,119,1360611179086,1360611179214,1032561778,1032561906,128
1360611186,1032568692,5,513,102.6,1360611179150,1360611179278,1032561842,1032561970,128
1360611186,1032568692,4,629,157.25,1360611179213,1360611179405,1032561905,1032562097,192
1360611186,1032568692,7,2064,294.8571429,1360611179213,1360611179533,1032561905,1032562225,320
1360611186,1032568692,10,759,75.9,1360611179404,1360611184844,1032562096,1032567536,5440
1360611186,1032568728,9,1719,191,1360611173032,1360611182952,1032555760,1032565680,9920
1360611194,1032576628,6,732,122,1360611178893,1360611189389,1032561521,1032572017,10496
1360611194,1032576632,4,609,152.25,1360611187079,1360611190663,1032569711,1032573295,3584
1360611194,1032576632,10,939,93.9,1360611179528,1360611190472,1032562160,1032573104,10944
1360611194,1032576712,2,116,58,1360611187063,1360611190711,1032569775,1032573423,3648
1360611195,3965857336,16,3716,232.25,1360611170260,1360611190164,3965832596,3965852500,19904
1360611195,3965857392,21,4716,224.5714286,1360611170204,1360611193628,3965832596,3965856020,23424
1360611201,3965864020,8,989,123.625,1360611190567,1360611200039,3965853587,3965863059,9472
1360611201,3965864024,8,1497,187.125,1360611192097,1360611196065,3965855121,3965859089,3968
1360611201,3965864032,3,172,57.33333333,1360611195037,1360611198109,3965858069,3965861141,3072
1360611201,3965864060,5,1809,361.8,1360611191873,1360611199745,3965854933,3965862805,7872
1360611202,1032584596,4,589,147.25,1360611190700,1360611198700,1032573296,1032581296,8000
1360611202,1032584628,2,104,52,1360611188302,1360611196494,1032570930,1032579122,8192
1360611202,1032584668,3,150,50,1360611186406,1360611198886,1032569074,1032581554,12480
1360611202,1032584672,4,232,58,1360611190625,1360611199969,1032573297,1032582641,9344
1360611206,1032588320,12,8688,724,1360611179840,1360611202752,1032562160,1032585072,22912
1360611209,3965872020,42,52140,1241.428571,1360611203368,1360611203880,3965866388,3965866900,512
1360611209,3965872020,19,6277,330.3684211,1360611199719,1360611207655,3965862739,3965870675,7936
1360611209,3965872020,19,10588,557.2631579,1360611196198,1360611207718,3965859218,3965870738,11520
1360611209,3965872024,28,34257,1223.464286,1360611206114,1360611206818,3965869138,3965869842,704
1360611209,3965872028,6,1869,311.5,1360611202846,1360611205278,3965865874,3965868306,2432
1360611209,3965872028,7,937,133.8571429,1360611202845,1360611204829,3965865873,3965867857,1984
1360611209,3965872028,6,2570,428.3333333,1360611199265,1360611201377,3965862293,3965864405,2112
1360611209,3965872044,6,800,133.3333333,1360611196433,1360611205713,3965859477,3965868757,9280
1360611209,3965872044,6,1879,313.1666667,1360611201872,1360611202384,3965864916,3965865428,512
1360611209,3965872044,5,1866,373.2,1360611204624,1360611204752,3965867668,3965867796,128
1360611209,3965872044,13,12152,934.7692308,1360611201999,1360611203151,3965865043,3965866195,1152
1360611209,3965872044,30,38092,1269.733333,1360611205263,1360611205455,3965868307,3965868499,192
1360611210,1032592616,3,162,54,1360611185754,1360611206938,1032568370,1032589554,21184
1360611210,1032592616,6,3293,548.8333333,1360611201561,1360611202009,1032584177,1032584625,448
1360611210,1032592616,3,162,54,1360611185880,1360611204504,1032568496,1032587120,18624
1360611210,1032592616,8,1872,234,1360611201943,1360611205271,1032584559,1032587887,3328
1360611210,1032592616,4,510,127.5,1360611205847,1360611206039,1032588463,1032588655,192
1360611210,1032592620,8,1860,232.5,1360611202006,1360611202198,1032584626,1032584818,192
1360611210,1032592620,4,490,122.5,1360611202070,1360611202262,1032584690,1032584882,192
1360611210,1032592620,4,510,127.5,1360611206036,1360611206164,1032588656,1032588784,128
1360611210,1032592620,6,623,103.8333333,1360611206163,1360611207507,1032588783,1032590127,1344
1360611210,1032592624,5,935,187,1360611202387,1360611202579,1032585011,1032585203,192
1360611210,1032592624,5,2846,569.2,1360611202640,1360611202832,1032585264,1032585456,192
1360611210,1032592624,4,931,232.75,1360611202831,1360611203087,1032585455,1032585711,256
1360611210,1032592624,5,513,102.6,1360611206671,1360611206927,1032589295,1032589551,256
1360611210,1032592624,4,476,119,1360611202895,1360611203023,1032585519,1032585647,128
1360611210,1032592628,4,928,232,1360611198799,1360611206287,1032581427,1032588915,7488
1360611210,1032592628,4,519,129.75,1360611202958,1360611203086,1032585586,1032585714,128
1360611210,1032592628,4,591,147.75,1360611203085,1360611203149,1032585713,1032585777,64
1360611210,1032592628,4,589,147.25,1360611203148,1360611203276,1032585776,1032585904,128
1360611210,1032592652,5,909,181.8,1360611207477,1360611207733,1032590129,1032590385,256
1360611210,1032592664,7,4408,629.7142857,1360611205352,1360611205800,1032588016,1032588464,448
1360611210,1032592664,5,513,102.6,1360611205351,1360611205479,1032588015,1032588143,128
1360611210,1032592668,5,1121,224.2,1360611200678,1360611201830,1032583346,1032584498,1152
1360611210,1032592668,6,820,136.6666667,1360611200614,1360611202022,1032583282,1032584690,1408
1360611210,1032592668,5,563,112.6,1360611208869,1360611208997,1032591537,1032591665,128
1360611210,1032592668,5,563,112.6,1360611208996,1360611209124,1032591664,1032591792,128
1360611210,1032592668,4,633,158.25,1360611208996,1360611209188,1032591664,1032591856,192
1360611210,1032592668,5,1082,216.4,1360611201444,1360611208420,1032584112,1032591088,6976
1360611210,1032592696,4,580,145,1360611205515,1360611205771,1032588211,1032588467,256
1360611210,1032592696,12,3338,278.1666667,1360611197578,1360611208202,1032580274,1032590898,10624
1360611210,1032592700,5,563,112.6,1360611205957,1360611206149,1032588657,1032588849,192
1360611210,1032592704,7,2080,297.1428571,1360611206402,1360611206658,1032589106,1032589362,256
1360611210,1032592704,4,411,102.75,1360611206400,1360611206656,1032589104,1032589360,256
1360611210,1032592704,5,1664,332.8,1360611202559,1360611202687,1032585263,1032585391,128
1360611210,1032592708,4,1103,275.75,1360611202685,1360611202877,1032585393,1032585585,192
1360611210,1032592708,3,833,277.6666667,1360611206843,1360611207355,1032589551,1032590063,512
1360611210,1032592712,7,3224,460.5714286,1360611203002,1360611203642,1032585714,1032586354,640
1360611210,1032592712,5,657,131.4,1360611203002,1360611203066,1032585714,1032585778,64
1360611210,1032592712,3,421,140.3333333,1360611203066,1360611203130,1032585778,1032585842,64
1360611210,1032592712,5,754,150.8,1360611203193,1360611203385,1032585905,1032586097,192
1360611210,1032592712,7,2351,335.8571429,1360611203193,1360611203321,1032585905,1032586033,128
1360611210,1032592716,4,629,157.25,1360611207350,1360611207542,1032590066,1032590258,192
1360611210,1032592740,6,1220,203.3333333,1360611207964,1360611208860,1032590704,1032591600,896
1360611210,1032592748,5,657,131.4,1360611205078,1360611205270,1032587826,1032588018,192
1360611210,1032592748,4,542,135.5,1360611205205,1360611205333,1032587953,1032588081,128
1360611210,1032592748,3,833,277.6666667,1360611205269,1360611205397,1032588017,1032588145,128
1360611210,1032592748,4,652,163,1360611209171,1360611209363,1032591919,1032592111,192
1360611217,3965880020,13,2199,169.1538462,1360611196453,1360611212581,3965859473,3965875601,16128
1360611217,3965880028,6,637,106.1666667,1360611207646,1360611216094,3965870674,3965879122,8448
1360611217,1032600308,1,46,46,1360611190437,1360611190437,1032573745,1032573745,0
1360611218,1032600632,6,910,151.6666667,1360611210631,1360611211335,1032593263,1032593967,704
1360611218,1032600672,5,866,173.2,1360611207520,1360611216608,1032590192,1032599280,9088
1360611218,1032600684,5,563,112.6,1360611216661,1360611216725,1032599345,1032599409,64
1360611218,1032600684,4,787,196.75,1360611216980,1360611217108,1032599664,1032599792,128
1360611218,1032600684,4,793,198.25,1360611217107,1360611217299,1032599791,1032599983,192
1360611218,1032600712,4,1776,444,1360611205815,1360611214263,1032588527,1032596975,8448
1360611218,1032600720,20,21714,1085.7,1360611206129,1360611214193,1032588849,1032596913,8064
1360611218,1032600720,4,604,151,1360611202352,1360611210544,1032585072,1032593264,8192
1360611218,1032600756,9,2167,240.7777778,1360611207374,1360611214158,1032590130,1032596914,6784
1360611218,1032600768,9,826,91.77777778,1360611208704,1360611216512,1032591472,1032599280,7808
1360611218,1032600772,4,787,196.75,1360611216894,1360611217022,1032599666,1032599794,128
1360611222,1032604404,1,46,46,1360611195118,1360611195118,1032577522,1032577522,0
1360611223,3965885408,1,52,52,1360611196682,1360611196682,3965859090,3965859090,0
1360611225,3965888044,93,121451,1305.924731,1360611216078,1360611219726,3965879122,3965882770,3648
1360611226,1032608748,4,232,58,1360611209044,1360611218324,1032591792,1032601072,9280
1360611233,3965896016,5,1852,370.4,1360611216873,1360611226025,3965879889,3965889041,9152
1360611233,1032616312,4,256,64,1360611204897,1360611225889,1032588209,1032609201,20992
1360611234,1032616656,4,232,58,1360611226608,1360611230000,1032609264,1032612656,3392
1360611238,1032620420,1,46,46,1360611213340,1360611213340,1032595760,1032595760,0
1360611238,1032620464,1,46,46,1360611210865,1360611210865,1032593329,1032593329,0
1360611242,1032624748,7,4792,684.5714286,1360611239252,1360611241492,1032622000,1032624240,2240
1360611249,3965912044,6,3716,619.3333333,1360611245200,1360611246480,3965908244,3965909524,1280
1360611249,3965912044,9,3457,384.1111111,1360611246094,1360611246926,3965909138,3965909970,832
1360611250,1032632636,15,17108,1140.533333,1360611238596,1360611246340,1032621232,1032628976,7744
1360611250,1032632644,3,562,187.3333333,1360611246974,1360611247102,1032629618,1032629746,128
1360611250,1032632644,6,3169,528.1666667,1360611247037,1360611247421,1032629681,1032630065,384
1360611250,1032632644,5,1941,388.2,1360611247164,1360611247356,1032629808,1032630000,192
1360611250,1032632648,8,3192,399,1360611247353,1360611248185,1032630001,1032630833,832
1360611250,1032632668,8,1864,233,1360611247652,1360611247972,1032630320,1032630640,320
1360611250,1032632672,4,490,122.5,1360611247969,1360611248481,1032630641,1032631153,512
1360611250,1032632712,5,874,174.8,1360611243319,1360611243959,1032626031,1032626671,640
1360611250,1032632716,2,92,46,1360611247093,1360611247093,1032629809,1032629809,0
1360611250,1032632716,8,1887,235.875,1360611247219,1360611247859,1032629935,1032630575,640
1360611250,1032632716,3,168,56,1360611244019,1360611244339,1032626735,1032627055,320
1360611250,1032632720,2,112,56,1360611244017,1360611244337,1032626737,1032627057,320
1360611250,1032632720,3,168,56,1360611244017,1360611244337,1032626737,1032627057,320
1360611250,1032632720,4,1467,366.75,1360611236721,1360611244209,1032619441,1032626929,7488
1360611250,1032632720,8,1864,233,1360611247600,1360611248176,1032630320,1032630896,576
1360611250,1032632752,5,2863,572.6,1360611248145,1360611248529,1032630897,1032631281,384
1360611250,1032632752,6,1026,171,1360611245007,1360611246223,1032627759,1032628975,1216
1360611257,3965920036,29,35672,1230.068966,1360611250903,1360611251479,3965913939,3965914515,576
1360611257,3965920036,9,1896,210.6666667,1360611246870,1360611250070,3965909906,3965913106,3200
1360611257,3965920040,15,15480,1032,1360611247826,1360611250002,3965910866,3965913042,2176
1360611257,3965920040,6,832,138.6666667,1360611244562,1360611253970,3965907602,3965917010,9408
1360611257,3965920044,5,1891,378.2,1360611249809,1360611250065,3965912853,3965913109,256
1360611257,3965920048,53,68211,1287,1360611244042,1360611250762,3965907090,3965913810,6720
1360611257,3965920064,4,472,118,1360611244540,1360611251836,3965907604,3965914900,7296
1360611257,3965920064,4,472,118,1360611244540,1360611251836,3965907604,3965914900,7296
1360611257,3965920064,212,282415,1332.146226,1360611220666,1360611251834,3965883730,3965914898,31168
1360611258,1032640656,5,2164,432.8,1360611251310,1360611251374,1032633966,1032634030,64
1360611258,1032640656,6,1747,291.1666667,1360611247025,1360611252081,1032629681,1032634737,5056
1360611258,1032640656,23,8380,364.3478261,1360611235632,1360611255408,1032618288,1032638064,19776
1360611258,1032640660,6,902,150.3333333,1360611247214,1360611254702,1032629874,1032637362,7488
1360611258,1032640684,3,833,277.6666667,1360611253011,1360611253203,1032635695,1032635887,192
1360611258,1032640724,4,519,129.75,1360611250476,1360611250604,1032633200,1032633328,128
1360611258,1032640724,8,2411,301.375,1360611250603,1360611251371,1032633327,1032634095,768
1360611258,1032640724,5,657,131.4,1360611250603,1360611250923,1032633327,1032633647,320
1360611258,1032640728,5,563,112.6,1360611251048,1360611251240,1032633776,1032633968,192
1360611258,1032640728,7,970,138.5714286,1360611251303,1360611253287,1032634031,1032636015,1984
1360611258,1032640732,5,513,102.6,1360611251429,1360611251493,1032634161,1032634225,64
1360611258,1032640764,6,725,120.8333333,1360611253251,1360611257155,1032636015,1032639919,3904
1360611258,1032640768,7,2517,359.5714286,1360611248320,1360611256832,1032631088,1032639600,8512
1360611265,3965928036,7,2240,320,1360611251545,1360611259993,3965914581,3965923029,8448
1360611265,3965928036,5,1809,361.8,1360611259992,1360611260184,3965923028,3965923220,192
1360611265,3965928044,4,571,142.75,1360611252174,1360611259982,3965915218,3965923026,7808
1360611266,1032648664,7,2092,298.8571429,1360611250664,1360611261160,1032633328,1032643824,10496
1360611266,1032648700,4,898,224.5,1360611260805,1360611260997,1032643505,1032643697,192
1360611266,1032648700,5,563,112.6,1360611260868,1360611261124,1032643568,1032643824,256
1360611266,1032648700,6,609,101.5,1360611260739,1360611264963,1032643439,1032647663,4224
1360611266,1032648704,6,711,118.5,1360611253185,1360611262273,1032635889,1032644977,9088
1360611266,1032648704,5,563,112.6,1360611261248,1360611262272,1032643952,1032644976,1024
1360611266,1032648748,6,999,166.5,1360611251923,1360611262291,1032634671,1032645039,10368
1360611266,1032648772,4,589,147.25,1360611260540,1360611260732,1032643312,1032643504,192
1360611266,1032648772,3,421,140.3333333,1360611260540,1360611260668,1032643312,1032643440,128
1360611266,1032648776,6,609,101.5,1360611261049,1360611265593,1032643825,1032648369,4544
1360611273,3965936036,52,66174,1272.576923,1360611255254,1360611268118,3965918290,3965931154,12864
1360611273,3965936040,4,464,116,1360611260115,1360611267987,3965923155,3965931027,7872
1360611274,1032656656,2,98,49,1360611258734,1360611268654,1032641390,1032651310,9920
1360611274,1032656656,5,536,107.2,1360611258734,1360611268654,1032641390,1032651310,9920
1360611274,1032656696,5,1178,235.6,1360611260745,1360611268617,1032643441,1032651313,7872
1360611274,1032656704,25,29666,1186.64,1360611257217,1360611268609,1032639921,1032651313,11392
1360611274,1032656724,2,104,52,1360611266090,1360611266666,1032648814,1032649390,576
1360611274,1032656728,4,510,127.5,1360611262184,1360611270760,1032644912,1032653488,8576
1360611274,1032656732,5,370,74,1360611258660,1360611266468,1032641392,1032649200,7808
1360611274,1032656740,5,563,112.6,1360611267678,1360611267998,1032650418,1032650738,320
1360611279,3965941740,93,125436,1348.774194,1360611254272,1360611276288,3965917012,3965939028,22016
1360611282,1032664640,5,840,168,1360611274303,1360611274495,1032656943,1032657135,192
1360611282,1032664640,8,2798,349.75,1360611274494,1360611280766,1032657134,1032663406,6272
1360611282,1032664692,4,794,198.5,1360611274253,1360611274445,1032656945,1032657137,192
1360611282,1032664692,5,686,137.2,1360611274189,1360611280525,1032656881,1032663217,6336
1360611289,3965952040,20,15698,784.9,1360611273428,1360611288020,3965936468,3965951060,14592
1360611289,3965952040,31,34055,1098.548387,1360611287828,1360611288596,3965950868,3965951636,768
1360611289,3965952044,22,23820,1082.727273,1360611286286,1360611287438,3965949330,3965950482,1152
1360611289,3965952048,8,4548,568.5,1360611282573,1360611284813,3965945621,3965947861,2240
1360611289,3965952064,6,3253,542.1666667,1360611285883,1360611286971,3965948947,3965950035,1088
1360611289,3965952064,12,12100,1008.333333,1360611285690,1360611285754,3965948754,3965948818,64
1360611290,1032672652,8,1864,233,1360611285747,1360611285939,1032668399,1032668591,192
1360611290,1032672656,4,490,122.5,1360611285936,1360611286128,1032668592,1032668784,192
1360611290,1032672656,6,3778,629.6666667,1360611286126,1360611286254,1032668782,1032668910,128
1360611290,1032672660,8,6757,844.625,1360611286316,1360611286444,1032668976,1032669104,128
1360611290,1032672664,10,9635,963.5,1360611286504,1360611286632,1032669168,1032669296,128
1360611290,1032672664,4,476,119,1360611286695,1360611286823,1032669359,1032669487,128
1360611290,1032672696,7,4746,678,1360611284360,1360611284616,1032667056,1032667312,256
1360611290,1032672696,3,986,328.6666667,1360611284423,1360611284679,1032667119,1032667375,256
1360611290,1032672696,5,935,187,1360611287750,1360611287878,1032670446,1032670574,128
1360611290,1032672700,10,4655,465.5,1360611284613,1360611287941,1032667313,1032670641,3328
1360611290,1032672700,5,657,131.4,1360611287939,1360611288131,1032670639,1032670831,192
1360611290,1032672704,7,2351,335.8571429,1360611288129,1360611288321,1032670833,1032671025,192
1360611290,1032672704,4,589,147.25,1360611288129,1360611288321,1032670833,1032671025,192
1360611290,1032672736,5,1664,332.8,1360611286303,1360611286431,1032669039,1032669167,128
1360611290,1032672740,2,131,65.5,1360611283418,1360611283418,1032666158,1032666158,0
1360611290,1032672776,6,2009,334.8333333,1360611284599,1360611285687,1032667375,1032668463,1088
1360611290,1032672780,4,591,147.75,1360611287794,1360611287794,1032670574,1032670574,0
1360611290,1032672780,3,421,140.3333333,1360611287861,1360611288053,1032670641,1032670833,192
1360611290,1032672784,5,1067,213.4,1360611285232,1360611285552,1032668016,1032668336,320
1360611290,1032672784,7,1300,185.7142857,1360611285232,1360611286320,1032668016,1032669104,1088
1360611297,3965960044,4,417,104.25,1360611282129,1360611290385,3965945173,3965953429,8256
1360611297,3965960044,6,3892,648.6666667,1360611290384,1360611292304,3965953428,3965955348,1920
1360611297,3965960048,8,1363,170.375,1360611291596,1360611293964,3965954644,3965957012,2368
1360611297,3965960060,5,764,152.8,1360611288191,1360611290367,3965951251,3965953427,2176
1360611297,3965960060,5,1554,310.8,1360611282110,1360611290366,3965945170,3965953426,8256
1360611298,1032680928,1,46,46,1360611272800,1360611272800,1032655728,1032655728,0
1360611298,1032680968,5,563,112.6,1360611293686,1360611293814,1032676654,1032676782,128
1360611298,1032680976,4,928,232,1360611282353,1360611290609,1032665329,1032673585,8256
1360611298,1032680976,5,513,102.6,1360611290672,1360611290736,1032673648,1032673712,64
1360611298,1032680976,7,683,97.57142857,1360611290672,1360611293680,1032673648,1032676656,3008
1360611298,1032680976,5,762,152.4,1360611294127,1360611294191,1032677103,1032677167,64
1360611298,1032680980,5,563,112.6,1360611294249,1360611294441,1032677229,1032677421,192
1360611298,1032681012,5,701,140.2,1360611291979,1360611292427,1032674991,1032675439,448
1360611298,1032681012,3,833,277.6666667,1360611291915,1360611291979,1032674927,1032674991,64
1360611298,1032681016,4,519,129.75,1360611287176,1360611294216,1032670192,1032677232,7040
1360611298,1032681016,5,1053,210.6,1360611292487,1360611297607,1032675503,1032680623,5120
1360611298,1032681016,5,563,112.6,1360611295494,1360611296070,1032678510,1032679086,576
1360611298,1032681056,10,9885,988.5,1360611293535,1360611293663,1032676591,1032676719,128
1360611298,1032681060,5,319,63.8,1360611293661,1360611295837,1032676721,1032678897,2176
1360611298,1032681060,10,3220,322,1360611281948,1360611290524,1032665008,1032673584,8576
1360611298,1032681064,5,563,112.6,1360611294104,1360611294168,1032677168,1032677232,64
1360611298,1032681092,5,935,187,1360611283643,1360611290491,1032666735,1032673583,6848
1360611298,1032681096,5,1366,273.2,1360611292024,1360611292408,1032675120,1032675504,384
1360611298,1032681100,4,652,163,1360611292532,1360611292596,1032675632,1032675696,64
1360611298,1032681104,7,1814,259.1428571,1360611284976,1360611293552,1032668080,1032676656,8576
1360611298,1032681104,7,675,96.42857143,1360611288367,1360611295279,1032671471,1032678383,6912
1360611297,3965960064,4,464,116,1360611293884,1360611293948,3965956948,3965957012,64
1360611305,3965968028,8,1401,175.125,1360611290529,1360611299169,3965953557,3965962197,8640
1360611305,3965968040,11,3586,326,1360611283219,1360611299155,3965946259,3965962195,15936
1360611305,3965968068,6,1869,311.5,1360611288247,1360611299127,3965951315,3965962195,10880
1360611305,3965968072,5,528,105.6,1360611293940,1360611300084,3965957012,3965963156,6144
1360611306,1032688880,6,3000,500,1360611284174,1360611299470,1032667054,1032682350,15296
1360611306,1032688928,4,510,127.5,1360611291040,1360611299424,1032673968,1032682352,8384
1360611306,1032688960,3,172,57.33333333,1360611294975,1360611299391,1032677935,1032682351,4416
1360611313,3965976040,4,1505,376.25,1360611302677,1360611312085,3965965717,3965975125,9408
1360611313,3965976040,5,1827,365.4,1360611307283,1360611308115,3965970323,3965971155,832
1360611313,3965976048,5,539,107.8,1360611297867,1360611306123,3965960915,3965969171,8256
1360611313,3965976068,5,524,104.8,1360611309239,1360611311671,3965972307,3965974739,2432
1360611313,3965976068,6,1869,311.5,1360611309238,1360611311798,3965972306,3965974866,2560
1360611313,3965976068,6,962,160.3333333,1360611309498,1360611311994,3965972566,3965975062,2496
1360611313,3965976072,4,472,118,1360611301301,1360611308213,3965964373,3965971285,6912
1360611314,1032696828,5,1082,216.4,1360611305923,1360611312515,1032688751,1032695343,6592
1360611314,1032696828,5,874,174.8,1360611306049,1360611312449,1032688877,1032695277,6400
1360611314,1032696832,13,14166,1089.692308,1360611301823,1360611308543,1032684655,1032691375,6720
1360611314,1032696836,8,1864,233,1360611306554,1360611307642,1032689390,1032690478,1088
1360611314,1032696844,5,935,187,1360611307633,1360611308465,1032690477,1032691309,832
1360611314,1032696868,6,3777,629.5,1360611311261,1360611311581,1032694129,1032694449,320
1360611314,1032696868,10,7802,780.2,1360611308187,1360611309595,1032691055,1032692463,1408
1360611314,1032696872,4,589,147.25,1360611308821,1360611309845,1032691693,1032692717,1024
1360611314,1032696876,4,510,127.5,1360611312020,1360611312340,1032694896,1032695216,320
1360611314,1032696876,5,563,112.6,1360611312338,1360611312402,1032695214,1032695278,64
1360611314,1032696876,5,513,102.6,1360611312338,1360611312402,1032695214,1032695278,64
1360611314,1032696884,10,5635,563.5,1360611301580,1360611312396,1032684464,1032695280,10816
1360611314,1032696904,8,1864,233,1360611306229,1360611307509,1032689133,1032690413,1280
1360611314,1032696924,8,6882,860.25,1360611311523,1360611311523,1032694447,1032694447,0
1360611314,1032696924,3,421,140.3333333,1360611308579,1360611308771,1032691503,1032691695,192
1360611314,1032696924,5,657,131.4,1360611308579,1360611309539,1032691503,1032692463,960
1360611314,1032696924,5,1136,227.2,1360611311587,1360611311971,1032694511,1032694895,384
1360611314,1032696948,7,2351,335.8571429,1360611311946,1360611312266,1032694894,1032695214,320
1360611314,1032696952,5,563,112.6,1360611312070,1360611312326,1032695022,1032695278,256
1360611314,1032696952,10,2989,298.9,1360611300934,1360611310598,1032683886,1032693550,9664
1360611314,1032696952,3,833,277.6666667,1360611312262,1360611312326,1032695214,1032695278,64
1360611314,1032696956,5,563,112.6,1360611312516,1360611313604,1032695472,1032696560,1088
1360611318,1032700500,1,52,52,1360611291083,1360611291083,1032673583,1032673583,0
1360611322,1032704852,18,19499,1083.277778,1360611306092,1360611314796,1032688944,1032697648,8704
1360611322,1032704852,5,563,112.6,1360611313707,1360611314795,1032696559,1032697647,1088
1360611322,1032704856,4,490,122.5,1360611306599,1360611318567,1032689455,1032701423,11968
1360611322,1032704856,12,11375,947.9166667,1360611314726,1360611315174,1032697582,1032698030,448
1360611322,1032704860,5,563,112.6,1360611315362,1360611315490,1032698222,1032698350,128
1360611322,1032704860,6,826,137.6666667,1360611315361,1360611315425,1032698221,1032698285,64
1360611322,1032704888,9,3780,420,1360611319750,1360611321606,1032702638,1032704494,1856
1360611322,1032704964,4,591,147.75,1360611308346,1360611316538,1032691310,1032699502,8192
1360611322,1032704964,4,476,119,1360611308346,1360611316538,1032691310,1032699502,8192
1360611322,1032704964,6,623,103.8333333,1360611319737,1360611321721,1032702701,1032704685,1984
1360611326,1032708528,1,46,46,1360611300781,1360611300781,1032683309,1032683309,0
1360611329,3965992036,5,516,103.2,1360611315032,1360611322520,3965978068,3965985556,7488
1360611329,3965992040,8,1066,133.25,1360611312211,1360611321363,3965975251,3965984403,9152
1360611329,3965992048,5,516,103.2,1360611315019,1360611322507,3965978067,3965985555,7488
1360611330,1032712860,4,267,66.75,1360611315234,1360611322850,1032698094,1032705710,7616
1360611330,1032712900,6,1718,286.3333333,1360611312828,1360611322492,1032695728,1032705392,9664
1360611334,1032716364,1,52,52,1360611306324,1360611306324,1032688688,1032688688,0
1360611337,3966000044,7,5322,760.2857143,1360611323855,1360611330895,3965986899,3965993939,7040
1360611337,3966000048,73,99479,1362.726027,1360611324812,1360611336140,3965987860,3965999188,11328
1360611337,3966000064,11,9825,893.1818182,1360611323835,1360611331323,3965986899,3965994387,7488
1360611337,3966000064,16,15404,962.75,1360611323835,1360611332155,3965986899,3965995219,8320
1360611345,3966008048,19,20885,1099.210526,1360611319500,1360611338380,3965982548,3966001428,18880
1360611345,3966008064,5,2237,447.4,1360611334461,1360611342205,3965997525,3966005269,7744
1360611393,3966056044,4,1042,260.5,1360611392464,1360611392656,3966055508,3966055700,192
1360611393,3966056044,4,1128,282,1360611392655,1360611392847,3966055699,3966055891,192
1360611393,3966056064,47,56317,1198.234043,1360611391677,1360611392381,3966054741,3966055445,704
1360611393,3966056064,23,20666,898.5217391,1360611392060,1360611392828,3966055124,3966055892,768
1360611393,3966056064,4,1051,262.75,1360611392442,1360611392634,3966055506,3966055698,192
1360611394,1032776940,17,16583,975.4705882,1360611388370,1360611388946,1032771310,1032771886,576
1360611394,1032776940,48,63363,1320.0625,1360611392017,1360611392401,1032774957,1032775341,384
1360611394,1032777016,13,7922,609.3846154,1360611391943,1360611392391,1032774959,1032775407,448
1360611394,1032777016,126,173036,1373.301587,1360611388487,1360611392775,1032771503,1032775791,4288
1360611394,1032777020,17,16278,957.5294118,1360611388995,1360611391875,1032772015,1032774895,2880
1360611401,3966064036,18,20973,1165.166667,1360611394714,1360611395354,3966057750,3966058390,640
1360611401,3966064044,45,59989,1333.088889,1360611398032,1360611399312,3966061076,3966062356,1280
1360611401,3966064044,9,7475,830.5555556,1360611398287,1360611399247,3966061331,3966062291,960
1360611401,3966064044,4,417,104.25,1360611392978,1360611393170,3966056022,3966056214,192
1360611401,3966064048,10,4919,491.9,1360611392974,1360611393294,3966056022,3966056342,320
1360611401,3966064048,4,472,118,1360611392974,1360611393166,3966056022,3966056214,192
1360611401,3966064060,18,18858,1047.666667,1360611392194,1360611400898,3966055254,3966063958,8704
1360611401,3966064064,290,402613,1388.32069,1360611324798,1360611400830,3965987862,3966063894,76032
1360611402,1032784932,31,33194,1070.774194,1360611399512,1360611401240,1032782444,1032784172,1728
1360611402,1032784932,4,1024,256,1360611391707,1360611398683,1032774639,1032781615,6976
1360611402,1032784936,19,21453,1129.105263,1360611388694,1360611396694,1032771630,1032779630,8000
1360611402,1032784940,26,29601,1138.5,1360611389073,1360611397137,1032772013,1032780077,8064
1360611402,1032784944,9,3828,425.3333333,1360611393230,1360611395598,1032776174,1032778542,2368
1360611402,1032784968,41,49480,1206.829268,1360611398262,1360611401142,1032781230,1032784110,2880
1360611402,1032785008,4,356,89,1360611391692,1360611398604,1032774700,1032781612,6912
1360611402,1032785012,13,12308,946.7692308,1360611399627,1360611400011,1032782639,1032783023,384
1360611402,1032785016,52,67102,1290.423077,1360611388613,1360611401029,1032771629,1032784045,12416
1360611409,3966072028,7,5292,756,1360611403232,1360611403360,3966066260,3966066388,128
1360611409,3966072028,121,165309,1366.190083,1360611403359,1360611403743,3966066387,3966066771,384
1360611409,3966072028,4,1355,338.75,1360611407199,1360611407391,3966070227,3966070419,192
1360611409,3966072028,13,4445,341.9230769,1360611399906,1360611404258,3966062934,3966067286,4352
1360611409,3966072032,92,123581,1343.271739,1360611403934,1360611407646,3966066966,3966070678,3712
1360611409,3966072032,6,3565,594.1666667,1360611404061,1360611404125,3966067093,3966067157,64
1360611409,3966072032,37,40730,1100.810811,1360611401373,1360611401821,3966064405,3966064853,448
1360611409,3966072032,5,2634,526.8,1360611407581,1360611407837,3966070613,3966070869,256
1360611409,3966072032,5,1829,365.8,1360611408027,1360611408091,3966071059,3966071123,64
1360611409,3966072032,32,41229,1288.40625,1360611408091,1360611408219,3966071123,3966071251,128
1360611409,3966072032,5,1770,354,1360611401819,1360611401883,3966064851,3966064915,64
1360611409,3966072036,12,11289,940.75,1360611397912,1360611402456,3966060948,3966065492,4544
1360611409,3966072036,116,158349,1365.077586,1360611397912,1360611403224,3966060948,3966066260,5312
1360611409,3966072040,17,17878,1051.647059,1360611402901,1360611403285,3966065941,3966066325,384
1360611409,3966072040,14,15562,1111.571429,1360611402965,1360611403221,3966066005,3966066261,256
1360611409,3966072040,135,184424,1366.103704,1360611403220,1360611403924,3966066260,3966066964,704
1360611409,3966072040,30,37405,1246.833333,1360611403220,1360611403412,3966066260,3966066452,192
1360611409,3966072052,4,464,116,1360611403721,1360611403785,3966066773,3966066837,64
1360611409,3966072052,12,12036,1003,1360611403849,1360611404105,3966066901,3966067157,256
1360611409,3966072052,47,54915,1168.404255,1360611401352,1360611403400,3966064404,3966066452,2048
1360611409,3966072056,11,5865,533.1818182,1360611405315,1360611406467,3966068371,3966069523,1152
1360611409,3966072056,5,689,137.8,1360611405315,1360611406787,3966068371,3966069843,1472
1360611409,3966072056,63,78896,1252.31746,1360611397891,1360611402883,3966060947,3966065939,4992
1360611410,1032792932,8,3761,470.125,1360611405400,1360611406360,1032788332,1032789292,960
1360611410,1032792936,5,899,179.8,1360611402069,1360611408789,1032785005,1032791725,6720
1360611410,1032792940,40,52124,1303.1,1360611402258,1360611408786,1032785198,1032791726,6528
1360611410,1032792940,5,1580,316,1360611402576,1360611402768,1032785516,1032785708,192
1360611410,1032792944,4,606,151.5,1360611402829,1360611403021,1032785773,1032785965,192
1360611410,1032792948,6,3315,552.5,1360611406731,1360611406923,1032789679,1032789871,192
1360611410,1032792948,6,3324,554,1360611406857,1360611407049,1032789805,1032789997,192
1360611410,1032792952,22,24666,1121.181818,1360611407044,1360611407428,1032789996,1032790380,384
1360611410,1032792952,6,3569,594.8333333,1360611407047,1360611407303,1032789999,1032790255,256
1360611410,1032792952,4,576,144,1360611403653,1360611403845,1032786605,1032786797,192
1360611410,1032792968,11,6590,599.0909091,1360611407348,1360611407924,1032790316,1032790892,576
1360611410,1032792968,4,731,182.75,1360611404087,1360611404279,1032787055,1032787247,192
1360611410,1032792968,4,730,182.5,1360611404085,1360611404277,1032787053,1032787245,192
1360611410,1032792968,44,58290,1324.772727,1360611399477,1360611408693,1032782445,1032791661,9216
1360611410,1032792972,8,5894,736.75,1360611404976,1360611405360,1032787948,1032788332,384
1360611410,1032792976,10,2890,289,1360611392175,1360611402223,1032775151,1032785199,10048
1360611410,1032792976,4,775,193.75,1360611408303,1360611408367,1032791279,1032791343,64
1360611410,1032792976,8,1860,232.5,1360611408813,1360611409005,1032791789,1032791981,192
1360611410,1032792976,4,490,122.5,1360611408877,1360611409069,1032791853,1032792045,192
1360611410,1032792976,4,589,147.25,1360611409197,1360611409261,1032792173,1032792237,64
1360611410,1032792980,5,836,167.2,1360611401899,1360611402027,1032784879,1032785007,128
1360611410,1032792980,3,421,140.3333333,1360611409514,1360611409578,1032792494,1032792558,64
1360611410,1032792980,5,3159,631.8,1360611409513,1360611409641,1032792493,1032792621,128
1360611410,1032793012,28,35007,1250.25,1360611402123,1360611402315,1032785135,1032785327,192
1360611410,1032793012,8,1198,149.75,1360611405835,1360611406731,1032788847,1032789743,896
1360611410,1032793016,5,561,112.2,1360611402629,1360611402821,1032785645,1032785837,192
1360611410,1032793024,4,1374,343.5,1360611406847,1360611406975,1032789871,1032789999,128
1360611410,1032793024,11,9133,830.2727273,1360611398974,1360611406654,1032781998,1032789678,7680
1360611410,1032793024,4,591,147.75,1360611403581,1360611403773,1032786605,1032786797,192
1360611410,1032793024,5,1939,387.8,1360611407101,1360611407293,1032790125,1032790317,192
1360611410,1032793024,6,3569,594.8333333,1360611407165,1360611407357,1032790189,1032790381,192
1360611410,1032793024,4,1148,287,1360611403772,1360611403964,1032786796,1032786988,192
1360611410,1032793024,30,38257,1275.233333,1360611403772,1360611403900,1032786796,1032786924,128
1360611410,1032793024,4,1317,329.25,1360611403900,1360611404028,1032786924,1032787052,128
1360611410,1032793028,6,3510,585,1360611404218,1360611404410,1032787246,1032787438,192
1360611410,1032793028,4,773,193.25,1360611407737,1360611407865,1032790765,1032790893,128
1360611410,1032793056,3,421,140.3333333,1360611408284,1360611408348,1032791340,1032791404,64
1360611410,1032793060,4,591,147.75,1360611408347,1360611408539,1032791407,1032791599,192
1360611410,1032793060,5,985,197,1360611408858,1360611409434,1032791918,1032792494,576
1360611410,1032793060,6,1748,291.3333333,1360611408730,1360611408922,1032791790,1032791982,192
1360611410,1032793060,5,3156,631.2,1360611409241,1360611409433,1032792301,1032792493,192
1360611410,1032793060,19,21449,1128.894737,1360611400537,1360611402841,1032783597,1032785901,2304
1360611410,1032793064,30,38432,1281.066667,1360611400980,1360611408596,1032784044,1032791660,7616
1360611417,3966080044,20,24231,1211.55,1360611414672,1360611414800,3966077716,3966077844,128
1360611417,3966080044,61,81388,1334.229508,1360611402896,1360611410512,3966065940,3966073556,7616
1360611417,3966080048,4,464,116,1360611409357,1360611409421,3966072405,3966072469,64
1360611417,3966080048,25,24100,964,1360611411596,1360611411852,3966074644,3966074900,256
1360611417,3966080056,7,4871,695.8571429,1360611413381,1360611413445,3966076437,3966076501,64
1360611417,3966080056,5,1788,357.6,1360611413636,1360611413700,3966076692,3966076756,64
1360611417,3966080056,8,6034,754.25,1360611413700,1360611413764,3966076756,3966076820,64
1360611417,3966080076,11,9026,820.5454545,1360611411569,1360611411825,3966074645,3966074901,256
1360611417,3966080076,9,6174,686,1360611411568,1360611411696,3966074644,3966074772,128
1360611417,3966080084,8,6183,772.875,1360611413353,1360611413545,3966076437,3966076629,192
1360611417,3966080084,11,10325,938.6363636,1360611413672,1360611413800,3966076756,3966076884,128
1360611417,3966080084,8,5542,692.75,1360611413672,1360611414056,3966076756,3966077140,384
1360611418,1032800580,8,4374,546.75,1360611391354,1360611395450,1032773934,1032778030,4096
1360611418,1032800944,4,1270,317.5,1360611413388,1360611413580,1032796332,1032796524,192
1360611418,1032800944,5,820,164,1360611413452,1360611413772,1032796396,1032796716,320
1360611418,1032800944,4,1045,261.25,1360611413455,1360611413839,1032796399,1032796783,384
1360611418,1032800944,4,890,222.5,1360611413582,1360611413710,1032796526,1032796654,128
1360611418,1032800944,4,1153,288.25,1360611413772,1360611413900,1032796716,1032796844,128
1360611418,1032800948,3,984,328,1360611413771,1360611413899,1032796719,1032796847,128
1360611418,1032800948,4,795,198.75,1360611413834,1360611413962,1032796782,1032796910,128
1360611418,1032800948,15,2471,164.7333333,1360611409801,1360611413257,1032792749,1032796205,3456
1360611418,1032800952,5,663,132.6,1360611414084,1360611414468,1032797036,1032797420,384
1360611418,1032800952,4,902,225.5,1360611406341,1360611414853,1032789293,1032797805,8512
1360611418,1032800952,4,498,124.5,1360611414276,1360611414404,1032797228,1032797356,128
1360611418,1032800956,11,4892,444.7272727,1360611414467,1360611414787,1032797423,1032797743,320
1360611418,1032800956,4,1287,321.75,1360611414467,1360611414595,1032797423,1032797551,128
1360611418,1032800956,60,79138,1318.966667,1360611402819,1360611412739,1032785775,1032795695,9920
1360611418,1032800956,6,1032,172,1360611414466,1360611414530,1032797422,1032797486,64
1360611418,1032800956,6,1887,314.5,1360611414593,1360611414721,1032797549,1032797677,128
1360611418,1032800956,5,820,164,1360611414657,1360611414785,1032797613,1032797741,128
1360611418,1032800976,6,2768,461.3333333,1360611411692,1360611411756,1032794668,1032794732,64
1360611418,1032800984,3,421,140.3333333,1360611412198,1360611412262,1032795182,1032795246,64
1360611418,1032800984,4,591,147.75,1360611412262,1360611412454,1032795246,1032795438,192
1360611418,1032800992,3,809,269.6666667,1360611412958,1360611413086,1032795950,1032796078,128
1360611418,1032800992,5,997,199.4,1360611413085,1360611413213,1032796077,1032796205,128
1360611418,1032800992,3,476,158.6666667,1360611413149,1360611413277,1032796141,1032796269,128
1360611418,1032800992,5,653,130.6,1360611413213,1360611413277,1032796205,1032796269,64
1360611418,1032800992,5,331,66.2,1360611413148,1360611413340,1032796140,1032796332,192
1360611418,1032801020,7,2092,298.8571429,1360611413698,1360611413890,1032796718,1032796910,192
1360611418,1032801020,4,1025,256.25,1360611413825,1360611414081,1032796845,1032797101,256
1360611418,1032801020,4,507,126.75,1360611409793,1360611409857,1032792813,1032792877,64
1360611418,1032801020,3,671,223.6666667,1360611413825,1360611413889,1032796845,1032796909,64
1360611418,1032801024,3,421,140.3333333,1360611410171,1360611410299,1032793195,1032793323,128
1360611418,1032801024,3,422,140.6666667,1360611414206,1360611414270,1032797230,1032797294,64
1360611418,1032801056,7,5270,752.8571429,1360611407260,1360611414748,1032790316,1032797804,7488
1360611418,1032801060,4,464,116,1360611415191,1360611415319,1032798251,1032798379,128
1360611418,1032801060,6,1107,184.5,1360611411867,1360611412059,1032794927,1032795119,192
1360611418,1032801060,57,65924,1156.561404,1360611404312,1360611414680,1032787372,1032797740,10368
1360611418,1032801068,6,999,166.5,1360611408146,1360611411218,1032791214,1032794286,3072
1360611418,1032801068,4,826,206.5,1360611412817,1360611412881,1032795885,1032795949,64
1360611418,1032801072,5,905,181,1360611412939,1360611413643,1032796011,1032796715,704
1360611418,1032801072,6,1018,169.6666667,1360611412942,1360611413070,1032796014,1032796142,128
1360611418,1032801072,4,476,119,1360611408590,1360611414734,1032791662,1032797806,6144
1360611418,1032801072,5,772,154.4,1360611413198,1360611413326,1032796270,1032796398,128
1360611418,1032801072,6,717,119.5,1360611408845,1360611412045,1032791917,1032795117,3200
1360611425,3966088040,18,17632,979.5555556,1360611414678,1360611423318,3966077718,3966086358,8640
1360611425,3966088040,22,21343,970.1363636,1360611414678,1360611424342,3966077718,3966087382,9664
1360611425,3966088040,20,19486,974.3,1360611414677,1360611424341,3966077717,3966087381,9664
1360611425,3966088064,4,866,216.5,1360611424574,1360611424702,3966087638,3966087766,128
1360611425,3966088068,94,127640,1357.87234,1360611408184,1360611417912,3966071252,3966080980,9728
1360611426,1032808948,4,1561,390.25,1360611418248,1360611418504,1032801196,1032801452,256
1360611426,1032808996,5,1314,262.8,1360611424666,1360611424794,1032807662,1032807790,128
1360611426,1032809028,21,24464,1164.952381,1360611418042,1360611418426,1032801070,1032801454,384
1360611426,1032809032,4,1558,389.5,1360611418291,1360611418483,1032801323,1032801515,192
1360611426,1032809032,5,855,171,1360611418423,1360611418679,1032801455,1032801711,256
1360611426,1032809040,14,2808,200.5714286,1360611415406,1360611424814,1032798446,1032807854,9408
1360611426,1032809072,6,907,151.1666667,1360611412877,1360611422797,1032795949,1032805869,9920
1360611426,1032809076,11,6076,552.3636364,1360611408651,1360611422731,1032791727,1032805807,14080
1360611430,1032812448,1,46,46,1360611404540,1360611404540,1032786988,1032786988,0
1360611430,1032812472,1,46,46,1360611404837,1360611404837,1032787309,1032787309,0
1360611430,1032812568,1,46,46,1360611404805,1360611404805,1032787373,1032787373,0
1360611433,3966096048,16,6061,378.8125,1360611422861,1360611430669,3966085909,3966093717,7808
1360611433,3966096048,5,2375,475,1360611427084,1360611427404,3966090132,3966090452,320
1360611433,3966096048,4,769,192.25,1360611431244,1360611431500,3966094292,3966094548,256
1360611433,3966096048,4,544,136,1360611431435,1360611431499,3966094483,3966094547,64
1360611433,3966096064,8,5036,629.5,1360611424701,1360611428797,3966087765,3966091861,4096
1360611434,1032816964,23,22487,977.6956522,1360611418489,1360611431033,1032801453,1032813997,12544
1360611434,1032816964,7,5036,719.4285714,1360611418680,1360611429112,1032801644,1032812076,10432
1360611434,1032816964,25,10385,415.4,1360611414456,1360611430904,1032797420,1032813868,16448
1360611434,1032816972,6,795,132.5,1360611431090,1360611433330,1032814062,1032816302,2240
1360611434,1032817000,8,2509,313.625,1360611431893,1360611432789,1032814893,1032815789,896
1360611434,1032817008,59,76058,1289.118644,1360611424908,1360611431756,1032807916,1032814764,6848
1360611434,1032817036,5,1430,286,1360611418096,1360611426288,1032801132,1032809324,8192
1360611434,1032817040,6,3810,635,1360611418604,1360611429036,1032801644,1032812076,10432
1360611434,1032817044,6,1814,302.3333333,1360611422825,1360611430825,1032805869,1032813869,8000
1360611434,1032817044,5,1033,206.6,1360611427048,1360611427432,1032810092,1032810476,384
1360611434,1032817052,4,704,176,1360611431331,1360611431587,1032814383,1032814639,256
1360611434,1032817076,4,1917,479.25,1360611431626,1360611431818,1032814702,1032814894,192
1360611434,1032817076,4,621,155.25,1360611431687,1360611431815,1032814763,1032814891,128
1360611434,1032817080,8,4656,582,1360611424133,1360611430789,1032807213,1032813869,6656
1360611434,1032817084,43,52931,1230.953488,1360611424833,1360611427713,1032807917,1032810797,2880
1360611441,3966104024,9,1480,164.4444444,1360611430566,1360611439078,3966093590,3966102102,8512
1360611441,3966104036,15,6660,444,1360611434714,1360611436378,3966097750,3966099414,1664
1360611441,3966104036,14,6838,488.4285714,1360611434778,1360611436058,3966097814,3966099094,1280
1360611441,3966104044,29,34837,1201.275862,1360611433938,1360611434706,3966096982,3966097750,768
1360611441,3966104044,6,828,138,1360611430671,1360611439055,3966093715,3966102099,8384
1360611441,3966104044,22,9601,436.4090909,1360611422735,1360611438031,3966085779,3966101075,15296
1360611441,3966104048,57,75654,1327.263158,1360611427596,1360611436684,3966090644,3966099732,9088
1360611441,3966104064,86,109904,1277.953488,1360611434110,1360611435390,3966097174,3966098454,1280
1360611442,1032824968,17,12870,757.0588235,1360611435956,1360611436212,1032818924,1032819180,256
1360611442,1032824972,15,14762,984.1333333,1360611436210,1360611436658,1032819182,1032819630,448
1360611442,1032824972,29,19325,666.3793103,1360611431794,1360611435058,1032814766,1032818030,3264
1360611442,1032824972,6,995,165.8333333,1360611436337,1360611436913,1032819309,1032819885,576
1360611442,1032824972,16,9893,618.3125,1360611431985,1360611434417,1032814957,1032817389,2432
1360611442,1032824980,5,1453,290.6,1360611437099,1360611437355,1032820079,1032820335,256
1360611442,1032824980,2,435,217.5,1360611440936,1360611441192,1032823916,1032824172,256
1360611442,1032824984,2,1013,506.5,1360611441189,1360611441317,1032824173,1032824301,128
1360611442,1032825012,2,112,56,1360611433802,1360611434122,1032816814,1032817134,320
1360611442,1032825012,2,112,56,1360611433802,1360611434122,1032816814,1032817134,320
1360611442,1032825016,21,25534,1215.904762,1360611430661,1360611439237,1032813677,1032822253,8576
1360611442,1032825020,25,31328,1253.12,1360611427583,1360611436863,1032810603,1032819883,9280
1360611442,1032825024,3,279,93,1360611435837,1360611435901,1032818861,1032818925,64
1360611442,1032825028,9,2516,279.5555556,1360611431671,1360611433911,1032814699,1032816939,2240
1360611442,1032825028,5,854,170.8,1360611436218,1360611441210,1032819246,1032824238,4992
1360611442,1032825032,8,1806,225.75,1360611439859,1360611440883,1032822891,1032823915,1024
1360611442,1032825052,3,477,159,1360611436832,1360611437024,1032819884,1032820076,192
1360611442,1032825056,3,474,158,1360611437022,1360611437278,1032820078,1032820334,256
1360611442,1032825056,3,687,229,1360611437277,1360611439325,1032820333,1032822381,2048
1360611449,3966112096,11,5041,458.2727273,1360611428763,1360611442843,3966091859,3966105939,14080
1360611450,1032832464,3,156,52,1360611423339,1360611423403,1032805803,1032805867,64
1360611450,1032832960,6,783,130.5,1360611442365,1360611446141,1032825325,1032829101,3776
1360611450,1032832964,8,2483,310.375,1360611438263,1360611449143,1032821227,1032832107,10880
1360611450,1032833032,3,481,160.3333333,1360611444021,1360611444341,1032827053,1032827373,320
1360611450,1032833048,5,1254,250.8,1360611437414,1360611445158,1032820462,1032828206,7744
1360611450,1032833072,7,665,95,1360611445903,1360611449103,1032828975,1032832175,3200
1360611450,1032833072,5,2070,414,1360611442251,1360611445515,1032825323,1032828587,3264
1360611450,1032833116,3,486,162,1360611436578,1360611442978,1032819694,1032826094,6400
1360611451,3966113696,1,52,52,1360611426350,1360611426350,3966089046,3966089046,0
1360611454,1032836656,1,79,79,1360611427052,1360611427052,1032809708,1032809708,0
1360611457,3966120056,5,764,152.8,1360611454854,1360611455494,3966117910,3966118550,640
1360611457,3966120064,46,50032,1087.652174,1360611433917,1360611455229,3966096981,3966118293,21312
1360611458,1032840960,58,74306,1281.137931,1360611437372,1360611451452,1032820332,1032834412,14080
1360611458,1032840996,23,19119,831.2608696,1360611439257,1360611457561,1032822253,1032840557,18304
1360611458,1032840996,44,42718,970.8636364,1360611439320,1360611451416,1032822316,1032834412,12096
1360611458,1032841000,23,25136,1092.869565,1360611444373,1360611453781,1032827373,1032836781,9408
1360611458,1032841008,5,669,133.8,1360611457100,1360611457356,1032840108,1032840364,256
1360611458,1032841040,4,775,193.75,1360611454187,1360611454251,1032837227,1032837291,64
1360611458,1032841040,9,4903,544.7777778,1360611442603,1360611451371,1032825643,1032834411,8768
1360611458,1032841044,5,3159,631.8,1360611454250,1360611454506,1032837294,1032837550,256
1360611458,1032841076,8,1904,238,1360611455688,1360611456200,1032838764,1032839276,512
1360611458,1032841080,4,1287,321.75,1360611455686,1360611456198,1032838766,1032839278,512
1360611458,1032841084,9,6017,668.5555556,1360611456258,1360611456834,1032839342,1032839918,576
1360611462,1032844536,1,46,46,1360611434343,1360611434343,1032816879,1032816879,0
1360611465,3966128060,3,172,57.33333333,1360611460799,1360611463167,3966123859,3966126227,2368
1360611465,3966128064,11,7664,696.7272727,1360611454396,1360611461564,3966117460,3966124628,7168
1360611465,3966128064,10,6238,623.8,1360611454396,1360611461564,3966117460,3966124628,7168
1360611465,3966128064,8,5044,630.5,1360611458684,1360611459580,3966121748,3966122644,896
1360611465,3966128064,5,524,104.8,1360611454971,1360611456955,3966118035,3966120019,1984
1360611465,3966128068,5,1656,331.2,1360611452215,1360611461559,3966115283,3966124627,9344
1360611465,3966128088,11,7664,696.7272727,1360611454374,1360611461542,3966117462,3966124630,7168
1360611466,1032848600,1,52,52,1360611439651,1360611439651,1032822251,1032822251,0
1360611466,1032848968,17,10711,630.0588235,1360611446261,1360611461877,1032829229,1032844845,15616
1360611466,1032848968,3,150,50,1360611458740,1360611462132,1032841708,1032845100,3392
1360611466,1032848972,7,2323,331.8571429,1360611459247,1360611462959,1032842219,1032845931,3712
1360611466,1032848976,6,2768,461.3333333,1360611454571,1360611461803,1032837547,1032844779,7232
1360611466,1032849004,7,4456,636.5714286,1360611452881,1360611459857,1032835885,1032842861,6976
1360611466,1032849008,6,498,83,1360611457164,1360611459340,1032840172,1032842348,2176
1360611466,1032849012,5,826,165.2,1360611457867,1360611458635,1032840879,1032841647,768
1360611466,1032849012,4,1045,261.25,1360611457482,1360611457930,1032840494,1032840942,448
1360611466,1032849012,6,765,127.5,1360611457545,1360611461001,1032840557,1032844013,3456
1360611466,1032849040,4,537,134.25,1360611458606,1360611458862,1032841646,1032841902,256
1360611466,1032849048,5,1605,321,1360611455013,1360611458597,1032838061,1032841645,3584
1360611466,1032849080,3,138,46,1360611460675,1360611461955,1032843755,1032845035,1280
1360611466,1032849084,2,112,56,1360611460799,1360611461055,1032843883,1032844139,256
1360611466,1032849084,3,138,46,1360611464130,1360611464130,1032847214,1032847214,0
1360611466,1032849084,5,1354,270.8,1360611456321,1360611463745,1032839405,1032846829,7424
1360611466,1032849084,2,112,56,1360611461055,1360611461247,1032844139,1032844331,192
1360611466,1032849084,3,168,56,1360611461119,1360611461311,1032844203,1032844395,192
1360611470,1032852468,3,156,52,1360611442857,1360611442985,1032825325,1032825453,128
1360611470,1032852468,2,92,46,1360611442856,1360611442984,1032825324,1032825452,128
1360611473,3966136068,60,76814,1280.233333,1360611467003,1360611470267,3966130071,3966133335,3264
1360611473,3966136088,241,331965,1377.448133,1360611461862,1360611471654,3966124950,3966134742,9792
1360611474,1032857084,4,591,147.75,1360611471681,1360611471873,1032854765,1032854957,192
1360611474,1032857084,4,901,225.25,1360611471745,1360611471873,1032854829,1032854957,128
1360611474,1032857088,6,945,157.5,1360611471998,1360611473534,1032855086,1032856622,1536
1360611474,1032857092,4,591,147.75,1360611472183,1360611472247,1032855275,1032855339,64
1360611474,1032857116,5,899,179.8,1360611469471,1360611471647,1032852587,1032854763,2176
1360611474,1032857128,6,2994,499,1360611470355,1360611471635,1032853483,1032854763,1280
1360611474,1032857132,6,850,141.6666667,1360611470482,1360611471826,1032853614,1032854958,1344
1360611474,1032857136,25,28373,1134.92,1360611467469,1360611470477,1032850605,1032853613,3008
1360611474,1032857168,4,731,182.75,1360611471723,1360611471851,1032854891,1032855019,128
1360611475,1032857444,4,591,147.75,1360611473919,1360611473983,1032856363,1032856427,64
1360611478,1032860524,1,46,46,1360611452401,1360611452401,1032834925,1032834925,0
1360611481,3966144060,10,6166,616.6,1360611467328,1360611474752,3966130388,3966137812,7424
1360611481,3966144072,49,65758,1342,1360611467316,1360611475572,3966130388,3966138644,8256
1360611481,3966144088,94,112735,1199.308511,1360611462564,1360611477540,3966125652,3966140628,14976
1360611482,1032865036,16,5747,359.1875,1360611473968,1360611481904,1032857004,1032864940,7936
1360611482,1032865044,18,12143,674.6111111,1360611473770,1360611476778,1032856814,1032859822,3008
1360611482,1032865044,19,9495,499.7368421,1360611473769,1360611475177,1032856813,1032858221,1408
1360611482,1032865044,31,36834,1188.193548,1360611462056,1360611475752,1032845100,1032858796,13696
1360611482,1032865072,3,643,214.3333333,1360611476046,1360611476174,1032859118,1032859246,128
1360611482,1032865072,3,979,326.3333333,1360611476237,1360611476365,1032859309,1032859437,128
1360611482,1032865072,4,1270,317.5,1360611476364,1360611476492,1032859436,1032859564,128
1360611482,1032865076,4,856,214,1360611476551,1360611480199,1032859627,1032863275,3648
1360611482,1032865076,7,649,92.71428571,1360611476682,1360611478026,1032859758,1032861102,1344
1360611482,1032865076,4,773,193.25,1360611477000,1360611477512,1032860076,1032860588,512
1360611482,1032865088,5,603,120.6,1360611481597,1360611481789,1032864685,1032864877,192
1360611482,1032865124,4,774,193.5,1360611475095,1360611475415,1032858219,1032858539,320
1360611482,1032865128,38,48917,1287.289474,1360611467091,1360611475667,1032850219,1032858795,8576
1360611482,1032865128,5,3158,631.6,1360611475413,1360611475797,1032858541,1032858925,384
1360611482,1032865136,4,1561,390.25,1360611476301,1360611476493,1032859437,1032859629,192
1360611482,1032865160,3,1353,451,1360611476406,1360611476534,1032859566,1032859694,128
1360611482,1032865160,4,602,150.5,1360611476469,1360611476597,1032859629,1032859757,128
1360611482,1032865160,5,589,117.8,1360611476596,1360611478068,1032859756,1032861228,1472
1360611486,1032868684,2,92,46,1360611458511,1360611458767,1032841195,1032841451,256
1360611489,3966152064,13,5096,392,1360611468863,1360611481535,3966131927,3966144599,12672
1360611489,3966152072,6,4386,731,1360611483510,1360611484086,3966146582,3966147158,576
1360611489,3966152084,160,202684,1266.775,1360611461160,1360611481448,3966124244,3966144532,20288
1360611490,1032872608,10,4467,446.7,1360611464604,1360611466332,1032847212,1032848940,1728
1360611490,1032873056,4,419,104.75,1360611477469,1360611486365,1032860525,1032869421,8896
1360611490,1032873056,9,4123,458.1111111,1360611481373,1360611489757,1032864429,1032872813,8384
1360611490,1032873064,3,1130,376.6666667,1360611482324,1360611489748,1032865388,1032872812,7424
1360611490,1032873068,5,3156,631.2,1360611482768,1360611482896,1032865836,1032865964,128
1360611490,1032873072,4,662,165.5,1360611483022,1360611483214,1032866094,1032866286,192
1360611490,1032873092,4,902,225.5,1360611483705,1360611484281,1032866797,1032867373,576
1360611490,1032873092,6,1692,282,1360611476024,1360611489720,1032859116,1032872812,13696
1360611490,1032873092,3,557,185.6666667,1360611476215,1360611483703,1032859307,1032866795,7488
1360611490,1032873108,3,172,57.33333333,1360611482023,1360611485159,1032865131,1032868267,3136
1360611490,1032873140,4,1558,389.5,1360611483143,1360611489735,1032866283,1032872875,6592
1360611490,1032873144,4,1045,261.25,1360611483398,1360611483590,1032866542,1032866734,192
1360611490,1032873148,2,112,56,1360611484160,1360611484416,1032867308,1032867564,256
1360611495,3966157860,10,3048,304.8,1360611470473,1360611489801,3966133333,3966152661,19328
1360611497,3966160132,14,12809,914.9285714,1360611490810,1360611491002,3966153942,3966154134,192
1360611497,3966160132,5,1821,364.2,1360611491319,1360611491447,3966154451,3966154579,128
1360611497,3966160144,11,10406,946,1360611494190,1360611494382,3966157334,3966157526,192
1360611497,3966160144,14,4857,346.9285714,1360611474670,1360611489518,3966137814,3966152662,14848
1360611497,3966160144,36,38266,1062.944444,1360611490734,1360611491118,3966153878,3966154262,384
1360611498,1032881048,4,731,182.75,1360611493539,1360611493667,1032876587,1032876715,128
1360611498,1032881048,5,2557,511.4,1360611493795,1360611493923,1032876843,1032876971,128
1360611498,1032881052,4,900,225,1360611493918,1360611494046,1032876970,1032877098,128
1360611498,1032881056,8,4516,564.5,1360611494238,1360611496030,1032877294,1032879086,1792
1360611498,1032881056,38,49322,1297.947368,1360611490717,1360611497885,1032873773,1032880941,7168
1360611498,1032881060,11,8431,766.4545455,1360611494745,1360611495129,1032877805,1032878189,384
1360611498,1032881060,5,742,148.4,1360611491607,1360611494679,1032874667,1032877739,3072
1360611498,1032881132,5,936,187.2,1360611494479,1360611494991,1032877611,1032878123,512
1360611498,1032881140,5,899,179.8,1360611491466,1360611491658,1032874606,1032874798,192
1360611498,1032881140,4,2902,725.5,1360611491402,1360611491466,1032874542,1032874606,64
1360611498,1032881160,4,730,182.5,1360611491764,1360611491892,1032874924,1032875052,128
1360611498,1032881168,5,2350,470,1360611495851,1360611496043,1032879019,1032879211,192
1360611497,3966160164,4,464,116,1360611494360,1360611494424,3966157524,3966157588,64
1360611505,3966168060,54,69302,1283.37037,1360611490882,1360611497666,3966153942,3966160726,6784
1360611505,3966168064,5,1692,338.4,1360611504126,1360611504382,3966167190,3966167446,256
1360611505,3966168064,7,1116,159.4285714,1360611504573,1360611504893,3966167637,3966167957,320
1360611505,3966168068,138,175620,1272.608696,1360611488314,1360611497722,3966151382,3966160790,9408
1360611505,3966168068,48,64332,1340.25,1360611490552,1360611497720,3966153620,3966160788,7168
1360611505,3966168084,10,6226,622.6,1360611504426,1360611504554,3966167510,3966167638,128
1360611505,3966168084,17,12300,723.5294118,1360611504490,1360611504874,3966167574,3966167958,384
1360611505,3966168084,155,213782,1379.23871,1360611489513,1360611497705,3966152597,3966160789,8192
1360611505,3966168088,7,4624,660.5714286,1360611490532,1360611497700,3966153620,3966160788,7168
1360611506,1032888644,18,5759,319.9444444,1360611477943,1360611490807,1032860587,1032873451,12864
1360611506,1032889044,5,826,165.2,1360611502120,1360611503080,1032885164,1032886124,960
1360611506,1032889048,6,3706,617.6666667,1360611502374,1360611504166,1032885422,1032887214,1792
1360611506,1032889048,23,24543,1067.086957,1360611490852,1360611501796,1032873900,1032884844,10944
1360611506,1032889048,23,28470,1237.826087,1360611490852,1360611497892,1032873900,1032880940,7040
1360611506,1032889080,7,885,126.4285714,1360611499846,1360611500422,1032882926,1032883502,576
1360611506,1032889080,6,1042,173.6666667,1360611500227,1360611503747,1032883307,1032886827,3520
1360611506,1032889084,18,8856,492,1360611495680,1360611505792,1032878764,1032888876,10112
1360611506,1032889136,11,6167,560.6363636,1360611499470,1360611504590,1032882606,1032887726,5120
1360611506,1032889136,6,944,157.3333333,1360611499723,1360611504971,1032882859,1032888107,5248
1360611506,1032889164,6,3148,524.6666667,1360611504111,1360611504367,1032887275,1032887531,256
1360611506,1032889164,5,599,119.8,1360611495918,1360611499630,1032879082,1032882794,3712
1360611506,1032889168,3,601,200.3333333,1360611504491,1360611504619,1032887659,1032887787,128
1360611506,1032889172,4,773,193.25,1360611504617,1360611504937,1032887789,1032888109,320
1360611506,1032889172,4,821,205.25,1360611504935,1360611505127,1032888107,1032888299,192
1360611506,1032889176,5,1206,241.2,1360611505186,1360611505634,1032888362,1032888810,448
1360611510,1032892540,2,92,46,1360611482593,1360611482977,1032865133,1032865517,384
1360611510,1032892664,8,3153,394.125,1360611482211,1360611483235,1032864875,1032865899,1024
1360611514,1032896556,2,427,213.5,1360611486161,1360611486929,1032868717,1032869485,768
1360611514,1032897040,6,585,97.5,1360611505388,1360611506668,1032888428,1032889708,1280
1360611514,1032897040,4,285,71.25,1360611513388,1360611513772,1032896428,1032896812,384
1360611514,1032897044,4,196,49,1360611506025,1360611507241,1032889069,1032890285,1216
1360611514,1032897044,6,2090,348.3333333,1360611501927,1360611509863,1032884971,1032892907,7936
1360611514,1032897052,5,667,133.4,1360611507551,1360611507743,1032890603,1032890795,192
1360611514,1032897056,17,8376,492.7058824,1360611507932,1360611509340,1032890988,1032892396,1408
1360611514,1032897076,7,1701,243,1360611500104,1360611507784,1032883180,1032890860,7680
1360611514,1032897076,8,1767,220.875,1360611500231,1360611513095,1032883307,1032896171,12864
1360611514,1032897080,5,829,165.8,1360611508676,1360611509252,1032891756,1032892332,576
1360611514,1032897080,4,872,218,1360611508803,1360611509443,1032891883,1032892523,640
1360611514,1032897084,7,2828,404,1360611504258,1360611507458,1032887342,1032890542,3200
1360611514,1032897084,6,560,93.33333333,1360611509247,1360611513215,1032892331,1032896299,3968
1360611514,1032897084,6,952,158.6666667,1360611509247,1360611509503,1032892331,1032892587,256
1360611514,1032897088,7,1156,165.1428571,1360611505020,1360611513788,1032888108,1032896876,8768
1360611514,1032897088,5,1337,267.4,1360611513147,1360611513211,1032896235,1032896299,64
1360611514,1032897088,7,1636,233.7142857,1360611509434,1360611509818,1032892522,1032892906,384
1360611514,1032897092,5,589,117.8,1360611505720,1360611507384,1032888812,1032890476,1664
1360611514,1032897116,6,1810,301.6666667,1360611505695,1360611507423,1032888811,1032890539,1728
1360611514,1032897120,4,781,195.25,1360611509850,1360611510234,1032892970,1032893354,384
1360611514,1032897132,5,3156,631.2,1360611507538,1360611507794,1032890670,1032890926,256
1360611514,1032897132,5,446,89.2,1360611507345,1360611508753,1032890477,1032891885,1408
1360611514,1032897132,5,905,181,1360611507345,1360611507537,1032890477,1032890669,192
1360611514,1032897132,5,1076,215.2,1360611507472,1360611513680,1032890604,1032896812,6208
1360611514,1032897164,6,716,119.3333333,1360611495857,1360611507697,1032879021,1032890861,11840
1360611514,1032897164,19,13737,723,1360611496047,1360611513007,1032879211,1032896171,16960
1360611514,1032897168,4,653,163.25,1360611513194,1360611513706,1032896362,1032896874,512
1360611514,1032897172,3,486,162,1360611504938,1360611513002,1032888110,1032896174,8064
1360611521,3966184064,5,516,103.2,1360611513086,1360611520190,3966176150,3966183254,7104
1360611521,3966184064,5,516,103.2,1360611513086,1360611520254,3966176150,3966183318,7168
1360611521,3966184064,8,1015,126.875,1360611503611,1360611512955,3966166675,3966176019,9344
1360611521,3966184072,5,2524,504.8,1360611517365,1360611517621,3966180437,3966180693,256
1360611521,3966184072,7,2960,422.8571429,1360611517812,1360611520180,3966180884,3966183252,2368
1360611521,3966184076,4,464,116,1360611513073,1360611513585,3966176149,3966176661,512
1360611521,3966184092,4,435,108.75,1360611517026,1360611517090,3966180118,3966180182,64
1360611522,1032905048,8,2960,370,1360611514082,1360611517154,1032897130,1032900202,3072
1360611522,1032905052,4,789,197.25,1360611509858,1360611517858,1032892910,1032900910,8000
1360611522,1032905056,5,1472,294.4,1360611514394,1360611521882,1032897450,1032904938,7488
1360611522,1032905056,7,579,82.71428571,1360611510237,1360611519901,1032893293,1032902957,9664
1360611522,1032905056,7,2862,408.8571429,1360611514651,1360611514843,1032897707,1032897899,192
1360611522,1032905064,8,4150,518.75,1360611515413,1360611516181,1032898477,1032899245,768
1360611522,1032905064,7,3067,438.1428571,1360611507733,1360611516245,1032890797,1032899309,8512
1360611522,1032905092,4,645,161.25,1360611516662,1360611516918,1032899754,1032900010,256
1360611522,1032905100,3,764,254.6666667,1360611516977,1360611517105,1032900077,1032900205,128
1360611522,1032905100,4,530,132.5,1360611517041,1360611517169,1032900141,1032900269,128
1360611522,1032905100,3,764,254.6666667,1360611517041,1360611517169,1032900141,1032900269,128
1360611522,1032905100,4,530,132.5,1360611517231,1360611517359,1032900331,1032900459,128
1360611522,1032905124,5,1168,233.6,1360611517337,1360611517529,1032900461,1032900653,192
1360611522,1032905124,8,1556,194.5,1360611517400,1360611520536,1032900524,1032903660,3136
1360611522,1032905128,7,2024,289.1428571,1360611513684,1360611514004,1032896812,1032897132,320
1360611522,1032905128,9,3502,389.1111111,1360611513747,1360611515219,1032896875,1032898347,1472
1360611522,1032905132,6,1117,186.1666667,1360611510224,1360611518416,1032893356,1032901548,8192
1360611522,1032905132,9,4428,492,1360611514511,1360611515087,1032897643,1032898219,576
1360611522,1032905136,7,2554,364.8571429,1360611514893,1360611515021,1032898029,1032898157,128
1360611522,1032905136,7,2678,382.5714286,1360611515211,1360611515339,1032898347,1032898475,128
1360611522,1032905136,3,675,225,1360611515147,1360611515339,1032898283,1032898475,192
1360611522,1032905136,9,6035,670.5555556,1360611515338,1360611516170,1032898474,1032899306,832
1360611522,1032905160,20,13162,658.1,1360611507765,1360611514613,1032890925,1032897773,6848
1360611522,1032905168,19,19867,1045.631579,1360611516077,1360611521645,1032899245,1032904813,5568
1360611522,1032905168,3,172,57.33333333,1360611519789,1360611521453,1032902957,1032904621,1664
1360611522,1032905172,4,530,132.5,1360611516775,1360611516903,1032899947,1032900075,128
1360611522,1032905176,4,873,218.25,1360611517030,1360611517158,1032900206,1032900334,128
1360611522,1032905176,5,1032,206.4,1360611517093,1360611517221,1032900269,1032900397,128
1360611521,3966184096,10,4905,490.5,1360611518493,1360611520797,3966181589,3966183893,2304
1360611529,3966192064,3,144,48,1360611521212,1360611521468,3966184276,3966184532,256
1360611529,3966192064,2,98,49,1360611521212,1360611521468,3966184276,3966184532,256
1360611529,3966192072,67,89270,1332.38806,1360611522228,1360611526900,3966185300,3966189972,4672
1360611529,3966192076,24,29716,1238.166667,1360611527027,1360611528627,3966190103,3966191703,1600
1360611529,3966192076,3,144,48,1360611521203,1360611521459,3966184279,3966184535,256
1360611530,1032913068,5,1477,295.4,1360611517967,1360611526671,1032901035,1032909739,8704
1360611530,1032913080,4,731,182.75,1360611526851,1360611527043,1032909931,1032910123,192
1360611530,1032913116,5,708,141.6,1360611513248,1360611523808,1032896364,1032906924,10560
1360611530,1032913148,2,112,56,1360611521663,1360611522303,1032904811,1032905451,640
1360611530,1032913160,4,591,147.75,1360611526834,1360611526962,1032909994,1032910122,128
1360611531,3966193816,1,52,52,1360611505268,1360611505268,3966168084,3966168084,0
1360611538,1032921084,8,2616,327,1360611526785,1360611537089,1032909869,1032920173,10304
1360611538,1032921120,4,841,210.25,1360611525274,1360611537562,1032908394,1032920682,12288
1360611538,1032921188,5,959,191.8,1360611526871,1360611537175,1032910059,1032920363,10304
1360611542,1032924656,16,15292,955.75,1360611516075,1360611522155,1032898731,1032904811,6080
1360611542,1032924724,2,92,46,1360611514280,1360611514920,1032897004,1032897644,640
1360611545,3966208072,21,16481,784.8095238,1360611522229,1360611542773,3966185301,3966205845,20544
1360611545,3966208092,5,1797,359.4,1360611526496,1360611539552,3966189588,3966202644,13056
1360611546,1032929048,4,730,182.5,1360611526883,1360611539043,1032909931,1032922091,12160
1360611546,1032929168,4,775,193.75,1360611544940,1360611545388,1032928108,1032928556,448
1360611547,3966210000,71,78739,1109,1360611519806,1360611541118,3966182806,3966204118,21312
1360611550,1032932612,23,27203,1182.73913,1360611522839,1360611547159,1032905451,1032929771,24320
1360611551,3966213952,1,52,52,1360611523693,1360611523693,3966186645,3966186645,0
1360611551,3966214024,27,24810,918.8888889,1360611524580,1360611541284,3966187604,3966204308,16704
1360611553,3966216068,5,524,104.8,1360611536632,1360611547832,3966199700,3966210900,11200
1360611553,3966216076,6,3272,545.3333333,1360611543728,1360611551792,3966206804,3966214868,8064
1360611554,1032936672,1,52,52,1360611529178,1360611529178,1032911850,1032911850,0
1360611554,1032936756,4,843,210.75,1360611527432,1360611528712,1032910188,1032911468,1280
1360611554,1032937044,5,2804,560.8,1360611553445,1360611553573,1032936489,1032936617,128
1360611554,1032937052,5,642,128.4,1360611547166,1360611550942,1032930218,1032933994,3776
1360611554,1032937056,7,1864,266.2857143,1360611551069,1360611551965,1032934125,1032935021,896
1360611554,1032937056,6,2932,488.6666667,1360611551132,1360611552156,1032934188,1032935212,1024
1360611554,1032937080,17,5634,331.4117647,1360611540609,1360611548353,1032923689,1032931433,7744
1360611554,1032937084,6,1781,296.8333333,1360611552065,1360611552385,1032935149,1032935469,320
1360611554,1032937088,10,5218,521.8,1360611552508,1360611553404,1032935596,1032936492,896
1360611554,1032937088,15,9317,621.1333333,1360611536315,1360611551931,1032919403,1032935019,15616
1360611554,1032937092,6,3707,617.8333333,1360611545465,1360611546873,1032928557,1032929965,1408
1360611554,1032937124,6,377,62.83333333,1360611550295,1360611552343,1032933419,1032935467,2048
1360611554,1032937128,5,905,181,1360611550612,1360611550996,1032933740,1032934124,384
1360611554,1032937128,5,902,180.4,1360611547028,1360611550228,1032930156,1032933356,3200
1360611554,1032937132,5,900,180,1360611550928,1360611551056,1032934060,1032934188,128
1360611554,1032937132,6,1228,204.6666667,1360611547279,1360611551247,1032930411,1032934379,3968
1360611554,1032937164,4,555,138.75,1360611548719,1360611548911,1032931883,1032932075,192
1360611554,1032937168,5,1295,259,1360611549035,1360611549227,1032932203,1032932395,192
1360611555,3966218036,1,52,52,1360611529689,1360611529689,3966192725,3966192725,0
1360611555,3966218056,12,14236,1186.333333,1360611528455,1360611547591,3966191511,3966210647,19136
1360611561,3966224060,38,44951,1182.921053,1360611536578,1360611555714,3966199638,3966218774,19136
1360611561,3966224072,6,1064,177.3333333,1360611549812,1360611557684,3966212884,3966220756,7872
1360611562,1032944672,1,52,52,1360611536794,1360611536794,1032919466,1032919466,0
1360611562,1032944672,1,52,52,1360611536730,1360611536730,1032919402,1032919402,0
1360611562,1032945048,5,2142,428.4,1360611549413,1360611556005,1032932461,1032939053,6592
1360611562,1032945048,24,26644,1110.166667,1360611553635,1360611555427,1032936683,1032938475,1792
1360611562,1032945048,7,5202,743.1428571,1360611553699,1360611561827,1032936747,1032944875,8128
1360611562,1032945048,5,691,138.2,1360611553699,1360611561891,1032936747,1032944939,8192
1360611562,1032945052,4,530,132.5,1360611554208,1360611555424,1032937260,1032938476,1216
1360611562,1032945052,4,902,225.5,1360611554207,1360611555231,1032937259,1032938283,1024
1360611562,1032945052,5,1031,206.2,1360611554398,1360611555614,1032937450,1032938666,1216
1360611562,1032945056,5,1295,259,1360611558105,1360611558297,1032941161,1032941353,192
1360611562,1032945056,5,905,181,1360611558235,1360611558811,1032941291,1032941867,576
1360611562,1032945056,6,1649,274.8333333,1360611558299,1360611560475,1032941355,1032943531,2176
1360611562,1032945060,5,882,176.4,1360611555223,1360611555479,1032938283,1032938539,256
1360611562,1032945060,4,537,134.25,1360611547159,1360611553943,1032930219,1032937003,6784
1360611562,1032945060,5,899,179.8,1360611555478,1360611555606,1032938538,1032938666,128
1360611562,1032945060,16,7349,459.3125,1360611551125,1360611560661,1032934185,1032943721,9536
1360611562,1032945064,4,731,182.75,1360611555605,1360611555733,1032938669,1032938797,128
1360611562,1032945092,11,1832,166.5454545,1360611551926,1360611561846,1032935018,1032944938,9920
1360611562,1032945096,4,773,193.25,1360611556725,1360611556917,1032939821,1032940013,192
1360611562,1032945140,4,730,182.5,1360611555272,1360611555400,1032938412,1032938540,128
1360611562,1032945140,4,386,96.5,1360611547208,1360611553864,1032930348,1032937004,6656
1360611562,1032945140,6,1563,260.5,1360611550920,1360611554312,1032934060,1032937452,3392
1360611562,1032945140,8,3247,405.875,1360611558728,1360611561800,1032941868,1032944940,3072
1360611562,1032945168,4,1559,389.75,1360611548394,1360611555882,1032931562,1032939050,7488
1360611562,1032945172,10,5286,528.6,1360611556841,1360611557865,1032940013,1032941037,1024
1360611566,1032948624,1,52,52,1360611538572,1360611538572,1032921196,1032921196,0
1360611566,1032948780,17,4716,277.4117647,1360611539887,1360611546351,1032922667,1032929131,6464
1360611566,1032948796,1,52,52,1360611540958,1360611540958,1032923754,1032923754,0
1360611570,1032952648,1,46,46,1360611542834,1360611542834,1032925482,1032925482,0
1360611570,1032953052,9,1055,117.2222222,1360611558238,1360611569246,1032941290,1032952298,11008
1360611570,1032953128,8,476,59.5,1360611562003,1360611569491,1032945131,1032952619,7488
1360611570,1032953132,9,1255,139.4444444,1360611558094,1360611568910,1032941226,1032952042,10816
1360611570,1032953132,4,184,46,1360611562254,1360611568526,1032945386,1032951658,6272
1360611570,1032953140,26,13221,508.5,1360611555590,1360611568198,1032938730,1032951338,12608
1360611570,1032953140,3,180,60,1360611563334,1360611568838,1032946474,1032951978,5504
1360611570,1032953144,31,15821,510.3548387,1360611555717,1360611568645,1032938861,1032951789,12928
1360611578,1032961132,3,138,46,1360611563407,1360611576143,1032946539,1032959275,12736
1360611579,3966241972,1,1426,1426,1360611554202,1360611554202,3966217174,3966217174,0
1360611583,3966246028,1,1426,1426,1360611556450,1360611556450,3966219478,3966219478,0
1360611586,1032968668,8,4598,574.75,1360611559199,1360611580319,1032941867,1032962987,21120
1360611586,1032968668,3,192,64,1360611559199,1360611568223,1032941867,1032950891,9024
1360611586,1032968836,3,138,46,1360611560697,1360611568569,1032943533,1032951405,7872
1360611586,1032968836,7,364,52,1360611560696,1360611576376,1032943532,1032959212,15680
1360611586,1032969060,3,138,46,1360611570903,1360611578583,1032953963,1032961643,7680
1360611586,1032969092,2,92,46,1360611572408,1360611580856,1032955500,1032963948,8448
1360611586,1032969100,3,210,70,1360611585071,1360611585711,1032968171,1032968811,640
1360611586,1032969136,3,168,56,1360611570188,1360611581388,1032953324,1032964524,11200
1360611586,1032969144,4,232,58,1360611571585,1360611580417,1032954729,1032963561,8832
1360611586,1032969168,2,92,46,1360611572332,1360611578796,1032955500,1032961964,6464
1360611594,1032977064,2,158,79,1360611587091,1360611589651,1032970155,1032972715,2560
1360611594,1032977132,4,232,58,1360611573967,1360611593487,1032957099,1032976619,19520
1360611594,1032977152,2,92,46,1360611575740,1360611590140,1032958892,1032973292,14400
1360611606,1032988696,3,192,64,1360611579842,1360611588802,1032962538,1032971498,8960
1360611606,1032988704,3,138,46,1360611580283,1360611589307,1032962987,1032972011,9024
1360611606,1032988824,3,138,46,1360611580611,1360611589635,1032963435,1032972459,9024
1360611610,1032992712,8,480,60,1360611585138,1360611594610,1032967850,1032977322,9472
1360611610,1032993080,5,368,73.6,1360611602756,1360611607684,1032985836,1032990764,4928
1360611610,1032993080,2,158,79,1360611594819,1360611605187,1032977899,1032988267,10368
1360611610,1032993120,2,116,58,1360611600860,1360611603804,1032983980,1032986924,2944
1360611618,1033000720,1,46,46,1360611592041,1360611592041,1032974761,1032974761,0
1360611618,1033000752,1,46,46,1360611592651,1360611592651,1032975403,1032975403,0
1360611618,1033000760,1,46,46,1360611593154,1360611593154,1032975914,1032975914,0
1360611618,1033000832,3,168,56,1360611591483,1360611617595,1032974315,1033000427,26112
1360611618,1033000844,1,52,52,1360611592365,1360611592365,1032975209,1032975209,0
1360611618,1033000876,1,892,892,1360611593293,1360611593293,1032976169,1032976169,0
1360611626,1033008704,1,46,46,1360611598522,1360611598522,1032981226,1032981226,0
1360611626,1033009208,2,158,79,1360611613251,1360611624643,1032996459,1033007851,11392
1360611627,3966290024,6,360,60,1360611600294,1360611620198,3966263318,3966283222,19904
1360611634,1033016804,7,420,60,1360611606037,1360611615573,1032988841,1032998377,9536
1360611638,1033020836,1,52,52,1360611613429,1360611613429,1032996265,1032996265,0
1360611643,1033025436,4,184,46,1360611634821,1360611641925,1033017257,1033024361,7104
1360611650,1033033256,1,892,892,1360611624977,1360611624977,1033008233,1033008233,0
1360611650,1033033304,2,116,58,1360611643620,1360611648420,1033026924,1033031724,4800
1360611654,1033037104,1,79,79,1360611625898,1360611625898,1033009002,1033009002,0
1360611671,3966334108,1,60,60,1360611644371,1360611644371,3966307479,3966307479,0
1360611674,1033057080,1,46,46,1360611646080,1360611646080,1033029160,1033029160,0
1360611674,1033057188,1,52,52,1360611648212,1360611648212,1033031400,1033031400,0
1360611674,1033057272,1,79,79,1360611647297,1360611647297,1033030569,1033030569,0
1360611694,1033077268,1,79,79,1360611667207,1360611667207,1033050475,1033050475,0
1360611714,1033097160,1,46,46,1360611687730,1360611687730,1033070890,1033070890,0
1360611724,3966386396,6,360,60,1360611699740,1360611720668,3966362136,3966383064,20928
1360611726,1033109256,7,436,62.28571429,1360611697807,1360611723023,1033081063,1033106279,25216
1360611748,3966410344,17,13300,782.3529412,1360611720846,1360611742158,3966383190,3966404502,21312
1360611750,1033133224,3,156,52,1360611724656,1360611733680,1033107880,1033116904,9024
1360611754,1033137260,6,360,60,1360611726475,1360611748875,1033109735,1033132135,22400
1360611763,1033145472,2,112,56,1360611759327,1360611759583,1033141799,1033142055,256
1360611768,3966430416,7,412,58.85714286,1360611742149,1360611763077,3966404565,3966425493,20928
1360611769,3966432132,5,522,104.4,1360611757307,1360611763387,3966420439,3966426519,6080
1360611771,1033153428,3,156,52,1360611746445,1360611755469,1033128873,1033137897,9024
1360611771,1033153516,4,2902,725.5,1360611770356,1360611770420,1033152872,1033152936,64
1360611771,1033153516,5,905,181,1360611770355,1360611770483,1033152871,1033152999,128
1360611771,1033153584,17,16269,957,1360611770160,1360611770480,1033152744,1033153064,320
1360611772,3966434396,1,60,60,1360611744858,1360611744858,3966407254,3966407254,0
1360611776,3966438444,2,1490,745,1360611751723,1360611755819,3966414167,3966418263,4096
1360611778,3966440188,162,224972,1388.716049,1360611768555,1360611773931,3966430743,3966436119,5376
1360611778,3966440196,5,1797,359.4,1360611770532,1360611770596,3966432728,3966432792,64
1360611778,3966440196,4,464,116,1360611771170,1360611771490,3966433366,3966433686,320
1360611778,3966440200,96,126020,1312.708333,1360611768541,1360611771677,3966430741,3966433877,3136
1360611778,3966440212,9,1547,171.8888889,1360611776850,1360611777618,3966439062,3966439830,768
1360611779,1033161516,7,1413,201.8571429,1360611770548,1360611778548,1033153064,1033161064,8000
1360611779,1033161516,10,5036,503.6,1360611774707,1360611775987,1033157223,1033158503,1280
1360611779,1033161516,10,3418,341.8,1360611774707,1360611775283,1033157223,1033157799,576
1360611779,1033161520,5,2460,492,1360611771183,1360611778479,1033153703,1033160999,7296
1360611779,1033161524,5,767,153.4,1360611767340,1360611774572,1033149864,1033157096,7232
1360611779,1033161528,4,773,193.25,1360611775591,1360611775975,1033158119,1033158503,384
1360611779,1033161532,5,887,177.4,1360611772835,1360611773283,1033155367,1033155815,448
1360611779,1033161552,9,3361,373.4444444,1360611773327,1360611773711,1033155879,1033156263,384
1360611779,1033161556,6,3230,538.3333333,1360611773517,1360611773645,1033156073,1033156201,128
1360611779,1033161564,9,3128,347.5555556,1360611777284,1360611777476,1033159848,1033160040,192
1360611779,1033161568,16,5554,347.125,1360611774590,1360611775678,1033157158,1033158246,1088
1360611779,1033161572,4,591,147.75,1360611770940,1360611771260,1033153512,1033153832,320
1360611779,1033161600,7,2970,424.2857143,1360611775073,1360611775521,1033157673,1033158121,448
1360611779,1033161608,23,28577,1242.478261,1360611768344,1360611776152,1033150952,1033158760,7808
1360611779,1033161652,4,774,193.5,1360611777518,1360611777838,1033160170,1033160490,320
1360611779,1033161652,4,3106,776.5,1360611777836,1360611778220,1033160488,1033160872,384
1360611780,3966442424,15,14548,969.8666667,1360611755453,1360611758717,3966417877,3966421141,3264
1360611782,1033165248,25,8806,352.24,1360611756506,1360611762970,1033139754,1033146218,6464
1360611786,3966448188,30,34978,1165.933333,1360611770153,1360611778729,3966432341,3966440917,8576
1360611786,3966448200,127,145793,1147.976378,1360611768286,1360611780318,3966430486,3966442518,12032
1360611786,3966448212,168,232183,1382.041667,1360611768788,1360611780308,3966431000,3966442520,11520
1360611786,3966448212,9,1412,156.8888889,1360611776786,1360611784338,3966438998,3966446550,7552
1360611787,1033169580,4,232,58,1360611777333,1360611780469,1033159913,1033163049,3136
1360611787,1033169616,7,1082,154.5714286,1360611771217,1360611782097,1033153833,1033164713,10880
1360611794,3966456188,94,103670,1102.87234,1360611770284,1360611787244,3966432472,3966449432,16960
1360611794,3966456192,4,464,116,1360611792229,1360611792357,3966454421,3966454549,128
1360611794,3966456196,6,2106,351,1360611781541,1360611788517,3966443737,3966450713,6976
1360611794,3966456208,28,33411,1193.25,1360611785943,1360611787223,3966448151,3966449431,1280
1360611795,1033177516,4,591,147.75,1360611783093,1360611790197,1033165609,1033172713,7104
1360611795,1033177516,6,3886,647.6666667,1360611783411,1360611792435,1033165927,1033174951,9024
1360611795,1033177516,5,331,66.2,1360611791346,1360611791538,1033173862,1033174054,192
1360611795,1033177520,3,984,328,1360611791474,1360611791666,1033173994,1033174186,192
1360611795,1033177520,6,1586,264.3333333,1360611783473,1360611792497,1033165993,1033175017,9024
1360611795,1033177520,4,1153,288.25,1360611791473,1360611791729,1033173993,1033174249,256
1360611795,1033177520,5,905,181,1360611791473,1360611791665,1033173993,1033174185,192
1360611795,1033177520,4,1560,390,1360611791664,1360611792048,1033174184,1033174568,384
1360611795,1033177548,5,901,180.2,1360611792404,1360611792532,1033174952,1033175080,128
1360611795,1033177552,6,1590,265,1360611781326,1360611790158,1033163878,1033172710,8832
1360611795,1033177552,3,605,201.6666667,1360611792846,1360611792974,1033175398,1033175526,128
1360611795,1033177556,4,672,168,1360611792971,1360611793163,1033175527,1033175719,192
1360611795,1033177556,6,1349,224.8333333,1360611781707,1360611790155,1033164263,1033172711,8448
1360611795,1033177564,4,775,193.75,1360611790851,1360611790979,1033173415,1033173543,128
1360611795,1033177568,5,3159,631.8,1360611790974,1360611791166,1033173542,1033173734,192
1360611795,1033177592,20,9312,465.6,1360611787369,1360611792873,1033169961,1033175465,5504
1360611795,1033177592,6,1810,301.6666667,1360611791336,1360611791464,1033173928,1033174056,128
1360611795,1033177592,4,902,225.5,1360611783335,1360611790119,1033165927,1033172711,6784
1360611795,1033177596,4,653,163.25,1360611791525,1360611791653,1033174121,1033174249,128
1360611795,1033177628,4,773,193.25,1360611792900,1360611793028,1033175528,1033175656,128
1360611795,1033177632,5,3156,631.2,1360611793022,1360611793214,1033175654,1033175846,192
1360611795,1033177632,5,950,190,1360611793090,1360611793218,1033175722,1033175850,128
1360611795,1033177632,14,6563,468.7857143,1360611785344,1360611787200,1033167976,1033169832,1856
1360611795,1033177636,3,984,328,1360611793466,1360611793658,1033176102,1033176294,192
1360611795,1033177636,5,1205,241,1360611793469,1360611793917,1033176105,1033176553,448
1360611799,1033181516,1,60,60,1360611773812,1360611773812,1033156328,1033156328,0
1360611802,3966464180,9,1716,190.6666667,1360611792244,1360611797428,3966454424,3966459608,5184
1360611802,3966464184,60,68494,1141.566667,1360611785775,1360611794543,3966447959,3966456727,8768
1360611802,3966464188,26,31905,1227.115385,1360611799212,1360611799340,3966461400,3966461528,128
1360611802,3966464188,4,1089,272.25,1360611800234,1360611800298,3966462422,3966462486,64
1360611802,3966464204,5,2844,568.8,1360611799449,1360611799833,3966461653,3966462037,384
1360611803,1033185408,1,52,52,1360611774879,1360611774879,1033157287,1033157287,0
1360611803,1033185716,7,5123,731.8571429,1360611798763,1360611798827,1033181479,1033181543,64
1360611803,1033185720,4,409,102.25,1360611799145,1360611799273,1033181865,1033181993,128
1360611803,1033185720,18,5700,316.6666667,1360611786921,1360611796329,1033169641,1033179049,9408
1360611803,1033185728,5,1228,245.6,1360611799905,1360611800033,1033182633,1033182761,128
1360611803,1033185728,14,4673,333.7857143,1360611791904,1360611797088,1033174632,1033179816,5184
1360611803,1033185756,5,905,181,1360611796804,1360611796932,1033179560,1033179688,128
1360611803,1033185756,4,971,242.75,1360611792451,1360611799939,1033175207,1033182695,7488
1360611803,1033185756,3,576,192,1360611796995,1360611797187,1033179751,1033179943,192
1360611803,1033185756,15,14186,945.7333333,1360611800643,1360611801475,1033183399,1033184231,832
1360611803,1033185760,8,2008,251,1360611792577,1360611796737,1033175337,1033179497,4160
1360611803,1033185760,4,726,181.5,1360611797375,1360611797567,1033180135,1033180327,192
1360611803,1033185760,4,503,125.75,1360611797439,1360611797503,1033180199,1033180263,64
1360611803,1033185764,5,3074,614.8,1360611797821,1360611797885,1033180585,1033180649,64
1360611803,1033185764,6,811,135.1666667,1360611798011,1360611801339,1033180775,1033184103,3328
1360611803,1033185764,6,924,154,1360611801339,1360611802299,1033184103,1033185063,960
1360611803,1033185768,14,9711,693.6428571,1360611798201,1360611798713,1033180969,1033181481,512
1360611803,1033185772,5,1503,300.6,1360611802293,1360611802421,1033185065,1033185193,128
1360611803,1033185772,4,530,132.5,1360611798899,1360611798963,1033181671,1033181735,64
1360611803,1033185796,3,689,229.6666667,1360611799194,1360611799258,1033181990,1033182054,64
1360611803,1033185800,7,2379,339.8571429,1360611791001,1360611799961,1033173801,1033182761,8960
1360611803,1033185800,3,567,189,1360611791065,1360611797913,1033173865,1033180713,6848
1360611803,1033185804,6,1264,210.6666667,1360611799762,1360611800338,1033182566,1033183142,576
1360611803,1033185812,5,988,197.6,1360611796683,1360611796747,1033179495,1033179559,64
1360611803,1033185816,5,900,180,1360611796937,1360611797129,1033179753,1033179945,192
1360611803,1033185816,6,2101,350.1666667,1360611800456,1360611801288,1033183272,1033184104,832
1360611803,1033185816,3,486,162,1360611797128,1360611797320,1033179944,1033180136,192
1360611803,1033185816,6,1887,314.5,1360611797127,1360611797383,1033179943,1033180199,256
1360611803,1033185816,4,1105,276.25,1360611797063,1360611797127,1033179879,1033179943,64
1360611803,1033185816,4,776,194,1360611797127,1360611797191,1033179943,1033180007,64
1360611803,1033185832,9,8075,897.2222222,1360611797303,1360611797431,1033180135,1033180263,128
1360611803,1033185836,8,2425,303.125,1360611797749,1360611799989,1033180585,1033182825,2240
1360611803,1033185836,9,3379,375.4444444,1360611781875,1360611797875,1033164711,1033180711,16000
1360611803,1033185836,6,2547,424.5,1360611797938,1360611798130,1033180774,1033180966,192
1360611803,1033185840,5,1295,259,1360611801519,1360611801711,1033184359,1033184551,192
1360611803,1033185844,5,900,180,1360611801710,1360611802222,1033184554,1033185066,512
1360611803,1033186120,4,1134,283.5,1360611802136,1360611802200,1033185256,1033185320,64
1360611807,1033189420,2,1120,560,1360611779794,1360611780114,1033162214,1033162534,320
1360611810,3966472188,4,1391,347.75,1360611802985,1360611802985,3966465173,3966465173,0
1360611810,3966472188,4,1505,376.25,1360611802985,1360611803049,3966465173,3966465237,64
1360611810,3966472192,6,2066,344.3333333,1360611803239,1360611803623,3966465431,3966465815,384
1360611811,1033193716,5,776,155.2,1360611802732,1360611802860,1033185448,1033185576,128
1360611811,1033193716,7,1298,185.4285714,1360611802796,1360611806444,1033185512,1033189160,3648
1360611811,1033193732,7,1660,237.1428571,1360611800028,1360611810140,1033182760,1033192872,10112
1360611811,1033193732,3,486,162,1360611800156,1360611808028,1033182888,1033190760,7872
1360611811,1033193756,11,4742,431.0909091,1360611796804,1360611804036,1033179560,1033186792,7232
1360611811,1033193760,30,36925,1230.833333,1360611797759,1360611806399,1033180519,1033189159,8640
1360611811,1033193764,5,708,141.6,1360611793468,1360611804028,1033176232,1033186792,10560
1360611811,1033193808,6,1649,274.8333333,1360611796558,1360611805006,1033179366,1033187814,8448
1360611811,1033193924,6,3771,628.5,1360611797725,1360611803869,1033180649,1033186793,6144
1360611811,1033193928,6,1202,200.3333333,1360611793305,1360611803865,1033176233,1033186793,10560
1360611811,1033193932,6,1264,210.6666667,1360611802132,1360611803092,1033185064,1033186024,960
1360611812,3966474488,1,1426,1426,1360611787710,1360611787710,3966450198,3966450198,0
1360611816,3966478452,4,464,116,1360611791586,1360611814306,3966454038,3966476758,22720
1360611818,3966480220,144,200451,1392.020833,1360611813515,1360611814091,3966475735,3966476311,576
1360611818,3966480220,49,65594,1338.653061,1360611813515,1360611814027,3966475735,3966476247,512
1360611819,1033201708,6,1349,224.8333333,1360611811317,1360611812469,1033194025,1033195177,1152
1360611819,1033201712,7,4756,679.4285714,1360611815407,1360611816367,1033198119,1033199079,960
1360611819,1033201748,15,12616,841.0666667,1360611805261,1360611814157,1033188009,1033196905,8896
1360611819,1033201752,5,1381,276.2,1360611806471,1360611814151,1033189223,1033196903,7680
1360611819,1033201788,7,4456,636.5714286,1360611811682,1360611818402,1033194470,1033201190,6720
1360611819,1033201832,4,2902,725.5,1360611814265,1360611814841,1033197097,1033197673,576
1360611820,3966482400,1,60,60,1360611793047,1360611793047,3966455447,3966455447,0
1360611827,1033209772,7,1413,201.8571429,1360611814965,1360611826229,1033197737,1033209001,11264
1360611827,1033209776,6,1017,169.5,1360611815408,1360611822512,1033198184,1033205288,7104
1360611827,1033209784,4,773,193.25,1360611824232,1360611825576,1033207016,1033208360,1344
1360611827,1033209808,22,27151,1234.136364,1360611813072,1360611820688,1033195880,1033203496,7616
1360611827,1033209820,16,12597,787.3125,1360611825539,1360611826051,1033208359,1033208871,512
1360611827,1033209896,18,19432,1079.555556,1360611814135,1360611822199,1033197031,1033205095,8064
1360611827,1033209900,5,900,180,1360611825844,1360611826100,1033208744,1033209000,256
1360611827,1033209904,5,3157,631.4,1360611826093,1360611826413,1033208997,1033209317,320
1360611834,3966496184,42,50934,1212.714286,1360611813678,1360611829806,3966475862,3966491990,16128
1360611834,3966496188,60,73916,1231.933333,1360611823085,1360611832749,3966485273,3966494937,9664
1360611834,3966496192,11,10406,946,1360611823719,1360611830759,3966485911,3966492951,7040
1360611834,3966496208,4,464,116,1360611828441,1360611828505,3966490649,3966490713,64
1360611834,3966496208,29,28398,979.2413793,1360611828504,1360611830744,3966490712,3966492952,2240
1360611834,3966496208,79,90599,1146.822785,1360611813015,1360611830743,3966475223,3966492951,17728
1360611834,3966496216,10,8636,863.6,1360611819729,1360611826897,3966481945,3966489113,7168
1360611834,3966496216,7,1820,260,1360611826960,1360611827728,3966489176,3966489944,768
1360611834,3966496216,22,18258,829.9090909,1360611827917,1360611828365,3966490133,3966490581,448
1360611835,1033217800,7,1012,144.5714286,1360611830614,1360611834390,1033213414,1033217190,3776
1360611835,1033217804,6,4224,704,1360611830803,1360611832275,1033213607,1033215079,1472
1360611835,1033217808,6,1986,331,1360611827281,1360611830801,1033210089,1033213609,3520
1360611835,1033217808,35,15916,454.7428571,1360611819535,1360611834383,1033202343,1033217191,14848
1360611835,1033217840,5,905,181,1360611829359,1360611829551,1033212199,1033212391,192
1360611835,1033217840,6,659,109.8333333,1360611829614,1360611831406,1033212454,1033214246,1792
1360611835,1033217848,5,999,199.8,1360611832807,1360611832935,1033215655,1033215783,128
1360611835,1033217848,4,958,239.5,1360611830439,1360611830631,1033213287,1033213479,192
1360611835,1033217848,5,502,100.4,1360611833062,1360611833190,1033215910,1033216038,128
1360611835,1033217852,6,969,161.5,1360611814245,1360611827429,1033197097,1033210281,13184
1360611835,1033217852,10,8367,836.7,1360611825891,1360611832227,1033208743,1033215079,6336
1360611835,1033217852,21,9128,434.6666667,1360611826274,1360611829154,1033209126,1033212006,2880
1360611835,1033217924,11,3406,309.6363636,1360611830236,1360611830812,1033213160,1033213736,576
1360611835,1033217924,8,3326,415.75,1360611822106,1360611832154,1033205030,1033215078,10048
1360611835,1033217928,5,901,180.2,1360611832857,1360611832985,1033215785,1033215913,128
1360611835,1033217928,6,1982,330.3333333,1360611832984,1360611833304,1033215912,1033216232,320
1360611835,1033217928,7,4623,660.4285714,1360611833366,1360611833558,1033216294,1033216486,192
1360611835,1033217932,5,502,100.4,1360611834068,1360611834580,1033217000,1033217512,512
1360611835,1033217932,6,2768,461.3333333,1360611826387,1360611834259,1033209319,1033217191,7872
1360611839,1033221456,10,3562,356.2,1360611811951,1360611813039,1033194407,1033195495,1088
1360611839,1033221484,8,6375,796.875,1360611812178,1360611812690,1033194662,1033195174,512
1360611840,3966502496,6,2104,350.6666667,1360611814519,1360611837495,3966477015,3966499991,22976
1360611842,3966504188,11,2316,210.5454545,1360611828268,1360611840812,3966490456,3966503000,12544
1360611842,3966504196,9,1067,118.5555556,1360611830884,1360611838756,3966493080,3966500952,7872
1360611842,3966504212,6,4018,669.6666667,1360611834196,1360611834452,3966496408,3966496664,256
1360611843,1033225808,8,4470,558.75,1360611827342,1360611840398,1033210150,1033223206,13056
1360611843,1033225848,4,1105,276.25,1360611836903,1360611837351,1033219751,1033220199,448
1360611843,1033225852,9,8075,897.2222222,1360611837411,1360611837539,1033220263,1033220391,128
1360611843,1033225856,3,567,189,1360611837536,1360611837792,1033220392,1033220648,256
1360611843,1033225856,30,36925,1230.833333,1360611837600,1360611837920,1033220456,1033220776,320
1360611843,1033225856,4,714,178.5,1360611832799,1360611840223,1033215655,1033223079,7424
1360611843,1033225856,5,712,142.4,1360611832926,1360611840798,1033215782,1033223654,7872
1360611843,1033225884,4,789,197.25,1360611834244,1360611837380,1033217128,1033220264,3136
1360611843,1033225884,5,798,159.6,1360611834626,1360611835842,1033217510,1033218726,1216
1360611843,1033225888,6,1851,308.5,1360611834814,1360611835518,1033217702,1033218406,704
1360611843,1033225892,5,897,179.4,1360611835131,1360611835579,1033218023,1033218471,448
1360611843,1033225896,5,1343,268.6,1360611835575,1360611835895,1033218471,1033218791,320
1360611843,1033225936,4,709,177.25,1360611837457,1360611837521,1033220393,1033220457,64
1360611843,1033225936,3,620,206.6666667,1360611837583,1360611837775,1033220519,1033220711,192
1360611843,1033225940,5,827,165.4,1360611832909,1360611840269,1033215849,1033223209,7360
1360611843,1033225964,3,1169,389.6666667,1360611834162,1360611837426,1033217126,1033220390,3264
1360611847,1033229696,1,52,52,1360611819070,1360611819070,1033201766,1033201766,0
1360611850,3966512188,21,23855,1135.952381,1360611834476,1360611843116,3966496664,3966505304,8640
1360611851,1033233860,14,6946,496.1428571,1360611835549,1360611844253,1033218409,1033227113,8704
1360611851,1033233864,6,1696,282.6666667,1360611844632,1360611849944,1033227496,1033232808,5312
1360611851,1033233888,3,172,57.33333333,1360611845182,1360611848446,1033228070,1033231334,3264
1360611851,1033233900,4,555,138.75,1360611849393,1360611850481,1033232293,1033233381,1088
1360611851,1033233928,4,1558,389.5,1360611850392,1360611850584,1033233320,1033233512,192
1360611851,1033233928,4,848,212,1360611850455,1360611850519,1033233383,1033233447,64
1360611851,1033233968,4,773,193.25,1360611848495,1360611848751,1033231463,1033231719,256
1360611851,1033233968,4,774,193.5,1360611848303,1360611848687,1033231271,1033231655,384
1360611851,1033233968,5,3158,631.6,1360611848686,1360611848942,1033231654,1033231910,256
1360611851,1033233972,5,3156,631.2,1360611848809,1360611849065,1033231781,1033232037,256
1360611851,1033233972,7,1742,248.8571429,1360611836845,1360611844397,1033219817,1033227369,7552
1360611858,3966520184,9,1480,164.4444444,1360611849839,1360611851055,3966512023,3966513239,1216
1360611858,3966520184,4,464,116,1360611849839,1360611856751,3966512023,3966518935,6912
1360611858,3966520188,5,2741,548.2,1360611852012,1360611852140,3966514200,3966514328,128
1360611858,3966520192,4,464,116,1360611854438,1360611854630,3966516630,3966516822,192
1360611859,1033241852,5,901,180.2,1360611850659,1360611850787,1033233511,1033233639,128
1360611859,1033241852,6,1987,331.1666667,1360611850659,1360611850979,1033233511,1033233831,320
1360611859,1033241852,21,9587,456.5238095,1360611846563,1360611854243,1033229415,1033237095,7680
1360611859,1033241852,21,10927,520.3333333,1360611846562,1360611856226,1033229414,1033239078,9664
1360611859,1033241860,3,1092,364,1360611850969,1360611851097,1033233829,1033233957,128
1360611859,1033241860,5,1567,313.4,1360611851033,1360611851161,1033233893,1033234021,128
1360611859,1033241860,6,3878,646.3333333,1360611851228,1360611851548,1033234088,1033234408,320
1360611859,1033241864,4,908,227,1360611851413,1360611851541,1033234277,1033234405,128
1360611859,1033241864,19,21947,1155.105263,1360611851544,1360611851864,1033234408,1033234728,320
1360611859,1033241872,10,9933,993.3,1360611856016,1360611856144,1033238888,1033239016,128
1360611859,1033241896,5,762,152.4,1360611856375,1360611856439,1033239271,1033239335,64
1360611859,1033241900,11,11006,1000.545455,1360611853236,1360611853300,1033236136,1033236200,64
1360611859,1033241904,5,455,91,1360611854191,1360611855663,1033237095,1033238567,1472
1360611859,1033241940,4,958,239.5,1360611850507,1360611850635,1033233447,1033233575,128
1360611859,1033241940,6,1981,330.1666667,1360611850698,1360611850954,1033233638,1033233894,256
1360611859,1033241944,3,900,300,1360611850950,1360611851078,1033233894,1033234022,128
1360611859,1033241972,9,4726,525.1111111,1360611844331,1360611858283,1033227303,1033241255,13952
1360611859,1033241980,8,1981,247.625,1360611845156,1360611854500,1033228136,1033237480,9344
1360611859,1033241988,4,1559,389.75,1360611849177,1360611858329,1033232165,1033241317,9152
1360611866,3966528184,36,45791,1271.972222,1360611852145,1360611864945,3966514329,3966527129,12800
1360611866,3966528188,6,1186,197.6666667,1360611849834,1360611862954,3966512022,3966525142,13120
1360611866,3966528196,4,464,116,1360611856931,1360611864931,3966519127,3966527127,8000
1360611866,3966528208,6,2218,369.6666667,1360611854295,1360611861079,3966516503,3966523287,6784
1360611866,3966528208,8,3145,393.125,1360611855189,1360611864917,3966517397,3966527125,9728
1360611867,1033249920,7,4327,618.1428571,1360611864159,1360611864351,1033247079,1033247271,192
1360611867,1033249932,4,669,167.25,1360611866449,1360611866641,1033249381,1033249573,192
1360611867,1033250052,6,1084,180.6666667,1360611863772,1360611863964,1033246824,1033247016,192
1360611867,1033250060,7,5123,731.8571429,1360611853523,1360611860371,1033236583,1033243431,6848
1360611871,1033253636,1,46,46,1360611843898,1360611843898,1033226534,1033226534,0
1360611874,3966536180,16,15393,962.0625,1360611872820,1360611873588,3966535000,3966535768,768
1360611874,3966536192,5,1805,361,1360611873575,1360611873639,3966535767,3966535831,64
1360611874,3966536192,5,516,103.2,1360611865255,1360611873255,3966527447,3966535447,8000
1360611875,1033257820,5,905,181,1360611873090,1360611873346,1033255910,1033256166,256
1360611875,1033257820,4,730,182.5,1360611873026,1360611873154,1033255846,1033255974,128
1360611879,1033261596,1,52,52,1360611850916,1360611850916,1033233512,1033233512,0
1360611882,3966544180,7,3973,567.5714286,1360611872947,1360611874163,3966535127,3966536343,1216
1360611882,3966544180,6,3843,640.5,1360611873395,1360611881139,3966535575,3966543319,7744
1360611882,3966544184,5,764,152.8,1360611878254,1360611880366,3966540438,3966542550,2112
1360611882,3966544188,48,64331,1340.229167,1360611871084,1360611880364,3966533272,3966542552,9280
1360611882,3966544204,7,4635,662.1428571,1360611871066,1360611880346,3966533270,3966542550,9280
1360611883,1033265816,38,49322,1297.947368,1360611870598,1360611879878,1033253414,1033262694,9280
1360611883,1033265832,4,773,193.25,1360611880373,1360611880693,1033263205,1033263525,320
1360611883,1033265872,5,3264,652.8,1360611881677,1360611882253,1033264549,1033265125,576
1360611883,1033265880,9,3367,374.1111111,1360611874632,1360611875080,1033257512,1033257960,448
1360611883,1033265880,23,28470,1237.826087,1360611870854,1360611879814,1033253734,1033262694,8960
1360611883,1033265916,8,2610,326.25,1360611876705,1360611878241,1033259621,1033261157,1536
1360611883,1033265920,5,3156,631.2,1360611880670,1360611880862,1033263590,1033263782,192
1360611883,1033265924,4,773,193.25,1360611880732,1360611880924,1033263656,1033263848,192
1360611890,3966552188,4,464,116,1360611882155,1360611882475,3966544343,3966544663,320
1360611890,3966552196,2,112,56,1360611882597,1360611882853,3966544793,3966545049,256
1360611891,1033273844,5,898,179.6,1360611879914,1360611886634,1033262758,1033269478,6720
1360611891,1033273880,29,16171,557.6206897,1360611876743,1360611886599,1033259623,1033269479,9856
1360611891,1033273880,5,953,190.6,1360611876743,1360611885511,1033259623,1033268391,8768
1360611891,1033273900,13,8661,666.2307692,1360611870643,1360611885427,1033253543,1033268327,14784
1360611891,1033273928,7,1418,202.5714286,1360611875735,1360611885399,1033258663,1033268327,9664
1360611891,1033273932,15,6112,407.4666667,1360611879764,1360611889428,1033262696,1033272360,9664
1360611891,1033273936,16,5559,347.4375,1360611880271,1360611888847,1033263207,1033271783,8576
1360611895,1033277628,2,557,278.5,1360611867268,1360611867332,1033249896,1033249960,64
1360611896,3966558464,82,86126,1050.317073,1360611869209,1360611883097,3966531673,3966545561,13888
1360611899,1033281884,2,110,55,1360611886851,1360611896579,1033269735,1033279463,9728
1360611906,3966568216,7,2156,308,1360611887376,1360611903696,3966549592,3966565912,16320
1360611907,1033289788,4,2908,727,1360611881700,1360611882212,1033264488,1033265000,512
1360611907,1033289836,6,1349,224.8333333,1360611888433,1360611903281,1033271269,1033286117,14848
1360611907,1033289864,7,3382,483.1428571,1360611888917,1360611903253,1033271781,1033286117,14336
1360611907,1033289908,13,7691,591.6153846,1360611892073,1360611903785,1033274981,1033286693,11712
1360611907,1033289916,5,1018,203.6,1360611888865,1360611903393,1033271781,1033286309,14528
1360611907,1033289920,5,960,192,1360611889055,1360611902175,1033271975,1033285095,13120
1360611915,1033297816,32,18573,580.40625,1360611891463,1360611914695,1033274279,1033297511,23232
1360611915,1033297816,8,4365,545.625,1360611903558,1360611912710,1033286374,1033295526,9152
1360611915,1033297816,4,774,193.5,1360611907909,1360611910661,1033290725,1033293477,2752
1360611915,1033297848,5,900,180,1360611912612,1360611912740,1033295460,1033295588,128
1360611915,1033297852,6,1880,313.3333333,1360611912738,1360611912930,1033295590,1033295782,192
1360611915,1033297860,5,3157,631.4,1360611910364,1360611911132,1033293224,1033293992,768
1360611915,1033297864,5,3158,631.6,1360611910740,1360611911892,1033293604,1033294756,1152
1360611915,1033297892,10,1199,119.9,1360611899131,1360611910779,1033282023,1033293671,11648
1360611915,1033297892,6,1590,265,1360611903163,1360611912635,1033286055,1033295527,9472
1360611915,1033297904,5,1605,321,1360611912364,1360611913580,1033295268,1033296484,1216
1360611915,1033297908,4,666,166.5,1360611912492,1360611912556,1033295400,1033295464,64
1360611915,1033297936,31,37881,1221.967742,1360611913229,1360611913677,1033296165,1033296613,448
1360611915,1033297940,19,7097,373.5263158,1360611905674,1360611914570,1033288614,1033297510,8896
1360611915,1033297940,4,774,193.5,1360611906185,1360611910665,1033289125,1033293605,4480
1360611920,3966582476,87,108617,1248.471264,1360611891979,1360611918923,3966554455,3966581399,26944
1360611922,3966584196,6,4208,701.3333333,1360611914851,1360611916771,3966577047,3966578967,1920
1360611922,3966584200,7,1364,194.8571429,1360611912478,1360611919198,3966574678,3966581398,6720
1360611922,3966584200,4,464,116,1360611912478,1360611919198,3966574678,3966581398,6720
1360611922,3966584212,5,2524,504.8,1360611914260,1360611914836,3966576472,3966577048,576
1360611923,1033305860,4,773,193.25,1360611919067,1360611919259,1033301927,1033302119,192
1360611923,1033305868,6,847,141.1666667,1360611916243,1360611916499,1033299111,1033299367,256
1360611923,1033305872,4,714,178.5,1360611912270,1360611918798,1033295142,1033301670,6528
1360611923,1033305872,8,3316,414.5,1360611917133,1360611917453,1033300005,1033300325,320
1360611923,1033305872,2,112,56,1360611920460,1360611920588,1033303332,1033303460,128
1360611923,1033305904,7,2235,319.2857143,1360611913071,1360611920623,1033295975,1033303527,7552
1360611923,1033305936,5,3156,631.2,1360611919182,1360611920398,1033302118,1033303334,1216
1360611923,1033305944,5,942,188.4,1360611916296,1360611916488,1033299240,1033299432,192
1360611923,1033305944,6,739,123.1666667,1360611916424,1360611917512,1033299368,1033300456,1088
1360611923,1033305944,2,192,96,1360611916742,1360611916742,1033299686,1033299686,0
1360611923,1033305944,4,730,182.5,1360611916869,1360611916997,1033299813,1033299941,128
1360611923,1033305948,10,3491,349.1,1360611917378,1360611917826,1033300326,1033300774,448
1360611923,1033305972,5,691,138.2,1360611913256,1360611920552,1033296228,1033303524,7296
1360611930,3966592188,132,157176,1190.727273,1360611872364,1360611929068,3966534552,3966591256,56704
1360611930,3966592200,4,1510,377.5,1360611928543,1360611928607,3966590743,3966590807,64
1360611930,3966592200,4,1388,347,1360611928543,1360611928607,3966590743,3966590807,64
1360611930,3966592200,7,1364,194.8571429,1360611912479,1360611929183,3966574679,3966591383,16704
1360611930,3966592200,4,1089,272.25,1360611928798,1360611928926,3966590998,3966591126,128
1360611930,3966592212,4,1089,272.25,1360611929045,1360611929109,3966591257,3966591321,64
1360611930,3966592216,4,464,116,1360611921681,1360611929169,3966583897,3966591385,7488
1360611930,3966592216,7,4678,668.2857143,1360611914831,1360611923151,3966577047,3966585367,8320
1360611931,1033313872,6,1989,331.5,1360611922959,1360611929679,1033305831,1033312551,6720
1360611931,1033313876,7,3283,469,1360611919051,1360611926667,1033301927,1033309543,7616
1360611931,1033313884,4,530,132.5,1360611927810,1360611927874,1033310694,1033310758,64
1360611931,1033313888,6,1880,313.3333333,1360611924669,1360611924925,1033307557,1033307813,256
1360611931,1033313912,4,486,121.5,1360611928295,1360611928487,1033311207,1033311399,192
1360611931,1033313912,5,1647,329.4,1360611928359,1360611928487,1033311271,1033311399,128
1360611931,1033313912,5,1231,246.2,1360611920613,1360611927781,1033303525,1033310693,7168
1360611931,1033313912,4,1555,388.75,1360611920676,1360611928676,1033303588,1033311588,8000
1360611931,1033313920,7,1019,145.5714286,1360611921116,1360611924636,1033304036,1033307556,3520
1360611931,1033313924,4,731,182.75,1360611918553,1360611926617,1033301477,1033309541,8064
1360611931,1033313948,6,699,116.5,1360611927104,1360611927680,1033310052,1033310628,576
1360611931,1033313952,6,3769,628.1666667,1360611927230,1360611927678,1033310182,1033310630,448
1360611931,1033313964,7,2862,408.8571429,1360611924850,1360611925042,1033307814,1033308006,192
1360611931,1033313968,23,13580,590.4347826,1360611917615,1360611930607,1033300583,1033313575,12992
1360611938,3966600192,28,32057,1144.892857,1360611935208,1360611937576,3966597400,3966599768,2368
1360611938,3966600208,31,25230,813.8709677,1360611930393,1360611932313,3966592601,3966594521,1920
1360611938,3966600212,35,45696,1305.6,1360611927698,1360611935186,3966589910,3966597398,7488
1360611939,1033321592,9,7203,800.3333333,1360611912166,1360611927334,1033294758,1033309926,15168
1360611939,1033321948,5,905,181,1360611931072,1360611938624,1033314020,1033321572,7552
1360611939,1033321952,5,3156,631.2,1360611935038,1360611935230,1033317990,1033318182,192
1360611939,1033321960,4,591,147.75,1360611932023,1360611932343,1033314983,1033315303,320
1360611939,1033321960,6,1018,169.6666667,1360611932279,1360611932471,1033315239,1033315431,192
1360611939,1033321964,2,131,65.5,1360611932468,1360611932468,1033315432,1033315432,0
1360611939,1033321984,5,1380,276,1360611936349,1360611937693,1033319333,1033320677,1344
1360611939,1033321988,5,900,180,1360611936920,1360611937048,1033319908,1033320036,128
1360611939,1033321992,5,718,143.6,1360611921174,1360611932630,1033304166,1033315622,11456
1360611939,1033321992,7,745,106.4285714,1360611937429,1360611938581,1033320421,1033321573,1152
1360611939,1033321996,4,530,132.5,1360611937491,1360611937619,1033320487,1033320615,128
1360611939,1033321996,5,3158,631.6,1360611937683,1360611937875,1033320679,1033320871,192
1360611939,1033322000,4,773,193.25,1360611934476,1360611934540,1033317476,1033317540,64
1360611939,1033322032,9,3362,373.5555556,1360611931309,1360611931501,1033314341,1033314533,192
1360611939,1033322036,5,824,164.8,1360611927080,1360611934504,1033310116,1033317540,7424
1360611939,1033322036,17,6103,359,1360611935147,1360611937067,1033318183,1033320103,1920
1360611939,1033322036,9,3451,383.4444444,1360611931563,1360611931691,1033314599,1033314727,128
1360611939,1033322044,5,1602,320.4,1360611935907,1360611937315,1033318951,1033320359,1408
1360611939,1033322044,9,5567,618.5555556,1360611924960,1360611934496,1033308004,1033317540,9536
1360611939,1033322044,5,961,192.2,1360611928480,1360611936608,1033311524,1033319652,8128
1360611939,1033322076,6,1896,316,1360611936962,1360611937154,1033320038,1033320230,192
1360611939,1033322076,7,2709,387,1360611937216,1360611937344,1033320292,1033320420,128
1360611939,1033322080,4,778,194.5,1360611937279,1360611937343,1033320359,1033320423,64
1360611939,1033322080,6,3769,628.1666667,1360611937343,1360611937343,1033320423,1033320423,0
1360611943,1033325760,1,52,52,1360611917564,1360611917564,1033300324,1033300324,0
1360611946,3966608192,29,33463,1153.896552,1360611935208,1360611943336,3966597400,3966605528,8128
1360611946,3966608192,33,42916,1300.484848,1360611940006,1360611940134,3966602198,3966602326,128
1360611946,3966608212,4,464,116,1360611939285,1360611939349,3966601497,3966601561,64
1360611946,3966608212,57,64204,1126.385965,1360611935060,1360611943316,3966597272,3966605528,8256
1360611947,1033329884,4,1558,389.5,1360611938563,1360611944835,1033321447,1033327719,6272
1360611947,1033329884,6,1931,321.8333333,1360611938944,1360611939264,1033321828,1033322148,320
1360611947,1033329888,5,897,179.4,1360611934911,1360611942783,1033317799,1033325671,7872
1360611947,1033329888,7,1401,200.1428571,1360611931262,1360611940862,1033314150,1033323750,9600
1360611947,1033329888,7,2824,403.4285714,1360611939261,1360611939453,1033322149,1033322341,192
1360611947,1033329892,6,3775,629.1666667,1360611939515,1360611939579,1033322407,1033322471,64
1360611947,1033329892,4,530,132.5,1360611939642,1360611939770,1033322534,1033322662,128
1360611947,1033329892,5,907,181.4,1360611939832,1360611939960,1033322724,1033322852,128
1360611947,1033329896,11,4980,452.7272727,1360611932150,1360611944054,1033315046,1033326950,11904
1360611947,1033329896,5,1268,253.6,1360611939957,1360611940085,1033322853,1033322981,128
1360611947,1033329964,5,899,179.8,1360611938803,1360611938867,1033321767,1033321831,64
1360611947,1033329968,4,778,194.5,1360611939375,1360611939439,1033322343,1033322407,64
1360611947,1033329968,5,653,130.6,1360611939374,1360611939566,1033322342,1033322534,192
1360611947,1033329968,3,906,302,1360611939564,1360611939756,1033322532,1033322724,192
1360611947,1033329980,30,12723,424.1,1360611933281,1360611944225,1033316261,1033327205,10944
1360611947,1033330016,5,932,186.4,1360611937407,1360611940479,1033320423,1033323495,3072
1360611948,3966610432,1,52,52,1360611921847,1360611921847,3966584279,3966584279,0
1360611951,1033333776,1,52,52,1360611925549,1360611925549,1033308325,1033308325,0
1360611954,3966616192,12,3657,304.75,1360611931688,1360611947368,3966593880,3966609560,15680
1360611955,1033338208,4,1315,328.75,1360611943676,1360611950524,1033326884,1033333732,6848
1360611955,1033338212,7,2442,348.8571429,1360611940344,1360611948536,1033323556,1033331748,8192
1360611955,1033338260,21,22140,1054.285714,1360611942472,1360611950472,1033325732,1033333732,8000
1360611962,3966624196,49,53777,1097.489796,1360611955172,1360611960804,3966617368,3966623000,5632
1360611963,1033346172,5,905,181,1360611955424,1360611962656,1033338596,1033345828,7232
1360611963,1033346180,9,3389,376.5555556,1360611959962,1360611960154,1033343142,1033343334,192
1360611963,1033346180,16,5561,347.5625,1360611959962,1360611960346,1033343142,1033343526,384
1360611963,1033346180,5,953,190.6,1360611956696,1360611956888,1033339876,1033340068,192
1360611963,1033346184,8,3088,386,1360611960147,1360611960403,1033343331,1033343587,256
1360611963,1033346208,4,773,193.25,1360611960574,1360611960638,1033343782,1033343846,64
1360611963,1033346212,20,9852,492.6,1360611957754,1360611960058,1033340966,1033343270,2304
1360611963,1033346220,4,1559,389.75,1360611961394,1360611962034,1033344614,1033345254,640
1360611963,1033346224,5,2018,403.6,1360611962286,1360611962670,1033345510,1033345894,384
1360611963,1033346256,9,3134,348.2222222,1360611960205,1360611960397,1033343461,1033343653,192
1360611963,1033346292,4,774,193.5,1360611960490,1360611960682,1033343782,1033343974,192
1360611963,1033346292,5,3158,631.6,1360611960744,1360611961320,1033344036,1033344612,576
1360611963,1033346304,5,900,180,1360611961887,1360611962207,1033345191,1033345511,320
1360611970,3966632196,4,464,116,1360611966757,1360611967141,3966628953,3966629337,384
1360611970,3966632220,32,40489,1265.28125,1360611959309,1360611967437,3966621529,3966629657,8128
1360611970,3966632220,36,40421,1122.805556,1360611955853,1360611967437,3966618073,3966629657,11584
1360611971,1033354160,6,1308,218,1360611966828,1360611967276,1033349988,1033350436,448
1360611971,1033354164,5,900,180,1360611967082,1360611967274,1033350246,1033350438,192
1360611971,1033354164,6,1907,317.8333333,1360611967272,1360611967528,1033350436,1033350692,256
1360611971,1033354164,6,1349,224.8333333,1360611955560,1360611964584,1033338724,1033347748,9024
1360611971,1033354168,3,902,300.6666667,1360611963877,1360611964261,1033347045,1033347429,384
1360611971,1033354172,6,3918,653,1360611964258,1360611964386,1033347430,1033347558,128
1360611971,1033354172,6,2512,418.6666667,1360611956705,1360611964641,1033339877,1033347813,7936
1360611971,1033354212,5,1366,273.2,1360611969401,1360611969657,1033352613,1033352869,256
1360611971,1033354216,5,667,133.4,1360611969655,1360611970679,1033352871,1033353895,1024
1360611971,1033354248,7,2734,390.5714286,1360611967509,1360611970709,1033350757,1033353957,3200
1360611971,1033354252,5,900,180,1360611959761,1360611966609,1033343013,1033349861,6848
1360611971,1033354252,4,591,147.75,1360611956497,1360611964497,1033339749,1033347749,8000
1360611971,1033354276,4,409,102.25,1360611965305,1360611965497,1033348581,1033348773,192
1360611971,1033354280,7,4646,663.7142857,1360611960695,1360611965303,1033343975,1033348583,4608
1360611971,1033354280,5,876,175.2,1360611968951,1360611969335,1033352231,1033352615,384
1360611971,1033354284,12,11489,957.4166667,1360611966195,1360611966963,1033349479,1033350247,768
1360611978,3966640184,14,4070,290.7142857,1360611956273,1360611974321,3966618457,3966636505,18048
1360611978,3966640184,6,2218,369.6666667,1360611965426,1360611973490,3966627610,3966635674,8064
1360611978,3966640192,67,77797,1161.149254,1360611956008,1360611975464,3966618200,3966637656,19456
1360611978,3966640192,7,880,125.7142857,1360611967655,1360611975463,3966629847,3966637655,7808
1360611978,3966640196,18,20356,1130.888889,1360611965346,1360611973538,3966627542,3966635734,8192
1360611979,1033362172,4,778,194.5,1360611970850,1360611971042,1033354022,1033354214,192
1360611979,1033362172,6,3769,628.1666667,1360611970850,1360611971042,1033354022,1033354214,192
1360611979,1033362176,7,716,102.2857143,1360611971038,1360611972574,1033354214,1033355750,1536
1360611979,1033362188,7,5123,731.8571429,1360611964626,1360611972690,1033347814,1033355878,8064
1360611979,1033362216,3,736,245.3333333,1360611968885,1360611976757,1033352101,1033359973,7872
1360611979,1033362220,6,4355,725.8333333,1360611965811,1360611974643,1033349031,1033357863,8832
1360611979,1033362248,6,646,107.6666667,1360611970966,1360611971990,1033354214,1033355238,1024
1360611979,1033362292,5,721,144.2,1360611976681,1360611976745,1033359973,1033360037,64
1360611987,1033370212,14,11994,856.7142857,1360611976827,1360611985915,1033360039,1033369127,9088
1360611987,1033370224,6,699,116.5,1360611970796,1360611980716,1033354020,1033363940,9920
1360611991,1033374024,1,52,52,1360611962997,1360611962997,1033346021,1033346021,0
1360611994,3966656188,9,3540,393.3333333,1360611988590,1360611992686,3966650778,3966654874,4096
1360611994,3966656192,52,66666,1282.038462,1360611985385,1360611993769,3966647577,3966655961,8384
1360611994,3966656192,65,87258,1342.430769,1360611986535,1360611993767,3966648727,3966655959,7232
1360611996,1033378356,7,3286,469.4285714,1360611992272,1360611992400,1033374628,1033374756,128
1360611996,1033378360,8,3402,425.25,1360611992462,1360611992718,1033374822,1033375078,256
1360611996,1033378360,8,3337,417.125,1360611992525,1360611992909,1033374885,1033375269,384
1360611996,1033378364,9,3134,348.2222222,1360611992906,1360611993162,1033375270,1033375526,256
1360611996,1033378384,4,774,193.5,1360611993204,1360611993332,1033375588,1033375716,128
1360611996,1033378428,7,3279,468.4285714,1360611992136,1360611992264,1033374564,1033374692,128
1360611996,1033378428,16,6903,431.4375,1360611992200,1360611993032,1033374628,1033375460,832
1360611996,1033378432,5,905,181,1360611988485,1360611995525,1033370917,1033377957,7040
1360611996,1033378472,5,4532,906.4,1360611993308,1360611994908,1033375780,1033377380,1600
1360611996,1033378472,7,889,127,1360611989596,1360611990556,1033372068,1033373028,960
1360611996,1033378480,6,689,114.8333333,1360611990039,1360611990551,1033372519,1033373031,512
1360611996,1033378480,8,3434,429.25,1360611990102,1360611993110,1033372582,1033375590,3008
1360611996,1033378480,5,1634,326.8,1360611990293,1360611991957,1033372773,1033374437,1664
1360611996,1033378480,6,1560,260,1360611990611,1360611991123,1033373091,1033373603,512
1360611996,1033378484,4,773,193.25,1360611994257,1360611994577,1033376741,1033377061,320
1360611996,1033378484,5,3156,631.2,1360611994575,1360611994831,1033377059,1033377315,256
1360611999,1033381864,1,52,52,1360611971411,1360611971411,1033354275,1033354275,0
1360612002,3966664188,25,17317,692.68,1360611986542,1360611997678,3966648730,3966659866,11136
1360612002,3966664192,33,42195,1278.636364,1360611987882,1360611995626,3966650074,3966657818,7744
1360612002,3966664196,7,3661,523,1360611986531,1360611995619,3966648727,3966657815,9088
1360612002,3966664212,11,10444,949.4545455,1360611988117,1360611995605,3966650329,3966657817,7488
1360612003,1033386208,4,232,58,1360611999100,1360612002236,1033382308,1033385444,3136
1360612003,1033386212,5,1726,345.2,1360611995514,1360611996666,1033378726,1033379878,1152
1360612003,1033386212,10,10012,1001.2,1360611999480,1360611999544,1033382692,1033382756,64
1360612003,1033386220,13,6026,463.5384615,1360611991919,1360612001327,1033375139,1033384547,9408
1360612003,1033386220,5,790,158,1360611988655,1360611996783,1033371875,1033380003,8128
1360612003,1033386252,7,3328,475.4285714,1360611998415,1360611998927,1033381667,1033382179,512
1360612003,1033386284,5,899,179.8,1360611995185,1360611995313,1033378469,1033378597,128
1360612003,1033386284,6,2103,350.5,1360611995312,1360611995440,1033378596,1033378724,128
1360612003,1033386288,7,1854,264.8571429,1360611999724,1360612000428,1033383012,1033383716,704
1360612003,1033386288,7,3963,566.1428571,1360611995948,1360611996588,1033379236,1033379876,640
1360612004,1033386328,5,900,180,1360611998957,1360611999085,1033381285,1033381413,128
1360612004,1033386328,4,409,102.25,1360611998893,1360611998957,1033381221,1033381285,64
1360612010,3966672184,6,816,136,1360612000561,1360612008049,3966662745,3966670233,7488
1360612010,3966672188,11,10406,946,1360612006830,1360612006894,3966669018,3966669082,64
1360612010,3966672192,10,2024,202.4,1360611992294,1360612005670,3966654486,3966667862,13376
1360612011,1033394260,7,4456,636.5714286,1360612006663,1360612007623,1033389923,1033390883,960
1360612011,1033394264,7,4422,631.7142857,1360611995078,1360612004806,1033378342,1033388070,9728
1360612011,1033394272,9,3371,374.5555556,1360612007935,1360612008255,1033391207,1033391527,320
1360612011,1033394272,8,4769,596.125,1360612008125,1360612009405,1033391397,1033392677,1280
1360612011,1033394272,5,781,156.2,1360612000571,1360612008827,1033383843,1033392099,8256
1360612011,1033394304,2,98,49,1360612009372,1360612009500,1033392676,1033392804,128
1360612012,1033394340,10,8268,826.8,1360612008162,1360612008866,1033390502,1033391206,704
1360612012,1033394344,9,3378,375.3333333,1360612008733,1360612009053,1033391077,1033391397,320
1360612012,1033394344,7,5756,822.2857143,1360612005148,1360612008796,1033387492,1033391140,3648
1360612012,1033394344,5,905,181,1360612005148,1360612005532,1033387492,1033387876,384
1360612012,1033394348,10,6208,620.8,1360612009367,1360612010199,1033391715,1033392547,832
1360612012,1033394376,5,953,190.6,1360612006459,1360612006651,1033388835,1033389027,192
1360612012,1033394380,7,1714,244.8571429,1360612006840,1360612007736,1033389220,1033390116,896
1360612015,1033398116,1,52,52,1360611988439,1360611988439,1033371555,1033371555,0
1360612018,3966680184,45,59890,1330.888889,1360612012465,1360612012657,3966674649,3966674841,192
1360612018,3966680184,8,576,72,1360612010160,1360612010672,3966672344,3966672856,512
1360612018,3966680188,4,464,116,1360612017836,1360612017900,3966680024,3966680088,64
1360612018,3966680188,17,19510,1147.647059,1360612013996,1360612016172,3966676184,3966678360,2176
1360612018,3966680188,10,6276,627.6,1360612003947,1360612012587,3966666135,3966674775,8640
1360612018,3966680192,14,6652,475.1428571,1360611995944,1360612015848,3966658136,3966678040,19904
1360612018,3966680196,24,29716,1238.166667,1360612016422,1360612016550,3966678618,3966678746,128
1360612019,1033402220,24,30003,1250.125,1360612011568,1360612012848,1033394788,1033396068,1280
1360612019,1033402224,16,16580,1036.25,1360612003949,1360612012781,1033387173,1033396005,8832
1360612019,1033402224,6,1349,224.8333333,1360612004523,1360612012779,1033387747,1033396003,8256
1360612019,1033402260,8,3325,415.625,1360612016329,1360612016521,1033399589,1033399781,192
1360612019,1033402264,5,890,178,1360612016836,1360612017028,1033400100,1033400292,192
1360612019,1033402264,8,3332,416.5,1360612016770,1360612016962,1033400034,1033400226,192
1360612019,1033402268,6,1349,224.8333333,1360612014145,1360612015681,1033397413,1033398949,1536
1360612019,1033402272,9,3461,384.5555556,1360612017086,1360612017470,1033400358,1033400742,384
1360612019,1033402304,18,5710,317.2222222,1360612007198,1360612016798,1033390502,1033400102,9600
1360612020,1033402344,8,3402,425.25,1360612017694,1360612017950,1033400038,1033400294,256
1360612020,1033402344,6,2512,418.6666667,1360612006493,1360612013725,1033388837,1033396069,7232
1360612020,1033402344,12,3266,272.1666667,1360612018076,1360612019164,1033400420,1033401508,1088
1360612020,1033402344,17,14015,824.4117647,1360612006812,1360612015708,1033389156,1033398052,8896
1360612020,1033402348,17,6980,410.5882353,1360612018073,1360612019161,1033400421,1033401509,1088
1360612020,1033402348,3,721,240.3333333,1360612018391,1360612018711,1033400739,1033401059,320
1360612020,1033402348,5,2459,491.8,1360612015383,1360612015703,1033397731,1033398051,320
1360612023,1033405936,2,1478,739,1360611996620,1360611996812,1033379556,1033379748,192
1360612026,3966688184,38,40134,1056.157895,1360612012466,1360612025266,3966674650,3966687450,12800
1360612026,3966688184,28,29697,1060.607143,1360612020401,1360612021233,3966682585,3966683417,832
1360612026,3966688184,9,6174,686,1360612020720,1360612020912,3966682904,3966683096,192
1360612026,3966688184,10,6226,622.6,1360612020848,1360612020976,3966683032,3966683160,128
1360612026,3966688184,10,6226,622.6,1360612020911,1360612021039,3966683095,3966683223,128
1360612026,3966688184,4,464,116,1360612020975,1360612021103,3966683159,3966683287,128
1360612026,3966688184,4,464,116,1360612021234,1360612021362,3966683418,3966683546,128
1360612026,3966688188,8,1360,170,1360612021932,1360612022508,3966684120,3966684696,576
1360612026,3966688188,37,37032,1000.864865,1360612014315,1360612025259,3966676503,3966687447,10944
1360612026,3966688196,12,8734,727.8333333,1360612016485,1360612025253,3966678681,3966687449,8768
1360612026,3966688196,5,1692,338.4,1360612020645,1360612020709,3966682841,3966682905,64
1360612026,3966688196,9,6174,686,1360612020644,1360612020772,3966682840,3966682968,128
1360612026,3966688196,16,12236,764.75,1360612020708,1360612020964,3966682904,3966683160,256
1360612026,3966688196,4,464,116,1360612021219,1360612021347,3966683415,3966683543,128
1360612026,3966688208,27,31985,1184.62963,1360612017498,1360612025754,3966679706,3966687962,8256
1360612026,3966688208,33,42916,1300.484848,1360612025305,1360612025497,3966687513,3966687705,192
1360612026,3966688208,4,464,116,1360612021720,1360612021784,3966683928,3966683992,64
1360612026,3966688208,11,1682,152.9090909,1360612021912,1360612023320,3966684120,3966685528,1408
1360612026,3966688208,92,93612,1017.521739,1360612003095,1360612025751,3966665303,3966687959,22656
1360612027,1033410252,4,775,193.75,1360612019534,1360612019662,1033402786,1033402914,128
1360612027,1033410256,5,3159,631.8,1360612019662,1360612019854,1033402918,1033403110,192
1360612027,1033410256,6,2768,461.3333333,1360612019661,1360612019725,1033402917,1033402981,64
1360612027,1033410256,4,1555,388.75,1360612020106,1360612020362,1033403362,1033403618,256
1360612027,1033410260,4,1559,389.75,1360612020361,1360612020617,1033403621,1033403877,256
1360612027,1033410264,6,960,160,1360612020806,1360612024454,1033404070,1033407718,3648
1360612027,1033410264,5,653,130.6,1360612024454,1360612024646,1033407718,1033407910,192
1360612027,1033410284,7,3360,480,1360612024561,1360612025009,1033407845,1033408293,448
1360612027,1033410284,5,901,180.2,1360612021040,1360612021552,1033404324,1033404836,512
1360612027,1033410284,4,530,132.5,1360612024687,1360612024815,1033407971,1033408099,128
1360612027,1033410292,6,957,159.5,1360612013737,1360612021993,1033397029,1033405285,8256
1360612027,1033410296,6,1347,224.5,1360612025509,1360612026021,1033408805,1033409317,512
1360612028,1033410328,5,3263,652.6,1360612020460,1360612020652,1033402788,1033402980,192
1360612028,1033410340,3,643,214.3333333,1360612025503,1360612025631,1033407843,1033407971,128
1360612028,1033410368,6,1960,326.6666667,1360612022470,1360612022982,1033404838,1033405350,512
1360612028,1033410372,13,4612,354.7692308,1360612022976,1360612025280,1033405348,1033407652,2304
1360612028,1033410376,4,591,147.75,1360612015357,1360612021693,1033397733,1033404069,6336
1360612028,1033410380,11,3226,293.2727273,1360612018615,1360612020407,1033400995,1033402787,1792
1360612034,3966696188,4,464,116,1360612021742,1360612027886,3966683930,3966690074,6144
1360612034,3966696196,4,464,116,1360612021734,1360612027878,3966683930,3966690074,6144
1360612034,3966696212,12,2230,185.8333333,1360612023062,1360612031766,3966685274,3966693978,8704
1360612035,1033417972,1,52,52,1360612008743,1360612008743,1033391715,1033391715,0
1360612035,1033418012,8,3082,385.25,1360612009538,1360612009794,1033392550,1033392806,256
1360612036,1033418324,6,1464,244,1360612025394,1360612034034,1033407718,1033416358,8640
1360612036,1033418368,4,894,223.5,1360612015749,1360612028293,1033398117,1033410661,12544
1360612036,1033418368,15,8069,537.9333333,1360612023940,1360612034052,1033406308,1033416420,10112
1360612036,1033418412,8,791,98.875,1360612026201,1360612035481,1033408613,1033417893,9280
1360612042,3966704196,43,55538,1291.581395,1360612026278,1360612038054,3966688474,3966700250,11776
1360612043,1033426308,28,31508,1125.285714,1360612024407,1360612041047,1033407715,1033424355,16640
1360612044,1033426392,4,1316,329,1360612030123,1360612037995,1033412515,1033420387,7872
1360612044,1033426404,5,590,118,1360612026400,1360612035808,1033408804,1033418212,9408
1360612047,1033429960,2,657,328.5,1360612019253,1360612019829,1033402213,1033402789,576
1360612051,1033434256,4,775,193.75,1360612047242,1360612047498,1033430498,1033430754,256
1360612051,1033434300,5,901,180.2,1360612048798,1360612049054,1033432098,1033432354,256
1360612051,1033434300,9,2238,248.6666667,1360612049056,1360612049760,1033432356,1033433060,704
1360612051,1033434300,6,554,92.33333333,1360612049055,1360612049567,1033432355,1033432867,512
1360612051,1033434308,6,830,138.3333333,1360612049752,1360612050584,1033433060,1033433892,832
1360612051,1033434308,4,937,234.25,1360612049752,1360612049944,1033433060,1033433252,192
1360612051,1033434308,3,1093,364.3333333,1360612049751,1360612050071,1033433059,1033433379,320
1360612051,1033434312,5,901,180.2,1360612049877,1360612050069,1033433189,1033433381,192
1360612051,1033434312,4,666,166.5,1360612050004,1360612050260,1033433316,1033433572,256
1360612051,1033434312,6,1943,323.8333333,1360612050196,1360612050516,1033433508,1033433828,320
1360612051,1033434312,5,1323,264.6,1360612050196,1360612050324,1033433508,1033433636,128
1360612051,1033434312,4,908,227,1360612050196,1360612050324,1033433508,1033433636,128
1360612051,1033434312,24,30109,1254.541667,1360612050387,1360612050707,1033433699,1033434019,320
1360612052,1033434332,7,2824,403.4285714,1360612051559,1360612051687,1033433891,1033434019,128
1360612052,1033434336,5,1380,276,1360612047717,1360612049637,1033430053,1033431973,1920
1360612052,1033434344,6,3210,535,1360612048413,1360612048861,1033430757,1033431205,448
1360612052,1033434352,6,950,158.3333333,1360612048917,1360612049621,1033431269,1033431973,704
1360612052,1033434376,4,856,214,1360612049662,1360612049918,1033432038,1033432294,256
1360612052,1033434376,5,3158,631.6,1360612049724,1360612050108,1033432100,1033432484,384
1360612052,1033434388,5,946,189.2,1360612050865,1360612051121,1033433253,1033433509,256
1360612058,3966720204,5,2741,548.2,1360612051230,1360612051294,3966713434,3966713498,64
1360612058,3966720204,5,516,103.2,1360612055579,1360612055707,3966717783,3966717911,128
1360612059,1033442220,3,480,160,1360612050866,1360612053938,1033434086,1033437158,3072
1360612059,1033442220,6,870,145,1360612050798,1360612052142,1033434018,1033435362,1344
1360612059,1033442228,10,4619,461.9,1360612043623,1360612057191,1033426851,1033440419,13568
1360612059,1033442232,27,14004,518.6666667,1360612044004,1360612055204,1033427236,1033438436,11200
1360612059,1033442236,6,3027,504.5,1360612048352,1360612057248,1033431588,1033440484,8896
1360612059,1033442256,22,11323,514.6818182,1360612044811,1360612053323,1033428067,1033436579,8512
1360612059,1033442260,5,884,176.8,1360612048713,1360612055177,1033431973,1033438437,6464
1360612059,1033442276,10,1306,130.6,1360612050744,1360612053304,1033434020,1033436580,2560
1360612059,1033442276,12,8940,745,1360612050744,1360612052088,1033434020,1033435364,1344
1360612059,1033442304,12,11077,923.0833333,1360612051996,1360612054556,1033435300,1033437860,2560
1360612060,1033442336,6,1383,230.5,1360612054950,1360612058022,1033437286,1033440358,3072
1360612066,3966728180,5,764,152.8,1360612049588,1360612058100,3966711768,3966720280,8512
1360612066,3966728184,4,464,116,1360612050611,1360612058099,3966712795,3966720283,7488
1360612066,3966728188,8,1725,215.625,1360612049195,1360612058091,3966711383,3966720279,8896
1360612068,1033450404,7,4327,618.1428571,1360612066849,1360612066977,1033449253,1033449381,128
1360612068,1033450444,4,530,132.5,1360612052920,1360612062008,1033435364,1033444452,9088
1360612068,1033450472,6,1084,180.6666667,1360612065499,1360612065563,1033447971,1033448035,64
1360612076,1033458396,11,10452,950.1818182,1360612060711,1360612068071,1033443107,1033450467,7360
1360612082,3966744208,17,19760,1162.352941,1360612078424,1360612078616,3966740632,3966740824,192
1360612082,3966744208,21,24598,1171.333333,1360612078744,1360612080856,3966740952,3966743064,2112
1360612082,3966744212,5,516,103.2,1360612067093,1360612074069,3966729305,3966736281,6976
1360612083,1033466304,4,775,193.75,1360612076381,1360612076509,1033459685,1033459813,128
1360612083,1033466304,5,3158,631.6,1360612076508,1360612076700,1033459812,1033460004,192
1360612083,1033466304,5,901,180.2,1360612076636,1360612076764,1033459940,1033460068,128
1360612084,1033466332,10,7436,743.6,1360612078504,1360612078824,1033460836,1033461156,320
1360612084,1033466332,7,1004,143.4285714,1360612078758,1360612079462,1033461090,1033461794,704
1360612084,1033466340,6,1413,235.5,1360612079456,1360612082272,1033461796,1033464612,2816
1360612084,1033466340,7,1915,273.5714286,1360612074464,1360612082208,1033456804,1033464548,7744
1360612084,1033466376,4,775,193.75,1360612076796,1360612076924,1033459172,1033459300,128
1360612084,1033466376,5,3159,631.8,1360612076986,1360612077114,1033459362,1033459490,128
1360612084,1033466384,6,1945,324.1666667,1360612077938,1360612078066,1033460322,1033460450,128
1360612084,1033466388,5,901,180.2,1360612078129,1360612078257,1033460517,1033460645,128
1360612084,1033466388,6,1983,330.5,1360612078256,1360612078576,1033460644,1033460964,320
1360612084,1033466388,12,5381,448.4166667,1360612078256,1360612078704,1033460644,1033461092,448
1360612090,3966752220,6,1064,177.3333333,1360612077326,1360612084174,3966739546,3966746394,6848
1360612090,3966752220,6,1064,177.3333333,1360612077326,1360612084174,3966739546,3966746394,6848
1360612092,1033474372,4,508,127,1360612078529,1360612086401,1033460901,1033468773,7872
1360612092,1033474372,6,1262,210.3333333,1360612078656,1360612090176,1033461028,1033472548,11520
1360612092,1033474380,22,12420,564.5454545,1360612075064,1360612084216,1033457444,1033466596,9152
1360612092,1033474380,22,11007,500.3181818,1360612075383,1360612084215,1033457763,1033466595,8832
1360612092,1033474412,6,3025,504.1666667,1360612077335,1360612084183,1033459747,1033466595,6848
1360612092,1033474428,7,2275,325,1360612079305,1360612086409,1033461733,1033468837,7104
1360612098,3966760184,12,5887,490.5833333,1360612085168,1360612095792,3966747352,3966757976,10624
1360612098,3966760192,23,17547,762.9130435,1360612084395,1360612095147,3966746587,3966757339,10752
1360612098,3966760196,9,2583,287,1360612084901,1360612095525,3966747097,3966757721,10624
1360612107,1033490312,3,168,56,1360612093077,1360612100693,1033476389,1033484005,7616
1360612116,1033498412,4,184,46,1360612113815,1360612113815,1033496227,1033496227,0
1360612122,3966784184,171,238391,1394.099415,1360612085104,1360612115952,3966747288,3966778136,30848
1360612122,3966784192,37,42446,1147.189189,1360612115755,1360612119211,3966777947,3966781403,3456
1360612122,3966784192,33,42773,1296.151515,1360612115818,1360612116010,3966778010,3966778202,192
1360612122,3966784212,7,3283,469,1360612116054,1360612117142,3966778266,3966779354,1088
1360612124,1033506392,23,28470,1237.826087,1360612115562,1360612123178,1033497954,1033505570,7616
1360612124,1033506400,6,1862,310.3333333,1360612116197,1360612117221,1033498597,1033499621,1024
1360612124,1033506400,19,9861,519,1360612120036,1360612122660,1033502436,1033505060,2624
1360612124,1033506400,7,3042,434.5714286,1360612120163,1360612120547,1033502563,1033502947,384
1360612124,1033506412,4,901,225.25,1360612117720,1360612117848,1033500132,1033500260,128
1360612124,1033506432,4,731,182.75,1360612117955,1360612118083,1033500387,1033500515,128
1360612124,1033506436,2,116,58,1360612113600,1360612116800,1033496036,1033499236,3200
1360612124,1033506448,37,47896,1294.486486,1360612115251,1360612123123,1033497699,1033505571,7872
1360612124,1033506472,5,903,180.6,1360612115932,1360612116700,1033498404,1033499172,768
1360612124,1033506480,4,773,193.25,1360612120469,1360612120597,1033502949,1033503077,128
1360612124,1033506480,5,4530,906,1360612120596,1360612122068,1033503076,1033504548,1472
1360612124,1033506484,7,2564,366.2857143,1360612117581,1360612117709,1033500065,1033500193,128
1360612124,1033506484,6,1586,264.3333333,1360612117902,1360612118350,1033500386,1033500834,448
1360612124,1033506516,18,9452,525.1111111,1360612118768,1360612120048,1033501284,1033502564,1280
1360612124,3966786716,1,46,46,1360612098011,1360612098011,3966760727,3966760727,0
1360612124,3966786736,1,46,46,1360612099083,1360612099083,3966761819,3966761819,0
1360612130,3966792196,4,464,116,1360612118758,1360612125158,3966780954,3966787354,6400
1360612130,3966792196,49,58513,1194.142857,1360612115749,1360612125157,3966777945,3966787353,9408
1360612130,3966792216,112,126521,1129.651786,1360612115281,1360612128273,3966777497,3966790489,12992
1360612130,3966792216,12,4913,409.4166667,1360612115345,1360612124049,3966777561,3966786265,8704
1360612130,3966792216,47,62904,1338.382979,1360612115409,1360612123153,3966777625,3966785369,7744
1360612132,1033514388,5,899,179.8,1360612131761,1360612131889,1033514149,1033514277,128
1360612132,1033514436,4,775,193.75,1360612130237,1360612130365,1033512673,1033512801,128
1360612132,1033514464,11,8533,775.7272727,1360612115300,1360612125028,1033497764,1033507492,9728
1360612132,1033514520,10,5289,528.9,1360612130283,1360612131435,1033512803,1033513955,1152
1360612139,1033522156,9,3463,384.7777778,1360612113069,1360612113453,1033496225,1033496609,384
1360612140,1033522392,6,2001,333.5,1360612131883,1360612132139,1033514275,1033514531,256
1360612140,1033522408,6,3777,629.5,1360612136986,1360612137114,1033519394,1033519522,128
1360612140,1033522432,7,3295,470.7142857,1360612134274,1360612134850,1033516706,1033517282,576
1360612140,1033522444,4,714,178.5,1360612130166,1360612137078,1033512610,1033519522,6912
1360612140,1033522448,7,1020,145.7142857,1360612130289,1360612134257,1033512737,1033516705,3968
1360612140,1033522448,4,666,166.5,1360612130357,1360612137077,1033512805,1033519525,6720
1360612140,1033522472,30,14648,488.2666667,1360612119515,1360612137051,1033501987,1033519523,17536
1360612140,1033522476,9,4308,478.6666667,1360612132119,1360612136919,1033514595,1033519395,4800
1360612140,1033522480,7,3823,546.1428571,1360612136339,1360612136403,1033518819,1033518883,64
1360612140,1033522480,4,530,132.5,1360612136465,1360612136529,1033518945,1033519009,64
1360612140,1033522488,3,616,205.3333333,1360612136908,1360612137100,1033519396,1033519588,192
1360612140,1033522524,6,3022,503.6666667,1360612129895,1360612139111,1033512419,1033521635,9216
1360612146,3966808256,10,1278,127.8,1360612130216,1360612141992,3966792472,3966804248,11776
1360612146,3966808256,9,978,108.6666667,1360612130280,1360612142120,3966792536,3966804376,11840
1360612146,3966808268,8,674,84.25,1360612129948,1360612145372,3966792216,3966807640,15424
1360612148,1033530452,11,3786,344.1818182,1360612134829,1360612145517,1033517281,1033527969,10688
1360612148,1033530484,6,276,46,1360612140047,1360612146191,1033522531,1033528675,6144
1360612148,1033530496,4,530,132.5,1360612137091,1360612145027,1033519587,1033527523,7936
1360612151,1033534016,3,2904,968,1360612123705,1360612128121,1033506721,1033511137,4416
1360612156,1033538396,5,838,167.6,1360612151462,1360612154726,1033533858,1033537122,3264
1360612156,1033538400,5,292,58.4,1360612140067,1360612149411,1033522467,1033531811,9344
1360612156,1033538416,2,92,46,1360612149649,1360612154257,1033532065,1033536673,4608
1360612156,1033538528,7,910,130,1360612145956,1360612155044,1033528484,1033537572,9088
1360612156,1033538536,6,352,58.66666667,1360612139227,1360612149659,1033521763,1033532195,10432
1360612156,1033538536,6,851,141.8333333,1360612147355,1360612155099,1033529891,1033537635,7744
1360612164,1033546400,4,774,193.5,1360612156129,1360612156257,1033538529,1033538657,128
1360612164,1033546404,5,3157,631.4,1360612156510,1360612156638,1033538914,1033539042,128
1360612164,1033546404,7,1021,145.8571429,1360612156574,1360612161182,1033538978,1033543586,4608
1360612164,1033546408,5,900,180,1360612157273,1360612157337,1033539681,1033539745,64
1360612164,1033546408,14,7658,547,1360612149209,1360612161881,1033531617,1033544289,12672
1360612164,1033546412,4,778,194.5,1360612160916,1360612163092,1033543328,1033545504,2176
1360612164,1033546412,6,1869,311.5,1360612157336,1360612157784,1033539748,1033540196,448
1360612164,1033546444,30,36910,1230.333333,1360612162228,1360612162740,1033544672,1033545184,512
1360612164,1033546452,6,3706,617.6666667,1360612154672,1360612156080,1033537124,1033538532,1408
1360612164,1033546484,7,4423,631.8571429,1360612156304,1360612163344,1033538788,1033545828,7040
1360612164,1033546492,36,21538,598.2777778,1360612149127,1360612163271,1033531619,1033545763,14144
1360612164,1033546492,6,1989,331.5,1360612161159,1360612161479,1033543651,1033543971,320
1360612164,1033546516,3,1092,364,1360612161453,1360612161901,1033543969,1033544417,448
1360612164,1033546520,5,2817,563.4,1360612161899,1360612162027,1033544419,1033544547,128
1360612167,1033550160,2,92,46,1360612142508,1360612164716,1033525668,1033547876,22208
1360612170,3966832316,5,524,104.8,1360612156335,1360612165359,3966818651,3966827675,9024
1360612170,3966832320,8,1416,177,1360612156331,1360612163307,3966818651,3966825627,6976
1360612172,1033554496,3,138,46,1360612160897,1360612164417,1033543393,1033546913,3520
1360612175,1033558160,1,52,52,1360612147689,1360612147689,1033530849,1033530849,0
1360612175,1033558184,1,52,52,1360612148241,1360612148241,1033531425,1033531425,0
1360612180,3966842864,4,773,193.25,1360612155786,1360612161738,3966818650,3966824602,5952
1360612183,1033566108,6,2750,458.3333333,1360612157085,1360612160221,1033540193,1033543329,3136
1360612187,1033570084,5,3717,743.4,1360612160312,1360612160312,1033543396,1033543396,0
1360612187,1033570088,3,478,159.3333333,1360612160560,1360612160624,1033543648,1033543712,64
1360612191,1033574064,6,2561,426.8333333,1360612163082,1360612163658,1033546146,1033546722,576
1360612191,1033574068,40,50978,1274.45,1360612163206,1360612164742,1033546274,1033547810,1536
1360612191,1033574184,26,32390,1245.769231,1360612163088,1360612188432,1033546272,1033571616,25344
1360612223,1033606220,3,4278,1426,1360612198445,1360612218413,1033581665,1033601633,19968
1360612228,1033610536,2,104,52,1360612220696,1360612224472,1033603232,1033607008,3776
1360612236,1033618648,5,368,73.6,1360612233897,1360612235753,1033616545,1033618401,1856
1360612244,1033626512,2,158,79,1360612238000,1360612242224,1033620512,1033624736,4224
1360612252,1033634544,2,104,52,1360612232016,1360612247184,1033614560,1033629728,15168
1360612256,1033638348,3,4278,1426,1360612229267,1360612249299,1033611615,1033631647,20032
1360612268,1033650868,2,158,79,1360612250315,1360612267275,1033633183,1033650143,16960
1360612283,1033666304,2,2852,1426,1360612258329,1360612268377,1033641633,1033651681,10048
1360612284,1033666600,4,208,52,1360612280794,1360612282650,1033663394,1033665250,1856
1360612292,1033674680,2,104,52,1360612284680,1360612288904,1033667360,1033671584,4224
1360612316,1033698668,2,104,52,1360612297364,1360612314260,1033680032,1033696928,16896
1360612328,1033710332,1,79,79,1360612301669,1360612301669,1033684001,1033684001,0
1360612375,1033758308,1,52,52,1360612347411,1360612347411,1033730719,1033730719,0
1360612396,1033778712,14,14571,1040.785714,1360612382183,1360612388327,1033764895,1033771039,6144
1360612408,1033790316,15,3228,215.2,1360612380339,1360612386419,1033762655,1033768735,6080
1360612408,1033790348,1,52,52,1360612381075,1360612381075,1033763423,1033763423,0
1360612428,1033810752,31,35313,1139.129032,1360612411709,1360612422205,1033794461,1033804957,10496
1360612428,1033810800,4,356,89,1360612414800,1360612422160,1033797600,1033804960,7360
1360612432,1033814344,22,12564,571.0909091,1360612404373,1360612411029,1033786717,1033793373,6656
1360612432,1033814348,1,46,46,1360612404432,1360612404432,1033786780,1033786780,0
1360612432,1033814352,10,1670,167,1360612404686,1360612412110,1033787038,1033794462,7424
1360612432,1033814360,1,52,52,1360612405064,1360612405064,1033787424,1033787424,0
1360612436,1033818732,5,553,110.6,1360612434067,1360612434195,1033816799,1033816927,128
1360612444,1033826720,52,67966,1307.038462,1360612436317,1360612442077,1033819037,1033824797,5760
1360612444,1033826760,20,21611,1080.55,1360612434358,1360612441462,1033817118,1033824222,7104
1360612444,1033826760,16,16621,1038.8125,1360612434422,1360612441974,1033817182,1033824734,7552
1360612444,1033826796,80,108455,1355.6875,1360612436371,1360612442003,1033819167,1033824799,5632
1360612444,1033826808,4,704,176,1360612433862,1360612440006,1033816670,1033822814,6144
1360612444,1033826808,16,16782,1048.875,1360612434116,1360612442180,1033816924,1033824988,8064
1360612444,1033826836,36,45451,1262.527778,1360612434282,1360612441898,1033817118,1033824734,7616
1360612448,1033830440,1,46,46,1360612422069,1360612422069,1033804509,1033804509,0
1360612472,1033854704,1,52,52,1360612444143,1360612444143,1033826847,1033826847,0
1360612472,1033854704,1,52,52,1360612444142,1360612444142,1033826846,1033826846,0
1360612472,1033854704,1,52,52,1360612444142,1360612444142,1033826846,1033826846,0
1360612472,1033854704,1,52,52,1360612444142,1360612444142,1033826846,1033826846,0
1360612472,1033854816,1,52,52,1360612444029,1360612444029,1033826845,1033826845,0
1360612472,1033854820,1,52,52,1360612444024,1360612444024,1033826844,1033826844,0
1360612484,1033867072,5,1630,326,1360612474367,1360612482559,1033857439,1033865631,8192
1360612484,1033867148,5,1628,325.6,1360612474290,1360612480434,1033857438,1033863582,6144
1360612524,1033907184,4,382,95.5,1360612513806,1360612519950,1033896990,1033903134,6144
1360612540,1033923200,14,15788,1127.714286,1360612524733,1360612531901,1033907933,1033915101,7168
1360612540,1033923272,12,10756,896.3333333,1360612524660,1360612531828,1033907932,1033915100,7168
1360612540,1033923276,8,4703,587.875,1360612524654,1360612531822,1033907930,1033915098,7168
1360612540,1033923276,14,14130,1009.285714,1360612524658,1360612531826,1033907934,1033915102,7168
1360612556,1033938924,1,46,46,1360612529423,1360612529423,1033912347,1033912347,0
1360612564,1033947216,26,29352,1128.923077,1360612549994,1360612558506,1033933210,1033941722,8512
1360612564,1033947228,4,356,89,1360612551073,1360612558497,1033934301,1033941725,7424
1360612572,1033955200,9,5997,666.3333333,1360612545661,1360612548029,1033928861,1033931229,2368
1360612573,1033955424,7,2436,348,1360612571972,1360612572292,1033954396,1033954716,320
1360612576,1033958968,2,393,196.5,1360612550179,1360612550179,1033933147,1033933147,0
1360612580,1033963184,27,29983,1110.481481,1360612571598,1360612572174,1033954782,1033955358,576
1360612580,1033963236,29,34988,1206.482759,1360612571351,1360612579351,1033954587,1033962587,8000
1360612580,1033963236,37,48353,1306.837838,1360612571351,1360612579351,1033954587,1033962587,8000
1360612580,1033963240,4,356,89,1360612571733,1360612579349,1033954973,1033962589,7616
1360612584,1033966900,8,2298,287.25,1360612571815,1360612572391,1033954715,1033955291,576
1360612594,3967256504,5,1770,354,1360612589555,1360612589555,3967252059,3967252059,0
1360612594,3967256508,16,16344,1021.5,1360612589938,1360612590130,3967252446,3967252638,192
1360612594,3967256508,9,7596,844,1360612589873,1360612589873,3967252381,3967252381,0
1360612594,3967256508,6,3914,652.3333333,1360612589936,1360612590128,3967252444,3967252636,192
1360612594,3967256508,4,464,116,1360612590384,1360612590512,3967252892,3967253020,128
1360612594,3967256512,136,171436,1260.558824,1360612587501,1360612590573,3967250013,3967253085,3072
1360612594,3967256512,35,40035,1143.857143,1360612587756,1360612589868,3967250268,3967252380,2112
1360612594,3967256512,262,365766,1396.053435,1360612587756,1360612590508,3967250268,3967253020,2752
1360612594,3967256516,4,764,191,1360612591722,1360612591786,3967254238,3967254302,64
1360612594,3967256516,8,6308,788.5,1360612591849,1360612591913,3967254365,3967254429,64
1360612594,3967256532,17,15080,887.0588235,1360612589784,1360612589912,3967252316,3967252444,128
1360612594,3967256532,9,8426,936.2222222,1360612589848,1360612589912,3967252380,3967252444,64
1360612594,3967256532,24,27505,1146.041667,1360612589847,1360612590103,3967252379,3967252635,256
1360612594,3967256532,17,16619,977.5882353,1360612589911,1360612590039,3967252443,3967252571,128
1360612594,3967256532,41,51495,1255.97561,1360612590230,1360612590422,3967252762,3967252954,192
1360612594,3967256540,8,7209,901.125,1360612591825,1360612591889,3967254365,3967254429,64
1360612596,1033979224,7,4456,636.5714286,1360612591589,1360612591653,1033974813,1033974877,64
1360612596,1033979232,5,901,180.2,1360612588955,1360612589019,1033972187,1033972251,64
1360612596,1033979236,10,1114,111.4,1360612592601,1360612592921,1033975837,1033976157,320
1360612596,1033979236,4,507,126.75,1360612592665,1360612592729,1033975901,1033975965,64
1360612596,1033979236,4,902,225.5,1360612589144,1360612589336,1033972380,1033972572,192
1360612596,1033979236,5,561,112.2,1360612589272,1360612589336,1033972508,1033972572,64
1360612596,1033979268,12,1438,119.8333333,1360612593654,1360612593910,1033976922,1033977178,256
1360612596,1033979272,9,3463,384.7777778,1360612594165,1360612594421,1033977437,1033977693,256
1360612596,1033979272,4,730,182.5,1360612591219,1360612591347,1033974491,1033974619,128
1360612596,1033979272,4,731,182.75,1360612591282,1360612591346,1033974554,1033974618,64
1360612596,1033979280,7,3282,468.8571429,1360612591722,1360612592042,1033975002,1033975322,320
1360612596,1033979284,7,3275,467.8571429,1360612591782,1360612591974,1033975066,1033975258,192
1360612596,1033979308,4,2902,725.5,1360612588880,1360612588944,1033972188,1033972252,64
1360612596,1033979308,3,421,140.3333333,1360612592527,1360612592591,1033975835,1033975899,64
1360612597,1033979344,3,421,140.3333333,1360612594899,1360612594963,1033977243,1033977307,64
1360612597,1033979348,9,3450,383.3333333,1360612595153,1360612595345,1033977501,1033977693,192
1360612597,1033979352,57,65924,1156.561404,1360612592269,1360612592909,1033974621,1033975261,640
1360612597,1033979352,5,663,132.6,1360612595533,1360612595597,1033977885,1033977949,64
1360612597,1033979352,3,279,93,1360612595852,1360612595980,1033978204,1033978332,128
1360612597,1033979352,9,3136,348.4444444,1360612595852,1360612596044,1033978204,1033978396,192
1360612597,1033979352,8,3082,385.25,1360612595915,1360612596043,1033978267,1033978395,128
1360612597,1033979352,4,775,193.75,1360612596043,1360612596235,1033978395,1033978587,192
1360612597,1033979352,5,3156,631.2,1360612596362,1360612596490,1033978714,1033978842,128
1360612597,1033979356,4,773,193.25,1360612596042,1360612596298,1033978398,1033978654,256
1360612597,1033979356,5,3159,631.8,1360612596233,1360612596489,1033978589,1033978845,256
1360612597,1033979752,37,47896,1294.486486,1360612587773,1360612595837,1033970525,1033978589,8064
1360612597,1033979752,10,7707,770.7,1360612587837,1360612595837,1033970589,1033978589,8000
1360612602,3967264512,6,2218,369.6666667,1360612601196,1360612601260,3967263708,3967263772,64
1360612602,3967264516,8,6034,754.25,1360612594664,1360612594792,3967257180,3967257308,128
1360612602,3967264516,14,15562,1111.571429,1360612589735,1360612595879,3967252251,3967258395,6144
1360612602,3967264516,20,22825,1141.25,1360612590122,1360612597930,3967252638,3967260446,7808
1360612602,3967264520,5,764,152.8,1360612598692,1360612598692,3967261212,3967261212,0
1360612602,3967264520,4,464,116,1360612598692,1360612598756,3967261212,3967261276,64
1360612602,3967264520,15,12184,812.2666667,1360612596580,1360612596708,3967259100,3967259228,128
1360612602,3967264520,9,6174,686,1360612596580,1360612596708,3967259100,3967259228,128
1360612602,3967264520,5,764,152.8,1360612598692,1360612598756,3967261212,3967261276,64
1360612602,3967264520,9,6174,686,1360612596643,1360612596707,3967259163,3967259227,64
1360612602,3967264524,7,4624,660.5714286,1360612587874,1360612595938,3967250398,3967258462,8064
1360612602,3967264540,11,10326,938.7272727,1360612594640,1360612594768,3967257180,3967257308,128
1360612602,3967264540,17,18331,1078.294118,1360612590098,1360612597906,3967252638,3967260446,7808
1360612602,3967264544,4,464,116,1360612598540,1360612598604,3967261084,3967261148,64
1360612602,3967264544,5,1692,338.4,1360612596554,1360612596618,3967259098,3967259162,64
1360612602,3967264544,16,12236,764.75,1360612596554,1360612596682,3967259098,3967259226,128
1360612602,3967264544,90,113392,1259.911111,1360612587726,1360612597902,3967250270,3967260446,10176
1360612604,1033987236,16,16580,1036.25,1360612587993,1360612599321,1033971229,1033982557,11328
1360612604,1033987236,6,2768,461.3333333,1360612595993,1360612603673,1033979229,1033986909,7680
1360612604,1033987240,3,896,298.6666667,1360612600085,1360612600213,1033983325,1033983453,128
1360612604,1033987240,4,1106,276.5,1360612600275,1360612600403,1033983515,1033983643,128
1360612604,1033987244,84,113173,1347.297619,1360612600720,1360612600976,1033983964,1033984220,256
1360612604,1033987244,7,5123,731.8571429,1360612600656,1360612600720,1033983900,1033983964,64
1360612604,1033987244,4,409,102.25,1360612600847,1360612600975,1033984091,1033984219,128
1360612604,1033987272,4,1559,389.75,1360612598066,1360612598258,1033981338,1033981530,192
1360612604,1033987276,8,5041,630.125,1360612601904,1360612602032,1033985180,1033985308,128
1360612604,1033987276,5,900,180,1360612598446,1360612598574,1033981722,1033981850,128
1360612604,1033987288,10,10007,1000.7,1360612603045,1360612603045,1033986333,1033986333,0
1360612605,1033987316,6,3917,652.8333333,1360612601197,1360612601325,1033983513,1033983641,128
1360612605,1033987316,9,8075,897.2222222,1360612601329,1360612601457,1033983645,1033983773,128
1360612605,1033987316,10,4955,495.5,1360612597870,1360612604590,1033980186,1033986906,6720
1360612605,1033987328,4,1555,388.75,1360612598949,1360612599077,1033981277,1033981405,128
1360612605,1033987356,5,900,180,1360612599495,1360612599559,1033981851,1033981915,64
1360612605,1033987360,6,1869,311.5,1360612599813,1360612600197,1033982173,1033982557,384
1360612605,1033987360,6,1983,330.5,1360612599812,1360612600196,1033982172,1033982556,384
1360612605,1033987364,17,6381,375.3529412,1360612595902,1360612604670,1033978266,1033987034,8768
1360612610,3967272516,5,2741,548.2,1360612602474,1360612602538,3967264990,3967265054,64
1360612610,3967272516,28,32037,1144.178571,1360612602728,1360612602856,3967265244,3967265372,128
1360612610,3967272516,13,8035,618.0769231,1360612596010,1360612604330,3967258526,3967266846,8320
1360612610,3967272540,4,525,131.25,1360612602641,1360612602641,3967265181,3967265181,0
1360612610,3967272540,4,1090,272.5,1360612602768,1360612602960,3967265308,3967265500,192
1360612610,3967272544,11,6340,576.3636364,1360612595981,1360612604237,3967258525,3967266781,8256
1360612610,3967272544,4,1054,263.5,1360612603532,1360612603724,3967266076,3967266268,192
1360612610,3967272544,5,528,105.6,1360612603724,1360612603788,3967266268,3967266332,64
1360612610,3967272544,4,464,116,1360612603915,1360612603979,3967266459,3967266523,64
1360612613,1033995400,1,708,708,1360612586780,1360612586780,1033969180,1033969180,0
1360612613,1033995492,6,1092,182,1360612598209,1360612606593,1033980701,1033989085,8384
1360612613,1033995492,4,714,178.5,1360612598655,1360612606591,1033981147,1033989083,7936
1360612613,1033995528,11,4814,437.6363636,1360612600093,1360612608541,1033982621,1033991069,8448
1360612616,1033999196,1,46,46,1360612591230,1360612591230,1033974426,1033974426,0
1360612616,1033999200,1,46,46,1360612591293,1360612591293,1033974493,1033974493,0
1360612617,1033999320,1,46,46,1360612592169,1360612592169,1033974489,1033974489,0
1360612618,3967280508,59,61296,1038.915254,1360612609968,1360612612464,3967272476,3967274972,2496
1360612618,3967280508,9,5211,579,1360612612911,1360612612975,3967275419,3967275483,64
1360612618,3967280508,7,4028,575.4285714,1360612612911,1360612612975,3967275419,3967275483,64
1360612618,3967280512,6,4065,677.5,1360612613739,1360612613739,3967276251,3967276251,0
1360612618,3967280512,4,1100,275,1360612613739,1360612613739,3967276251,3967276251,0
1360612618,3967280512,213,294653,1383.347418,1360612610474,1360612612778,3967272986,3967275290,2304
1360612618,3967280516,12,4743,395.25,1360612604266,1360612612650,3967266782,3967275166,8384
1360612618,3967280520,9,8619,957.6666667,1360612615142,1360612615206,3967277662,3967277726,64
1360612618,3967280520,59,73889,1252.355932,1360612612325,1360612612581,3967274845,3967275101,256
1360612618,3967280520,11,10406,946,1360612615972,1360612616100,3967278492,3967278620,128
1360612618,3967280524,7,4127,589.5714286,1360612612897,1360612612961,3967275421,3967275485,64
1360612618,3967280524,7,4151,593,1360612612897,1360612613153,3967275421,3967275677,256
1360612618,3967280536,6,1761,293.5,1360612613651,1360612613843,3967276187,3967276379,192
1360612618,3967280540,71,94160,1326.197183,1360612610578,1360612612754,3967273118,3967275294,2176
1360612618,3967280540,35,33489,956.8285714,1360612610770,1360612612882,3967273310,3967275422,2112
1360612618,3967280540,24,29752,1239.666667,1360612615119,1360612615247,3967277659,3967277787,128
1360612621,1034003408,9,3456,384,1360612617109,1360612617237,1033999517,1033999645,128
1360612621,1034003408,8,3334,416.75,1360612617172,1360612617300,1033999580,1033999708,128
1360612621,1034003420,10,8268,826.8,1360612618377,1360612618441,1034000797,1034000861,64
1360612621,1034003420,8,3417,427.125,1360612618568,1360612618760,1034000988,1034001180,192
1360612621,1034003444,7,3281,468.7142857,1360612615344,1360612615472,1033997788,1033997916,128
1360612621,1034003444,4,591,147.75,1360612615470,1360612615534,1033997914,1033997978,64
1360612621,1034003444,5,3157,631.4,1360612619182,1360612619374,1034001626,1034001818,192
1360612621,1034003448,4,773,193.25,1360612619181,1360612619245,1034001629,1034001693,64
1360612621,1034003448,5,3157,631.4,1360612619244,1360612619500,1034001692,1034001948,256
1360612621,1034003452,5,886,177.2,1360612616231,1360612616359,1033998683,1033998811,128
1360612621,1034003452,38,47948,1261.789474,1360612612007,1360612619239,1033994459,1034001691,7232
1360612621,1034003452,21,23689,1128.047619,1360612612325,1360612612709,1033994777,1033995161,384
1360612621,1034003456,6,2702,450.3333333,1360612620387,1360612620515,1034002843,1034002971,128
1360612621,1034003456,5,900,180,1360612620451,1360612620579,1034002907,1034003035,128
1360612621,1034003456,4,2902,725.5,1360612612705,1360612612833,1033995161,1033995289,128
1360612621,1034003480,7,4456,636.5714286,1360612613388,1360612613452,1033995868,1033995932,64
1360612621,1034003488,15,5476,365.0666667,1360612618309,1360612618757,1034000797,1034001245,448
1360612621,1034003488,8,3088,386,1360612618436,1360612618628,1034000924,1034001116,192
1360612621,1034003488,4,774,193.5,1360612618625,1360612618753,1034001113,1034001241,128
1360612621,1034003492,4,901,225.25,1360612615552,1360612615680,1033998044,1033998172,128
1360612621,1034003492,6,2512,418.6666667,1360612615487,1360612615551,1033997979,1033998043,64
1360612621,1034003524,22,27151,1234.136364,1360612610783,1360612618847,1033993307,1034001371,8064
1360612621,1034003528,16,12589,786.8125,1360612616156,1360612616860,1033998684,1033999388,704
1360612621,1034003528,4,1559,389.75,1360612619739,1360612619931,1034002267,1034002459,192
1360612621,1034003532,3,1400,466.6666667,1360612619671,1360612619799,1034002203,1034002331,128
1360612621,1034003532,23,28471,1237.869565,1360612612247,1360612618839,1033994779,1034001371,6592
1360612621,1034003532,28,33603,1200.107143,1360612620310,1360612620502,1034002842,1034003034,192
1360612626,3967288512,76,95679,1258.934211,1360612618092,1360612618668,3967280604,3967281180,576
1360612626,3967288516,28,28323,1011.535714,1360612618919,1360612619495,3967281435,3967282011,576
1360612626,3967288520,9,6174,686,1360612619301,1360612619365,3967281821,3967281885,64
1360612626,3967288520,9,6174,686,1360612619301,1360612619365,3967281821,3967281885,64
1360612626,3967288520,9,1547,171.8888889,1360612620067,1360612620515,3967282587,3967283035,448
1360612626,3967288520,4,464,116,1360612620067,1360612620131,3967282587,3967282651,64
1360612626,3967288536,28,32037,1144.178571,1360612618069,1360612618261,3967280605,3967280797,192
1360612626,3967288540,10,6226,622.6,1360612619216,1360612619280,3967281756,3967281820,64
1360612626,3967288540,9,6174,686,1360612619216,1360612619280,3967281756,3967281820,64
1360612626,3967288540,4,464,116,1360612619474,1360612619538,3967282014,3967282078,64
1360612626,3967288540,4,464,116,1360612619474,1360612619538,3967282014,3967282078,64
1360612626,3967288544,7,4624,660.5714286,1360612611790,1360612618702,3967274334,3967281246,6912
1360612626,3967288544,47,62905,1338.404255,1360612612109,1360612620685,3967274653,3967283229,8576
1360612626,3967288544,4,464,116,1360612620044,1360612620108,3967282588,3967282652,64
1360612629,1034011420,42,53784,1280.571429,1360612620616,1360612620808,1034003036,1034003228,192
1360612629,1034011420,5,901,180.2,1360612612743,1360612620999,1033995163,1034003419,8256
1360612629,1034011460,8,3090,386.25,1360612618910,1360612625118,1034001370,1034007578,6208
1360612629,1034011492,6,1349,224.8333333,1360612612925,1360612623037,1033995417,1034005529,10112
1360612629,1034011496,6,1869,311.5,1360612620668,1360612620924,1034003164,1034003420,256
1360612629,1034011496,10,9033,903.3,1360612621115,1360612621371,1034003611,1034003867,256
1360612629,1034011544,6,2768,461.3333333,1360612619273,1360612626953,1034001817,1034009497,7680
1360612632,1034015152,9,3463,384.7777778,1360612603883,1360612605035,1033987035,1033988187,1152
1360612634,3967296512,12,3827,318.9166667,1360612618860,1360612626924,3967281372,3967289436,8064
1360612634,3967296536,15,12184,812.2666667,1360612619221,1360612626901,3967281757,3967289437,7680
1360612634,3967296540,10,4225,422.5,1360612612561,1360612626897,3967275101,3967289437,14336
1360612637,1034019448,12,4866,405.5,1360612620972,1360612629228,1034003420,1034011676,8256
1360612637,1034019524,84,113174,1347.309524,1360612621471,1360612629087,1034003995,1034011611,7616
1360612645,1034027444,5,901,180.2,1360612644656,1360612644720,1034027100,1034027164,64
1360612645,1034027492,4,773,193.25,1360612643582,1360612643646,1034026074,1034026138,64
1360612645,1034027572,5,3156,631.2,1360612643567,1360612643759,1034026139,1034026331,192
1360612653,1034035452,4,775,193.75,1360612645223,1360612645415,1034027675,1034027867,192
1360612653,1034035452,5,653,130.6,1360612645413,1360612645605,1034027865,1034028057,192
1360612653,1034035456,4,778,194.5,1360612645477,1360612645669,1034027933,1034028125,192
1360612653,1034035456,11,10452,950.1818182,1360612649444,1360612649636,1034031900,1034032092,192
1360612653,1034035488,6,1869,311.5,1360612647618,1360612647874,1034030106,1034030362,256
1360612653,1034035496,84,113173,1347.297619,1360612648125,1360612648765,1034030621,1034031261,640
1360612653,1034035500,6,1869,311.5,1360612644726,1360612644918,1034027226,1034027418,192
1360612653,1034035524,6,3769,628.1666667,1360612645598,1360612645662,1034028122,1034028186,64
1360612653,1034035528,4,530,132.5,1360612645724,1360612645788,1034028252,1034028316,64
1360612653,1034035528,5,3159,631.8,1360612645724,1360612645916,1034028252,1034028444,192
1360612653,1034035540,4,865,216.25,1360612650445,1360612650637,1034032985,1034033177,192
1360612653,1034035540,4,1316,329,1360612650449,1360612650641,1034032989,1034033181,192
1360612653,1034035540,12,1673,139.4166667,1360612642766,1360612651854,1034025306,1034034394,9088
1360612653,1034035540,5,900,180,1360612647438,1360612647566,1034029978,1034030106,128
1360612653,1034035572,43,19394,451.0232558,1360612642989,1360612651757,1034025561,1034034329,8768
1360612653,1034035572,4,1106,276.5,1360612647918,1360612648046,1034030490,1034030618,128
1360612658,3967320552,5,764,152.8,1360612644100,1360612654980,3967306652,3967317532,10880
1360612658,3967320552,5,764,152.8,1360612644164,1360612654980,3967306716,3967317532,10816
1360612658,3967320556,32,40669,1270.90625,1360612644993,1360612652993,3967307549,3967315549,8000
1360612658,3967320572,5,764,152.8,1360612644144,1360612654960,3967306716,3967317532,10816
1360612661,1034043560,6,3025,504.1666667,1360612644283,1360612655163,1034026843,1034037723,10880
1360612661,1034043580,17,7631,448.8823529,1360612644840,1360612655144,1034027420,1034037724,10304
1360612674,3967336552,48,49327,1027.645833,1360612668420,1360612672004,3967330972,3967334556,3584
1360612674,3967336572,27,31985,1184.62963,1360612671856,1360612672048,3967334428,3967334620,192
1360612677,1034059572,16,5560,347.5,1360612672559,1360612673007,1034055131,1034055579,448
1360612677,1034059572,9,3463,384.7777778,1360612672558,1360612672878,1034055130,1034055450,320
1360612677,1034059576,4,773,193.25,1360612672812,1360612673004,1034055388,1034055580,192
1360612677,1034059576,5,3156,631.2,1360612673001,1360612673321,1034055577,1034055897,320
1360612677,1034059620,8,2854,356.75,1360612675264,1360612675392,1034057884,1034058012,128
1360612677,1034059620,4,516,129,1360612675519,1360612675583,1034058139,1034058203,64
1360612677,1034059620,6,3839,639.8333333,1360612675519,1360612675583,1034058139,1034058203,64
1360612677,1034059620,34,42522,1250.647059,1360612675454,1360612675582,1034058074,1034058202,128
1360612677,1034059620,7,5123,731.8571429,1360612675901,1360612675965,1034058521,1034058585,64
1360612677,1034059624,6,3918,653,1360612675640,1360612675832,1034058264,1034058456,192
1360612677,1034059624,4,409,102.25,1360612676281,1360612676473,1034058905,1034059097,192
1360612677,1034059652,8,3084,385.5,1360612672862,1360612673182,1034055514,1034055834,320
1360612677,1034059692,4,774,193.5,1360612674166,1360612674294,1034056858,1034056986,128
1360612677,1034059696,4,1555,388.75,1360612674482,1360612674674,1034057178,1034057370,192
1360612677,1034059696,5,3158,631.6,1360612674482,1360612674610,1034057178,1034057306,128
1360612677,1034059696,8,3321,415.125,1360612671601,1360612671793,1034054297,1034054489,192
1360612677,1034059700,5,900,180,1360612674608,1360612674736,1034057308,1034057436,128
1360612677,1034059700,9,3374,374.8888889,1360612672046,1360612672174,1034054746,1034054874,128
1360612677,1034059700,8,3410,426.25,1360612672046,1360612672302,1034054746,1034055002,256
1360612677,1034059700,5,899,179.8,1360612672046,1360612672174,1034054746,1034054874,128
1360612677,1034059700,4,1561,390.25,1360612674861,1360612675053,1034057561,1034057753,192
1360612677,1034059704,5,901,180.2,1360612674988,1360612675180,1034057692,1034057884,192
1360612677,1034059704,7,3042,434.5714286,1360612672363,1360612672619,1034055067,1034055323,256
1360612677,1034059704,6,1869,311.5,1360612674987,1360612675179,1034057691,1034057883,192
1360612677,1034059704,6,1989,331.5,1360612675178,1360612675370,1034057882,1034058074,192
1360612677,1034059704,8,4591,573.875,1360612675306,1360612675370,1034058010,1034058074,64
1360612677,1034059704,3,902,300.6666667,1360612675369,1360612675497,1034058073,1034058201,128
1360612677,1034059708,4,530,132.5,1360612675624,1360612675688,1034058332,1034058396,64
1360612682,3967344548,33,37513,1136.757576,1360612669319,1360612678727,3967331867,3967341275,9408
1360612682,3967344556,4,464,116,1360612674818,1360612674882,3967337374,3967337438,64
1360612682,3967344556,4,464,116,1360612674818,1360612674882,3967337374,3967337438,64
1360612682,3967344556,6,2230,371.6666667,1360612675776,1360612675840,3967338332,3967338396,64
1360612682,3967344572,4,464,116,1360612674415,1360612674479,3967336987,3967337051,64
1360612682,3967344572,4,464,116,1360612674415,1360612674479,3967336987,3967337051,64
1360612682,3967344576,27,31985,1184.62963,1360612671855,1360612678703,3967334431,3967341279,6848
1360612685,1034067604,10,10018,1001.8,1360612677646,1360612677710,1034060250,1034060314,64
1360612685,1034067604,5,901,180.2,1360612669708,1360612676812,1034052312,1034059416,7104
1360612685,1034067612,4,591,147.75,1360612670279,1360612676807,1034052891,1034059419,6528
1360612685,1034067612,4,901,225.25,1360612670469,1360612676869,1034053081,1034059481,6400
1360612685,1034067688,5,761,152.2,1360612677689,1360612677817,1034060377,1034060505,128
1360612685,1034067692,6,1349,224.8333333,1360612669812,1360612678708,1034052504,1034061400,8896
1360612685,1034067692,6,2512,418.6666667,1360612670388,1360612676724,1034053080,1034059416,6336
1360612689,1034071508,16,8275,517.1875,1360612664303,1360612666351,1034046811,1034048859,2048
1360612689,3967351428,1,52,52,1360612662207,1360612662207,3967324635,3967324635,0
1360612690,3967352552,6,580,96.66666667,1360612677699,1360612684803,3967340251,3967347355,7104
1360612690,3967352556,10,3117,311.7,1360612669634,1360612682754,3967332190,3967345310,13120
1360612690,3967352576,4,464,116,1360612677676,1360612684716,3967340252,3967347292,7040
1360612693,1034075592,11,10450,950,1360612678555,1360612684827,1034061147,1034067419,6272
1360612693,1034075628,5,721,144.2,1360612687797,1360612687797,1034070425,1034070425,0
1360612706,3967368596,5,2741,548.2,1360612704346,1360612704474,3967366942,3967367070,128
1360612709,1034091620,13,6607,508.2307692,1360612700671,1360612708287,1034083291,1034090907,7616
1360612709,1034091628,11,11026,1002.363636,1360612705717,1360612705781,1034088345,1034088409,64
1360612709,1034091632,5,3158,631.6,1360612702578,1360612702706,1034085210,1034085338,128
1360612709,1034091672,6,1989,331.5,1360612703624,1360612703944,1034086296,1034086616,320
1360612709,1034091672,6,1869,311.5,1360612703435,1360612703755,1034086107,1034086427,320
1360612709,1034091676,5,653,130.6,1360612704068,1360612704196,1034086744,1034086872,128
1360612709,1034091680,9,4056,450.6666667,1360612699780,1360612704196,1034082460,1034086876,4416
1360612709,1034091680,16,18671,1166.9375,1360612704513,1360612704577,1034087193,1034087257,64
1360612709,1034091708,4,775,193.75,1360612701157,1360612701285,1034083865,1034083993,128
1360612709,1034091712,5,3158,631.6,1360612701474,1360612701666,1034084186,1034084378,192
1360612709,1034091716,4,774,193.5,1360612701724,1360612701852,1034084440,1034084568,128
1360612709,1034091720,5,900,180,1360612702617,1360612702681,1034085337,1034085401,64
1360612709,1034091748,5,901,180.2,1360612703484,1360612703548,1034086232,1034086296,64
1360612709,1034091756,3,1092,364,1360612703864,1360612703992,1034086620,1034086748,128
1360612709,1034091756,11,10452,950.1818182,1360612707255,1360612707383,1034090011,1034090139,128
1360612709,1034091756,4,778,194.5,1360612703990,1360612708534,1034086746,1034091290,4544
1360612709,1034091756,6,3769,628.1666667,1360612703990,1360612704054,1034086746,1034086810,64
1360612709,1034091760,4,530,132.5,1360612704240,1360612704368,1034087000,1034087128,128
1360612709,1034091760,4,908,227,1360612704304,1360612704368,1034087064,1034087128,64
1360612709,1034091764,26,12609,484.9615385,1360612700016,1360612708144,1034082780,1034090908,8128
1360612714,3967376552,6,1064,177.3333333,1360612702406,1360612710150,3967364958,3967372702,7744
1360612714,3967376552,6,1125,187.5,1360612702469,1360612712133,3967365021,3967374685,9664
1360612714,3967376552,4,464,116,1360612702469,1360612710149,3967365021,3967372701,7680
1360612714,3967376560,5,516,103.2,1360612705981,1360612706045,3967368541,3967368605,64
1360612717,1034099612,6,3023,503.8333333,1360612702535,1360612710279,1034085147,1034092891,7744
1360612717,1034099652,8,4379,547.375,1360612716190,1360612716190,1034098842,1034098842,0
1360612717,1034099652,6,1084,180.6666667,1360612716061,1360612716125,1034098713,1034098777,64
1360612717,1034099724,8,2987,373.375,1360612703702,1360612710166,1034086426,1034092890,6464
1360612730,3967392560,4,464,116,1360612716284,1360612724156,3967378844,3967386716,7872
1360612733,1034115584,2,131,65.5,1360612725472,1360612725472,1034108056,1034108056,0
1360612733,1034115624,4,774,193.5,1360612730811,1360612730939,1034113435,1034113563,128
1360612733,1034115624,6,3210,535,1360612731129,1360612731897,1034113753,1034114521,768
1360612733,1034115696,5,3157,631.4,1360612730866,1360612731122,1034113562,1034113818,256
1360612733,1034115696,4,774,193.5,1360612730930,1360612731058,1034113626,1034113754,128
1360612733,1034115704,5,901,180.2,1360612732266,1360612732394,1034114970,1034115098,128
1360612733,1034115984,5,899,179.8,1360612732177,1360612732241,1034115161,1034115225,64
1360612737,1034119488,1,46,46,1360612710400,1360612710400,1034092888,1034092888,0
1360612738,3967400552,33,42916,1300.484848,1360612734535,1360612734663,3967397087,3967397215,128
1360612741,1034123604,6,1869,311.5,1360612732685,1360612733005,1034115289,1034115609,320
1360612741,1034123608,8,2974,371.75,1360612733066,1360612733194,1034115674,1034115802,128
1360612741,1034123608,5,672,134.4,1360612733257,1360612733385,1034115865,1034115993,128
1360612741,1034123612,4,530,132.5,1360612733510,1360612733574,1034116122,1034116186,64
1360612741,1034123616,6,1349,224.8333333,1360612729859,1360612736387,1034112475,1034119003,6528
1360612741,1034123616,27,12655,468.7037037,1360612730113,1360612738369,1034112729,1034120985,8256
1360612741,1034123660,6,3023,503.8333333,1360612731863,1360612738391,1034114523,1034121051,6528
1360612741,1034123680,6,1869,311.5,1360612732609,1360612732865,1034115289,1034115545,256
1360612741,1034123684,7,2986,426.5714286,1360612732927,1360612740287,1034115611,1034122971,7360
1360612741,1034123684,9,7380,820,1360612733180,1360612733308,1034115864,1034115992,128
1360612741,1034123684,4,778,194.5,1360612733180,1360612733244,1034115864,1034115928,64
1360612741,1034123688,4,530,132.5,1360612733369,1360612733497,1034116057,1034116185,128
1360612741,1034123724,15,6693,446.2,1360612730262,1360612738262,1034112986,1034120986,8000
1360612746,3967408560,4,464,116,1360612731836,1360612738236,3967394396,3967400796,6400
1360612746,3967408584,4,464,116,1360612731814,1360612738214,3967394398,3967400798,6400
1360612746,3967408584,8,1416,177,1360612731814,1360612738214,3967394398,3967400798,6400
1360612749,1034131708,19,20739,1091.526316,1360612736229,1360612744229,1034118937,1034126937,8000
1360612749,1034131780,5,901,180.2,1360612747549,1360612747805,1034130329,1034130585,256
1360612754,3967416552,4,464,116,1360612753093,1360612753157,3967415645,3967415709,64
1360612754,3967416556,4,464,116,1360612753411,1360612753475,3967415967,3967416031,64
1360612754,3967416560,7,2396,342.2857143,1360612747645,1360612753085,3967410205,3967415645,5440
1360612754,3967416576,4,464,116,1360612753070,1360612753134,3967415646,3967415710,64
1360612754,3967416576,4,464,116,1360612753324,1360612753324,3967415900,3967415900,0
1360612754,3967416580,4,464,116,1360612753451,1360612753451,3967416031,3967416031,0
1360612757,1034139600,4,776,194,1360612752595,1360612752659,1034135195,1034135259,64
1360612757,1034139600,6,1869,311.5,1360612753554,1360612753874,1034136154,1034136474,320
1360612757,1034139600,4,730,182.5,1360612748882,1360612749010,1034131482,1034131610,128
1360612757,1034139600,4,773,193.25,1360612752848,1360612752976,1034135448,1034135576,128
1360612757,1034139604,5,3156,631.2,1360612752974,1360612753166,1034135578,1034135770,192
1360612757,1034139604,4,1560,390,1360612753228,1360612753356,1034135832,1034135960,128
1360612757,1034139608,6,2511,418.5,1360612749447,1360612749511,1034132055,1034132119,64
1360612757,1034139608,4,591,147.75,1360612749447,1360612749511,1034132055,1034132119,64
1360612757,1034139608,5,901,180.2,1360612753482,1360612753546,1034136090,1034136154,64
1360612757,1034139608,4,1556,389,1360612753481,1360612753609,1034136089,1034136217,128
1360612757,1034139612,7,2972,424.5714286,1360612753862,1360612753990,1034136474,1034136602,128
1360612757,1034139612,4,778,194.5,1360612753988,1360612754116,1034136600,1034136728,128
1360612757,1034139616,6,3775,629.1666667,1360612754051,1360612754115,1034136667,1034136731,64
1360612757,1034139616,4,530,132.5,1360612754178,1360612754242,1034136794,1034136858,64
1360612757,1034139644,8,3410,426.25,1360612751907,1360612752227,1034134551,1034134871,320
1360612757,1034139644,16,5555,347.1875,1360612751909,1360612752229,1034134553,1034134873,320
1360612757,1034139652,5,3268,653.6,1360612752799,1360612752927,1034135451,1034135579,128
1360612757,1034139680,4,901,225.25,1360612749379,1360612749571,1034132059,1034132251,192
1360612757,1034139680,5,900,180,1360612753601,1360612753665,1034136281,1034136345,64
1360612757,1034139680,4,731,182.75,1360612749696,1360612749824,1034132376,1034132504,128
1360612757,1034139680,4,666,166.5,1360612753344,1360612753408,1034136024,1034136088,64
1360612757,1034139684,6,1983,330.5,1360612753660,1360612753916,1034136344,1034136600,256
1360612757,1034139688,5,653,130.6,1360612753975,1360612754167,1034136663,1034136855,192
1360612757,1034139688,5,889,177.8,1360612750585,1360612750713,1034133273,1034133401,128
1360612757,1034139692,3,910,303.3333333,1360612754039,1360612754103,1034136731,1034136795,64
1360612757,1034139692,7,3288,469.7142857,1360612751348,1360612751476,1034134040,1034134168,128
1360612757,1034139696,7,3281,468.7142857,1360612751347,1360612751475,1034134043,1034134171,128
1360612757,1034139696,9,3463,384.7777778,1360612751857,1360612752177,1034134553,1034134873,320
1360612757,1034139720,10,3182,318.2,1360612752154,1360612752410,1034134874,1034135130,256
1360612757,1034139720,8,3088,386,1360612752408,1360612752664,1034135128,1034135384,256
1360612762,3967424556,33,41800,1266.666667,1360612754113,1360612754241,3967416669,3967416797,128
1360612762,3967424556,19,21993,1157.526316,1360612754113,1360612754241,3967416669,3967416797,128
1360612762,3967424560,7,4930,704.2857143,1360612746367,1360612756287,3967408927,3967418847,9920
1360612762,3967424560,7,4622,660.2857143,1360612747004,1360612754300,3967409564,3967416860,7296
1360612762,3967424560,36,42386,1177.388889,1360612747003,1360612754299,3967409563,3967416859,7296
1360612762,3967424580,34,34191,1005.617647,1360612745961,1360612754281,3967408541,3967416861,8320
1360612762,3967424584,61,82214,1347.770492,1360612746342,1360612754214,3967408926,3967416798,7872
1360612762,3967424584,33,42039,1273.909091,1360612746342,1360612754214,3967408926,3967416798,7872
1360612762,3967424588,11,10444,949.4545455,1360612747104,1360612754208,3967409692,3967416796,7104
1360612765,1034147624,4,714,178.5,1360612753081,1360612760377,1034135705,1034143001,7296
1360612770,3967432556,5,2671,534.2,1360612759808,1360612766336,3967422364,3967428892,6528
1360612770,3967432560,88,110283,1253.215909,1360612768638,1360612769534,3967431198,3967432094,896
1360612770,3967432572,33,42773,1296.151515,1360612769330,1360612769458,3967431902,3967432030,128
1360612770,3967432572,11,10511,955.5454545,1360612769330,1360612769458,3967431902,3967432030,128
1360612770,3967432572,5,1823,364.6,1360612769840,1360612769904,3967432412,3967432476,64
1360612773,1034155900,4,2902,725.5,1360612769636,1360612769700,1034152536,1034152600,64
1360612773,1034155904,4,730,182.5,1360612769888,1360612770016,1034152792,1034152920,128
1360612773,1034155908,4,731,182.75,1360612770395,1360612770459,1034153303,1034153367,64
1360612773,1034155912,5,954,190.8,1360612770714,1360612770842,1034153626,1034153754,128
1360612773,1034155936,5,935,187,1360612771008,1360612771136,1034153944,1034154072,128
1360612773,1034155944,11,10451,950.0909091,1360612759610,1360612766074,1034142554,1034149018,6464
1360612773,1034155948,7,4456,636.5714286,1360612771635,1360612771763,1034154583,1034154711,128
1360612773,1034155952,10,8466,846.6,1360612771888,1360612771952,1034154840,1034154904,64
1360612773,1034155952,8,3410,426.25,1360612772272,1360612772464,1034155224,1034155416,192
1360612773,1034155976,5,901,180.2,1360612769561,1360612769817,1034152537,1034152793,256
1360612773,1034156016,6,2512,418.6666667,1360612770545,1360612770673,1034153561,1034153689,128
1360612773,1034156028,7,3281,468.7142857,1360612771876,1360612772132,1034154904,1034155160,256
1360612773,1034156028,8,3334,416.75,1360612771939,1360612772067,1034154967,1034155095,128
1360612773,1034156032,16,5586,349.125,1360612771938,1360612772386,1034154970,1034155418,448
1360612777,1034159548,8,3417,427.125,1360612772678,1360612772870,1034155226,1034155418,192
1360612778,3967440548,10,1119,111.9,1360612773130,1360612773450,3967435678,3967435998,320
1360612778,3967440548,7,4623,660.4285714,1360612769034,1360612776522,3967431582,3967439070,7488
1360612778,3967440552,10,6226,622.6,1360612774151,1360612774279,3967436703,3967436831,128
1360612778,3967440552,5,1692,338.4,1360612774150,1360612774150,3967436702,3967436702,0
1360612778,3967440552,9,6174,686,1360612774277,1360612774341,3967436829,3967436893,64
1360612778,3967440556,4,464,116,1360612775426,1360612775490,3967437982,3967438046,64
1360612778,3967440556,4,464,116,1360612775745,1360612775809,3967438301,3967438365,64
1360612778,3967440572,47,62904,1338.382979,1360612769011,1360612776371,3967431583,3967438943,7360
1360612778,3967440572,9,6174,686,1360612774128,1360612774256,3967436700,3967436828,128
1360612778,3967440572,9,6174,686,1360612774256,1360612774320,3967436828,3967436892,64
1360612778,3967440572,10,6226,622.6,1360612774128,1360612774256,3967436700,3967436828,128
1360612778,3967440572,10,6226,622.6,1360612774259,1360612774323,3967436831,3967436895,64
1360612778,3967440576,4,464,116,1360612771181,1360612771245,3967433757,3967433821,64
1360612778,3967440580,4,464,116,1360612775722,1360612775786,3967438302,3967438366,64
1360612778,3967440580,6,1064,177.3333333,1360612775722,1360612775786,3967438302,3967438366,64
1360612778,3967440580,113,128187,1134.39823,1360612768168,1360612776488,3967430748,3967439068,8320
1360612778,3967440584,145,200503,1382.77931,1360612768615,1360612776359,3967431199,3967438943,7744
1360612778,3967440584,5,2727,545.4,1360612768615,1360612776295,3967431199,3967438879,7680
1360612781,1034163916,37,47896,1294.486486,1360612768852,1360612776340,1034151768,1034159256,7488
1360612781,1034163920,9,3134,348.2222222,1360612772946,1360612773202,1034155866,1034156122,256
1360612781,1034163920,4,774,193.5,1360612773200,1360612773328,1034156120,1034156248,128
1360612781,1034163920,4,774,193.5,1360612773200,1360612773328,1034156120,1034156248,128
1360612781,1034163924,5,3157,631.4,1360612773517,1360612773837,1034156441,1034156761,320
1360612781,1034163952,5,901,180.2,1360612775408,1360612775472,1034158360,1034158424,64
1360612781,1034163956,5,901,180.2,1360612775788,1360612775916,1034158744,1034158872,128
1360612781,1034163956,8,2914,364.25,1360612775851,1360612776043,1034158807,1034158999,192
1360612781,1034163960,18,19094,1060.777778,1360612776298,1360612779754,1034159258,1034162714,3456
1360612781,1034163968,25,24278,971.12,1360612768799,1360612779359,1034151767,1034162327,10560
1360612781,1034163972,23,28471,1237.869565,1360612768862,1360612776094,1034151834,1034159066,7232
1360612781,1034163992,9,3136,348.4444444,1360612772938,1360612773130,1034155930,1034156122,192
1360612781,1034163996,5,3158,631.6,1360612773445,1360612773765,1034156441,1034156761,320
1360612781,1034164000,6,2768,461.3333333,1360612773826,1360612773826,1034156826,1034156826,0
1360612781,1034164000,4,1557,389.25,1360612774335,1360612774463,1034157335,1034157463,128
1360612781,1034164028,4,1559,389.75,1360612775398,1360612775718,1034158426,1034158746,320
1360612781,1034164028,6,1869,311.5,1360612775524,1360612775780,1034158552,1034158808,256
1360612781,1034164032,6,1869,311.5,1360612775842,1360612776098,1034158874,1034159130,256
1360612781,1034164036,11,10451,950.0909091,1360612779421,1360612779677,1034162457,1034162713,256
1360612786,3967448556,7,4150,592.8571429,1360612782081,1360612782145,3967444637,3967444701,64
1360612786,3967448556,35,29054,830.1142857,1360612778944,1360612782464,3967441500,3967445020,3520
1360612786,3967448560,4,1100,275,1360612783101,1360612783229,3967445661,3967445789,128
1360612786,3967448560,20,16080,804,1360612780284,1360612783100,3967442844,3967445660,2816
1360612786,3967448564,24,29752,1239.666667,1360612783611,1360612783739,3967446175,3967446303,128
1360612786,3967448580,5,1797,359.4,1360612782250,1360612782442,3967444830,3967445022,192
1360612786,3967448580,14,14454,1032.428571,1360612782313,1360612784233,3967444893,3967446813,1920
1360612786,3967448584,46,59987,1304.065217,1360612780262,1360612781030,3967442846,3967443614,768
1360612786,3967448584,4,464,116,1360612783078,1360612783142,3967445662,3967445726,64
1360612786,3967448588,32,40669,1270.90625,1360612776611,1360612784611,3967439199,3967447199,8000
1360612789,1034171832,1,46,46,1360612762025,1360612762025,1034144857,1034144857,0
1360612789,1034171932,4,730,182.5,1360612782276,1360612782468,1034165208,1034165400,192
1360612789,1034171936,6,2512,418.6666667,1360612782783,1360612782847,1034165719,1034165783,64
1360612789,1034171964,4,774,193.5,1360612786339,1360612786467,1034169303,1034169431,128
1360612789,1034171968,4,731,182.75,1360612783394,1360612783522,1034166362,1034166490,128
1360612789,1034171968,5,3158,631.6,1360612786592,1360612786720,1034169560,1034169688,128
1360612789,1034171972,9,1260,140,1360612776285,1360612784349,1034159257,1034167321,8064
1360612789,1034171972,4,1555,388.75,1360612786973,1360612787101,1034169945,1034170073,128
1360612789,1034171972,4,1558,389.5,1360612787036,1360612787164,1034170008,1034170136,128
1360612789,1034171972,25,12820,512.8,1360612784412,1360612786076,1034167384,1034169048,1664
1360612789,1034171972,6,1464,244,1360612776283,1360612784347,1034159255,1034167319,8064
1360612789,1034171976,22,27151,1234.136364,1360612779991,1360612780823,1034162967,1034163799,832
1360612789,1034171976,5,901,180.2,1360612787354,1360612787482,1034170330,1034170458,128
1360612789,1034171976,6,1869,311.5,1360612787481,1360612787609,1034170457,1034170585,128
1360612789,1034171976,8,2972,371.5,1360612787672,1360612787736,1034170648,1034170712,64
1360612789,1034171976,4,778,194.5,1360612787736,1360612787800,1034170712,1034170776,64
1360612789,1034171976,4,530,132.5,1360612787864,1360612787928,1034170840,1034170904,64
1360612789,1034172008,15,6442,429.4666667,1360612785080,1360612786104,1034168088,1034169112,1024
1360612789,1034172012,5,901,180.2,1360612781942,1360612788342,1034164954,1034171354,6400
1360612789,1034172016,6,1017,169.5,1360612782767,1360612782895,1034165783,1034165911,128
1360612789,1034172044,4,774,193.5,1360612786262,1360612786390,1034169306,1034169434,128
1360612789,1034172044,5,3157,631.4,1360612786516,1360612786644,1034169560,1034169688,128
1360612789,1034172048,17,8542,502.4705882,1360612775954,1360612784274,1034159002,1034167322,8320
1360612789,1034172048,5,896,179.2,1360612776335,1360612784271,1034159383,1034167319,7936
1360612789,1034172052,5,900,180,1360612787149,1360612787405,1034170201,1034170457,256
1360612789,1034172052,6,1869,311.5,1360612787403,1360612787659,1034170455,1034170711,256
1360612789,1034172056,6,3769,628.1666667,1360612787658,1360612787722,1034170714,1034170778,64
1360612789,1034172056,7,2975,425,1360612787658,1360612787786,1034170714,1034170842,128
1360612789,1034172056,5,653,130.6,1360612787658,1360612787850,1034170714,1034170906,192
1360612789,1034172056,6,3775,629.1666667,1360612787785,1360612787849,1034170841,1034170905,64
1360612789,1034172056,4,778,194.5,1360612787785,1360612787849,1034170841,1034170905,64
1360612789,1034172056,4,530,132.5,1360612787912,1360612787976,1034170968,1034171032,64
1360612794,3967456552,27,31985,1184.62963,1360612785735,1360612792647,3967448287,3967455199,6912
1360612794,3967456552,6,1064,177.3333333,1360612787204,1360612787524,3967449756,3967450076,320
1360612794,3967456576,27,31985,1184.62963,1360612785709,1360612792621,3967448285,3967455197,6912
1360612794,3967456576,27,31985,1184.62963,1360612785709,1360612785965,3967448285,3967448541,256
1360612794,3967456576,27,31985,1184.62963,1360612785709,1360612792621,3967448285,3967455197,6912
1360612794,3967456584,4,464,116,1360612787431,1360612787495,3967450015,3967450079,64
1360612794,3967456584,4,464,116,1360612787431,1360612787495,3967450015,3967450079,64
1360612797,1034179972,10,1137,113.7,1360612784732,1360612793244,1034167704,1034176216,8512
1360612797,1034179984,20,5817,290.85,1360612785679,1360612793167,1034168663,1034176151,7488
1360612797,1034180092,4,591,147.75,1360612782564,1360612790244,1034165656,1034173336,7680
1360612802,3967464584,4,464,116,1360612787430,1360612794598,3967450014,3967457182,7168
1360612805,1034188032,14,11918,851.2857143,1360612790688,1360612800288,1034173720,1034183320,9600
1360612805,1034188036,14,12819,915.6428571,1360612790747,1360612800283,1034173783,1034183319,9536
1360612817,1034199708,1,46,46,1360612790436,1360612790436,1034173144,1034173144,0
1360612821,1034204004,14,6647,474.7857143,1360612812604,1360612820412,1034195608,1034203416,7808
1360612821,1034204012,4,774,193.5,1360612813362,1360612813426,1034196374,1034196438,64
1360612821,1034204012,6,2992,498.6666667,1360612813493,1360612814901,1034196505,1034197913,1408
1360612821,1034204012,44,56270,1278.863636,1360612813810,1360612820402,1034196822,1034203414,6592
1360612821,1034204084,4,773,193.25,1360612812846,1360612812974,1034195930,1034196058,128
1360612821,1034204084,5,3156,631.2,1360612812972,1360612813228,1034196056,1034196312,256
1360612821,1034204092,25,29622,1184.88,1360612813730,1360612818210,1034196822,1034201302,4480
1360612821,1034204092,5,3158,631.6,1360612813798,1360612813926,1034196890,1034197018,128
1360612821,1034204136,28,12707,453.8214286,1360612812087,1360612820279,1034195223,1034203415,8192
1360612826,3967488588,6,1064,177.3333333,1360612813664,1360612822688,3967476252,3967485276,9024
1360612826,3967488592,5,764,152.8,1360612813983,1360612822687,3967476575,3967485279,8704
1360612826,3967488596,4,464,116,1360612815067,1360612822683,3967477663,3967485279,7616
1360612829,1034212124,14,2578,184.1428571,1360612811907,1360612822275,1034195031,1034205399,10368
1360612837,1034220184,7,3281,468.7142857,1360612835721,1360612835849,1034218905,1034219033,128
1360612837,1034220184,7,3288,469.7142857,1360612835976,1360612836168,1034219160,1034219352,192
1360612837,1034220312,2,192,96,1360612831624,1360612831624,1034214936,1034214936,0
1360612837,1034220320,7,3364,480.5714286,1360612835905,1360612836097,1034219225,1034219417,192
1360612837,1034220320,5,899,179.8,1360612835969,1360612836097,1034219289,1034219417,128
1360612842,3967504592,4,464,116,1360612838047,1360612838111,3967500639,3967500703,64
1360612842,3967504592,4,464,116,1360612838047,1360612838111,3967500639,3967500703,64
1360612842,3967504600,27,31985,1184.62963,1360612836311,1360612836439,3967498911,3967499039,128
1360612842,3967504600,26,31933,1228.192308,1360612836311,1360612836567,3967498911,3967499167,256
1360612842,3967504600,7,4624,660.5714286,1360612833428,1360612841172,3967496028,3967503772,7744
1360612842,3967504616,4,464,116,1360612838726,1360612838790,3967501342,3967501406,64
1360612842,3967504620,27,31985,1184.62963,1360612836289,1360612836481,3967498909,3967499101,192
1360612845,1034228064,8,3417,427.125,1360612836607,1360612836863,1034219671,1034219927,256
1360612845,1034228064,16,5560,347.5,1360612836606,1360612836990,1034219670,1034220054,384
1360612845,1034228064,9,3128,347.5555556,1360612836606,1360612836862,1034219670,1034219926,256
1360612845,1034228068,4,773,193.25,1360612836860,1360612836988,1034219928,1034220056,128
1360612845,1034228072,5,3264,652.8,1360612837305,1360612837497,1034220377,1034220569,192
1360612845,1034228076,4,1556,389,1360612837749,1360612837877,1034220825,1034220953,128
1360612845,1034228080,4,1559,389.75,1360612838257,1360612838449,1034221337,1034221529,192
1360612845,1034228080,5,899,179.8,1360612833648,1360612840816,1034216728,1034223896,7168
1360612845,1034228084,7,3295,470.7142857,1360612838573,1360612839085,1034221657,1034222169,512
1360612845,1034228108,5,653,130.6,1360612838933,1360612839061,1034222041,1034222169,128
1360612845,1034228108,7,2975,425,1360612839189,1360612839317,1034222297,1034222425,128
1360612845,1034228108,6,2512,418.6666667,1360612834260,1360612840788,1034217368,1034223896,6528
1360612845,1034228108,4,778,194.5,1360612839250,1360612839314,1034222358,1034222422,64
1360612845,1034228108,5,653,130.6,1360612839314,1360612839506,1034222422,1034222614,192
1360612845,1034228140,8,3090,386.25,1360612836851,1360612836979,1034219991,1034220119,128
1360612845,1034228144,4,774,193.5,1360612837232,1360612837360,1034220376,1034220504,128
1360612845,1034228144,5,3158,631.6,1360612837422,1360612837550,1034220566,1034220694,128
1360612845,1034228152,5,900,180,1360612838185,1360612838313,1034221337,1034221465,128
1360612845,1034228152,6,1869,311.5,1360612838312,1360612838568,1034221464,1034221720,256
1360612845,1034228152,6,1349,224.8333333,1360612833640,1360612840744,1034216792,1034223896,7104
1360612845,1034228152,5,900,180,1360612838376,1360612838440,1034221528,1034221592,64
1360612845,1034228152,8,2974,371.75,1360612838631,1360612838887,1034221783,1034222039,256
1360612845,1034228156,4,778,194.5,1360612838885,1360612838885,1034222041,1034222041,0
1360612845,1034228156,6,3769,628.1666667,1360612838885,1360612838949,1034222041,1034222105,64
1360612845,1034228156,4,591,147.75,1360612834148,1360612840740,1034217304,1034223896,6592
1360612845,1034228156,4,530,132.5,1360612839012,1360612839140,1034222168,1034222296,128
1360612845,1034228156,4,902,225.5,1360612834275,1360612840803,1034217431,1034223959,6528
1360612845,1034228156,6,3775,629.1666667,1360612839267,1360612839267,1034222423,1034222423,0
1360612845,1034228156,4,530,132.5,1360612839394,1360612839458,1034222550,1034222614,64
1360612849,1034231852,1,52,52,1360612822546,1360612822546,1034205398,1034205398,0
1360612850,3967512604,10,3057,305.7,1360612833940,1360612845140,3967496544,3967507744,11200
1360612850,3967512628,53,54614,1030.45283,1360612832762,1360612843130,3967495390,3967505758,10368
1360612853,1034235936,1,46,46,1360612826241,1360612826241,1034209177,1034209177,0
1360612853,1034236120,19,20739,1091.526316,1360612841930,1360612848778,1034225050,1034231898,6848
1360612869,1034252092,5,3266,653.2,1360612867685,1360612867813,1034250777,1034250905,128
1360612869,1034252116,5,900,180,1360612868557,1360612868749,1034251673,1034251865,192
1360612869,1034252176,4,773,193.25,1360612867345,1360612867473,1034250521,1034250649,128
1360612869,1034252176,4,774,193.5,1360612867409,1360612867601,1034250585,1034250777,192
1360612869,1034252176,5,3156,631.2,1360612867472,1360612867728,1034250648,1034250904,256
1360612869,1034252180,5,900,180,1360612868429,1360612868493,1034251609,1034251673,64
1360612877,1034260056,6,1869,311.5,1360612868809,1360612869065,1034251865,1034252121,256
1360612877,1034260056,8,2976,372,1360612869064,1360612875912,1034252120,1034258968,6848
1360612877,1034260056,4,778,194.5,1360612869128,1360612869256,1034252184,1034252312,128
1360612877,1034260056,6,3769,628.1666667,1360612869127,1360612869255,1034252183,1034252311,128
1360612877,1034260056,7,2974,424.8571429,1360612869127,1360612869255,1034252183,1034252311,128
1360612877,1034260056,6,3775,629.1666667,1360612869255,1360612869319,1034252311,1034252375,64
1360612877,1034260056,4,530,132.5,1360612869318,1360612869382,1034252374,1034252438,64
1360612877,1034260092,21,9356,445.5238095,1360612866660,1360612873892,1034249752,1034256984,7232
1360612877,1034260104,6,3021,503.5,1360612868119,1360612875927,1034251223,1034259031,7808
1360612877,1034260132,6,1869,311.5,1360612868733,1360612868925,1034251865,1034252057,192
1360612877,1034260132,5,653,130.6,1360612869115,1360612869243,1034252247,1034252375,128
1360612877,1034260136,4,530,132.5,1360612869368,1360612869496,1034252504,1034252632,128
1360612877,1034260172,20,9952,497.6,1360612866450,1360612873810,1034249622,1034256982,7360
1360612877,1034260176,6,1349,224.8333333,1360612863630,1360612873806,1034246806,1034256982,10176
1360612877,1034260184,11,10452,950.1818182,1360612872069,1360612872133,1034255253,1034255317,64
1360612877,1034260184,11,10451,950.0909091,1360612872201,1360612872393,1034255385,1034255577,192
1360612882,3967544644,5,764,152.8,1360612868393,1360612876201,3967531037,3967538845,7808
1360612882,3967544644,5,764,152.8,1360612868393,1360612876201,3967531037,3967538845,7808
1360612882,3967544644,5,764,152.8,1360612868393,1360612876201,3967531037,3967538845,7808
1360612901,1034284132,26,12859,494.5769231,1360612893884,1360612896956,1034277016,1034280088,3072
1360612901,1034284136,5,3158,631.6,1360612897976,1360612898424,1034281112,1034281560,448
1360612901,1034284136,4,773,193.25,1360612894710,1360612894838,1034277846,1034277974,128
1360612901,1034284168,6,1869,311.5,1360612895702,1360612895894,1034278870,1034279062,192
1360612901,1034284200,8,3411,426.375,1360612896950,1360612897270,1034280150,1034280470,320
1360612901,1034284204,7,3044,434.8571429,1360612897458,1360612897714,1034280662,1034280918,256
1360612901,1034284208,5,826,165.2,1360612897711,1360612898159,1034280919,1034281367,448
1360612901,1034284212,5,3156,631.2,1360612894762,1360612894954,1034277974,1034278166,192
1360612901,1034284244,5,900,180,1360612895434,1360612895562,1034278678,1034278806,128
1360612901,1034284248,5,901,180.2,1360612899015,1360612899207,1034282263,1034282455,192
1360612901,1034284252,5,653,130.6,1360612896258,1360612896642,1034279510,1034279894,384
1360612909,1034292272,5,653,130.6,1360612902896,1360612903024,1034286168,1034286296,128
1360612909,1034292280,8,1989,248.625,1360612899175,1360612902375,1034282455,1034285655,3200
1360612909,1034292284,6,2511,418.5,1360612907618,1360612907682,1034290902,1034290966,64
1360612910,1034292324,6,1349,224.8333333,1360612894500,1360612904612,1034276824,1034286936,10112
1360612910,1034292356,4,778,194.5,1360612903811,1360612907971,1034286167,1034290327,4160
1360612910,1034292360,6,3024,504,1360612896192,1360612906624,1034278552,1034288984,10432
1360612910,1034292368,5,824,164.8,1360612897142,1360612903798,1034279510,1034286166,6656
1360612910,1034292372,4,591,147.75,1360612908401,1360612908465,1034290773,1034290837,64
1360612910,1034292372,5,954,190.8,1360612908596,1360612908788,1034290968,1034291160,192
1360612913,3967575928,5,2741,548.2,1360612912784,1360612912848,3967575712,3967575776,64
1360612914,3967576584,28,32037,1144.178571,1360612909224,1360612909416,3967571808,3967572000,192
1360612914,3967576584,55,54114,983.8909091,1360612906405,1360612909413,3967568989,3967571997,3008
1360612914,3967576588,10,3366,336.6,1360612907617,1360612913313,3967570205,3967575901,5696
1360612914,3967576592,4,464,116,1360612912223,1360612912287,3967574815,3967574879,64
1360612914,3967576592,5,764,152.8,1360612895838,1360612906206,3967558430,3967568798,10368
1360612914,3967576596,27,31985,1184.62963,1360612909212,1360612909340,3967571808,3967571936,128
1360612914,3967576612,7,1364,194.8571429,1360612895754,1360612906186,3967558366,3967568798,10432
1360612914,3967576612,4,464,116,1360612912202,1360612912266,3967574814,3967574878,64
1360612914,3967576612,4,464,116,1360612912201,1360612912265,3967574813,3967574877,64
1360612917,1034300160,5,896,179.2,1360612896607,1360612909983,1034279767,1034293143,13376
1360612917,1034300160,4,530,132.5,1360612912671,1360612912735,1034295831,1034295895,64
1360612917,1034300160,5,898,179.6,1360612908958,1360612909086,1034292118,1034292246,128
1360612917,1034300160,4,908,227,1360612912734,1360612912734,1034295894,1034295894,0
1360612917,1034300164,7,3281,468.7142857,1360612908953,1360612909081,1034292117,1034292245,128
1360612917,1034300200,5,3158,631.6,1360612911224,1360612911416,1034294424,1034294616,192
1360612917,1034300200,5,3156,631.2,1360612911223,1360612911351,1034294423,1034294551,128
1360612917,1034300200,4,1559,389.75,1360612911605,1360612911733,1034294805,1034294933,128
1360612917,1034300204,5,901,180.2,1360612911922,1360612912050,1034295126,1034295254,128
1360612917,1034300208,5,899,179.8,1360612907117,1360612914285,1034290325,1034297493,7168
1360612917,1034300208,6,1869,311.5,1360612912047,1360612912303,1034295255,1034295511,256
1360612917,1034300208,9,4052,450.2222222,1360612907247,1360612912559,1034290455,1034295767,5312
1360612917,1034300220,9,3380,375.5555556,1360612908964,1360612909220,1034292184,1034292440,256
1360612917,1034300232,2,92,46,1360612909142,1360612909334,1034292374,1034292566,192
1360612917,1034300244,4,774,193.5,1360612910985,1360612911049,1034294229,1034294293,64
1360612917,1034300248,4,773,193.25,1360612910984,1360612911048,1034294232,1034294296,64
1360612917,1034300248,4,1558,389.5,1360612911494,1360612911686,1034294742,1034294934,192
1360612917,1034300280,6,1983,330.5,1360612911974,1360612912230,1034295254,1034295510,256
1360612917,1034300284,5,901,180.2,1360612911844,1360612911972,1034295128,1034295256,128
1360612917,1034300284,12,5779,481.5833333,1360612895908,1360612909924,1034279192,1034293208,14016
1360612917,1034300284,3,1093,364.3333333,1360612912290,1360612912354,1034295574,1034295638,64
1360612917,1034300284,25,27955,1118.2,1360612896225,1360612912161,1034279509,1034295445,15936
1360612917,1034300288,6,3775,629.1666667,1360612912413,1360612912477,1034295701,1034295765,64
1360612917,1034300288,5,653,130.6,1360612912413,1360612912605,1034295701,1034295893,192
1360612922,3967584584,33,32309,979.0606061,1360612909224,1360612917480,3967571808,3967580064,8256
1360612926,1034308388,27,28909,1070.703704,1360612913572,1360612922212,1034295960,1034304600,8640
1360612926,1034308388,11,10451,950.0909091,1360612917923,1360612925091,1034300311,1034307479,7168
1360612926,1034308400,20,5822,291.1,1360612911128,1360612920856,1034293528,1034303256,9728
1360612926,1034308400,23,6814,296.2608696,1360612911191,1360612920919,1034293591,1034303319,9728
1360612926,1034308400,20,6685,334.25,1360612911191,1360612920919,1034293591,1034303319,9728
1360612926,1034308440,6,870,145,1360612913262,1360612921582,1034295702,1034304022,8320
1360612926,1034308516,9,3074,341.5555556,1360612912994,1360612922146,1034295510,1034304662,9152
1360612930,3967592592,6,1762,293.6666667,1360612928285,1360612928349,3967590877,3967590941,64
1360612930,3967592592,88,91786,1043.022727,1360612925216,1360612926944,3967587808,3967589536,1728
1360612930,3967592596,71,95256,1341.633803,1360612925596,1360612929372,3967588192,3967591968,3776
1360612930,3967592608,39,48414,1241.384615,1360612926671,1360612926991,3967589279,3967589599,320
1360612930,3967592608,18,18146,1008.111111,1360612926735,1360612927119,3967589343,3967589727,384
1360612934,1034316384,3,723,241,1360612933607,1360612933671,1034315991,1034316055,64
1360612934,1034316396,21,23689,1128.047619,1360612926873,1360612927321,1034309269,1034309717,448
1360612934,1034316396,38,47960,1262.105263,1360612926684,1360612933532,1034309080,1034315928,6848
1360612934,1034316396,10,8466,846.6,1360612930524,1360612930588,1034312920,1034312984,64
1360612934,1034316396,5,898,179.6,1360612930523,1360612930651,1034312919,1034313047,128
1360612934,1034316400,5,899,179.8,1360612927319,1360612927511,1034309719,1034309911,192
1360612934,1034316400,4,730,182.5,1360612927446,1360612927574,1034309846,1034309974,128
1360612934,1034316432,6,1018,169.6666667,1360612928759,1360612928887,1034311191,1034311319,128
1360612934,1034316440,4,772,193,1360612932592,1360612932720,1034315032,1034315160,128
1360612934,1034316440,8,3090,386.25,1360612932720,1360612932912,1034315160,1034315352,192
1360612934,1034316464,22,27151,1234.136364,1360612925910,1360612933014,1034308374,1034315478,7104
1360612934,1034316468,8,3327,415.875,1360612929874,1360612930066,1034312342,1034312534,192
1360612934,1034316476,9,3374,374.8888889,1360612930312,1360612930440,1034312788,1034312916,128
1360612934,1034316476,8,3410,426.25,1360612930376,1360612930504,1034312852,1034312980,128
1360612934,1034316476,16,12589,786.8125,1360612930380,1360612930892,1034312856,1034313368,512
1360612934,1034316476,24,29704,1237.666667,1360612926924,1360612927180,1034309400,1034309656,256
1360612934,1034316476,4,2902,725.5,1360612927242,1360612927306,1034309718,1034309782,64
1360612934,1034316480,9,3457,384.1111111,1360612930760,1360612930888,1034313240,1034313368,128
1360612934,1034316480,7,3042,434.5714286,1360612930759,1360612930951,1034313239,1034313431,192
1360612934,1034316480,16,5561,347.5625,1360612930759,1360612931207,1034313239,1034313687,448
1360612934,1034316508,4,591,147.75,1360612928553,1360612928617,1034311061,1034311125,64
1360612934,1034316512,7,2563,366.1428571,1360612928616,1360612928680,1034311128,1034311192,64
1360612934,1034316516,4,731,182.75,1360612929314,1360612929634,1034311830,1034312150,320
1360612937,1034320104,9,3463,384.7777778,1360612909461,1360612910997,1034292565,1034294101,1536
1360612937,1034320140,1,46,46,1360612910065,1360612910065,1034293205,1034293205,0
1360612938,3967600588,11,10406,946,1360612930082,1360612930146,3967592670,3967592734,64
1360612938,3967600588,8,6443,805.375,1360612925922,1360612933090,3967588510,3967595678,7168
1360612938,3967600588,27,31985,1184.62963,1360612929888,1360612930080,3967592476,3967592668,192
1360612938,3967600592,9,6174,686,1360612934368,1360612934496,3967596960,3967597088,128
1360612938,3967600592,9,4740,526.6666667,1360612926368,1360612934048,3967588960,3967596640,7680
1360612938,3967600592,4,464,116,1360612934814,1360612934878,3967597406,3967597470,64
1360612938,3967600592,15,5238,349.2,1360612927006,1360612934878,3967589598,3967597470,7872
1360612938,3967600600,4,525,131.25,1360612936727,1360612936791,3967599327,3967599391,64
1360612938,3967600600,153,210448,1375.477124,1360612925589,1360612937045,3967588189,3967599645,11456
1360612938,3967600612,28,32037,1144.178571,1360612929867,1360612930059,3967592479,3967592671,192
1360612938,3967600612,27,31985,1184.62963,1360612929867,1360612929995,3967592479,3967592607,128
1360612938,3967600612,28,32037,1144.178571,1360612929867,1360612930059,3967592479,3967592671,192
1360612938,3967600612,22,18246,829.3636364,1360612934155,1360612934411,3967596767,3967597023,256
1360612938,3967600612,9,6174,686,1360612934219,1360612934411,3967596831,3967597023,192
1360612938,3967600612,49,63024,1286.204082,1360612926410,1360612933706,3967589022,3967596318,7296
1360612938,3967600620,32,40669,1270.90625,1360612936131,1360612936259,3967598751,3967598879,128
1360612938,3967600620,6,3892,648.6666667,1360612936323,1360612936643,3967598943,3967599263,320
1360612942,1034324416,5,3159,631.8,1360612934085,1360612934469,1034316501,1034316885,384
1360612942,1034324420,6,2768,461.3333333,1360612934466,1360612941506,1034316886,1034323926,7040
1360612942,1034324424,4,714,178.5,1360612935166,1360612935230,1034317590,1034317654,64
1360612942,1034324428,5,900,180,1360612935610,1360612935738,1034318038,1034318166,128
1360612942,1034324428,4,666,166.5,1360612935738,1360612936186,1034318166,1034318614,448
1360612942,1034324432,6,1989,331.5,1360612935864,1360612936184,1034318296,1034318616,320
1360612942,1034324432,3,1092,364,1360612936183,1360612936311,1034318615,1034318743,128
1360612942,1034324456,8,2926,365.75,1360612936094,1360612936222,1034318550,1034318678,128
1360612942,1034324456,6,4048,674.6666667,1360612936349,1360612936541,1034318805,1034318997,192
1360612942,1034324460,8,2975,371.875,1360612936284,1360612936412,1034318744,1034318872,128
1360612942,1034324460,5,653,130.6,1360612936474,1360612936922,1034318934,1034319382,448
1360612942,1034324460,4,530,132.5,1360612936857,1360612936985,1034319317,1034319445,128
1360612942,1034324464,19,21947,1155.105263,1360612936853,1360612937045,1034319317,1034319509,192
1360612942,1034324476,5,3155,631,1360612933772,1360612934284,1034316248,1034316760,512
1360612942,1034324500,4,1556,389,1360612934770,1360612941490,1034317270,1034323990,6720
1360612942,1034324504,4,1557,389.25,1360612935020,1360612935212,1034317524,1034317716,192
1360612942,1034324504,5,900,180,1360612935534,1360612935598,1034318038,1034318102,64
1360612942,1034324508,6,1869,311.5,1360612935788,1360612935980,1034318296,1034318488,192
1360612942,1034324512,4,778,194.5,1360612936360,1360612936488,1034318872,1034319000,128
1360612942,1034324512,6,3769,628.1666667,1360612936488,1360612936552,1034319000,1034319064,64
1360612942,1034324512,6,1006,167.6666667,1360612936487,1360612936871,1034318999,1034319383,384
1360612942,1034324540,9,5946,660.6666667,1360612928907,1360612937227,1034311447,1034319767,8320
1360612946,3967608580,9,6174,686,1360612934188,1360612941164,3967596768,3967603744,6976
1360612946,3967608584,17,9935,584.4117647,1360612932325,1360612941157,3967594909,3967603741,8832
1360612946,3967608584,12,5094,424.5,1360612932325,1360612941157,3967594909,3967603741,8832
1360612946,3967608584,26,29129,1120.346154,1360612932325,1360612941157,3967594909,3967603741,8832
1360612950,1034332440,13,12306,946.6153846,1360612939821,1360612947501,1034322261,1034329941,7680
1360612950,1034332524,7,2436,348,1360612947802,1360612948122,1034330326,1034330646,320
1360612961,1034344192,1,52,52,1360612932925,1360612932925,1034316117,1034316117,0
1360612973,1034356252,36,48301,1341.694444,1360612947266,1360612947394,1034330518,1034330646,128
1360612973,1034356252,17,20529,1207.588235,1360612947265,1360612947393,1034330517,1034330645,128
1360612973,1034356256,4,1683,420.75,1360612947452,1360612947708,1034330708,1034330964,256
1360612973,1034356276,23,29458,1280.782609,1360612947434,1360612947754,1034330710,1034331030,320
1360613038,1034420576,6,447,74.5,1360613031397,1360613035685,1034413973,1034418261,4288
1360680337,1101720092,1,48,48,1360680308903,1360680308903,1101691995,1101691995,0
1360680662,1102045056,1,46,46,1360680634243,1360680634243,1102017299,1102017299,0
1360680771,1102153396,2,122,61,1360680746133,1360680748245,1102128529,1102130641,2112
1360680874,1102256752,3,505,168.3333333,1360680870834,1360680870898,1102253586,1102253650,64
1360680874,1102256836,11,3743,340.2727273,1360680871515,1360680872795,1102254351,1102255631,1280
1360680914,1102296840,3,505,168.3333333,1360680912279,1360680912343,1102295119,1102295183,64
1360680922,1102304804,11,3743,340.2727273,1360680913147,1360680914427,1102295951,1102297231,1280
1360680962,1102344784,11,3743,340.2727273,1360680955089,1360680956433,1102337873,1102339217,1344
1360680962,1102344836,3,505,168.3333333,1360680954204,1360680954332,1102337040,1102337168,128
1360681633,1103015312,1,148,148,1360681605855,1360681605855,1102988167,1102988167,0
1360681908,1103290572,1,46,46,1360681878292,1360681878292,1103260864,1103260864,0
1360682130,1103512680,2,96,48,1360682105382,1360682108262,1103488062,1103490942,2880
1360683811,1105193428,1,48,48,1360683784776,1360683784776,1105167204,1105167204,0
1360683839,4038501648,9,3418,379.7777778,1360683837053,1360683837501,4038499701,4038500149,448
1360683846,1105229036,31,11327,365.3870968,1360683835943,1360683838567,1105218979,1105221603,2624
1360683862,1105244212,16,3041,190.0625,1360683837279,1360683841567,1105219491,1105223779,4288
1360683862,1105244216,4,481,120.25,1360683837597,1360683837917,1105219813,1105220133,320
1360683862,1105244260,19,16496,868.2105263,1360683835825,1360683842929,1105218085,1105225189,7104
1360683862,1105244260,24,20892,870.5,1360683835825,1360683843441,1105218085,1105225701,7616
1360683862,1105244260,22,22180,1008.181818,1360683835825,1360683836849,1105218085,1105219109,1024
1360683862,1105245084,6,581,96.83333333,1360683850807,1360683855415,1105233891,1105238499,4608
1360683870,1105252428,45,12874,286.0888889,1360683842890,1360683867530,1105225318,1105249958,24640
1360683870,1105252516,69,86638,1255.623188,1360683843247,1360683865711,1105225763,1105248227,22464
1360683870,1105252548,24,4463,185.9583333,1360683843791,1360683858063,1105226339,1105240611,14272
1360683870,1105253024,3,156,52,1360683867060,1360683869364,1105250084,1105252388,2304
1360683870,1105253056,13,13044,1003.384615,1360683848212,1360683862484,1105231268,1105245540,14272
1360683871,4038533664,7,3368,481.1428571,1360683848235,1360683869355,4038510899,4038532019,21120
1360683874,1105256548,23,25303,1100.130435,1360683848783,1360683867791,1105231331,1105250339,19008
1360683886,1105269028,2,104,52,1360683872430,1360683878574,1105255458,1105261602,6144
1360683894,1105277032,2,127,63.5,1360683886314,1360683886314,1105269346,1105269346,0
1360683894,1105277040,5,1599,319.8,1360683874467,1360683886371,1105257507,1105269411,11904
1360683895,1105277088,2,127,63.5,1360683887261,1360683887261,1105269349,1105269349,0
1360683895,1105277088,4,235,58.75,1360683887260,1360683887260,1105269348,1105269348,0
1360683895,1105277088,3,183,61,1360683887259,1360683887259,1105269347,1105269347,0
1360683898,4038560344,1,52,52,1360683871982,1360683871982,4038534326,4038534326,0
1360683902,1105284480,8,11408,1426,1360683876818,1360683901522,1105259298,1105284002,24704
1360683902,1105284552,2,104,52,1360683875149,1360683894029,1105257701,1105276581,18880
1360683918,1105300524,12,2696,224.6666667,1360683893223,1360683904167,1105275747,1105286691,10944
1360683918,1105300524,10,3974,397.4,1360683893222,1360683894950,1105275746,1105277474,1728
1360683918,1105301032,24,11840,493.3333333,1360683901353,1360683910377,1105284385,1105293409,9024
1360683918,1105301036,17,6691,393.5882353,1360683893289,1360683912489,1105276325,1105295525,19200
1360683918,1105301036,17,4725,277.9411765,1360683913512,1360683917224,1105296548,1105300260,3712
1360683918,1105301036,18,6374,354.1111111,1360683893415,1360683911655,1105276451,1105294691,18240
1360683918,1105301048,16,4579,286.1875,1360683911642,1360683912858,1105294690,1105295906,1216
1360683919,1105301088,38,10159,267.3421053,1360683895131,1360683911003,1105277219,1105293091,15872
1360683919,1105301088,17,4515,265.5882353,1360683911322,1360683913946,1105293410,1105296034,2624
1360683926,1105309052,14,4448,317.7142857,1360683918550,1360683920534,1105301602,1105303586,1984
1360683926,1105309060,16,7089,443.0625,1360683912397,1360683918541,1105295457,1105301601,6144
1360683927,1105309136,5,275,55,1360683921962,1360683922090,1105304098,1105304226,128
1360683927,1105309140,19,6999,368.3684211,1360683917285,1360683921701,1105299425,1105303841,4416
1360683930,1105312476,13,4295,330.3846154,1360683901847,1360683923543,1105284323,1105306019,21696
1360683930,1105312520,14,6493,463.7857143,1360683903979,1360683911467,1105286499,1105293987,7488
1360683934,1105317036,16,5381,336.3125,1360683930534,1360683932518,1105313570,1105315554,1984
1360683935,1105317120,17,4745,279.1176471,1360683921724,1360683931452,1105303844,1105313572,9728
1360683938,1105320508,20,13279,663.95,1360683910263,1360683931319,1105292771,1105313827,21056
1360683938,1105320636,19,21217,1116.684211,1360683912374,1360683912886,1105295010,1105295522,512
1360683946,1105328536,1,79,79,1360683919450,1360683919450,1105301986,1105301986,0
1360683946,1105328556,9,3517,390.7777778,1360683921031,1360683922503,1105303587,1105305059,1472
1360683946,1105328668,60,69744,1162.4,1360683921557,1360683940693,1105304225,1105323361,19136
1360683950,1105333052,17,2959,174.0588235,1360683941910,1360683943318,1105324962,1105326370,1408
1360683950,1105333060,17,3811,224.1764706,1360683938126,1360683944974,1105321186,1105328034,6848
1360683951,1105333112,19,4999,263.1052632,1360683946948,1360683947652,1105329060,1105329764,704
1360683958,1105340692,9,3972,441.3333333,1360683932798,1360683936318,1105315490,1105319010,3520
1360683966,1105348508,21,14418,686.5714286,1360683938680,1360683947384,1105321188,1105329892,8704
1360683970,1105352508,8,2488,311,1360683942454,1360683943222,1105324962,1105325730,768
1360683970,1105352524,21,4486,213.6190476,1360683943461,1360683962789,1105325985,1105345313,19328
1360683970,1105352592,1,52,52,1360683945440,1360683945440,1105328032,1105328032,0
1360683974,1105356540,11,7376,670.5454545,1360683946902,1360683947222,1105329442,1105329762,320
1360683974,1105356580,2,2852,1426,1360683948528,1360683964016,1105331108,1105346596,15488
1360683974,1105356656,26,29044,1117.076923,1360683947300,1360683962980,1105329956,1105345636,15680
1360683998,1105380648,3,630,210,1360683972714,1360683992682,1105355362,1105375330,19968
1360683999,1105381124,2,127,63.5,1360683993912,1360683993912,1105376036,1105376036,0
1360684006,1105388680,1,1426,1426,1360683978569,1360683978569,1105361249,1105361249,0
1360684007,1105389204,6,427,71.16666667,1360684001829,1360684006117,1105384033,1105388321,4288
1360684018,1105400660,9,9334,1037.111111,1360683993564,1360684016156,1105376224,1105398816,22592
1360684018,1105400712,6,4599,766.5,1360683992618,1360683992810,1105375330,1105375522,192
1360684022,1105404604,1,1426,1426,1360683994965,1360683994965,1105377569,1105377569,0
1360684030,1105412820,1,210,210,1360684002494,1360684002494,1105385314,1105385314,0
1360684034,1105416960,1,1426,1426,1360684009457,1360684009457,1105392417,1105392417,0
1360684038,1105420896,3,225,75,1360684009905,1360684037105,1105392801,1105420001,27200
1360684039,1105421184,4,289,72.25,1360684031799,1360684038455,1105413983,1105420639,6656
1360684047,1105429168,5,368,73.6,1360684042827,1360684045003,1105424995,1105427171,2176
1360684047,1105429168,4,289,72.25,1360684043144,1360684044936,1105425312,1105427104,1792
1360684055,1105437200,2,158,79,1360684047275,1360684052075,1105429475,1105434275,4800
1360684055,1105437200,2,158,79,1360684047465,1360684052393,1105429665,1105434593,4928
1360684066,1105448968,1,1426,1426,1360684038889,1360684038889,1105421857,1105421857,0
1360684071,1105453188,2,158,79,1360684047284,1360684065076,1105429472,1105447264,17792
1360684071,1105453192,5,368,73.6,1360684067632,1360684069424,1105449824,1105451616,1792
1360684079,1105461288,2,158,79,1360684071377,1360684075473,1105453665,1105457761,4096
1360684086,1105468968,2,158,79,1360684061481,1360684081257,1105444449,1105464225,19776
1360684086,1105469084,2,158,79,1360684060787,1360684080051,1105443871,1105463135,19264
1360684099,1105481100,1,75,75,1360684074061,1360684074061,1105456161,1105456161,0
1360684103,1105485320,2,158,79,1360684083630,1360684100078,1105465950,1105482398,16448
1360684111,1105493088,1,1426,1426,1360684085914,1360684085914,1105468002,1105468002,0
1360684119,1105501276,4,208,52,1360684113244,1360684117148,1105495520,1105499424,3904
1360684126,1105509052,1,79,79,1360684099732,1360684099732,1105482784,1105482784,0
1360684135,1105517372,2,104,52,1360684121530,1360684130490,1105503902,1105512862,8960
1360684138,1105520968,1,52,52,1360684113448,1360684113448,1105496416,1105496416,0
1360684146,1105528916,1,79,79,1360684118620,1360684118620,1105501536,1105501536,0
1360684146,1105528996,1,79,79,1360684120716,1360684120716,1105503712,1105503712,0
1360684158,1105541080,1,79,79,1360684132151,1360684132151,1105515231,1105515231,0
1360684159,1105541324,3,156,52,1360684153066,1360684155626,1105535390,1105537950,2560
1360684175,1105557112,1,52,52,1360684148734,1360684148734,1105530846,1105530846,0
1360684183,1105565692,3,156,52,1360684173818,1360684177146,1105556510,1105559838,3328
1360684186,1105569072,1,52,52,1360684158336,1360684158336,1105541408,1105541408,0
1360684190,1105572812,271,375666,1386.221402,1360683842563,1360683887619,1105225375,1105270431,45056
1360684210,1105593012,1,52,52,1360684183740,1360684183740,1105566752,1105566752,0
1360684223,1105605184,1,78,78,1360684198070,1360684198070,1105580254,1105580254,0
1360684250,1105632872,217,296399,1365.894009,1360683925701,1360683945989,1105308573,1105328861,20288
1360684267,1105649088,1,46,46,1360684239447,1360684239447,1105621535,1105621535,0
1360684275,1105657140,1,46,46,1360684247971,1360684247971,1105630111,1105630111,0
1360684278,1105661020,1,46,46,1360684251249,1360684251249,1105634269,1105634269,0
1360684323,1105705184,1,46,46,1360684297013,1360684297013,1105679197,1105679197,0
1360684399,1105781584,6,447,74.5,1360684393445,1360684397605,1105776029,1105780189,4160
1360684415,1105797572,2,158,79,1360684402031,1360684410927,1105784603,1105793499,8896
1360684455,1105837340,1,79,79,1360684428887,1360684428887,1105811227,1105811227,0
1360684491,1105873436,1,79,79,1360684464181,1360684464181,1105846617,1105846617,0
1360684800,1106182216,2,131,65.5,1360684795278,1360684795278,1106177494,1106177494,0
1360685730,1107112224,1,48,48,1360685703029,1360685703029,1107085253,1107085253,0
1360764485,1185867528,1,48,48,1360764457254,1360764457254,1185839782,1185839782,0
1360764485,1185867568,1,48,48,1360764457020,1360764457020,1185839588,1185839588,0
1360764485,1185867568,1,48,48,1360764457084,1360764457084,1185839652,1185839652,0
1360764513,1185895616,7,1309,187,1360764488652,1360764504332,1185871268,1185886948,15680
1360764541,1185923748,3,561,187,1360764514182,1360764534214,1185896930,1185916962,20032
1360764570,1185951856,1,187,187,1360764545092,1360764545092,1185926948,1185926948,0
1360764580,1185962608,1,46,46,1360764549972,1360764549972,1185932580,1185932580,0
1360764746,1186128160,2,122,61,1360764720017,1360764722449,1186102177,1186104609,2432
1360764778,1186160236,1,46,46,1360764753476,1360764753476,1186135712,1186135712,0
1360765195,1186577156,1,46,46,1360765168271,1360765168271,1186550427,1186550427,0
1360765734,1187116632,19,5408,284.6315789,1360765730796,1360765732332,1187113428,1187114964,1536
1360765742,1187124536,132,178304,1350.787879,1360765725898,1360765736266,1187108434,1187118802,10368
1360765742,1187124596,4,356,89,1360765728398,1360765736206,1187110994,1187118802,7808
1360765742,1187124596,39,50171,1286.435897,1360765726477,1360765734157,1187109073,1187116753,7680
1360765742,1187124600,4,414,103.5,1360765728712,1360765736200,1187111312,1187118800,7488
1360765744,1187125980,8,3153,394.125,1360765718580,1360765718964,1187100560,1187100944,384
1360765744,1187126020,15,3228,215.2,1360765717324,1360765723404,1187099344,1187105424,6080
1360765748,1187130076,8,4007,500.875,1360765723157,1360765724629,1187105233,1187106705,1472
1360765750,1187132648,5,895,179,1360765744282,1360765744602,1187126930,1187127250,320
1360765772,1187154072,4,1732,433,1360765745115,1360765745179,1187127187,1187127251,64
1360765772,1187154072,23,29784,1294.956522,1360765745242,1360765745434,1187127314,1187127506,192
1360765846,1187228704,6,447,74.5,1360765838175,1360765842079,1187220879,1187224783,3904
1360765862,1187244764,2,158,79,1360765846245,1360765854565,1187229009,1187237329,8320
1360765900,1187282240,1,79,79,1360765871856,1360765871856,1187254096,1187254096,0
1360765932,1187314220,1,79,79,1360765905346,1360765905346,1187287566,1187287566,0
1360765967,1187348820,4,208,52,1360765964884,1360765966676,1187346704,1187348496,1792
1360765990,1187372784,5,260,52,1360765984654,1360765988494,1187367438,1187371278,3840
1360765990,1187372788,108,143588,1329.518519,1360765744394,1360765988554,1187127182,1187371342,244160
1360765991,1187372828,5,260,52,1360765985419,1360765989067,1187367247,1187370895,3648
1360765996,1187378416,1,52,52,1360765968125,1360765968125,1187350541,1187350541,0
1360766858,1188240020,1,46,46,1360766832187,1360766832187,1188214207,1188214207,0
1360767150,1188532532,1,60,60,1360767123706,1360767123706,1188506238,1188506238,0
1360767166,1188548552,16,3438,214.875,1360767138662,1360767144742,1188521214,1188527294,6080
1360767166,1188548556,1,52,52,1360767139298,1360767139298,1188521854,1188521854,0
1360767202,1188584488,25,18172,726.88,1360767173987,1360767190371,1188556475,1188572859,16384
1360767208,1188590092,31,33317,1074.741935,1360767191857,1360767200305,1188573949,1188582397,8448
1360767208,1188590104,4,356,89,1360767192934,1360767200294,1188575038,1188582398,7360
1360767214,1188596560,4,528,132,1360767189084,1360767189148,1188571644,1188571708,64
1360767216,1188598132,37,47773,1291.162162,1360767202631,1360767210247,1188584763,1188592379,7616
1360767216,1188598144,3,481,160.3333333,1360767204219,1360767212347,1188586363,1188594491,8128
1360767216,1188598172,4,820,205,1360767202273,1360767210209,1188584445,1188592381,7936
1360767216,1188598176,18,20875,1159.722222,1360767202589,1360767210205,1188584765,1188592381,7616
1360767216,1188598184,8,2062,257.75,1360767203477,1360767212245,1188585661,1188594429,8768
1360767216,1188598184,4,592,148,1360767204114,1360767210194,1188586298,1188592378,6080
1360767216,1188598188,3,480,160,1360767204113,1360767210193,1188586301,1188592381,6080
1360767224,1188606144,134,180879,1349.843284,1360767204154,1360767216314,1188586298,1188598458,12160
1360767256,1188638140,5,2754,550.8,1360767248576,1360767255296,1188630716,1188637436,6720
1360767256,1188638180,6,982,163.6666667,1360767245782,1360767253270,1188627962,1188635450,7488
1360767256,1188638224,31,31434,1014,1360767244713,1360767255209,1188626937,1188637433,10496
1360767256,1188638228,76,99431,1308.302632,1360767245734,1360767253222,1188627962,1188635450,7488
1360767272,1188654132,10,7430,743,1360767263880,1360767271304,1188646012,1188653436,7424
1360767274,1188656764,9,3463,384.7777778,1360767248909,1360767249485,1188631673,1188632249,576
1360767280,1188662120,4,352,88,1360767275282,1360767275474,1188657402,1188657594,192
1360767280,1188662128,5,895,179,1360767274186,1360767274506,1188656314,1188656634,320
1360767280,1188662200,17,15544,914.3529412,1360767274308,1360767275140,1188656508,1188657340,832
1360767288,1188670128,4,356,89,1360767274699,1360767281291,1188656827,1188663419,6592
1360767288,1188670176,24,29837,1243.208333,1360767274523,1360767281307,1188656699,1188663483,6784
1360767288,1188670180,14,14570,1040.714286,1360767275032,1360767281240,1188657212,1188663420,6208
1360767335,1188716856,54,35318,654.037037,1360767308186,1360767334874,1188690042,1188716730,26688
1360767359,1188740920,16,6712,419.5,1360767333273,1360767334617,1188715193,1188716537,1344
1360767359,1188741004,3,273,91,1360767334788,1360767334980,1188716792,1188716984,192
1360767360,1188742164,8,4091,511.375,1360767355175,1360767356647,1188737339,1188738811,1472
1360767360,1188742164,20,8203,410.15,1360767351526,1360767355238,1188733690,1188737402,3712
1360767375,1188756948,5,1518,303.6,1360767348668,1360767353468,1188730616,1188735416,4800
1360767375,1188756956,7,3219,459.8571429,1360767349366,1360767350966,1188731322,1188732922,1600
1360767375,1188757032,7,3219,459.8571429,1360767349289,1360767350889,1188731321,1188732921,1600
1360767376,1188758244,2,131,65.5,1360767369878,1360767369878,1188752122,1188752122,0
1360767379,1188760920,57,47411,831.7719298,1360767351833,1360767370585,1188733753,1188752505,18752
1360767379,1188760984,12,8948,745.6666667,1360767354714,1360767355290,1188736698,1188737274,576
1360767379,1188760988,23,12912,561.3913043,1360767350934,1360767360854,1188732922,1188742842,9920
1360767379,1188761032,4,1157,289.25,1360767354025,1360767354473,1188736057,1188736505,448
1360767383,1188764992,5,3034,606.8,1360767355088,1360767355152,1188737080,1188737144,64
1360767383,1188765040,24,29681,1236.708333,1360767357857,1360767363041,1188739897,1188745081,5184
1360767383,1188765048,8,5985,748.125,1360767358107,1360767359515,1188740155,1188741563,1408
1360767383,1188765076,58,55475,956.4655172,1360767355259,1360767371131,1188737335,1188753207,15872
1360767383,1188765120,17,19176,1128,1360767357776,1360767362960,1188739896,1188745080,5184
1360767383,1188765124,12,10557,879.75,1360767358029,1360767359565,1188740153,1188741689,1536
1360767391,1188772900,18,22140,1230,1360767363182,1360767372910,1188745082,1188754810,9728
1360767391,1188772960,8,8423,1052.875,1360767363122,1360767363186,1188745082,1188745146,64
1360767391,1188772960,12,13381,1115.083333,1360767363122,1360767372978,1188745082,1188754938,9856
1360767395,1188776968,3,419,139.6666667,1360767370023,1360767370279,1188751991,1188752247,256
1360767395,1188776972,13,5298,407.5384615,1360767370468,1360767372452,1188752440,1188754424,1984
1360767395,1188777048,6,2515,419.1666667,1360767370138,1360767371546,1188752186,1188753594,1408
1360767395,1188777048,5,2022,404.4,1360767370330,1360767370394,1188752378,1188752442,64
1360767395,1188777048,10,4974,497.4,1360767370392,1360767371864,1188752440,1188753912,1472
1360767399,1188780976,4,1050,262.5,1360767373792,1360767392544,1188755768,1188774520,18752
1360767399,1188781016,8,6770,846.25,1360767372023,1360767372983,1188754039,1188754999,960
1360767399,1188781056,6,3150,525,1360767373712,1360767374096,1188755768,1188756152,384
1360767427,1188809476,1,469,469,1360767402026,1360767402026,1188784502,1188784502,0
1360767455,1188837232,1,52,52,1360767430624,1360767430624,1188812856,1188812856,0
1360767455,1188837304,1,52,52,1360767429398,1360767429398,1188811702,1188811702,0
1360767464,1188846308,3878,5491299,1416.013151,1360767370194,1360767459346,1188752502,1188841654,89152
1360767472,1188854216,2,192,96,1360767467631,1360767467631,1188849847,1188849847,0
1360767480,1188862196,2,192,96,1360767472642,1360767472642,1188854838,1188854838,0
1360767547,1188929268,9,3819,424.3333333,1360767519675,1360767520571,1188901943,1188902839,896
1360767568,1188950356,5,1057,211.4,1360767562531,1360767562595,1188944887,1188944951,64
1360767579,1188961352,11,7966,724.1818182,1360767552102,1360767555814,1188934454,1188938166,3712
1360767583,1188965268,11,12984,1180.363636,1360767558906,1360767561146,1188941174,1188943414,2240
1360767583,1188965268,57,73217,1284.508772,1360767558906,1360767577402,1188941174,1188959670,18496
1360767583,1188965268,8,10460,1307.5,1360767558906,1360767558906,1188941174,1188941174,0
1360767583,1188965288,1,46,46,1360767557094,1360767557094,1188939382,1188939382,0
1360767583,1188965616,34,33258,978.1764706,1360767557405,1360767567133,1188940021,1188949749,9728
1360767583,1188965672,30,24292,809.7333333,1360767557350,1360767567078,1188940022,1188949750,9728
1360767583,1188965672,2,988,494,1360767557350,1360767570982,1188940022,1188953654,13632
1360767583,1188965700,6,7535,1255.833333,1360767558411,1360767558411,1188941111,1188941111,0
1360767583,1188965700,7,9802,1400.285714,1360767558345,1360767558409,1188941045,1188941109,64
1360767584,1188966324,13,3571,274.6923077,1360767580417,1360767580929,1188962741,1188963253,512
1360767584,1188966376,13,3571,274.6923077,1360767580367,1360767581327,1188962743,1188963703,960
1360767584,1188966376,4,184,46,1360767580558,1360767580558,1188962934,1188962934,0
1360767584,1188966392,13,3571,274.6923077,1360767580861,1360767581757,1188963253,1188964149,896
1360767587,1188969360,4,1776,444,1360767562397,1360767562461,1188944757,1188944821,64
1360767587,1188969364,19,12173,640.6842105,1360767562714,1360767567834,1188945078,1188950198,5120
1360767587,1188969364,11,11165,1015,1360767562714,1360767565594,1188945078,1188947958,2880
1360767587,1188969440,2,1050,525,1360767562253,1360767566797,1188944693,1188949237,4544
1360767587,1188969444,12,4596,383,1360767562633,1360767567689,1188945077,1188950133,5056
1360767591,1188973296,8,5653,706.625,1360767562910,1360767563550,1188945206,1188945846,640
1360767595,1188977308,2,1115,557.5,1360767566928,1360767566992,1188949236,1188949300,64
1360767595,1188977320,3,2843,947.6666667,1360767567556,1360767567556,1188949876,1188949876,0
1360767595,1188977392,3,904,301.3333333,1360767567231,1360767567487,1188949623,1188949879,256
1360767595,1188977400,4,1780,445,1360767567604,1360767567668,1188950004,1188950068,64
1360767599,1188981392,1,469,469,1360767571261,1360767571261,1188953653,1188953653,0
1360767607,1188989340,9,3463,384.7777778,1360767580528,1360767580912,1188962868,1188963252,384
1360767611,1188993368,6,3150,525,1360767586455,1360767586775,1188968823,1188969143,320
1360767611,1188993456,1,494,494,1360767586367,1360767586367,1188968823,1188968823,0
1360767611,1188993456,1,52,52,1360767586367,1360767586367,1188968823,1188968823,0
1360767615,1188997312,31,35464,1144,1360767587405,1360767594317,1188969717,1188976629,6912
1360767615,1188997356,1,52,52,1360767590561,1360767590561,1188972917,1188972917,0
1360767615,1188997388,84,98994,1178.5,1360767587265,1360767594305,1188969653,1188976693,7040
1360767615,1188997404,40,47350,1183.75,1360767588659,1360767594547,1188971063,1188976951,5888
1360767615,1188997432,19,21277,1119.842105,1360767589845,1360767590229,1188972277,1188972661,384
1360767615,1188997440,1,52,52,1360767590540,1360767590540,1188972980,1188972980,0
1360767619,1189001376,1,52,52,1360767594124,1360767594124,1188976500,1188976500,0
1360767619,1189001384,1,52,52,1360767594823,1360767594823,1188977207,1188977207,0
1360767619,1189001460,48,57889,1206.020833,1360767594298,1360767602106,1188976758,1188984566,7808
1360767623,1189005376,1,52,52,1360767594893,1360767594893,1188977269,1188977269,0
1360767627,1189009380,1,52,52,1360767599176,1360767599176,1188981556,1188981556,0
1360767627,1189009384,1,52,52,1360767599303,1360767599303,1188981687,1188981687,0
1360767631,1189013344,34,20002,588.2941176,1360767605677,1360767620909,1188988021,1189003253,15232
1360767632,1189014432,3,138,46,1360767629781,1360767629781,1189012213,1189012213,0
1360767640,1189022424,2,92,46,1360767633310,1360767633310,1189015734,1189015734,0
1360767647,1189029364,27,18455,683.5185185,1360767621912,1360767629720,1189004276,1189012084,7808
1360767647,1189029368,5,5530,1106,1360767622548,1360767622612,1189004916,1189004980,64
1360767647,1189029448,5,5604,1120.8,1360767622343,1360767622343,1189004791,1189004791,0
1360767647,1189029448,8,9960,1245,1360767622406,1360767622470,1189004854,1189004918,64
1360767647,1189029448,51,66731,1308.45098,1360767622533,1360767628613,1189004981,1189011061,6080
1360767648,1189030404,2,131,65.5,1360767640371,1360767640371,1189022775,1189022775,0
1360767655,1189037328,2,988,494,1360767628093,1360767628285,1189010421,1189010613,192
1360767655,1189037368,13,13031,1002.384615,1360767629846,1360767630934,1189012214,1189013302,1088
1360767659,1189041416,52,25349,487.4807692,1360767633318,1360767649766,1189015734,1189032182,16448
1360767664,1189046368,4,356,89,1360767651540,1360767659092,1189033908,1189041460,7552
1360767664,1189046444,24,25857,1077.375,1360767650504,1360767659016,1189032948,1189041460,8512
1360767672,1189054360,6,2064,344,1360767667292,1360767668316,1189049652,1189050676,1024
1360767672,1189054404,5,895,179,1360767666993,1360767667633,1189049397,1189050037,640
1360767672,1189054416,4,352,88,1360767668389,1360767668517,1189050805,1189050933,128
1360767680,1189062408,6,472,78.66666667,1360767667437,1360767675373,1189049845,1189057781,7936
1360767680,1189062408,25,30104,1204.16,1360767667691,1360767675179,1189050099,1189057587,7488
1360767704,1189086472,2,131,65.5,1360767700715,1360767700715,1189083187,1189083187,0
1360767768,1189150420,3,138,46,1360767763425,1360767763425,1189145845,1189145845,0
1360767768,1189150420,3,138,46,1360767763871,1360767763871,1189146291,1189146291,0
1360767768,1189150420,31,10694,344.9677419,1360767763870,1360767765662,1189146290,1189148082,1792
1360767768,1189150468,15,6089,405.9333333,1360767763375,1360767764271,1189145843,1189146739,896
1360767776,1189158480,21,6715,319.7619048,1360767767586,1360767775522,1189150066,1189158002,7936
1360767776,1189158528,17,7496,440.9411765,1360767763379,1360767768755,1189145907,1189151283,5376
1360767784,1189166404,28,5182,185.0714286,1360767779376,1360767781488,1189161780,1189163892,2112
1360767784,1189166444,13,2114,162.6153846,1360767774085,1360767782149,1189156529,1189164593,8064
1360767784,1189166456,43,31768,738.7906977,1360767767353,1360767782137,1189149809,1189164593,14784
1360767784,1189166456,19,11521,606.3684211,1360767775803,1360767776891,1189158259,1189159347,1088
1360767784,1189166456,19,10916,574.5263158,1360767775803,1360767776891,1189158259,1189159347,1088
1360767784,1189166492,24,8550,356.25,1360767773016,1360767776984,1189155508,1189159476,3968
1360767785,4122447764,27,29731,1101.148148,1360767768946,1360767777586,4122431710,4122440350,8640
1360767785,4122447764,39,42610,1092.564103,1360767768949,1360767777717,4122431713,4122440481,8768
1360767785,4122447768,26,23869,918.0384615,1360767768881,1360767777713,4122431649,4122440481,8832
1360767785,4122447788,71,92779,1306.746479,1360767768924,1360767779804,4122431712,4122442592,10880
1360767791,1189173508,13,1089,83.76923077,1360767765318,1360767768262,1189147826,1189150770,2944
1360767792,1189174420,29,9854,339.7931034,1360767787614,1360767789726,1189170034,1189172146,2112
1360767792,1189174428,20,11177,558.85,1360767775832,1360767784152,1189158260,1189166580,8320
1360767792,1189174460,49,13555,276.6326531,1360767781240,1360767786936,1189163700,1189169396,5696
1360767792,1189174500,52,40708,782.8461538,1360767772493,1360767784141,1189154993,1189166641,11648
1360767792,1189174500,11,3346,304.1818182,1360767777423,1360767786063,1189159923,1189168563,8640
1360767792,1189174504,12,2973,247.75,1360767777932,1360767786060,1189160436,1189168564,8128
1360767793,4122455756,28,24515,875.5357143,1360767788860,1360767789948,4122451616,4122452704,1088
1360767793,4122455756,23,16632,723.1304348,1360767777659,1360767787131,4122440415,4122449887,9472
1360767795,1189177660,8,2860,357.5,1360767767407,1360767768815,1189150067,1189151475,1408
1360767801,4122463752,90,109698,1218.866667,1360767788862,1360767793790,4122451614,4122456542,4928
1360767803,1189185536,21,14330,682.3809524,1360767776362,1360767777514,1189158898,1189160050,1152
1360767803,1189185608,43,36109,839.744186,1360767776354,1360767796706,1189158962,1189179314,20352
1360767803,1189185652,8,5441,680.125,1360767777718,1360767779702,1189160370,1189162354,1984
1360767809,4122471768,22,20017,909.8636364,1360767803439,1360767804207,4122466207,4122466975,768
1360767823,1189205572,1,52,52,1360767798471,1360767798471,1189181043,1189181043,0
1360767831,1189213504,1,52,52,1360767803337,1360767803337,1189185841,1189185841,0
1360767831,1189213560,1,52,52,1360767806739,1360767806739,1189189299,1189189299,0
1360767831,1189213560,1,46,46,1360767806675,1360767806675,1189189235,1189189235,0
1360767831,1189213588,12,10519,876.5833333,1360767803383,1360767810167,1189185971,1189192755,6784
1360767832,4122494276,6,1725,287.5,1360767805979,1360767806683,4122468255,4122468959,704
1360767835,1189217512,1,52,52,1360767807296,1360767807296,1189189808,1189189808,0
1360767835,1189217516,1,52,52,1360767807614,1360767807614,1189190130,1189190130,0
1360767835,1189217552,58,74080,1277.241379,1360767810204,1360767810716,1189192756,1189193268,512
1360767835,1189217584,1,52,52,1360767807161,1360767807161,1189189745,1189189745,0
1360767835,1189217588,1,52,52,1360767807288,1360767807288,1189189876,1189189876,0
1360767835,1189217588,1,52,52,1360767807287,1360767807287,1189189875,1189189875,0
1360767839,1189221500,1,52,52,1360767811150,1360767811150,1189193650,1189193650,0
1360767840,1189222536,17,4186,246.2352941,1360767832937,1360767833385,1189215473,1189215921,448
1360767848,1189230528,2,127,63.5,1360767847281,1360767847281,1189229809,1189229809,0
1360767851,1189233536,1,52,52,1360767826281,1360767826281,1189208817,1189208817,0
1360767855,1189237512,9,3213,357,1360767827840,1360767829184,1189210352,1189211696,1344
1360767872,1189254476,28,8071,288.25,1360767868838,1360767870758,1189251314,1189253234,1920
1360767872,1189254504,6,1644,274,1360767870088,1360767870536,1189252592,1189253040,448
1360767872,1189254516,2,92,46,1360767865020,1360767865020,1189247536,1189247536,0
1360767872,1189254540,20,6103,305.15,1360767865383,1360767866599,1189247923,1189249139,1216
1360767880,1189262456,58,47514,819.2068966,1360767875066,1360767878970,1189257522,1189261426,3904
1360767880,1189262456,68,58194,855.7941176,1360767875193,1360767879033,1189257649,1189261489,3840
1360767880,1189262468,17,5167,303.9411765,1360767872942,1360767878830,1189255410,1189261298,5888
1360767880,1189262504,20,8696,434.8,1360767874379,1360767878731,1189256883,1189261235,4352
1360767880,1189262504,5,531,106.2,1360767870282,1360767877258,1189252786,1189259762,6976
1360767880,1189262504,18,8203,455.7222222,1360767870729,1360767879305,1189253233,1189261809,8576
1360767880,1189262508,61,49387,809.6229508,1360767875332,1360767878532,1189257840,1189261040,3200
1360767880,1189262548,23,13308,578.6086957,1360767874271,1360767878687,1189256819,1189261235,4416
1360767880,1189262548,19,9366,492.9473684,1360767874526,1360767879006,1189257074,1189261554,4480
1360767880,1189262548,12,3557,296.4166667,1360767870301,1360767878941,1189252849,1189261489,8640
1360767881,4122543792,15,8368,557.8666667,1360767871703,1360767878999,4122534495,4122541791,7296
1360767887,1189269576,1517,2147542,1415.650626,1360767567552,1360767586048,1188950128,1188968624,18496
1360767887,1189269624,1,52,52,1360767862160,1360767862160,1189244784,1189244784,0
1360767887,1189269628,1,52,52,1360767862287,1360767862287,1189244915,1189244915,0
1360767887,1189269628,1,52,52,1360767862350,1360767862350,1189244978,1189244978,0
1360767887,1189269664,1,52,52,1360767860585,1360767860585,1189243249,1189243249,0
1360767887,1189269704,42,33737,803.2619048,1360767862208,1360767877568,1189244912,1189260272,15360
1360767888,1189270476,30,9773,325.7666667,1360767879013,1360767880741,1189261489,1189263217,1728
1360767888,1189270488,20,13085,654.25,1360767873176,1360767881304,1189255664,1189263792,8128
1360767888,1189270524,76,66847,879.5657895,1360767874487,1360767885239,1189257011,1189267763,10752
1360767888,1189270556,20,12671,633.55,1360767873109,1360767881493,1189255665,1189264049,8384
1360767888,1189270556,20,8812,440.6,1360767873108,1360767884884,1189255664,1189267440,11776
1360767888,1189270556,20,12314,615.7,1360767873108,1360767882004,1189255664,1189264560,8896
1360767889,4122551784,27,22339,827.3703704,1360767871712,1360767880992,4122534496,4122543776,9280
1360767891,1189273620,18,10045,558.0555556,1360767864916,1360767867412,1189247536,1189250032,2496
1360767891,1189273636,11,6413,583,1360767866247,1360767866951,1189248883,1189249587,704
1360767892,4122554504,2,1153,576.5,1360767867384,1360767867512,4122529888,4122530016,128
1360767895,1189277580,4,4281,1070.25,1360767867131,1360767867131,1189249711,1189249711,0
1360767895,1189277620,1,52,52,1360767869399,1360767869399,1189252019,1189252019,0
1360767895,1189277628,1,52,52,1360767870668,1360767870668,1189253296,1189253296,0
1360767895,1189277664,1,52,52,1360767867946,1360767867946,1189250610,1189250610,0
1360767895,1189277668,1,52,52,1360767868390,1360767868390,1189251058,1189251058,0
1360767895,1189277708,9,2992,332.4444444,1360767870396,1360767877756,1189253104,1189260464,7360
1360767896,1189278588,2,158,79,1360767882548,1360767890356,1189265136,1189272944,7808
1360767896,1189278596,2,158,79,1360767882926,1360767890798,1189265522,1189273394,7872
1360767896,1189278640,2,158,79,1360767882497,1360767890241,1189265137,1189272881,7744
1360767903,1189285604,14,3303,235.9285714,1360767876132,1360767879012,1189258736,1189261616,2880
1360767904,1189286632,2,158,79,1360767888650,1360767896458,1189271282,1189279090,7808
1360767912,1189294588,20,3010,150.5,1360767904119,1360767906103,1189286707,1189288691,1984
1360767915,1189297784,1,52,52,1360767889394,1360767889394,1189272178,1189272178,0
1360767920,1189302640,20,6311,315.55,1360767915200,1360767915968,1189297840,1189298608,768
1360767921,4122583788,14,11804,843.1428571,1360767916254,1360767916510,4122579042,4122579298,256
1360767923,1189305652,23,17096,743.3043478,1360767898804,1360767916724,1189281456,1189299376,17920
1360767928,1189310656,27,6877,254.7037037,1360767917232,1360767922672,1189299888,1189305328,5440
1360767932,1189313996,20,15445,772.25,1360767904197,1360767917445,1189286193,1189299441,13248
1360767932,1189314036,1,79,79,1360767906333,1360767906333,1189288369,1189288369,0
1360767932,1189314036,1,79,79,1360767906588,1360767906588,1189288624,1189288624,0
1360767936,1189318676,5,269,53.8,1360767930459,1360767932379,1189313135,1189315055,1920
1360767940,1189321976,1,79,79,1360767912730,1360767912730,1189294706,1189294706,0
1360767944,1189325964,1,195,195,1360767918819,1360767918819,1189300783,1189300783,0
1360767944,1189326052,8,2967,370.875,1360767918923,1360767919371,1189300975,1189301423,448
1360767944,1189326052,4,1401,350.25,1360767918926,1360767919374,1189300978,1189301426,448
1360767944,1189326080,42,56261,1339.547619,1360767919281,1360767919409,1189301361,1189301489,128
1360767944,4122606508,9,4775,530.5555556,1360767916980,1360767917684,4122579488,4122580192,704
1360767944,1189326636,36,9141,253.9166667,1360767932805,1360767936453,1189315441,1189319089,3648
1360767952,1189334624,2,131,65.5,1360767949009,1360767949009,1189331633,1189331633,0
1360767952,1189334684,21,5624,267.8095238,1360767932758,1360767944534,1189315442,1189327218,11776
1360767960,1189342012,56,71171,1270.910714,1360767933044,1360767933556,1189315056,1189315568,512
1360767960,1189342016,10,9601,960.1,1360767933038,1360767942062,1189315054,1189324078,9024
1360767964,1189345956,1,79,79,1360767937966,1360767937966,1189319922,1189319922,0
1360767964,1189346012,1,79,79,1360767937396,1360767937396,1189319408,1189319408,0
1360767968,1189350340,1,46,46,1360767941482,1360767941482,1189323822,1189323822,0
1360767972,1189353932,1,79,79,1360767943876,1360767943876,1189325808,1189325808,0
1360767976,1189358628,26,5353,205.8846154,1360767970700,1360767972940,1189353328,1189355568,2240
1360767992,1189374656,17,4194,246.7058824,1360767983663,1360767984111,1189366319,1189366767,448
1360767992,1189374664,2,127,63.5,1360767985128,1360767985128,1189367792,1189367792,0
1360767996,1189378104,6,6756,1126,1360767971159,1360767977431,1189353263,1189359535,6272
1360768000,1189382084,3,2084,694.6666667,1360767974382,1360767974382,1189356466,1189356466,0
1360768000,1189382704,17,4267,251,1360767994817,1360767995265,1189377521,1189377969,448
1360768024,1189406708,18,4473,248.5,1360768023354,1360768023802,1189406062,1189406510,448
1360768040,1189422628,28,7474,266.9285714,1360768032201,1360768033481,1189414829,1189416109,1280
1360768040,1189422676,2,131,65.5,1360768038684,1360768038684,1189421360,1189421360,0
1360768040,1189422680,2,127,63.5,1360768039128,1360768039128,1189421808,1189421808,0
1360768040,1189422748,2,131,65.5,1360768038612,1360768038612,1189421360,1189421360,0
1360768048,1189430640,19,5037,265.1052632,1360768039808,1360768040384,1189422448,1189423024,576
1360768048,1189430692,2,92,46,1360768040459,1360768040459,1189423151,1189423151,0
1360768048,1189430692,2,92,46,1360768040522,1360768040522,1189423214,1189423214,0
1360768056,1189438680,2,131,65.5,1360768052757,1360768052757,1189435437,1189435437,0
1360768064,1189446052,1,52,52,1360768039305,1360768039305,1189421357,1189421357,0
1360768068,1189450040,7,3741,534.4285714,1360768041112,1360768041688,1189423152,1189423728,576
1360768068,1189450040,7,3213,459,1360768041175,1360768041815,1189423215,1189423855,640
1360768072,1189454044,2,129,64.5,1360768045331,1360768045331,1189427375,1189427375,0
1360768092,1189474388,3,344,114.6666667,1360768067451,1360768068411,1189449839,1189450799,960
1360768096,1189478772,2,131,65.5,1360768093692,1360768093692,1189476464,1189476464,0
1360768112,1189494736,2,127,63.5,1360768111071,1360768111071,1189493807,1189493807,0
1360768136,1189518700,2,127,63.5,1360768135105,1360768135105,1189517805,1189517805,0
1360768136,1189518748,17,4088,240.4705882,1360768134738,1360768135250,1189517486,1189517998,512
1360768144,1189526696,2,92,46,1360768136772,1360768136772,1189519468,1189519468,0
1360768144,1189526768,2,92,46,1360768136638,1360768136638,1189519406,1189519406,0
1360768160,1189542804,5,530,106,1360768149338,1360768155802,1189532142,1189538606,6464
1360768160,1189542804,295,377909,1281.047458,1360767796504,1360768153368,1189179308,1189536172,356864
1360768161,1189542840,21,13624,648.7619048,1360768152031,1360768160735,1189533871,1189542575,8704
1360768161,1189542880,18,7390,410.5555556,1360768150709,1360768158709,1189532589,1189540589,8000
1360768161,1189542888,13,4755,365.7692308,1360768151982,1360768160686,1189533870,1189542574,8704
1360768161,1189542888,11,4354,395.8181818,1360768151982,1360768160686,1189533870,1189542574,8704
1360768161,1189542888,19,11336,596.6315789,1360768151982,1360768160686,1189533870,1189542574,8704
1360768161,4122823772,15,9381,625.4,1360768152367,1360768153007,4122815139,4122815779,640
1360768161,4122823772,11,3998,363.4545455,1360768152367,1360768159919,4122815139,4122822691,7552
1360768161,4122823780,9,2389,265.4444444,1360768150887,1360768157799,4122813667,4122820579,6912
1360768164,1189546576,7,3418,488.2857143,1360768136827,1360768137915,1189519403,1189520491,1088
1360768164,1189546652,7,3641,520.1428571,1360768136818,1360768137842,1189519470,1189520494,1024
1360768196,1189578696,34,7438,218.7647059,1360768169283,1360768195331,1189551979,1189578027,26048
1360768200,1189582804,3,138,46,1360768195865,1360768195865,1189578669,1189578669,0
1360768200,1189582816,27,7170,265.5555556,1360768197003,1360768198539,1189579819,1189581355,1536
1360768201,1189582844,3,138,46,1360768199579,1360768199579,1189581423,1189581423,0
1360768209,1189590968,18,5174,287.4444444,1360768200412,1360768201500,1189582380,1189583468,1088
1360768212,1189594696,9,4564,507.1111111,1360768186886,1360768188230,1189569582,1189570926,1344
1360768212,1189594780,39,38152,978.2564103,1360768187377,1360768203505,1189570157,1189586285,16128
1360768224,1189606640,26,21416,823.6923077,1360768196027,1360768198843,1189578667,1189581483,2816
1360768224,1189606696,67,85879,1281.776119,1360768198723,1360768199299,1189581419,1189581995,576
1360768224,4122886796,6,2906,484.3333333,1360768195928,1360768196632,4122858724,4122859428,704
1360768224,4122886800,6,6959,1159.833333,1360768196691,1360768196755,4122859491,4122859555,64
1360768224,1189606732,19,12289,646.7894737,1360768196321,1360768198753,1189579053,1189581485,2432
1360768224,1189606736,7,5985,855,1360768196574,1360768196638,1189579310,1189579374,64
1360768228,1189610780,13,3301,253.9230769,1360768200049,1360768200817,1189582829,1189583597,768
1360768228,1189610788,1,46,46,1360768200871,1360768200871,1189583659,1189583659,0
1360768233,1189614936,1,46,46,1360768208380,1360768208380,1189590316,1189590316,0
1360768233,1189615016,3,138,46,1360768229037,1360768229037,1189611053,1189611053,0
1360768240,1189622756,30,16485,549.5,1360768212102,1360768215878,1189594858,1189598634,3776
1360768240,1189622756,1,46,46,1360768212106,1360768212106,1189594862,1189594862,0
1360768241,1189622832,1,46,46,1360768213027,1360768213027,1189594859,1189594859,0
1360768245,1189626876,1,211,211,1360768219066,1360768219066,1189600942,1189600942,0
1360768249,1189631012,29,22869,788.5862069,1360768244594,1360768246450,1189626606,1189628462,1856
1360768249,1189631024,20,5793,289.65,1360768229093,1360768243109,1189611117,1189625133,14016
1360768256,1189638776,1,46,46,1360768228148,1360768228148,1189610924,1189610924,0
1360768256,1189638776,16,5329,333.0625,1360768228339,1360768249459,1189611115,1189632235,21120
1360768257,1189638860,77,105699,1372.714286,1360768230214,1360768231174,1189612074,1189613034,960
1360768257,1189638984,15,5552,370.1333333,1360768250378,1360768255754,1189632362,1189637738,5376
1360768257,1189638988,44,37861,860.4772727,1360768246472,1360768255048,1189628460,1189637036,8576
1360768257,1189639016,73,67068,918.739726,1360768244587,1360768255019,1189626603,1189637035,10432
1360768257,1189639020,19,9595,505,1360768248296,1360768256872,1189630316,1189638892,8576
1360768257,1189639048,5,527,105.4,1360768242636,1360768249036,1189624684,1189631084,6400
1360768257,1189639052,18,8117,450.9444444,1360768243017,1360768251017,1189625069,1189633069,8000
1360768257,1189639060,84,75562,899.547619,1360768244481,1360768254977,1189626541,1189637037,10496
1360768257,1189639060,81,73813,911.2716049,1360768244544,1360768254976,1189626604,1189637036,10432
1360768257,1189639060,18,9334,518.5555556,1360768248063,1360768256767,1189630123,1189638827,8704
1360768257,1189639064,15,8351,556.7333333,1360768248382,1360768249278,1189630446,1189631342,896
1360768265,1189647044,2,158,79,1360768258767,1360768262735,1189640811,1189644779,3968
1360768265,1189647076,15,5487,365.8,1360768259888,1360768263792,1189641964,1189645868,3904
1360768265,1189647076,3,179,59.66666667,1360768260078,1360768260078,1189642154,1189642154,0
1360768268,1189650816,16,7453,465.8125,1360768247564,1360768256972,1189630380,1189639788,9408
1360768273,1189655188,2,127,63.5,1360768265600,1360768265600,1189647788,1189647788,0
1360768273,1189655224,2,92,46,1360768259230,1360768266526,1189641454,1189648750,7296
1360768273,4122935816,2,127,63.5,1360768271620,1360768271620,4122934436,4122934436,0
1360768273,4122935832,3,179,59.66666667,1360768271986,1360768271986,4122934818,4122934818,0
1360768277,1189658916,51,53240,1043.921569,1360768250385,1360768276241,1189632301,1189658157,25856
1360768281,1189662888,34,32973,969.7941176,1360768256429,1360768277741,1189638317,1189659629,21312
1360768281,1189663016,31,29921,965.1935484,1360768255786,1360768269546,1189637802,1189651562,13760
1360768281,1189663020,34,34838,1024.647059,1360768255784,1360768277736,1189637804,1189659756,21952
1360768281,1189663020,9,8860,984.4444444,1360768256103,1360768256487,1189638123,1189638507,384
1360768281,1189663052,27,29010,1074.444444,1360768256650,1360768271434,1189638702,1189653486,14784
1360768285,1189666888,8,7552,944,1360768256940,1360768257196,1189638828,1189639084,256
1360768285,1189666888,9,8444,938.2222222,1360768257260,1360768257580,1189639148,1189639468,320
1360768285,1189666900,1,46,46,1360768258335,1360768258335,1189640235,1189640235,0
1360768285,1189666928,1,79,79,1360768259012,1360768259012,1189640940,1189640940,0
1360768285,1189666940,10,3378,337.8,1360768260089,1360768263993,1189642029,1189645933,3904
1360768285,1189666944,66,92109,1395.590909,1360768260597,1360768260981,1189642541,1189642925,384
1360768285,1189666980,22,24127,1096.681818,1360768258321,1360768277009,1189640301,1189658989,18688
1360768285,1189667016,1,46,46,1360768259882,1360768259882,1189641898,1189641898,0
1360768285,1189667020,59,80531,1364.932203,1360768260200,1360768261736,1189642220,1189643756,1536
1360768289,1189671120,2,158,79,1360768270595,1360768286531,1189652715,1189668651,15936
1360768297,1189678912,8,7155,894.375,1360768269138,1360768269458,1189651050,1189651370,320
1360768297,1189679172,5,352,70.4,1360768293646,1360768295246,1189675818,1189677418,1600
1360768301,1189682908,10,9213,921.3,1360768273113,1360768273753,1189655021,1189655661,640
1360768301,1189682908,10,9213,921.3,1360768273176,1360768273816,1189655084,1189655724,640
1360768301,1189683032,9,7685,853.8888889,1360768276316,1360768276636,1189658348,1189658668,320
1360768305,1189687112,14,1350,96.42857143,1360768278922,1360768279434,1189661034,1189661546,512
1360768321,1189703188,148,187362,1265.959459,1360768196479,1360768320831,1189578667,1189703019,124352
1360768321,1189703272,4,289,72.25,1360768319403,1360768320171,1189701675,1189702443,768
1360768325,1189707012,4,300,75,1360768297327,1360768323567,1189679339,1189705579,26240
1360768329,1189711184,3,237,79,1360768321219,1360768327299,1189703403,1189709483,6080
1360768329,1189711188,3,237,79,1360768321856,1360768327936,1189704044,1189710124,6080
1360768345,1189726964,1,79,79,1360768318494,1360768318494,1189700458,1189700458,0
1360768353,1189735248,2,158,79,1360768335236,1360768351364,1189717484,1189733612,16128
1360768353,1189735248,2,158,79,1360768336001,1360768352193,1189718249,1189734441,16192
1360768361,1189743332,3,156,52,1360768356463,1360768357807,1189738795,1189740139,1344
1360768381,1189763096,1,75,75,1360768353500,1360768353500,1189735596,1189735596,0
1360768385,1189767264,4,208,52,1360768380659,1360768384819,1189762923,1189767083,4160
1360768385,1189767308,4,289,72.25,1360768383558,1360768384710,1189765866,1189767018,1152
1360768385,1189767364,3,156,52,1360768380172,1360768382220,1189762536,1189764584,2048
1360768393,1189775292,3,156,52,1360768389077,1360768391637,1189771369,1189773929,2560
1360768393,1189775304,2,158,79,1360768386315,1360768389451,1189768619,1189771755,3136
1360768393,1189775348,2,104,52,1360768384862,1360768390238,1189767210,1189772586,5376
1360768401,1189783496,2,104,52,1360768389257,1360768398729,1189771753,1189781225,9472
1360768401,1189783548,5,260,52,1360768396312,1360768400088,1189778860,1189782636,3776
1360768401,1189783588,4,289,72.25,1360768398637,1360768399533,1189781225,1189782121,896
1360768409,1189791352,1,79,79,1360768384537,1360768384537,1189766889,1189766889,0
1360768409,1189791428,1,79,79,1360768383375,1360768383375,1189765803,1189765803,0
1360768409,1189791496,2,158,79,1360768395595,1360768408267,1189778091,1189790763,12672
1360768409,1189791500,3,237,79,1360768400772,1360768407748,1189783272,1189790248,6976
1360768409,1189791504,6,644,107.3333333,1360768400835,1360768404739,1189783339,1189787243,3904
1360768409,1189791540,2,104,52,1360768394845,1360768401757,1189777385,1189784297,6912
1360768417,1189799504,2,104,52,1360768404164,1360768412228,1189786668,1189794732,8064
1360768425,1189807480,2,104,52,1360768400794,1360768422234,1189783274,1189804714,21440
1360768433,1189815552,5,260,52,1360768428369,1360768431697,1189810921,1189814249,3328
1360768437,1189819368,3,339,113,1360768409098,1360768434378,1189791466,1189816746,25280
1360768441,1189823324,1,52,52,1360768415860,1360768415860,1189798184,1189798184,0
1360768441,1189823608,2,158,79,1360768416986,1360768435674,1189799594,1189818282,18688
1360768445,1189827304,1,52,52,1360768417738,1360768417738,1189800042,1189800042,0
1360768449,1189831604,5,260,52,1360768443676,1360768447132,1189826280,1189829736,3456
1360768453,1189835336,1,52,52,1360768428458,1360768428458,1189810794,1189810794,0
1360768461,1189843380,1,79,79,1360768433662,1360768433662,1189816042,1189816042,0
1360768469,1189851348,1,52,52,1360768443485,1360768443485,1189825833,1189825833,0
1360768481,1189863468,1,52,52,1360768455269,1360768455269,1189837737,1189837737,0
1360768485,1189867408,1,52,52,1360768460642,1360768460642,1189843050,1189843050,0
1360768493,1189875400,1,113,113,1360768468007,1360768468007,1189850407,1189850407,0
1360768493,1189875432,1,52,52,1360768465226,1360768465226,1189847658,1189847658,0
1360768501,1189883380,1,79,79,1360768473213,1360768473213,1189855593,1189855593,0
1360768509,1189891496,1,79,79,1360768484041,1360768484041,1189866537,1189866537,0
1360768529,1189911464,1,46,46,1360768502057,1360768502057,1189884521,1189884521,0
1360768529,1189911508,1,46,46,1360768504573,1360768504573,1189887081,1189887081,0
1360768529,1189911708,7,1009,144.1428571,1360768518198,1360768527734,1189900906,1189910442,9536
1360768561,1189943660,2,346,173,1360768537573,1360768557221,1189920233,1189939881,19648
1360768590,1189971832,1,46,46,1360768565344,1360768565344,1189947176,1189947176,0
1360768594,1189976028,1,46,46,1360768566489,1360768566489,1189948517,1189948517,0
1360768598,1189979880,1,46,46,1360768571694,1360768571694,1189953574,1189953574,0
1360778669,1200050804,1,107,107,1360778643553,1360778643553,1200025357,1200025357,0
1360778669,1200050844,1,52,52,1360778642493,1360778642493,1200024337,1200024337,0
1360778673,1200054836,8,1824,228,1360778645252,1360778645380,1200027088,1200027216,128
1360778673,1200054848,7,4455,636.4285714,1360778646519,1360778646583,1200028367,1200028431,64
1360778674,1200056140,5,534,106.8,1360778672595,1360778672659,1200054735,1200054799,64
1360778674,1200056216,2,139,69.5,1360778672456,1360778672456,1200054672,1200054672,0
1360778674,1200056268,4,488,122,1360778670549,1360778670613,1200052817,1200052881,64
1360778676,1200058772,6126,8438657,1377.515018,1360778599325,1360778671965,1199982097,1200054737,72640
1360778682,1200064152,5,534,106.8,1360778674440,1360778674504,1200056592,1200056656,64
1360778685,1200066864,3,361,120.3333333,1360778658600,1360778667432,1200040464,1200049296,8832
1360778690,1200072148,5,577,115.4,1360778684938,1360778685066,1200067086,1200067214,128
1360778690,1200072164,2,119,59.5,1360778689212,1360778689276,1200071376,1200071440,64
1360778690,1200072228,5,577,115.4,1360778684857,1360778684985,1200067085,1200067213,128
1360778690,1200072228,6,623,103.8333333,1360778684857,1360778684985,1200067085,1200067213,128
1360778690,1200072228,5,577,115.4,1360778684857,1360778684985,1200067085,1200067213,128
1360778697,1200079000,1,46,46,1360778672671,1360778672671,1200054671,1200054671,0
1360778697,1200079000,7,825,117.8571429,1360778672734,1360778672798,1200054734,1200054798,64
1360778697,1200079012,1,46,46,1360778670034,1360778670034,1200052046,1200052046,0
1360778701,1200083136,1,107,107,1360778673302,1360778673302,1200055438,1200055438,0
1360778701,1200083160,3,1252,417.3333333,1360778673344,1360778673536,1200055504,1200055696,192
1360778713,1200095080,1,134,134,1360778684940,1360778684940,1200067020,1200067020,0
1360778717,1200099056,4,603,150.75,1360778689448,1360778714856,1200071504,1200096912,25408
1360778729,1200111152,1,107,107,1360778703237,1360778703237,1200085389,1200085389,0
1360778737,1200119156,4,414,103.5,1360778711360,1360778718336,1200093516,1200100492,6976
1360778745,1200127084,3,144,48,1360778718664,1360778743624,1200100748,1200125708,24960
1360778745,1200127164,1,52,52,1360778717691,1360778717691,1200099855,1200099855,0
1360778746,1200128156,5,577,115.4,1360778744962,1360778745026,1200127118,1200127182,64
1360778746,1200128232,6,629,104.8333333,1360778744884,1360778744948,1200127116,1200127180,64
1360778746,1200128232,5,577,115.4,1360778744884,1360778744948,1200127116,1200127180,64
1360778746,1200128236,5,577,115.4,1360778744883,1360778744947,1200127119,1200127183,64
1360778753,1200135032,1,134,134,1360778725054,1360778725054,1200107086,1200107086,0
1360778753,1200135192,6,4305,717.5,1360778728541,1360778728989,1200110733,1200111181,448
1360778761,1200143128,1,107,107,1360778733340,1360778733340,1200115468,1200115468,0
1360778765,1200147104,4,1622,405.5,1360778739508,1360778764660,1200121612,1200146764,25152
1360778769,1200151064,8,966,120.75,1360778741534,1360778765150,1200123598,1200147214,23616
1360778785,1200167192,7,1397,199.5714286,1360778760412,1360778763356,1200142604,1200145548,2944
1360778789,1200171108,1,107,107,1360778763507,1360778763507,1200145615,1200145615,0
1360778789,1200171172,1,52,52,1360778762738,1360778762738,1200144910,1200144910,0
1360778793,1200175136,1,134,134,1360778764947,1360778764947,1200147083,1200147083,0
1360778801,1200183084,1,46,46,1360778774280,1360778774280,1200156364,1200156364,0
1360778810,1200192200,6,623,103.8333333,1360778804947,1360778805011,1200187147,1200187211,64
1360778810,1200192200,5,577,115.4,1360778804947,1360778805075,1200187147,1200187275,128
1360778810,1200192280,5,577,115.4,1360778804870,1360778804934,1200187150,1200187214,64
1360778810,1200192280,5,577,115.4,1360778804870,1360778804998,1200187150,1200187278,128
1360778817,1200199188,3,586,195.3333333,1360778789919,1360778815071,1200172107,1200197259,25152
1360778818,1200200228,7,873,124.7142857,1360778802488,1360778813496,1200184716,1200195724,11008
1360778821,1200203196,1,107,107,1360778793497,1360778793497,1200175693,1200175693,0
1360778825,1200207172,1,46,46,1360778797170,1360778797170,1200179342,1200179342,0
1360778825,1200207176,5,641,128.2,1360778797741,1360778818925,1200179917,1200201101,21184
1360778833,1200215104,1,134,134,1360778804979,1360778804979,1200187083,1200187083,0
1360778833,1200215156,1,52,52,1360778807809,1360778807809,1200189965,1200189965,0
1360778833,1200215156,3,144,48,1360778808446,1360778827518,1200190602,1200209674,19072
1360778845,1200227164,1,46,46,1360778819256,1360778819256,1200201420,1200201420,0
1360778849,1200231600,1,107,107,1360778823364,1360778823364,1200205964,1200205964,0
1360778853,1200235312,6,755,125.8333333,1360778828132,1360778840804,1200210444,1200223116,12672
1360778865,1200247260,2,536,268,1360778839832,1360778839896,1200222092,1200222156,64
1360778866,1200248236,6,629,104.8333333,1360778864944,1360778865008,1200247180,1200247244,64
1360778866,1200248292,5,577,115.4,1360778864887,1360778864951,1200247179,1200247243,64
1360778866,1200248292,5,577,115.4,1360778864887,1360778864951,1200247179,1200247243,64
1360778866,1200248292,5,577,115.4,1360778864887,1360778864951,1200247179,1200247243,64
1360778873,1200255172,1,134,134,1360778844910,1360778844910,1200227082,1200227082,0
1360778873,1200255332,2,92,46,1360778848657,1360778853457,1200230989,1200235789,4800
1360778877,1200259368,1,52,52,1360778852653,1360778852653,1200235021,1200235021,0
1360778881,1200263248,8,984,123,1360778856358,1360778880614,1200238606,1200262862,24256
1360778881,1200263284,1,107,107,1360778853758,1360778853758,1200236042,1200236042,0
1360778893,1200275216,5,2681,536.2,1360778865285,1360778891781,1200247501,1200273997,26496
1360778897,1200279212,9,2995,332.7777778,1360778870088,1360778870408,1200252300,1200252620,320
1360778909,1200291308,4,624,156,1360778880808,1360778903592,1200263116,1200285900,22784
1360778909,1200291352,1,107,107,1360778883707,1360778883707,1200266059,1200266059,0
1360778913,1200295216,1,134,134,1360778884869,1360778884869,1200267085,1200267085,0
1360778914,1200296404,5,326,65.2,1360778897672,1360778912456,1200280076,1200294860,14784
1360778930,1200312260,5,577,115.4,1360778924886,1360778925014,1200307146,1200307274,128
1360778930,1200312400,6,623,103.8333333,1360778924745,1360778924809,1200307145,1200307209,64
1360778930,1200312400,5,577,115.4,1360778924745,1360778924873,1200307145,1200307273,128
1360778930,1200312400,5,577,115.4,1360778924747,1360778924811,1200307147,1200307211,64
1360778941,1200323272,1,107,107,1360778913995,1360778913995,1200296267,1200296267,0
1360778941,1200323288,3,601,200.3333333,1360778914813,1360778939837,1200297101,1200322125,25024
1360778941,1200323364,5,690,138,1360778914096,1360778937008,1200296460,1200319372,22912
1360778941,1200323404,1,46,46,1360778915272,1360778915272,1200297676,1200297676,0
1360778953,1200335196,1,134,134,1360778924949,1360778924949,1200307145,1200307145,0
1360778969,1200351400,6,714,119,1360778940873,1360778962313,1200323273,1200344713,21440
1360778969,1200351472,1,107,107,1360778943937,1360778943937,1200326409,1200326409,0
1360778970,1200352424,4,347,86.75,1360778964722,1360778964722,1200347146,1200347146,0
1360778985,1200367456,3,138,46,1360778960273,1360778982801,1200342729,1200365257,22528
1360778986,1200368312,5,534,106.8,1360778981539,1360778981603,1200363851,1200363915,64
1360778986,1200368380,6,623,103.8333333,1360778984799,1360778984863,1200367179,1200367243,64
1360778986,1200368380,5,577,115.4,1360778984799,1360778984863,1200367179,1200367243,64
1360778986,1200368380,5,577,115.4,1360778984799,1360778984863,1200367179,1200367243,64
1360778986,1200368380,5,577,115.4,1360778984799,1360778984863,1200367179,1200367243,64
1360778986,1200368424,25636,35170317,1371.911258,1360778673329,1360778982833,1200055753,1200365257,309504
1360778986,1200368432,5,534,106.8,1360778982826,1360778982890,1200365258,1200365322,64
1360778986,1200368464,12,4153,346.0833333,1360778983499,1360778983755,1200365963,1200366219,256
1360778986,1200368464,5,534,106.8,1360778983754,1360778983818,1200366218,1200366282,64
1360778989,1200371328,1,53,53,1360778964816,1360778964816,1200347144,1200347144,0
1360778989,1200371408,8,1818,227.25,1360778964736,1360778968064,1200347144,1200350472,3328
1360778994,1200376312,2,130,65,1360778989412,1360778989476,1200371724,1200371788,64
1360778994,1200376312,5,534,106.8,1360778986593,1360778986657,1200368905,1200368969,64
1360779001,1200383320,1,107,107,1360778974299,1360778974299,1200356619,1200356619,0
1360779009,1200391340,8,948,118.5,1360778980998,1360779007110,1200363338,1200389450,26112
1360779009,1200391380,7,825,117.8571429,1360778982880,1360778982944,1200365260,1200365324,64
1360779009,1200391468,5,2452,490.4,1360778983301,1360778985605,1200365769,1200368073,2304
1360779017,1200399364,4,603,150.75,1360778990511,1360779015791,1200372875,1200398155,25280
1360779029,1200411412,1,107,107,1360779004219,1360779004219,1200386631,1200386631,0
1360779029,1200411420,1,134,134,1360779004727,1360779004727,1200387147,1200387147,0
1360779050,1200432384,5,577,115.4,1360779044762,1360779044954,1200427146,1200427338,192
1360779050,1200432384,6,623,103.8333333,1360779044760,1360779044952,1200427144,1200427336,192
1360779050,1200432384,5,577,115.4,1360779044760,1360779044952,1200427144,1200427336,192
1360779050,1200432460,5,577,115.4,1360779044685,1360779044877,1200427145,1200427337,192
1360779053,1200435412,1,52,52,1360779027966,1360779027966,1200410378,1200410378,0
1360779057,1200439488,3,144,48,1360779030641,1360779055665,1200413129,1200438153,25024
1360779061,1200443376,1,107,107,1360779034464,1360779034464,1200416840,1200416840,0
1360779065,1200447408,7,950,135.7142857,1360779039169,1360779048769,1200421577,1200431177,9600
1360779065,1200447528,2,536,268,1360779040584,1360779040648,1200423112,1200423176,64
1360779069,1200451532,1,134,134,1360779044613,1360779044613,1200427145,1200427145,0
1360779089,1200471480,1,107,107,1360779064506,1360779064506,1200446986,1200446986,0
1360779093,1200475476,3,589,196.3333333,1360779065853,1360779090493,1200448329,1200472969,24640
1360779101,1200483416,1,52,52,1360779073015,1360779073015,1200455431,1200455431,0
1360779106,1200488444,5,577,115.4,1360779104731,1360779104859,1200487175,1200487303,128
1360779106,1200488532,6,629,104.8333333,1360779104642,1360779104706,1200487174,1200487238,64
1360779106,1200488532,5,577,115.4,1360779104645,1360779104709,1200487177,1200487241,64
1360779106,1200488532,5,577,115.4,1360779104645,1360779104773,1200487177,1200487305,128
1360779109,1200491588,1,134,134,1360779084555,1360779084555,1200467143,1200467143,0
1360779117,1200499520,3,573,191,1360779090062,1360779116046,1200472582,1200498566,25984
1360779121,1200503456,1,107,107,1360779094735,1360779094735,1200477191,1200477191,0
1360779137,1200519572,11,8435,766.8181818,1360779110557,1360779110749,1200493129,1200493321,192
1360779141,1200523528,3,589,196.3333333,1360779115846,1360779140422,1200498374,1200522950,24576
1360779145,1200527500,1,52,52,1360779117988,1360779117988,1200500488,1200500488,0
1360779149,1200531572,1,107,107,1360779124764,1360779124764,1200507336,1200507336,0
1360779149,1200531656,1,134,134,1360779124550,1360779124550,1200507206,1200507206,0
1360779161,1200543692,8,1048,131,1360779136227,1360779150563,1200518919,1200533255,14336
1360779170,1200552520,6,629,104.8333333,1360779164624,1360779164752,1200547144,1200547272,128
1360779170,1200552520,5,577,115.4,1360779164688,1360779164752,1200547208,1200547272,64
1360779170,1200552608,5,577,115.4,1360779164600,1360779164664,1200547208,1200547272,64
1360779170,1200552608,5,577,115.4,1360779164600,1360779164664,1200547208,1200547272,64
1360779178,1200560568,11,2913,264.8181818,1360779170143,1360779170527,1200552711,1200553095,384
1360779181,1200563588,1,107,107,1360779154955,1360779154955,1200537543,1200537543,0
1360779181,1200563680,1,46,46,1360779155695,1360779155695,1200538375,1200538375,0
1360779189,1200571700,1,52,52,1360779162842,1360779162842,1200545542,1200545542,0
1360779189,1200571740,1,134,134,1360779164468,1360779164468,1200547208,1200547208,0
1360779194,1200575788,3,589,196.3333333,1360779166122,1360779191530,1200547910,1200573318,25408
1360779194,1200575960,6,637,106.1666667,1360779168575,1360779183487,1200550535,1200565447,14912
1360779210,1200591892,3,310,103.3333333,1360779185732,1360779206212,1200567624,1200588104,20480
1360779226,1200607888,1,46,46,1360779201477,1360779201477,1200583365,1200583365,0
1360779226,1200608576,5,326,65.2,1360779208023,1360779222807,1200590599,1200605383,14784
1360779226,1200608576,6,623,103.8333333,1360779224599,1360779224727,1200607175,1200607303,128
1360779226,1200608576,5,577,115.4,1360779224599,1360779224727,1200607175,1200607303,128
1360779226,1200608676,5,577,115.4,1360779224496,1360779224624,1200607172,1200607300,128
1360779226,1200608676,5,577,115.4,1360779224496,1360779224624,1200607172,1200607300,128
1360779230,1200611912,1,134,134,1360779205294,1360779205294,1200587206,1200587206,0
1360779230,1200611964,6,523,87.16666667,1360779203769,1360779217017,1200585733,1200598981,13248
1360779234,1200615996,6,4308,718,1360779209308,1360779209756,1200591304,1200591752,448
1360779238,1200619972,7,799,114.1428571,1360779212787,1360779230323,1200594759,1200612295,17536
1360779242,1200623952,3,589,196.3333333,1360779216392,1360779241480,1200598344,1200623432,25088
1360779270,1200652020,4,491,122.75,1360779241985,1360779247105,1200624005,1200629125,5120
1360779270,1200652044,1,46,46,1360779243113,1360779243113,1200625157,1200625157,0
1360779270,1200652092,1,134,134,1360779245113,1360779245113,1200627205,1200627205,0
1360779282,1200663956,4,439,109.75,1360779255682,1360779269634,1200637638,1200651590,13952
1360779282,1200664012,1,46,46,1360779254793,1360779254793,1200636805,1200636805,0
1360779290,1200671988,1,53,53,1360779265634,1360779265634,1200647622,1200647622,0
1360779290,1200672584,6,629,104.8333333,1360779284621,1360779284749,1200667205,1200667333,128
1360779290,1200672668,5,577,115.4,1360779284537,1360779284665,1200667205,1200667333,128
1360779290,1200672668,5,577,115.4,1360779284537,1360779284665,1200667205,1200667333,128
1360779290,1200672668,3,286,95.33333333,1360779284537,1360779284601,1200667205,1200667269,64
1360779290,1200672668,5,577,115.4,1360779284536,1360779284664,1200667204,1200667332,128
1360779298,1200679960,2,213,106.5,1360779272252,1360779276156,1200654212,1200658116,3904
1360779298,1200680588,5,534,106.8,1360779295688,1360779295752,1200678276,1200678340,64
1360779298,1200680632,12,4153,346.0833333,1360779293918,1360779294110,1200676550,1200676742,192
1360779298,1200680636,5,534,106.8,1360779294171,1360779294171,1200676807,1200676807,0
1360779298,1200680660,25667,35232315,1372.669771,1360778985473,1360779293121,1200368133,1200675781,307648
1360779298,1200680692,2,92,46,1360779293089,1360779293089,1200675781,1200675781,0
1360779298,1200680696,5,534,106.8,1360779293087,1360779293151,1200675783,1200675847,64
1360779310,1200691972,11,7237,657.9090909,1360779285296,1360779285424,1200667268,1200667396,128
1360779314,1200695928,6,740,123.3333333,1360779287326,1360779301406,1200669254,1200683334,14080
1360779318,1200699968,3,589,196.3333333,1360779291316,1360779316532,1200673284,1200698500,25216
1360779318,1200700020,7,825,117.8571429,1360779293762,1360779293890,1200675782,1200675910,128
1360779322,1200703952,5,2474,494.8,1360779294339,1360779295491,1200676291,1200677443,1152
1360779334,1200716036,5,589,117.8,1360779306290,1360779317042,1200688326,1200699078,10752
1360779346,1200728636,5,577,115.4,1360779344602,1360779344666,1200727238,1200727302,64
1360779346,1200728636,5,577,115.4,1360779344600,1360779344664,1200727236,1200727300,64
1360779346,1200728688,2,130,65,1360779340134,1360779340198,1200722822,1200722886,64
1360779346,1200728724,6,629,104.8333333,1360779344512,1360779344576,1200727236,1200727300,64
1360779346,1200728724,5,577,115.4,1360779344512,1360779344576,1200727236,1200727300,64
1360779350,1200732428,5,632,126.4,1360779322088,1360779345960,1200704516,1200728388,23872
1360779350,1200732508,1,134,134,1360779324759,1360779324759,1200707267,1200707267,0
1360779362,1200744400,3,321,107,1360779336131,1360779336899,1200718531,1200719299,768
1360779362,1200744692,2,98,49,1360779339809,1360779359777,1200722501,1200742469,19968
1360779366,1200748312,3,550,183.3333333,1360779340700,1360779340764,1200723012,1200723076,64
1360779366,1200748352,1,52,52,1360779338612,1360779338612,1200720964,1200720964,0
1360779390,1200772352,1,134,134,1360779364916,1360779364916,1200747268,1200747268,0
1360779390,1200772356,1,46,46,1360779365105,1360779365105,1200747461,1200747461,0
1360779394,1200776324,5,2697,539.4,1360779366160,1360779390800,1200748484,1200773124,24640
1360779394,1200776440,4,550,137.5,1360779366939,1360779391131,1200749379,1200773571,24192
1360779410,1200792328,1,52,52,1360779383626,1360779383626,1200765954,1200765954,0
1360779410,1200792648,6,623,103.8333333,1360779404555,1360779404683,1200787203,1200787331,128
1360779410,1200792652,5,577,115.4,1360779404550,1360779404678,1200787202,1200787330,128
1360779410,1200792652,5,577,115.4,1360779404549,1360779404677,1200787201,1200787329,128
1360779410,1200792728,5,577,115.4,1360779404475,1360779404603,1200787203,1200787331,128
1360779418,1200800344,7,741,105.8571429,1360779391162,1360779414394,1200773506,1200796738,23232
1360779418,1200800768,6,1868,311.3333333,1360779407893,1360779416853,1200790661,1200799621,8960
1360779422,1200804412,3,317,105.6666667,1360779397112,1360779398776,1200779524,1200781188,1664
1360779430,1200812416,1,134,134,1360779404849,1360779404849,1200787265,1200787265,0
1360779442,1200824428,3,589,196.3333333,1360779415847,1360779440295,1200798275,1200822723,24448
1360779446,1200828412,6,876,146,1360779418165,1360779443509,1200800577,1200825921,25344
1360779446,1200828412,1,46,46,1360779418231,1360779418231,1200800643,1200800643,0
1360779454,1200836400,2,213,106.5,1360779427332,1360779438788,1200809732,1200821188,11456
1360779454,1200836432,1,52,52,1360779428578,1360779428578,1200811010,1200811010,0
1360779467,1200848788,5,577,115.4,1360779465446,1360779465574,1200847234,1200847362,128
1360779467,1200848868,6,623,103.8333333,1360779465365,1360779465493,1200847233,1200847361,128
1360779467,1200848868,5,577,115.4,1360779465364,1360779465492,1200847232,1200847360,128
1360779467,1200848868,5,577,115.4,1360779465368,1360779465496,1200847236,1200847364,128
1360779470,1200852472,1,134,134,1360779444793,1360779444793,1200827265,1200827265,0
1360779474,1200856496,8,865,108.125,1360779448289,1360779473505,1200830785,1200856001,25216
1360779482,1200864584,2,213,106.5,1360779457289,1360779473033,1200839873,1200855617,15744
1360779490,1200872488,1,53,53,1360779465066,1360779465066,1200847554,1200847554,0
1360779490,1200872716,11,2572,233.8181818,1360779470405,1360779487621,1200853121,1200870337,17216
1360779490,1200872748,15991,21937110,1371.841036,1360779294757,1360779487589,1200677505,1200870337,192832
1360779490,1200872756,5,534,106.8,1360779487646,1360779487710,1200870402,1200870466,64
1360779490,1200872764,5,534,106.8,1360779488534,1360779488598,1200871298,1200871362,64
1360779493,4134155092,4,737,184.25,1360779471523,1360779488227,4134133615,4134150319,16704
1360779494,1200876324,2,98,49,1360779473740,1360779487948,1200856064,1200870272,14208
1360779498,1200880736,5,534,106.8,1360779489840,1360779489904,1200872576,1200872640,64
1360779499,1200880820,2,130,65,1360779490950,1360779491014,1200872770,1200872834,64
1360779507,1200888908,5,533,106.6,1360779481007,1360779504943,1200862915,1200886851,23936
1360779507,1200889060,11,2387,217,1360779506004,1360779506388,1200888064,1200888448,384
1360779507,1200889108,2,153,76.5,1360779487908,1360779504996,1200870016,1200887104,17088
1360779507,1200889148,1412,1949466,1380.641643,1360779489661,1360779504765,1200871809,1200886913,15104
1360779510,1200892756,2,246,123,1360779484510,1360779504286,1200867266,1200887042,19776
1360779514,1200896736,7,823,117.5714286,1360779487539,1360779487667,1200870275,1200870403,128
1360779515,1200896804,5,2486,497.2,1360779488725,1360779489941,1200870529,1200871745,1216
1360779515,1200896808,64,82626,1291.03125,1360779489041,1360779489425,1200870849,1200871233,384
1360779515,1200896964,13,2611,200.8461538,1360779506997,1360779514101,1200888961,1200896065,7104
1360779515,1200897040,37,27388,740.2162162,1360779506025,1360779509673,1200888065,1200891713,3648
1360779515,1200897044,78,77736,996.6153846,1360779506917,1360779514021,1200888961,1200896065,7104
1360779515,1200897088,13,1624,124.9230769,1360779509819,1360779513595,1200891907,1200895683,3776
1360779519,1200900788,6,786,131,1360779491108,1360779513700,1200872896,1200895488,22592
1360779523,1200904992,8,1082,135.25,1360779516441,1360779516569,1200898433,1200898561,128
1360779530,1200912752,6,1862,310.3333333,1360779504097,1360779504097,1200886849,1200886849,0
1360779531,1200912784,8,4873,609.125,1360779506537,1360779513641,1200888321,1200895425,7104
1360779531,1200912784,20,17182,859.1,1360779506537,1360779519529,1200888321,1200901313,12992
1360779531,1200912956,9,9702,1078,1360779506367,1360779519423,1200888323,1200901379,13056
1360779531,1200913076,78,71046,910.8461538,1360779506887,1360779528391,1200888963,1200910467,21504
1360779531,1200913112,6,733,122.1666667,1360779516448,1360779528160,1200898560,1200910272,11712
1360779531,1200913152,3,144,48,1360779513595,1360779529659,1200895747,1200911811,16064
1360779535,1200916820,17,4330,254.7058824,1360779507141,1360779520197,1200888961,1200902017,13056
1360779543,1200924788,4,645,161.25,1360779516775,1360779518823,1200898563,1200900611,2048
1360779544,4134206732,3,374,124.6666667,1360779517983,1360779518047,4134180715,4134180779,64
1360779547,1200928984,1,46,46,1360779522017,1360779522017,1200904001,1200904001,0
1360779550,1200932780,7,1043,149,1360779521925,1360779521989,1200904705,1200904769,64
1360779554,1200936768,10,1720,172,1360779527250,1360779553170,1200910018,1200935938,25920
1360779563,1200945136,2,92,46,1360779554633,1360779555273,1200936769,1200937409,640
1360779587,1200969220,4,184,46,1360779578421,1360779583669,1200960641,1200965889,5248
1360779591,1200972856,2,286,143,1360779566175,1360779590367,1200948031,1200972223,24192
1360779603,1200985124,2,92,46,1360779589718,1360779601750,1200971842,1200983874,12032
1360779611,1200993236,3,138,46,1360779605094,1360779608486,1200987330,1200990722,3392
1360779639,1201020956,1,46,46,1360779612859,1360779612859,1200994815,1200994815,0
1360779643,1201025192,3,138,46,1360779639758,1360779641998,1201021950,1201024190,2240
1360779651,1201033108,1,46,46,1360779625765,1360779625765,1201007873,1201007873,0
1360779651,1201033180,6,276,46,1360779642589,1360779650397,1201024769,1201032577,7808
1360779659,1201041192,2,92,46,1360779645071,1360779651087,1201027263,1201033279,6016
1360779663,1201045116,1,46,46,1360779638810,1360779638810,1201020926,1201020926,0
1360779663,1201045284,2,366,183,1360779637682,1360779638322,1201019966,1201020606,640
1360779675,1201057576,2,92,46,1360779658064,1360779674256,1201040640,1201056832,16192
1360779691,1201073148,2,92,46,1360779663291,1360779687547,1201045439,1201069695,24256
1360779699,1201081172,1,46,46,1360779673764,1360779673764,1201055936,1201055936,0
1360779731,1201113440,6,531,88.5,1360779727959,1360779729751,1201110399,1201112191,1792
1360779735,1201117152,1,46,46,1360779706997,1360779706997,1201089149,1201089149,0
1360779759,1201141276,1,101,101,1360779731898,1360779731898,1201114174,1201114174,0
1360779763,1201145292,1,46,46,1360779735914,1360779735914,1201118206,1201118206,0
1360780009,4134671724,2,96,48,1360779983147,1360779986219,4134645871,4134648943,3072
1360780020,1201402032,4,184,46,1360780013353,1360780014889,1201395385,1201396921,1536
1360780020,1201402076,2,92,46,1360780019263,1360780019519,1201401339,1201401595,256
1360780020,1201402076,2,92,46,1360780019260,1360780019516,1201401336,1201401592,256
1360780021,4134683492,3,138,46,1360780018259,1360780019859,4134680751,4134682351,1600
1360780028,1201409916,2,92,46,1360780020127,1360780021023,1201402043,1201402939,896
1360780047,1201429772,1,46,46,1360780019333,1360780019333,1201402105,1201402105,0
1360780132,1201514140,2,92,46,1360780127486,1360780127550,1201509626,1201509690,64
1360780140,1201522080,5,2001,400.2,1360780133177,1360780133241,1201515257,1201515321,64
1360780140,1201522144,17,5013,294.8823529,1360780130872,1360780131832,1201513016,1201513976,960
1360780140,1201522184,6,4364,727.3333333,1360780133905,1360780133905,1201516089,1201516089,0
1360780154,4134816008,1,46,46,1360780129786,1360780129786,4134791794,4134791794,0
1360780156,1201537824,1,46,46,1360780129914,1360780129914,1201511738,1201511738,0
1360780156,1201537824,1,46,46,1360780129914,1360780129914,1201511738,1201511738,0
1360780156,1201537824,1,46,46,1360780129977,1360780129977,1201511801,1201511801,0
1360780156,1201537824,1,46,46,1360780129977,1360780129977,1201511801,1201511801,0
1360780156,1201537824,1,46,46,1360780129913,1360780129913,1201511737,1201511737,0
1360780156,1201537828,9,3800,422.2222222,1360780130420,1360780154100,1201512248,1201535928,23680
1360780156,1201537912,1,46,46,1360780129823,1360780129823,1201511735,1201511735,0
1360780156,1201537912,1,46,46,1360780129886,1360780129886,1201511798,1201511798,0
1360780156,1201537916,1,46,46,1360780129886,1360780129886,1201511802,1201511802,0
1360780156,1201537916,1,46,46,1360780129821,1360780129821,1201511737,1201511737,0
1360780156,1201537948,1,46,46,1360780130874,1360780130874,1201512822,1201512822,0
1360780156,1201537948,5,1330,266,1360780131068,1360780145340,1201513016,1201527288,14272
1360780156,1201537948,8,871,108.875,1360780131067,1360780131195,1201513015,1201513143,128
1360780156,1201537952,9,3566,396.2222222,1360780131257,1360780142265,1201513209,1201524217,11008
1360780160,1201541796,5,3125,625,1360780131988,1360780132052,1201513784,1201513848,64
1360780160,1201541924,5,641,128.2,1360780133590,1360780134358,1201515514,1201516282,768
1360780164,1201546316,4,846,211.5,1360780159308,1360780159756,1201541624,1201542072,448
1360780164,1201546316,3,139,46.33333333,1360780162251,1360780162315,1201544567,1201544631,64
1360780164,1201546396,2,92,46,1360780162298,1360780162362,1201544694,1201544758,64
1360780176,1201558136,13,2761,212.3846154,1360780150402,1360780153154,1201532538,1201535290,2752
1360780176,1201558140,28,24010,857.5,1360780150906,1360780156410,1201533046,1201538550,5504
1360780184,1201566076,5,2162,432.4,1360780158779,1360780182011,1201540855,1201564087,23232
1360780184,1201566148,1,46,46,1360780157365,1360780157365,1201539513,1201539513,0
1360780196,1201578400,3,138,46,1360780193656,1360780194936,1201576056,1201577336,1280
1360780204,1201586028,1,52,52,1360780176877,1360780176877,1201558905,1201558905,0
1360780204,1201586168,1,52,52,1360780175967,1360780175967,1201558135,1201558135,0
1360780204,1201586408,2,92,46,1360780196592,1360780199984,1201579000,1201582392,3392
1360780208,1201590060,10,4273,427.3,1360780181708,1360780181836,1201563768,1201563896,128
1360780208,1201590176,7,1310,187.1428571,1360780181720,1360780202776,1201563896,1201584952,21056
1360780208,1201590176,1,46,46,1360780181655,1360780181655,1201563831,1201563831,0
1360780212,1201594264,1,46,46,1360780187133,1360780187133,1201569397,1201569397,0
1360780228,1201610420,2,92,46,1360780206693,1360780220133,1201589113,1201602553,13440
1360780236,1201618148,2,380,190,1360780208754,1360780220594,1201590902,1201602742,11840
1360780268,1201650476,5,230,46,1360780261673,1360780267625,1201644149,1201650101,5952
1360780272,1201654144,1,46,46,1360780247288,1360780247288,1201629432,1201629432,0
1360780272,1201654180,1,190,190,1360780244307,1360780244307,1201626487,1201626487,0
1360780292,1201674556,2,92,46,1360780273881,1360780286617,1201656437,1201669173,12736
1360780312,1201694232,1,46,46,1360780285020,1360780285020,1201667252,1201667252,0
1360780320,1201702440,2,278,139,1360780291599,1360780291599,1201674039,1201674039,0
1360780340,1201722188,1,46,46,1360780312521,1360780312521,1201694709,1201694709,0
1360780372,1201754600,5,430,86,1360780370540,1360780371244,1201753140,1201753844,704
1360780388,1201770304,1,46,46,1360780363349,1360780363349,1201745653,1201745653,0
1360780400,1201782372,2,202,101,1360780372494,1360780374414,1201754866,1201756786,1920
1360780428,1201810732,7,632,90.28571429,1360780421096,1360780424424,1201803828,1201807156,3328
1360780477,1201859068,3,138,46,1360780471040,1360780474432,1201853108,1201856500,3392
1360780493,1201874972,2,92,46,1360780478750,1360780486174,1201860722,1201868146,7424
1360780589,1201971100,4,184,46,1360780586654,1360780588190,1201968754,1201970290,1536
1360780595,1201977276,1,48,48,1360780564524,1360780564524,1201946800,1201946800,0
1360781635,1203017616,1,46,46,1360781608458,1360781608458,1202991074,1202991074,0
1360849073,1270455088,1,48,48,1360849046239,1360849046239,1270428327,1270428327,0
1360849525,1270906980,1,46,46,1360849500804,1360849500804,1270882784,1270882784,0
1360851469,1272850792,30,40353,1345.1,1360851464933,1360851465317,1272846725,1272847109,384
1360851469,1272850792,1,60,60,1360851465061,1360851465061,1272846853,1272846853,0
1360851469,1272850792,1,46,46,1360851465253,1360851465253,1272847045,1272847045,0
1360851470,1272851828,6,524,87.33333333,1360851466047,1360851466175,1272847875,1272848003,128
1360851470,1272851844,5,895,179,1360851467438,1360851468398,1272849282,1272850242,960
1360851470,1272851868,5,468,93.6,1360851465622,1360851469206,1272847490,1272851074,3584
1360851478,1272859820,11,3757,341.5454545,1360851470665,1360851471497,1272852485,1272853317,832
1360851478,1272859852,17,20529,1207.588235,1360851468328,1360851475624,1272850180,1272857476,7296
1360851478,1272859852,36,48301,1341.694444,1360851468328,1360851475624,1272850180,1272857476,7296
1360851478,1272859860,5,504,100.8,1360851466144,1360851470624,1272848004,1272852484,4480
1360851478,1272859860,4,356,89,1360851470432,1360851477664,1272852292,1272859524,7232
1360851478,1272859864,4,351,87.75,1360851471452,1360851471580,1272853316,1272853444,128
1360851478,1272859888,6,2272,378.6666667,1360851468486,1360851471302,1272850374,1272853190,2816
1360851486,1272867852,101,143140,1417.227723,1360851476969,1360851483689,1272858821,1272865541,6720
1360851486,1272867856,5,544,108.8,1360851485222,1360851485414,1272867078,1272867270,192
1360851486,1272867900,4,356,89,1360851478906,1360851485626,1272860806,1272867526,6720
1360851486,1272867928,64,86584,1352.875,1360851468509,1360851485597,1272850437,1272867525,17088
1360851491,4206152756,1,76,76,1360851464526,1360851464526,4206126282,4206126282,0
1360851493,1272874852,4,976,244,1360851465577,1360851465705,1272847429,1272847557,128
1360851493,1272874852,1,52,52,1360851465576,1360851465576,1272847428,1272847428,0
1360851493,1272874860,8,4481,560.125,1360851466465,1360851467617,1272848325,1272849477,1152
1360851493,1272874928,15,3341,222.7333333,1360851465757,1360851479837,1272847685,1272861765,14080
1360851494,1272875844,51,67827,1329.941176,1360851485681,1360851493745,1272867525,1272875589,8064
1360851494,1272875844,39,47901,1228.230769,1360851485681,1360851493745,1272867525,1272875589,8064
1360851494,1272875848,76,104545,1375.592105,1360851486956,1360851493676,1272868804,1272875524,6720
1360851494,1272875848,59,81315,1378.220339,1360851486956,1360851493676,1272868804,1272875524,6720
1360851494,1272875880,64,79906,1248.53125,1360851488973,1360851491725,1272870853,1272873605,2752
1360851494,1272875888,69,92943,1347,1360851486724,1360851493508,1272868612,1272875396,6784
1360851494,1272875892,71,87720,1235.492958,1360851471745,1360851491649,1272853637,1272873541,19904
1360851494,1272875892,13,6663,512.5384615,1360851491967,1360851493439,1272873859,1272875331,1472
1360851501,1272882868,22,20138,915.3636364,1360851474520,1360851485144,1272856388,1272867012,10624
1360851501,1272882936,5,2443,488.6,1360851473810,1360851474642,1272855746,1272856578,832
1360851501,1272882980,4,528,132,1360851476072,1360851476392,1272858052,1272858372,320
1360851502,1272883848,24,19074,794.75,1360851495211,1360851501419,1272877059,1272883267,6208
1360851502,1272883880,24,28081,1170.041667,1360851485388,1360851497740,1272867268,1272879620,12352
1360851502,1272883888,52,67800,1303.846154,1360851486852,1360851497732,1272868740,1272879620,10880
1360851517,1272898852,11,5298,481.6363636,1360851489894,1360851503654,1272871746,1272885506,13760
1360851517,1272898940,13,5353,411.7692308,1360851491790,1360851493198,1272873730,1272875138,1408
1360851521,1272902904,1,52,52,1360851495668,1360851495668,1272877572,1272877572,0
1360851521,1272902904,1,52,52,1360851495668,1360851495668,1272877572,1272877572,0
1360851521,1272902904,1,52,52,1360851495668,1360851495668,1272877572,1272877572,0
1360851521,1272902936,10,4947,494.7,1360851493650,1360851494802,1272875586,1272876738,1152
1360851521,1272902948,1,52,52,1360851495624,1360851495624,1272877572,1272877572,0
1360851521,1272902948,1,52,52,1360851495624,1360851495624,1272877572,1272877572,0
1360851525,1272906944,10,3385,338.5,1360851498314,1360851499978,1272880258,1272881922,1664
1360851529,1272910960,16,13718,857.375,1360851501562,1360851506362,1272883522,1272888322,4800
1360851529,1272910960,24,9901,412.5416667,1360851501689,1360851514937,1272883649,1272896897,13248
1360851533,1272914888,12,8095,674.5833333,1360851506947,1360851507331,1272888835,1272889219,384
1360851533,1272914920,1,185,185,1360851508385,1360851508385,1272890305,1272890305,0
1360851537,1272918964,22,8773,398.7727273,1360851509559,1360851514743,1272891523,1272896707,5184
1360851550,1272931940,4,1579,394.75,1360851543823,1360851548943,1272925763,1272930883,5120
1360851565,1272946904,4,829,207.25,1360851537972,1360851538420,1272919876,1272920324,448
1360851577,1272958936,1,52,52,1360851549969,1360851549969,1272931905,1272931905,0
1360851622,1273004008,2,131,65.5,1360851619787,1360851619787,1273001795,1273001795,0
1360851630,1273011944,2,131,65.5,1360851627274,1360851627274,1273009218,1273009218,0
1360851638,1273019904,4,783,195.75,1360851630065,1360851635185,1273011969,1273017089,5120
1360851638,1273019908,32,41484,1296.375,1360851630318,1360851635950,1273012226,1273017858,5632
1360851638,1273019908,43,58786,1367.116279,1360851630318,1360851635822,1273012226,1273017730,5504
1360851638,1273019920,13,3583,275.6153846,1360851632481,1360851634977,1273014401,1273016897,2496
1360851638,1273019944,12,3353,279.4166667,1360851632967,1360851633927,1273014911,1273015871,960
1360851638,1273019948,41,56062,1367.365854,1360851630149,1360851635845,1273012097,1273017793,5696
1360851638,1273019952,59,83586,1416.711864,1360851630272,1360851635712,1273012224,1273017664,5440
1360851638,1273019952,18,20254,1125.222222,1360851629442,1360851635330,1273011394,1273017282,5888
1360851638,1273019964,4,184,46,1360851632374,1360851632374,1273014338,1273014338,0
1360851646,1273027960,22,6602,300.0909091,1360851634873,1360851638585,1273016833,1273020545,3712
1360851654,1273036012,4,444,111,1360851648453,1360851648645,1273030465,1273030657,192
1360851661,1273042984,8,2872,359,1360851632993,1360851635105,1273014977,1273017089,2112
1360851665,1273046956,1,52,52,1360851638139,1360851638139,1273020095,1273020095,0
1360851665,1273046956,1,52,52,1360851638139,1360851638139,1273020095,1273020095,0
1360851665,1273046956,1,52,52,1360851638139,1360851638139,1273020095,1273020095,0
1360851665,1273046956,1,52,52,1360851638139,1360851638139,1273020095,1273020095,0
1360851665,1273047008,10,3462,346.2,1360851636937,1360851638601,1273018945,1273020609,1664
1360851665,1273047008,1,52,52,1360851638089,1360851638089,1273020097,1273020097,0
1360851665,1273047008,1,52,52,1360851638089,1360851638089,1273020097,1273020097,0
1360851673,1273055008,16,20477,1279.8125,1360851648521,1360851648585,1273030529,1273030593,64
1360851673,1273055012,23,29926,1301.130435,1360851648771,1360851648899,1273030783,1273030911,128
1360851673,1273055088,35,48249,1378.542857,1360851648441,1360851648505,1273030529,1273030593,64
1360851677,1273058964,1,60,60,1360851650742,1360851650742,1273032706,1273032706,0
1360851710,1273091992,4,208,52,1360851707480,1360851709080,1273089472,1273091072,1600
1360851713,1273095044,7,1295,185,1360851688228,1360851703460,1273070272,1273085504,15232
1360851718,1273100056,4,208,52,1360851714522,1360851716314,1273096578,1273098370,1792
1360851718,1273100084,3,156,52,1360851716282,1360851717114,1273098366,1273099198,832
1360851726,1273107992,2,104,52,1360851718295,1360851720471,1273100287,1273102463,2176
1360851734,1273116056,3,156,52,1360851733080,1360851733784,1273115136,1273115840,704
1360851737,1273119000,1,52,52,1360851710802,1360851710802,1273092802,1273092802,0
1360851741,1273123016,3,555,185,1360851713470,1360851733438,1273095486,1273115454,19968
1360851742,1273124076,5,260,52,1360851734594,1360851738114,1273116670,1273120190,3520
1360851742,1273124076,2,104,52,1360851734725,1360851736709,1273116801,1273118785,1984
1360851745,1273127024,1,52,52,1360851718393,1360851718393,1273100417,1273100417,0
1360851750,1273132036,5,260,52,1360851743467,1360851746795,1273125503,1273128831,3328
1360851758,1273140048,4,208,52,1360851754655,1360851756703,1273136703,1273138751,2048
1360851758,1273140052,5,368,73.6,1360851754973,1360851756957,1273137025,1273139009,1984
1360851766,1273148044,6,447,74.5,1360851758500,1360851762340,1273140544,1273144384,3840
1360851766,1273148088,2,158,79,1360851759158,1360851763702,1273141246,1273145790,4544
1360851769,1273151156,1,185,185,1360851743348,1360851743348,1273125504,1273125504,0
1360851782,1273164092,5,260,52,1360851778164,1360851781812,1273160256,1273163904,3648
1360851782,1273164128,2,158,79,1360851766352,1360851774608,1273148480,1273156736,8256
1360851785,1273167232,1,52,52,1360851758823,1360851758823,1273141055,1273141055,0
1360851797,1273179416,2,158,79,1360851772400,1360851790512,1273154816,1273172928,18112
1360851817,1273199464,1,79,79,1360851790653,1360851790653,1273173117,1273173117,0
1360851849,1273231476,1,79,79,1360851823476,1360851823476,1273205952,1273205952,0
1360851853,1273235460,1,79,79,1360851826626,1360851826626,1273209086,1273209086,0
1360851894,1273276148,5,260,52,1360851888442,1360851891834,1273270590,1273273982,3392
1360851894,1273276192,4,208,52,1360851890575,1360851892111,1273272767,1273274303,1536
1360851894,1273276216,5,260,52,1360851888310,1360851891702,1273270526,1273273918,3392
1360851894,1273276216,5,260,52,1360851888692,1360851892980,1273270908,1273275196,4288
1360851894,1273276220,164,227769,1388.835366,1360851647986,1360851892082,1273030206,1273274302,244096
1360851922,1273303556,1,52,52,1360851894539,1360851894539,1273276095,1273276095,0
1360851922,1273303556,1,52,52,1360851894728,1360851894728,1273276284,1273276284,0
1360851958,1273339904,1,46,46,1360851932654,1360851932654,1273314558,1273314558,0
1360852014,1273396268,7,502,71.71428571,1360852006014,1360852013246,1273388282,1273395514,7232
1360852046,1273427936,2,150,75,1360852021003,1360852035915,1273402939,1273417851,14912
1360852090,1273471940,1,75,75,1360852065672,1360852065672,1273447612,1273447612,0
1360852467,1273848756,3,192,64,1360852440120,1360852442296,1273821876,1273824052,2176
1360852467,1273848768,2,128,64,1360852441773,1360852442861,1273823541,1273824629,1088
1360936672,1358053896,30,36712,1223.733333,1360936671136,1360936671584,1358053032,1358053480,448
1360936680,1358061916,6,569,94.83333333,1360936678668,1360936678988,1358060584,1358060904,320
1360936680,1358061924,15,6086,405.7333333,1360936676613,1360936677701,1358058537,1358059625,1088
1360936680,1358061928,5,504,100.8,1360936671873,1360936672321,1358053801,1358054249,448
1360936680,1358061960,30,8972,299.0666667,1360936676704,1360936679584,1358058664,1358061544,2880
1360936688,1358069940,40,46392,1159.8,1360936682995,1360936684851,1358064935,1358066791,1856
1360936688,1358069948,14,3631,259.3571429,1360936677996,1360936682156,1358059944,1358064104,4160
1360936688,1358069972,14,4785,341.7857143,1360936682324,1360936684180,1358064296,1358066152,1856
1360936688,1358069984,22,6145,279.3181818,1360936676232,1360936687112,1358058216,1358069096,10880
1360936688,1358069988,14,4152,296.5714286,1360936677063,1360936682375,1358059051,1358064363,5312
1360936688,1358069992,13,3571,274.6923077,1360936678019,1360936682307,1358060011,1358064299,4288
1360936694,1358076172,1,76,76,1360936667469,1360936667469,1358049641,1358049641,0
1360936694,1358076172,4,481,120.25,1360936667533,1360936667789,1358049705,1358049961,256
1360936694,1358076176,16,3403,212.6875,1360936668039,1360936674183,1358050215,1358056359,6144
1360936696,1358077956,38,41238,1085.210526,1360936686884,1360936688420,1358068840,1358070376,1536
1360936698,1358080164,20,13507,675.35,1360936669909,1360936690261,1358052073,1358072425,20352
1360936698,1358080216,4,452,113,1360936671841,1360936672033,1358054057,1358054249,192
1360936702,1358084236,29,3858,133.0344828,1360936677580,1360936684620,1358059816,1358066856,7040
1360936706,1358088168,11,4011,364.6363636,1360936678994,1360936703506,1358061162,1358085674,24512
1360936706,1358088172,11,6408,582.5454545,1360936679566,1360936680078,1358061738,1358062250,512
1360936706,1358088208,30,34101,1136.7,1360936678567,1360936680999,1358060775,1358063207,2432
1360936706,1358088244,6,3258,543,1360936679555,1360936680899,1358061799,1358063143,1344
1360936720,1358101948,33,12534,379.8181818,1360936714220,1360936716460,1358096168,1358098408,2240
1360936721,4291382628,19,16194,852.3157895,1360936718711,1360936719607,4291380339,4291381235,896
1360936722,1358104208,1,52,52,1360936697767,1360936697767,1358079975,1358079975,0
1360936728,1358109932,2,98,49,1360936702333,1360936723645,1358084265,1358105577,21312
1360936736,1358117964,18,4472,248.4444444,1360936727646,1360936728478,1358109610,1358110442,832
1360936738,1358120220,15,13418,894.5333333,1360936711070,1360936734238,1358093290,1358116458,23168
1360936746,1358128204,2,1295,647.5,1360936718765,1360936718765,1358100969,1358100969,0
1360936754,1358136228,1,185,185,1360936727317,1360936727317,1358109545,1358109545,0
1360936755,1358136272,11,2614,237.6363636,1360936727442,1360936731282,1358108714,1358112554,3840
1360936768,1358149988,18,4472,248.4444444,1360936760002,1360936760770,1358141990,1358142758,768
1360936775,1358156272,8,3406,425.75,1360936747535,1360936748303,1358128807,1358129575,768
1360936775,1358156276,8,2812,351.5,1360936747726,1360936748302,1358129002,1358129578,576
1360936775,1358156352,1,151,151,1360936750271,1360936750271,1358131623,1358131623,0
1360936776,1358157988,32,12193,381.03125,1360936774213,1360936775621,1358156201,1358157609,1408
1360936776,1358157996,19,4187,220.3684211,1360936771066,1360936772474,1358153062,1358154470,1408
1360936776,1358158044,17,4029,237,1360936769164,1360936769868,1358151208,1358151912,704
1360936783,1358164512,1,48,48,1360936757409,1360936757409,1358138921,1358138921,0
1360936783,1358164872,5,3822,764.4,1360936757816,1360936761080,1358139688,1358142952,3264
1360936824,1358206052,6,938,156.3333333,1360936814596,1360936819524,1358196648,1358201576,4928
1360936824,1358206064,46,13677,297.326087,1360936799608,1360936821560,1358181672,1358203624,21952
1360936827,1358208372,45,52718,1171.511111,1360936802281,1360936822505,1358183653,1358203877,20224
1360936827,1358208380,5,4758,951.6,1360936799394,1360936802274,1358180774,1358183654,2880
1360936832,1358214100,31,5702,183.9354839,1360936826900,1360936829716,1358209000,1358211816,2816
1360936839,1358220452,18,20170,1120.555556,1360936814107,1360936814427,1358195559,1358195879,320
1360936840,1358222064,4,289,72.25,1360936838902,1360936839542,1358220966,1358221606,640
1360936848,1358230096,3,237,79,1360936840408,1360936845720,1358222504,1358227816,5312
1360936851,1358232372,2,131,65.5,1360936824298,1360936824298,1358205670,1358205670,0
1360936859,1358240436,1,190,190,1360936831211,1360936831211,1358212647,1358212647,0
1360936872,1358254076,6,447,74.5,1360936867436,1360936871276,1358249512,1358253352,3840
1360936872,1358254076,4,289,72.25,1360936867436,1360936869676,1358249512,1358251752,2240
1360936872,1358254148,2,158,79,1360936852834,1360936867042,1358234982,1358249190,14208
1360936880,1358262124,2,158,79,1360936872570,1360936878522,1358254694,1358260646,5952
1360936888,1358270100,2,158,79,1360936875412,1360936883668,1358257512,1358265768,8256
1360936919,1358300440,2,158,79,1360936891046,1360936914726,1358272486,1358296166,23680
1360936920,1358302144,618,859073,1390.085761,1360936717862,1360936919334,1358100006,1358301478,201472
1360936923,1358304452,1,79,79,1360936896218,1360936896218,1358277670,1358277670,0
1360936927,1358308492,1,79,79,1360936900721,1360936900721,1358282213,1358282213,0
1360936928,1358310088,409,548247,1340.457213,1360936711197,1360936925213,1358093285,1358307301,214016
1360936928,1358310120,3,237,79,1360936920254,1360936925758,1358302374,1358307878,5504
1360936928,1358310128,5,260,52,1360936921076,1360936924916,1358303204,1358307044,3840
1360936944,1358326112,2,158,79,1360936929093,1360936936965,1358311205,1358319077,7872
1360936952,1358334180,2,158,79,1360936932995,1360936947587,1358315175,1358329767,14592
1360936959,1358340568,1,79,79,1360936933670,1360936933670,1358315238,1358315238,0
1360936976,1358358124,5,352,70.4,1360936974138,1360936975802,1358356262,1358357926,1664
1360936976,1358358124,5,260,52,1360936970425,1360936974969,1358352549,1358357093,4544
1360936979,1358360548,1,79,79,1360936953273,1360936953273,1358334821,1358334821,0
1360936984,1358366164,2,150,75,1360936977617,1360936981393,1358359781,1358363557,3776
1360936987,1358368608,1,79,79,1360936961981,1360936961981,1358343589,1358343589,0
1360936992,1358374204,3,179,59.66666667,1360936991018,1360936991018,1358373222,1358373222,0
1360937003,1358384580,1,79,79,1360936977495,1360936977495,1358359075,1358359075,0
1360937007,1358388592,7,1022,146,1360936980939,1360937001227,1358362531,1358382819,20288
1360937008,1358390224,2,150,75,1360936988886,1360937003926,1358371110,1358386150,15040
1360937011,1358392584,1,79,79,1360936984661,1360936984661,1358366245,1358366245,0
1360937047,1358428592,1,46,46,1360937019210,1360937019210,1358400802,1358400802,0
1360937047,1358428628,1,146,146,1360937021734,1360937021734,1358403362,1358403362,0
1360937059,1358440644,1,75,75,1360937034710,1360937034710,1358416354,1358416354,0
1360937087,1358468816,1,146,146,1360937062701,1360937062701,1358444517,1358444517,0
1360937127,1358508920,1,46,46,1360937099716,1360937099716,1358481636,1358481636,0
1360937127,1358508952,1,46,46,1360937101537,1360937101537,1358483489,1358483489,0
1360937171,1358552952,1,146,146,1360937144995,1360937144995,1358526947,1358526947,0
1360937227,1358608928,1,173,173,1360937201783,1360937201783,1358583711,1358583711,0
1360937321,1358702380,6,427,71.16666667,1360937314460,1360937317788,1358695840,1358699168,3328
1360937329,1358710368,2,150,75,1360937321321,1360937328425,1358702689,1358709793,7104
1360937367,1358749128,1,75,75,1360937341870,1360937341870,1358723998,1358723998,0
1360937395,1358777100,1,75,75,1360937370187,1360937370187,1358752287,1358752287,0
1360937548,1358929872,1,46,46,1360937520301,1360937520301,1358902173,1358902173,0
1360938623,1360005104,1,46,46,1360938597107,1360938597107,1359979211,1359979211,0
1360940011,1361392644,24,18993,791.375,1360940005163,1360940008875,1361386807,1361390519,3712
1360940026,1361407352,16,3292,205.75,1360940000526,1360940007310,1361381878,1361388662,6784
1360940026,1361407352,7,3231,461.5714286,1360940000526,1360940001614,1361381878,1361382966,1088
1360940030,1361411316,12,5375,447.9166667,1360940002098,1360940009650,1361383414,1361390966,7552
1360940030,1361411316,1,52,52,1360940002034,1360940002034,1361383350,1361383350,0
1360940030,1361411352,11,5530,502.7272727,1360940003984,1360940005200,1361385336,1361386552,1216
1360940030,1361411352,13,6293,484.0769231,1360940002959,1360940003599,1361384311,1361384951,640
1360940034,1361415284,10,3385,338.5,1360940008209,1360940008721,1361389493,1361390005,512
1360940034,1361415356,22,18843,856.5,1360940009163,1360940033803,1361390519,1361415159,24640
1360940035,1361416576,15,6086,405.7333333,1360940030191,1360940031023,1361411767,1361412599,832
1360940035,1361416624,31,10715,345.6451613,1360940030334,1360940032574,1361411958,1361414198,2240
1360940043,1361424596,12,3356,279.6666667,1360940034840,1360940035480,1361416436,1361417076,640
1360940043,1361424640,21,6413,305.3809524,1360940029999,1360940037487,1361411639,1361419127,7488
1360940043,1361424664,8,2459,307.375,1360940035670,1360940036246,1361417334,1361417910,576
1360940043,1361424668,5,577,115.4,1360940034387,1360940035091,1361416055,1361416759,704
1360940043,1361424672,5,577,115.4,1360940034764,1360940037004,1361416436,1361418676,2240
1360940054,1361435332,1,52,52,1360940026915,1360940026915,1361408247,1361408247,0
1360940058,1361439360,9,3213,357,1360940030085,1360940035013,1361411445,1361416373,4928
1360940058,1361439400,23,1618,70.34782609,1360940031711,1360940034911,1361413111,1361416311,3200
1360940058,1361439408,25,19072,762.88,1360940033173,1360940055509,1361414581,1361436917,22336
1360940059,1361440632,28,9785,349.4642857,1360940051445,1360940055029,1361433077,1361436661,3584
1360940062,1361443324,13,10879,836.8461538,1360940034155,1360940055467,1361415479,1361436791,21312
1360940062,1361443376,41,49950,1218.292683,1360940034167,1360940034487,1361415543,1361415863,320
1360940062,1361443412,87,112326,1291.103448,1360940036307,1360940045843,1361417719,1361427255,9536
1360940082,1361463400,11,7204,654.9090909,1360940057181,1360940057437,1361438581,1361438837,256
1360940086,1361467432,16,11046,690.375,1360940057917,1360940074877,1361439349,1361456309,16960
1360940090,1361471468,21,8582,408.6666667,1360940063642,1360940067354,1361445110,1361448822,3712
1360940106,1361487460,1,151,151,1360940080991,1360940080991,1361462451,1361462451,0
1360940118,1361499452,23,15855,689.3478261,1360940091816,1360940098088,1361473268,1361479540,6272
1360940147,1361528752,22,14900,677.2727273,1360940142971,1360940145467,1361524723,1361527219,2496
1360940150,1361531620,11,6647,604.2727273,1360940123584,1360940123904,1361505204,1361505524,320
1360940150,1361531624,16,15641,977.5625,1360940123836,1360940149372,1361505460,1361530996,25536
1360940155,1361536704,2,131,65.5,1360940154093,1360940154093,1361535797,1361535797,0
1360940155,1361536716,12,3173,264.4166667,1360940148382,1360940149150,1361530098,1361530866,768
1360940155,1361536716,17,4466,262.7058824,1360940148769,1360940151841,1361530485,1361533557,3072
1360940155,1361536752,16,5390,336.875,1360940143036,1360940148924,1361524788,1361530676,5888
1360940155,1361536756,28,5616,200.5714286,1360940151991,1360940152759,1361533747,1361534515,768
1360940163,1361544716,17,4065,239.1176471,1360940156959,1360940157535,1361538675,1361539251,576
1360940163,1361544724,28,5591,199.6785714,1360940157722,1360940158490,1361539446,1361540214,768
1360940171,1361552712,27,30152,1116.740741,1360940166050,1360940169314,1361547762,1361551026,3264
1360940171,1361552728,5,851,170.2,1360940165077,1360940165909,1361546805,1361547637,832
1360940171,1361552752,2,131,65.5,1360940165434,1360940165434,1361547186,1361547186,0
1360940171,1361552752,8,2661,332.625,1360940165565,1360940169341,1361547317,1361551093,3776
1360940178,1361559700,2,491,245.5,1360940151534,1360940151598,1361533234,1361533298,64
1360940179,1361560724,4,1508,377,1360940171225,1360940177369,1361552949,1361559093,6144
1360940179,1361560764,5,1919,383.8,1360940171182,1360940177326,1361552946,1361559090,6144
1360940179,1361560768,52,64157,1233.788462,1360940170412,1360940177324,1361552180,1361559092,6912
1360940179,1361560804,2,131,65.5,1360940177033,1360940177033,1361558837,1361558837,0
1360940187,1361568752,14,7707,550.5,1360940171194,1360940181370,1361552946,1361563122,10176
1360940187,1361568800,5,548,109.6,1360940168653,1360940181325,1361550453,1361563125,12672
1360940195,1361576772,2,192,96,1360940194344,1360940194344,1361576116,1361576116,0
1360940198,1361579720,10,4463,446.3,1360940171229,1360940185629,1361552949,1361567349,14400
1360940203,1361584760,5,2948,589.6,1360940187825,1360940195377,1361569585,1361577137,7552
1360940203,1361584796,4,356,89,1360940188945,1360940195345,1361570741,1361577141,6400
1360940203,1361584808,57,70548,1237.684211,1360940186563,1360940197379,1361568371,1361579187,10816
1360940203,1361584812,8,6742,842.75,1360940187776,1360940195328,1361569588,1361577140,7552
1360940210,1361591724,2,221,110.5,1360940184473,1360940209753,1361566197,1361591477,25280
1360940211,1361592832,5,540,108,1360940209260,1360940209388,1361591092,1361591220,128
1360940219,1361600780,64,84953,1327.390625,1360940209887,1360940218271,1361591667,1361600051,8384
1360940219,1361600784,68,91547,1346.279412,1360940211355,1360940218267,1361593139,1361600051,6912
1360940219,1361600820,26,31135,1197.5,1360940209465,1360940218297,1361591285,1361600117,8832
1360940219,1361600820,20,22247,1112.35,1360940209846,1360940218230,1361591666,1361600050,8384
1360940219,1361600860,4,678,169.5,1360940208911,1360940215119,1361590771,1361596979,6208
1360940227,1361608800,7,3037,433.8571429,1360940211597,1360940225229,1361593397,1361607029,13632
1360940238,1361619816,2,104,52,1360940209916,1360940210044,1361591732,1361591860,128
1360940243,1361624844,6,1234,205.6666667,1360940241248,1360940241696,1361623092,1361623540,448
1360940246,1361627852,1,52,52,1360940221142,1360940221142,1361602994,1361602994,0
1360940246,1361627852,1,52,52,1360940221142,1360940221142,1361602994,1361602994,0
1360940246,1361627900,1,52,52,1360940221093,1360940221093,1361602993,1361602993,0
1360940246,1361627924,1,52,52,1360940221071,1360940221071,1361602995,1361602995,0
1360940251,1361632804,2,131,65.5,1360940243718,1360940243782,1361625522,1361625586,64
1360940251,1361632812,17,4065,239.1176471,1360940248318,1360940249086,1361630130,1361630898,768
1360940251,1361632812,4,319,79.75,1360940245054,1360940245182,1361626866,1361626994,128
1360940251,1361632844,37,48353,1306.837838,1360940241504,1360940249312,1361623348,1361631156,7808
1360940254,1361635808,25,29846,1193.84,1360940241860,1360940244932,1361623668,1361626740,3072
1360940259,1361640824,4,356,89,1360940244402,1360940251442,1361626226,1361633266,7040
1360940259,1361640828,4,399,99.75,1360940244974,1360940251374,1361626802,1361633202,6400
1360940259,1361640900,29,34979,1206.172414,1360940241447,1360940251303,1361623347,1361633203,9856
1360940266,1361647904,1,52,52,1360940241059,1360940241059,1361622963,1361622963,0
1360940270,1361651856,1,52,52,1360940244497,1360940244497,1361626353,1361626353,0
1360940270,1361651868,1,52,52,1360940243077,1360940243077,1361624945,1361624945,0
1360940274,1361655908,2,104,52,1360940248224,1360940248288,1361630132,1361630196,64
1360940274,1361655908,2,798,399,1360940248287,1360940248351,1361630195,1361630259,64
1360940274,1361655912,1,52,52,1360940249051,1360940249051,1361630963,1361630963,0
1360940275,1361656892,35,9569,273.4,1360940251758,1360940272622,1361633650,1361654514,20864
1360940275,1361656920,3,138,46,1360940272912,1360940272912,1361654832,1361654832,0
1360940291,1361672844,3,138,46,1360940287070,1360940287070,1361668914,1361668914,0
1360940291,1361672848,13,3571,274.6923077,1360940284632,1360940289560,1361666480,1361671408,4928
1360940291,1361672856,3,138,46,1360940284948,1360940284948,1361666804,1361666804,0
1360940291,1361672920,13,3571,274.6923077,1360940284627,1360940289363,1361666547,1361671283,4736
1360940291,1361672924,19,6101,321.1052632,1360940285133,1360940286733,1361667057,1361668657,1600
1360940297,4294959516,14,6431,459.3571429,1360940285014,1360940293974,4294947530,4294956490,8960
1360940298,1361680088,11,7360,669.0909091,1360940272746,1360940273002,1361654834,1361655090,256
1360940298,1361680144,47,32190,684.893617,1360940272564,1360940287604,1361654708,1361669748,15040
1360940299,1361680856,27,8212,304.1481481,1360940288339,1360940291027,1361670195,1361672883,2688
1360940299,1361680888,15,3726,248.4,1360940294450,1360940296114,1361676338,1361678002,1664
1360940299,1361680920,28,8632,308.2857143,1360940296466,1360940298066,1361678386,1361679986,1600
1360940302,1361684128,55,40483,736.0545455,1360940274752,1360940298496,1361656880,1361680624,23744
1360940305,200,15,8913,594.2,1365235265902,1365235266606,4294961102,4294961806,704
1360940306,1361688072,1,46,46,1360940278074,1360940278074,1361660146,1361660146,0
1360940313,7528,7,2193,313.2857143,1365235253004,1365235254156,4294947532,4294948684,1152
1360940314,8332,18,12257,680.9444444,1360940310734,1360940311630,5066,5962,896
1360940314,1361696128,17,13461,791.8235294,1360940286402,1360940307842,1361668530,1361689970,21440
1360940315,1361696844,25,7087,283.48,1360940294494,1360940307550,1361676338,1361689394,13056
1360940315,1361696888,15,3663,244.2,1360940310385,1360940312241,1361692273,1361694129,1856
1360940315,1361696888,36,13370,371.3888889,1360940310385,1360940313713,1361692273,1361695601,3328
1360940315,1361696896,27,7775,287.962963,1360940308011,1360940310059,1361689907,1361691955,2048
1360940318,1361700208,1,46,46,1360940292336,1360940292336,1361674544,1361674544,0
1360940322,1361704080,1,46,46,1360940294449,1360940294449,1361676529,1361676529,0
1360940326,1361708168,19,12606,663.4736842,1360940298393,1360940308057,1361680561,1361690225,9664
1360940334,1361716088,40,32876,821.9,1360940307432,1360940310120,1361689520,1361692208,2688
1360940338,32292,18,15450,858.3333333,1360940332728,1360940333240,27020,27532,512
1360940338,1361720152,4,3813,953.25,1360940309931,1360940309931,1361692083,1361692083,0
1360940339,1361720936,6,1002,167,1360940334591,1360940334783,1361716527,1361716719,192
1360940355,1361736948,21,8079,384.7142857,1360940351350,1360940352118,1361733298,1361734066,768
1360940358,1361740176,3,250,83.33333333,1360940331727,1360940334159,1361713903,1361716335,2432
1360940378,1361760144,3,2356,785.3333333,1360940352115,1360940352115,1361734259,1361734259,0
1360940378,1361760144,9,6480,720,1360940352176,1360940361840,1361734320,1361743984,9664
1360940419,1361800956,147,190245,1294.183673,1360940286956,1360940418668,1361668912,1361800624,131712
1360940422,1361804212,6,4189,698.1666667,1360940395501,1360940404333,1361777713,1361786545,8832
1360940435,1361817036,274,362526,1323.087591,1360940284893,1360940427677,1361666929,1361809713,142784
1360940435,1361817040,2,131,65.5,1360940430039,1360940430039,1361812079,1361812079,0
1360940450,1361832204,1,46,46,1360940425138,1360940425138,1361807342,1361807342,0
1360940451,1361832320,9,6650,738.8888889,1360940424550,1360940447654,1361805870,1361828974,23104
1360940459,1361840980,3,138,46,1360940452565,1360940452565,1361834545,1361834545,0
1360940459,1361841044,30,9521,317.3666667,1360940452562,1360940457938,1361834606,1361839982,5376
1360940474,1361856204,87,119353,1371.873563,1360940446836,1360940447220,1361829040,1361829424,384
1360940476,1361857336,15,6698,446.5333333,1360940471641,1360940472665,1361852977,1361854001,1024
1360940476,1361857364,34,8187,240.7941176,1360940465404,1360940467772,1361846768,1361849136,2368
1360940476,1361857376,31,12583,405.9032258,1360940468080,1360940470192,1361849456,1361851568,2112
1360940476,1361857420,14,4483,320.2142857,1360940457921,1360940471681,1361839341,1361853101,13760
1360940478,1361860240,50,62406,1248.12,1360940452302,1360940452622,1361834542,1361834862,320
1360940479,1361860292,2,2072,1036,1360940453250,1360940453250,1361834542,1361834542,0
1360940482,176324,9,4266,474,1360940473305,1360940481881,167629,176205,8576
1360940483,1361864292,20,6970,348.5,1360940458178,1360940480514,1361839470,1361861806,22336
1360940484,1361865272,17,6885,405,1360940471959,1360940479959,1361853231,1361861231,8000
1360940484,1361865316,5,524,104.8,1360940471531,1360940477931,1361852847,1361859247,6400
1360940484,1361865352,18,9202,511.2222222,1360940473287,1360940481863,1361854639,1361863215,8576
1360940484,1361865352,16,9070,566.875,1360940473287,1360940482055,1361854639,1361863407,8768
1360940484,1361865352,18,7933,440.7222222,1360940473286,1360940483590,1361854638,1361864942,10304
1360940486,1361868184,1,46,46,1360940459397,1360940459397,1361841581,1361841581,0
1360940486,1361868252,83,110436,1330.554217,1360940458562,1360940485058,1361840814,1361867310,26496
1360940492,1361873272,13,5431,417.7692308,1360940475032,1360940484184,1361856304,1361865456,9152
1360940492,1361873284,13,4002,307.8461538,1360940485642,1360940490250,1361866926,1361871534,4608
1360940492,1361873348,2,92,46,1360940480138,1360940489226,1361861486,1361870574,9088
1360940492,1361873360,18,4404,244.6666667,1360940489214,1360940489790,1361870574,1361871150,576
1360940506,1361888216,22,21784,990.1818182,1360940478629,1360940481637,1361860845,1361863853,3008
1360940506,1361888228,10,8078,807.8,1360940479644,1360940480156,1361861872,1361862384,512
1360940506,1361888228,13,13705,1054.230769,1360940479708,1360940480860,1361861936,1361863088,1152
1360940507,1361888300,11,9897,899.7272727,1360940481082,1360940481210,1361862382,1361862510,128
1360940507,1361888304,7,5202,743.1428571,1360940481464,1360940481784,1361862768,1361863088,320
1360940507,1361888304,9,9309,1034.333333,1360940481974,1360940482230,1361863278,1361863534,256
1360940508,1361889364,20,5503,275.15,1360940493501,1360940506237,1361874865,1361887601,12736
1360940510,1361892220,1,196,196,1360940483937,1360940483937,1361866157,1361866157,0
1360940511,1361892300,20,6200,310,1360940485755,1360940506107,1361867055,1361887407,20352
1360940511,1361892300,32,42334,1322.9375,1360940485754,1360940486074,1361867054,1361867374,320
1360940524,1361905360,22,16688,758.5454545,1360940513216,1360940520320,1361894576,1361901680,7104
1360940527,1361908284,75,102901,1372.013333,1360940500556,1360940503756,1361881840,1361885040,3200
1360940539,1361920340,2,505,252.5,1360940513426,1360940513490,1361894766,1361894830,64
1360940543,1361924284,21,3757,178.9047619,1360940517513,1360940518409,1361898797,1361899693,896
1360940580,1361961692,6,447,74.5,1360940573104,1360940576496,1361954796,1361958188,3392
1360940588,1361969424,2,158,79,1360940580415,1360940587775,1361961839,1361969199,7360
1360940612,1361993388,4,356,89,1360940602912,1360940610400,1361984300,1361991788,7488
1360940612,1361993436,28,25950,926.7857143,1360940601905,1360940610417,1361983341,1361991853,8512
1360940618,312328,5,934,186.8,1360940613398,1360940613398,307726,307726,0
1360940618,312328,9,4539,504.3333333,1360940613462,1360940613974,307790,308302,512
1360940618,312328,12,9458,788.1666667,1360940613972,1360940614356,308300,308684,384
1360940623,1362004308,19,3261,171.6315789,1360940596207,1360940603439,1361977515,1361984747,7232
1360940623,1362004352,1,52,52,1360940598663,1360940598663,1361980015,1361980015,0
1360940623,1362004384,15,3228,215.2,1360940596453,1360940603813,1361977837,1361985197,7360
1360940623,1362004424,1,60,60,1360940598332,1360940598332,1361979756,1361979756,0
1360940627,1362008372,1,52,52,1360940602097,1360940602097,1361983469,1361983469,0
1360940627,1362008376,1,79,79,1360940602415,1360940602415,1361983791,1361983791,0
1360940628,1362009404,4,662,165.5,1360940613202,1360940620434,1361994606,1362001838,7232
1360940628,1362009448,247,337637,1366.951417,1360940485604,1360940625188,1361867052,1362006636,139584
1360940631,1362012432,1,52,52,1360940605876,1360940605876,1361987308,1361987308,0
1360940636,1362017496,2,131,65.5,1360940633268,1360940633268,1362014764,1362014764,0
1360940644,1362025424,2,131,65.5,1360940637758,1360940637758,1362019182,1362019182,0
1360940651,1362032412,1,52,52,1360940623562,1360940623562,1362004974,1362004974,0
1360940671,1362052504,1,146,146,1360940643630,1360940643630,1362025134,1362025134,0
1360940755,1362136540,1,46,46,1360940730821,1360940730821,1362112361,1362112361,0
1360940759,1362140540,1,46,46,1360940731208,1360940731208,1362112748,1362112748,0
1360940775,1362156556,2,336,168,1360940747256,1360940747512,1362128812,1362129068,256
1360940794,488348,3,202,67.33333333,1360940787010,1360940787266,481358,481614,256
1360940812,1362193544,3,202,67.33333333,1360940808449,1360940808705,1362189993,1362190249,256
1360940860,1362241528,2,127,63.5,1360940852754,1360940852754,1362234282,1362234282,0
1360940923,1362305012,2,104,52,1360940895853,1360940896237,1362277865,1362278249,384
1360940948,1362329540,2,127,63.5,1360940947843,1360940947843,1362329383,1362329383,0
1360940956,1362337584,2,127,63.5,1360940952920,1360940952920,1362334504,1362334504,0
1360940988,1362369612,2,104,52,1360940980860,1360940981116,1362362472,1362362728,256
1360940988,1362369620,2,104,52,1360940982195,1360940982451,1362363815,1362364071,256
1360940995,1362377252,22,8587,390.3181818,1360940967034,1360940971450,1362349286,1362353702,4416
1360941007,1362389268,1,52,52,1360940980077,1360940980077,1362362345,1362362345,0
1360941007,1362389272,1,52,52,1360940980840,1360940980840,1362363112,1362363112,0
1360941007,1362389272,1,52,52,1360940980839,1360940980839,1362363111,1362363111,0
1360941032,1362413440,3,303,101,1360941006374,1360941006950,1362387814,1362388390,576
1360941072,1362453384,1,191,191,1360941047264,1360941047264,1362428648,1362428648,0
1360941108,1362489716,5,851,170.2,1360941105106,1360941106322,1362486822,1362488038,1216
1360941108,1362489756,4,319,79.75,1360941107051,1360941107115,1362488807,1362488871,64
1360941108,1362489792,25,29850,1194,1360941106372,1360941106884,1362488164,1362488676,512
1360941116,1362497744,4,527,131.75,1360941105269,1360941113205,1362487013,1362494949,7936
1360941116,1362497776,21,6767,322.2380952,1360941107542,1360941114774,1362489318,1362496550,7232
1360941116,1362497776,29,7891,272.1034483,1360941108052,1360941109524,1362489828,1362491300,1472
1360941116,1362497816,4,356,89,1360941106092,1360941113132,1362487908,1362494948,7040
1360941122,816452,30,27689,922.9666667,1360941110045,1360941117917,804497,812369,7872
1360941124,1362505812,12,3441,286.75,1360941119343,1360941119983,1362501155,1362501795,640
1360941124,1362505828,27,7142,264.5185185,1360941115360,1360941117216,1362497188,1362499044,1856
1360941128,1362509448,2,241,120.5,1360941103071,1360941103071,1362484519,1362484519,0
1360941132,1362513736,3,156,52,1360941107517,1360941107645,1362489253,1362489381,128
1360941136,1362517440,8,3153,394.125,1360941107879,1360941113191,1362489319,1362494631,5312
1360941140,1362521452,35,33235,949.5714286,1360941115162,1360941117722,1362496614,1362499174,2560
1360941140,1362521492,27,17323,641.5925926,1360941113651,1360941117683,1362495143,1362499175,4032
1360941140,1362521752,2,192,96,1360941135275,1360941135275,1362517027,1362517027,0
1360941144,1362525436,13,3243,249.4615385,1360941117867,1360941118443,1362499303,1362499879,576
1360941144,1362525436,13,3954,304.1538462,1360941117866,1360941118442,1362499302,1362499878,576
1360941144,1362525476,11,8369,760.8181818,1360941115969,1360941116673,1362497445,1362498149,704
1360941144,1362525540,10,3740,374,1360941119617,1360941120257,1362501157,1362501797,640
1360941148,1362529460,88,122124,1387.772727,1360941120657,1360941120849,1362502117,1362502309,192
1360941204,1362585572,7,1309,187,1360941178399,1360941199455,1362559971,1362581027,21056
1360941224,1362605552,6,1290,215,1360941197173,1360941217205,1362578725,1362598757,20032
1360941236,1362617552,3,561,187,1360941209458,1360941229490,1362591010,1362611042,20032
1360941236,1362617868,5,368,73.6,1360941232630,1360941235574,1362614498,1362617442,2944
1360941244,1362625808,5,368,73.6,1360941239924,1360941241908,1362621732,1362623716,1984
1360941244,1362625812,4,208,52,1360941240305,1360941241969,1362622117,1362623781,1664
1360941244,1362625820,6,447,74.5,1360941237928,1360941242088,1362619748,1362623908,4160
1360941244,1362625860,6,447,74.5,1360941237886,1360941241726,1362619746,1362623586,3840
1360941252,1362633792,2,104,52,1360941243907,1360941247747,1362625699,1362629539,3840
1360941252,1362633844,2,158,79,1360941244113,1360941248657,1362625957,1362630501,4544
1360941252,1362633872,2,158,79,1360941238898,1360941245682,1362620770,1362627554,6784
1360941260,1362641924,2,158,79,1360941245758,1360941253950,1362627682,1362635874,8192
1360941260,1362641924,2,158,79,1360941246397,1360941255229,1362628321,1362637153,8832
1360941264,1362645656,1,215,215,1360941237835,1360941237835,1362619491,1362619491,0
1360941276,1362657920,2,158,79,1360941257667,1360941275843,1362639587,1362657763,18176
1360941276,1362657976,2,104,52,1360941255180,1360941270412,1362637156,1362652388,15232
1360941284,1362665700,1,79,79,1360941259295,1360941259295,1362640995,1362640995,0
1360941296,1362677644,1,79,79,1360941270678,1360941270678,1362652322,1362652322,0
1360941300,1362681628,1,79,79,1360941273128,1360941273128,1362654756,1362654756,0
1360941304,1362685636,1,215,215,1360941279264,1360941279264,1362660900,1362660900,0
1360941312,1362693620,1,79,79,1360941286320,1360941286320,1362667940,1362667940,0
1360941328,1362709696,1,52,52,1360941301218,1360941301218,1362682914,1362682914,0
1360941328,1362709728,1,79,79,1360941303491,1360941303491,1362685219,1362685219,0
1360941336,1362717684,1,79,79,1360941308399,1360941308399,1362690083,1362690083,0
1360941340,1362721680,1,79,79,1360941312370,1360941312370,1362694050,1362694050,0
1360941388,1362769800,1,215,215,1360941361915,1360941361915,1362743715,1362743715,0
1360941388,1362769800,1,52,52,1360941362104,1360941362104,1362743904,1362743904,0
1360941452,1362833836,1,46,46,1360941425876,1360941425876,1362807712,1362807712,0
1360941508,1362890136,1,215,215,1360941481897,1360941481897,1362864033,1362864033,0
1360941596,1362978212,1,334,334,1360941568154,1360941568154,1362950366,1362950366,0
1360941621,1363002608,5,352,70.4,1360941617589,1360941619189,1362999197,1363000797,1600
1360941621,1363002656,5,352,70.4,1360941617477,1360941619141,1362999133,1363000797,1664
1360941645,1363026280,8,577,72.125,1360941616829,1360941630973,1362998109,1363012253,14144
1360941648,1363030224,4,300,75,1360941620365,1360941646221,1363002589,1363028445,25856
1360941649,1363030272,4,300,75,1360941621315,1360941646659,1363002587,1363027931,25344
1360941672,1363054232,1,75,75,1360941644423,1360941644423,1363026655,1363026655,0
1360941701,1363082316,1,75,75,1360941674071,1360941674071,1363055387,1363055387,0
1360941701,1363082328,1,75,75,1360941675596,1360941675596,1363056924,1363056924,0
1360941701,1363082336,1,75,75,1360941676613,1360941676613,1363057949,1363057949,0
1360941741,1363122316,14,1180,84.28571429,1360941715608,1360941734616,1363096924,1363115932,19008
1360941741,1363122368,15,3228,215.2,1360941715685,1360941722405,1363097053,1363103773,6720
1360941749,1363130708,2,131,65.5,1360941744463,1360941744463,1363126171,1363126171,0
1360941757,1363138620,4,399,99.75,1360941748905,1360941755113,1363130525,1363136733,6208
1360941770,1464584,12,9298,774.8333333,1360941769567,1360941769887,1464151,1464471,320
1360941770,1464592,5,864,172.8,1360941769045,1360941769109,1463637,1463701,64
1360941770,1464592,9,4539,504.3333333,1360941769109,1360941769557,1463701,1464149,448
1360941773,1363154636,4,356,89,1360941761751,1360941769111,1363143387,1363150747,7360
1360941773,1363154676,4,707,176.75,1360941761262,1360941769070,1363142938,1363150746,7808
1360941781,1363162684,24,20337,847.375,1360941760808,1360941775144,1363142492,1363156828,14336
1360941794,1488600,10,7029,702.9,1360941791694,1360941791950,1486294,1486550,256
1360941794,1488600,12,7876,656.3333333,1360941792399,1360941793167,1486999,1487767,768
1360941794,1488608,8,1423,177.875,1360941791301,1360941791621,1485909,1486229,320
1360941794,1488612,15,12326,821.7333333,1360941792385,1360941793089,1486997,1487701,704
1360941794,1488612,9,1487,165.2222222,1360941788801,1360941791297,1483413,1485909,2496
1360941802,1496596,8,1604,200.5,1360941794067,1360941794963,1488663,1489559,896
1360941802,1496596,8,1604,200.5,1360941794067,1360941794963,1488663,1489559,896
1360941802,1496596,9,2226,247.3333333,1360941795410,1360941795794,1490006,1490390,384
1360941802,1496596,8,1550,193.75,1360941795922,1360941797394,1490518,1491990,1472
1360941802,1496596,10,2629,262.9,1360941795921,1360941797073,1490517,1491669,1152
1360941802,1496596,9,1472,163.5555556,1360941795921,1360941796945,1490517,1491541,1024
1360941802,1496600,8,1382,172.75,1360941797070,1360941798478,1491670,1493078,1408
1360941802,1496600,8,1521,190.125,1360941796942,1360941798478,1491542,1493078,1536
1360941802,1496600,8,1649,206.125,1360941797134,1360941798222,1491734,1492822,1088
1360941802,1496600,10,2318,231.8,1360941797390,1360941798222,1491990,1492822,832
1360941802,1496604,8,1415,176.875,1360941798219,1360941798667,1492823,1493271,448
1360941802,1496604,8,1604,200.5,1360941794057,1360941794889,1488661,1489493,832
1360941802,1496604,8,1604,200.5,1360941794057,1360941795017,1488661,1489621,960
1360941802,1496604,9,2355,261.6666667,1360941795912,1360941797000,1490516,1491604,1088
1360941802,1496620,8,1190,148.75,1360941798713,1360941799353,1493333,1493973,640
1360941813,1363194740,32,35437,1107.40625,1360941798447,1360941805807,1363180187,1363187547,7360
1360941826,1520596,12,7876,656.3333333,1360941819283,1360941819923,1513879,1514519,640
1360941826,1520596,9,1293,143.6666667,1360941823698,1360941824530,1518294,1519126,832
1360941826,1520596,8,1520,190,1360941823698,1360941824530,1518294,1519126,832
1360941826,1520596,8,1484,185.5,1360941819794,1360941820370,1514390,1514966,576
1360941826,1520596,8,1512,189,1360941824528,1360941824720,1519124,1519316,192
1360941826,1520596,9,2226,247.3333333,1360941820560,1360941821008,1515156,1515604,448
1360941826,1520596,9,1487,165.2222222,1360941824720,1360941825616,1519316,1520212,896
1360941826,1520596,8,1399,174.875,1360941824787,1360941825683,1519383,1520279,896
1360941826,1520600,14,9038,645.5714286,1360941824847,1360941825743,1519447,1520343,896
1360941826,1520600,17,14787,869.8235294,1360941821070,1360941821582,1515670,1516182,512
1360941826,1520600,10,6959,695.9,1360941817869,1360941818125,1512469,1512725,256
1360941826,1520600,8,1189,148.625,1360941822477,1360941822861,1517077,1517461,384
1360941826,1520600,9,1520,168.8888889,1360941819276,1360941819788,1513876,1514388,512
1360941826,1520604,9,1572,174.6666667,1360941823691,1360941824523,1518295,1519127,832
1360941826,1520604,8,1512,189,1360941823691,1360941824523,1518295,1519127,832
1360941826,1520604,8,1488,186,1360941820617,1360941821065,1515221,1515669,448
1360941826,1520604,9,1425,158.3333333,1360941824776,1360941825608,1519380,1520212,832
1360941826,1520608,9,1339,148.7777778,1360941822981,1360941823365,1517589,1517973,384
1360941834,1528596,9,1284,142.6666667,1360941826064,1360941826576,1520660,1521172,512
1360941834,1528604,9,1722,191.3333333,1360941825865,1360941826313,1520469,1520917,448
1360941858,1552592,9,1284,142.6666667,1360941856660,1360941856916,1551252,1551508,256
1360941866,1560592,10,7023,702.3,1360941863958,1360941864662,1558550,1559254,704
1360941866,1560592,11,7824,711.2727273,1360941864980,1360941865556,1559572,1560148,576
1360941866,1560596,9,1550,172.2222222,1360941865491,1360941865939,1560087,1560535,448
1360941866,1560600,8,1591,198.875,1360941864973,1360941865485,1559573,1560085,512
1360941866,1560604,9,1365,151.6666667,1360941862731,1360941863883,1557335,1558487,1152
1360941874,1568592,8,1100,137.5,1360941872023,1360941872343,1566615,1566935,320
1360941874,1568592,8,1345,168.125,1360941867670,1360941868118,1562262,1562710,448
1360941874,1568592,9,1290,143.3333333,1360941867861,1360941868245,1562453,1562837,384
1360941874,1568596,8,1189,148.625,1360941867409,1360941867793,1562005,1562389,384
1360941874,1568596,13,10787,829.7692308,1360941866193,1360941866769,1560789,1561365,576
1360941874,1568596,9,2226,247.3333333,1360941866384,1360941866704,1560980,1561300,320
1360941882,1576712,13,9125,701.9230769,1360941875678,1360941876062,1570390,1570774,384
1360941882,1576716,8,814,101.75,1360941875164,1360941875356,1569880,1570072,192
1360941882,1576720,8,1694,211.75,1360941875415,1360941875607,1570135,1570327,192
1360941885,1363266448,1,46,46,1360941860112,1360941860112,1363241560,1363241560,0
1360941885,1363266724,6,903,150.5,1360941879100,1360941880636,1363260824,1363262360,1536
1360941885,1363266768,4,319,79.75,1360941882067,1360941882131,1363263835,1363263899,64
1360941885,1363266796,8,1142,142.75,1360941879798,1360941881910,1363261594,1363263706,2112
1360941894,1363275776,1,46,46,1360941866506,1360941866506,1363248282,1363248282,0
1360941896,1363278028,4,356,89,1360941879887,1360941887631,1363261915,1363269659,7744
1360941896,1363278032,24,29581,1232.541667,1360941880457,1360941887625,1363262489,1363269657,7168
1360941897,1363279004,22,8587,390.3181818,1360941871716,1360941874340,1363253720,1363256344,2624
1360941899,1593820,17,17509,1029.941176,1360941872114,1360941872434,1566934,1567254,320
1360941917,1363298492,9,3463,384.7777778,1360941892199,1360941892583,1363273691,1363274075,384
1360941930,1624784,29545,42123611,1425.744153,1360941872855,1360941923351,1567639,1618135,50496
1360942014,1363395540,2,131,65.5,1360942012404,1360942012404,1363393944,1363393944,0
1360942050,1363432140,1,46,46,1360942024602,1360942024602,1363406742,1363406742,0
1360942062,1363443624,2,192,96,1360942054238,1360942054238,1363435862,1363435862,0
1360942197,1363578972,1,46,46,1360942169601,1360942169601,1363551573,1363551573,0
1360942230,1363611728,4,184,46,1360942222901,1360942222901,1363604629,1363604629,0
1360942249,1363631080,9,3463,384.7777778,1360942222548,1360942222868,1363604628,1363604948,320
1360942350,1363732052,6,447,74.5,1360942342832,1360942346800,1363724884,1363728852,3968
1360942366,1363748004,2,158,79,1360942351070,1360942359454,1363733074,1363741458,8384
1360942401,1363783228,1,79,79,1360942376127,1360942376127,1363758355,1363758355,0
1360942437,1363819212,1,79,79,1360942409934,1360942409934,1363792146,1363792146,0
1360952009,1373390348,7,632,90.28571429,1360952001948,1360952005596,1373383296,1373386944,3648
1360952041,1373422336,7,539,77,1360952016165,1360952031205,1373397501,1373412541,15040
1360952061,1373442268,1,46,46,1360952032809,1360952032809,1373414077,1373414077,0
1360952081,11776076,5,276,55.2,1360952054964,1360952067572,11750040,11762648,12608
1360952081,11776084,5,276,55.2,1360952056109,1360952068717,11751193,11763801,12608
1360952109,1373490340,1,46,46,1360952084767,1360952084767,1373466107,1373466107,0
1360952109,1373490340,1,46,46,1360952084767,1360952084767,1373466107,1373466107,0
1360952113,1373494344,1,46,46,1360952088798,1360952088798,1373470142,1373470142,0
1360952125,1373506512,1,46,46,1360952100534,1360952100534,1373482046,1373482046,0
1360952157,1373538452,1,46,46,1360952131950,1360952131950,1373513402,1373513402,0
1360952161,1373542456,2,104,52,1360952135597,1360952138605,1373517053,1373520061,3008
1360952161,1373542488,2,104,52,1360952136716,1360952139660,1373518204,1373521148,2944
1360952161,1373542552,1,46,46,1360952133644,1360952133644,1373515196,1373515196,0
1360952165,1373546416,2,104,52,1360952137876,1360952140884,1373519292,1373522300,3008
1360952165,1373546416,2,104,52,1360952137875,1360952140883,1373519291,1373522299,3008
1360952217,1373598468,2,128,64,1360952188958,1360952189982,1373570426,1373571450,1024
1360952249,1373630652,1,46,46,1360952221605,1360952221605,1373603257,1373603257,0
1360952249,1373630780,2,92,46,1360952224037,1360952227557,1373605817,1373609337,3520
1360952257,1373638960,1,46,46,1360952231219,1360952231219,1373613179,1373613179,0
1360952293,1373674792,2,104,52,1360952264923,1360952267931,1373646715,1373649723,3008
1360952293,1373674804,2,104,52,1360952266060,1360952269004,1373647864,1373650808,2944
1360952293,1373674836,2,104,52,1360952267117,1360952270125,1373648953,1373651961,3008
1360952293,1373674920,2,104,52,1360952267033,1360952269977,1373648953,1373651897,2944
1360952309,1373690808,1,46,46,1360952281738,1360952281738,1373663546,1373663546,0
1360952317,1373698860,6,384,64,1360952292437,1360952297429,1373674297,1373679289,4992
1360952321,1373702828,5,320,64,1360952294710,1360952298678,1373676538,1373680506,3968
1360952321,1373702848,5,320,64,1360952294690,1360952298658,1373676538,1373680506,3968
1360952321,1373702900,6,384,64,1360952293487,1360952298479,1373675387,1373680379,4992
1360952369,1373751044,1,64,64,1360952344668,1360952344668,1373726712,1373726712,0
1360952369,1373751192,2,128,64,1360952344519,1360952344519,1373726711,1373726711,0
1360952414,1373795272,2,104,52,1360952388257,1360952391265,1373769529,1373772537,3008
1360952414,1373795312,2,104,52,1360952385976,1360952388984,1373767288,1373770296,3008
1360952414,1373795344,2,104,52,1360952387032,1360952390040,1373768376,1373771384,3008
1360952414,1373795356,2,104,52,1360952388173,1360952391181,1373769529,1373772537,3008
1360952418,1373799484,1,46,46,1360952392778,1360952392778,1373774262,1373774262,0
1360952466,1373847332,1,48,48,1360952437860,1360952437860,1373819192,1373819192,0
1360952478,1373859380,4,184,46,1360952451506,1360952466610,1373832886,1373847990,15104
1360952574,1373955748,4,256,64,1360952548289,1360952551425,1373930037,1373933173,3136
1360952574,1373955864,2,128,64,1360952549324,1360952550348,1373931188,1373932212,1024
1360952578,1373959708,1,64,64,1360952550633,1360952550633,1373932341,1373932341,0
1360952578,1373959712,1,64,64,1360952550630,1360952550630,1373932342,1373932342,0
1360952586,1373967748,2,100,50,1360952559810,1360952565826,1373941558,1373947574,6016
1360952586,1373967840,3,152,50.66666667,1360952557796,1360952566820,1373939636,1373948660,9024
1360952650,1374032020,1,46,46,1360952624624,1360952624624,1374006644,1374006644,0
1360952698,1374079896,1,46,46,1360952671593,1360952671593,1374053489,1374053489,0
1360952718,1374099912,1,46,46,1360952690394,1360952690394,1374072306,1374072306,0
1360952779,1374160556,1,46,46,1360952751614,1360952751614,1374133170,1374133170,0
1360952799,1374180440,1,46,46,1360952774512,1360952774512,1374155952,1374155952,0
1360952951,1374332872,1,46,46,1360952923073,1360952923073,1374304945,1374304945,0
1360952991,1374372836,6,384,64,1360952963172,1360952968100,1374345008,1374349936,4928
1360952991,1374372880,5,320,64,1360952965368,1360952969272,1374347248,1374351152,3904
1360952991,1374372880,5,320,64,1360952965368,1360952969272,1374347248,1374351152,3904
1360952991,1374372956,6,384,64,1360952964137,1360952969065,1374346093,1374351021,4928
1360953015,1374396912,1,46,46,1360952988375,1360952988375,1374370287,1374370287,0
1360953208,1374589680,2,96,48,1360953183354,1360953186298,1374565034,1374567978,2944
1360953212,1374593720,2,96,48,1360953184402,1360953187346,1374566122,1374569066,2944
1360953216,1374597672,2,120,60,1360953191427,1360953194179,1374573099,1374575851,2752
1360953220,1374601632,2,120,60,1360953193386,1360953196394,1374575018,1374578026,3008
1360953220,1374601672,2,120,60,1360953192261,1360953195269,1374573933,1374576941,3008
1360953260,1374641660,1,46,46,1360953233485,1360953233485,1374615145,1374615145,0
1360953272,1374653708,1,46,46,1360953244638,1360953244638,1374626346,1374626346,0
1360953284,1374665620,1,46,46,1360953256565,1360953256565,1374638185,1374638185,0
1360953292,1374673664,2,120,60,1360953267592,1360953270600,1374649256,1374652264,3008
1360953296,1374677664,2,120,60,1360953269835,1360953272843,1374651499,1374654507,3008
1360953296,1374677676,2,104,52,1360953271101,1360953274109,1374652777,1374655785,3008
1360953296,1374677720,2,120,60,1360953268625,1360953271633,1374650345,1374653353,3008
1360953296,1374677748,2,120,60,1360953269748,1360953272756,1374651496,1374654504,3008
1360953296,1374677752,2,104,52,1360953269939,1360953272947,1374651691,1374654699,3008
1360953300,1374681628,2,104,52,1360953272300,1360953275308,1374653928,1374656936,3008
1360953300,1374681708,2,104,52,1360953272222,1360953275230,1374653930,1374656938,3008
1360953340,1374721720,2,104,52,1360953314704,1360953317712,1374696424,1374699432,3008
1360953340,1374721776,2,104,52,1360953313560,1360953316568,1374695336,1374698344,3008
1360953344,1374725660,2,104,52,1360953315919,1360953318991,1374697579,1374700651,3072
1360953344,1374725708,6,384,64,1360953318556,1360953323868,1374700264,1374705576,5312
1360953344,1374725716,6,384,64,1360953319572,1360953325012,1374701288,1374706728,5440
1360953344,1374725740,2,104,52,1360953315837,1360953318845,1374697577,1374700585,3008
1360953348,1374730108,4,256,64,1360953320396,1360953323532,1374702504,1374705640,3136
1360953348,1374730112,5,320,64,1360953320395,1360953324619,1374702507,1374706731,4224
1360953352,1374733800,1,64,64,1360953324929,1360953324929,1374706729,1374706729,0
1360953548,1374930020,1,52,52,1360953522211,1360953522211,1374904231,1374904231,0
1360953600,1374981984,6,384,64,1360953573061,1360953578309,1374955045,1374960293,5248
1360953600,1374982048,6,384,64,1360953571845,1360953577733,1374953893,1374959781,5888
1360953600,1374982100,5,320,64,1360953574032,1360953578256,1374956132,1374960356,4224
1360953600,1374982104,5,320,64,1360953574030,1360953578190,1374956134,1374960294,4160
1360953717,1375098528,2,104,52,1360953692557,1360953695565,1375074085,1375077093,3008
1360953721,1375102412,2,104,52,1360953693761,1360953696769,1375075173,1375078181,3008
1360953721,1375102444,2,104,52,1360953694881,1360953697889,1375076325,1375079333,3008
1360953721,1375102444,2,104,52,1360953694881,1360953697889,1375076325,1375079333,3008
1360953721,1375102484,6,384,64,1360953696631,1360953703799,1375078115,1375085283,7168
1360953725,1375106476,5,320,64,1360953698814,1360953703806,1375080290,1375085282,4992
1360953725,1375106520,6,384,64,1360953697684,1360953703764,1375079204,1375085284,6080
1360953725,1375106552,1,64,64,1360953698803,1360953698803,1375080355,1375080355,0
1360953765,1375146524,1,64,64,1360953739407,1360953739407,1375120931,1375120931,0
1360953765,1375146644,2,128,64,1360953737687,1360953738775,1375119331,1375120419,1088
1360953857,1375238880,1,46,46,1360953830953,1360953830953,1375212833,1375212833,0
1360953893,1375274996,3,144,48,1360953867700,1360953876724,1375249696,1375258720,9024
1360953893,1375275032,3,144,48,1360953866576,1360953875536,1375248608,1375257568,8960
1360953897,1375278892,3,144,48,1360953868956,1360953877916,1375250848,1375259808,8960
1360953897,1375278892,3,144,48,1360953868956,1360953877916,1375250848,1375259808,8960
1360953933,1375315012,1,60,60,1360953908261,1360953908261,1375290273,1375290273,0
1360954150,1375531504,1,46,46,1360954124382,1360954124382,1375505886,1375505886,0
1360954190,1375571776,1,46,46,1360954162443,1360954162443,1375544219,1375544219,0
1360954343,1375724348,1,46,46,1360954315637,1360954315637,1375696985,1375696985,0
1360954579,1375960940,3,176,58.66666667,1360954551842,1360954560802,1375933782,1375942742,8960
1360954687,1376069208,2,104,52,1360954658965,1360954661909,1376041173,1376044117,2944
1360954688,1376069264,2,104,52,1360954662147,1360954665091,1376043411,1376046355,2944
1360954688,1376069344,2,104,52,1360954660917,1360954663925,1376042261,1376045269,3008
1360954688,1376069356,2,104,52,1360954661993,1360954665001,1376043349,1376046357,3008
1360954917,1376298332,3,152,50.66666667,1360954892671,1360954901375,1376274003,1376282707,8704
1360954921,1376302308,2,100,50,1360954893975,1360954902615,1376275283,1376283923,8640
1360954981,1376362516,2,120,60,1360954955589,1360954956613,1376337105,1376338129,1024
1360955005,1376386908,1,46,46,1360954980285,1360954980285,1376362193,1376362193,0
1360955357,1376739160,2,120,60,1360955331644,1360955333756,1376713804,1376715916,2112
1360955358,1376739272,2,120,60,1360955333235,1360955337395,1376714507,1376718667,4160
1360955613,1376994932,5,895,179,1360955610457,1360955611353,1376992389,1376993285,896
1360955613,1376994964,13,3571,274.6923077,1360955608185,1360955608697,1376990149,1376990661,512
1360955613,1376994964,13,3571,274.6923077,1360955608185,1360955608825,1376990149,1376990789,640
1360955613,1376995008,18,4404,244.6666667,1360955608142,1360955608782,1376990150,1376990790,640
1360955614,1376996040,15,3228,215.2,1360955587501,1360955593517,1376969541,1376975557,6016
1360955621,1377002984,4,351,87.75,1360955614052,1360955614180,1376996036,1376996164,128
1360955621,1377003004,5,416,83.2,1360955613330,1360955620626,1376995334,1377002630,7296
1360955621,1377003016,25,30132,1205.28,1360955611399,1360955613895,1376993415,1376995911,2496
1360955622,1377004064,26,30721,1181.576923,1360955597334,1360955597974,1376979398,1376980038,640
1360955629,1377010948,4,356,89,1360955620936,1360955628744,1377002884,1377010692,7808
1360955629,1377011008,5,2461,492.2,1360955628495,1360955628623,1377010503,1377010631,128
1360955630,1377011920,8,5019,627.375,1360955628517,1360955628709,1377010437,1377010629,192
1360955634,1377016136,11,6315,574.0909091,1360955609165,1360955614029,1376991301,1376996165,4864
1360955637,1377018956,5,566,113.2,1360955628993,1360955629377,1377010949,1377011333,384
1360955637,1377018956,32,32132,1004.125,1360955613953,1360955634945,1376995909,1377016901,20992
1360955637,1377019008,5,2671,534.2,1360955628301,1360955634893,1377010309,1377016901,6592
1360955637,1377019012,4,562,140.5,1360955628873,1360955629001,1377010885,1377011013,128
1360955637,1377019076,58,70991,1223.982759,1360955627339,1360955634827,1377009415,1377016903,7488
1360955637,1377019084,3,626,208.6666667,1360955628227,1360955634883,1377010311,1377016967,6656
1360955638,15333220,10,8805,880.5,1360955628411,1360955636731,15323631,15331951,8320
1360955639,15333240,4,525,131.25,1360955629137,1360955635665,15323377,15329905,6528
1360955639,15333240,9,8421,935.6666667,1360955629136,1360955635664,15323376,15329904,6528
1360955642,1377024176,6,3295,549.1666667,1360955615720,1360955616936,1376997896,1376999112,1216
1360955645,1377027004,20,20078,1003.9,1360955628113,1360955636945,1377010117,1377018949,8832
1360955646,1377028036,4,528,132,1360955618480,1360955618544,1377000516,1377000580,64
1360955706,1377088128,3,144,48,1360955681493,1360955683093,1377063621,1377065221,1600
1360955706,1377088164,3,144,48,1360955678387,1360955679667,1377060551,1377061831,1280
1360955706,1377088196,3,144,48,1360955679825,1360955681169,1377062021,1377063365,1344
1360955725,1377107116,4,614,153.5,1360955724384,1360955724576,1377106500,1377106692,192
1360955726,1377107280,12,11778,981.5,1360955720550,1360955722022,1377101830,1377103302,1472
1360955726,1377107284,4,414,103.5,1360955713313,1360955719521,1377094597,1377100805,6208
1360955726,1377107284,5,683,136.6,1360955725023,1360955725343,1377106307,1377106627,320
1360955726,1377107288,3,651,217,1360955725086,1360955725214,1377106374,1377106502,128
1360955727,15421308,14,15565,1111.785714,1360955726347,1360955726411,15420655,15420719,64
1360955733,1377115080,56,58748,1049.071429,1360955727043,1360955727363,1377109123,1377109443,320
1360955733,1377115084,9,8058,895.3333333,1360955727297,1360955727361,1377109381,1377109445,64
1360955733,1377115084,4,612,153,1360955727361,1360955727489,1377109445,1377109573,128
1360955733,1377115084,9,6890,765.5555556,1360955727361,1360955727489,1377109445,1377109573,128
1360955733,1377115084,26,31944,1228.615385,1360955727360,1360955727552,1377109444,1377109636,192
1360955733,1377115084,4,1190,297.5,1360955727552,1360955727616,1377109636,1377109700,64
1360955733,1377115112,4,924,231,1360955727974,1360955728038,1377110086,1377110150,64
1360955733,1377115112,5,1676,335.2,1360955727974,1360955728038,1377110086,1377110150,64
1360955733,1377115116,3,421,140.3333333,1360955732002,1360955732066,1377114118,1377114182,64
1360955733,1377115116,11,10091,917.3636364,1360955724193,1360955730657,1377106309,1377112773,6464
1360955733,1377115116,4,401,100.25,1360955724192,1360955730720,1377106308,1377112836,6528
1360955733,1377115120,15,16701,1113.4,1360955724382,1360955730654,1377106502,1377112774,6272
1360955733,1377115120,7,3270,467.1428571,1360955729244,1360955729884,1377111364,1377112004,640
1360955733,1377115120,3,1320,440,1360955729307,1360955729435,1377111427,1377111555,128
1360955733,1377115124,4,693,173.25,1360955721241,1360955728601,1377103365,1377110725,7360
1360955733,1377115124,160,219261,1370.38125,1360955721305,1360955724889,1377103429,1377107013,3584
1360955733,1377115128,31,38734,1249.483871,1360955730198,1360955730326,1377112326,1377112454,128
1360955733,1377115128,8,6410,801.25,1360955725077,1360955725269,1377107205,1377107397,192
1360955733,1377115128,20,22568,1128.4,1360955725077,1360955725333,1377107205,1377107461,256
1360955733,1377115128,7,3412,487.4285714,1360955726740,1360955727252,1377108868,1377109380,512
1360955733,1377115128,44,56410,1282.045455,1360955725140,1360955726164,1377107268,1377108292,1024
1360955733,1377115152,5,672,134.4,1360955726843,1360955727227,1377108995,1377109379,384
1360955733,1377115152,6,2960,493.3333333,1360955726910,1360955727038,1377109062,1377109190,128
1360955733,1377115152,6,3084,514,1360955727036,1360955727164,1377109188,1377109316,128
1360955733,1377115156,13,12487,960.5384615,1360955727226,1360955727354,1377109382,1377109510,128
1360955733,1377115156,19,23290,1225.789474,1360955727353,1360955727609,1377109509,1377109765,256
1360955733,1377115168,16,16579,1036.1875,1360955724012,1360955724972,1377106180,1377107140,960
1360955733,1377115192,6,2281,380.1666667,1360955728916,1360955730388,1377111108,1377112580,1472
1360955733,1377115192,84,104178,1240.214286,1360955724499,1360955725267,1377106691,1377107459,768
1360955733,1377115192,57,75656,1327.298246,1360955724499,1360955724883,1377106691,1377107075,384
1360955733,1377115196,4,691,172.75,1360955721168,1360955728528,1377103364,1377110724,7360
1360955733,1377115196,4,591,147.75,1360955729807,1360955729871,1377112003,1377112067,64
1360955733,1377115200,13,12241,941.6153846,1360955729870,1360955730062,1377112070,1377112262,192
1360955733,1377115200,4,2902,725.5,1360955729870,1360955729998,1377112070,1377112198,128
1360955733,1377115200,191,264257,1383.544503,1360955721166,1360955725390,1377103366,1377107590,4224
1360955733,1377115200,27,30996,1148,1360955721166,1360955730766,1377103366,1377112966,9600
1360955735,15429300,36,42080,1168.888889,1360955727060,1360955727828,15421360,15422128,768
1360955735,15429300,6,3901,650.1666667,1360955728022,1360955728150,15422322,15422450,128
1360955735,15429304,34,43892,1290.941176,1360955729618,1360955729938,15423922,15424242,320
1360955735,15429308,5,1692,338.4,1360955730763,1360955730827,15425071,15425135,64
1360955735,15429312,7,2398,342.5714286,1360955727049,1360955727689,15421361,15422001,640
1360955735,15429312,8,6182,772.75,1360955728266,1360955728394,15422578,15422706,128
1360955735,15429328,14,14566,1040.428571,1360955729081,1360955729337,15423409,15423665,256
1360955735,15429328,42,54107,1288.261905,1360955729528,1360955730040,15423856,15424368,512
1360955735,15429328,8,6040,755,1360955730039,1360955730103,15424367,15424431,64
1360955741,1377123088,26,32661,1256.192308,1360955733181,1360955733309,1377115269,1377115397,128
1360955741,1377123092,34,44250,1301.470588,1360955733366,1360955733878,1377115458,1377115970,512
1360955741,1377123092,14,4698,335.5714286,1360955730617,1360955739001,1377112709,1377121093,8384
1360955741,1377123100,2,131,65.5,1360955734001,1360955734001,1377116101,1377116101,0
1360955741,1377123100,5,1306,261.2,1360955735537,1360955735729,1377117637,1377117829,192
1360955741,1377123100,4,725,181.25,1360955735664,1360955735728,1377117764,1377117828,64
1360955741,1377123124,4,725,181.25,1360955734041,1360955734169,1377116165,1377116293,128
1360955741,1377123124,5,1762,352.4,1360955735704,1360955735832,1377117828,1377117956,128
1360955741,1377123124,43,50065,1164.302326,1360955731991,1360955733015,1377114115,1377115139,1024
1360955741,1377123128,140,190888,1363.485714,1360955732244,1360955733140,1377114372,1377115268,896
1360955741,1377123128,225,310595,1380.422222,1360955732307,1360955733011,1377114435,1377115139,704
1360955741,1377123136,10,3484,348.4,1360955737485,1360955737869,1377119621,1377120005,384
1360955741,1377123140,3,1240,413.3333333,1360955733001,1360955733129,1377115141,1377115269,128
1360955741,1377123144,4,632,158,1360955730371,1360955736835,1377112515,1377118979,6464
1360955741,1377123160,12,5519,459.9166667,1360955730484,1360955738996,1377112644,1377121156,8512
1360955741,1377123160,6,2281,380.1666667,1360955730547,1360955733171,1377112707,1377115331,2624
1360955741,1377123164,29,15991,551.4137931,1360955725489,1360955734705,1377107653,1377116869,9216
1360955741,1377123172,8,4849,606.125,1360955719526,1360955734694,1377101698,1377116866,15168
1360955743,15437296,13,9763,751,1360955737240,1360955737496,15431536,15431792,256
1360955743,15437296,5,3005,601,1360955737240,1360955737496,15431536,15431792,256
1360955743,15437296,59,69938,1185.389831,1360955729623,1360955737431,15423919,15431727,7808
1360955743,15437304,5,764,152.8,1360955732814,1360955741902,15427118,15436206,9088
1360955749,1377131116,4,428,107,1360955742241,1360955742369,1377124357,1377124485,128
1360955749,1377131116,5,366,73.2,1360955742241,1360955742369,1377124357,1377124485,128
1360955749,1377131124,4,578,144.5,1360955742745,1360955742809,1377124869,1377124933,64
1360955749,1377131156,16,5169,323.0625,1360955735481,1360955747001,1377117637,1377129157,11520
1360955749,1377131160,6,694,115.6666667,1360955743925,1360955744309,1377126085,1377126469,384
1360955749,1377131164,271,374959,1383.612546,1360955732334,1360955740974,1377114498,1377123138,8640
1360955749,1377131172,4,578,144.5,1360955745897,1360955745961,1377128069,1377128133,64
1360955749,1377131172,5,1299,259.8,1360955746024,1360955747176,1377128196,1377129348,1152
1360955749,1377131208,4,718,179.5,1360955741509,1360955741637,1377123717,1377123845,128
1360955750,1377131252,4,578,144.5,1360955746818,1360955746882,1377128070,1377128134,64
1360955750,1377131252,5,2217,443.4,1360955746945,1360955748289,1377128197,1377129541,1344
1360955751,15445324,19,19793,1041.736842,1360955737214,1360955749886,15431538,15444210,12672
1360955757,1377139100,5,366,73.2,1360955748975,1360955749103,1377131075,1377131203,128
1360955757,1377139116,23,9198,399.9130435,1360955739169,1360955755105,1377121285,1377137221,15936
1360955757,1377139152,19,7753,408.0526316,1360955737531,1360955753083,1377119683,1377135235,15552
1360955757,1377139156,4,428,107,1360955748921,1360955749049,1377131077,1377131205,128
1360955757,1377139160,5,643,128.6,1360955742518,1360955748982,1377124678,1377131142,6464
1360955757,1377139184,9,4797,533,1360955741470,1360955749086,1377123654,1377131270,7616
1360955757,1377139188,91,124843,1371.901099,1360955741786,1360955748954,1377123974,1377131142,7168
1360955757,1377139188,45,22555,501.2222222,1360955735448,1360955753048,1377117636,1377135236,17600
1360955759,15453308,6,2507,417.8333333,1360955746699,1360955755915,15441007,15450223,9216
1360955765,1377147144,10,8361,836.1,1360955756164,1360955763076,1377138308,1377145220,6912
1360955765,1377147156,4,972,243,1360955754745,1360955761081,1377136901,1377143237,6336
1360955767,15461304,4,1069,267.25,1360955757519,1360955763919,15451823,15458223,6400
1360955767,15461328,4,1207,301.75,1360955757495,1360955763895,15451823,15458223,6400
1360955767,1377148412,12,11860,988.3333333,1360955740639,1360955760863,1377122051,1377142275,20224
1360955773,1377155128,35,44823,1280.657143,1360955757141,1360955765141,1377139269,1377147269,8000
1360955789,1377171164,4,414,103.5,1360955777646,1360955783982,1377159810,1377166146,6336
1360955789,1377171208,4,414,103.5,1360955775813,1360955781893,1377158021,1377164101,6080
1360955795,1377176480,12,12969,1080.75,1360955770588,1360955790812,1377152068,1377172292,20224
1360955799,1377180508,21,7353,350.1428571,1360955774336,1360955777408,1377155844,1377158916,3072
1360955827,1377208540,12,12969,1080.75,1360955800545,1360955820705,1377182085,1377202245,20160
1360955838,1377219512,3,161,53.66666667,1360955830586,1360955830650,1377212098,1377212162,64
1360955839,1377220440,41,27224,664,1360955811138,1360955827458,1377192578,1377208898,16320
1360955846,1377227416,2,104,52,1360955838555,1360955838811,1377219971,1377220227,256
1360955851,1377232548,15,6546,436.4,1360955823319,1360955825623,1377204867,1377207171,2304
1360955855,1377236524,11,10464,951.2727273,1360955830704,1360955851312,1377212228,1377232836,20608
1360955862,1377243472,3,156,52,1360955859169,1360955859937,1377240641,1377241409,768
1360955883,1377264868,1,52,52,1360955857238,1360955857238,1377239106,1377239106,0
1360955887,1377268988,13,14380,1106.153846,1360955860320,1360955880480,1377242308,1377262468,20160
1360955915,1377296952,12,12969,1080.75,1360955890307,1360955910403,1377272259,1377292355,20096
1360955926,1377307532,3,161,53.66666667,1360955920743,1360955920935,1377302275,1377302467,192
1360955947,1377329008,10,9038,903.8,1360955922441,1360955942857,1377304449,1377324865,20416
1360955958,1377339560,4,184,46,1360955956043,1360955956043,1377337603,1377337603,0
1360955979,1377361172,12,12969,1080.75,1360955952484,1360955972644,1377334656,1377354816,20160
1360955982,1377363612,2,192,96,1360955979159,1360955979159,1377360771,1377360771,0
1360955983,1377365000,9,3463,384.7777778,1360955955601,1360955955985,1377337601,1377337985,384
1360955998,1377379624,2,192,96,1360955994697,1360955994697,1377376321,1377376321,0
1360956006,1377387528,13,13021,1001.615385,1360955983144,1360956004072,1377364672,1377385600,20928
1360956014,1377395600,4,414,103.5,1360956004322,1360956010466,1377385922,1377392066,6144
1360956014,1377395628,5,643,128.6,1360956002242,1360956008450,1377383870,1377390078,6208
1360956027,1377409084,1,48,48,1360955998973,1360955998973,1377381057,1377381057,0
1360956030,1377411528,4,562,140.5,1360956024938,1360956025066,1377406466,1377406594,128
1360956030,1377411528,4,514,128.5,1360956025128,1360956025448,1377406656,1377406976,320
1360956030,1377411552,4,772,193,1360956023247,1360956029391,1377404799,1377410943,6144
1360956030,1377411608,12,7239,603.25,1360956026006,1360956026198,1377407614,1377407806,192
1360956030,1377411608,5,1373,274.6,1360956025881,1360956026009,1377407489,1377407617,128
1360956038,1377419532,8,5932,741.5,1360956023459,1360956031395,1377404991,1377412927,7936
1360956038,1377419544,9,7523,835.8888889,1360956024601,1360956031449,1377406145,1377412993,6848
1360956039,15733292,10,9847,984.7,1360956024925,1360956031645,15719217,15725937,6720
1360956039,15733312,4,525,131.25,1360956024907,1360956031627,15719219,15725939,6720
1360956054,1377435572,16,15212,950.75,1360956051964,1360956052924,1377433536,1377434496,960
1360956054,1377435612,5,2924,584.8,1360956053523,1360956053651,1377435135,1377435263,128
1360956054,1377435656,4,1648,412,1360956052712,1360956052904,1377434368,1377434560,192
1360956062,1377443556,8,1420,177.5,1360956047373,1360956057805,1377428929,1377439361,10432
1360956062,1377443564,8,6446,805.75,1360956052100,1360956059780,1377433664,1377441344,7680
1360956062,1377443564,4,591,147.75,1360956054530,1360956055042,1377436094,1377436606,512
1360956062,1377443564,25,30267,1210.68,1360956052290,1360956059970,1377433854,1377441534,7680
1360956062,1377443568,13,13906,1069.692308,1360956056640,1360956056896,1377438208,1377438464,256
1360956062,1377443568,19,22049,1160.473684,1360956054718,1360956055486,1377436286,1377437054,768
1360956062,1377443604,81,91168,1125.530864,1360956050906,1360956059930,1377432510,1377441534,9024
1360956062,1377443604,49,60200,1228.571429,1360956050906,1360956059930,1377432510,1377441534,9024
1360956062,1377443608,7,1768,252.5714286,1360956053847,1360956055191,1377435455,1377436799,1344
1360956062,1377443676,32,34712,1084.75,1360956053074,1360956054738,1377434750,1377436414,1664
1360956062,1377443684,17,17880,1051.764706,1360956053388,1360956053964,1377435072,1377435648,576
1360956062,1377443684,56,74781,1335.375,1360956053388,1360956057420,1377435072,1377439104,4032
1360956062,1377443684,16,12589,786.8125,1360956058700,1360956059660,1377440384,1377441344,960
1360956062,1377443684,112,137063,1223.776786,1360956050828,1360956059852,1377432512,1377441536,9024
1360956062,1377443684,10,1290,129,1360956058763,1360956059275,1377440447,1377440959,512
1360956063,15757288,5,577,115.4,1360956055906,1360956056226,15750194,15750514,320
1360956063,15757292,8,6861,857.625,1360956052703,1360956060063,15746995,15754355,7360
1360956063,15757292,5,516,103.2,1360956057310,1360956057438,15751602,15751730,128
1360956063,15757312,7,5318,759.7142857,1360956054345,1360956055753,15748657,15750065,1408
1360956070,1377451644,7,4327,618.1428571,1360956067059,1360956067123,1377448703,1377448767,64
1360956070,1377451708,58,73925,1274.568966,1360956050293,1360956063861,1377432001,1377445569,13568
1360956070,1377451728,6,1084,180.6666667,1360956066846,1360956066974,1377448574,1377448702,128
1360956071,15765300,11,10406,946,1360956059095,1360956066263,15753395,15760563,7168
1360956078,1377459580,3,210,70,1360956076340,1360956076596,1377457920,1377458176,256
1360956079,15773292,4,464,116,1360956067679,1360956074271,15761971,15768563,6592
1360956102,1377484000,5,545,109,1360956100238,1360956100366,1377482238,1377482366,128
1360956110,1377491620,19,20118,1058.842105,1360956101003,1360956108107,1377482623,1377489727,7104
1360956110,1377491672,4,720,180,1360956100375,1360956106519,1377482047,1377488191,6144
1360956110,1377491696,8,472,59,1360956093374,1360956102526,1377475070,1377484222,9152
1360956116,1377497220,26,4145,159.4230769,1360956090587,1360956106587,1377471807,1377487807,16000
1360956118,1377499584,119,160984,1352.806723,1360956102574,1360956116654,1377484158,1377498238,14080
1360956118,1377499592,22,19769,898.5909091,1360956103271,1360956116647,1377484863,1377498239,13376
1360956118,1377499616,68,89863,1321.514706,1360956100943,1360956112591,1377482559,1377494207,11648
1360956118,1377499632,12,6188,515.6666667,1360956103615,1360956112575,1377485247,1377494207,8960
1360956118,1377499668,61,77958,1278,1360956100697,1360956116569,1377482365,1377498237,15872
1360956118,1377499672,12,9691,807.5833333,1360956105686,1360956112534,1377487358,1377494206,6848
1360956118,1377499672,10,7374,737.4,1360956105685,1360956116565,1377487357,1377498237,10880
1360956123,1377505152,2,128,64,1360956098485,1360956099701,1377480637,1377481853,1216
1360956127,1377509148,1,64,64,1360956099901,1360956099901,1377482049,1377482049,0
1360956128,1377509228,1,64,64,1360956100562,1360956100562,1377481790,1377481790,0
1360956128,1377509260,5,320,64,1360956100785,1360956105585,1377482045,1377486845,4800
1360956132,1377513252,1,52,52,1360956106236,1360956106236,1377487488,1377487488,0
1360956135,1377517136,1,52,52,1360956110087,1360956110087,1377492223,1377492223,0
1360956142,1377523716,5,1628,325.6,1360956131049,1360956137257,1377512765,1377518973,6208
1360956192,1377573312,2,92,46,1360956166911,1360956167999,1377548223,1377549311,1088
1360956200,1377581240,3,152,50.66666667,1360956175429,1360956177093,1377556669,1377558333,1664
1360956203,1377585200,3,152,50.66666667,1360956175556,1360956177092,1377557756,1377559292,1536
1360956204,1377585236,3,152,50.66666667,1360956177609,1360956179209,1377558845,1377560445,1600
1360956204,1377585316,3,152,50.66666667,1360956177529,1360956186553,1377558845,1377567869,9024
1361192525,1613905836,1,46,46,1361192497541,1361192497541,1613878377,1613878377,0
1361192600,1613981112,1,46,46,1361192572016,1361192572016,1613953128,1613953128,0
1361193864,1615244684,1,46,46,1361193839562,1361193839562,1615220246,1615220246,0
1361193901,1615281896,1,48,48,1361193873779,1361193873779,1615254675,1615254675,0
1361194839,1616219488,2,122,61,1361194813371,1361194815483,1616193859,1616195971,2112
1361195833,1617214264,1,46,46,1361195808038,1361195808038,1617189302,1617189302,0
1361195929,1617310296,1,76,76,1361195901765,1361195901765,1617283061,1617283061,0
1361195929,1617310300,4,1901,475.25,1361195902274,1361195902402,1617283574,1617283702,128
1361195963,1617344124,2,104,52,1361195962482,1361195962738,1617343606,1617343862,256
1361195971,1617352104,4,208,52,1361195963267,1361195969987,1617344371,1617351091,6720
1361195995,1617376080,2,104,52,1361195977819,1361195987803,1617358899,1617368883,9984
1361196011,1617392088,2,104,52,1361195997779,1361196007763,1617378867,1617388851,9984
1361196045,1617426348,1,52,52,1361196017550,1361196017550,1617398898,1617398898,0
1361196911,1618291976,1,46,46,1361196886199,1361196886199,1618267175,1618267175,0
1361199311,1620691632,37,32709,884.027027,1361199292650,1361199309802,1620673282,1620690434,17152
1361199320,1620700780,25,16808,672.32,1361199294421,1361199310805,1620675201,1620691585,16384
1361199320,1620700816,17,3574,210.2352941,1361199292594,1361199300082,1620673410,1620680898,7488
1361199320,1620700824,9,5521,613.4444444,1361199292968,1361199293608,1620673792,1620674432,640
1361199324,1620704784,14,7753,553.7857143,1361199298386,1361199314322,1620679170,1620695106,15936
1361199324,1620704944,15,5509,367.2666667,1361199299121,1361199299761,1620680065,1620680705,640
1361199327,1620707624,13,3571,274.6923077,1361199322287,1361199322799,1620702911,1620703423,512
1361199327,1620707624,18,4404,244.6666667,1361199322351,1361199322991,1620702975,1620703615,640
1361199327,1620707668,13,3571,274.6923077,1361199322243,1361199322755,1620702911,1620703423,512
1361199328,1620708748,9,4875,541.6666667,1361199300468,1361199301364,1620681216,1620682112,896
1361199335,1620715684,5,851,170.2,1361199328438,1361199329334,1620709122,1620710018,896
1361199335,1620715688,7,1096,156.5714286,1361199329073,1361199331825,1620709761,1620712513,2752
1361199335,1620715688,27,30056,1113.185185,1361199329455,1361199332079,1620710143,1620712767,2624
1361199336,1620716884,9,4881,542.3333333,1361199309611,1361199317675,1620690495,1620698559,8064
1361199343,1620723656,4,356,89,1361199331408,1361199339088,1620712064,1620719744,7680
1361199348,1620728820,10,3462,346.2,1361199322922,1361199324394,1620703742,1620705214,1472
1361199348,1620728904,8,2872,359,1361199323417,1361199324505,1620704321,1620705409,1088
1361199351,1620731652,37,44048,1190.486486,1361199336594,1361199347090,1620717246,1620727742,10496
1361199351,1620731700,6,4137,689.5,1361199336997,1361199345061,1620717697,1620725761,8064
1361199351,1620731728,4,356,89,1361199339335,1361199347015,1620720063,1620727743,7680
1361199352,1620732796,4,740,185,1361199324739,1361199326531,1620705535,1620707327,1792
1361199352,1620732832,14,6596,471.1428571,1361199326560,1361199334688,1620707392,1620715520,8128
1361199352,1620732836,9,3463,384.7777778,1361199323869,1361199324573,1620704705,1620705409,704
1361199352,1620732868,3,729,243,1361199324157,1361199324541,1620705025,1620705409,384
1361199352,1620732880,3,180,60,1361199325230,1361199326510,1620706110,1620707390,1280
1361199356,1620736824,16,3399,212.4375,1361199331111,1361199339559,1620711935,1620720383,8448
1361199359,1620739636,5,2168,433.6,1361199351973,1361199357093,1620732609,1620737729,5120
1361199359,1620739640,15,15414,1027.6,1361199350239,1361199357215,1620730879,1620737855,6976
1361199359,1620739672,16,15478,967.375,1361199351103,1361199356927,1620731775,1620737599,5824
1361199359,1620739672,7,4238,605.4285714,1361199351231,1361199356991,1620731903,1620737663,5760
1361199359,1620739672,17,18908,1112.235294,1361199351231,1361199357055,1620731903,1620737727,5824
1361199359,1620739684,4,700,175,1361199350004,1361199357044,1620730688,1620737728,7040
1361199359,1620739684,8,5492,686.5,1361199350387,1361199357107,1620731071,1620737791,6720
1361199359,1620739684,5,837,167.4,1361199350387,1361199357107,1620731071,1620737791,6720
1361199360,1620740820,6,2981,496.8333333,1361199333548,1361199335148,1620714368,1620715968,1600
1361199375,1620755776,6,1684,280.6666667,1361199363159,1361199371223,1620743935,1620751999,8064
1361199380,1620760800,3,567,189,1361199353662,1361199353726,1620734462,1620734526,64
1361199383,1620763676,2,127,63.5,1361199378749,1361199378749,1620759425,1620759425,0
1361199384,1620764796,1,52,52,1361199358980,1361199358980,1620739776,1620739776,0
1361199384,1620764796,1,52,52,1361199358980,1361199358980,1620739776,1620739776,0
1361199384,1620764844,1,52,52,1361199358929,1361199358929,1620739773,1620739773,0
1361199384,1620764844,1,52,52,1361199358929,1361199358929,1620739773,1620739773,0
1361199384,1620764864,1,52,52,1361199359040,1361199359040,1620739904,1620739904,0
1361199447,1620827732,2,131,65.5,1361199444673,1361199444673,1620825405,1620825405,0
1361199447,1620827776,2,131,65.5,1361199444567,1361199444567,1620825343,1620825343,0
1361199472,1620853180,2,131,65.5,1361199443969,1361199443969,1620825149,1620825149,0
1361199535,1620915776,2,104,52,1361199533654,1361199533846,1620914430,1620914622,192
1361199552,1620933416,1,76,76,1361199527380,1361199527380,1620908796,1620908796,0
1361199565,1620945532,1,52,52,1361199540168,1361199540168,1620920700,1620920700,0
1361199569,1620949588,1,52,52,1361199541521,1361199541521,1620922109,1620922109,0
1361199581,1620961476,1,52,52,1361199553982,1361199553982,1620934458,1620934458,0
1361199593,1620973480,1,52,52,1361199564924,1361199564924,1620945404,1620945404,0
1361199601,1620981608,1,46,46,1361199575354,1361199575354,1620955962,1620955962,0
1361199621,1621001636,1,52,52,1361199593889,1361199593889,1620974525,1620974525,0
1361199621,1621001664,1,189,189,1361199595138,1361199595138,1620975802,1620975802,0
1361199631,1621011820,4,382,95.5,1361199622057,1361199628265,1621002877,1621009085,6208
1361199639,1621019820,4,320,80,1361199638312,1361199638440,1621019132,1621019260,128
1361199639,1621019864,6,1234,205.6666667,1361199634746,1361199635194,1621015610,1621016058,448
1361199639,1621019884,25,29848,1193.92,1361199635239,1361199638119,1621016123,1621019003,2880
1361199647,1621027816,4,356,89,1361199637420,1361199644268,1621018236,1621025084,6848
1361199647,1621027824,4,399,99.75,1361199638179,1361199646243,1621019003,1621027067,8064
1361199653,1621033716,9,3463,384.7777778,1361199626385,1361199626705,1621007101,1621007421,320
1361199671,1621051856,14,2815,201.0714286,1361199663237,1361199664261,1621044093,1621045117,1024
1361199671,1621051856,20,3565,178.25,1361199665347,1361199666179,1621046203,1621047035,832
1361199671,1621051856,29,7594,261.862069,1361199663553,1361199665537,1621044409,1621046393,1984
1361199679,1621059868,14,5250,375,1361199670647,1361199671863,1621051515,1621052731,1216
1361199687,1621067824,17,7496,440.9411765,1361199663074,1361199683106,1621043898,1621063930,20032
1361199689,1621069652,9,2540,282.2222222,1361199663184,1361199663952,1621043836,1621044604,768
1361199689,1621069708,8,2488,311,1361199663126,1361199664086,1621043834,1621044794,960
1361199693,1621073732,15,3904,260.2666667,1361199665661,1361199670589,1621046393,1621051321,4928
1361199693,1621073740,6,3552,592,1361199666613,1361199668021,1621047353,1621048761,1408
1361199693,1621073744,73,95991,1314.945205,1361199666675,1361199667571,1621047419,1621048315,896
1361199693,1621073780,1,710,710,1361199668304,1361199668304,1621049084,1621049084,0
1361199695,259388808,76,92768,1220.631579,1361199683958,1361199694262,259377766,259388070,10304
1361199695,259388808,29,30914,1066,1361199683958,1361199694134,259377766,259387942,10176
1361199695,259388808,24,22231,926.2916667,1361199683958,1361199694198,259377766,259388006,10240
1361199695,259388828,39,42770,1096.666667,1361199683937,1361199694177,259377765,259388005,10240
1361199695,1621075820,4,223,55.75,1361199693672,1361199693736,1621074492,1621074556,64
1361199695,1621075824,21,12471,593.8571429,1361199687904,1361199688864,1621068728,1621069688,960
1361199695,1621075824,12,3156,263,1361199688225,1361199689185,1621069049,1621070009,960
1361199695,1621075828,6,1009,168.1666667,1361199694686,1361199694814,1621075514,1621075642,128
1361199695,1621075864,4,223,55.75,1361199693560,1361199693624,1621074424,1621074488,64
1361199695,1621075892,23,7648,332.5217391,1361199670240,1361199692192,1621051132,1621073084,21952
1361199695,1621075892,10,3302,330.2,1361199688159,1361199689119,1621069051,1621070011,960
1361199695,1621075896,64,55097,860.890625,1361199686747,1361199689115,1621067643,1621070011,2368
1361199703,1621083832,15,3748,249.8666667,1361199697180,1361199699804,1621078012,1621080636,2624
1361199703,1621083832,10,4983,498.3,1361199687385,1361199695961,1621068217,1621076793,8576
1361199703,1621083832,18,9763,542.3888889,1361199687385,1361199695961,1621068217,1621076793,8576
1361199703,1621083840,38,25733,677.1842105,1361199682258,1361199695954,1621063098,1621076794,13696
1361199703,1621083840,14,5809,414.9285714,1361199682513,1361199695441,1621063353,1621076281,12928
1361199703,1621083872,27,6987,258.7777778,1361199699442,1361199700658,1621080314,1621081530,1216
1361199703,1621083880,16,3762,235.125,1361199697000,1361199699240,1621077880,1621080120,2240
1361199703,1621083880,19,7691,404.7894737,1361199687338,1361199699242,1621068218,1621080122,11904
1361199703,1621083884,12,3172,264.3333333,1361199695591,1361199696103,1621076475,1621076987,512
1361199703,1621083884,22,5457,248.0454545,1361199693797,1361199695589,1621074681,1621076473,1792
1361199703,1621083912,37,9819,265.3783784,1361199691466,1361199696714,1621072378,1621077626,5248
1361199703,1621083916,17,4224,248.4705882,1361199696455,1361199697095,1621077371,1621078011,640
1361199711,1621091832,2,158,79,1361199703002,1361199710362,1621083834,1621091194,7360
1361199717,1621097752,22,1542,70.09090909,1361199689065,1361199691241,1621069817,1621071993,2176
1361199719,1621099896,39,14104,361.6410256,1361199699739,1361199716315,1621080635,1621097211,16576
1361199721,1621101708,47,37800,804.2553191,1361199693334,1361199707478,1621074042,1621088186,14144
1361199721,1621101784,11,7574,688.5454545,1361199693322,1361199696970,1621074106,1621077754,3648
1361199721,1621101796,13,3106,238.9230769,1361199695935,1361199696511,1621076731,1621077307,576
1361199735,1621115876,20,12355,617.75,1361199725164,1361199732716,1621106040,1621113592,7552
1361199743,259436876,17,10499,617.5882353,1361199726963,1361199737139,259420839,259431015,10176
1361199743,259436888,21,16477,784.6190476,1361199726950,1361199735142,259420838,259429030,8192
1361199743,1621123856,29,14587,503,1361199727873,1361199736833,1621108729,1621117689,8960
1361199743,1621123856,29,18270,630,1361199727873,1361199736833,1621108729,1621117689,8960
1361199743,1621123856,12,3557,296.4166667,1361199734208,1361199735360,1621115064,1621116216,1152
1361199743,1621123900,18,9566,531.4444444,1361199727959,1361199736791,1621108859,1621117691,8832
1361199743,1621123924,14,5056,361.1428571,1361199728060,1361199736764,1621108984,1621117688,8704
1361199753,1621133708,1,79,79,1361199725204,1361199725204,1621105912,1621105912,0
1361199753,1621133712,8,2893,361.625,1361199725391,1361199726351,1621106103,1621107063,960
1361199759,1621139916,2,127,63.5,1361199757510,1361199757510,1621138426,1621138426,0
1361199767,259460876,9,1530,170,1361199754035,1361199761971,259447911,259455847,7936
1361199767,1621147924,18,9726,540.3333333,1361199752510,1361199759550,1621133434,1621140474,7040
1361199767,1621147928,2,127,63.5,1361199763451,1361199763451,1621144379,1621144379,0
1361199775,1621155892,32,18487,577.71875,1361199754077,1361199767581,1621134969,1621148473,13504
1361199775,1621155892,36,23440,651.1111111,1361199754076,1361199771612,1621134968,1621152504,17536
1361199775,1621155940,31,20973,676.5483871,1361199753967,1361199767535,1621134907,1621148475,13568
1361199775,1621155940,31,19087,615.7096774,1361199753967,1361199767535,1621134907,1621148475,13568
1361199775,1621155960,18,7796,433.1111111,1361199760024,1361199767512,1621140984,1621148472,7488
1361199781,1621161736,1,79,79,1361199754744,1361199754744,1621135480,1621135480,0
1361199791,1621171964,2,131,65.5,1361199787220,1361199787220,1621168184,1621168184,0
1361199799,1621179892,2,92,46,1361199793691,1361199793691,1621174583,1621174583,0
1361199799,1621179944,32,6130,191.5625,1361199786280,1361199793448,1621167224,1621174392,7168
1361199799,1621179968,3,138,46,1361199798098,1361199798098,1621179066,1621179066,0
1361199799,1621179972,10,2704,270.4,1361199790350,1361199791438,1621171322,1621172410,1088
1361199807,1621187908,59,70873,1201.237288,1361199800140,1361199802572,1621181048,1621183480,2432
1361199817,1621197820,8,3529,441.125,1361199789923,1361199790819,1621170743,1621171639,896
1361199821,1621201824,7,3729,532.7142857,1361199793761,1361199795425,1621174585,1621176249,1664
1361199823,1621204004,2,131,65.5,1361199816171,1361199816171,1621197175,1621197175,0
1361199825,1621205752,1,185,185,1361199797800,1361199797800,1621178552,1621178552,0
1361199825,1621205784,12,5262,438.5,1361199798282,1361199799690,1621179066,1621180474,1408
1361199863,1621244040,6,427,71.16666667,1361199859336,1361199862856,1621240376,1621243896,3520
1361199893,1621273884,3,225,75,1361199866723,1361199889187,1621247607,1621270071,22464
1361199911,1621292084,2,131,65.5,1361199910554,1361199910554,1621291638,1621291638,0
1361199919,1621300084,2,158,79,1361199912090,1361199915162,1621293174,1621296246,3072
1361199935,1621316120,2,158,79,1361199921272,1361199933624,1621302392,1621314744,12352
1361199949,1621329892,1,75,75,1361199919066,1361199919066,1621299958,1621299958,0
1361199985,1621366048,1,79,79,1361199958332,1361199958332,1621339380,1621339380,0
1361200005,1621386116,7,1295,185,1361199977403,1361199995323,1621358519,1621376439,17920
1361200017,1621398168,7,1176,168,1361199990982,1361200007686,1621372150,1621388854,16704
1361200033,1621414132,1,79,79,1361200007656,1361200007656,1621388788,1621388788,0
1361200033,1621414188,3,555,185,1361200005231,1361200025263,1621386419,1621406451,20032
1361200047,1621428152,5,260,52,1361200039316,1361200042644,1621420468,1621423796,3328
1361200049,1621430144,1,168,168,1361200024731,1361200024731,1621405875,1621405875,0
1361200061,1621442248,1,185,185,1361200035189,1361200035189,1621416437,1621416437,0
1361200085,1621466160,1,168,168,1361200058763,1361200058763,1621439923,1621439923,0
1361200154,1621534544,1,168,168,1361200127349,1361200127349,1621507893,1621507893,0
1361200194,1621574532,1,195,195,1361200166973,1361200166973,1621547505,1621547505,0
1361202384,262078328,16,16031,1001.9375,1361202381696,1361202383040,262076024,262077368,1344
1361202384,262078328,8,1600,200,1361202381887,1361202383167,262076215,262077495,1280
1361202384,262078328,9,2296,255.1111111,1361202382206,1361202383806,262076534,262078134,1600
1361202384,262078332,9,2184,242.6666667,1361202379580,1361202380412,262073912,262074744,832
1361202384,262078332,9,2341,260.1111111,1361202379579,1361202380731,262073911,262075063,1152
1361202384,262078332,9,2003,222.5555556,1361202380537,1361202381241,262074869,262075573,704
1361202384,262078336,35,42390,1211.142857,1361202380664,1361202381688,262075000,262076024,1024
1361202384,262078336,39,47985,1230.384615,1361202380728,1361202381688,262075064,262076024,960
1361202384,262078336,9,4539,504.3333333,1361202377271,1361202378807,262071607,262073143,1536
1361202384,262078336,27,30676,1136.148148,1361202381621,1361202382965,262075957,262077301,1344
1361202384,262078340,12,8625,718.75,1361202378867,1361202379507,262073207,262073847,640
1361202384,262078340,8,1051,131.375,1361202379573,1361202380661,262073913,262075001,1088
1361202384,262078340,9,2179,242.1111111,1361202379573,1361202380725,262073913,262075065,1152
1361202384,262078352,5,859,171.8,1361202377126,1361202377190,262071478,262071542,64
1361202384,262078352,16,15576,973.5,1361202380709,1361202381477,262075061,262075829,768
1361202384,262078356,10,2547,254.7,1361202381284,1361202382116,262075640,262076472,832
1361202385,1623766372,4,356,89,1361202372181,1361202379541,1623753553,1623760913,7360
1361202385,1623766408,24,20376,849,1361202370927,1361202383855,1623752335,1623765263,12928
1361202386,1623766444,4,399,99.75,1361202373747,1361202380659,1623754191,1623761103,6912
1361202391,1623771868,16,3401,212.5625,1361202363150,1361202369678,1623744018,1623750546,6528
1361202391,1623771868,15,5238,349.2,1361202363342,1361202367246,1623744210,1623748114,3904
1361202391,1623771916,13,8323,640.2307692,1361202363163,1361202370587,1623744079,1623751503,7424
1361202392,262086332,8,1416,177,1361202385660,1361202386492,262079992,262080824,832
1361202392,262086336,9,2362,262.4444444,1361202386488,1361202386744,262080824,262081080,256
1361202392,262086336,12,10039,836.5833333,1361202384631,1361202385655,262078967,262079991,1024
1361202392,262086340,9,2179,242.1111111,1361202383857,1361202384497,262078197,262078837,640
1361202392,262086344,8,1409,176.125,1361202385456,1361202386288,262079800,262080632,832
1361202392,262086344,10,6888,688.8,1361202385455,1361202386415,262079799,262080759,960
1361202392,262086344,10,6418,641.8,1361202385647,1361202386479,262079991,262080823,832
1361202392,262086356,9,3398,377.5555556,1361202384547,1361202385379,262078903,262079735,832
1361202392,262086356,8,1700,212.5,1361202384611,1361202385443,262078967,262079799,832
1361202392,262086356,8,1718,214.75,1361202384610,1361202385634,262078966,262079990,1024
1361202392,262086356,9,2554,283.7777778,1361202383073,1361202384353,262077429,262078709,1280
1361202392,262086360,8,1836,229.5,1361202383328,1361202384352,262077688,262078712,1024
1361202392,262086360,8,1554,194.25,1361202383328,1361202384416,262077688,262078776,1088
1361202401,1623782432,5,851,170.2,1361202397207,1361202397527,1623778639,1623778959,320
1361202402,1623782436,5,795,159,1361202398462,1361202399614,1623778898,1623780050,1152
1361202402,1623782488,4,320,80,1361202399688,1361202399752,1623780176,1623780240,64
1361202419,1623800068,8,3411,426.375,1361202393092,1361202393668,1623774160,1623774736,576
1361202425,1623805996,24,29784,1241,1361202398093,1361202398989,1623779089,1623779985,896
1361202426,1623806708,1,46,46,1361202397034,1361202397034,1623777742,1623777742,0
1361202426,1623807472,3,304,101.3333333,1361202398318,1361202398318,1623779790,1623779790,0
1361202522,1623902576,6,447,74.5,1361202514029,1361202518381,1623894605,1623898957,4352
1361202538,1623918628,2,158,79,1361202523004,1361202532220,1623903632,1623912848,9216
1361202575,1623956196,1,79,79,1361202550211,1361202550211,1623931407,1623931407,0
1361202610,1623990676,3,156,52,1361202607433,1361202608585,1623988109,1623989261,1152
1361202615,1623996144,1,79,79,1361202587319,1361202587319,1623968463,1623968463,0
1361202618,1623998628,5,230,46,1361202610874,1361202614522,1623991502,1623995150,3648
1361202618,1623998660,2,104,52,1361202610071,1361202613015,1623990731,1623993675,2944
1361202634,1624014620,2,92,46,1361202618433,1361202626177,1623999053,1624006797,7744
1361202642,1624022696,4,208,52,1361202639091,1361202640755,1624019787,1624021451,1664
1361202642,1624022700,4,184,46,1361202639410,1361202641074,1624020110,1624021774,1664
1361202650,1624030656,2,92,46,1361202636188,1361202646172,1624016844,1624026828,9984
1361202650,1624030704,2,92,46,1361202643053,1361202646893,1624023757,1624027597,3840
1361202666,1624046700,2,92,46,1361202654702,1361202664686,1624035402,1624045386,9984
1361202668,1624048492,1,52,52,1361202642815,1361202642815,1624023307,1624023307,0
1361202700,1624080516,1,46,46,1361202674854,1361202674854,1624055370,1624055370,0
1361202884,1624265064,8,1400,175,1361202856642,1361202883714,1624237706,1624264778,27072
1361202920,1624301072,3,525,175,1361202893689,1361202913721,1624274761,1624294793,20032
1361368298,1789678732,1,46,46,1361368269870,1361368269870,1789650602,1789650602,0
1361368522,1789902116,1,64,64,1361368495442,1361368495442,1789875558,1789875558,0
1361368714,1790094700,1,46,46,1361368686856,1361368686856,1790067556,1790067556,0
1361369713,1791093492,1,88,88,1361369688262,1361369688262,1791068754,1791068754,0
1361371693,1793073044,5,504,100.8,1361371692073,1361371692841,1793072117,1793072885,768
1361371693,1793073048,6,569,94.83333333,1361371692389,1361371692581,1793072437,1793072629,192
1361371701,1793081056,6,524,87.33333333,1361371693789,1361371693981,1793073845,1793074037,192
1361371701,1793081100,20,15832,791.6,1361371693745,1361371696561,1793073845,1793076661,2816
1361371701,1793081128,16,6165,385.3125,1361371697364,1361371699220,1793077492,1793079348,1856
1361371709,1793089048,14,5023,358.7857143,1361371706724,1361371708132,1793086772,1793088180,1408
1361371709,1793089048,13,3571,274.6923077,1361371698788,1361371706724,1793078836,1793086772,7936
1361371709,1793089092,13,3571,274.6923077,1361371698681,1361371706681,1793078773,1793086773,8000
1361371709,1793089132,31,10812,348.7741935,1361371697550,1361371705742,1793077682,1793085874,8192
1361371709,1793089136,15,5582,372.1333333,1361371697805,1361371706701,1793077941,1793086837,8896
1361371709,1793089136,6,629,104.8333333,1361371706508,1361371707404,1793086644,1793087540,896
1361371718,1793098860,17,3467,203.9411765,1361371692088,1361371698872,1793072948,1793079732,6784
1361371719,1793098896,4,994,248.5,1361371691643,1361371691707,1793071539,1793071603,64
1361371723,1793102912,18,11722,651.2222222,1361371696749,1361371713645,1793076661,1793093557,16896
1361371725,1793105096,2,104,52,1361371721526,1361371722614,1793101622,1793102710,1088
1361371726,1793106856,24,5487,228.625,1361371701692,1361371719612,1793082548,1793100468,17920
1361371726,1793106860,18,1333,74.05555556,1361371697975,1361371699767,1793078835,1793080627,1792
1361371726,1793106864,8,3153,394.125,1361371698354,1361371704434,1793079218,1793085298,6080
1361371730,1793110812,27,31778,1176.962963,1361371702184,1361371703656,1793082996,1793084468,1472
1361371730,1793110860,6,3390,565,1361371705465,1361371709817,1793086325,1793090677,4352
1361371738,1793118832,56,71080,1269.285714,1361371710165,1361371710805,1793090997,1793091637,640
1361371751,1793130912,5,3281,656.2,1361371723626,1361371723818,1793103538,1793103730,192
1361371774,1793154864,1,52,52,1361371748404,1361371748404,1793129268,1793129268,0
1361371775,1793154952,16,1229,76.8125,1361371747907,1361371773187,1793127859,1793153139,25280
1361371775,1793154960,17,3774,222,1361371748285,1361371764733,1793128245,1793144693,16448
1361371781,1793161172,23,5893,256.2173913,1361371772969,1361371780009,1793153141,1793160181,7040
1361371788,1793168644,12,4081,340.0833333,1361371762062,1361371766030,1793142706,1793146674,3968
1361371797,1793177148,18,4413,245.1666667,1361371792830,1361371793598,1793172978,1793173746,768
1361371797,1793177192,21,4674,222.5714286,1361371787409,1361371790225,1793167601,1793170417,2816
1361371799,1793178992,8,3153,394.125,1361371772953,1361371774425,1793152945,1793154417,1472
1361371805,1793185168,19,5793,304.8947368,1361371800170,1361371801002,1793180338,1793181170,832
1361371807,1793186912,12,7677,639.75,1361371781484,1361371801516,1793161396,1793181428,20032
1361371807,1793186964,21,13847,659.3809524,1361371781432,1361371801464,1793161396,1793181428,20032
1361371827,1793207100,3,704,234.6666667,1361371801517,1361371801965,1793181617,1793182065,448
1361371829,1793209156,2,131,65.5,1361371825078,1361371825078,1793205234,1793205234,0
1361371837,1793217204,2,131,65.5,1361371831304,1361371831304,1793211508,1793211508,0
1361371845,1793225160,2,131,65.5,1361371839668,1361371839668,1793219828,1793219828,0
1361371847,1793227120,6,4909,818.1666667,1361371820185,1361371824409,1793200305,1793204529,4224
1361371867,1793247096,21,3757,178.9047619,1361371840624,1361371841520,1793220720,1793221616,896
1361371877,1793257204,3,202,67.33333333,1361371869639,1361371869895,1793249843,1793250099,256
1361371893,1793273220,6,427,71.16666667,1361371888630,1361371892086,1793268850,1793272306,3456
1361371901,1793281196,14,3478,248.4285714,1361371896012,1361371897612,1793276208,1793277808,1600
1361371901,1793281200,2,104,52,1361371896523,1361371896779,1793276723,1793276979,256
1361371901,1793281200,2,131,65.5,1361371894154,1361371894154,1793274354,1793274354,0
1361371901,1793281244,19,5793,304.8947368,1361371894364,1361371895452,1793274608,1793275696,1088
1361371915,1793295108,5,300,60,1361371890535,1361371892839,1793270643,1793272947,2304
1361371917,1793297224,18,5144,285.7777778,1361371894513,1361371911153,1793274737,1793291377,16640
1361371919,1793299132,12,993,82.75,1361371894349,1361371895117,1793274481,1793275249,768
1361371919,1793299180,16,3401,212.5625,1361371894621,1361371902173,1793274801,1793282353,7552
1361371923,1793303084,1,75,75,1361371895932,1361371895932,1793276016,1793276016,0
1361371923,1793303112,7,3150,450,1361371897311,1361371898143,1793277423,1793278255,832
1361371925,1793305188,18,4483,249.0555556,1361371918230,1361371918998,1793298418,1793299186,768
1361371925,1793305212,21,5628,268,1361371921980,1361371924604,1793302192,1793304816,2624
1361371933,1793313176,29,8954,308.7586207,1361371929314,1361371930594,1793309490,1793310770,1280
1361371939,1793319092,14,7466,533.2857143,1361371911414,1361371935734,1793291506,1793315826,24320
1361371941,1793321268,31,11097,357.9677419,1361371932614,1361371933830,1793312882,1793314098,1216
1361371963,1793343208,20,12696,634.8,1361371935618,1361371944962,1793315826,1793325170,9344
1361371965,1793345204,2,131,65.5,1361371961027,1361371961027,1793341231,1793341231,0
1361371971,1793351476,1,46,46,1361371943926,1361371943926,1793324402,1793324402,0
1361371991,1793371472,1,52,52,1361371963255,1361371963255,1793343727,1793343727,0
1361372013,1793393252,2,127,63.5,1361372008597,1361372008597,1793388849,1793388849,0
1361372021,1793401200,2,127,63.5,1361372015622,1361372015622,1793395822,1793395822,0
1361372029,1793409208,2,92,46,1361372028415,1361372028415,1793408623,1793408623,0
1361372029,1793409208,2,92,46,1361372028351,1361372028351,1793408559,1793408559,0
1361372047,1793427588,27,4506,166.8888889,1361372022596,1361372044932,1793403184,1793425520,22336
1361372053,1793433260,11,2805,255,1361372047946,1361372048394,1793428206,1793428654,448
1361372055,1793435576,43,26811,623.5116279,1361372027984,1361372048400,1793408560,1793428976,20416
1361372055,1793435576,19,11680,614.7368421,1361372028110,1361372039502,1793408686,1793420078,11392
1361372067,1793447508,11,7247,658.8181818,1361372039634,1361372040018,1793420142,1793420526,384
1361372067,1793447544,1,52,52,1361372041584,1361372041584,1793422128,1793422128,0
1361372069,1793449268,19,5941,312.6842105,1361372062145,1361372062977,1793442413,1793443245,832
1361372071,1793451512,2,336,168,1361372044751,1361372045007,1793425263,1793425519,256
1361372079,1793459636,11,6506,591.4545455,1361372053908,1361372054292,1793434544,1793434928,384
1361372087,1793467560,34,39574,1163.941176,1361372060381,1361372060701,1793440941,1793441261,320
1361372087,1793467572,5,4765,953,1361372062738,1361372062802,1793443310,1793443374,64
1361372091,1793471568,9,6631,736.7777778,1361372062870,1361372074838,1793443438,1793455406,11968
1361372109,1793489280,25,19187,767.48,1361372099445,1361372102645,1793479725,1793482925,3200
1361372109,1793489364,19,4832,254.3157895,1361372106144,1361372106848,1793486508,1793487212,704
1361372117,1793497332,2,127,63.5,1361372116546,1361372116546,1793496878,1793496878,0
1361372119,1793499656,19,14909,784.6842105,1361372092223,1361372110143,1793472879,1793490799,17920
1361372119,1793499660,4,644,161,1361372094075,1361372094203,1793474735,1793474863,128
1361372119,1793499684,14,5537,395.5,1361372094690,1361372102882,1793475374,1793483566,8192
1361372123,1793503864,13,5359,412.2307692,1361372095341,1361372095981,1793476205,1793476845,640
1361372123,1793503872,11,5256,477.8181818,1361372096231,1361372097767,1793477103,1793478639,1536
1361372133,1793513316,17,4803,282.5294118,1361372126227,1361372127251,1793506543,1793507567,1024
1361372133,1793513380,2,92,46,1361372127376,1361372127376,1793507756,1793507756,0
1361372141,1793521372,19,4860,255.7894737,1361372137112,1361372137880,1793517484,1793518252,768
1361372149,1793529332,18,5049,280.5,1361372139715,1361372141059,1793520047,1793521391,1344
1361372149,1793529336,28,5253,187.6071429,1361372141631,1361372147647,1793521967,1793527983,6016
1361372149,1793529372,17,3766,221.5294118,1361372147097,1361372148185,1793527469,1793528557,1088
1361372152,1793531904,13,9323,717.1538462,1361372127852,1361372141548,1793507756,1793521452,13696
1361372152,1793531948,22,16401,745.5,1361372127746,1361372141506,1793507694,1793521454,13760
1361372152,1793532024,1,189,189,1361372127540,1361372127540,1793507564,1793507564,0
1361372157,1793537332,38,6599,173.6578947,1361372147650,1361372156482,1793527982,1793536814,8832
1361372165,1793545272,2,131,65.5,1361372160190,1361372160190,1793540462,1793540462,0
1361372165,1793545312,18,4413,245.1666667,1361372160020,1361372160852,1793540332,1793541164,832
1361372166,431859816,5,2081,416.2,1361372141204,1361372141716,431835020,431835532,512
1361372168,1793547940,14,10078,719.8571429,1361372142603,1361372143627,1793522543,1793523567,1024
1361372168,1793547956,36,40625,1128.472222,1361372141626,1361372142394,1793521582,1793522350,768
1361372168,1793547988,8,3013,376.625,1361372142938,1361372144026,1793522926,1793524014,1088
1361372168,1793547988,10,3734,373.4,1361372142937,1361372144345,1793522925,1793524333,1408
1361372172,1793551964,15,18407,1227.133333,1361372144560,1361372144688,1793524524,1793524652,128
1361372181,1793561300,2,131,65.5,1361372180897,1361372180897,1793561197,1793561197,0
1361372181,1793561300,3,210,70,1361372174496,1361372174752,1793554796,1793555052,256
1361372189,1793569300,19,4678,246.2105263,1361372181602,1361372182498,1793561902,1793562798,896
1361372208,1793588004,3,2513,837.6666667,1361372182984,1361372183048,1793562988,1793563052,64
1361372208,1793588004,4,2335,583.75,1361372183048,1361372183048,1793563052,1793563052,0
1361372213,1793593404,2,127,63.5,1361372210296,1361372210296,1793590700,1793590700,0
1361372220,1793600028,2,104,52,1361372194993,1361372195057,1793575021,1793575085,64
1361372228,1793608008,46,34468,749.3043478,1361372202051,1361372204739,1793582059,1793584747,2688
1361372229,1793609376,2,127,63.5,1361372227475,1361372227475,1793607851,1793607851,0
1361372229,1793609420,30,9258,308.6,1361372225577,1361372226921,1793605997,1793607341,1344
1361372237,1793617356,2,127,63.5,1361372230503,1361372230503,1793610859,1793610859,0
1361372237,1793617400,3,138,46,1361372236732,1361372236732,1793617132,1793617132,0
1361372245,1793625384,2,92,46,1361372240845,1361372240845,1793621229,1793621229,0
1361372260,1793640072,18,6816,378.6666667,1361372234629,1361372238853,1793614701,1793618925,4224
1361372260,1793640124,12,1299,108.25,1361372234190,1361372239310,1793614314,1793619434,5120
1361372264,1793644060,71,92866,1307.971831,1361372237073,1361372237585,1793617133,1793617645,512
1361372268,1793648072,10,5263,526.3,1361372241157,1361372265925,1793621229,1793645997,24768
1361372268,1793648188,1,46,46,1361372243791,1361372243791,1793623979,1793623979,0
1361372269,1793649364,2,131,65.5,1361372263840,1361372263840,1793644204,1793644204,0
1361372269,1793649372,2,131,65.5,1361372261656,1361372261656,1793642028,1793642028,0
1361372269,1793649400,2,131,65.5,1361372263485,1361372263485,1793643885,1793643885,0
1361372269,1793649444,2,131,65.5,1361372262926,1361372262926,1793643370,1793643370,0
1361372285,1793665384,45,12079,268.4222222,1361372273739,1361372278283,1793654123,1793658667,4544
1361372285,1793665416,17,4237,249.2352941,1361372283626,1361372284394,1793664042,1793664810,768
1361372285,1793665464,17,4124,242.5882353,1361372279741,1361372280509,1793660205,1793660973,768
1361372292,1793672328,1,52,52,1361372264260,1361372264260,1793644588,1793644588,0
1361372292,1793672404,28,37750,1348.214286,1361372265655,1361372265719,1793646059,1793646123,64
1361372293,1793673416,17,4124,242.5882353,1361372291501,1361372292205,1793671917,1793672621,704
1361372301,1793681396,17,4124,242.5882353,1361372296575,1361372297407,1793676971,1793677803,832
1361372308,1793688328,1,76,76,1361372280386,1361372280386,1793660714,1793660714,0
1361372308,1793688332,6,4601,766.8333333,1361372280959,1361372284671,1793661291,1793665003,3712
1361372309,1793689432,3,138,46,1361372305179,1361372305179,1793685611,1793685611,0
1361372325,1793705404,18,4411,245.0555556,1361372323574,1361372324086,1793703978,1793704490,512
1361372332,1793712468,93,117400,1262.365591,1361372305144,1361372318840,1793685612,1793699308,13696
1361372336,1793716412,1,46,46,1361372310576,1361372310576,1793690988,1793690988,0
1361372341,1793721388,3,138,46,1361372335302,1361372335302,1793715690,1793715690,0
1361372348,1793728424,10,7319,731.9,1361372322145,1361372335329,1793702569,1793715753,13184
1361372349,1793729412,12,3358,279.8333333,1361372345134,1361372346030,1793725546,1793726442,896
1361372357,1793737372,33,12824,388.6060606,1361372352405,1361372354261,1793732777,1793734633,1856
1361372360,1793740468,1,52,52,1361372334391,1361372334391,1793714859,1793714859,0
1361372360,1793740496,6,3539,589.8333333,1361372335259,1361372336667,1793715755,1793717163,1408
1361372364,1793744372,1,52,52,1361372336405,1361372336405,1793716777,1793716777,0
1361372364,1793744408,1,52,52,1361372338225,1361372338225,1793718633,1793718633,0
1361372368,1793748420,1,52,52,1361372342757,1361372342757,1793723177,1793723177,0
1361372372,1793752392,1,146,146,1361372344897,1361372344897,1793725289,1793725289,0
1361372373,1793753420,32,11916,372.375,1361372372071,1361372372775,1793752491,1793753195,704
1361372373,1793753428,2,192,96,1361372369373,1361372369373,1793749801,1793749801,0
1361372373,1793753456,22,9329,424.0454545,1361372371139,1361372371907,1793751595,1793752363,768
1361372389,1793769388,4,219,54.75,1361372385478,1361372386438,1793765866,1793766826,960
1361372389,1793769416,23,10551,458.7391304,1361372387050,1361372387690,1793767466,1793768106,640
1361372405,1793785580,26,5470,210.3846154,1361372395781,1361372397061,1793776361,1793777641,1280
1361372412,1793792472,7,6398,914,1361372386354,1361372391346,1793766826,1793771818,4992
1361372412,1793792524,27,24472,906.3703704,1361372386302,1361372411134,1793766826,1793791658,24832
1361372421,1793801472,2,192,96,1361372413810,1361372413810,1793794282,1793794282,0
1361372444,1793824464,25,24244,969.76,1361372416312,1361372436024,1793796776,1793816488,19712
1361372445,1793825544,2,127,63.5,1361372438314,1361372438314,1793818858,1793818858,0
1361372445,1793825544,2,131,65.5,1361372438633,1361372438633,1793819177,1793819177,0
1361372453,1793833520,3,138,46,1361372446850,1361372446850,1793827370,1793827370,0
1361372469,1793849672,19,5899,310.4736842,1361372461352,1361372462248,1793842024,1793842920,896
1361372472,1793852672,62,77528,1250.451613,1361372446761,1361372447657,1793827433,1793828329,896
1361372480,1793860672,1,46,46,1361372454632,1361372454632,1793835304,1793835304,0
1361372488,1793868592,3,2096,698.6666667,1361372462649,1361372462649,1793843241,1793843241,0
1361372488,1793868668,1,46,46,1361372462445,1361372462445,1793843113,1793843113,0
1361372500,1793880552,92,10593,115.1413043,1361372472351,1361372498335,1793852903,1793878887,25984
1361372500,1793880676,32,43229,1350.90625,1361372475236,1361372475300,1793855912,1793855976,64
1361372500,1793880676,1,46,46,1361372475363,1361372475363,1793856039,1793856039,0
1361372501,1793881656,12,3358,279.8333333,1361372495095,1361372495927,1793875751,1793876583,832
1361372501,1793881660,3,138,46,1361372498995,1361372499059,1793879655,1793879719,64
1361372501,1793881708,12,3380,281.6666667,1361372499013,1361372499589,1793879721,1793880297,576
1361372509,1793889708,16,5450,340.625,1361372499077,1361372501317,1793879785,1793882025,2240
1361372520,1793900688,3,319,106.3333333,1361372494295,1361372494679,1793874983,1793875367,384
1361372524,1793904604,1,46,46,1361372498986,1361372498986,1793879590,1793879590,0
1361372524,1793904612,8,3290,411.25,1361372499683,1361372500003,1793880295,1793880615,320
1361372525,1793905688,2,127,63.5,1361372517144,1361372517144,1793897832,1793897832,0
1361372528,1793908616,85,8186,96.30588235,1361372502625,1361372521185,1793883241,1793901801,18560
1361372533,1793913704,2,92,46,1361372532361,1361372532361,1793913065,1793913065,0
1361372541,1793921692,2,92,46,1361372533332,1361372533332,1793914024,1793914024,0
1361372541,1793921692,26,4097,157.5769231,1361372533459,1361372536979,1793914151,1793917671,3520
1361372541,1793921732,17,5190,305.2941176,1361372538923,1361372540331,1793919655,1793921063,1408
1361372541,1793921776,55,10233,186.0545455,1361372534016,1361372538368,1793914792,1793919144,4352
1361372553,432246984,15,9731,648.7333333,1361372546092,1361372546540,432240076,432240524,448
1361372553,432246988,15,7455,497,1361372550120,1361372551016,432244108,432245004,896
1361372560,1793940620,47,48945,1041.382979,1361372532444,1361372545372,1793913064,1793925992,12928
1361372560,1793940696,32,20181,630.65625,1361372533326,1361372546574,1793914022,1793927270,13248
1361372572,1793952648,9,5700,633.3333333,1361372545405,1361372546429,1793926053,1793927077,1024
1361372572,1793952724,36,49628,1378.555556,1361372544821,1361372545077,1793925545,1793925801,256
1361383998,1805377988,4,3541,885.25,1361383991015,1361383995367,1805371003,1805375355,4352
1361384014,1805394052,2,1211,605.5,1361384000996,1361384010532,1805381048,1805390584,9536
1361384098,1805478028,6,1818,303,1361384072572,1361384090236,1805452600,1805470264,17664
1361384110,1805490272,2,92,46,1361384104006,1361384108166,1805484278,1805488438,4160
1361384130,1805509980,2,606,303,1361384102123,1361384125419,1805482103,1805505399,23296
1361384142,1805522008,1,46,46,1361384114832,1361384114832,1805494840,1805494840,0
1361384142,1805522320,7,632,90.28571429,1361384135000,1361384138712,1805515320,1805519032,3712
1361384170,1805550068,3,303,101,1361384142868,1361384160660,1805522936,1805540728,17792
1361384198,1805578064,1,101,101,1361384170645,1361384170645,1805550709,1805550709,0
1361384198,1805578192,1,303,303,1361384171800,1361384171800,1805551992,1805551992,0
1361384234,1805614472,1,46,46,1361384208316,1361384208316,1805588788,1805588788,0
1361384234,1805614496,1,46,46,1361384208741,1361384208741,1805589237,1805589237,0
1361384234,1805614624,13,7432,571.6923077,1361384205925,1361384223653,1805586549,1805604277,17728
1361384239,1805618864,7,824,117.7142857,1361384213916,1361384214044,1805593780,1805593908,128
1361384263,1805642892,2,349,174.5,1361384236099,1361384236291,1805615991,1805616183,192
1361384286,1805666840,1,52,52,1361384258125,1361384258125,1805638965,1805638965,0
1361384290,1805670532,1,46,46,1361384262016,1361384262016,1805642548,1805642548,0
1361384290,1805670580,1,134,134,1361384263762,1361384263762,1805644342,1805644342,0
1361384330,1805710704,1,52,52,1361384303254,1361384303254,1805683958,1805683958,0
1361384330,1805710820,1,134,134,1361384303522,1361384303522,1805684342,1805684342,0
1361384343,1805722908,1,46,46,1361384316591,1361384316591,1805696499,1805696499,0
1361384350,1805730448,1,46,46,1361384322133,1361384322133,1805702581,1805702581,0
1361384371,1805750912,1,134,134,1361384344427,1361384344427,1805724339,1805724339,0
1361384375,1805754924,1,52,52,1361384349087,1361384349087,1805729011,1805729011,0
1361384407,1805787064,1,46,46,1361384382548,1361384382548,1805762612,1805762612,0
1361384411,1805790980,1,134,134,1361384384358,1361384384358,1805764338,1805764338,0
1361384419,1805799160,1,52,52,1361384393843,1361384393843,1805774003,1805774003,0
1361384451,1805831168,2,268,134,1361384424235,1361384425643,1805804403,1805805811,1408
1361384454,1805834688,7,473,67.57142857,1361384438370,1361384453602,1805819058,1805834290,15232
1361384467,1805847236,1,46,46,1361384442342,1361384442342,1805822578,1805822578,0
1361384491,1805871160,1,134,134,1361384464242,1361384464242,1805844402,1805844402,0
1361384527,1805907156,1,46,46,1361384502451,1361384502451,1805882607,1805882607,0
1361384531,1805911196,2,180,90,1361384504204,1361384523020,1805884400,1805903216,18816
1361384550,1805930676,3,138,46,1361384543726,1361384547182,1805924402,1805927858,3456
1361384558,1805938748,2,92,46,1361384551332,1361384556324,1805932080,1805937072,4992
1361384855,1806235004,11,6654,604.9090909,1361384845767,1361384849543,1806225771,1806229547,3776
1361384872,1806251856,1,46,46,1361384846814,1361384846814,1806226670,1806226670,0
1361384875,1806255636,1,48,48,1361384847054,1361384847054,1806227690,1806227690,0
1361384875,1806255724,1,48,48,1361384846968,1361384846968,1806227692,1806227692,0
1361384879,1806259724,8,870,108.75,1361384852278,1361384852406,1806233002,1806233130,128
1361384880,1806259840,13,3390,260.7692308,1361384853229,1361384871917,1806233069,1806251757,18688
1361384880,1806259848,27,24000,888.8888889,1361384853860,1361384860900,1806233708,1806240748,7040
1361384908,1806287984,8,4029,503.625,1361384882717,1361384882845,1806262701,1806262829,128
1361384916,1806295920,25,18574,742.96,1361384888924,1361384889564,1806268844,1806269484,640
1361384920,1806299960,1,134,134,1361384893684,1361384893684,1806273644,1806273644,0
1361384924,1806303980,1,52,52,1361384898142,1361384898142,1806278122,1806278122,0
1361384928,1806307952,1,46,46,1361384901820,1361384901820,1806281772,1806281772,0
1361384932,1806311900,1,46,46,1361384905969,1361384905969,1806285869,1806285869,0
1361384940,1806319936,1,46,46,1361384913611,1361384913611,1806293547,1806293547,0
1361384956,1806335860,1,52,52,1361384927958,1361384927958,1806307818,1806307818,0
1361384960,1806339976,1,134,134,1361384933730,1361384933730,1806313706,1806313706,0
1361384960,1806340000,1,52,52,1361384934473,1361384934473,1806314473,1806314473,0
1361384967,1806347796,1,52,52,1361384942382,1361384942382,1806323178,1806323178,0
1361384975,1806355788,3,484,161.3333333,1361384950136,1361384974392,1806330924,1806355180,24256
1361384988,1806367940,1,46,46,1361384961864,1361384961864,1806341804,1806341804,0
1361385000,1806379856,1,52,52,1361384973018,1361384973018,1806352874,1806352874,0
1361385000,1806379864,7,1309,187,1361384973841,1361384976465,1806353705,1806356329,2624
1361385004,1806383920,3,1632,544,1361384976409,1361384976409,1806356329,1806356329,0
1361385004,1806384016,1,52,52,1361384979515,1361384979515,1806359531,1806359531,0
1361385016,1806395976,1,52,52,1361384988257,1361384988257,1806368233,1806368233,0
1361385040,1806419920,1,200,200,1361385013786,1361385013786,1806393706,1806393706,0
1361385044,1806424020,1,52,52,1361385017847,1361385017847,1806397867,1806397867,0
1361385047,1806427148,2,98,49,1361385024372,1361385045364,1806404520,1806425512,20992
1361385047,1806427268,2,98,49,1361385032959,1361385045311,1806413227,1806425579,12352
1361385047,1806427292,3,138,46,1361385021095,1361385045287,1806401387,1806425579,24192
1361385048,1806428348,1,46,46,1361385021487,1361385021487,1806401835,1806401835,0
1361385063,1806443228,3,144,48,1361385046499,1361385058211,1806426727,1806438439,11712
1361385063,1806443228,9,916,101.7777778,1361385046247,1361385056103,1806426475,1806436331,9856
1361385072,1806452384,1,46,46,1361385045130,1361385045130,1806425514,1806425514,0
1361385080,1806460404,4,564,141,1361385053301,1361385079477,1806433705,1806459881,26176
1361385084,1806464236,8,870,108.75,1361385056223,1361385056351,1806436459,1806436587,128
1361385108,1806488384,1,46,46,1361385081418,1361385081418,1806461802,1806461802,0
1361385120,1806500292,1,134,134,1361385093478,1361385093478,1806473770,1806473770,0
1361385128,1806508364,1,52,52,1361385101276,1361385101276,1806481640,1806481640,0
1361385160,1806540444,2,180,90,1361385133323,1361385136971,1806513767,1806517415,3648
1361385168,1806548416,1,46,46,1361385141415,1361385141415,1806521831,1806521831,0
1361385172,1806552424,1,52,52,1361385146273,1361385146273,1806526697,1806526697,0
1361385175,1806555556,2,92,46,1361385173211,1361385174427,1806553767,1806554983,1216
1361385183,1806563496,2,92,46,1361385176662,1361385180886,1806557158,1806561382,4224
1361385199,1806579640,2,92,46,1361385188934,1361385195654,1806569574,1806576294,6720
1361385228,1806608448,1,181,181,1361385202437,1361385202437,1806582885,1806582885,0
1361385263,1806643628,5,430,86,1361385261203,1361385261907,1806641831,1806642535,704
1361385288,1806668432,5,505,101,1361385263126,1361385286678,1806643558,1806667110,23552
1361385292,1806672572,1,181,181,1361385265995,1361385265995,1806646567,1806646567,0
1361385324,1806704596,1,101,101,1361385296498,1361385296498,1806677094,1806677094,0
1361385356,1806736516,1,286,286,1361385329793,1361385329793,1806710309,1806710309,0
1361385375,1806755696,7,1015,145,1361385366476,1361385366988,1806747172,1806747684,512
1361385392,1806772616,1,46,46,1361385367069,1361385367069,1806747685,1806747685,0
1361385392,1806772652,1,46,46,1361385364662,1361385364662,1806745314,1806745314,0
1361385396,1806776664,9,2894,321.5555556,1361385371629,1361385371693,1806752293,1806752357,64
1361385396,1806776776,12,2568,214,1361385371517,1361385372989,1806752293,1806753765,1472
1361385400,1806780684,8,2332,291.5,1361385371800,1361385373080,1806752484,1806753764,1280
1361385420,1806800780,1,476,476,1361385393271,1361385393271,1806774051,1806774051,0
1361385440,1806820796,1,134,134,1361385413030,1361385413030,1806793826,1806793826,0
1361385444,1806824668,1,52,52,1361385416742,1361385416742,1806797410,1806797410,0
1361385444,1806824816,1,46,46,1361385418002,1361385418002,1806798818,1806798818,0
1361385448,1806828812,1,46,46,1361385422167,1361385422167,1806802979,1806802979,0
1361385480,1806860796,1,134,134,1361385453096,1361385453096,1806833892,1806833892,0
1361385488,1806868740,1,46,46,1361385463135,1361385463135,1806843875,1806843875,0
1361385488,1806868792,1,52,52,1361385461677,1361385461677,1806842469,1806842469,0
1361385492,1806872768,3,455,151.6666667,1361385465474,1361385482242,1806846242,1806863010,16768
1361385521,1806900888,2,268,134,1361385494003,1361385495283,1806873891,1806875171,1280
1361385528,1806908828,1,46,46,1361385499973,1361385499973,1806880801,1806880801,0
1361385533,1806912984,1,52,52,1361385507539,1361385507539,1806887523,1806887523,0
1361385537,1806917048,1,46,46,1361385511696,1361385511696,1806891744,1806891744,0
1361385561,1806941108,1,134,134,1361385533783,1361385533783,1806913891,1806913891,0
1361385569,1806949144,1,46,46,1361385542896,1361385542896,1806923040,1806923040,0
1361385577,1806957104,1,52,52,1361385552473,1361385552473,1806932577,1806932577,0
1361385601,1806981064,2,277,138.5,1361385573824,1361385599936,1806953888,1806980000,26112
1361385616,1806996072,7,473,67.57142857,1361385597495,1361385612663,1806977567,1806992735,15168
1361385629,1807009216,1,46,46,1361385602855,1361385602855,1806983071,1806983071,0
1361385641,1807021112,1,134,134,1361385613840,1361385613840,1806993952,1806993952,0
1361385681,1807061248,2,180,90,1361385653703,1361385664391,1807033951,1807044639,10688
1361385689,1807069328,1,46,46,1361385662711,1361385662711,1807043039,1807043039,0
1361385696,1807076120,2,92,46,1361385693832,1361385695048,1807073952,1807075168,1216
1361385704,1807084092,2,92,46,1361385697250,1361385701474,1807077342,1807081566,4224
1361385733,1807113464,1,46,46,1361385707631,1361385707631,1807088095,1807088095,0
1361385855,1807234864,1,48,48,1361385827141,1361385827141,1807207005,1807207005,0
1361385945,1807325616,5,1090,218,1361385919958,1361385932758,1807300574,1807313374,12800
1361385973,1807353608,2,436,218,1361385945692,1361385964252,1807326300,1807344860,18560
1361386029,1807409800,1,218,218,1361386001049,1361386001049,1807381849,1807381849,0
1361386093,1807473768,1,218,218,1361386065147,1361386065147,1807445915,1807445915,0
1361386138,1807518052,1,46,46,1361386113414,1361386113414,1807493466,1807493466,0
1361386158,1807537896,1,218,218,1361386130146,1361386130146,1807510042,1807510042,0
1361386214,1807594224,1,46,46,1361386188633,1361386188633,1807568857,1807568857,0
1361386218,1807598264,1,218,218,1361386193519,1361386193519,1807573783,1807573783,0
1361386282,1807662284,2,516,258,1361386257177,1361386261145,1807637461,1807641429,3968
1361386290,1807670336,1,46,46,1361386263720,1361386263720,1807644056,1807644056,0
1361386346,1807726324,2,913,456.5,1361386321011,1361386335923,1807701335,1807716247,14912
1361386366,1807746592,1,46,46,1361386338597,1361386338597,1807719189,1807719189,0
1361386410,1807790792,1,46,46,1361386384415,1361386384415,1807765207,1807765207,0
1361386438,1807818772,1,46,46,1361386413617,1361386413617,1807794389,1807794389,0
1361386515,1807894920,1,46,46,1361386489605,1361386489605,1807869525,1807869525,0
1361386591,1807971068,1,46,46,1361386564717,1361386564717,1807944785,1807944785,0
1361386667,1808047224,1,46,46,1361386639759,1361386639759,1808019983,1808019983,0
1361386743,1808123576,1,46,46,1361386714993,1361386714993,1808095569,1808095569,0
1361387300,1808680232,7,1407,201,1361387274368,1361387291264,1808654600,1808671496,16896
1361387329,1808709320,2,1462,731,1361387308327,1361387324263,1808688647,1808704583,15936
1361387368,1808748344,1,201,201,1361387342608,1361387342608,1808722952,1808722952,0
1361387633,447326868,1,46,46,1361387605570,1361387605570,447299438,447299438,0
1361387873,1809253608,1,46,46,1361387847678,1361387847678,1809228286,1809228286,0
1361387906,1809286104,5,456,91.2,1361387902136,1361387902200,1809282240,1809282304,64
1361387928,447621860,3,313,104.3333333,1361387901006,1361387901070,447594866,447594930,64
1361387937,1809317680,1,60,60,1361387910070,1361387910070,1809290750,1809290750,0
1361387937,1809317788,13,3520,270.7692308,1361387909897,1361387910793,1809290685,1809291581,896
1361387941,1809321784,2,152,76,1361387913870,1361387928846,1809294654,1809309630,14976
1361387970,1809349892,2,152,76,1361387944777,1361387959881,1809324669,1809339773,15104
1361387988,447682064,1,52,52,1361387960770,1361387960770,447654834,447654834,0
1361388002,1809382016,1,76,76,1361387974796,1361387974796,1809354812,1809354812,0
1361388206,1809586612,2,152,76,1361388180855,1361388195831,1809561467,1809576443,14976
1361388216,447910320,17,22371,1315.941176,1361388190658,1361388190786,447884978,447885106,128
1361388218,1809598676,14,8809,629.2142857,1361388191157,1361388191477,1809571833,1809572153,320
1361388218,1809598676,1,52,52,1361388191220,1361388191220,1809571896,1809571896,0
1361388238,1809618628,2,152,76,1361388210852,1361388225892,1809591480,1809606520,15040
1361388266,1809646700,1,76,76,1361388240860,1361388240860,1809621560,1809621560,0
1361388315,1809695376,2,126,63,1361388312800,1361388313824,1809693176,1809694200,1024
1361388323,1809703268,2,126,63,1361388315978,1361388320010,1809696246,1809700278,4032
1361388355,1809735196,1,63,63,1361388328084,1361388328084,1809708280,1809708280,0
1361388695,448388740,4,208,52,1361388691273,1361388692873,448385013,448386613,1600
1361389721,1811101652,1,46,46,1361389693173,1361389693173,1811073825,1811073825,0
1361412635,1834014988,1,48,48,1361412609460,1361412609460,1833989448,1833989448,0
1361412685,1834065220,1,48,48,1361412655948,1361412655948,1834036168,1834036168,0
1361412763,1834143036,4,277,69.25,1361412761604,1361412762756,1834141640,1834142792,1152
1361412790,1834169780,4,300,75,1361412764608,1361412786496,1834144388,1834166276,21888
1361412838,1834217856,1,75,75,1361412811446,1361412811446,1834191302,1834191302,0
1361412886,1834265880,1,75,75,1361412861531,1361412861531,1834241411,1834241411,0
1361413223,1834603100,3,156,52,1361413197754,1361413206650,1834577854,1834586750,8896
1361414287,1835667300,1,46,46,1361414257635,1361414257635,1835637935,1835637935,0
1361416091,1837470740,18,3819,212.1666667,1361416063286,1361416069558,1837443026,1837449298,6272
1361416091,1837470828,31,16459,530.9354839,1361416064479,1361416075551,1837444307,1837455379,11072
1361416095,1837474756,9,4449,494.3333333,1361416067625,1361416068329,1837447381,1837448085,704
1361416115,1837494872,9,3463,384.7777778,1361416090674,1361416091826,1837470546,1837471698,1152
1361416131,1837510900,5,3293,658.6,1361416106262,1361416106518,1837486162,1837486418,256
1361416175,1837554956,9,3571,396.7777778,1361416150557,1361416165085,1837530513,1837545041,14528
1361416203,1837583040,3,4278,1426,1361416174984,1361416195016,1837555024,1837575056,20032
1361416203,1837583056,1,46,46,1361416176955,1361416176955,1837557011,1837557011,0
1361416216,1837596644,6,447,74.5,1361416210989,1361416215021,1837591633,1837595665,4032
1361416216,1837596680,3,2904,968,1361416204363,1361416214347,1837585043,1837595027,9984
1361416233,1837612772,2,158,79,1361416220247,1361416228823,1837600019,1837608595,8576
1361416239,1837619260,8,1480,185,1361416211694,1361416237678,1837591954,1837617938,25984
1361416271,1837651260,1,79,79,1361416245549,1361416245549,1837625809,1837625809,0
1361416275,1837655244,3,555,185,1361416247676,1361416267708,1837627920,1837647952,20032
1361416307,1837687380,1,79,79,1361416279798,1361416279798,1837660178,1837660178,0
1361416313,1837693076,5,260,52,1361416308002,1361416311266,1837688078,1837691342,3264
1361416353,1837733124,5,260,52,1361416346228,1361416349684,1837726352,1837729808,3456
1361416857,1838237208,3,180,60,1361416830934,1361416839958,1838211142,1838220166,9024
1361419283,1840662964,1,46,46,1361419255528,1361419255528,1840635492,1840635492,0
1361419446,1840825896,1,46,46,1361419421223,1361419421223,1840801119,1840801119,0
1361419762,1841142660,1,46,46,1361419734569,1361419734569,1841115229,1841115229,0
1361419827,1841206872,1,46,46,1361419801084,1361419801084,1841180956,1841180956,0
1361422536,1843916124,1,60,60,1361422508692,1361422508692,1843888816,1843888816,0
1361422600,1843980520,1,441,441,1361422573320,1361422573320,1843953840,1843953840,0
1361422600,1843980520,1,439,439,1361422573320,1361422573320,1843953840,1843953840,0
1361422600,1843980520,1,440,440,1361422573320,1361422573320,1843953840,1843953840,0
1361422600,1843980520,1,439,439,1361422573384,1361422573384,1843953904,1843953904,0
1361422600,1843980520,1,441,441,1361422573384,1361422573384,1843953904,1843953904,0
1361422600,1843980520,1,440,440,1361422573384,1361422573384,1843953904,1843953904,0
1361422600,1843980520,1,440,440,1361422573383,1361422573383,1843953903,1843953903,0
1361422600,1843980520,1,441,441,1361422573383,1361422573383,1843953903,1843953903,0
1361422600,1843980524,1,440,440,1361422573319,1361422573319,1843953843,1843953843,0
1361422600,1843980524,1,441,441,1361422573318,1361422573318,1843953842,1843953842,0
1361422600,1843980524,1,441,441,1361422573382,1361422573382,1843953906,1843953906,0
1361422600,1843980524,1,439,439,1361422573381,1361422573381,1843953905,1843953905,0
1361422600,1843980524,1,441,441,1361422573381,1361422573381,1843953905,1843953905,0
1361422600,1843980524,1,441,441,1361422573445,1361422573445,1843953969,1843953969,0
1361422600,1843980524,1,442,442,1361422573445,1361422573445,1843953969,1843953969,0
1361422600,1843980640,1,441,441,1361422573136,1361422573136,1843953776,1843953776,0
1361422600,1843980640,1,441,441,1361422573200,1361422573200,1843953840,1843953840,0
1361422600,1843980640,1,437,437,1361422573199,1361422573199,1843953839,1843953839,0
1361422600,1843980644,1,439,439,1361422573199,1361422573199,1843953843,1843953843,0
1361422600,1843980644,1,441,441,1361422573199,1361422573199,1843953843,1843953843,0
1361422600,1843980644,1,441,441,1361422573262,1361422573262,1843953906,1843953906,0
1361422600,1843980644,1,441,441,1361422573326,1361422573326,1843953970,1843953970,0
1361422600,1843980644,1,440,440,1361422573197,1361422573197,1843953841,1843953841,0
1361422600,1843980644,1,441,441,1361422573197,1361422573197,1843953841,1843953841,0
1361422600,1843980644,1,441,441,1361422573197,1361422573197,1843953841,1843953841,0
1361422600,1843980644,1,441,441,1361422573196,1361422573196,1843953840,1843953840,0
1361422600,1843980644,1,438,438,1361422573260,1361422573260,1843953904,1843953904,0
1361422600,1843980644,1,438,438,1361422573260,1361422573260,1843953904,1843953904,0
1361422600,1843980644,1,442,442,1361422573260,1361422573260,1843953904,1843953904,0
1361422600,1843980644,1,441,441,1361422573323,1361422573323,1843953967,1843953967,0
1361423285,1844665236,2,230,115,1361423257049,1361423257113,1844637285,1844637349,64
1361424250,1845629936,1,46,46,1361424221880,1361424221880,1845601816,1845601816,0
1361424821,1846200972,2,106,53,1361424814861,1361424820685,1846194833,1846200657,5824
1361424829,1846208920,2,106,53,1361424816893,1361424823037,1846196813,1846202957,6144
1361425161,1846540988,1,46,46,1361425135606,1361425135606,1846515594,1846515594,0
1361459605,1880985476,1,46,46,1361459579206,1361459579206,1880959682,1880959682,0
1361459845,1881225540,1,46,46,1361459817796,1361459817796,1881198336,1881198336,0
1361460483,1881862660,1,46,46,1361460457259,1361460457259,1881836919,1881836919,0
1361460523,1881902816,6,384,64,1361460497037,1361460502413,1881876853,1881882229,5376
1361460523,1881902824,7,448,64,1361460495621,1361460503237,1881875445,1881883061,7616
1361460523,1881902860,6,384,64,1361460498273,1361460503585,1881878133,1881883445,5312
1361460523,1881902864,6,384,64,1361460498335,1361460503583,1881878199,1881883447,5248
1361460608,1881988040,1,48,48,1361460581932,1361460581932,1881961972,1881961972,0
1361461368,1882748052,9,2555,283.8888889,1361461343315,1361461347923,1882723367,1882727975,4608
1361461368,1882748132,8,6542,817.75,1361461343556,1361461366020,1882723688,1882746152,22464
1361461369,1882749172,7,406,58,1361461356892,1361461368412,1882737064,1882748584,11520
1361461376,1882756020,5,3327,665.4,1361461349878,1361461350902,1882729898,1882730922,1024
1361461376,1882756052,12,9052,754.3333333,1361461351252,1361461366100,1882731304,1882746152,14848
1361461392,1882772080,12,7934,661.1666667,1361461366265,1361461387449,1882746345,1882767529,21184
1361461392,1882772084,8,3833,479.125,1361461366838,1361461368694,1882746922,1882748778,1856
1361461392,1882772164,2,124,62,1361461366758,1361461382438,1882746922,1882762602,15680
1361461393,1882773144,5,1264,252.8,1361461368952,1361461390520,1882749096,1882770664,21568
1361461393,1882773196,9,1592,176.8888889,1361461368899,1361461392131,1882749095,1882772327,23232
1361461396,1882776016,60,74802,1246.7,1361461369080,1361461395832,1882749096,1882775848,26752
1361461396,1882776116,2,151,75.5,1361461370518,1361461370518,1882750634,1882750634,0
1361461396,1882776136,11,4065,369.5454545,1361461370562,1361461380738,1882750698,1882760874,10176
1361461401,1882781228,7,406,58,1361461386598,1361461392934,1882766826,1882773162,6336
1361461401,1882781272,2,127,63.5,1361461394360,1361461394680,1882774632,1882774952,320
1361461412,1882792136,9,4476,497.3333333,1361461385216,1361461394240,1882765352,1882774376,9024
1361461417,1882797184,3,156,52,1361461410064,1361461413712,1882790248,1882793896,3648
1361461420,1882800104,9,1407,156.3333333,1361461394975,1361461411487,1882775079,1882791591,16512
1361461424,1882804044,9,11109,1234.333333,1361461397918,1361461415902,1882777962,1882795946,17984
1361461424,1882804080,2,2714,1357,1361461396023,1361461413239,1882776103,1882793319,17216
1361461424,1882804112,4,5704,1426,1361461397528,1361461422104,1882777640,1882802216,24576
1361461433,1882813204,2,104,52,1361461418492,1361461428156,1882798696,1882808360,9664
1361461449,1882829256,2,104,52,1361461438152,1361461448136,1882818408,1882828392,9984
1361461456,1882836172,1,185,185,1361461428059,1361461428059,1882808231,1882808231,0
1361461460,1882840236,1,1426,1426,1361461434012,1361461434012,1882814248,1882814248,0
1361461472,1882852184,1,1357,1357,1361461447568,1361461447568,1882827752,1882827752,0
1361461473,1882853304,2,104,52,1361461458073,1361461468057,1882838377,1882848361,9984
1361461473,1882853312,3,156,52,1361461471056,1361461472592,1882851368,1882852904,1536
1361461476,1882856156,1,1426,1426,1361461450155,1361461450155,1882830311,1882830311,0
1361461481,1882861328,2,104,52,1361461474558,1361461478526,1882854886,1882858854,3968
1361461488,1882868212,1,185,185,1361461461237,1361461461237,1882841449,1882841449,0
1361461489,1882869244,2,131,65.5,1361461488529,1361461488529,1882868773,1882868773,0
1361461489,1882869280,4,256,64,1361461486702,1361461488814,1882866982,1882869094,2112
1361461492,1882872272,1,64,64,1361461467702,1361461467702,1882847974,1882847974,0
1361461497,1882877264,2,158,79,1361461490048,1361461492992,1882870312,1882873256,2944
1361461497,1882877268,3,210,70,1361461490364,1361461493308,1882870632,1882873576,2944
1361461497,1882877272,2,128,64,1361461491193,1361461495993,1882871465,1882876265,4800
1361461505,1882885260,2,104,52,1361461486530,1361461502466,1882866790,1882882726,15936
1361461513,1882893288,2,158,79,1361461499176,1361461510888,1882879464,1882891176,11712
1361461513,1882893336,2,158,79,1361461498872,1361461510712,1882879208,1882891048,11840
1361461513,1882893336,3,156,52,1361461507190,1361461509622,1882887526,1882889958,2432
1361461521,1882901260,2,104,52,1361461513026,1361461519682,1882893286,1882899942,6656
1361461524,1882904228,1,79,79,1361461499682,1361461499682,1882879910,1882879910,0
1361461529,1882909328,2,128,64,1361461505469,1361461524605,1882885797,1882904933,19136
1361461552,1882932268,1,185,185,1361461527737,1361461527737,1882908005,1882908005,0
1361461560,1882940244,2,104,52,1361461532946,1361461559506,1882913190,1882939750,26560
1361461560,1882940256,1,79,79,1361461534344,1361461534344,1882914600,1882914600,0
1361461560,1882940276,1,52,52,1361461534322,1361461534322,1882914598,1882914598,0
1361461560,1882940328,1,79,79,1361461534526,1361461534526,1882914854,1882914854,0
1361461588,1882968308,1,64,64,1361461562835,1361461562835,1882943143,1882943143,0
1361461608,1882988288,1,79,79,1361461581160,1361461581160,1882961448,1882961448,0
1361461608,1882988364,1,79,79,1361461582040,1361461582040,1882962404,1882962404,0
1361461676,1883056320,1,185,185,1361461648004,1361461648004,1883028324,1883028324,0
1361461728,1883108420,1,46,46,1361461700319,1361461700319,1883080739,1883080739,0
1361461793,1883172756,1,185,185,1361461768888,1361461768888,1883148644,1883148644,0
1361461913,1883293104,1,185,185,1361461888859,1361461888859,1883268963,1883268963,0
1361462037,1883417256,1,185,185,1361462009022,1361462009022,1883389278,1883389278,0
1361462154,1883533764,1,185,185,1361462129833,1361462129833,1883509597,1883509597,0
1361462274,1883654372,1,185,185,1361462249544,1361462249544,1883629916,1883629916,0
1361462642,1884022308,2,131,65.5,1361462640579,1361462640579,1884020887,1884020887,0
1361462982,1884362352,1,48,48,1361462954257,1361462954257,1884334609,1884334609,0
1361540338,1961718232,1,48,48,1361540311490,1361540311490,1961691722,1961691722,0
1361540403,1961782408,3,513,171,1361540376057,1361540382073,1961755465,1961761481,6016
1361540671,1962050832,4,244,61,1361540646223,1361540656911,1962026055,1962036743,10688
1361540671,1962050872,3,152,50.66666667,1361540646180,1361540655076,1962026052,1962034948,8896
1361540815,1962195036,3,447,149,1361540788865,1361540794881,1962168901,1962174917,6016
1361541008,1962387432,3,513,171,1361540983129,1361540989145,1962362561,1962368577,6016
1361541085,1962465260,1,48,48,1361541055453,1361541055453,1962435713,1962435713,0
1361541144,1962523800,1,95,95,1361541118567,1361541118567,1962498367,1962498367,0
1361541225,1962604680,1,46,46,1361541199263,1361541199263,1962578943,1962578943,0
1361541489,1962868800,3,513,171,1361541462372,1361541468388,1962842172,1962848188,6016
1361541870,1963249948,4,244,61,1361541843271,1361541853895,1963223219,1963233843,10624
1361541870,1963249984,3,152,50.66666667,1361541843238,1361541852262,1963223222,1963232246,9024
1361541986,1963366084,4,244,61,1361541960317,1361541970813,1963340401,1963350897,10496
1361541986,1963366120,3,152,50.66666667,1361541960282,1361541969370,1963340402,1963349490,9088
1361542255,1963634392,3,558,186,1361542230511,1361542236463,1963609903,1963615855,5952
1361542283,1963662348,4,244,61,1361542255194,1361542265690,1963634542,1963645038,10496
1361542283,1963662396,3,152,50.66666667,1361542255147,1361542263979,1963634543,1963643375,8832
1361542379,1963758788,3,444,148,1361542350945,1361542356961,1963730733,1963736749,6016
1361542795,1964175144,1,46,46,1361542768759,1361542768759,1964148903,1964148903,0
1361542831,1964211116,3,513,171,1361542806032,1361542812048,1964186148,1964192164,6016
1361543328,1964707928,4,244,61,1361543301445,1361543312069,1964681373,1964691997,10624
1361543328,1964707964,3,152,50.66666667,1361543301410,1361543310242,1964681374,1964690206,8832
1361543533,1964912536,15,3228,215.2,1361543507018,1361543512714,1964886554,1964892250,5696
1361543665,1965044708,1,46,46,1361543638943,1361543638943,1965018651,1965018651,0
1361543729,1965109016,3,444,148,1361543701673,1361543707689,1965081689,1965087705,6016
1361543861,1965241124,1,52,52,1361543833466,1361543833466,1965213590,1965213590,0
1361543946,1965325728,17,18363,1080.176471,1361543932932,1361543941188,1965312660,1965320916,8256
1361543946,1965325788,18,20332,1129.555556,1361543933128,1361543941128,1965312916,1965320916,8000
1361543946,1965325788,10,9396,939.6,1361543933128,1361543941128,1965312916,1965320916,8000
1361543953,1965333196,12,7423,618.5833333,1361543925616,1361543929776,1965305812,1965309972,4160
1361543953,1965333204,1,52,52,1361543926315,1361543926315,1965306519,1965306519,0
1361543953,1965333276,16,3438,214.875,1361543925407,1361543931679,1965305683,1965311955,6272
1361543969,1965349212,1,46,46,1361543941601,1361543941601,1965321813,1965321813,0
1361543970,1965349796,8,6456,807,1361543957439,1361543965311,1965337235,1965345107,7872
1361543981,1965361264,35,32281,922.3142857,1361543956716,1361543980780,1965336980,1965361044,24064
1361544010,1965390052,7,1774,253.4285714,1361543985406,1361544005054,1965365458,1965385106,19648
1361544010,1965390064,208,157418,756.8173077,1361544000757,1361544009077,1965380821,1965389141,8320
1361544013,1965393136,537,413396,769.8249534,1361544000684,1361544009004,1965380820,1965389140,8320
1361544018,1965398048,52,34991,672.9038462,1361543999493,1361544011077,1965379541,1965391125,11584
1361544018,1965398080,16,16580,1036.25,1361544002658,1361544011042,1965382738,1965391122,8384
1361544061,1965441308,9,3463,384.7777778,1361544034242,1361544034562,1965414550,1965414870,320
1361544098,1965477376,20,8475,423.75,1361544072738,1361544074274,1965452114,1965453650,1536
1361544114,1965494124,4,320,80,1361544107127,1361544107255,1965487251,1965487379,128
1361544114,1965494160,5,996,199.2,1361544106004,1361544106964,1965486164,1965487124,960
1361544114,1965494164,5,851,170.2,1361544105741,1361544106061,1965485905,1965486225,320
1361544134,1965513364,24,29881,1245.041667,1361544106990,1361544107502,1965486354,1965486866,512
1361544134,1965513444,23,26194,1138.869565,1361544106847,1361544107295,1965486291,1965486739,448
1361544162,1965542148,6,447,74.5,1361544154653,1361544158493,1965534801,1965538641,3840
1361544178,1965558144,6,276,46,1361544169826,1361544177314,1965549970,1965557458,7488
1361544178,1965558148,2,158,79,1361544162656,1361544170848,1965542804,1965550996,8192
1361544202,1965582180,5,531,106.2,1361544199999,1361544201855,1965580179,1965582035,1856
1361544202,1965582208,2,92,46,1361544184992,1361544194976,1965565200,1965575184,9984
1361544214,1965593784,1,79,79,1361544187722,1361544187722,1965567506,1965567506,0
1361544230,1965609848,3,339,113,1361544204296,1361544216840,1965584144,1965596688,12544
1361544230,1965609856,1,46,46,1361544205378,1361544205378,1965585234,1965585234,0
1361544246,1965625876,1,79,79,1361544220652,1361544220652,1965600528,1965600528,0
1361544258,1965637940,1,113,113,1361544233517,1361544233517,1965613457,1965613457,0
1361544294,1965673924,1,113,113,1361544267069,1361544267069,1965646993,1965646993,0
1361544354,1965734316,5,260,52,1361544345973,1361544349429,1965726289,1965729745,3456
1361544355,1965734352,149,201201,1350.342282,1361544106805,1361544354677,1965486157,1965734029,247872
1361544355,1965734352,4,184,46,1361544347448,1361544354680,1965726800,1965734032,7232
1361544379,1965758408,2,92,46,1361544362813,1361544372797,1965742221,1965752205,9984
1361544379,1965758448,2,92,46,1361544362582,1361544372566,1965742030,1965752014,9984
1361544407,1965786344,1,46,46,1361544382653,1361544382653,1965761997,1965761997,0
1361544410,1965790248,1,46,46,1361544381942,1361544381942,1965762190,1965762190,0
1361544543,1965922732,1,46,46,1361544515065,1361544515065,1965894797,1965894797,0
1361544567,1965946720,1,60,60,1361544540164,1361544540164,1965919884,1965919884,0
1361544612,1965992056,1,46,46,1361544586228,1361544586228,1965966284,1965966284,0
1361544916,1966295676,1,46,46,1361544889002,1361544889002,1966268678,1966268678,0
1361545129,1966508396,4,244,61,1361545104768,1361545115264,1966484164,1966494660,10496
1361545129,1966508396,3,152,50.66666667,1361545104768,1361545113792,1966484164,1966493188,9024
1361545181,1966560440,1,46,46,1361545153684,1361545153684,1966533124,1966533124,0
1361558008,1979387968,1,74,74,1361557980544,1361557980544,1979360512,1979360512,0
1361558040,1979420092,2,120,60,1361558013064,1361558014088,1979393156,1979394180,1024
1361559167,1980546892,6,570,95,1361559140220,1361559161852,1980520112,1980541744,21632
1361559207,1980586864,3,144,48,1361559181273,1361559190297,1980561137,1980570161,9024
1361559211,1980590952,1,95,95,1361559184126,1361559184126,1980564078,1980564078,0
1361559219,1980598940,2,116,58,1361559190860,1361559193868,1980570800,1980573808,3008
1361559295,1980674988,1,95,95,1361559267612,1361559267612,1980647600,1980647600,0
1361559299,1980678892,3,144,48,1361559271162,1361559280058,1980651054,1980659950,8896
1361559552,1980931648,1,95,95,1361559525035,1361559525035,1980904683,1980904683,0
1361559560,1980939688,3,144,48,1361559534401,1361559543425,1980914089,1980923113,9024
1361559612,1980991784,1,95,95,1361559584164,1361559584164,1980963948,1980963948,0
1361559772,1981152212,8,600,75,1361559744693,1361559766901,1981124905,1981147113,22208
1361559805,1981184348,3,225,75,1361559777749,1361559797781,1981157097,1981177129,20032
1361559833,1981212600,1,52,52,1361559805269,1361559805269,1981184869,1981184869,0
1361560406,1981786256,17,6391,375.9411765,1361560380541,1361560387261,1981760797,1981767517,6720
1361560419,1981798728,14,1267,90.5,1361560394703,1361560414671,1981774431,1981794399,19968
1361560435,1981814764,5,780,156,1361560429290,1361560429930,1981809054,1981809694,640
1361560442,1981822224,12,6881,573.4166667,1361560417503,1361560435487,1981797727,1981815711,17984
1361560442,1981822228,11,1090,99.09090909,1361560414105,1361560414937,1981794333,1981795165,832
1361560443,1981822304,24,4865,202.7083333,1361560418614,1361560421814,1981797918,1981801118,3200
1361560447,1981826288,10,2665,266.5,1361560422150,1361560433094,1981801438,1981812382,10944
1361560447,1981826288,10,2665,266.5,1361560422150,1361560432902,1981801438,1981812190,10752
1361560451,1981830768,2,131,65.5,1361560444775,1361560444775,1981824543,1981824543,0
1361560459,1981838460,17,1387,81.58823529,1361560430936,1361560432472,1981810396,1981811932,1536
1361560459,1981838464,9,3463,384.7777778,1361560431124,1361560431572,1981810588,1981811036,448
1361560459,1981838464,15,3228,215.2,1361560431124,1361560438164,1981810588,1981817628,7040
1361560459,1981838512,1,52,52,1361560432869,1361560432869,1981812381,1981812381,0
1361560463,1981842536,56,70714,1262.75,1361560435982,1361560437006,1981815518,1981816542,1024
1361560467,1981846764,15,5972,398.1333333,1361560460009,1361560461801,1981839773,1981841565,1792
1361560471,1981850624,30,9542,318.0666667,1361560445878,1361560450934,1981825502,1981830558,5056
1361560487,1981866536,32,24828,775.875,1361560462349,1361560483789,1981841885,1981863325,21440
1361560487,1981866572,38,27117,713.6052632,1361560460202,1361560485674,1981839774,1981865246,25472
1361560491,1981870620,43,14775,343.6046512,1361560466426,1361560483962,1981846046,1981863582,17536
1361560499,1981878840,18,4093,227.3888889,1361560495518,1361560496734,1981875358,1981876574,1216
1361560503,1981882496,63,79369,1259.825397,1361560475892,1361560494836,1981855388,1981874332,18944
1361560507,1981886928,19,4754,250.2105263,1361560501573,1361560502341,1981881501,1981882269,768
1361560515,1981894492,11,4745,431.3636364,1361560487672,1361560489336,1981867164,1981868828,1664
1361560515,1981894540,13,7241,557,1361560489928,1361560494344,1981869468,1981873884,4416
1361560515,1981894624,11,4707,427.9090909,1361560489909,1361560492789,1981869533,1981872413,2880
1361560519,1981898544,10,5221,522.1,1361560494278,1361560505286,1981873822,1981884830,11008
1361560523,1981902928,20,6051,302.55,1361560513922,1361560520706,1981893850,1981900634,6784
1361560527,1981906556,12,7044,587,1361560502776,1361560503736,1981882332,1981883292,960
1361560539,1981918604,10,991,99.1,1361560513736,1361560514312,1981893340,1981893916,576
1361560539,1981918688,16,3361,210.0625,1361560514166,1361560521718,1981893854,1981901406,7552
1361560543,1981922560,1,52,52,1361560516405,1361560516405,1981895965,1981895965,0
1361560547,1981926584,9,6934,770.4444444,1361560521118,1361560545118,1981900702,1981924702,24000
1361560547,1981926672,9,5425,602.7777778,1361560521093,1361560521605,1981900765,1981901277,512
1361560547,1981926840,2,131,65.5,1361560541210,1361560541210,1981921050,1981921050,0
1361560552,620245952,27,29085,1077.222222,1361560544729,1361560550169,620238681,620244121,5440
1361560563,1981942852,2,131,65.5,1361560556113,1361560556113,1981935965,1981935965,0
1361560563,1981942924,17,4284,252,1361560556681,1361560557385,1981936605,1981937309,704
1361560579,1981958876,6,629,104.8333333,1361560573241,1361560578489,1981953117,1981958365,5248
1361560579,1981958892,2,192,96,1361560578727,1361560578727,1981958619,1981958619,0
1361560579,1981958916,19,4828,254.1052632,1361560570767,1361560571343,1981950683,1981951259,576
1361560587,1981966560,4,5379,1344.75,1361560559413,1361560559477,1981938973,1981939037,64
1361560587,1981966644,16,14997,937.3125,1361560559327,1361560571743,1981938971,1981951387,12416
1361560587,1981966932,33,13928,422.0606061,1361560582911,1361560584703,1981962843,1981964635,1792
1361560595,1981974684,16,18136,1133.5,1361560569145,1361560569977,1981948829,1981949661,832
1361560603,1981982844,47,12737,271,1361560587161,1361560600729,1981967005,1981980573,13568
1361560611,1981991228,3,210,70,1361560607511,1361560607831,1981987739,1981988059,320
1361560619,1981998932,2,131,65.5,1361560610880,1361560610880,1981990812,1981990812,0
1361560619,1981998944,2,131,65.5,1361560612405,1361560612405,1981992349,1981992349,0
1361560619,1981998972,2,131,65.5,1361560613846,1361560613846,1981993818,1981993818,0
1361560667,1982047228,2,365,182.5,1361560641175,1361560663575,1982021403,1982043803,22400
1361560695,1982075220,17,3387,199.2352941,1361560670044,1361560676316,1982050264,1982056536,6272
1361560696,1982075304,11,1159,105.3636364,1361560670452,1361560671860,1982049756,1982051164,1408
1361560699,1982078892,115,149142,1296.886957,1361560566822,1361560693670,1981946714,1982073562,126848
1361560699,1982079148,1,52,52,1361560671140,1361560671140,1982051288,1982051288,0
1361560715,1982095200,15,13301,886.7333333,1361560689266,1361560706482,1982069466,1982086682,17216
1361560715,1982095232,36,30688,852.4444444,1361560690450,1361560712658,1982070682,1982092890,22208
1361560715,1982095232,12,8297,691.4166667,1361560690705,1361560691473,1982070937,1982071705,768
1361560731,1982110980,20,6188,309.4,1361560711821,1361560724301,1982091801,1982104281,12480
1361560736,1982115308,22,3856,175.2727273,1361560711213,1361560712429,1982090521,1982091737,1216
1361560736,620430048,350,491036,1402.96,1361560428476,1361560434428,620122524,620128476,5952
1361560748,1982127288,11,8981,816.4545455,1361560723587,1361560739011,1982102875,1982118299,15424
1361560752,620446024,18,9355,519.7222222,1361560747602,1361560750226,620441626,620444250,2624
1361560755,1982134996,6,629,104.8333333,1361560737788,1361560748412,1982117784,1982128408,10624
1361560760,620454012,2,150,75,1361560751901,1361560755165,620445913,620449177,3264
1361560776,1982155352,4,3758,939.5,1361560748416,1361560748672,1982127768,1982128024,256
1361560776,1982155428,3,3530,1176.666667,1361560748339,1361560748595,1982127767,1982128023,256
1361560776,620470012,2,150,75,1361560761758,1361560774942,620455770,620468954,13184
1361560784,1982163400,8,416,52,1361560759312,1361560773264,1982138712,1982152664,13952
1361560811,1982191028,2,104,52,1361560809437,1361560810013,1982189465,1982190041,576
1361560812,1982191392,7,6847,978.1428571,1361560787670,1361560811286,1982167062,1982190678,23616
1361560816,1982195400,7,420,60,1361560788367,1361560791375,1982167767,1982170775,3008
1361560816,1982195400,7,420,60,1361560788367,1361560791375,1982167767,1982170775,3008
1361560819,1982198976,6,447,74.5,1361560811472,1361560815248,1982191448,1982195224,3776
1361560819,1982198980,2,104,52,1361560811213,1361560813517,1982191193,1982193497,2304
1361560829,620522204,1,75,75,1361560802120,1361560802120,620495324,620495324,0
1361560835,1982214980,2,158,79,1361560819341,1361560827405,1982199321,1982207385,8064
1361560840,1982219500,3,4278,1426,1361560813357,1361560826605,1982192857,1982206105,13248
1361560843,1982223016,107,12773,119.3738318,1361560710696,1361560842472,1982090712,1982222488,131776
1361560848,1982227488,7,1659,237,1361560821367,1361560839095,1982200855,1982218583,17728
1361560859,1982238956,110,140234,1274.854545,1361560723298,1361560858658,1982103254,1982238614,135360
1361560859,1982238996,2,158,79,1361560847227,1361560856699,1982227223,1982236695,9472
1361560867,1982247000,3,237,79,1361560859192,1361560862648,1982239192,1982242648,3456
1361560872,1982251528,1,1426,1426,1361560844176,1361560844176,1982223704,1982223704,0
1361560872,1982251608,1,79,79,1361560843902,1361560843902,1982223510,1982223510,0
1361560875,1982255036,460,635435,1381.380435,1361560713045,1361560872789,1982093081,1982252825,159744
1361560881,1982261104,1,48,48,1361560853710,1361560853710,1982233814,1982233814,0
1361560883,1982263312,2,127,63.5,1361560878528,1361560878528,1982258840,1982258840,0
1361560884,1982263320,2,158,79,1361560867935,1361560877087,1982247255,1982256407,9152
1361560884,1982263588,1,237,237,1361560857045,1361560857045,1982236633,1982236633,0
1361560900,1982279528,12,1052,87.66666667,1361560875855,1361560878863,1982255383,1982258391,3008
1361560904,1982283516,16,3408,213,1361560875993,1361560882265,1982255509,1982261781,6272
1361560904,1982283516,1,79,79,1361560876314,1361560876314,1982255830,1982255830,0
1361560904,1982283520,1,52,52,1361560876567,1361560876567,1982256087,1982256087,0
1361560904,1982283524,1,52,52,1361560877010,1361560877010,1982256534,1982256534,0
1361560904,1982283568,1,52,52,1361560879145,1361560879145,1982258713,1982258713,0
1361560904,1982283588,1,79,79,1361560876050,1361560876050,1982255638,1982255638,0
1361560904,1982283704,1,79,79,1361560878494,1361560878494,1982258198,1982258198,0
1361560907,1982287028,62,15410,248.5483871,1361560883353,1361560906713,1982263381,1982286741,23360
1361560908,1982287544,32,8954,279.8125,1361560880702,1361560898174,1982260246,1982277718,17472
1361560912,620606012,19,13661,719,1361560905375,1361560906335,620599387,620600347,960
1361560920,1982299552,10,3862,386.2,1361560893176,1361560894840,1982272728,1982274392,1664
1361560920,1982299636,1,237,237,1361560893026,1361560893026,1982272662,1982272662,0
1361560920,1982299640,12,3221,268.4166667,1361560893279,1361560897823,1982272919,1982277463,4544
1361560931,1982311288,30,9808,326.9333333,1361560923096,1361560924184,1982303384,1982304472,1088
1361560932,1982311840,13,5440,418.4615385,1361560905749,1361560907989,1982285589,1982287829,2240
1361560936,1982315840,67,89157,1330.701493,1361560910357,1361560912789,1982290197,1982292629,2432
1361560936,1982315928,14,11140,795.7142857,1361560909888,1361560932032,1982289816,1982311960,22144
1361560936,620630016,2,127,63.5,1361560933852,1361560933852,620627868,620627868,0
1361560939,1982318972,20,5174,258.7,1361560936275,1361560937683,1982316247,1982317655,1408
1361560939,1982319008,20,6540,327,1361560930351,1361560931375,1982310359,1982311383,1024
1361560944,620638016,42,49290,1173.571429,1361560942748,1361560943772,620636764,620637788,1024
1361560964,1982343836,23,23461,1020.043478,1361560939545,1361560940313,1982319381,1982320149,768
1361560964,1982343920,3,2032,677.3333333,1361560939399,1361560939399,1982319319,1982319319,0
1361560964,1982343920,39,47185,1209.871795,1361560939462,1361560940550,1982319382,1982320470,1088
1361560968,1982347932,27,27113,1004.185185,1361560940411,1361560940987,1982320343,1982320919,576
1361561011,1982391124,7,502,71.71428571,1361561002938,1361561010426,1982383062,1982390550,7488
1361561011,1982391132,6,427,71.16666667,1361561004658,1361561008626,1982384790,1982388758,3968
1361561019,1982399104,4,289,72.25,1361561013324,1361561015820,1982393428,1982395924,2496
1361561019,1982399204,5,368,73.6,1361561016423,1361561018727,1982396627,1982398931,2304
1361561019,1982399216,4,289,72.25,1361561017118,1361561018526,1982397334,1982398742,1408
1361561027,1982407092,2,158,79,1361561020440,1361561024088,1982400532,1982404180,3648
1361561027,1982407100,2,158,79,1361561021456,1361561026768,1982401556,1982406868,5312
1361561027,1982407136,2,158,79,1361561019118,1361561025774,1982399254,1982405910,6656
1361561040,1982419900,3,225,75,1361561013016,1361561038040,1982392916,1982417940,25024
1361561044,1982423964,2,150,75,1361561018330,1361561033882,1982398294,1982413846,15552
1361561051,1982431144,2,158,79,1361561031269,1361561045797,1982411413,1982425941,14528
1361561056,1982435900,7,1540,220,1361561028313,1361561045017,1982408213,1982424917,16704
1361561059,1982439112,2,158,79,1361561037252,1361561058308,1982417364,1982438420,21056
1361561060,1982439328,2,127,63.5,1361561059670,1361561059670,1982438998,1982438998,0
1361561064,1982443964,1,79,79,1361561039193,1361561039193,1982419157,1982419157,0
1361561067,1982447168,6,447,74.5,1361561059917,1361561064717,1982440085,1982444885,4800
1361561067,1982447168,6,447,74.5,1361561060107,1361561064779,1982440275,1982444947,4672
1361561067,1982447196,6,447,74.5,1361561060527,1361561065775,1982440723,1982445971,5248
1361561075,1982455160,6,427,71.16666667,1361561071188,1361561074772,1982451348,1982454932,3584
1361561083,1982463168,2,158,79,1361561071308,1361561082380,1982451476,1982462548,11072
1361561083,1982463208,2,158,79,1361561069730,1361561079906,1982449938,1982460114,10176
1361561083,1982463208,2,158,79,1361561069602,1361561079458,1982449810,1982459666,9856
1361561084,1982464236,6,450,75,1361561059014,1361561074182,1982439250,1982454418,15168
1361561088,1982468272,1,220,220,1361561061603,1361561061603,1982441875,1982441875,0
1361561092,1982472236,1,75,75,1361561064649,1361561064649,1982444885,1982444885,0
1361561093,1982472356,1,79,79,1361561066422,1361561066422,1982445778,1982445778,0
1361561097,1982476360,1,75,75,1361561071989,1361561071989,1982451349,1982451349,0
1361561101,1982480320,1,79,79,1361561075675,1361561075675,1982454995,1982454995,0
1361561105,1982484376,3,225,75,1361561079333,1361561101989,1982458709,1982481365,22656
1361561117,1982496340,1,75,75,1361561090823,1361561090823,1982470163,1982470163,0
1361561121,1982500332,1,220,220,1361561096465,1361561096465,1982475797,1982475797,0
1361561125,1982504292,1,79,79,1361561100086,1361561100086,1982479378,1982479378,0
1361561129,1982508292,1,79,79,1361561101240,1361561101240,1982480532,1982480532,0
1361561129,1982508368,1,79,79,1361561101035,1361561101035,1982480403,1982480403,0
1361561133,1982512308,1,79,79,1361561105382,1361561105382,1982484690,1982484690,0
1361561149,1982528432,1,75,75,1361561122154,1361561122154,1982501586,1982501586,0
1361561157,1982536396,1,75,75,1361561132240,1361561132240,1982511636,1982511636,0
1361561165,1982544480,1,79,79,1361561139258,1361561139258,1982518738,1982518738,0
1361561169,1982548420,1,79,79,1361561141621,1361561141621,1982521041,1982521041,0
1361561177,1982556424,1,79,79,1361561149491,1361561149491,1982528915,1982528915,0
1361561189,1982568436,1,220,220,1361561164197,1361561164197,1982543633,1982543633,0
1361561252,1982631340,4,277,69.25,1361561248389,1361561250565,1982627729,1982629905,2176
1361561269,1982648784,1,46,46,1361561242698,1361561242698,1982622482,1982622482,0
1361561271,1982650360,1,46,46,1361561243762,1361561243762,1982623122,1982623122,0
1361561271,1982650360,1,46,46,1361561243761,1361561243761,1982623121,1982623121,0
1361561281,1982660820,3,225,75,1361561252901,1361561270053,1982632721,1982649873,17152
1361561309,1982688808,1,220,220,1361561283890,1361561283890,1982663698,1982663698,0
1361561317,1982696956,1,75,75,1361561292701,1361561292701,1982672657,1982672657,0
1361561353,1982733012,1,356,356,1361561328547,1361561328547,1982708559,1982708559,0
1361561365,1982744920,1,75,75,1361561338302,1361561338302,1982718222,1982718222,0
1361561420,1982799356,6,427,71.16666667,1361561413045,1361561418229,1982792401,1982797585,5184
1361561433,1982813192,7,502,71.71428571,1361561406256,1361561426992,1982786448,1982807184,20736
1361561436,1982815312,2,150,75,1361561423838,1361561434910,1982803150,1982814222,11072
1361561444,1982823356,4,277,69.25,1361561439986,1361561442034,1982819342,1982821390,2048
1361561470,1982849536,3,225,75,1361561444670,1361561461566,1982824206,1982841102,16896
1361561474,1982853304,1,75,75,1361561449317,1361561449317,1982828621,1982828621,0
1361561482,1982861384,1,75,75,1361561456984,1361561456984,1982836368,1982836368,0
1361561510,1982889280,1,75,75,1361561484220,1361561484220,1982863500,1982863500,0
1361561518,1982897392,1,75,75,1361561492172,1361561492172,1982871564,1982871564,0
1361561526,1982905420,1,75,75,1361561501232,1361561501232,1982880652,1982880652,0
1361561554,1982933640,1,75,75,1361561528789,1361561528789,1982908429,1982908429,0
1361800565,2221944236,1,46,46,1361800538392,1361800538392,2221917628,2221917628,0
1361801531,2222910060,1,46,46,1361801505020,1361801505020,2222884080,2222884080,0
1361802184,2223563420,1,46,46,1361802159114,1361802159114,2223538534,2223538534,0
1361803159,2224537576,3,432,144,1361803131333,1361803137349,2224509909,2224515925,6016
1361803217,2224596112,1,46,46,1361803187245,1361803187245,2224566357,2224566357,0
1361803359,2224738084,2,92,46,1361803333127,1361803355143,2224712211,2224734227,22016
1361803555,2224934472,3,144,48,1361803527168,1361803536192,2224906640,2224915664,9024
1361803776,2225154728,3,432,144,1361803751143,1361803757159,2225129871,2225135887,6016
1361803983,2225361568,30,36632,1221.066667,1361803978626,1361803979138,2225357194,2225357706,512
1361803983,2225361572,6,514,85.66666667,1361803978880,1361803979776,2225357452,2225358348,896
1361804004,2225383104,4,481,120.25,1361803977067,1361803977131,2225356171,2225356235,64
1361804004,2225383108,16,3378,211.125,1361803977957,1361803984741,2225357065,2225363849,6784
1361804008,2225387104,39,29215,749.1025641,1361803980714,1361804007658,2225359818,2225386762,26944
1361804012,2225391144,28,31758,1134.214286,1361803987584,1361803988352,2225366728,2225367496,768
1361804015,2225393604,4,320,80,1361804012701,1361804013213,2225391305,2225391817,512
1361804015,2225393608,5,851,170.2,1361804009178,1361804009818,2225387786,2225388426,640
1361804015,2225393612,25,30156,1206.24,1361804009941,1361804012629,2225388553,2225391241,2688
1361804023,2225401632,4,399,99.75,1361804012544,1361804019456,2225391176,2225398088,6912
1361804023,2225401684,4,356,89,1361804012109,1361804019405,2225390793,2225398089,7296
1361804032,2225411152,1,52,52,1361804007097,1361804007097,2225386249,2225386249,0
1361804032,2225411188,1,185,185,1361804006294,1361804006294,2225385482,2225385482,0
1361804036,2225415228,21,8249,392.8095238,1361804010221,1361804035437,2225389449,2225414665,25216
1361804065,2225443492,5,3252,650.4,1361804039503,1361804039695,2225417995,2225418187,192
1361804109,2225487536,7,1323,189,1361804084832,1361804100192,2225463368,2225478728,15360
1361804137,2225515544,3,567,189,1361804110167,1361804130199,2225488711,2225508743,20032
1361804165,2225543628,1,189,189,1361804140098,1361804140098,2225518726,2225518726,0
1361804231,2225609840,4,184,46,1361804228591,1361804230319,2225607431,2225609159,1728
1361804239,2225617720,2,92,46,1361804232423,1361804236455,2225611143,2225615175,4032
1361804255,2225633848,2,92,46,1361804244262,1361804254246,2225623110,2225633094,9984
1361804287,2225665980,5,260,52,1361804279202,1361804282658,2225658182,2225661638,3456
1361804289,2225667752,1,46,46,1361804264390,1361804264390,2225643142,2225643142,0
1361805960,2227338856,1,60,60,1361805932867,1361805932867,2227311723,2227311723,0
1361806033,2227411616,16,2913,182.0625,1361806028083,1361806030067,2227406699,2227408683,1984
1361806033,2227411632,23,6929,301.2608696,1361806029220,1361806030948,2227407852,2227409580,1728
1361806040,2227419116,15,3226,215.0666667,1361806012799,1361806019263,2227391915,2227398379,6464
1361806041,2227419600,15,4775,318.3333333,1361806034500,1361806039748,2227413100,2227418348,5248
1361806041,2227419604,12,3519,293.25,1361806027455,1361806033791,2227406059,2227412395,6336
1361806041,2227419624,31,10183,328.483871,1361806030701,1361806034605,2227409325,2227413229,3904
1361806041,2227419668,14,4034,288.1428571,1361806034177,1361806039425,2227412845,2227418093,5248
1361806041,2227419676,14,3650,260.7142857,1361806027384,1361806033656,2227406060,2227412332,6272
1361806041,2227419684,13,3571,274.6923077,1361806039601,1361806040433,2227418285,2227419117,832
1361806041,865733912,10,4173,417.3,1361806033063,1361806034919,865725975,865727831,1856
1361806041,865733912,9,3418,379.7777778,1361806037671,1361806038247,865730583,865731159,576
1361806049,2227427632,13,3571,274.6923077,1361806039779,1361806041251,2227418411,2227419883,1472
1361806049,2227427672,32,6308,197.125,1361806038587,1361806042491,2227417259,2227421163,3904
1361806052,2227431136,8,2488,311,1361806027434,1361806028202,2227406570,2227407338,768
1361806052,2227431136,8,2488,311,1361806027433,1361806028393,2227406569,2227407529,960
1361806056,2227435092,26,5170,198.8461538,1361806030487,1361806032471,2227409579,2227411563,1984
1361806056,2227435132,8,3169,396.125,1361806028910,1361806032110,2227408042,2227411242,3200
1361806056,2227435136,34,25829,759.6764706,1361806029547,1361806042603,2227408683,2227421739,13056
1361806056,2227435136,14,9909,707.7857143,1361806029545,1361806042345,2227408681,2227421481,12800
1361806064,2227443048,44,53624,1218.727273,1361806036035,1361806036675,2227415083,2227415723,640
1361806065,2227443604,4,223,55.75,1361806058813,1361806058877,2227437417,2227437481,64
1361806065,2227443668,4,223,55.75,1361806058623,1361806058751,2227437291,2227437419,128
1361806080,2227459184,10,1004,100.4,1361806055610,1361806056122,2227434794,2227435306,512
1361806088,2227467228,8,7051,881.375,1361806062927,1361806078543,2227442155,2227457771,15616
1361806088,2227467228,12,8930,744.1666667,1361806062927,1361806084815,2227442155,2227464043,21888
1361806089,2227467624,32,12376,386.75,1361806083049,1361806084201,2227461673,2227462825,1152
1361806097,2227475664,23,9078,394.6956522,1361806088577,1361806089985,2227467241,2227468649,1408
1361806104,2227483280,24,31728,1322,1361806078299,1361806078299,2227457579,2227457579,0
1361806116,2227495180,6,4412,735.3333333,1361806089599,1361806089791,2227468779,2227468971,192
1361806116,2227495180,16,10638,664.875,1361806089660,1361806103228,2227468840,2227482408,13568
1361806144,2227523296,30,20150,671.6666667,1361806116555,1361806143563,2227495851,2227522859,27008
1361806153,2227531656,2,131,65.5,1361806152778,1361806152778,2227531434,2227531434,0
1361806153,2227531696,2,131,65.5,1361806152419,1361806152419,2227531115,2227531115,0
1361806169,2227547720,33,6992,211.8787879,1361806159305,1361806164745,2227538025,2227543465,5440
1361806172,2227551216,26,17799,684.5769231,1361806145114,1361806164506,2227524330,2227543722,19392
1361806177,2227555772,2,127,63.5,1361806174676,1361806174676,2227553448,2227553448,0
1361806185,2227563668,23,17082,742.6956522,1361806181758,1361806184318,2227560426,2227562986,2560
1361806193,2227571524,11,6602,600.1818182,1361806165323,1361806165835,2227543847,2227544359,512
1361806193,2227571676,61,28195,462.2131148,1361806181811,1361806189235,2227560487,2227567911,7424
1361806201,2227579768,2,92,46,1361806192857,1361806192857,2227571625,2227571625,0
1361806217,865909924,16,8295,518.4375,1361806214365,1361806215261,865907289,865908185,896
1361806217,865909936,14,8873,633.7857143,1361806214353,1361806215057,865907289,865907993,704
1361806217,2227595776,31,10689,344.8064516,1361806212304,1361806214288,2227591080,2227593064,1984
1361806221,2227599516,5,4065,813,1361806193106,1361806193298,2227571622,2227571814,192
1361806221,2227599572,19,16096,847.1578947,1361806193052,1361806220060,2227571624,2227598632,27008
1361806225,2227603584,11,7092,644.7272727,1361806198096,1361806198416,2227576680,2227577000,320
1361806233,2227611528,1,169,169,1361806206791,1361806206791,2227585319,2227585319,0
1361806241,2227619736,32,13158,411.1875,1361806232695,1361806236983,2227611431,2227615719,4288
1361806241,865933936,35,35871,1024.885714,1361806239569,1361806240529,865932505,865933465,960
1361806249,2227627572,19,13490,710,1361806224668,1361806244956,2227603240,2227623528,20288
1361806249,865941924,33,29060,880.6060606,1361806241372,1361806242524,865934296,865935448,1152
1361806249,865941928,45,45410,1009.111111,1361806239643,1361806241307,865932571,865934235,1664
1361806249,865941932,40,37331,933.275,1361806240535,1361806241751,865933467,865934683,1216
1361806265,2227643572,15,10940,729.3333333,1361806238811,1361806262427,2227617383,2227640999,23616
1361806265,2227643640,77,104280,1354.285714,1361806238934,1361806244950,2227617574,2227623590,6016
1361806273,2227651776,30,10338,344.6,1361806265294,1361806266830,2227644070,2227645606,1536
1361806277,2227655644,26,17960,690.7692308,1361806250260,1361806273492,2227628904,2227652136,23232
1361806281,865973928,14,7682,548.7142857,1361806272472,1361806274008,865965400,865966936,1536
1361806289,2227667916,2,131,65.5,1361806285315,1361806285315,2227664231,2227664231,0
1361806297,2227675656,4,2143,535.75,1361806272455,1361806272455,2227651111,2227651111,0
1361806297,2227675844,3,138,46,1361806295115,1361806295115,2227673959,2227673959,0
1361806297,2227675900,45,12106,269.0222222,1361806280594,1361806288914,2227659494,2227667814,8320
1361806321,2227699672,21,3909,186.1428571,1361806295288,1361806296632,2227673960,2227675304,1344
1361806321,2227699868,2,131,65.5,1361806318131,1361806318131,2227696999,2227696999,0
1361806345,2227723828,4,356,89,1361806335580,1361806343516,2227714408,2227722344,7936
1361806345,2227723832,25,26259,1050.36,1361806332886,1361806343510,2227711718,2227722342,10624
1361806353,2227731596,25,10802,432.08,1361806325058,1361806332162,2227703654,2227710758,7104
1361806353,2227731636,2,104,52,1361806327194,1361806327258,2227705830,2227705894,64
1361806353,2227731812,2,127,63.5,1361806349673,1361806349673,2227728485,2227728485,0
1361806357,2227735568,5,843,168.6,1361806329182,1361806330718,2227707750,2227709286,1536
1361806369,2227747896,65,82056,1262.4,1361806361047,1361806367959,2227739943,2227746855,6912
1361806369,2227747944,14,7343,524.5,1361806360807,1361806362855,2227739751,2227741799,2048
1361806369,2227747948,4,722,180.5,1361806357793,1361806363873,2227736741,2227742821,6080
1361806369,2227747948,4,504,126,1361806357921,1361806365985,2227736869,2227744933,8064
1361806369,2227747972,2,127,63.5,1361806366473,1361806366473,2227745445,2227745445,0
1361806369,2227747976,131,171939,1312.51145,1361806358918,1361806367942,2227737894,2227746918,9024
1361806377,2227755864,10,4992,499.2,1361806363127,1361806370039,2227741991,2227748903,6912
1361806377,2227755892,60,72512,1208.533333,1361806360793,1361806370009,2227739685,2227748901,9216
1361806377,2227755924,14,6984,498.8571429,1361806358201,1361806370041,2227737125,2227748965,11840
1361806377,2227755936,65,69390,1067.538462,1361806372272,1361806376240,2227751208,2227755176,3968
1361806381,2227759716,3,277,92.33333333,1361806356427,1361806356491,2227735143,2227735207,64
1361806385,2227763864,269,309445,1150.35316,1361806361335,1361806380343,2227740199,2227759207,19008
1361806385,2227763868,8,1733,216.625,1361806370096,1361806378352,2227748964,2227757220,8256
1361806385,2227763892,35,32657,933.0571429,1361806371801,1361806380313,2227750693,2227759205,8512
1361806385,2227763908,10,2347,234.7,1361806370059,1361806378315,2227748967,2227757223,8256
1361806385,2227763908,12,6258,521.5,1361806370059,1361806378315,2227748967,2227757223,8256
1361806385,2227763952,241,291330,1208.838174,1361806371679,1361806382239,2227750631,2227761191,10560
1361806385,2227763952,72,88175,1224.652778,1361806364316,1361806378268,2227743268,2227757220,13952
1361806393,2227771852,462,635204,1374.900433,1361806176576,1361806392384,2227555428,2227771236,215808
1361806393,2227771904,730,988560,1354.191781,1361806032847,1361806392655,2227411751,2227771559,359808
1361806393,2227771936,16,6806,425.375,1361806371564,1361806386348,2227750500,2227765284,14784
1361806401,2227779856,26,25832,993.5384615,1361806393022,1361806400382,2227771878,2227779238,7360
1361806401,2227779856,137,184701,1348.182482,1361806393149,1361806400445,2227772005,2227779301,7296
1361806401,2227779896,11,4905,445.9090909,1361806391830,1361806400406,2227770726,2227779302,8576
1361806401,2227779896,80,92341,1154.2625,1361806392021,1361806400341,2227770917,2227779237,8320
1361806401,2227779900,15,10394,692.9333333,1361806392978,1361806400402,2227771878,2227779302,7424
1361806401,2227779936,16,12006,750.375,1361806390958,1361806398318,2227769894,2227777254,7360
1361806417,2227795904,2,131,65.5,1361806416269,1361806416269,2227795173,2227795173,0
1361806441,2227820040,10,3891,389.1,1361806439939,1361806440707,2227818979,2227819747,768
1361806449,2227828020,4,320,80,1361806446299,1361806446427,2227825319,2227825447,128
1361806449,2227828048,7,1472,210.2857143,1361806439998,1361806444030,2227819046,2227823078,4032
1361806449,2227828092,25,30155,1206.2,1361806444051,1361806446099,2227823143,2227825191,2048
1361806457,2227836104,4,356,89,1361806445893,1361806452165,2227824997,2227831269,6272
1361806457,2227836108,4,399,99.75,1361806446143,1361806454207,2227825251,2227833315,8064
1361806473,2227852040,4,356,89,1361806459203,1361806466307,2227838243,2227845347,7104
1361806473,2227852100,24,25228,1051.166667,1361806458249,1361806466249,2227837349,2227845349,8000
1361806477,2227855728,15,10836,722.4,1361806450557,1361806457405,2227829285,2227836133,6848
1361806481,2227859680,3,745,248.3333333,1361806455852,1361806458604,2227834532,2227837284,2752
1361806529,2227908040,26,31205,1200.192308,1361806528646,1361806528710,2227907686,2227907750,64
1361806529,2227908084,44,57668,1310.636364,1361806527641,1361806527833,2227906725,2227906917,192
1361806529,2227908084,8,4306,538.25,1361806527768,1361806528216,2227906852,2227907300,448
1361806529,2227908088,7,4276,610.8571429,1361806528210,1361806528338,2227907298,2227907426,128
1361806529,2227908088,24,25696,1070.666667,1361806528338,1361806528594,2227907426,2227907682,256
1361806529,2227908124,25,30248,1209.92,1361806528176,1361806528240,2227907300,2227907364,64
1361806529,2227908124,5,931,186.2,1361806528175,1361806528239,2227907299,2227907363,64
1361806529,2227908124,5,1160,232,1361806528239,1361806528303,2227907363,2227907427,64
1361806529,2227908124,5,758,151.6,1361806528239,1361806528303,2227907363,2227907427,64
1361806533,2227911772,1,168,168,1361806506450,1361806506450,2227885222,2227885222,0
1361806537,866229976,5,2775,555,1361806530989,1361806530989,866223965,866223965,0
1361806537,866229976,4,774,193.5,1361806531116,1361806531180,866224092,866224156,64
1361806537,866229980,8,4097,512.125,1361806528103,1361806535975,866221083,866228955,7872
1361806537,866229996,4,1489,372.25,1361806530838,1361806530902,866223834,866223898,64
1361806537,2227916064,7,5082,726,1361806532589,1361806532653,2227911653,2227911717,64
1361806537,2227916064,16,18089,1130.5625,1361806532716,1361806532844,2227911780,2227911908,128
1361806537,2227916064,4,409,102.25,1361806532843,1361806533035,2227911907,2227912099,192
1361806537,2227916068,5,2689,537.8,1361806533161,1361806533673,2227912229,2227912741,512
1361806537,2227916068,4,437,109.25,1361806529702,1361806529830,2227908770,2227908898,128
1361806537,2227916076,4,908,227,1361806531103,1361806531167,2227910179,2227910243,64
1361806537,2227916076,18,20669,1148.277778,1361806531167,1361806531231,2227910243,2227910307,64
1361806537,2227916076,7,5082,726,1361806531167,1361806531231,2227910243,2227910307,64
1361806537,2227916080,4,409,102.25,1361806531357,1361806531485,2227910437,2227910565,128
1361806537,2227916116,10,8761,876.1,1361806535030,1361806535670,2227914146,2227914786,640
1361806537,2227916116,7,4738,676.8571429,1361806531958,1361806533750,2227911074,2227912866,1792
1361806537,2227916116,19,22786,1199.263158,1361806532022,1361806532150,2227911138,2227911266,128
1361806537,2227916120,5,2821,564.2,1361806532212,1361806532340,2227911332,2227911460,128
1361806537,2227916120,4,734,183.5,1361806527475,1361806533619,2227906595,2227912739,6144
1361806537,2227916124,67,80366,1199.492537,1361806528238,1361806529646,2227907362,2227908770,1408
1361806537,2227916132,11,7116,646.9090909,1361806529321,1361806533737,2227908453,2227912869,4416
1361806537,2227916132,9,8166,907.3333333,1361806529703,1361806529767,2227908835,2227908899,64
1361806537,2227916132,37,41928,1133.189189,1361806529831,1361806530151,2227908963,2227909283,320
1361806537,2227916132,22,24327,1105.772727,1361806529894,1361806530150,2227909026,2227909282,256
1361806537,2227916152,33,36172,1096.121212,1361806530131,1361806531987,2227909283,2227911139,1856
1361806537,2227916152,26,30689,1180.346154,1361806530194,1361806530514,2227909346,2227909666,320
1361806537,2227916156,5,935,187,1361806530639,1361806530767,2227909795,2227909923,128
1361806537,2227916160,5,2815,563,1361806530828,1361806531020,2227909988,2227910180,192
1361806537,2227916168,17,19815,1165.588235,1361806531972,1361806532100,2227911140,2227911268,128
1361806537,2227916168,18,20524,1140.222222,1361806527746,1361806535618,2227906914,2227914786,7872
1361806537,2227916172,16,16581,1036.3125,1361806528065,1361806535617,2227907237,2227914789,7552
1361806537,2227916172,59,67331,1141.20339,1361806528255,1361806529727,2227907427,2227908899,1472
1361806537,2227916172,98,115627,1179.867347,1361806528255,1361806530239,2227907427,2227909411,1984
1361806545,866237960,15,17199,1146.6,1361806538042,1361806544378,866231002,866237338,6336
1361806545,866237960,18,20245,1124.722222,1361806538045,1361806544381,866231005,866237341,6336
1361806545,866237968,8,2356,294.5,1361806528821,1361806538485,866221789,866231453,9664
1361806545,2227924096,4,576,144,1361806533646,1361806539982,2227912742,2227919078,6336
1361806545,2227924096,6,2436,406,1361806533709,1361806539981,2227912805,2227919077,6272
1361806545,2227924096,4,1038,259.5,1361806533709,1361806539981,2227912805,2227919077,6272
1361806545,2227924096,5,657,131.4,1361806538250,1361806538314,2227917346,2227917410,64
1361806545,2227924100,4,672,168,1361806538631,1361806538695,2227917731,2227917795,64
1361806545,2227924104,3,682,227.3333333,1361806539012,1361806539076,2227918116,2227918180,64
1361806545,2227924144,157,194897,1241.382166,1361806529370,1361806544346,2227908514,2227923490,14976
1361806545,2227924144,4,573,143.25,1361806537692,1361806544028,2227916836,2227923172,6336
1361806545,2227924148,11,6464,587.6363636,1361806538070,1361806539350,2227917218,2227918498,1280
1361806545,2227924168,4,468,117,1361806538242,1361806538306,2227917410,2227917474,64
1361806545,2227924168,13,13543,1041.769231,1361806538242,1361806538306,2227917410,2227917474,64
1361806545,2227924168,4,652,163,1361806539010,1361806539138,2227918178,2227918306,128
1361806545,2227924172,4,1095,273.75,1361806539200,1361806539328,2227918372,2227918500,128
1361806553,2227931832,1,76,76,1361806524757,1361806524757,2227903589,2227903589,0
1361806553,2227932148,4,267,66.75,1361806539222,1361806546006,2227918370,2227925154,6784
1361806561,2227940084,23,6654,289.3043478,1361806558744,1361806560024,2227937828,2227939108,1280
1361806561,2227940156,3,138,46,1361806560144,1361806560144,2227939300,2227939300,0
1361806569,2227948120,12,3348,279,1361806560178,1361806561074,2227939298,2227940194,896
1361806573,2227951916,1,52,52,1361806546238,1361806546238,2227925154,2227925154,0
1361806613,2227991964,1,46,46,1361806588494,1361806588494,2227967458,2227967458,0
1361806649,2228027960,1,46,46,1361806622928,1361806622928,2228001888,2228001888,0
1361806669,2228047912,126,160327,1272.436508,1361806359681,1361806364353,2227738593,2227743265,4672
1361806681,2228060288,3,272,90.66666667,1361806655433,1361806655945,2228034721,2228035233,512
1361806721,2228100288,1,46,46,1361806693000,1361806693000,2228072288,2228072288,0
1361806721,2228100408,1,46,46,1361806696720,1361806696720,2228076128,2228076128,0
1361806722,2228100568,3,138,46,1361806697626,1361806719258,2228076194,2228097826,21632
1361806722,2228100612,5,851,170.2,1361806716907,1361806717867,2228095519,2228096479,960
1361806722,2228100620,4,412,103,1361806718052,1361806718180,2228096672,2228096800,128
1361806722,2228100624,3,138,46,1361806698656,1361806719904,2228077280,2228098528,21248
1361806722,2228100652,26,30443,1170.884615,1361806717060,1361806718212,2228095712,2228096864,1152
1361806729,2228108452,4,399,99.75,1361806717222,1361806724518,2228096674,2228103970,7296
1361806730,2228108544,4,818,204.5,1361806729135,1361806729199,2228107679,2228107743,64
1361806737,866429960,20,18391,919.55,1361806726974,1361806735230,866419934,866428190,8256
1361806737,866429960,8,5664,708,1361806731069,1361806731069,866424029,866424029,0
1361806737,866429960,140,173661,1240.435714,1361806727803,1361806730363,866420763,866423323,2560
1361806737,866429960,64,82288,1285.75,1361806727931,1361806730171,866420891,866423131,2240
1361806737,866429964,20,11926,596.3,1361806729975,1361806731127,866422939,866424091,1152
1361806737,866429972,105,136542,1300.4,1361806727793,1361806730417,866420765,866423389,2624
1361806737,866429972,5,1271,254.2,1361806729584,1361806729840,866422556,866422812,256
1361806737,866429984,4,648,162,1361806730597,1361806730661,866423581,866423645,64
1361806738,2228116536,6,4058,676.3333333,1361806733944,1361806734072,2228112480,2228112608,128
1361806738,2228116536,5,808,161.6,1361806733944,1361806734072,2228112480,2228112608,128
1361806738,2228116540,18,21199,1177.722222,1361806730099,1361806737459,2228108639,2228115999,7360
1361806738,2228116540,4,350,87.5,1361806730230,1361806730294,2228108770,2228108834,64
1361806738,2228116540,6,640,106.6666667,1361806730293,1361806730357,2228108833,2228108897,64
1361806738,2228116544,4,843,210.75,1361806734514,1361806734578,2228113058,2228113122,64
1361806738,2228116544,9,4418,490.8888889,1361806734514,1361806735154,2228113058,2228113698,640
1361806738,2228116552,5,896,179.2,1361806735335,1361806735399,2228113887,2228113951,64
1361806738,2228116584,25,30849,1233.96,1361806736265,1361806736393,2228114849,2228114977,128
1361806738,2228116584,17,14415,847.9411765,1361806733193,1361806734089,2228111777,2228112673,896
1361806738,2228116588,10,7648,764.8,1361806736323,1361806736515,2228114911,2228115103,192
1361806738,2228116592,7,3948,564,1361806733699,1361806733891,2228112291,2228112483,192
1361806738,2228116592,9,7583,842.5555556,1361806733698,1361806733890,2228112290,2228112482,192
1361806738,2228116592,12,12684,1057,1361806729858,1361806729922,2228108450,2228108514,64
1361806738,2228116592,5,807,161.4,1361806734016,1361806734144,2228112608,2228112736,128
1361806738,2228116592,6,640,106.6666667,1361806730175,1361806730239,2228108767,2228108831,64
1361806738,2228116600,6,1721,286.8333333,1361806731192,1361806731256,2228109792,2228109856,64
1361806738,2228116624,28,30113,1075.464286,1361806723680,1361806733344,2228102304,2228111968,9664
1361806738,2228116628,7,3817,545.2857143,1361806735390,1361806735582,2228114018,2228114210,192
1361806738,2228116632,47,61657,1311.851064,1361806728026,1361806735322,2228106658,2228113954,7296
1361806738,2228116632,29,31665,1091.896552,1361806733081,1361806734105,2228111713,2228112737,1024
1361806738,2228116632,10,7724,772.4,1361806736279,1361806736471,2228114911,2228115103,192
1361806738,2228116636,5,548,109.6,1361806717462,1361806731350,2228096098,2228109986,13888
1361806745,866437968,5,1613,322.6,1361806730997,1361806737205,866423965,866430173,6208
1361806745,866437968,11,10406,946,1361806739635,1361806739955,866432603,866432923,320
1361806745,866437972,4,827,206.75,1361806732977,1361806739185,866425949,866432157,6208
1361806745,866437980,35,42844,1224.114286,1361806735274,1361806743210,866428254,866436190,7936
1361806745,866437980,53,65754,1240.641509,1361806727915,1361806741227,866420895,866434207,13312
1361806745,866437992,4,464,116,1361806738075,1361806738139,866431067,866431131,64
1361806745,866437996,5,1341,268.2,1361806730074,1361806737178,866423070,866430174,7104
1361806745,2228124436,14,7682,548.7142857,1361806718389,1361806721333,2228097825,2228100769,2944
1361806745,2228124464,6,884,147.3333333,1361806719064,1361806722712,2228098528,2228102176,3648
1361806746,2228124516,4,912,228,1361806745742,1361806745742,2228124258,2228124258,0
1361806746,2228124516,7,2207,315.2857143,1361806741963,1361806742283,2228120479,2228120799,320
1361806746,2228124520,5,620,124,1361806742026,1361806742282,2228120546,2228120802,256
1361806746,2228124520,4,592,148,1361806738378,1361806738442,2228116898,2228116962,64
1361806746,2228124520,4,725,181.25,1361806738442,1361806738570,2228116962,2228117090,128
1361806746,2228124520,7,1174,167.7142857,1361806738505,1361806738697,2228117025,2228117217,192
1361806746,2228124520,5,724,144.8,1361806738569,1361806738953,2228117089,2228117473,384
1361806746,2228124520,22,25890,1176.818182,1361806738696,1361806738760,2228117216,2228117280,64
1361806746,2228124524,14,5429,387.7857143,1361806739142,1361806740230,2228117666,2228118754,1088
1361806746,2228124524,11,5821,529.1818182,1361806739460,1361806740164,2228117984,2228118688,704
1361806746,2228124528,47,61951,1318.106383,1361806731777,1361806739457,2228110305,2228117985,7680
1361806746,2228124528,12,3280,273.3333333,1361806740224,1361806741184,2228118752,2228119712,960
1361806746,2228124560,5,1067,213.4,1361806745120,1361806745504,2228123680,2228124064,384
1361806746,2228124560,7,915,130.7142857,1361806745120,1361806745440,2228123680,2228124000,320
1361806746,2228124560,7,891,127.2857143,1361806745439,1361806745695,2228123999,2228124255,256
1361806746,2228124564,21,24465,1165,1361806737886,1361806745438,2228116450,2228124002,7552
1361806746,2228124564,6,729,121.5,1361806741916,1361806742172,2228120480,2228120736,256
1361806746,2228124568,5,673,134.6,1361806738968,1361806739096,2228117536,2228117664,128
1361806746,2228124572,20,12905,645.25,1361806739988,1361806745044,2228118560,2228123616,5056
1361806746,2228124596,4,784,196,1361806735355,1361806741435,2228113951,2228120031,6080
1361806746,2228124604,4,687,171.75,1361806744436,1361806744564,2228123040,2228123168,128
1361806746,2228124608,10,1112,111.2,1361806744495,1361806745071,2228123103,2228123679,576
1361806746,2228124608,2,127,63.5,1361806744945,1361806744945,2228123553,2228123553,0
1361806746,2228124608,5,1067,213.4,1361806745073,1361806745457,2228123681,2228124065,384
1361806746,2228124608,19,6816,358.7368421,1361806736817,1361806737969,2228115425,2228116577,1152
1361806746,2228124608,20,6916,345.8,1361806736881,1361806738033,2228115489,2228116641,1152
1361806748,2228126640,7,1013,144.7142857,1361806745359,1361806745615,2228123999,2228124255,256
1361806748,2228126640,7,887,126.7142857,1361806745359,1361806745615,2228123999,2228124255,256
1361806753,866445964,35,42497,1214.2,1361806746359,1361806746935,866439323,866439899,576
1361806754,2228132484,23,26646,1158.521739,1361806737838,1361806747566,2228116322,2228126050,9728
1361806754,2228132484,4,647,161.75,1361806745773,1361806745837,2228124257,2228124321,64
1361806754,2228132484,5,1168,233.6,1361806745965,1361806746093,2228124449,2228124577,128
1361806754,2228132484,19,9638,507.2631579,1361806745901,1361806746605,2228124385,2228125089,704
1361806754,2228132484,8,1103,137.875,1361806741932,1361806749548,2228120416,2228128032,7616
1361806754,2228132484,10,4452,445.2,1361806746219,1361806746859,2228124703,2228125343,640
1361806754,2228132488,4,490,122.5,1361806750376,1361806750504,2228128864,2228128992,128
1361806754,2228132488,4,726,181.5,1361806739111,1361806747559,2228117599,2228126047,8448
1361806754,2228132496,5,673,134.6,1361806739874,1361806747554,2228118370,2228126050,7680
1361806754,2228132528,56,68308,1219.785714,1361806736832,1361806747456,2228115360,2228125984,10624
1361806754,2228132532,19,9640,507.3684211,1361806745853,1361806746557,2228124385,2228125089,704
1361806754,2228132532,4,647,161.75,1361806745725,1361806745853,2228124257,2228124385,128
1361806754,2228132532,4,647,161.75,1361806745789,1361806745853,2228124321,2228124385,64
1361806754,2228132532,4,638,159.5,1361806745852,1361806745980,2228124384,2228124512,128
1361806754,2228132532,5,1067,213.4,1361806741820,1361806749500,2228120352,2228128032,7680
1361806754,2228132532,5,653,130.6,1361806746107,1361806746235,2228124639,2228124767,128
1361806754,2228132536,5,453,90.6,1361806750202,1361806750266,2228128738,2228128802,64
1361806754,2228132536,4,678,169.5,1361806746553,1361806746617,2228125089,2228125153,64
1361806754,2228132536,10,6112,611.2,1361806750456,1361806750904,2228128992,2228129440,448
1361806754,2228132536,10,4892,489.2,1361806750392,1361806750904,2228128928,2228129440,512
1361806754,2228132536,9,5759,639.8888889,1361806750647,1361806751095,2228129183,2228129631,448
1361806754,2228132564,22,22328,1014.909091,1361806743325,1361806751517,2228121889,2228130081,8192
1361806754,2228132576,34,39715,1168.088235,1361806745042,1361806753554,2228123618,2228132130,8512
1361806754,2228132576,7,899,128.4285714,1361806745552,1361806745872,2228124128,2228124448,320
1361806761,866453996,9,1592,176.8888889,1361806746842,1361806753242,866439838,866446238,6400
1361806761,866454012,4,858,214.5,1361806749451,1361806757323,866442463,866450335,7872
1361806761,866454012,6,3884,647.3333333,1361806749450,1361806757322,866442462,866450334,7872
1361806762,2228140600,4,1151,287.75,1361806748473,1361806755577,2228127073,2228134177,7104
1361806762,2228140620,4,502,125.5,1361806749412,1361806755556,2228128032,2228134176,6144
1361806762,2228140624,9,5362,595.7777778,1361806749792,1361806755872,2228128416,2228134496,6080
1361806769,2228148448,1,46,46,1361806743591,1361806743591,2228123039,2228123039,0
1361806770,2228148532,5,453,90.6,1361806764922,1361806764986,2228143454,2228143518,64
1361806786,2228164548,5,453,90.6,1361806779946,1361806780074,2228158494,2228158622,128
1361806802,2228180636,5,453,90.6,1361806794834,1361806794898,2228173470,2228173534,64
1361806818,2228196616,5,453,90.6,1361806809833,1361806809897,2228188449,2228188513,64
1361806826,2228204624,5,453,90.6,1361806824864,1361806824992,2228203488,2228203616,128
1361806834,2228212636,1,174,174,1361806806613,1361806806613,2228185249,2228185249,0
1361806842,2228220652,5,453,90.6,1361806839813,1361806839877,2228218465,2228218529,64
1361806846,2228224656,65,66545,1023.769231,1361806819201,1361806823617,2228197857,2228202273,4416
1361806858,2228236696,5,453,90.6,1361806854809,1361806855193,2228233505,2228233889,384
1361806874,2228252592,4,382,95.5,1361806866877,1361806873021,2228245469,2228251613,6144
1361806890,2228268592,40,48766,1219.15,1361806886205,1361806886525,2228264797,2228265117,320
1361806890,2228268644,4,592,148,1361806886348,1361806886476,2228264992,2228265120,128
1361806890,2228268680,20,12391,619.55,1361806887718,1361806888294,2228266398,2228266974,576
1361806890,2228268688,4,235,58.75,1361806888351,1361806888351,2228267039,2228267039,0
1361806898,2228276592,15,9905,660.3333333,1361806886271,1361806893247,2228264863,2228271839,6976
1361806898,2228276592,5,1154,230.8,1361806886335,1361806893247,2228264927,2228271839,6912
1361806898,2228276600,23,27461,1193.956522,1361806891829,1361806891957,2228270429,2228270557,128
1361806898,2228276628,108,141348,1308.777778,1361806885145,1361806895129,2228263773,2228273757,9984
1361806898,2228276632,24,27399,1141.625,1361806885846,1361806893206,2228264478,2228271838,7360
1361806898,2228276636,40,38351,958.775,1361806893842,1361806894930,2228272478,2228273566,1088
1361806898,2228276640,25,31363,1254.52,1361806886159,1361806893199,2228264799,2228271839,7040
1361806898,2228276640,26,24773,952.8076923,1361806886221,1361806891661,2228264861,2228270301,5440
1361806898,2228276668,16,5966,372.875,1361806894705,1361806895409,2228273373,2228274077,704
1361806898,2228276672,4,1502,375.5,1361806895085,1361806895149,2228273757,2228273821,64
1361806898,2228276676,47,58760,1250.212766,1361806891624,1361806891880,2228270300,2228270556,256
1361806898,2228276676,9,7661,851.2222222,1361806891564,1361806896812,2228270240,2228275488,5248
1361806898,2228276676,18,21199,1177.722222,1361806891691,1361806891819,2228270367,2228270495,128
1361806898,2228276676,5,669,133.8,1361806891818,1361806892202,2228270494,2228270878,384
1361806898,2228276680,23,27680,1203.478261,1361806895528,1361806895592,2228274208,2228274272,64
1361806898,2228276680,41,54056,1318.439024,1361806892327,1361806892583,2228271007,2228271263,256
1361806898,2228276680,15,16786,1119.066667,1361806892327,1361806892583,2228271007,2228271263,256
1361806898,2228276680,4,957,239.25,1361806895591,1361806895719,2228274271,2228274399,128
1361806898,2228276680,4,770,192.5,1361806884965,1361806891109,2228263645,2228269789,6144
1361806898,2228276684,20,23067,1153.35,1361806895972,1361806896100,2228274656,2228274784,128
1361806898,2228276688,21,23949,1140.428571,1361806885791,1361806891679,2228264479,2228270367,5888
1361806898,2228276896,15,1911,127.4,1361806871695,1361806874703,2228250591,2228253599,3008
1361806898,2228276896,31,8216,265.0322581,1361806872013,1361806875213,2228250909,2228254109,3200
1361806905,866597956,7,4704,672,1361806903618,1361806903682,866596574,866596638,64
1361806905,866597956,9,7656,850.6666667,1361806897408,1361806897472,866590364,866590428,64
1361806905,866597960,6,3618,603,1361806902781,1361806903037,866595741,866595997,256
1361806905,866597960,4,893,223.25,1361806903165,1361806903293,866596125,866596253,128
1361806906,2228284600,4,697,174.25,1361806898357,1361806898549,2228276957,2228277149,192
1361806906,2228284600,5,673,134.6,1361806898357,1361806898421,2228276957,2228277021,64
1361806906,2228284604,27,24651,913,1361806898675,1361806898803,2228277279,2228277407,128
1361806906,2228284604,4,653,163.25,1361806902768,1361806902832,2228281372,2228281436,64
1361806906,2228284608,7,3026,432.2857143,1361806894704,1361806901232,2228273312,2228279840,6528
1361806906,2228284608,38,49726,1308.578947,1361806903149,1361806903405,2228281757,2228282013,256
1361806906,2228284608,5,1012,202.4,1361806903085,1361806903277,2228281693,2228281885,192
1361806906,2228284608,11,7895,717.7272727,1361806903213,1361806903405,2228281821,2228282013,192
1361806906,2228284608,4,899,224.75,1361806903277,1361806903405,2228281885,2228282013,128
1361806906,2228284612,4,1400,350,1361806900521,1361806900585,2228279133,2228279197,64
1361806906,2228284612,4,703,175.75,1361806903849,1361806903977,2228282461,2228282589,128
1361806906,2228284616,12,1820,151.6666667,1361806901158,1361806903718,2228279774,2228282334,2560
1361806906,2228284640,6,3024,504,1361806904271,1361806904527,2228282911,2228283167,256
1361806906,2228284640,4,794,198.5,1361806904463,1361806904655,2228283103,2228283295,192
1361806906,2228284640,5,732,146.4,1361806904398,1361806904526,2228283038,2228283166,128
1361806906,2228284640,3,722,240.6666667,1361806901646,1361806901774,2228280286,2228280414,128
1361806906,2228284640,6,3870,645,1361806901710,1361806901966,2228280350,2228280606,256
1361806906,2228284640,10,6230,623,1361806904525,1361806904717,2228283165,2228283357,192
1361806906,2228284644,3,443,147.6666667,1361806904648,1361806904776,2228283292,2228283420,128
1361806906,2228284644,7,4101,585.8571429,1361806901832,1361806902856,2228280476,2228281500,1024
1361806906,2228284648,30,26071,869.0333333,1361806893765,1361806901253,2228272413,2228279901,7488
1361806906,2228284648,7,3530,504.2857143,1361806905607,1361806905863,2228284255,2228284511,256
1361806906,2228284652,4,1134,283.5,1361806897988,1361806898052,2228276640,2228276704,64
1361806906,2228284652,9,4677,519.6666667,1361806898371,1361806898947,2228277023,2228277599,576
1361806906,2228284656,4,1018,254.5,1361806902910,1361806903038,2228281566,2228281694,128
1361806906,2228284656,6,1630,271.6666667,1361806903038,1361806903102,2228281694,2228281758,64
1361806906,2228284676,4,957,239.25,1361806903081,1361806903145,2228281757,2228281821,64
1361806906,2228284680,12,12684,1057,1361806891432,1361806899112,2228270112,2228277792,7680
1361806906,2228284680,10,4638,463.8,1361806899559,1361806900327,2228278239,2228279007,768
1361806906,2228284680,9,6180,686.6666667,1361806891495,1361806901223,2228270175,2228279903,9728
1361806906,2228284680,5,1021,204.2,1361806903397,1361806903781,2228282077,2228282461,384
1361806906,2228284680,4,1589,397.25,1361806900005,1361806900261,2228278685,2228278941,256
1361806906,2228284684,11,7896,717.8181818,1361806900388,1361806900452,2228279072,2228279136,64
1361806906,2228284684,7,1976,282.2857143,1361806903651,1361806903843,2228282335,2228282527,192
1361806906,2228284684,5,1419,283.8,1361806903778,1361806903906,2228282462,2228282590,128
1361806906,2228284688,9,8166,907.3333333,1361806901023,1361806901151,2228279711,2228279839,128
1361806906,2228284688,4,694,173.5,1361806904222,1361806904350,2228282910,2228283038,128
1361806906,2228284688,47,61952,1318.12766,1361806892829,1361806901149,2228271517,2228279837,8320
1361806906,2228284688,11,7898,718,1361806904221,1361806904413,2228282909,2228283101,192
1361806906,2228284688,5,1277,255.4,1361806901533,1361806901597,2228280221,2228280285,64
1361806906,2228284692,13,7995,615,1361806904539,1361806904667,2228283231,2228283359,128
1361806906,2228284692,10,3693,369.3,1361806904666,1361806905498,2228283358,2228284190,832
1361806906,2228284692,20,10381,519.05,1361806904730,1361806905562,2228283422,2228284254,832
1361806906,2228284692,7,3930,561.4285714,1361806904793,1361806905241,2228283485,2228283933,448
1361806906,2228284692,9,4919,546.5555556,1361806904921,1361806905241,2228283613,2228283933,320
1361806906,2228284696,19,4718,248.3157895,1361806893719,1361806901143,2228272415,2228279839,7424
1361806906,2228284696,20,4656,232.8,1361806893719,1361806901143,2228272415,2228279839,7424
1361806906,2228284696,4,1018,254.5,1361806905238,1361806905430,2228283934,2228284126,192
1361806906,2228284696,4,987,246.75,1361806905238,1361806905494,2228283934,2228284190,256
1361806906,2228284944,1,64,64,1361806881118,1361806881118,2228260062,2228260062,0
1361806913,866605956,7,3687,526.7142857,1361806908545,1361806908801,866601501,866601757,256
1361806913,866605956,29,35912,1238.344828,1361806908673,1361806908801,866601629,866601757,128
1361806913,866605956,7,4950,707.1428571,1361806908800,1361806908864,866601756,866601820,64
1361806913,866605956,4,571,142.75,1361806905344,1361806905472,866598300,866598428,128
1361806913,866605960,6,3405,567.5,1361806905408,1361806905728,866598368,866598688,320
1361806913,866605960,55,72281,1314.2,1361806909503,1361806910271,866602463,866603231,768
1361806913,866605960,7,4950,707.1428571,1361806909695,1361806909759,866602655,866602719,64
1361806913,866605960,9,1594,177.1111111,1361806899389,1361806907133,866592349,866600093,7744
1361806913,866605964,4,571,142.75,1361806908410,1361806908538,866601374,866601502,128
1361806913,866605964,4,571,142.75,1361806911866,1361806911994,866604830,866604958,128
1361806913,866605964,4,571,142.75,1361806908410,1361806908538,866601374,866601502,128
1361806913,866605964,6,3493,582.1666667,1361806905721,1361806906041,866598685,866599005,320
1361806913,866605964,22,25890,1176.818182,1361806905785,1361806905913,866598749,866598877,128
1361806913,866605968,4,571,142.75,1361806910391,1361806910519,866603359,866603487,128
1361806914,2228292616,8,3766,470.75,1361806905896,1361806906024,2228284512,2228284640,128
1361806914,2228292616,12,4818,401.5,1361806906152,1361806906664,2228284768,2228285280,512
1361806914,2228292616,4,897,224.25,1361806906152,1361806906280,2228284768,2228284896,128
1361806914,2228292616,23,28281,1229.608696,1361806905896,1361806906024,2228284512,2228284640,128
1361806914,2228292616,3,648,216,1361806906023,1361806906087,2228284639,2228284703,64
1361806914,2228292616,23,28598,1243.391304,1361806906022,1361806906214,2228284638,2228284830,192
1361806914,2228292620,36,46466,1290.722222,1361806902754,1361806909666,2228281374,2228288286,6912
1361806914,2228292620,6,1470,245,1361806910562,1361806910882,2228289182,2228289502,320
1361806914,2228292620,8,3093,386.625,1361806910562,1361806910690,2228289182,2228289310,128
1361806914,2228292620,18,21541,1196.722222,1361806910625,1361806910753,2228289245,2228289373,128
1361806914,2228292620,5,559,111.8,1361806907424,1361806907616,2228286044,2228286236,192
1361806914,2228292624,23,16875,733.6956522,1361806907292,1361806912156,2228285916,2228290780,4864
1361806914,2228292624,6,874,145.6666667,1361806910880,1361806911008,2228289504,2228289632,128
1361806914,2228292624,4,652,163,1361806910879,1361806910943,2228289503,2228289567,64
1361806914,2228292624,5,916,183.2,1361806910879,1361806911007,2228289503,2228289631,128
1361806914,2228292624,4,645,161.25,1361806911007,1361806911135,2228289631,2228289759,128
1361806914,2228292624,4,651,162.75,1361806911070,1361806911198,2228289694,2228289822,128
1361806914,2228292624,4,1103,275.75,1361806907870,1361806907934,2228286494,2228286558,64
1361806914,2228292624,4,621,155.25,1361806899550,1361806907230,2228278174,2228285854,7680
1361806914,2228292624,4,640,160,1361806911325,1361806911453,2228289949,2228290077,128
1361806914,2228292624,6,859,143.1666667,1361806907932,1361806908060,2228286556,2228286684,128
1361806914,2228292628,5,689,137.8,1361806911196,1361806911388,2228289824,2228290016,192
1361806914,2228292628,4,464,116,1361806911196,1361806911516,2228289824,2228290144,320
1361806914,2228292628,5,895,179,1361806911388,1361806911452,2228290016,2228290080,64
1361806914,2228292628,9,6442,715.7777778,1361806908187,1361806908379,2228286815,2228287007,192
1361806914,2228292628,5,563,112.6,1361806911515,1361806911899,2228290143,2228290527,384
1361806914,2228292628,5,840,168,1361806908250,1361806908442,2228286878,2228287070,192
1361806914,2228292628,4,433,108.25,1361806911385,1361806911513,2228290013,2228290141,128
1361806914,2228292628,8,1903,237.875,1361806911449,1361806912537,2228290077,2228291165,1088
1361806914,2228292632,5,2881,576.2,1361806908631,1361806908695,2228287263,2228287327,64
1361806914,2228292632,12,6376,531.3333333,1361806911894,1361806913302,2228290526,2228291934,1408
1361806914,2228292632,5,770,154,1361806909014,1361806909142,2228287646,2228287774,128
1361806914,2228292632,5,498,99.6,1361806911766,1361806911894,2228290398,2228290526,128
1361806914,2228292656,4,925,231.25,1361806911999,1361806912127,2228290655,2228290783,128
1361806914,2228292656,5,918,183.6,1361806912191,1361806912319,2228290847,2228290975,128
1361806914,2228292656,8,2908,363.5,1361806912254,1361806912446,2228290910,2228291102,192
1361806914,2228292656,6,2193,365.5,1361806912254,1361806912446,2228290910,2228291102,192
1361806914,2228292656,5,452,90.4,1361806912125,1361806912253,2228290781,2228290909,128
1361806914,2228292656,5,899,179.8,1361806912125,1361806912253,2228290781,2228290909,128
1361806914,2228292656,4,1832,458,1361806901565,1361806909629,2228280221,2228288285,8064
1361806914,2228292660,8,2900,362.5,1361806912252,1361806912444,2228290912,2228291104,192
1361806914,2228292660,7,2626,375.1428571,1361806901692,1361806909628,2228280352,2228288288,7936
1361806914,2228292660,14,5224,373.1428571,1361806909692,1361806911676,2228288352,2228290336,1984
1361806914,2228292660,4,777,194.25,1361806912570,1361806912634,2228291230,2228291294,64
1361806914,2228292660,5,498,99.6,1361806909818,1361806909946,2228288478,2228288606,128
1361806914,2228292660,4,843,210.75,1361806909817,1361806909881,2228288477,2228288541,64
1361806914,2228292664,5,850,170,1361806913207,1361806913335,2228291871,2228291999,128
1361806914,2228292664,4,645,161.25,1361806913271,1361806913399,2228291935,2228292063,128
1361806914,2228292664,6,3021,503.5,1361806905463,1361806905847,2228284127,2228284511,384
1361806914,2228292664,5,956,191.2,1361806913078,1361806913142,2228291742,2228291806,64
1361806914,2228292664,4,645,161.25,1361806913269,1361806913525,2228291933,2228292189,256
1361806914,2228292664,6,1712,285.3333333,1361806913717,1361806913781,2228292381,2228292445,64
1361806914,2228292664,6,1996,332.6666667,1361806913397,1361806913589,2228292061,2228292253,192
1361806914,2228292664,4,599,149.75,1361806913525,1361806913653,2228292189,2228292317,128
1361806914,2228292668,9,3557,395.2222222,1361806910131,1361806910259,2228288799,2228288927,128
1361806914,2228292668,3,421,140.3333333,1361806906033,1361806906097,2228284701,2228284765,64
1361806914,2228292672,4,487,121.75,1361806910510,1361806910574,2228289182,2228289246,64
1361806914,2228292676,4,897,224.25,1361806907240,1361806907368,2228285916,2228286044,128
1361806914,2228292676,5,1536,307.2,1361806910828,1361806910956,2228289504,2228289632,128
1361806914,2228292676,3,809,269.6666667,1361806907308,1361806913708,2228285984,2228292384,6400
1361806914,2228292676,3,575,191.6666667,1361806910892,1361806910956,2228289568,2228289632,64
1361806914,2228292676,4,543,135.75,1361806910955,1361806911083,2228289631,2228289759,128
1361806914,2228292692,6,2299,383.1666667,1361806911065,1361806911193,2228289757,2228289885,128
1361806914,2228292696,3,421,140.3333333,1361806907608,1361806907672,2228286304,2228286368,64
1361806914,2228292696,3,754,251.3333333,1361806911000,1361806911192,2228289696,2228289888,192
1361806914,2228292696,4,630,157.5,1361806911063,1361806911127,2228289759,2228289823,64
1361806914,2228292696,5,517,103.4,1361806907607,1361806907735,2228286303,2228286431,128
1361806914,2228292696,5,2110,422,1361806903127,1361806911639,2228281823,2228290335,8512
1361806914,2228292696,5,569,113.8,1361806907798,1361806907926,2228286494,2228286622,128
1361806914,2228292696,4,987,246.75,1361806911190,1361806911382,2228289886,2228290078,192
1361806914,2228292696,5,3648,729.6,1361806908180,1361806908308,2228286876,2228287004,128
1361806914,2228292700,5,770,154,1361806911379,1361806911507,2228290079,2228290207,128
1361806914,2228292700,6,3859,643.1666667,1361806908689,1361806908881,2228287389,2228287581,192
1361806914,2228292700,8,4788,598.5,1361806911825,1361806911953,2228290525,2228290653,128
1361806914,2228292704,5,1077,215.4,1361806912014,1361806912142,2228290718,2228290846,128
1361806914,2228292704,5,929,185.8,1361806912142,1361806912270,2228290846,2228290974,128
1361806914,2228292708,24,10003,416.7916667,1361806909580,1361806912588,2228288288,2228291296,3008
1361806914,2228292708,5,1025,205,1361806912396,1361806912524,2228291104,2228291232,128
1361806914,2228292708,4,649,162.25,1361806912395,1361806912459,2228291103,2228291167,64
1361806914,2228292708,5,452,90.4,1361806912459,1361806912523,2228291167,2228291231,64
1361806914,2228292708,8,2926,365.75,1361806912523,1361806912587,2228291231,2228291295,64
1361806914,2228292708,5,840,168,1361806905481,1361806905865,2228284189,2228284573,384
1361806914,2228292712,6,2960,493.3333333,1361806913284,1361806913540,2228291996,2228292252,256
1361806921,866613956,4,571,142.75,1361806916034,1361806916162,866608990,866609118,128
1361806921,866613960,7,1608,229.7142857,1361806901567,1361806913535,866594527,866606495,11968
1361806921,866613960,4,571,142.75,1361806912894,1361806913022,866605854,866605982,128
1361806921,866613960,19,19308,1016.210526,1361806910206,1361806915070,866603166,866608030,4864
1361806921,866613964,4,571,142.75,1361806916027,1361806916155,866608991,866609119,128
1361806921,866613968,5,2439,487.8,1361806912951,1361806913399,866605919,866606367,448
1361806922,2228300604,5,1199,239.8,1361806913908,1361806921780,2228292512,2228300384,7872
1361806922,2228300604,10,3456,345.6,1361806914098,1361806914418,2228292702,2228293022,320
1361806922,2228300604,9,2916,324,1361806914098,1361806914418,2228292702,2228293022,320
1361806922,2228300604,4,599,149.75,1361806914481,1361806914609,2228293085,2228293213,128
1361806922,2228300604,6,2240,373.3333333,1361806914544,1361806914736,2228293148,2228293340,192
1361806922,2228300608,6,1458,243,1361806914672,1361806914992,2228293280,2228293600,320
1361806922,2228300608,4,608,152,1361806918575,1361806918703,2228297183,2228297311,128
1361806922,2228300608,5,1152,230.4,1361806914735,1361806914927,2228293343,2228293535,192
1361806922,2228300608,6,4065,677.5,1361806918766,1361806918830,2228297374,2228297438,64
1361806922,2228300608,6,4010,668.3333333,1361806918766,1361806918830,2228297374,2228297438,64
1361806922,2228300608,6,1942,323.6666667,1361806915181,1361806921773,2228293789,2228300381,6592
1361806922,2228300612,8,2668,333.5,1361806915308,1361806915436,2228293920,2228294048,128
1361806922,2228300612,4,777,194.25,1361806915307,1361806915371,2228293919,2228293983,64
1361806922,2228300612,5,2744,548.8,1361806915371,1361806915563,2228293983,2228294175,192
1361806922,2228300612,4,777,194.25,1361806915371,1361806915435,2228293983,2228294047,64
1361806922,2228300612,10,8574,857.4,1361806919083,1361806919211,2228297695,2228297823,128
1361806922,2228300612,4,843,210.75,1361806915689,1361806915753,2228294301,2228294365,64
1361806922,2228300616,4,448,112,1361806916071,1361806916199,2228294687,2228294815,128
1361806922,2228300616,4,466,116.5,1361806916199,1361806916391,2228294815,2228295007,192
1361806922,2228300616,8,3076,384.5,1361806916453,1361806916709,2228295069,2228295325,256
1361806922,2228300616,4,439,109.75,1361806916389,1361806916517,2228295005,2228295133,128
1361806922,2228300616,5,829,165.8,1361806916516,1361806916644,2228295132,2228295260,128
1361806922,2228300616,14,12383,884.5,1361806919844,1361806920612,2228298460,2228299228,768
1361806922,2228300620,86,38880,452.0930233,1361806911584,1361806916768,2228290204,2228295388,5184
1361806922,2228300620,4,704,176,1361806916644,1361806916772,2228295264,2228295392,128
1361806922,2228300620,4,1084,271,1361806916771,1361806916899,2228295391,2228295519,128
1361806922,2228300620,4,473,118.25,1361806916898,1361806917026,2228295518,2228295646,128
1361806922,2228300620,5,1618,323.6,1361806916898,1361806917026,2228295518,2228295646,128
1361806922,2228300620,4,766,191.5,1361806916961,1361806917025,2228295581,2228295645,64
1361806922,2228300620,5,1196,239.2,1361806916961,1361806917089,2228295581,2228295709,128
1361806922,2228300620,5,613,122.6,1361806917152,1361806917152,2228295772,2228295772,0
1361806922,2228300620,4,561,140.25,1361806917152,1361806917152,2228295772,2228295772,0
1361806922,2228300620,5,595,119,1361806917216,1361806917408,2228295836,2228296028,192
1361806922,2228300624,5,846,169.2,1361806917408,1361806917472,2228296032,2228296096,64
1361806922,2228300644,18,17162,953.4444444,1361806901580,1361806915212,2228280224,2228293856,13632
1361806922,2228300644,5,697,139.4,1361806912459,1361806919755,2228291103,2228298399,7296
1361806922,2228300644,5,2374,474.8,1361806920714,1361806920842,2228299358,2228299486,128
1361806922,2228300644,5,717,143.4,1361806920840,1361806920968,2228299484,2228299612,128
1361806922,2228300648,8,1554,194.25,1361806913732,1361806921732,2228292380,2228300380,8000
1361806922,2228300652,12,1299,108.25,1361806913604,1361806914244,2228292256,2228292896,640
1361806922,2228300652,5,969,193.8,1361806913859,1361806913987,2228292511,2228292639,128
1361806922,2228300652,4,704,176,1361806914178,1361806914370,2228292830,2228293022,192
1361806922,2228300656,6,1458,243,1361806914623,1361806921791,2228293279,2228300447,7168
1361806922,2228300656,7,5696,813.7142857,1361806918718,1361806918782,2228297374,2228297438,64
1361806922,2228300656,4,928,232,1361806914813,1361806914877,2228293469,2228293533,64
1361806922,2228300660,5,843,168.6,1361806914936,1361806915064,2228293596,2228293724,128
1361806922,2228300660,18,21061,1170.055556,1361806919035,1361806919163,2228297695,2228297823,128
1361806922,2228300660,5,1921,384.2,1361806915130,1361806915258,2228293790,2228293918,128
1361806922,2228300660,4,1514,378.5,1361806915386,1361806915578,2228294046,2228294238,192
1361806922,2228300660,8,2908,363.5,1361806915513,1361806915705,2228294173,2228294365,192
1361806922,2228300680,5,1506,301.2,1361806915556,1361806915684,2228294236,2228294364,128
1361806922,2228300684,4,1134,283.5,1361806915427,1361806915619,2228294111,2228294303,192
1361806922,2228300684,7,2984,426.2857143,1361806916002,1361806916130,2228294686,2228294814,128
1361806922,2228300684,5,866,173.2,1361806916257,1361806916385,2228294941,2228295069,128
1361806922,2228300684,4,680,170,1361806916321,1361806916513,2228295005,2228295197,192
1361806922,2228300688,4,704,176,1361806916638,1361806916766,2228295326,2228295454,128
1361806922,2228300688,7,930,132.8571429,1361806916510,1361806916894,2228295198,2228295582,384
1361806922,2228300688,7,865,123.5714286,1361806916766,1361806916894,2228295454,2228295582,128
1361806922,2228300688,25,31474,1258.96,1361806916574,1361806916638,2228295262,2228295326,64
1361806922,2228300688,6,2868,478,1361806916957,1361806917021,2228295645,2228295709,64
1361806922,2228300688,4,1133,283.25,1361806917020,1361806917148,2228295708,2228295836,128
1361806922,2228300692,6,2611,435.1666667,1361806917466,1361806917530,2228296158,2228296222,64
1361806922,2228300692,22,11715,532.5,1361806912218,1361806915674,2228290910,2228294366,3456
1361806922,2228300692,3,279,93,1361806920728,1361806920856,2228299420,2228299548,128
1361806922,2228300692,5,1765,353,1361806917656,1361806917720,2228296348,2228296412,64
1361806922,2228300700,19,7939,417.8421053,1361806913620,1361806914516,2228292320,2228293216,896
1361806922,2228300700,5,1618,323.6,1361806913748,1361806913940,2228292448,2228292640,192
1361806926,2228304908,1,46,46,1361806898883,1361806898883,2228277791,2228277791,0
1361806929,866622048,13,2814,216.4615385,1361806912807,1361806923623,866605855,866616671,10816
1361806930,2228308612,7,2146,306.5714286,1361806914408,1361806926248,2228293020,2228304860,11840
1361806930,2228308620,5,943,188.6,1361806922912,1361806923232,2228301532,2228301852,320
1361806930,2228308620,11,5904,536.7272727,1361806923235,1361806923875,2228301855,2228302495,640
1361806930,2228308620,4,509,127.25,1361806923298,1361806923490,2228301918,2228302110,192
1361806930,2228308620,4,1269,317.25,1361806923361,1361806923425,2228301981,2228302045,64
1361806930,2228308620,5,959,191.8,1361806923361,1361806923425,2228301981,2228302045,64
1361806930,2228308624,12,6187,515.5833333,1361806923807,1361806924255,2228302431,2228302879,448
1361806930,2228308624,4,559,139.75,1361806923615,1361806923807,2228302239,2228302431,192
1361806930,2228308624,5,1584,316.8,1361806916062,1361806923870,2228294686,2228302494,7808
1361806930,2228308628,9,8236,915.1111111,1361806919772,1361806926172,2228298400,2228304800,6400
1361806930,2228308660,5,1648,329.6,1361806921787,1361806928187,2228300447,2228306847,6400
1361806930,2228308668,3,450,150,1361806922803,1361806922867,2228301471,2228301535,64
1361806930,2228308668,5,865,173,1361806922802,1361806923186,2228301470,2228301854,384
1361806930,2228308668,4,559,139.75,1361806923184,1361806923312,2228301852,2228301980,128
1361806930,2228308688,6,1712,285.3333333,1361806923356,1361806923484,2228302044,2228302172,128
1361806930,2228308692,3,477,159,1361806923355,1361806923419,2228302047,2228302111,64
1361806930,2228308692,4,863,215.75,1361806923355,1361806923419,2228302047,2228302111,64
1361806930,2228308692,4,559,139.75,1361806923610,1361806923738,2228302302,2228302430,128
1361806930,2228308692,4,894,223.5,1361806923610,1361806923802,2228302302,2228302494,192
1361806930,2228308692,5,760,152,1361806923801,1361806925849,2228302493,2228304541,2048
1361806930,2228308704,8,2953,369.125,1361806921101,1361806928141,2228299805,2228306845,7040
1361806938,2228316608,8,3090,386.25,1361806922861,1361806930285,2228301469,2228308893,7424
1361806938,2228316660,4,1124,281,1361806922810,1361806930170,2228301470,2228308830,7360
1361806946,2228325024,2,129,64.5,1361806919053,1361806919053,2228298077,2228298077,0
1361806954,2228332996,1,52,52,1361806929833,1361806929833,2228308829,2228308829,0
1361806986,2228365020,1,46,46,1361806961745,1361806961745,2228340765,2228340765,0
1361806990,2228369088,1,46,46,1361806963084,1361806963084,2228342172,2228342172,0
1361807002,2228380708,4,794,198.5,1361806999432,1361806999560,2228378140,2228378268,128
1361807002,2228380732,4,676,169,1361807000239,1361807000367,2228378971,2228379099,128
1361807010,2228388736,2,192,96,1361807005806,1361807005806,2228384542,2228384542,0
1361807034,2228412656,2,192,96,1361807030652,1361807030652,2228409308,2228409308,0
1361807066,2228444676,4,676,169,1361807062822,1361807062950,2228441498,2228441626,128
1361807066,2228444728,4,676,169,1361807062964,1361807063028,2228441692,2228441756,64
1361807066,2228444752,6,1089,181.5,1361807063898,1361807065690,2228442650,2228444442,1792
1361807070,2228449088,1,187,187,1361807043341,1361807043341,2228422429,2228422429,0
1361807074,2228452692,4,356,89,1361807068952,1361807069080,2228447644,2228447772,128
1361807074,2228452724,25,30151,1206.04,1361807065913,1361807069177,2228444637,2228447901,3264
1361807081,866774004,4,464,116,1361807078803,1361807078867,866771807,866771871,64
1361807082,2228460696,4,618,154.5,1361807078354,1361807078418,2228457050,2228457114,64
1361807082,2228460696,21,25359,1207.571429,1361807074450,1361807074706,2228453146,2228453402,256
1361807082,2228460700,4,497,124.25,1361807078417,1361807078481,2228457117,2228457181,64
1361807082,2228460700,5,2080,416,1361807078417,1361807078609,2228457117,2228457309,192
1361807082,2228460700,16,5913,369.5625,1361807078543,1361807079183,2228457243,2228457883,640
1361807082,2228460700,21,18489,880.4285714,1361807074766,1361807079438,2228453466,2228458138,4672
1361807082,2228460704,21,23857,1136.047619,1361807078732,1361807078860,2228457436,2228457564,128
1361807082,2228460704,71,94702,1333.830986,1361807075020,1361807078412,2228453724,2228457116,3392
1361807082,2228460704,8,6826,853.25,1361807075146,1361807075274,2228453850,2228453978,128
1361807082,2228460708,3,421,140.3333333,1361807078985,1361807079113,2228457693,2228457821,128
1361807082,2228460708,5,1708,341.6,1361807079239,1361807079495,2228457947,2228458203,256
1361807082,2228460708,90,123388,1370.977778,1361807079302,1361807080262,2228458010,2228458970,960
1361807082,2228460712,5,745,149,1361807076483,1361807076867,2228455195,2228455579,384
1361807082,2228460712,4,2902,725.5,1361807076546,1361807076610,2228455258,2228455322,64
1361807082,2228460716,4,1164,291,1361807080062,1361807080254,2228458778,2228458970,192
1361807082,2228460716,15,16153,1076.866667,1361807076477,1361807076605,2228455193,2228455321,128
1361807082,2228460752,7,4838,691.1428571,1361807078685,1361807078749,2228457437,2228457501,64
1361807082,2228460752,6,2972,495.3333333,1361807078685,1361807078813,2228457437,2228457565,128
1361807082,2228460756,4,921,230.25,1361807079191,1361807079319,2228457947,2228458075,128
1361807082,2228460756,4,592,148,1361807079127,1361807079191,2228457883,2228457947,64
1361807082,2228460756,5,2072,414.4,1361807079254,1361807079446,2228458010,2228458202,192
1361807082,2228460780,4,586,146.5,1361807079553,1361807079617,2228458333,2228458397,64
1361807082,2228460784,5,657,131.4,1361807079804,1361807079996,2228458588,2228458780,192
1361807082,2228460784,8,7006,875.75,1361807076538,1361807076730,2228455322,2228455514,192
1361807082,2228460788,4,497,124.25,1361807080118,1361807080182,2228458906,2228458970,64
1361807082,2228460792,4,871,217.75,1361807077748,1361807077876,2228456540,2228456668,128
1361807082,2228460792,4,747,186.75,1361807081715,1361807081779,2228460507,2228460571,64
1361807089,866781984,4,525,131.25,1361807082790,1361807082854,866775774,866775838,64
1361807090,2228468696,6,1397,232.8333333,1361807066001,1361807082257,2228444697,2228460953,16256
1361807090,2228468700,4,742,185.5,1361807082001,1361807082193,2228460701,2228460893,192
1361807090,2228468700,4,409,102.25,1361807086545,1361807086673,2228465245,2228465373,128
1361807090,2228468700,5,1942,388.4,1361807082128,1361807082256,2228460828,2228460956,128
1361807090,2228468704,77,103531,1344.558442,1361807075020,1361807082252,2228453724,2228460956,7232
1361807090,2228468748,5,1742,348.4,1361807081759,1361807081887,2228460507,2228460635,128
1361807090,2228468752,35,44437,1269.628571,1361807082460,1361807083100,2228461212,2228461852,640
1361807090,2228468752,28,35124,1254.428571,1361807082075,1361807088219,2228460827,2228466971,6144
1361807090,2228468756,39,49046,1257.589744,1361807074968,1361807082328,2228453724,2228461084,7360
1361807090,2228468784,100,137620,1376.2,1361807076348,1361807084156,2228455132,2228462940,7808
1361807090,2228468784,4,1164,291,1361807079995,1361807088187,2228458779,2228466971,8192
1361807097,866789984,6,3884,647.3333333,1361807089894,1361807090022,866782878,866783006,128
1361807097,866789984,4,643,160.75,1361807082150,1361807090150,866775134,866783134,8000
1361807098,2228476708,40,37940,948.5,1361807090312,1361807091144,2228469020,2228469852,832
1361807098,2228476712,8,4513,564.125,1361807082178,1361807093186,2228460890,2228471898,11008
1361807098,2228476712,7,5165,737.8571429,1361807082178,1361807090242,2228460890,2228468954,8064
1361807098,2228476724,38,46946,1235.421053,1361807092536,1361807092792,2228471260,2228471516,256
1361807098,2228476724,97,130500,1345.360825,1361807092536,1361807092792,2228471260,2228471516,256
1361807098,2228476728,4,267,66.75,1361807092853,1361807092981,2228471581,2228471709,128
1361807098,2228476756,4,902,225.5,1361807078168,1361807090200,2228456924,2228468956,12032
1361807098,2228476756,4,1569,392.25,1361807089750,1361807096214,2228468506,2228474970,6464
1361807098,2228476756,4,1225,306.25,1361807089750,1361807096278,2228468506,2228475034,6528
1361807098,2228476756,18,18473,1026.277778,1361807089814,1361807090198,2228468570,2228468954,384
1361807098,2228476760,43,52239,1214.860465,1361807089873,1361807090129,2228468633,2228468889,256
1361807098,2228476760,46,57639,1253.021739,1361807090261,1361807090837,2228469021,2228469597,576
1361807098,2228476760,7,5312,758.8571429,1361807089877,1361807090005,2228468637,2228468765,128
1361807098,2228476760,28,23414,836.2142857,1361807086420,1361807089940,2228465180,2228468700,3520
1361807098,2228476760,8,5809,726.125,1361807090067,1361807090195,2228468827,2228468955,128
1361807098,2228476760,4,1522,380.5,1361807090067,1361807090131,2228468827,2228468891,64
1361807098,2228476764,40,49856,1246.4,1361807074960,1361807089872,2228453724,2228468636,14912
1361807098,2228476792,5,453,90.6,1361807093107,1361807093171,2228471899,2228471963,64
1361807098,2228476796,4,1014,253.5,1361807089645,1361807096173,2228468441,2228474969,6528
1361807098,2228476800,5,2275,455,1361807089708,1361807096172,2228468508,2228474972,6464
1361807106,2228484716,141,185580,1316.170213,1361807090368,1361807100288,2228469084,2228479004,9920
1361807106,2228484720,7,3790,541.4285714,1361807090171,1361807098299,2228468891,2228477019,8128
1361807106,2228484752,5,499,99.8,1361807093082,1361807100250,2228471834,2228479002,7168
1361807106,2228484760,89,118792,1334.741573,1361807090258,1361807100242,2228469018,2228479002,9984
1361807114,2228492720,5,453,90.6,1361807108154,1361807108282,2228486874,2228487002,128
1361807130,2228508808,5,453,90.6,1361807123045,1361807123173,2228501853,2228501981,128
1361807146,2228524728,5,453,90.6,1361807138161,1361807138289,2228516889,2228517017,128
1361807154,2228532776,5,453,90.6,1361807153090,1361807153154,2228531866,2228531930,64
1361807170,2228548816,5,453,90.6,1361807168027,1361807168155,2228546843,2228546971,128
1361807186,2228564728,5,453,90.6,1361807183152,1361807183280,2228561880,2228562008,128
1361807187,2228565512,10,4467,446.7,1361807162251,1361807163147,2228540763,2228541659,896
1361807202,2228580852,5,453,90.6,1361807198007,1361807198135,2228576859,2228576987,128
1361807218,2228596764,5,453,90.6,1361807213133,1361807213325,2228591897,2228592089,192
1361807234,2228612752,5,453,90.6,1361807228123,1361807228251,2228606875,2228607003,128
1361807250,2228628792,5,453,90.6,1361807243058,1361807243186,2228621850,2228621978,128
1361807251,2228629704,2,128,64,1361807225097,1361807226121,2228603801,2228604825,1024
1361807251,2228629704,3,192,64,1361807225097,1361807227273,2228603801,2228605977,2176
1361807251,2228629772,2,128,64,1361807223813,1361807224837,2228602585,2228603609,1024
1361807251,2228629772,2,128,64,1361807223877,1361807224901,2228602649,2228603673,1024
1361807290,2228668880,3,210,70,1361807282328,1361807282648,2228661208,2228661528,320
1361816970,2238348548,1,46,46,1361816943569,1361816943569,2238322117,2238322117,0
1361889686,2311064900,5,354,70.8,1361889681391,1361889685615,2311060291,2311064515,4224
1361889702,2311080916,2,154,77,1361889690334,1361889699870,2311069250,2311078786,9536
1361889745,2311123544,1,77,77,1361889719316,1361889719316,2311097860,2311097860,0
1361889785,2311163504,1,77,77,1361889757499,1361889757499,2311136003,2311136003,0
1361889861,2311239640,1,77,77,1361889833651,1361889833651,2311212291,2311212291,0
1361891538,2312916728,1,46,46,1361891512574,1361891512574,2312891302,2312891302,0
1361892380,2313758740,1,46,46,1361892352552,1361892352552,2313731292,2313731292,0
1361892976,2314354996,1,46,46,1361892948960,1361892948960,2314327956,2314327956,0
1361893145,2314523468,20,5331,266.55,1361893142827,1361893144683,2314521295,2314523151,1856
1361893152,2314531200,6,482,80.33333333,1361893126096,1361893128848,2314505296,2314508048,2752
1361893153,2314531276,4,349,87.25,1361893127018,1361893127210,2314505294,2314505486,192
1361893153,2314531276,11,976,88.72727273,1361893127018,1361893137770,2314505294,2314516046,10752
1361893153,2314531280,44,35686,811.0454545,1361893127078,1361893138790,2314505358,2314517070,11712
1361893156,2314535168,15,4600,306.6666667,1361893128430,1361893137070,2314507598,2314516238,8640
1361893156,2314535172,9,3125,347.2222222,1361893128811,1361893129323,2314507983,2314508495,512
1361893161,2314539468,3,177,59,1361893157037,1361893157165,2314535505,2314535633,128
1361893161,2314539516,4,223,55.75,1361893156985,1361893157113,2314535501,2314535629,128
1361893205,2314583296,7,7616,1088,1361893180246,1361893182358,2314558542,2314560654,2112
1361893213,2314591288,7,1887,269.5714286,1361893186462,1361893202206,2314564750,2314580494,15744
1361893217,2314595608,59,64562,1094.271186,1361893203423,1361893215135,2314582031,2314593743,11712
1361893225,2314603524,2,158,79,1361893216947,1361893220403,2314595471,2314598927,3456
1361893228,2314607204,9,5306,589.5555556,1361893200137,1361893204617,2314579341,2314583821,4480
1361893237,2314615296,1,145,145,1361893211863,1361893211863,2314590159,2314590159,0
1361893241,2314619532,3,156,52,1361893237227,1361893240043,2314615759,2314618575,2816
1361893245,2314623248,4,671,167.75,1361893220165,1361893222085,2314598413,2314600333,1920
1361893245,2314623256,6,2355,392.5,1361893216957,1361893217149,2314595213,2314595405,192
1361893249,2314627332,11,12920,1174.545455,1361893222067,1361893237747,2314600399,2314616079,15680
1361893249,2314627548,2,158,79,1361893227353,1361893241305,2314605901,2314619853,13952
1361893257,2314635564,2,104,52,1361893243724,1361893251276,2314622288,2314629840,7552
1361893257,2314635584,2,131,65.5,1361893249912,1361893249912,2314628496,2314628496,0
1361893273,2314651836,2,104,52,1361893260988,1361893270972,2314639824,2314649808,9984
1361893281,2314659592,1,1426,1426,1361893253358,1361893253358,2314631950,2314631950,0
1361893289,2314667632,11,763,69.36363636,1361893286662,1361893287366,2314665294,2314665998,704
1361893297,2314675700,2,104,52,1361893281155,1361893291139,2314659855,2314669839,9984
1361893297,2314675812,1,79,79,1361893268946,1361893268946,2314647758,2314647758,0
1361893309,2314687636,2,1972,986,1361893281856,1361893285056,2314660492,2314663692,3200
1361893313,2314691780,6,482,80.33333333,1361893286449,1361893286961,2314665229,2314665741,512
1361893313,2314691780,10,7879,787.9,1361893286704,1361893297776,2314665484,2314676556,11072
1361893313,2314691864,15,3226,215.0666667,1361893287581,1361893294365,2314666445,2314673229,6784
1361893313,2314691892,17,16745,985,1361893288066,1361893305474,2314666958,2314684366,17408
1361893321,2314699876,14,8926,637.5714286,1361893293647,1361893298575,2314672523,2314677451,4928
1361893329,2314707736,4,289,72.25,1361893324124,1361893326876,2314702860,2314705612,2752
1361893337,2314715744,2,131,65.5,1361893336662,1361893336662,2314715406,2314715406,0
1361893345,2314723584,5,395,79,1361893337077,1361893344181,2314715661,2314722765,7104
1361893345,2314723592,2,158,79,1361893330667,1361893337963,2314709259,2314716555,7296
1361893369,2314747636,2,158,79,1361893351744,1361893366976,2314730380,2314745612,15232
1361893369,2314747684,3,156,52,1361893367314,1361893368082,2314745998,2314746766,768
1361893377,2314755648,3,156,52,1361893369204,1361893375732,2314747852,2314754380,6528
1361893377,2314755920,1,79,79,1361893352228,1361893352228,2314731148,2314731148,0
1361893401,2314779640,3,305,101.6666667,1361893396413,1361893398525,2314775053,2314777165,2112
1361893401,2314779644,2,104,52,1361893384441,1361893394489,2314763085,2314773133,10048
1361893401,2314779648,6,427,71.16666667,1361893393524,1361893397172,2314772172,2314775820,3648
1361893409,2314787844,1,79,79,1361893381486,1361893381486,2314760330,2314760330,0
1361893417,2314795700,6,427,71.16666667,1361893412481,1361893415937,2314791181,2314794637,3456
1361893417,2314795700,2,104,52,1361893404415,1361893414399,2314783115,2314793099,9984
1361893425,2314803928,6,447,74.5,1361893418523,1361893422107,2314797451,2314801035,3584
1361893425,2314804164,3,225,75,1361893400561,1361893424049,2314779725,2314803213,23488
1361893425,2314804192,1,79,79,1361893396817,1361893396817,2314776009,2314776009,0
1361893429,2314808036,3,339,113,1361893402480,1361893428336,2314781516,2314807372,25856
1361893441,2314819700,2,158,79,1361893426177,1361893433793,2314804877,2314812493,7616
1361893445,2314824096,3,225,75,1361893419186,1361893441202,2314798282,2314820298,22016
1361893449,2314828096,1,52,52,1361893423985,1361893423985,2314803081,2314803081,0
1361893473,2314852148,1,79,79,1361893448704,1361893448704,2314827852,2314827852,0
1361893482,2314860236,1,75,75,1361893456271,1361893456271,2314834507,2314834507,0
1361893489,2314868204,1,113,113,1361893462664,1361893462664,2314841868,2314841868,0
1361893497,2314876164,1,75,75,1361893470576,1361893470576,2314849740,2314849740,0
1361893506,2314884280,1,79,79,1361893480228,1361893480228,2314858508,2314858508,0
1361893510,2314888240,1,46,46,1361893482186,1361893482186,2314860426,2314860426,0
1361893534,2314912288,1,46,46,1361893507737,1361893507737,2314886025,2314886025,0
1361893546,2314924228,1,46,46,1361893520596,1361893520596,2314898824,2314898824,0
1361893707,2315085680,1,46,46,1361893681551,1361893681551,2315060231,2315060231,0
1361917342,2338720740,6,2370,395,1361917314545,1361917340209,2338693285,2338718949,25664
1361917395,2338773192,1,395,395,1361917367251,1361917367251,2338745443,2338745443,0
1361917447,2338825400,1,395,395,1361917420032,1361917420032,2338798432,2338798432,0
1361917551,2338929892,1,395,395,1361917525524,1361917525524,2338904416,2338904416,0
1361917671,2339049972,1,395,395,1361917645444,1361917645444,2339024416,2339024416,0
1361917792,2339170332,1,395,395,1361917766082,1361917766082,2339144414,2339144414,0
1361917912,2339290612,1,395,395,1361917885798,1361917885798,2339264410,2339264410,0
1361917951,2339329412,2,104,52,1361917949166,1361917950062,2339327578,2339328474,896
1361917959,2339337356,2,104,52,1361917951973,1361917955557,2339330329,2339333913,3584
1361917975,2339353396,2,104,52,1361917962812,1361917972796,2339341208,2339351192,9984
1361917976,2339354652,1,52,52,1361917948221,1361917948221,2339326873,2339326873,0
1361917999,2339377500,2,104,52,1361917982677,1361917992725,2339361177,2339371225,10048
1361918029,2339407160,1,52,52,1361918003048,1361918003048,2339381208,2339381208,0
1361918249,977942340,3,408,136,1361918221328,1361918227344,977914668,977920684,6016
1361918670,2340048180,1,46,46,1361918643789,1361918643789,2340021969,2340021969,0
1361918750,2340128304,3,408,136,1361918724624,1361918730704,2340102928,2340109008,6080
1361919166,2340544996,1,46,46,1361919138516,1361919138516,2340517512,2340517512,0
1361919527,2340905964,3,411,137,1361919501295,1361919506927,2340880259,2340885891,5632
1361919687,2341065220,1,48,48,1361919659157,1361919659157,2341037377,2341037377,0
1361919704,2341082504,3,432,144,1361919678264,1361919684280,2341056768,2341062784,6016
1361919780,2341158768,3,408,136,1361919753648,1361919759664,2341132416,2341138432,6016
1361920393,2341771724,3,459,153,1361920368210,1361920374226,2341746934,2341752950,6016
1361920560,980253248,3,408,136,1361920532603,1361920538683,980225851,980231931,6080
1361920730,2342108892,23,18888,821.2173913,1361920724259,1361920727843,2342103151,2342106735,3584
1361920742,2342120492,18,7271,403.9444444,1361920715187,1361920729011,2342093679,2342107503,13824
1361920742,2342120568,18,3738,207.6666667,1361920713959,1361920729127,2342092527,2342107695,15168
1361920746,2342124900,11,5782,525.6363636,1361920720669,1361920730461,2342099569,2342109361,9792
1361920746,2342124904,11,5195,472.2727273,1361920721559,1361920722135,2342100463,2342101039,576
1361920750,2342128892,11,5024,456.7272727,1361920722597,1361920724005,2342101489,2342102897,1408
1361920754,2342133072,15,14313,954.2,1361920727792,1361920730096,2342106864,2342109168,2304
1361920782,2342160940,1,171,171,1361920757427,1361920757427,2342136367,2342136367,0
1361920782,2342161000,5,1776,355.2,1361920756918,1361920759926,2342135918,2342138926,3008
1361920891,2342269152,7,1323,189,1361920865285,1361920880901,2342243437,2342259053,15616
1361920914,2342292868,6,427,71.16666667,1361920907258,1361920910714,2342286126,2342289582,3456
1361920915,2342293304,3,567,189,1361920890732,1361920910764,2342269036,2342289068,20032
1361920943,2342321348,3,225,75,1361920915008,1361920937408,2342293356,2342315756,22400
1361920947,2342325392,1,189,189,1361920920663,1361920920663,2342299055,2342299055,0
1361920970,2342348892,5,260,52,1361920962145,1361920965473,2342341037,2342344365,3328
1361920970,2342348972,5,260,52,1361920963921,1361920968017,2342342893,2342346989,4096
1361920978,2342356928,5,260,52,1361920970428,1361920974204,2342349356,2342353132,3776
1361920995,2342373392,1,75,75,1361920967187,1361920967187,2342345579,2342345579,0
1361921002,2342380908,4,208,52,1361921000015,1361921001871,2342378923,2342380779,1856
1361921031,2342409508,1,52,52,1361921004383,1361921004383,2342382891,2342382891,0
1361921075,2342453860,3,411,137,1361921049024,1361921055104,2342427884,2342433964,6080
1361921392,2342770340,3,405,135,1361921364675,1361921370755,2342743015,2342749095,6080
1361921400,2342778484,1,48,48,1361921374323,1361921374323,2342752807,2342752807,0
1361921404,2342782332,1,48,48,1361921376523,1361921376523,2342754855,2342754855,0
1361973443,2394821756,1,46,46,1361973414545,1361973414545,2394793301,2394793301,0
1361975151,2396529012,1,46,46,1361975127008,1361975127008,2396505020,2396505020,0
1361975155,2396533496,1,46,46,1361975137918,1361975137918,2396516414,2396516414,0
1361975553,2396931060,1,46,46,1361975548714,1361975548714,2396926774,2396926774,0
1361975651,2397028972,2,120,60,1361975626371,1361975629379,2397004343,2397007351,3008
1361975654,2397032924,2,120,60,1361975626568,1361975629576,2397005492,2397008500,3008
1361975655,2397032960,2,120,60,1361975628619,1361975631627,2397006579,2397009587,3008
1361977362,1037054668,1,46,46,1361977333487,1361977333487,1037026155,1037026155,0
1361977758,2399136456,44,57671,1310.704545,1361977756923,1361977757179,2399135379,2399135635,256
1361977758,2399136540,8,4306,538.25,1361977757290,1361977757738,2399135830,2399136278,448
1361977758,2399136548,4,879,219.75,1361977757730,1361977757794,2399136278,2399136342,64
1361977760,2399138004,6,4224,704,1361977758337,1361977758337,2399136341,2399136341,0
1361977760,2399138016,12,2945,245.4166667,1361977734838,1361977735542,2399112854,2399113558,704
1361977760,1037452448,6,1992,332,1361977758033,1361977758609,1037450481,1037451057,576
1361977760,2399138092,15,3228,215.2,1361977735083,1361977741803,2399113175,2399119895,6720
1361977766,2399144396,4,657,164.25,1361977763513,1361977763577,2399141909,2399141973,64
1361977766,2399144396,5,758,151.6,1361977757944,1361977758008,2399136340,2399136404,64
1361977766,2399144400,124,145238,1171.274194,1361977758003,1361977762227,2399136403,2399140627,4224
1361977766,2399144400,22,24773,1126.045455,1361977759731,1361977759923,2399138131,2399138323,192
1361977766,2399144400,15,14215,947.6666667,1361977758007,1361977758263,2399136407,2399136663,256
1361977766,2399144400,44,30893,702.1136364,1361977763575,1361977763831,2399141975,2399142231,256
1361977766,2399144400,26,31205,1200.192308,1361977758197,1361977758325,2399136597,2399136725,128
1361977766,2399144400,6,3794,632.3333333,1361977760116,1361977760884,2399138516,2399139284,768
1361977766,2399144404,4,267,66.75,1361977763953,1361977764017,2399142357,2399142421,64
1361977766,2399144404,4,1085,271.25,1361977764080,1361977764144,2399142484,2399142548,64
1361977766,2399144408,4,437,109.25,1361977759023,1361977759151,2399137431,2399137559,128
1361977766,2399144408,52,57223,1100.442308,1361977759149,1361977759853,2399137557,2399138261,704
1361977766,2399144408,10,8554,855.4,1361977761197,1361977761645,2399139605,2399140053,448
1361977766,2399144440,29,26205,903.6206897,1361977753550,1361977764110,2399131990,2399142550,10560
1361977766,2399144440,5,1792,358.4,1361977762573,1361977763149,2399141013,2399141589,576
1361977766,2399144440,17,19815,1165.588235,1361977762700,1361977762828,2399141140,2399141268,128
1361977766,2399144444,5,657,131.4,1361977762763,1361977762827,2399141207,2399141271,64
1361977766,2399144448,25,30248,1209.92,1361977757829,1361977757893,2399136277,2399136341,64
1361977766,2399144448,4,979,244.75,1361977763461,1361977763525,2399141909,2399141973,64
1361977766,2399144448,56,74766,1335.107143,1361977763460,1361977763652,2399141908,2399142100,192
1361977766,2399144448,5,1160,232,1361977757892,1361977757956,2399136340,2399136404,64
1361977766,2399144448,48,55967,1165.979167,1361977757956,1361977758852,2399136404,2399137300,896
1361977766,2399144448,5,2698,539.6,1361977763460,1361977763844,2399141908,2399142292,384
1361977766,2399144452,4,652,163,1361977763523,1361977763651,2399141975,2399142103,128
1361977766,2399144480,9,6033,670.3333333,1361977758564,1361977763364,2399137044,2399141844,4800
1361977766,2399144484,30,30646,1021.533333,1361977758690,1361977759074,2399137174,2399137558,384
1361977766,2399144484,10,8598,859.8,1361977764002,1361977764386,2399142486,2399142870,384
1361977766,2399144484,37,41011,1108.405405,1361977758880,1361977759264,2399137364,2399137748,384
1361977766,2399144484,9,8166,907.3333333,1361977758944,1361977759072,2399137428,2399137556,128
1361977766,2399144488,4,576,144,1361977760989,1361977761117,2399139477,2399139605,128
1361977766,2399144488,4,1412,353,1361977761116,1361977761116,2399139604,2399139604,0
1361977766,2399144492,4,923,230.75,1361977761114,1361977761114,2399139606,2399139606,0
1361977766,2399144492,27,30729,1138.111111,1361977759386,1361977759578,2399137878,2399138070,192
1361977766,2399144492,5,2824,564.8,1361977761369,1361977761433,2399139861,2399139925,64
1361977766,2399144492,5,1675,335,1361977761433,1361977761433,2399139925,2399139925,0
1361977766,2399144492,4,704,176,1361977761368,1361977761432,2399139860,2399139924,64
1361977766,2399144496,5,1664,332.8,1361977762069,1361977762133,2399140565,2399140629,64
1361977766,2399144500,19,22786,1199.263158,1361977762450,1361977762514,2399140950,2399141014,64
1361977766,2399144524,4,1210,302.5,1361977762743,1361977762807,2399141267,2399141331,64
1361977766,2399144524,4,644,161,1361977762743,1361977762807,2399141267,2399141331,64
1361977766,2399144524,4,468,117,1361977762938,1361977763066,2399141462,2399141590,128
1361977766,2399144524,5,988,197.6,1361977763194,1361977763898,2399141718,2399142422,704
1361977766,2399144524,4,644,161,1361977763257,1361977763321,2399141781,2399141845,64
1361977766,2399144524,3,846,282,1361977763129,1361977763257,2399141653,2399141781,128
1361977766,2399144524,7,2147,306.7142857,1361977763256,1361977763320,2399141780,2399141844,64
1361977766,2399144524,4,356,89,1361977754552,1361977761976,2399133076,2399140500,7424
1361977766,2399144528,18,20524,1140.222222,1361977757366,1361977764022,2399135894,2399142550,6656
1361977768,1037460440,7,4043,577.5714286,1361977757784,1361977764504,1037450224,1037456944,6720
1361977768,1037460440,15,17200,1146.666667,1361977762519,1361977762583,1037454959,1037455023,64
1361977768,1037460440,4,464,116,1361977760471,1361977760535,1037452911,1037452975,64
1361977768,1037460452,4,775,193.75,1361977760333,1361977760397,1037452785,1037452849,64
1361977768,1037460452,4,1489,372.25,1361977760269,1361977760333,1037452721,1037452785,64
1361977768,1037460452,5,2763,552.6,1361977760332,1361977760332,1037452784,1037452784,0
1361977774,2399152408,122,140314,1150.114754,1361977757997,1361977772269,2399136405,2399150677,14272
1361977774,2399152416,8,4864,608,1361977763942,1361977772262,2399142358,2399150678,8320
1361977774,2399152420,5,657,131.4,1361977768800,1361977768864,2399147220,2399147284,64
1361977774,2399152456,16,16581,1036.3125,1361977757820,1361977766204,2399136276,2399144660,8384
1361977774,2399152492,6,1036,172.6666667,1361977762007,1361977772183,2399140499,2399150675,10176
1361977776,1037468440,32,40188,1255.875,1361977762455,1361977772631,1037454895,1037465071,10176
1361977776,1037468464,15,17200,1146.666667,1361977765438,1361977772606,1037457902,1037465070,7168
1361977782,2399160500,4,468,117,1361977777042,1361977777170,2399155542,2399155670,128
1361977784,2399162000,1,52,52,1361977758340,1361977758340,2399136340,2399136340,0
1361977784,2399162048,1,52,52,1361977758355,1361977758355,2399136403,2399136403,0
1361977790,2399168420,4,1214,303.5,1361977777056,1361977784416,2399155476,2399162836,7360
1361977790,2399168420,5,1185,237,1361977777055,1361977784415,2399155475,2399162835,7360
1361977790,2399168420,4,267,66.75,1361977777119,1361977784415,2399155539,2399162835,7296
1361977790,2399168444,6,1743,290.5,1361977777355,1361977784395,2399155799,2399162839,7040
1361977790,2399168496,3,1043,347.6666667,1361977777173,1361977784341,2399155669,2399162837,7168
1361977912,2399290360,1,151,151,1361977885082,1361977885082,2399263442,2399263442,0
1361977952,2399330544,9,3463,384.7777778,1361977925090,1361977925410,2399303634,2399303954,320
1361977958,2399336732,26,30406,1169.461538,1361977950053,1361977953381,2399328785,2399332113,3328
1361977958,2399336776,7,1280,182.8571429,1361977949691,1361977949947,2399328467,2399328723,256
1361977958,2399336780,7,1004,143.4285714,1361977950070,1361977953526,2399328850,2399332306,3456
1361977966,2399344736,37,48354,1306.864865,1361977949921,1361977958049,2399328657,2399336785,8128
1361977966,2399344788,29,34981,1206.241379,1361977949868,1361977959980,2399328656,2399338768,10112
1361977966,2399344816,4,356,89,1361977952913,1361977959953,2399331729,2399338769,7040
1361977980,2399358532,5,2519,503.8,1361977953583,1361977954927,2399332115,2399333459,1344
1361977991,2399369096,4,235,58.75,1361977988192,1361977988192,2399366288,2399366288,0
1361978047,2399425148,2,131,65.5,1361978045741,1361978045741,2399423889,2399423889,0
1361978220,2399598784,1,46,46,1361978194669,1361978194669,2399573453,2399573453,0
1361978263,2399641320,4,184,46,1361978256061,1361978256061,2399634381,2399634381,0
1361978280,2399658736,26,16227,624.1153846,1361978252255,1361978254495,2399630991,2399633231,2240
1361978280,2399658748,9,3463,384.7777778,1361978255632,1361978255952,2399634380,2399634700,320
1361978383,2399761368,2,131,65.5,1361978376266,1361978376266,2399754634,2399754634,0
1361978391,2399769336,2,192,96,1361978385132,1361978385132,2399763468,2399763468,0
1361978396,2399774904,1,64,64,1361978371379,1361978371379,2399750283,2399750283,0
1361978397,2399774980,1,64,64,1361978372559,1361978372559,2399750539,2399750539,0
1361978625,2400003756,1,52,52,1361978598277,1361978598277,2399977033,2399977033,0
1361978663,2400041680,4,184,46,1361978658958,1361978658958,2400037638,2400037638,0
1361978669,2400047724,4,270,67.5,1361978641314,1361978641634,2400020038,2400020358,320
1361978685,2400063760,9,3463,384.7777778,1361978658877,1361978660541,2400037637,2400039301,1664
1361978727,2400105740,2,98,49,1361978724369,1361978724497,2400103109,2400103237,128
1361978727,2400105740,2,98,49,1361978724372,1361978724500,2400103112,2400103240,128
1361978727,2400105744,2,92,46,1361978721551,1361978721551,2400100295,2400100295,0
1361978735,2400113704,4,356,89,1361978725494,1361978732662,2400104198,2400111366,7168
1361978735,2400113792,38,43906,1155.421053,1361978724126,1361978732638,2400102918,2400111430,8512
1361978735,2400113792,5,2676,535.2,1361978724701,1361978732573,2400103493,2400111365,7872
1361978750,2400128128,6,3244,540.6666667,1361978722168,1361978722936,2400100296,2400101064,768
1361978783,2400161796,2,131,65.5,1361978780441,1361978780441,2400159237,2400159237,0
1361978831,2400209756,44,52451,1192.068182,1361978817219,1361978826883,2400195975,2400205639,9664
1361978831,2400209792,17,6311,371.2352941,1361978810719,1361978824799,2400189511,2400203591,14080
1361978847,2400225824,5,562,112.4,1361978842878,1361978843006,2400221702,2400221830,128
1361978855,2400233768,4,722,180.5,1361978842806,1361978848886,2400221574,2400227654,6080
1361978855,2400233796,39,48304,1238.564103,1361978843098,1361978850906,2400221894,2400229702,7808
1361978855,2400233796,46,59129,1285.413043,1361978843288,1361978850904,2400222084,2400229700,7616
1361978855,2400233796,5,836,167.2,1361978843287,1361978850903,2400222083,2400229699,7616
1361978855,2400233800,93,127808,1374.27957,1361978849171,1361978854419,2400227971,2400233219,5248
1361978855,2400233808,19,19674,1035.473684,1361978844622,1361978852942,2400223430,2400231750,8320
1361978855,2400233808,24,24954,1039.75,1361978844621,1361978852941,2400223429,2400231749,8320
1361978855,2400233880,18,17796,988.6666667,1361978844613,1361978852869,2400223493,2400231749,8256
1361978863,2400241752,4,1577,394.25,1361978855555,1361978860739,2400234307,2400239491,5184
1361978882,2400260380,1,52,52,1361978857338,1361978857338,2400235718,2400235718,0
1361978887,2400265752,11,11180,1016.363636,1361978885699,1361978885763,2400264451,2400264515,64
1361978887,2400265752,8,6709,838.625,1361978885762,1361978885826,2400264514,2400264578,64
1361978887,2400265792,5,982,196.4,1361978883869,1361978883933,2400262661,2400262725,64
1361978887,2400265792,4,2902,725.5,1361978883995,1361978884059,2400262787,2400262851,64
1361978887,2400265796,3,625,208.3333333,1361978884631,1361978884759,2400263427,2400263555,128
1361978887,2400265804,8,6650,831.25,1361978885713,1361978885777,2400264517,2400264581,64
1361978887,2400265804,26,32382,1245.461538,1361978885712,1361978885776,2400264516,2400264580,64
1361978887,2400265836,44,52029,1182.477273,1361978880498,1361978883314,2400259334,2400262150,2816
1361978890,2400268608,1,52,52,1361978863126,1361978863126,2400241734,2400241734,0
1361978895,2400273748,4,356,89,1361978881671,1361978889095,2400260419,2400267843,7424
1361978895,2400273756,4,1279,319.75,1361978887422,1361978887550,2400266178,2400266306,128
1361978895,2400273764,4,740,185,1361978883513,1361978891129,2400262277,2400269893,7616
1361978895,2400273764,8,6716,839.5,1361978888441,1361978888569,2400267205,2400267333,128
1361978895,2400273764,21,23336,1111.238095,1361978883641,1361978893177,2400262405,2400271941,9536
1361978895,2400273764,17,19968,1174.588235,1361978883831,1361978891127,2400262595,2400269891,7296
1361978895,2400273764,27,32385,1199.444444,1361978883895,1361978891127,2400262659,2400269891,7232
1361978895,2400273780,16,16581,1036.3125,1361978884007,1361978891111,2400262787,2400269891,7104
1361978895,2400273784,14,13563,968.7857143,1361978884066,1361978893154,2400262850,2400271938,9088
1361978895,2400273796,4,576,144,1361978887511,1361978887639,2400266307,2400266435,128
1361978895,2400273800,4,1544,386,1361978887765,1361978887893,2400266565,2400266693,128
1361978895,2400273828,6,3276,546,1361978888120,1361978888376,2400266948,2400267204,256
1361978896,1038588632,8,6861,857.625,1361978888159,1361978888223,1038580791,1038580855,64
1361978896,1038588632,5,2624,524.8,1361978888477,1361978888477,1038581109,1038581109,0
1361978896,1038588636,6,1992,332,1361978884572,1361978891612,1038577208,1038584248,7040
1361978896,1038588644,4,1369,342.25,1361978888979,1361978889107,1038581623,1038581751,128
1361978896,1038588644,4,1232,308,1361978889107,1361978889235,1038581751,1038581879,128
1361978902,2400280676,12,6858,571.5,1361978877520,1361978879696,2400256196,2400258372,2176
1361978906,2400284708,4,491,122.75,1361978879729,1361978879793,2400258437,2400258501,64
1361978999,2400377808,4,184,46,1361978991180,1361978991180,2400369988,2400369988,0
1361979018,2400396732,9,3463,384.7777778,1361978991256,1361978991576,2400369988,2400370308,320
1361979023,2400401796,29,37123,1280.103448,1361979010838,1361979016982,2400389634,2400395778,6144
1361979023,2400401796,110,151896,1380.872727,1361979010837,1361979018965,2400389633,2400397761,8128
1361979063,2400441896,190,265863,1399.278947,1361979055664,1361979061936,2400434560,2400440832,6272
1361979087,2400465848,5,1982,396.4,1361979079136,1361979085216,2400457984,2400464064,6080
1361979095,2400473824,4,784,196,1361979088122,1361979088314,2400466946,2400467138,192
1361979095,2400473864,10,10081,1008.1,1361979086674,1361979093266,2400465538,2400472130,6592
1361979095,2400473864,3,649,216.3333333,1361979087632,1361979087632,2400466496,2400466496,0
1361979095,2400473864,5,880,176,1361979086864,1361979086864,2400465728,2400465728,0
1361979095,2400473888,15,17217,1147.8,1361979088119,1361979088183,2400467007,2400467071,64
1361979095,2400473892,27,33046,1223.925926,1361979088119,1361979088183,2400467011,2400467075,64
1361979096,1038788640,4,464,116,1361979088216,1361979095832,1038780856,1038788472,7616
1361979103,2400481228,8,3169,396.125,1361979075854,1361979076302,2400454082,2400454530,448
1361979103,2400481836,4,1342,335.5,1361979087982,1361979095278,2400466818,2400474114,7296
1361979103,2400481904,4,592,148,1361979087401,1361979095209,2400466305,2400474113,7808
1361979111,2400489864,3,421,140.3333333,1361979105170,1361979105234,2400484034,2400484098,64
1361979111,2400489872,31,38205,1232.419355,1361979105927,1361979106375,2400484799,2400485247,448
1361979111,2400489920,5,880,176,1361979104793,1361979104857,2400483713,2400483777,64
1361979112,1038804640,4,464,116,1361979105815,1361979111831,1038798455,1038804471,6016
1361979115,2400493208,33,42944,1301.333333,1361979088800,1361979088928,2400467008,2400467136,128
1361979119,2400497828,2,131,65.5,1361979111477,1361979111477,2400490305,2400490305,0
1361979119,2400497836,10,10121,1012.1,1361979104750,1361979111278,2400483586,2400490114,6528
1361979119,2400497860,4,592,148,1361979105364,1361979113236,2400484224,2400492096,7872
1361979119,2400497864,27,34074,1262,1361979105935,1361979113231,2400484799,2400492095,7296
1361979119,2400497868,31,38781,1251,1361979106125,1361979113229,2400484993,2400492097,7104
1361979119,2400497912,4,1095,273.75,1361979104929,1361979111201,2400483841,2400490113,6272
1361979119,2400497916,4,686,171.5,1361979105820,1361979113180,2400484736,2400492096,7360
1361979120,2400497940,21,25337,1206.52381,1361979106860,1361979114156,2400484800,2400492096,7296
1361979127,2400505832,4,356,89,1361979112432,1361979119280,2400491264,2400498112,6848
1361979127,2400505832,5,880,176,1361979123887,1361979123951,2400502719,2400502783,64
1361979127,2400505836,4,382,95.5,1361979112750,1361979119342,2400491586,2400498178,6592
1361979127,2400505856,3,421,140.3333333,1361979124633,1361979124697,2400503489,2400503553,64
1361979127,2400505856,57,76855,1348.333333,1361979124951,1361979125079,2400503807,2400503935,128
1361979127,2400505908,4,382,95.5,1361979112678,1361979119270,2400491586,2400498178,6592
1361979135,2400513872,4,592,148,1361979124424,1361979131336,2400503296,2400510208,6912
1361979135,2400513876,4,686,171.5,1361979124806,1361979131334,2400503682,2400510210,6528
1361979135,2400513876,13,13061,1004.692308,1361979124997,1361979131333,2400503873,2400510209,6336
1361979135,2400513888,4,716,179,1361979122874,1361979129338,2400501762,2400508226,6464
1361979135,2400513888,10,9800,980,1361979123000,1361979129336,2400501888,2400508224,6336
1361979135,2400513928,9,8226,914,1361979124879,1361979131279,2400503807,2400510207,6400
1361979135,2400513928,7,5409,772.7142857,1361979124943,1361979131343,2400503871,2400510271,6400
1361979136,1038828632,4,464,116,1361979125215,1361979131999,1038817847,1038824631,6784
1361979147,2400525208,1,46,46,1361979120224,1361979120224,2400498432,2400498432,0
1361979147,2400525208,1,46,46,1361979120352,1361979120352,2400498560,2400498560,0
1361979151,2400529816,4,574,143.5,1361979150401,1361979150785,2400529217,2400529601,384
1361979151,2400529816,5,574,114.8,1361979150400,1361979150592,2400529216,2400529408,192
1361979151,2400529852,4,700,175,1361979148572,1361979148700,2400527424,2400527552,128
1361979151,2400529852,6,3408,568,1361979148826,1361979148890,2400527678,2400527742,64
1361979151,2400529860,32,41153,1286.03125,1361979149077,1361979149397,2400527937,2400528257,320
1361979151,2400529860,3,421,140.3333333,1361979149460,1361979149524,2400528320,2400528384,64
1361979151,2400529860,5,563,112.6,1361979149843,1361979149971,2400528703,2400528831,128
1361979151,2400529860,5,563,112.6,1361979149907,1361979149971,2400528767,2400528831,64
1361979151,2400529864,5,563,112.6,1361979150351,1361979150415,2400529215,2400529279,64
1361979151,2400529868,5,880,176,1361979146892,1361979146956,2400525760,2400525824,64
1361979151,2400529868,5,563,112.6,1361979150667,1361979150731,2400529535,2400529599,64
1361979151,2400529896,3,421,140.3333333,1361979148017,1361979148081,2400526913,2400526977,64
1361979151,2400529896,4,576,144,1361979148208,1361979148272,2400527104,2400527168,64
1361979151,2400529900,21,25485,1213.571429,1361979148779,1361979149163,2400527679,2400528063,384
1361979151,2400529908,22,26524,1205.636364,1361979149670,1361979149862,2400528578,2400528770,192
1361979151,2400529908,46,58888,1280.173913,1361979149542,1361979149862,2400528450,2400528770,320
1361979151,2400529908,4,574,143.5,1361979149925,1361979150309,2400528833,2400529217,384
1361979151,2400529908,4,850,212.5,1361979149924,1361979150116,2400528832,2400529024,192
1361979152,1038844644,11,10471,951.9090909,1361979150291,1361979150291,1038842935,1038842935,0
1361979152,1038844644,5,2740,548,1361979150163,1361979150291,1038842807,1038842935,128
1361979159,2400537852,11,11204,1018.545455,1361979151132,1361979151964,2400529984,2400530816,832
1361979159,2400537852,11,10403,945.7272727,1361979146779,1361979154651,2400525631,2400533503,7872
1361979159,2400537856,5,573,114.6,1361979150745,1361979150937,2400529601,2400529793,192
1361979159,2400537856,5,563,112.6,1361979151385,1361979151449,2400530241,2400530305,64
1361979159,2400537856,20,22682,1134.1,1361979150808,1361979151064,2400529664,2400529920,256
1361979159,2400537864,4,1339,334.75,1361979148050,1361979154642,2400526914,2400533506,6592
1361979159,2400537864,53,71448,1348.075472,1361979148050,1361979154642,2400526914,2400533506,6592
1361979159,2400537864,13,13772,1059.384615,1361979148113,1361979154641,2400526977,2400533505,6528
1361979159,2400537900,4,548,137,1361979149038,1361979152110,2400527938,2400531010,3072
1361979159,2400537904,6,1448,241.3333333,1361979146534,1361979156582,2400525438,2400535486,10048
1361979159,2400537928,5,608,121.6,1361979151888,1361979152208,2400530816,2400531136,320
1361979160,2400537932,12,11909,992.4166667,1361979148982,1361979155574,2400526914,2400533506,6592
1361979160,2400537932,9,8479,942.1111111,1361979149046,1361979155574,2400526978,2400533506,6528
1361979160,2400537932,8,6911,863.875,1361979153269,1361979153461,2400531201,2400531393,192
1361979160,2400537932,5,574,114.8,1361979153269,1361979153397,2400531201,2400531329,128
1361979160,2400537932,4,835,208.75,1361979153523,1361979153587,2400531455,2400531519,64
1361979160,2400537936,5,504,100.8,1361979153646,1361979153710,2400531582,2400531646,64
1361979160,2400537940,5,563,112.6,1361979154285,1361979154413,2400532225,2400532353,128
1361979160,1038852640,5,2687,537.4,1361979153305,1361979153433,1038845945,1038846073,128
1361979160,1038852648,5,825,165,1361979148625,1361979157265,1038841273,1038849913,8640
1361979167,2400545864,5,563,112.6,1361979159119,1361979159247,2400537983,2400538111,128
1361979167,2400545872,5,563,112.6,1361979159881,1361979159945,2400538753,2400538817,64
1361979167,2400545904,2,92,46,1361979164967,1361979164967,2400543871,2400543871,0
1361979183,2400561224,1,46,46,1361979155023,1361979155023,2400533247,2400533247,0
1361979183,2400561284,16,8275,517.1875,1361979154965,1361979155989,2400533249,2400534273,1024
1361979183,2400561912,14,14155,1011.071429,1361979182622,1361979182814,2400561534,2400561726,192
1361979183,2400561916,2,92,46,1361979175453,1361979175453,2400554369,2400554369,0
1361979191,2400569300,32,13076,408.625,1361979165570,1361979177154,2400543870,2400555454,11584
1361979191,2400569864,6,1704,284,1361979182927,1361979183055,2400561791,2400561919,128
1361979191,2400569872,37,47311,1278.675676,1361979183241,1361979183561,2400562113,2400562433,320
1361979191,2400569872,7,4298,614,1361979182855,1361979182983,2400561727,2400561855,128
1361979191,2400569872,4,356,89,1361979179078,1361979186502,2400557950,2400565374,7424
1361979191,2400569904,10,8885,888.5,1361979185447,1361979185639,2400564351,2400564543,192
1361979191,2400569908,6,992,165.3333333,1361979185637,1361979185829,2400564545,2400564737,192
1361979191,2400569908,22,10430,474.0909091,1361979188580,1361979189860,2400567488,2400568768,1280
1361979191,2400569912,26,24962,960.0769231,1361979177889,1361979190497,2400556801,2400569409,12608
1361979191,2400569912,5,1138,227.6,1361979188960,1361979189088,2400567872,2400568000,128
1361979192,2400569936,25,29406,1176.24,1361979183790,1361979184046,2400561726,2400561982,256
1361979192,2400569936,9,6872,763.5555556,1361979188014,1361979188398,2400565950,2400566334,384
1361979192,2400569936,7,4570,652.8571429,1361979183854,1361979183982,2400561790,2400561918,128
1361979192,2400569944,11,10236,930.5454545,1361979185511,1361979185575,2400563455,2400563519,64
1361979192,2400569948,53,63074,1190.075472,1361979186338,1361979189922,2400564286,2400567870,3584
1361979192,2400569948,7,3979,568.4285714,1361979186402,1361979186594,2400564350,2400564542,192
1361979192,2400569948,7,2497,356.7142857,1361979186402,1361979186594,2400564350,2400564542,192
1361979192,2400569952,9,7554,839.3333333,1361979186593,1361979186785,2400564545,2400564737,192
1361979192,2400569952,9,6413,712.5555556,1361979186784,1361979187104,2400564736,2400565056,320
1361979192,2400569984,4,651,162.75,1361979189887,1361979190015,2400567871,2400567999,128
1361979192,2400569988,36,39297,1091.583333,1361979190907,1361979191547,2400568895,2400569535,640
1361979199,2400577904,87,116449,1338.494253,1361979188774,1361979196518,2400567678,2400575422,7744
1361979199,2400577908,7,2901,414.4285714,1361979194085,1361979194917,2400572993,2400573825,832
1361979199,2400577912,24,23267,969.4583333,1361979190049,1361979198497,2400568961,2400577409,8448
1361979200,2400577940,2,131,65.5,1361979196525,1361979196525,2400574465,2400574465,0
1361979200,2400577944,12,12682,1056.833333,1361979185383,1361979193447,2400563327,2400571391,8064
1361979200,2400577944,18,17104,950.2222222,1361979185383,1361979193511,2400563327,2400571455,8128
1361979200,2400577948,27,29698,1099.925926,1361979186210,1361979193506,2400564158,2400571454,7296
1361979200,2400577948,8,4807,600.875,1361979186274,1361979193506,2400564222,2400571454,7232
1361979200,2400577952,18,21197,1177.611111,1361979186528,1361979193440,2400564480,2400571392,6912
1361979200,2400577952,8,4585,573.125,1361979187102,1361979193502,2400565054,2400571454,6400
1361979200,2400577952,6,1114,185.6666667,1361979194846,1361979194974,2400572798,2400572926,128
1361979203,2400581544,6,884,147.3333333,1361979175822,1361979178190,2400554366,2400556734,2368
1361979207,2400585908,23,28622,1244.434783,1361979193700,1361979200484,2400572608,2400579392,6784
1361979207,2400585908,4,854,213.5,1361979194020,1361979200548,2400572928,2400579456,6528
1361979208,2400585976,4,854,213.5,1361979194953,1361979201481,2400572929,2400579457,6528
1361979208,2400585976,4,854,213.5,1361979194953,1361979201481,2400572929,2400579457,6528
1361979208,2400585976,8,2953,369.125,1361979195017,1361979203465,2400572993,2400581441,8448
1361979208,2400585976,8,2953,369.125,1361979195017,1361979203465,2400572993,2400581441,8448
1361988655,2410032996,1,52,52,1361988629475,1361988629475,2410007471,2410007471,0
1361988658,2410036148,4,186,46.5,1361988637772,1361988654284,2410015920,2410032432,16512
1361988659,2410036956,2,265,132.5,1361988634444,1361988634508,2410012400,2410012464,64
1361988671,2410048936,9,1883,209.2222222,1361988643552,1361988651744,2410021488,2410029680,8192
1361988671,2410049048,1,46,46,1361988644018,1361988644018,2410022066,2410022066,0
1361988683,2410060988,3,142,47.33333333,1361988658797,1361988659053,2410036785,2410037041,256
1361988691,2410068992,1,84,84,1361988663783,1361988663783,2410041775,2410041775,0
1361988699,2410077104,1,95,95,1361988672822,1361988672822,2410050926,2410050926,0
1361988706,2410084248,7,352,50.28571429,1361988689192,1361988704936,2410067440,2410083184,15744
1361988715,2410093032,2,265,132.5,1361988690304,1361988690368,2410068336,2410068400,64
1361988715,2410093076,3,147,49,1361988689045,1361988689365,2410067121,2410067441,320
1361988715,2410093120,1,46,46,1361988687145,1361988687145,2410065265,2410065265,0
1361988715,2410093220,2,92,46,1361988689218,1361988709762,2410067438,2410087982,20544
1361988722,2410100168,8,483,60.375,1361988718392,1361988719416,2410096560,2410097584,1024
1361988727,2410105140,15,1872,124.8,1361988700116,1361988701588,2410078256,2410079728,1472
1361988731,2410109064,2,174,87,1361988703328,1361988715232,2410081392,2410093296,11904
1361988743,2410121136,1,46,46,1361988715158,1361988715158,2410093294,2410093294,0
1361988755,2410133052,3,643,214.3333333,1361988727149,1361988741293,2410105201,2410119345,14144
1361988775,2410153044,2,265,132.5,1361988745971,1361988746035,2410124015,2410124079,64
1361988775,2410153140,3,142,47.33333333,1361988747601,1361988747921,2410125741,2410126061,320
1361988787,2410165096,7,476,68,1361988760126,1361988767102,2410138222,2410145198,6976
1361988791,2410169136,1,46,46,1361988765590,1361988765590,2410143726,2410143726,0
1361988810,2410188308,4,186,46.5,1361988805356,1361988805996,2410183664,2410184304,640
1361988821,1048513796,6,1163,193.8333333,1361988792892,1361988802236,1048485688,1048495032,9344
1361988823,2410201464,17,2088,122.8235294,1361988796367,1361988819791,2410174831,2410198255,23424
1361988827,2410205420,2,265,132.5,1361988801082,1361988801146,2410179502,2410179566,64
1361988850,2410228340,3,160,53.33333333,1361988844616,1361988844808,2410222956,2410223148,192
1361988850,2410228344,3,160,53.33333333,1361988845060,1361988845252,2410223404,2410223596,192
1361988850,2410228348,8,504,63,1361988845441,1361988846913,2410223789,2410225261,1472
1361988863,2410241392,1,46,46,1361988835220,1361988835220,2410213612,2410213612,0
1361988863,2410241480,1,46,46,1361988834877,1361988834877,2410213357,2410213357,0
1361988867,2410245544,1,95,95,1361988840702,1361988840702,2410219246,2410219246,0
1361988871,2410249592,1,52,52,1361988845198,1361988845198,2410223790,2410223790,0
1361988874,2410252340,9,531,59,1361988864905,1361988866121,2410243245,2410244461,1216
1361988883,2410261596,2,265,132.5,1361988856777,1361988856841,2410235373,2410235437,64
1361988890,2410268268,4,254,63.5,1361988881808,1361988883152,2410260076,2410261420,1344
1361988890,2410268268,10,688,68.8,1361988881808,1361988887888,2410260076,2410266156,6080
1361988890,2410268372,4,254,63.5,1361988881706,1361988883114,2410260078,2410261486,1408
1361988895,2410273456,21,2323,110.6190476,1361988868437,1361988880469,2410246893,2410258925,12032
1361988895,2410273528,4,188,47,1361988867787,1361988880459,2410246315,2410258987,12672
1361988898,2410276288,5,302,60.4,1361988882619,1361988892603,2410260907,2410270891,9984
1361988898,2410276288,11,7449,677.1818182,1361988892155,1361988895611,2410270443,2410273899,3456
1361988898,2410276352,3,144,48,1361988891131,1361988891259,2410269483,2410269611,128
1361988898,2410276404,4,2775,693.75,1361988893257,1361988893257,2410271661,2410271661,0
1361988898,2410276412,7,2548,364,1361988894209,1361988894465,2410272621,2410272877,256
1361988898,2410276412,7,2513,359,1361988894529,1361988894785,2410272941,2410273197,256
1361988906,2410284404,6,349,58.16666667,1361988891656,1361988903944,2410270060,2410282348,12288
1361988911,2410289516,1,80,80,1361988886490,1361988886490,2410265006,2410265006,0
1361988915,2410293528,3,498,166,1361988889358,1361988895438,2410267886,2410273966,6080
1361988915,2410293560,8,3032,379,1361988890219,1361988892395,2410268779,2410270955,2176
1361988915,2410293568,46,63362,1377.434783,1361988890406,1361988890598,2410268974,2410269166,192
1361988919,2410297444,23,12494,543.2173913,1361988890913,1361988892897,2410269357,2410271341,1984
1361988919,2410297452,9,3691,410.1111111,1361988891480,1361988891992,2410269932,2410270444,512
1361988919,2410297452,8,4516,564.5,1361988891544,1361988891928,2410269996,2410270380,384
1361988919,2410297456,1,46,46,1361988891603,1361988891603,2410270059,2410270059,0
1361988919,2410297460,8,6413,801.625,1361988892050,1361988892818,2410270510,2410271278,768
1361988919,2410297492,6,2374,395.6666667,1361988893167,1361988893231,2410271659,2410271723,64
1361988919,2410297532,11,8038,730.7272727,1361988890890,1361988891274,2410269422,2410269806,384
1361988919,2410297536,6,899,149.8333333,1361988891332,1361988891588,2410269868,2410270124,256
1361988919,2410297560,66,85608,1297.090909,1361988891756,1361988892844,2410270316,2410271404,1088
1361988919,2410297564,8,4659,582.375,1361988891945,1361988892393,2410270509,2410270957,448
1361988919,2410297564,11,9143,831.1818182,1361988892072,1361988892520,2410270636,2410271084,448
1361988919,2410297568,10,8112,811.2,1361988892579,1361988892899,2410271147,2410271467,320
1361988919,2410297572,2,1349,674.5,1361988892960,1361988893024,2410271532,2410271596,64
1361988919,2410297572,6,963,160.5,1361988892640,1361988892896,2410271212,2410271468,256
1361988919,2410297572,23,22690,986.5217391,1361988893087,1361988896479,2410271659,2410275051,3392
1361988919,2410297576,1,46,46,1361988893150,1361988893150,2410271726,2410271726,0
1361988921,1048614040,29,39633,1366.655172,1361988893063,1361988893127,1048586103,1048586167,64
1361988922,2410300372,4,314,78.5,1361988916326,1361988916454,2410294698,2410294826,128
1361988923,2410301476,1,95,95,1361988898306,1361988898306,2410276782,2410276782,0
1361988923,2410301696,6,2307,384.5,1361988896226,1361988896418,2410274922,2410275114,192
1361988930,2410308408,8,1054,131.75,1361988920644,1361988924484,2410299052,2410302892,3840
1361988939,2410317528,2,265,132.5,1361988912139,1361988912203,2410290667,2410290731,64
1361988943,2410321536,2,92,46,1361988916354,1361988916354,2410294890,2410294890,0
1361988945,1048638184,7,1431,204.4285714,1361988920377,1361988920633,1048613561,1048613817,256
1361988946,2410324392,6,344,57.33333333,1361988930771,1361988941139,2410309163,2410319531,10368
1361988947,2410325624,1,46,46,1361988921258,1361988921258,2410299882,2410299882,0
1361988951,2410329504,9,644,71.55555556,1361988924132,1361988948260,2410302636,2410326764,24128
1361988955,2410333516,1,46,46,1361988930712,1361988930712,2410309228,2410309228,0
1361988967,2410345836,5,918,183.6,1361988939225,1361988960281,2410318061,2410339117,21056
1361988978,2410356344,14,6929,494.9285714,1361988975429,1361988975813,2410353773,2410354157,384
1361988979,2410357776,4,188,47,1361988954709,1361988964309,2410333485,2410343085,9600
1361988979,2410357776,1,46,46,1361988954898,1361988954898,2410333674,2410333674,0
1361988979,2410357780,6,1268,211.3333333,1361988950992,1361988977808,2410329772,2410356588,26816
1361988983,2410361788,1,77,77,1361988955782,1361988955782,2410334570,2410334570,0
1361988983,2410361872,1,77,77,1361988955698,1361988955698,2410334570,2410334570,0
1361988991,2410369812,1,82,82,1361988963952,1361988963952,2410342764,2410342764,0
1361988995,2410373800,2,265,132.5,1361988967418,1361988967482,2410346218,2410346282,64
1361989019,2410397896,1,63,63,1361988992220,1361988992220,2410371116,2410371116,0
1361989023,2410401888,1,46,46,1361988998117,1361988998117,2410377005,2410377005,0
1361989027,2410405884,8,549,68.625,1361988999400,1361989010856,2410378284,2410389740,11456
1361989040,2410417948,1,46,46,1361989015631,1361989015631,2410393579,2410393579,0
1361989048,2410425940,2,265,132.5,1361989023703,1361989023767,2410401643,2410401707,64
1361989056,2410433908,7,1321,188.7142857,1361989029560,1361989037496,2410407468,2410415404,7936
1361989066,2410444516,3,160,53.33333333,1361989064727,1361989064919,2410443243,2410443435,192
1361989066,2410444516,3,160,53.33333333,1361989064724,1361989064916,2410443240,2410443432,192
1361989074,2410452428,8,509,63.625,1361989064876,1361989066220,2410443304,2410444648,1344
1361989088,2410465912,16,1107,69.1875,1361989060400,1361989061488,2410438312,2410439400,1088
1361989092,2410469944,1,52,52,1361989064208,1361989064208,2410442152,2410442152,0
1361989100,2410477960,2,92,46,1361989075522,1361989085442,2410453482,2410463402,9920
1361989100,2410478048,1,46,46,1361989075690,1361989075690,2410453738,2410453738,0
1361989104,2410482080,2,265,132.5,1361989079112,1361989079176,2410457192,2410457256,64
1361989116,2410494008,1,46,46,1361989090002,1361989090002,2410468010,2410468010,0
1361989116,2410494056,7,522,74.57142857,1361989088801,1361989113057,2410466857,2410491113,24256
1361989148,2410526152,1,46,46,1361989123007,1361989123007,2410501159,2410501159,0
1361989154,2410532432,11,5602,509.2727273,1361989135527,1361989150823,2410513959,2410529255,15296
1361989156,2410534024,1,46,46,1361989131904,1361989131904,2410509928,2410509928,0
1361989160,2410538160,2,265,132.5,1361989134328,1361989134392,2410512488,2410512552,64
1361989168,2410546280,1,95,95,1361989140799,1361989140799,2410519079,2410519079,0
1361989172,2410550224,3,142,47.33333333,1361989147449,1361989147769,2410525673,2410525993,320
1361989180,2410558144,3,469,156.3333333,1361989154314,1361989154442,2410532458,2410532586,128
1361989192,2410570212,2,128,64,1361989166530,1361989167426,2410544742,2410545638,896
1361989196,2410574172,9,1560,173.3333333,1361989170222,1361989194670,2410548394,2410572842,24448
1361989212,2410590096,1,46,46,1361989184502,1361989184502,2410562598,2410562598,0
1361989216,2410594316,2,265,132.5,1361989190043,1361989190107,2410568359,2410568423,64
1361989220,2410598208,1,46,46,1361989195401,1361989195401,2410573609,2410573609,0
1361989220,2410598364,1,46,46,1361989195498,1361989195498,2410573862,2410573862,0
1361989240,2410618416,1,56,56,1361989214969,1361989214969,2410593385,2410593385,0
1361989244,2410622280,1,46,46,1361989219325,1361989219325,2410597605,2410597605,0
1361989248,2410626172,2,190,95,1361989220652,1361989245676,2410598824,2410623848,25024
1361989272,2410650304,2,265,132.5,1361989246056,1361989246120,2410624360,2410624424,64
1361989274,2410652624,3,186,62,1361989269031,1361989269415,2410647655,2410648039,384
1361989274,2410652704,3,186,62,1361989269013,1361989269397,2410647717,2410648101,384
1361989276,2410654316,6,289,48.16666667,1361989251547,1361989253787,2410629863,2410632103,2240
1361989276,2410654460,9,6037,670.7777778,1361989251276,1361989251852,2410629736,2410630312,576
1361989280,2410658240,6,1262,210.3333333,1361989252006,1361989274982,2410630246,2410653222,22976
1361989282,2410660612,7,495,70.71428571,1361989269107,1361989274291,2410647719,2410652903,5184
1361989296,2410674208,2,120,60,1361989268358,1361989271366,2410646566,2410649574,3008
1361989316,2410694196,1,478,478,1361989288593,1361989288593,2410666789,2410666789,0
1361989316,2410694196,1,84,84,1361989288593,1361989288593,2410666789,2410666789,0
1361989316,2410694196,1,48,48,1361989288592,1361989288592,2410666788,2410666788,0
1361989316,2410694200,1,1285,1285,1361989288655,1361989288655,2410666855,2410666855,0
1361989316,2410694232,1,48,48,1361989288814,1361989288814,2410667046,2410667046,0
1361989316,2410694316,1,49,49,1361989288602,1361989288602,2410666918,2410666918,0
1361989322,2410700652,3,156,52,1361989315593,1361989315721,2410694245,2410694373,128
1361989322,2410700656,7,433,61.85714286,1361989315846,1361989316614,2410694502,2410695270,768
1361989322,2410700696,3,156,52,1361989315230,1361989315358,2410693926,2410694054,128
1361989328,2410706212,2,265,132.5,1361989301952,1361989302016,2410680164,2410680228,64
1361989328,2410706336,1,95,95,1361989302534,1361989302534,2410680870,2410680870,0
1361989340,2410718272,3,138,46,1361989315589,1361989315589,2410693861,2410693861,0
1361989340,2410718272,1,128,128,1361989315589,1361989315589,2410693861,2410693861,0
1361989344,2410722248,3,144,48,1361989316252,1361989325276,2410694500,2410703524,9024
1361989348,2410726336,1,46,46,1361989323461,1361989323461,2410701797,2410701797,0
1361989356,2410734256,8,591,73.875,1361989328021,1361989354325,2410706277,2410732581,26304
1361989368,2410746280,3,142,47.33333333,1361989340412,1361989340732,2410718692,2410719012,320
1361989368,2410746320,4,1225,306.25,1361989341909,1361989341909,2410720229,2410720229,0
1361989368,2410746404,22,13337,606.2272727,1361989341888,1361989342208,2410720292,2410720612,320
1361989380,2410758368,1,46,46,1361989354085,1361989354085,2410732453,2410732453,0
1361989384,2410762328,2,265,132.5,1361989357326,1361989357390,2410735654,2410735718,64
1361989388,2410766368,15,1504,100.2666667,1361989362021,1361989382757,2410740389,2410761125,20736
1361989394,2410772748,3,160,53.33333333,1361989393258,1361989393514,2410772006,2410772262,256
1361989394,2410772824,3,160,53.33333333,1361989392540,1361989392924,2410771364,2410771748,384
1361989400,2410778396,2,92,46,1361989375432,1361989375432,2410753828,2410753828,0
1361989402,2410780836,7,463,66.14285714,1361989393616,1361989395088,2410772452,2410773924,1472
1361989420,2410798512,1,52,52,1361989393942,1361989393942,2410772454,2410772454,0
1361989440,2410818376,2,190,95,1361989412126,1361989437982,2410790502,2410816358,25856
1361989440,2410818460,2,265,132.5,1361989412424,1361989412488,2410790884,2410790948,64
1361989456,2410834496,4,188,47,1361989428197,1361989435429,2410806693,2410813925,7232
1361989460,2410838552,1,46,46,1361989435562,1361989435562,2410814114,2410814114,0
1361989484,2410862752,1,46,46,1361989457508,1361989457508,2410836260,2410836260,0
1361989484,2410862844,1,46,46,1361989457417,1361989457417,2410836261,2410836261,0
1361989492,2410870700,9,1558,173.1111111,1361989464280,1361989489368,2410842980,2410868068,25088
1361989496,2410874712,2,265,132.5,1361989468108,1361989468172,2410846820,2410846884,64
1361989508,2410886816,1,46,46,1361989480353,1361989480353,2410859169,2410859169,0
1361989520,2410898828,5,234,46.8,1361989495189,1361989513237,2410874017,2410892065,18048
1361989540,2410918816,1,95,95,1361989514273,1361989514273,2410893089,2410893089,0
1361989548,2410926860,2,265,132.5,1361989523319,1361989523383,2410902179,2410902243,64
1361989554,2410932844,10,653,65.3,1361989548550,1361989549574,2410927394,2410928418,1024
1361989556,2410934740,1,80,80,1361989531309,1361989531309,2410910049,2410910049,0
1361989568,2410946764,6,1132,188.6666667,1361989541909,1361989552853,2410920673,2410931617,10944
1361989572,2410950836,1,46,46,1361989546192,1361989546192,2410925028,2410925028,0
1361989580,2410958800,1,46,46,1361989555314,1361989555314,2410934114,2410934114,0
1361989580,2410958800,1,46,46,1361989555377,1361989555377,2410934177,2410934177,0
1361989580,2410958880,1,46,46,1361989555108,1361989555108,2410933988,2410933988,0
1361989596,2410974724,6,427,71.16666667,1361989570622,1361989570686,2410949346,2410949410,64
1361989604,2410982784,2,265,132.5,1361989579201,1361989579265,2410957985,2410958049,64
1361989610,2410988824,3,190,63.33333333,1361989603545,1361989603673,2410982369,2410982497,128
1361989610,2410988828,3,190,63.33333333,1361989603798,1361989603926,2410982626,2410982754,128
1361989610,2410988860,10,683,68.3,1361989603957,1361989604725,2410982817,2410983585,768
1361989625,2411003120,1,95,95,1361989598618,1361989598618,2410976738,2410976738,0
1361989632,2411010748,1,64,64,1361989604198,1361989604198,2410982946,2410982946,0
1361989632,2411010800,1,460,460,1361989607025,1361989607025,2410985825,2410985825,0
1361989633,2411010908,1,478,478,1361989608046,1361989608046,2410985954,2410985954,0
1361989633,2411010912,1,82,82,1361989608105,1361989608105,2410986017,2410986017,0
1361989634,2411012832,3,160,53.33333333,1361989633043,1361989633171,2411011875,2411012003,128
1361989634,2411012836,3,160,53.33333333,1361989633230,1361989633358,2411012066,2411012194,128
1361989636,2411014844,3,498,166,1361989610118,1361989616262,2410988962,2410995106,6144
1361989642,2411020848,8,519,64.875,1361989633410,1361989634626,2411012258,2411013474,1216
1361989652,2411030856,8,1424,178,1361989625274,1361989650362,2411004130,2411029218,25088
1361989660,2411038836,1,104,104,1361989635148,1361989635148,2411013984,2411013984,0
1361989660,2411038864,3,152,50.66666667,1361989633391,1361989642415,2411012255,2411021279,9024
1361989661,2411038920,2,265,132.5,1361989635747,1361989635939,2411013667,2411013859,192
1361989661,2411038956,1,46,46,1361989634558,1361989634558,2411012514,2411012514,0
1361989689,2411066972,8,557,69.625,1361989662381,1361989677869,2411040353,2411055841,15488
1361989693,2411070908,6,280,46.66666667,1361989668013,1361989675117,2411045921,2411053025,7104
1361989701,2411078944,1,46,46,1361989676298,1361989676298,2411054242,2411054242,0
1361989717,2411094916,2,265,132.5,1361989691747,1361989691811,2411069663,2411069727,64
1361989732,2411110868,2,190,95,1361989706157,1361989730349,2411085025,2411109217,24192
1361989753,2411131056,5,234,46.8,1361989727895,1361989750935,2411105951,2411128991,23040
1361989769,2411146996,2,572,286,1361989743957,1361989743957,2411121953,2411121953,0
1361989773,2411151036,2,265,132.5,1361989747436,1361989747500,2411125472,2411125536,64
1361989797,2411175148,13,1656,127.3846154,1361989772666,1361989781434,2411150814,2411159582,8768
1361989813,2411191036,4,188,47,1361989787949,1361989804909,2411165985,2411182945,16960
1361989821,2411199112,1,46,46,1361989796192,1361989796192,2411174304,2411174304,0
1361989825,2411203076,3,645,215,1361989800067,1361989804227,2411178143,2411182303,4160
1361989829,2411207004,2,265,132.5,1361989803532,1361989803596,2411181536,2411181600,64
1361989837,2411215176,5,230,46,1361989810016,1361989830240,2411188192,2411208416,20224
1361989841,2411219160,1,46,46,1361989816238,1361989816238,2411194398,2411194398,0
1361989851,2411228952,3,190,63.33333333,1361989849021,1361989849213,2411226973,2411227165,192
1361989851,2411229116,3,190,63.33333333,1361989848412,1361989848668,2411226528,2411226784,256
1361989857,2411235052,7,1299,185.5714286,1361989831580,1361989856732,2411209632,2411234784,25152
1361989866,1049558480,8,474,59.25,1361989862718,1361989863230,1049555198,1049555710,512
1361989874,1049566488,3,150,50,1361989862710,1361989869366,1049555198,1049561854,6656
1361989882,1049574472,2,94,47,1361989869893,1361989876165,1049562365,1049568637,6272
1361989885,2411263044,2,265,132.5,1361989859171,1361989859235,2411237215,2411237279,64
1361989889,2411267172,3,147,49,1361989861793,1361989862113,2411239965,2411240285,320
1361989909,2411287132,1,95,95,1361989884681,1361989884681,2411262813,2411262813,0
1361989917,2411295260,4,188,47,1361989891336,1361989907784,2411269596,2411286044,16448
1361989921,2411299136,1,84,84,1361989894787,1361989894787,2411272923,2411272923,0
1361989921,2411299136,1,478,478,1361989894787,1361989894787,2411272923,2411272923,0
1361989921,2411299140,1,48,48,1361989894786,1361989894786,2411272926,2411272926,0
1361989921,2411299148,1,46,46,1361989895992,1361989895992,2411274140,2411274140,0
1361989921,2411299232,1,48,48,1361989894693,1361989894693,2411272925,2411272925,0
1361989933,2411311176,1,128,128,1361989907868,1361989907868,2411286044,2411286044,0
1361989937,2411315260,2,190,95,1361989910024,1361989936648,2411288284,2411314908,26624
1361989941,2411319204,2,265,132.5,1361989915008,1361989915072,2411293212,2411293276,64
1361989981,2411359556,5,234,46.8,1361989954527,1361989965471,2411333083,2411344027,10944
1361989989,2411367616,8,550,68.75,1361989961763,1361989963491,2411340379,2411342107,1728
1361989997,2411375612,2,265,132.5,1361989970153,1361989970217,2411348765,2411348829,64
1361990017,2411395552,7,518,74,1361989990053,1361990014693,2411368605,2411393245,24640
1361990041,2411419668,3,138,46,1361990014510,1361990014510,2411393178,2411393178,0
1361990053,2411431552,2,265,132.5,1361990025698,1361990025762,2411404250,2411404314,64
1361990053,2411431568,1,46,46,1361990027733,1361990027733,2411406301,2411406301,0
1361990067,2411445172,3,180,60,1361990063838,1361990063902,2411442010,2411442074,64
1361990067,2411445176,3,180,60,1361990063965,1361990064029,2411442141,2411442205,64
1361990067,2411445280,8,514,64.25,1361990063985,1361990065201,2411442265,2411443481,1216
1361990069,2411447544,1,95,95,1361990043499,1361990043499,2411422043,2411422043,0
1361990077,2411455700,3,142,47.33333333,1361990051984,1361990052304,2411430684,2411431004,320
1361990083,2411461132,3,140,46.66666667,1361990082311,1361990082631,2411460443,2411460763,320
1361990083,2411461180,3,140,46.66666667,1361990081048,1361990081304,2411459228,2411459484,256
1361990089,2411467624,3,212,70.66666667,1361990063643,1361990072667,2411442267,2411451291,9024
1361990097,2411475528,8,1323,165.375,1361990069177,1361990083577,2411447705,2411462105,14400
1361990101,2411479620,1,46,46,1361990074591,1361990074591,2411453211,2411453211,0
1361990109,2411487628,2,265,132.5,1361990081558,1361990081622,2411460186,2411460250,64
1361990121,2411499628,3,142,47.33333333,1361990093014,1361990093334,2411471642,2411471962,320
1361990126,2411503948,1,95,95,1361990098496,1361990098496,2411476444,2411476444,0
1361990153,2411531612,1,95,95,1361990127781,1361990127781,2411506393,2411506393,0
1361990157,2411535640,1,49,49,1361990129225,1361990129225,2411507865,2411507865,0
1361990161,2411539660,2,265,132.5,1361990136759,1361990136823,2411515419,2411515483,64
1361990161,2411539692,1,46,46,1361990134484,1361990134484,2411513176,2411513176,0
1361990173,2411551704,1,46,46,1361990147657,1361990147657,2411526361,2411526361,0
1361990181,2411559700,9,1872,208,1361990153613,1361990167501,2411532313,2411546201,13888
1361990205,2411583664,5,230,46,1361990180274,1361990180658,2411558938,2411559322,384
1361990217,2411595800,2,265,132.5,1361990192169,1361990192233,2411570969,2411571033,64
1361990221,2411599664,5,234,46.8,1361990194607,1361990210287,2411573271,2411588951,15680
1361990225,2411603740,2,190,95,1361990196965,1361990221989,2411575705,2411600729,25024
1361990233,2411611780,1,80,80,1361990207292,1361990207292,2411586072,2411586072,0
1361990257,2411635660,16,2731,170.6875,1361990229554,1361990251826,2411608214,2411630486,22272
1361990273,2411651816,3,311,103.6666667,1361990247319,1361990268119,2411626135,2411646935,20800
1361990275,2411653376,4,184,46,1361990253969,1361990268497,2411632345,2411646873,14528
1361990275,2411653492,3,138,46,1361990267932,1361990268444,2411646424,2411646936,512
1361990289,2411667816,12,956,79.66666667,1361990261593,1361990287641,2411640409,2411666457,26048
1361990293,2411671772,1,46,46,1361990268162,1361990268162,2411646934,2411646934,0
1361990307,2411685488,5,1180,236,1361990303198,1361990305118,2411681686,2411683606,1920
1361990321,2411699776,3,285,95,1361990295166,1361990315198,2411673942,2411693974,20032
1361990333,2411711840,3,657,219,1361990306943,1361990319999,2411685783,2411698839,13056
1361990353,2411731856,3,285,95,1361990325103,1361990345135,2411703959,2411723991,20032
1361990366,2411743936,1,219,219,1361990338372,1361990338372,2411716308,2411716308,0
1361990381,2411759824,3,285,95,1361990355149,1361990375117,2411733973,2411753941,19968
1361990387,2411765652,4,238,59.5,1361990381305,1361990384761,2411759957,2411763413,3456
1361990390,2411767980,3,405,135,1361990364571,1361990370715,2411742551,2411748695,6144
1361990398,2411776028,1,219,219,1361990373160,1361990373160,2411751188,2411751188,0
1361990410,2411788024,6,384,64,1361990382702,1361990387822,2411760726,2411765846,5120
1361990410,2411788024,6,384,64,1361990382702,1361990387950,2411760726,2411765974,5248
1361990410,2411788024,6,384,64,1361990382702,1361990387950,2411760726,2411765974,5248
1361990414,2411791936,1,95,95,1361990386053,1361990386053,2411763989,2411763989,0
1361990434,2411812056,3,152,50.66666667,1361990409421,1361990418381,2411787477,2411796437,8960
1361990434,2411812100,3,152,50.66666667,1361990407138,1361990416162,2411785238,2411794262,9024
1361990434,2411812128,3,152,50.66666667,1361990408197,1361990417221,2411786325,2411795349,9024
1361990434,2411812140,3,152,50.66666667,1361990409337,1361990418297,2411787477,2411796437,8960
1361990442,2411819972,5,320,64,1361990416416,1361990420896,2411794388,2411798868,4480
1361990442,2411819976,5,320,64,1361990416542,1361990420958,2411794518,2411798934,4416
1361990442,2411820008,4,256,64,1361990417661,1361990420925,2411795669,2411798933,3264
1361990442,2411820096,4,256,64,1361990417701,1361990421029,2411795797,2411799125,3328
1361990546,2411924320,2,104,52,1361990521412,1361990524420,2411899732,2411902740,3008
1361990550,2411928236,2,104,52,1361990523733,1361990526741,2411901969,2411904977,3008
1361990550,2411928308,2,104,52,1361990523662,1361990526670,2411901970,2411904978,3008
1361990550,2411928348,2,104,52,1361990522536,1361990525544,2411900884,2411903892,3008
1361990786,2412164728,1,52,52,1361990760106,1361990760106,2412138834,2412138834,0
1361990818,2412196740,2,96,48,1361990792347,1361990795163,2412171087,2412173903,2816
1361990818,2412196776,2,96,48,1361990790072,1361990793016,2412168848,2412171792,2944
1361990818,2412196824,2,96,48,1361990791238,1361990793990,2412170062,2412172814,2752
1361990818,2412196856,2,96,48,1361990792233,1361990795049,2412171089,2412173905,2816
1361990914,2412292812,3,402,134,1361990886547,1361990892563,2412265359,2412271375,6016
1361990971,2412349136,1,46,46,1361990944948,1361990944948,2412323084,2412323084,0
1361990988,2412366092,2,110,55,1361990984289,1361990984353,2412362381,2412362445,64
1361991087,2412465204,3,144,48,1361991061105,1361991070129,2412439309,2412448333,9024
1361991308,2412686240,4,238,59.5,1361991297416,1361991300808,2412675656,2412679048,3392
1361991396,2412774036,2,104,52,1361991369425,1361991372433,2412747461,2412750469,3008
1361991396,2412774104,2,104,52,1361991371599,1361991374607,2412749703,2412752711,3008
1361991396,2412774156,2,104,52,1361991370394,1361991373402,2412748550,2412751558,3008
1361991396,2412774184,2,104,52,1361991371519,1361991374527,2412749703,2412752711,3008
1361991504,2412882356,3,405,135,1361991479378,1361991485394,2412857734,2412863750,6016
1361991556,2412934392,3,192,64,1361991531054,1361991536622,2412909446,2412915014,5568
1361991560,2412938200,3,192,64,1361991532076,1361991536812,2412910276,2412915012,4736
1361991560,2412938316,3,192,64,1361991531960,1361991536696,2412910276,2412915012,4736
1361991560,2412938316,5,320,64,1361991531959,1361991536695,2412910275,2412915011,4736
1361991569,2412947204,1,46,46,1361991541351,1361991541351,2412919555,2412919555,0
1361991756,2413134684,4,184,46,1361991731397,1361991746565,2413110081,2413125249,15168
1361992033,2413411564,1,64,64,1361992008314,1361992008314,2413386878,2413386878,0
1362007066,2428444616,3,156,52,1362007064867,1362007065635,2428443483,2428444251,768
1362007074,2428452484,3,156,52,1362007066791,1362007073063,2428445275,2428451547,6272
1362007102,2428480264,2,104,52,1362007081602,1362007091586,2428459866,2428469850,9984
1362007126,2428504332,1,52,52,1362007101500,1362007101500,2428479832,2428479832,0
1362008161,2429539076,1,46,46,1362008135853,1362008135853,2429513929,2429513929,0
1362009194,2430572548,8,600,75,1362009167814,1362009192902,2430546362,2430571450,25088
1362009230,2430608076,4,277,69.25,1362009203357,1362009228253,2430581433,2430606329,24896
1362009871,2431249688,1,46,46,1362009843374,1362009843374,2431222062,2431222062,0
1362010207,2431584900,13,3571,274.6923077,1362010202304,1362010203328,2431580204,2431581228,1024
1362010207,2431584900,6,569,94.83333333,1362010200062,1362010200318,2431577962,2431578218,256
1362010207,2431585044,6,524,87.33333333,1362010201135,1362010201327,2431579179,2431579371,192
1362010207,2431585052,20,6133,306.65,1362010205286,1362010206374,2431583338,2431584426,1088
1362010207,2431585052,17,6928,407.5294118,1362010202149,1362010205861,2431580201,2431583913,3712
1362010215,2431592904,26,7232,278.1538462,1362010207612,1362010209468,2431585516,2431587372,1856
1362010215,2431592936,12,3821,318.4166667,1362010203229,1362010209309,2431581165,2431587245,6080
1362010223,2431600928,41,17587,428.9512195,1362010209634,1362010219362,2431587562,2431597290,9728
1362010223,2431601004,16,3800,237.5,1362010209557,1362010214997,2431587561,2431593001,5440
1362010223,2431601044,26,5202,200.0769231,1362010219246,1362010222190,2431597290,2431600234,2944
1362010224,2431602648,4,481,120.25,1362010199252,1362010199316,2431577900,2431577964,64
1362010224,2431602652,13,5474,421.0769231,1362010199376,1362010213072,2431578028,2431591724,13696
1362010224,2431602724,17,4124,242.5882353,1362010198981,1362010206277,2431577705,2431585001,7296
1362010231,2431608968,24,18935,788.9583333,1362010224124,1362010227708,2431602092,2431605676,3584
1362010232,2431610672,13,7096,545.8461538,1362010206075,1362010207099,2431584747,2431585771,1024
1362010232,2431610740,11,6687,607.9090909,1362010205110,1362010208054,2431583850,2431586794,2944
1362010232,2431610752,8,2846,355.75,1362010205611,1362010208107,2431584363,2431586859,2496
1362010233,2431611628,16,11337,708.5625,1362010206119,1362010227239,2431584747,2431605867,21120
1362010236,2431614580,10,1107,110.7,1362010208023,1362010208535,2431586603,2431587115,512
1362010244,2431622620,39,5655,145,1362010216046,1362010243566,2431594666,2431622186,27520
1362010244,2431622748,12,5868,489,1362010218028,1362010229100,2431596776,2431607848,11072
1362010247,2431625000,13,5243,403.3076923,1362010238363,1362010244507,2431616363,2431622507,6144
1362010247,2431625008,6,629,104.8333333,1362010242515,1362010244435,2431620523,2431622443,1920
1362010247,1069939744,23,23678,1029.478261,1362010239931,1362010240379,1069932675,1069933123,448
1362010247,1069939748,18,10870,603.8888889,1362010238328,1362010239096,1069931076,1069931844,768
1362010248,2431626632,9,4170,463.3333333,1362010222307,1362010223203,2431600939,2431601835,896
1362010248,2431626760,12,5282,440.1666667,1362010221219,1362010221923,2431599979,2431600683,704
1362010252,2431630688,5,1197,239.4,1362010227180,1362010229612,2431605868,2431608300,2432
1362010252,2431630804,1,185,185,1362010227509,1362010227509,2431606313,2431606313,0
1362010255,2431632912,15,7001,466.7333333,1362010244659,1362010250867,2431622571,2431628779,6208
1362010256,2431634696,1,52,52,1362010229284,1362010229284,2431607980,2431607980,0
1362010265,2431642944,2,814,407,1362010237649,1362010237969,2431615593,2431615913,320
1362010265,2431643572,38,28570,751.8421053,1362010238876,1362010262940,2431617448,2431641512,24064
1362010269,2431647276,78,102462,1313.615385,1362010243527,1362010244167,2431621803,2431622443,640
1362010269,2431647436,1,48,48,1362010240359,1362010240359,2431618795,2431618795,0
1362010269,2431647484,5,4329,865.8,1362010240820,1362010250420,2431619304,2431628904,9600
1362010281,2431658936,11,6636,603.2727273,1362010252760,1362010253208,2431630696,2431631144,448
1362010281,2431659052,3,729,243,1362010255333,1362010255653,2431633385,2431633705,320
1362010285,2431662960,16,11445,715.3125,1362010257985,1362010260993,2431635945,2431638953,3008
1362010293,2431670948,29,21105,727.7586207,1362010264972,1362010286924,2431642920,2431664872,21952
1362010295,2431672928,6,989,164.8333333,1362010289632,1362010290144,2431667560,2431668072,512
1362010295,2431672960,20,6023,301.15,1362010291075,1362010293187,2431669035,2431671147,2112
1362010295,2431672968,21,5643,268.7142857,1362010287098,1362010289018,2431665066,2431666986,1920
1362010313,2431691016,3,1937,645.6666667,1362010286411,1362010286411,2431664427,2431664427,0
1362010313,2431691124,11,10678,970.7272727,1362010286302,1362010286494,2431664426,2431664618,192
1362010317,2431694944,6,3957,659.5,1362010289744,1362010293392,2431667688,2431671336,3648
1362010319,2431697020,31,11130,359.0322581,1362010315910,1362010318854,2431693930,2431696874,2944
1362010335,2431713012,12,3446,287.1666667,1362010327373,1362010328397,2431705385,2431706409,1024
1362010335,2431713028,18,6861,381.1666667,1362010328382,1362010333886,2431706410,2431711914,5504
1362010335,2431713048,2,131,65.5,1362010328681,1362010328681,2431706729,2431706729,0
1362010345,2431723068,77,100729,1308.168831,1362010320406,1362010320918,2431698474,2431698986,512
1362010345,2431723152,62,84984,1370.709677,1362010320257,1362010320385,2431698409,2431698537,128
1362010349,2431727100,3,2340,780,1362010321077,1362010321205,2431699177,2431699305,128
1362010351,1070043748,16,12534,783.375,1362010347830,1362010348150,1070040578,1070040898,320
1362010353,2431731112,10,3756,375.6,1362010327335,1362010329511,2431705447,2431707623,2176
1362010359,2431736972,17,4262,250.7058824,1362010350580,1362010351348,2431728552,2431729320,768
1362010369,2431746956,142,187947,1323.570423,1362010239557,1362010361413,2431617513,2431739369,121856
1362010375,1070067756,13,6779,521.4615385,1362010367665,1362010367985,1070060421,1070060741,320
1362010377,2431755112,9,6846,760.6666667,1362010351271,1362010375911,2431729383,2431754023,24640
1362010383,2431760988,45,13062,290.2666667,1362010365221,1362010377317,2431743209,2431755305,12096
1362010383,1070075760,17,12629,742.8823529,1362010378859,1362010379371,1070071619,1070072131,512
1362010383,1070075768,62,74058,1194.483871,1362010377379,1362010378723,1070070147,1070071491,1344
1362010385,2431763036,1,254,254,1362010359219,1362010359219,2431737255,2431737255,0
1362010391,2431768980,21,6136,292.1904762,1362010389292,1362010390828,2431767272,2431768808,1536
1362010391,1070083760,16,11053,690.8125,1362010385258,1362010385642,1070078018,1070078402,384
1362010399,1070091764,15,9400,626.6666667,1362010393065,1362010393449,1070085829,1070086213,384
1362010399,1070091764,32,33599,1049.96875,1362010393448,1362010393960,1070086212,1070086724,512
1362010405,2431783028,6,2525,420.8333333,1362010378554,1362010379770,2431756582,2431757798,1216
1362010405,2431783044,8,3288,411,1362010378602,1362010379178,2431756646,2431757222,576
1362010405,2431783104,10,6958,695.8,1362010377585,1362010390961,2431755689,2431769065,13376
1362010407,2431785012,3,210,70,1362010406413,1362010406605,2431784425,2431784617,192
1362010415,2431792964,4,289,72.25,1362010413374,1362010414078,2431791338,2431792042,704
1362010415,2431793032,4,316,79,1362010407095,1362010413815,2431785127,2431791847,6720
1362010417,2431795048,2,2513,1256.5,1362010391016,1362010391016,2431769064,2431769064,0
1362010423,2431800952,3,237,79,1362010415046,1362010420870,2431792998,2431798822,5824
1362010433,2431811236,7,1295,185,1362010408109,1362010423853,2431786345,2431802089,15744
1362010439,2431816980,2,158,79,1362010421483,1362010436843,2431799463,2431814823,15360
1362010447,2431825060,2,158,79,1362010428442,1362010443930,2431806502,2431821990,15488
1362010461,2431839464,3,555,185,1362010433605,1362010453637,2431812069,2431832101,20032
1362010463,2431841028,2,104,52,1362010462589,1362010462845,2431840617,2431840873,256
1362010471,2431848988,3,156,52,1362010463329,1362010466081,2431841317,2431844069,2752
1362010471,2431848992,5,260,52,1362010463838,1362010467742,2431841830,2431845734,3904
1362010471,2431849040,3,156,52,1362010469807,1362010470511,2431847847,2431848551,704
1362010479,2431857016,2,104,52,1362010471432,1362010473160,2431849448,2431851176,1728
1362010489,2431867404,1,185,185,1362010463682,1362010463682,2431842086,2431842086,0
1362010493,2431871412,1,79,79,1362010467068,1362010467068,2431845480,2431845480,0
1362010501,2431879488,1,79,79,1362010474413,1362010474413,2431852901,2431852901,0
1362010503,2431881028,5,260,52,1362010495675,1362010499323,2431873703,2431877351,3648
1362010503,2431881032,5,368,73.6,1362010499063,1362010501111,2431877095,2431879143,2048
1362010503,2431881224,305,415464,1362.177049,1362010347638,1362010499318,2431725862,2431877542,151680
1362010503,2431881224,5,368,73.6,1362010499510,1362010501558,2431877734,2431879782,2048
1362010503,2431881228,166,221975,1337.198795,1362010348276,1362010501492,2431726504,2431879720,153216
1362010511,2431889088,2,158,79,1362010503359,1362010507967,2431881447,2431886055,4608
1362010511,2431889096,2,158,79,1362010504117,1362010508853,2431882213,2431886949,4736
1362010519,2431897016,2,158,79,1362010505990,1362010514438,2431884006,2431892454,8448
1362010519,2431897020,2,158,79,1362010503555,1362010511555,2431881575,2431889575,8000
1362010533,2431911472,7,1736,248,1362010508604,1362010525436,2431887076,2431903908,16832
1362010543,2431921020,2,158,79,1362010517315,1362010535811,2431895335,2431913831,18496
1362010543,2431921116,2,158,79,1362010518435,1362010537507,2431896551,2431915623,19072
1362010553,2431931472,1,79,79,1362010527101,1362010527101,2431905573,2431905573,0
1362010557,2431935496,1,79,79,1362010530980,1362010530980,2431909476,2431909476,0
1362010566,2431944644,1,46,46,1362010540432,1362010540432,2431919076,2431919076,0
1362010570,2431948816,1,248,248,1362010542117,1362010542117,2431920933,2431920933,0
1362010585,2431963520,1,79,79,1362010559116,1362010559116,2431937636,2431937636,0
1362010594,2431972504,1,79,79,1362010564958,1362010564958,2431943462,2431943462,0
1362010598,2431975860,1,79,79,1362010572896,1362010572896,2431950756,2431950756,0
1362010602,2431979928,1,79,79,1362010575903,1362010575903,2431953831,2431953831,0
1362010602,2431979984,1,248,248,1362010577126,1362010577126,2431955110,2431955110,0
1362010618,2431995928,1,46,46,1362010591582,1362010591582,2431969510,2431969510,0
1362010622,2431999864,1,46,46,1362010595742,1362010595742,2431973606,2431973606,0
1362010631,2432009096,4,277,69.25,1362010629682,1362010630450,2432007778,2432008546,768
1362010658,2432035868,4,300,75,1362010631639,1362010645143,2432009507,2432023011,13504
1362010666,2432043880,2,443,221.5,1362010645581,1362010659469,2432023461,2432037349,13888
1362010686,2432064032,1,75,75,1362010660467,1362010660467,2432038499,2432038499,0
1362010690,2432067988,1,46,46,1362010661921,1362010661921,2432039909,2432039909,0
1362010705,2432083972,1,46,46,1362010680136,1362010680136,2432059108,2432059108,0
1362010706,2432084032,1,46,46,1362010678770,1362010678770,2432056802,2432056802,0
1362010718,2432096076,1,75,75,1362010691336,1362010691336,2432069412,2432069412,0
1362010895,2432273284,6,427,71.16666667,1362010890739,1362010894195,2432269023,2432272479,3456
1362010923,2432300916,3,225,75,1362010898276,1362010920356,2432276192,2432298272,22080
1362010975,2432353028,1,75,75,1362010949748,1362010949748,2432327776,2432327776,0
